,TIME,SRC,PACKET_SIZE,CUMULATIVE_PACKET_SIZE,PAGE_NUMBER,TOTAL_PACKET_SIZE
0,0.0,74.125.68.0-255,146,146,64,304851
1,2.2e-05,172.31.40.0-255,66,212,64,304851
2,3e-05,74.125.68.0-255,1484,1696,64,304851
3,3.4e-05,172.31.40.0-255,66,1762,64,304851
4,3.9e-05,74.125.68.0-255,2902,4664,64,304851
5,4.9e-05,172.31.40.0-255,66,4730,64,304851
6,5.6e-05,74.125.68.0-255,4320,9050,64,304851
7,5.9e-05,172.31.40.0-255,66,9116,64,304851
8,9.9e-05,172.31.40.0-255,66,9182,64,304851
9,0.000136,172.31.40.0-255,66,9248,64,304851
10,0.00014,74.125.68.0-255,2902,12150,64,304851
11,0.000142,172.31.40.0-255,66,12216,64,304851
12,0.000188,74.125.68.0-255,2543,14759,64,304851
13,0.000191,172.31.40.0-255,66,14825,64,304851
14,0.000249,74.125.68.0-255,1484,16309,64,304851
15,0.000252,172.31.40.0-255,66,16375,64,304851
16,0.000256,74.125.68.0-255,2902,19277,64,304851
17,0.000259,172.31.40.0-255,66,19343,64,304851
18,0.000287,74.125.68.0-255,2902,22245,64,304851
19,0.00029,172.31.40.0-255,66,22311,64,304851
20,0.000297,74.125.68.0-255,4320,26631,64,304851
21,0.000299,172.31.40.0-255,66,26697,64,304851
22,0.000336,172.31.40.0-255,66,26763,64,304851
23,0.000342,74.125.68.0-255,5738,32501,64,304851
24,0.000344,172.31.40.0-255,66,32567,64,304851
25,0.000382,74.125.68.0-255,7156,39723,64,304851
26,0.000385,172.31.40.0-255,66,39789,64,304851
27,0.000388,74.125.68.0-255,766,40555,64,304851
28,0.00039,172.31.40.0-255,66,40621,64,304851
29,0.000423,74.125.68.0-255,400,41021,64,304851
30,0.000537,74.125.68.0-255,344,41365,64,304851
31,0.000689,74.125.68.0-255,1484,42849,64,304851
32,0.000693,172.31.40.0-255,66,42915,64,304851
33,0.000699,74.125.68.0-255,2902,45817,64,304851
34,0.000701,172.31.40.0-255,66,45883,64,304851
35,0.000726,74.125.68.0-255,5738,51621,64,304851
36,0.00073,172.31.40.0-255,66,51687,64,304851
37,0.00076,74.125.68.0-255,7156,58843,64,304851
38,0.000764,172.31.40.0-255,66,58909,64,304851
39,0.000775,172.31.40.0-255,66,58975,64,304851
40,0.000828,172.31.40.0-255,66,59041,64,304851
41,0.000891,74.125.68.0-255,1484,60525,64,304851
42,0.000917,74.125.68.0-255,2902,63427,64,304851
43,0.00092,172.31.40.0-255,66,63493,64,304851
44,0.000964,74.125.68.0-255,4320,67813,64,304851
45,0.000967,172.31.40.0-255,66,67879,64,304851
46,0.000974,74.125.68.0-255,5738,73617,64,304851
47,0.000976,172.31.40.0-255,66,73683,64,304851
48,0.000992,172.31.40.0-255,66,73749,64,304851
49,0.001018,74.125.68.0-255,1484,75233,64,304851
50,0.001023,74.125.68.0-255,2902,78135,64,304851
51,0.001026,172.31.40.0-255,66,78201,64,304851
52,0.001045,74.125.68.0-255,5020,83221,64,304851
53,0.001047,172.31.40.0-255,66,83287,64,304851
54,0.001096,74.125.68.0-255,1484,84771,64,304851
55,0.001109,74.125.68.0-255,2902,87673,64,304851
56,0.001112,172.31.40.0-255,66,87739,64,304851
57,0.001137,74.125.68.0-255,5738,93477,64,304851
58,0.00114,172.31.40.0-255,66,93543,64,304851
59,0.001143,74.125.68.0-255,1484,95027,64,304851
60,0.001169,74.125.68.0-255,2902,97929,64,304851
61,0.001172,172.31.40.0-255,66,97995,64,304851
62,0.001178,74.125.68.0-255,5738,103733,64,304851
63,0.00118,172.31.40.0-255,66,103799,64,304851
64,0.001214,172.31.40.0-255,66,103865,64,304851
65,0.00124,74.125.68.0-255,1484,105349,64,304851
66,0.001256,74.125.68.0-255,3602,108951,64,304851
67,0.001258,172.31.40.0-255,66,109017,64,304851
68,0.001564,74.125.68.0-255,1484,110501,64,304851
69,0.00157,74.125.68.0-255,2902,113403,64,304851
70,0.001573,172.31.40.0-255,66,113469,64,304851
71,0.001597,74.125.68.0-255,1484,114953,64,304851
72,0.001622,74.125.68.0-255,2902,117855,64,304851
73,0.001628,74.125.68.0-255,5738,123593,64,304851
74,0.001632,172.31.40.0-255,66,123659,64,304851
75,0.001635,172.31.40.0-255,66,123725,64,304851
76,0.001662,172.31.40.0-255,66,123791,64,304851
77,0.001667,74.125.68.0-255,4320,128111,64,304851
78,0.00167,172.31.40.0-255,66,128177,64,304851
79,0.001716,74.125.68.0-255,5738,133915,64,304851
80,0.001719,172.31.40.0-255,66,133981,64,304851
81,0.001722,74.125.68.0-255,766,134747,64,304851
82,0.001999,74.125.68.0-255,1484,136231,64,304851
83,0.002003,172.31.40.0-255,66,136297,64,304851
84,0.002007,74.125.68.0-255,1484,137781,64,304851
85,0.002033,74.125.68.0-255,1484,139265,64,304851
86,0.002036,172.31.40.0-255,66,139331,64,304851
87,0.004029,74.125.68.0-255,5738,145069,64,304851
88,0.004034,172.31.40.0-255,66,145135,64,304851
89,0.006046,74.125.68.0-255,5738,150873,64,304851
90,0.006049,172.31.40.0-255,66,150939,64,304851
91,0.008059,74.125.68.0-255,5738,156677,64,304851
92,0.008064,172.31.40.0-255,66,156743,64,304851
93,0.010082,74.125.68.0-255,5738,162481,64,304851
94,0.010089,172.31.40.0-255,66,162547,64,304851
95,0.012113,74.125.68.0-255,5738,168285,64,304851
96,0.012119,172.31.40.0-255,66,168351,64,304851
97,0.014145,74.125.68.0-255,5738,174089,64,304851
98,0.014153,172.31.40.0-255,66,174155,64,304851
99,0.016162,74.125.68.0-255,5738,179893,64,304851
100,0.016169,172.31.40.0-255,66,179959,64,304851
101,0.018189,74.125.68.0-255,5738,185697,64,304851
102,0.018196,172.31.40.0-255,66,185763,64,304851
103,0.020228,74.125.68.0-255,5738,191501,64,304851
104,0.020245,172.31.40.0-255,66,191567,64,304851
105,0.022267,74.125.68.0-255,5738,197305,64,304851
106,0.022282,172.31.40.0-255,66,197371,64,304851
107,0.024299,74.125.68.0-255,5738,203109,64,304851
108,0.024313,172.31.40.0-255,66,203175,64,304851
109,0.026386,74.125.68.0-255,5738,208913,64,304851
110,0.0264,172.31.40.0-255,66,208979,64,304851
111,0.028426,74.125.68.0-255,5738,214717,64,304851
112,0.028437,172.31.40.0-255,66,214783,64,304851
113,0.030476,74.125.68.0-255,5738,220521,64,304851
114,0.030492,172.31.40.0-255,66,220587,64,304851
115,0.032516,74.125.68.0-255,5738,226325,64,304851
116,0.032524,172.31.40.0-255,66,226391,64,304851
117,0.034554,74.125.68.0-255,5738,232129,64,304851
118,0.034562,172.31.40.0-255,66,232195,64,304851
119,0.036585,74.125.68.0-255,5738,237933,64,304851
120,0.036601,172.31.40.0-255,66,237999,64,304851
121,0.038626,74.125.68.0-255,5738,243737,64,304851
122,0.038634,172.31.40.0-255,66,243803,64,304851
123,0.040654,74.125.68.0-255,5738,249541,64,304851
124,0.040666,172.31.40.0-255,66,249607,64,304851
125,0.042702,74.125.68.0-255,5738,255345,64,304851
126,0.042719,172.31.40.0-255,66,255411,64,304851
127,0.044741,74.125.68.0-255,5738,261149,64,304851
128,0.044752,172.31.40.0-255,66,261215,64,304851
129,0.046765,74.125.68.0-255,5738,266953,64,304851
130,0.046773,172.31.40.0-255,66,267019,64,304851
131,0.048806,74.125.68.0-255,5738,272757,64,304851
132,0.048825,172.31.40.0-255,66,272823,64,304851
133,0.050838,74.125.68.0-255,4320,277143,64,304851
134,0.050844,172.31.40.0-255,66,277209,64,304851
135,0.05087,74.125.68.0-255,1484,278693,64,304851
136,0.051812,172.31.40.0-255,172,278865,64,304851
137,0.051848,172.31.40.0-255,1113,279978,64,304851
138,0.051949,172.31.40.0-255,1514,281492,64,304851
139,0.051951,172.31.40.0-255,1297,282789,64,304851
140,0.052864,74.125.68.0-255,4320,287109,64,304851
141,0.052871,172.31.40.0-255,66,287175,64,304851
142,0.053351,104.244.42.0-255,66,287241,64,304851
143,0.053376,104.244.42.0-255,66,287307,64,304851
144,0.053505,104.244.42.0-255,66,287373,64,304851
145,0.053529,104.244.42.0-255,66,287439,64,304851
146,0.054906,74.125.68.0-255,5738,293177,64,304851
147,0.054916,172.31.40.0-255,66,293243,64,304851
148,0.05695,74.125.68.0-255,5738,298981,64,304851
149,0.056963,172.31.40.0-255,66,299047,64,304851
150,0.058993,74.125.68.0-255,5738,304785,64,304851
151,0.059006,172.31.40.0-255,66,304851,64,304851
152,0.0,172.217.194.0-255,148,148,64,287486
153,2.2e-05,172.31.40.0-255,66,214,64,287486
154,2.9e-05,172.217.194.0-255,1484,1698,64,287486
155,3.5e-05,172.31.40.0-255,66,1764,64,287486
156,4.1e-05,172.217.194.0-255,2902,4666,64,287486
157,4.5e-05,172.31.40.0-255,66,4732,64,287486
158,5.3e-05,172.217.194.0-255,7156,11888,64,287486
159,5.6e-05,172.31.40.0-255,66,11954,64,287486
160,5.9e-05,172.217.194.0-255,1993,13947,64,287486
161,6.1e-05,172.31.40.0-255,66,14013,64,287486
162,0.00025,172.217.194.0-255,1484,15497,64,287486
163,0.000255,172.31.40.0-255,66,15563,64,287486
164,0.000261,172.217.194.0-255,2902,18465,64,287486
165,0.000264,172.31.40.0-255,66,18531,64,287486
166,0.00027,172.217.194.0-255,4320,22851,64,287486
167,0.000272,172.31.40.0-255,66,22917,64,287486
168,0.000285,172.217.194.0-255,1484,24401,64,287486
169,0.000288,172.31.40.0-255,66,24467,64,287486
170,0.00031,172.217.194.0-255,6797,31264,64,287486
171,0.000312,172.31.40.0-255,66,31330,64,287486
172,0.00077,172.217.194.0-255,1484,32814,64,287486
173,0.000776,172.31.40.0-255,66,32880,64,287486
174,0.000784,172.217.194.0-255,2902,35782,64,287486
175,0.000786,172.31.40.0-255,66,35848,64,287486
176,0.000793,172.217.194.0-255,5738,41586,64,287486
177,0.000795,172.31.40.0-255,66,41652,64,287486
178,0.000832,172.217.194.0-255,6797,48449,64,287486
179,0.000834,172.31.40.0-255,66,48515,64,287486
180,0.000842,172.217.194.0-255,7156,55671,64,287486
181,0.000844,172.31.40.0-255,66,55737,64,287486
182,0.000866,172.217.194.0-255,2902,58639,64,287486
183,0.000869,172.31.40.0-255,66,58705,64,287486
184,0.000891,172.217.194.0-255,7110,65815,64,287486
185,0.000894,172.31.40.0-255,66,65881,64,287486
186,0.001004,172.217.194.0-255,365,66246,64,287486
187,0.001088,172.217.194.0-255,1484,67730,64,287486
188,0.001092,172.31.40.0-255,66,67796,64,287486
189,0.001097,172.217.194.0-255,2902,70698,64,287486
190,0.0011,172.31.40.0-255,66,70764,64,287486
191,0.001104,172.217.194.0-255,2902,73666,64,287486
192,0.001106,172.31.40.0-255,66,73732,64,287486
193,0.001134,172.217.194.0-255,2902,76634,64,287486
194,0.001137,172.31.40.0-255,66,76700,64,287486
195,0.001144,172.217.194.0-255,6797,83497,64,287486
196,0.001147,172.31.40.0-255,66,83563,64,287486
197,0.001165,172.217.194.0-255,4320,87883,64,287486
198,0.001169,172.31.40.0-255,66,87949,64,287486
199,0.001202,172.31.40.0-255,66,88015,64,287486
200,0.001206,172.217.194.0-255,2543,90558,64,287486
201,0.001208,172.31.40.0-255,66,90624,64,287486
202,0.001874,172.217.194.0-255,1484,92108,64,287486
203,0.001884,172.217.194.0-255,2902,95010,64,287486
204,0.001889,172.31.40.0-255,66,95076,64,287486
205,0.001897,172.217.194.0-255,5738,100814,64,287486
206,0.001899,172.31.40.0-255,66,100880,64,287486
207,0.001939,172.31.40.0-255,66,100946,64,287486
208,0.001966,172.31.40.0-255,66,101012,64,287486
209,0.001982,172.217.194.0-255,766,101778,64,287486
210,0.002008,172.217.194.0-255,1484,103262,64,287486
211,0.002011,172.31.40.0-255,66,103328,64,287486
212,0.002014,172.217.194.0-255,1484,104812,64,287486
213,0.002031,172.217.194.0-255,1484,106296,64,287486
214,0.002034,172.31.40.0-255,66,106362,64,287486
215,0.00204,172.217.194.0-255,5738,112100,64,287486
216,0.002042,172.31.40.0-255,66,112166,64,287486
217,0.002045,172.217.194.0-255,1484,113650,64,287486
218,0.002058,172.217.194.0-255,2902,116552,64,287486
219,0.002061,172.31.40.0-255,66,116618,64,287486
220,0.002088,172.217.194.0-255,5738,122356,64,287486
221,0.00209,172.31.40.0-255,66,122422,64,287486
222,0.002093,172.217.194.0-255,1484,123906,64,287486
223,0.002108,172.217.194.0-255,4320,128226,64,287486
224,0.002111,172.31.40.0-255,66,128292,64,287486
225,0.002137,172.31.40.0-255,66,128358,64,287486
226,0.00214,172.217.194.0-255,1484,129842,64,287486
227,0.002162,172.217.194.0-255,2902,132744,64,287486
228,0.002165,172.31.40.0-255,66,132810,64,287486
229,0.002172,172.217.194.0-255,5738,138548,64,287486
230,0.002174,172.31.40.0-255,66,138614,64,287486
231,0.002222,172.31.40.0-255,66,138680,64,287486
232,0.002233,172.31.40.0-255,66,138746,64,287486
233,0.002235,172.217.194.0-255,766,139512,64,287486
234,0.004443,172.217.194.0-255,4320,143832,64,287486
235,0.004448,172.31.40.0-255,66,143898,64,287486
236,0.006688,172.217.194.0-255,5738,149636,64,287486
237,0.006693,172.31.40.0-255,66,149702,64,287486
238,0.008903,172.217.194.0-255,5738,155440,64,287486
239,0.00891,172.31.40.0-255,66,155506,64,287486
240,0.011171,172.217.194.0-255,5738,161244,64,287486
241,0.011179,172.31.40.0-255,66,161310,64,287486
242,0.013411,172.217.194.0-255,5738,167048,64,287486
243,0.013418,172.31.40.0-255,66,167114,64,287486
244,0.015624,172.217.194.0-255,5738,172852,64,287486
245,0.01563,172.31.40.0-255,66,172918,64,287486
246,0.017819,172.217.194.0-255,5738,178656,64,287486
247,0.017828,172.31.40.0-255,66,178722,64,287486
248,0.020063,172.217.194.0-255,5738,184460,64,287486
249,0.020075,172.31.40.0-255,66,184526,64,287486
250,0.02233,172.217.194.0-255,5738,190264,64,287486
251,0.022338,172.31.40.0-255,66,190330,64,287486
252,0.024551,172.217.194.0-255,5738,196068,64,287486
253,0.024559,172.31.40.0-255,66,196134,64,287486
254,0.02672,172.31.40.0-255,172,196306,64,287486
255,0.026752,172.31.40.0-255,1112,197418,64,287486
256,0.026783,172.217.194.0-255,5738,203156,64,287486
257,0.026787,172.31.40.0-255,66,203222,64,287486
258,0.026889,172.31.40.0-255,1514,204736,64,287486
259,0.026891,172.31.40.0-255,1296,206032,64,287486
260,0.028244,104.244.42.0-255,66,206098,64,287486
261,0.028289,104.244.42.0-255,66,206164,64,287486
262,0.02848,104.244.42.0-255,66,206230,64,287486
263,0.028984,172.217.194.0-255,5738,211968,64,287486
264,0.028991,172.31.40.0-255,66,212034,64,287486
265,0.031235,172.217.194.0-255,5738,217772,64,287486
266,0.031241,172.31.40.0-255,66,217838,64,287486
267,0.033459,172.217.194.0-255,5738,223576,64,287486
268,0.033466,172.31.40.0-255,66,223642,64,287486
269,0.035666,172.217.194.0-255,5738,229380,64,287486
270,0.035672,172.31.40.0-255,66,229446,64,287486
271,0.037876,172.217.194.0-255,5738,235184,64,287486
272,0.037882,172.31.40.0-255,66,235250,64,287486
273,0.040094,172.217.194.0-255,5738,240988,64,287486
274,0.040099,172.31.40.0-255,66,241054,64,287486
275,0.042313,172.217.194.0-255,5738,246792,64,287486
276,0.042322,172.31.40.0-255,66,246858,64,287486
277,0.044533,172.217.194.0-255,5738,252596,64,287486
278,0.04454,172.31.40.0-255,66,252662,64,287486
279,0.046744,172.217.194.0-255,5738,258400,64,287486
280,0.046751,172.31.40.0-255,66,258466,64,287486
281,0.048945,172.217.194.0-255,5738,264204,64,287486
282,0.048952,172.31.40.0-255,66,264270,64,287486
283,0.051162,172.217.194.0-255,5738,270008,64,287486
284,0.051168,172.31.40.0-255,66,270074,64,287486
285,0.053384,172.217.194.0-255,5738,275812,64,287486
286,0.05339,172.31.40.0-255,66,275878,64,287486
287,0.055601,172.217.194.0-255,5738,281616,64,287486
288,0.055606,172.31.40.0-255,66,281682,64,287486
289,0.057819,172.217.194.0-255,5738,287420,64,287486
290,0.057826,172.31.40.0-255,66,287486,64,287486
291,0.0,172.217.194.0-255,156,156,64,305800
292,1.9e-05,172.31.40.0-255,66,222,64,305800
293,2.6e-05,172.217.194.0-255,1484,1706,64,305800
294,3e-05,172.31.40.0-255,66,1772,64,305800
295,3.7e-05,172.217.194.0-255,2902,4674,64,305800
296,4.1e-05,172.31.40.0-255,66,4740,64,305800
297,4.9e-05,172.217.194.0-255,7156,11896,64,305800
298,5.1e-05,172.31.40.0-255,66,11962,64,305800
299,5.5e-05,172.217.194.0-255,2029,13991,64,305800
300,5.7e-05,172.31.40.0-255,66,14057,64,305800
301,0.000229,172.217.194.0-255,1484,15541,64,305800
302,0.000233,172.31.40.0-255,66,15607,64,305800
303,0.000239,172.217.194.0-255,2902,18509,64,305800
304,0.000241,172.31.40.0-255,66,18575,64,305800
305,0.000244,172.217.194.0-255,1484,20059,64,305800
306,0.000246,172.31.40.0-255,66,20125,64,305800
307,0.000276,172.217.194.0-255,4320,24445,64,305800
308,0.000279,172.31.40.0-255,66,24511,64,305800
309,0.000284,172.217.194.0-255,4320,28831,64,305800
310,0.000286,172.31.40.0-255,66,28897,64,305800
311,0.000291,172.217.194.0-255,4320,33217,64,305800
312,0.000293,172.31.40.0-255,66,33283,64,305800
313,0.000317,172.31.40.0-255,66,33349,64,305800
314,0.000329,172.31.40.0-255,66,33415,64,305800
315,0.000349,172.217.194.0-255,4320,37735,64,305800
316,0.000351,172.31.40.0-255,66,37801,64,305800
317,0.000355,172.217.194.0-255,2902,40703,64,305800
318,0.000357,172.31.40.0-255,66,40769,64,305800
319,0.000381,172.217.194.0-255,6438,47207,64,305800
320,0.000384,172.31.40.0-255,66,47273,64,305800
321,0.000386,172.217.194.0-255,409,47682,64,305800
322,0.00057,172.217.194.0-255,1484,49166,64,305800
323,0.000576,172.31.40.0-255,66,49232,64,305800
324,0.000579,172.217.194.0-255,1484,50716,64,305800
325,0.000595,172.217.194.0-255,1484,52200,64,305800
326,0.000601,172.217.194.0-255,5738,57938,64,305800
327,0.000605,172.31.40.0-255,66,58004,64,305800
328,0.000608,172.31.40.0-255,66,58070,64,305800
329,0.00062,172.217.194.0-255,1484,59554,64,305800
330,0.000648,172.31.40.0-255,66,59620,64,305800
331,0.000683,172.31.40.0-255,66,59686,64,305800
332,0.000685,172.217.194.0-255,365,60051,64,305800
333,0.000785,172.217.194.0-255,1484,61535,64,305800
334,0.000789,172.217.194.0-255,2902,64437,64,305800
335,0.000794,172.31.40.0-255,66,64503,64,305800
336,0.000797,172.31.40.0-255,66,64569,64,305800
337,0.00082,172.217.194.0-255,5738,70307,64,305800
338,0.000823,172.31.40.0-255,66,70373,64,305800
339,0.000826,172.217.194.0-255,1484,71857,64,305800
340,0.000861,172.31.40.0-255,66,71923,64,305800
341,0.000869,172.217.194.0-255,7156,79079,64,305800
342,0.000871,172.31.40.0-255,66,79145,64,305800
343,0.00089,172.217.194.0-255,3602,82747,64,305800
344,0.000892,172.31.40.0-255,66,82813,64,305800
345,0.001014,172.217.194.0-255,1484,84297,64,305800
346,0.001018,172.217.194.0-255,2902,87199,64,305800
347,0.001021,172.31.40.0-255,66,87265,64,305800
348,0.001025,172.217.194.0-255,4320,91585,64,305800
349,0.001027,172.31.40.0-255,66,91651,64,305800
350,0.001037,172.217.194.0-255,1484,93135,64,305800
351,0.001049,172.217.194.0-255,2902,96037,64,305800
352,0.00105,172.31.40.0-255,66,96103,64,305800
353,0.001081,172.31.40.0-255,66,96169,64,305800
354,0.001087,172.217.194.0-255,7156,103325,64,305800
355,0.001089,172.31.40.0-255,66,103391,64,305800
356,0.0011,172.217.194.0-255,2902,106293,64,305800
357,0.001102,172.31.40.0-255,66,106359,64,305800
358,0.001121,172.217.194.0-255,766,107125,64,305800
359,0.001583,172.217.194.0-255,1484,108609,64,305800
360,0.001586,172.31.40.0-255,66,108675,64,305800
361,0.001591,172.217.194.0-255,2902,111577,64,305800
362,0.001593,172.31.40.0-255,66,111643,64,305800
363,0.001608,172.217.194.0-255,5738,117381,64,305800
364,0.00161,172.31.40.0-255,66,117447,64,305800
365,0.001619,172.217.194.0-255,1484,118931,64,305800
366,0.001633,172.217.194.0-255,7156,126087,64,305800
367,0.001635,172.31.40.0-255,66,126153,64,305800
368,0.001652,172.217.194.0-255,2902,129055,64,305800
369,0.001654,172.31.40.0-255,66,129121,64,305800
370,0.001661,172.217.194.0-255,7156,136277,64,305800
371,0.001663,172.31.40.0-255,66,136343,64,305800
372,0.001688,172.217.194.0-255,5020,141363,64,305800
373,0.001691,172.31.40.0-255,66,141429,64,305800
374,0.002132,172.217.194.0-255,1484,142913,64,305800
375,0.002136,172.217.194.0-255,1484,144397,64,305800
376,0.00214,172.31.40.0-255,66,144463,64,305800
377,0.002149,172.217.194.0-255,1484,145947,64,305800
378,0.002152,172.217.194.0-255,1484,147431,64,305800
379,0.002153,172.31.40.0-255,66,147497,64,305800
380,0.002167,172.217.194.0-255,4320,151817,64,305800
381,0.002169,172.31.40.0-255,66,151883,64,305800
382,0.002181,172.217.194.0-255,2902,154785,64,305800
383,0.002183,172.31.40.0-255,66,154851,64,305800
384,0.002209,172.31.40.0-255,66,154917,64,305800
385,0.002253,172.31.40.0-255,66,154983,64,305800
386,0.002282,172.31.40.0-255,66,155049,64,305800
387,0.0023,172.217.194.0-255,2902,157951,64,305800
388,0.002302,172.31.40.0-255,66,158017,64,305800
389,0.002341,172.31.40.0-255,66,158083,64,305800
390,0.002403,172.217.194.0-255,4320,162403,64,305800
391,0.002406,172.31.40.0-255,66,162469,64,305800
392,0.002434,172.31.40.0-255,66,162535,64,305800
393,0.002452,172.217.194.0-255,2184,164719,64,305800
394,0.002454,172.31.40.0-255,66,164785,64,305800
395,0.004723,172.217.194.0-255,2902,167687,64,305800
396,0.004739,172.31.40.0-255,66,167753,64,305800
397,0.004759,172.217.194.0-255,2902,170655,64,305800
398,0.004761,172.31.40.0-255,66,170721,64,305800
399,0.007106,172.217.194.0-255,5738,176459,64,305800
400,0.007119,172.31.40.0-255,66,176525,64,305800
401,0.009426,172.217.194.0-255,5738,182263,64,305800
402,0.009434,172.31.40.0-255,66,182329,64,305800
403,0.011727,172.217.194.0-255,5738,188067,64,305800
404,0.01173,172.31.40.0-255,66,188133,64,305800
405,0.014043,172.217.194.0-255,5738,193871,64,305800
406,0.01405,172.31.40.0-255,66,193937,64,305800
407,0.016366,172.217.194.0-255,5738,199675,64,305800
408,0.016381,172.31.40.0-255,66,199741,64,305800
409,0.018718,172.217.194.0-255,5738,205479,64,305800
410,0.018732,172.31.40.0-255,66,205545,64,305800
411,0.021043,172.217.194.0-255,5738,211283,64,305800
412,0.021051,172.31.40.0-255,66,211349,64,305800
413,0.023375,172.217.194.0-255,4320,215669,64,305800
414,0.023383,172.31.40.0-255,66,215735,64,305800
415,0.023403,172.217.194.0-255,1484,217219,64,305800
416,0.025692,172.217.194.0-255,4320,221539,64,305800
417,0.025699,172.31.40.0-255,66,221605,64,305800
418,0.028017,172.217.194.0-255,5738,227343,64,305800
419,0.028036,172.31.40.0-255,66,227409,64,305800
420,0.030341,172.217.194.0-255,4320,231729,64,305800
421,0.03035,172.31.40.0-255,66,231795,64,305800
422,0.030373,172.217.194.0-255,1484,233279,64,305800
423,0.032653,172.217.194.0-255,4320,237599,64,305800
424,0.032661,172.31.40.0-255,66,237665,64,305800
425,0.034969,172.217.194.0-255,5738,243403,64,305800
426,0.034987,172.31.40.0-255,66,243469,64,305800
427,0.037292,172.217.194.0-255,5738,249207,64,305800
428,0.037302,172.31.40.0-255,66,249273,64,305800
429,0.039626,172.217.194.0-255,5738,255011,64,305800
430,0.03964,172.31.40.0-255,66,255077,64,305800
431,0.041966,172.217.194.0-255,5738,260815,64,305800
432,0.041983,172.31.40.0-255,66,260881,64,305800
433,0.044301,172.217.194.0-255,5738,266619,64,305800
434,0.044308,172.31.40.0-255,66,266685,64,305800
435,0.046611,172.217.194.0-255,5738,272423,64,305800
436,0.046623,172.31.40.0-255,66,272489,64,305800
437,0.048946,172.217.194.0-255,5738,278227,64,305800
438,0.048958,172.31.40.0-255,66,278293,64,305800
439,0.051262,172.217.194.0-255,5738,284031,64,305800
440,0.05127,172.31.40.0-255,66,284097,64,305800
441,0.051412,172.31.40.0-255,171,284268,64,305800
442,0.051441,172.31.40.0-255,1136,285404,64,305800
443,0.051562,172.31.40.0-255,1514,286918,64,305800
444,0.051565,172.31.40.0-255,1272,288190,64,305800
445,0.052954,104.244.42.0-255,66,288256,64,305800
446,0.052997,104.244.42.0-255,66,288322,64,305800
447,0.053094,104.244.42.0-255,66,288388,64,305800
448,0.053566,172.217.194.0-255,5738,294126,64,305800
449,0.053573,172.31.40.0-255,66,294192,64,305800
450,0.055911,172.217.194.0-255,5738,299930,64,305800
451,0.055921,172.31.40.0-255,66,299996,64,305800
452,0.058262,172.217.194.0-255,5738,305734,64,305800
453,0.05828,172.31.40.0-255,66,305800,64,305800
454,0.0,74.125.68.0-255,298,298,64,254891
455,2.3e-05,172.31.40.0-255,66,364,64,254891
456,3e-05,74.125.68.0-255,1484,1848,64,254891
457,3.5e-05,172.31.40.0-255,66,1914,64,254891
458,3.8e-05,74.125.68.0-255,1484,3398,64,254891
459,4.9e-05,172.31.40.0-255,66,3464,64,254891
460,5.6e-05,74.125.68.0-255,4320,7784,64,254891
461,6e-05,172.31.40.0-255,66,7850,64,254891
462,0.000101,74.125.68.0-255,6193,14043,64,254891
463,0.000105,172.31.40.0-255,66,14109,64,254891
464,0.000195,74.125.68.0-255,1484,15593,64,254891
465,0.000199,172.31.40.0-255,66,15659,64,254891
466,0.000227,74.125.68.0-255,2902,18561,64,254891
467,0.00023,172.31.40.0-255,66,18627,64,254891
468,0.000236,74.125.68.0-255,4320,22947,64,254891
469,0.000238,172.31.40.0-255,66,23013,64,254891
470,0.000245,74.125.68.0-255,5738,28751,64,254891
471,0.000247,172.31.40.0-255,66,28817,64,254891
472,0.000291,74.125.68.0-255,6797,35614,64,254891
473,0.000294,172.31.40.0-255,66,35680,64,254891
474,0.000323,74.125.68.0-255,7156,42836,64,254891
475,0.000326,172.31.40.0-255,66,42902,64,254891
476,0.000332,74.125.68.0-255,4320,47222,64,254891
477,0.000335,172.31.40.0-255,66,47288,64,254891
478,0.000338,74.125.68.0-255,1484,48772,64,254891
479,0.00034,172.31.40.0-255,66,48838,64,254891
480,0.000373,74.125.68.0-255,4320,53158,64,254891
481,0.000376,172.31.40.0-255,66,53224,64,254891
482,0.000387,172.31.40.0-255,66,53290,64,254891
483,0.000415,74.125.68.0-255,2902,56192,64,254891
484,0.000418,172.31.40.0-255,66,56258,64,254891
485,0.000421,74.125.68.0-255,766,57024,64,254891
486,0.000426,74.125.68.0-255,360,57384,64,254891
487,0.000524,74.125.68.0-255,134,57518,64,254891
488,0.000563,74.125.68.0-255,346,57864,64,254891
489,0.000909,74.125.68.0-255,1484,59348,64,254891
490,0.000914,74.125.68.0-255,1484,60832,64,254891
491,0.000926,172.31.40.0-255,66,60898,64,254891
492,0.000936,74.125.68.0-255,1484,62382,64,254891
493,0.000945,74.125.68.0-255,4320,66702,64,254891
494,0.00095,74.125.68.0-255,4320,71022,64,254891
495,0.000959,74.125.68.0-255,1484,72506,64,254891
496,0.000988,74.125.68.0-255,4320,76826,64,254891
497,0.000994,172.31.40.0-255,66,76892,64,254891
498,0.001026,74.125.68.0-255,7156,84048,64,254891
499,0.001033,74.125.68.0-255,4320,88368,64,254891
500,0.001049,74.125.68.0-255,2902,91270,64,254891
501,0.001064,74.125.68.0-255,766,92036,64,254891
502,0.001076,172.31.40.0-255,66,92102,64,254891
503,0.002168,74.125.68.0-255,1484,93586,64,254891
504,0.002176,74.125.68.0-255,2902,96488,64,254891
505,0.00218,172.31.40.0-255,66,96554,64,254891
506,0.002208,74.125.68.0-255,5738,102292,64,254891
507,0.002211,74.125.68.0-255,2902,105194,64,254891
508,0.002226,74.125.68.0-255,2902,108096,64,254891
509,0.002238,74.125.68.0-255,1484,109580,64,254891
510,0.002242,74.125.68.0-255,2902,112482,64,254891
511,0.002269,74.125.68.0-255,5738,118220,64,254891
512,0.002275,74.125.68.0-255,5738,123958,64,254891
513,0.002306,74.125.68.0-255,2184,126142,64,254891
514,0.00555,172.31.40.0-255,66,126208,64,254891
515,0.00791,74.125.68.0-255,5738,131946,64,254891
516,0.007915,172.31.40.0-255,66,132012,64,254891
517,0.010261,74.125.68.0-255,2902,134914,64,254891
518,0.010268,172.31.40.0-255,66,134980,64,254891
519,0.010299,74.125.68.0-255,2902,137882,64,254891
520,0.012403,172.31.40.0-255,66,137948,64,254891
521,0.012634,74.125.68.0-255,2902,140850,64,254891
522,0.012641,172.31.40.0-255,66,140916,64,254891
523,0.014757,74.125.68.0-255,2902,143818,64,254891
524,0.01477,172.31.40.0-255,66,143884,64,254891
525,0.014972,74.125.68.0-255,2902,146786,64,254891
526,0.014977,172.31.40.0-255,66,146852,64,254891
527,0.017119,74.125.68.0-255,2902,149754,64,254891
528,0.017127,172.31.40.0-255,66,149820,64,254891
529,0.017313,74.125.68.0-255,2902,152722,64,254891
530,0.017318,172.31.40.0-255,66,152788,64,254891
531,0.019477,74.125.68.0-255,2902,155690,64,254891
532,0.019483,172.31.40.0-255,66,155756,64,254891
533,0.019652,74.125.68.0-255,2902,158658,64,254891
534,0.019657,172.31.40.0-255,66,158724,64,254891
535,0.02185,74.125.68.0-255,2902,161626,64,254891
536,0.021856,172.31.40.0-255,66,161692,64,254891
537,0.022019,74.125.68.0-255,2902,164594,64,254891
538,0.022024,172.31.40.0-255,66,164660,64,254891
539,0.024202,74.125.68.0-255,2902,167562,64,254891
540,0.02421,172.31.40.0-255,66,167628,64,254891
541,0.024363,74.125.68.0-255,2902,170530,64,254891
542,0.024367,172.31.40.0-255,66,170596,64,254891
543,0.026553,74.125.68.0-255,2902,173498,64,254891
544,0.02656,172.31.40.0-255,66,173564,64,254891
545,0.026698,74.125.68.0-255,2902,176466,64,254891
546,0.028397,172.31.40.0-255,66,176532,64,254891
547,0.028911,74.125.68.0-255,2902,179434,64,254891
548,0.028916,172.31.40.0-255,66,179500,64,254891
549,0.030755,74.125.68.0-255,2902,182402,64,254891
550,0.030761,172.31.40.0-255,66,182468,64,254891
551,0.031259,74.125.68.0-255,2902,185370,64,254891
552,0.031265,172.31.40.0-255,66,185436,64,254891
553,0.033112,74.125.68.0-255,2902,188338,64,254891
554,0.03312,172.31.40.0-255,66,188404,64,254891
555,0.033626,74.125.68.0-255,2902,191306,64,254891
556,0.033633,172.31.40.0-255,66,191372,64,254891
557,0.035534,74.125.68.0-255,2902,194274,64,254891
558,0.035542,172.31.40.0-255,66,194340,64,254891
559,0.035982,74.125.68.0-255,2902,197242,64,254891
560,0.035989,172.31.40.0-255,66,197308,64,254891
561,0.036099,172.31.40.0-255,171,197479,64,254891
562,0.036126,172.31.40.0-255,1137,198616,64,254891
563,0.036181,172.31.40.0-255,1514,200130,64,254891
564,0.036183,172.31.40.0-255,1271,201401,64,254891
565,0.037622,104.244.42.0-255,66,201467,64,254891
566,0.037663,104.244.42.0-255,66,201533,64,254891
567,0.037738,104.244.42.0-255,66,201599,64,254891
568,0.037885,74.125.68.0-255,2902,204501,64,254891
569,0.037892,172.31.40.0-255,66,204567,64,254891
570,0.038351,74.125.68.0-255,2902,207469,64,254891
571,0.038357,172.31.40.0-255,66,207535,64,254891
572,0.040243,74.125.68.0-255,2902,210437,64,254891
573,0.04025,172.31.40.0-255,66,210503,64,254891
574,0.040742,74.125.68.0-255,2902,213405,64,254891
575,0.040748,172.31.40.0-255,66,213471,64,254891
576,0.042603,74.125.68.0-255,2902,216373,64,254891
577,0.042609,172.31.40.0-255,66,216439,64,254891
578,0.043091,74.125.68.0-255,2902,219341,64,254891
579,0.043097,172.31.40.0-255,66,219407,64,254891
580,0.044972,74.125.68.0-255,2902,222309,64,254891
581,0.044979,172.31.40.0-255,66,222375,64,254891
582,0.045455,74.125.68.0-255,2902,225277,64,254891
583,0.045461,172.31.40.0-255,66,225343,64,254891
584,0.04733,74.125.68.0-255,2902,228245,64,254891
585,0.047336,172.31.40.0-255,66,228311,64,254891
586,0.047801,74.125.68.0-255,2902,231213,64,254891
587,0.047824,172.31.40.0-255,66,231279,64,254891
588,0.049697,74.125.68.0-255,2902,234181,64,254891
589,0.049704,172.31.40.0-255,66,234247,64,254891
590,0.050181,74.125.68.0-255,2902,237149,64,254891
591,0.050188,172.31.40.0-255,66,237215,64,254891
592,0.05206,74.125.68.0-255,2902,240117,64,254891
593,0.052067,172.31.40.0-255,66,240183,64,254891
594,0.052536,74.125.68.0-255,1484,241667,64,254891
595,0.052555,74.125.68.0-255,1484,243151,64,254891
596,0.05256,172.31.40.0-255,66,243217,64,254891
597,0.054461,74.125.68.0-255,2902,246119,64,254891
598,0.054897,74.125.68.0-255,2902,249021,64,254891
599,0.056585,172.31.40.0-255,66,249087,64,254891
600,0.058961,74.125.68.0-255,5738,254825,64,254891
601,0.058979,172.31.40.0-255,66,254891,64,254891
602,0.0,74.125.200.0-255,153,153,64,383974
603,2.3e-05,172.31.40.0-255,66,219,64,383974
604,3e-05,74.125.200.0-255,1484,1703,64,383974
605,3.5e-05,172.31.40.0-255,66,1769,64,383974
606,3.8e-05,74.125.200.0-255,1484,3253,64,383974
607,4.1e-05,172.31.40.0-255,66,3319,64,383974
608,4.7e-05,74.125.200.0-255,2902,6221,64,383974
609,5e-05,172.31.40.0-255,66,6287,64,383974
610,5.7e-05,74.125.200.0-255,5738,12025,64,383974
611,5.9e-05,172.31.40.0-255,66,12091,64,383974
612,8.4e-05,74.125.200.0-255,6276,18367,64,383974
613,8.7e-05,172.31.40.0-255,66,18433,64,383974
614,9.4e-05,74.125.200.0-255,5738,24171,64,383974
615,9.6e-05,172.31.40.0-255,66,24237,64,383974
616,0.000111,74.125.200.0-255,1484,25721,64,383974
617,0.000113,172.31.40.0-255,66,25787,64,383974
618,0.00014,74.125.200.0-255,5379,31166,64,383974
619,0.000143,172.31.40.0-255,66,31232,64,383974
620,0.000217,74.125.200.0-255,1484,32716,64,383974
621,0.000221,172.31.40.0-255,66,32782,64,383974
622,0.000239,74.125.200.0-255,2902,35684,64,383974
623,0.000241,172.31.40.0-255,66,35750,64,383974
624,0.000258,74.125.200.0-255,5738,41488,64,383974
625,0.00026,172.31.40.0-255,66,41554,64,383974
626,0.000287,74.125.200.0-255,5738,47292,64,383974
627,0.00029,172.31.40.0-255,66,47358,64,383974
628,0.000328,74.125.200.0-255,4320,51678,64,383974
629,0.000331,172.31.40.0-255,66,51744,64,383974
630,0.000356,74.125.200.0-255,2543,54287,64,383974
631,0.000359,172.31.40.0-255,66,54353,64,383974
632,0.000364,74.125.200.0-255,4320,58673,64,383974
633,0.000366,172.31.40.0-255,66,58739,64,383974
634,0.000386,74.125.200.0-255,2902,61641,64,383974
635,0.000388,172.31.40.0-255,66,61707,64,383974
636,0.000393,74.125.200.0-255,4234,65941,64,383974
637,0.000395,172.31.40.0-255,66,66007,64,383974
638,0.000816,74.125.200.0-255,127,66134,64,383974
639,0.001041,172.31.40.0-255,66,66200,64,383974
640,0.001119,74.125.200.0-255,1484,67684,64,383974
641,0.001127,74.125.200.0-255,2902,70586,64,383974
642,0.00113,172.31.40.0-255,66,70652,64,383974
643,0.001152,74.125.200.0-255,1484,72136,64,383974
644,0.001167,74.125.200.0-255,1484,73620,64,383974
645,0.001169,172.31.40.0-255,66,73686,64,383974
646,0.001175,74.125.200.0-255,4320,78006,64,383974
647,0.001177,172.31.40.0-255,66,78072,64,383974
648,0.001187,172.31.40.0-255,66,78138,64,383974
649,0.001194,74.125.200.0-255,7156,85294,64,383974
650,0.001196,172.31.40.0-255,66,85360,64,383974
651,0.001231,74.125.200.0-255,1484,86844,64,383974
652,0.001254,74.125.200.0-255,5020,91864,64,383974
653,0.001256,172.31.40.0-255,66,91930,64,383974
654,0.001272,74.125.200.0-255,4320,96250,64,383974
655,0.001274,172.31.40.0-255,66,96316,64,383974
656,0.001291,74.125.200.0-255,2902,99218,64,383974
657,0.001293,172.31.40.0-255,66,99284,64,383974
658,0.001301,74.125.200.0-255,7156,106440,64,383974
659,0.001303,172.31.40.0-255,66,106506,64,383974
660,0.001351,74.125.200.0-255,4320,110826,64,383974
661,0.001354,172.31.40.0-255,66,110892,64,383974
662,0.001369,74.125.200.0-255,1484,112376,64,383974
663,0.001377,74.125.200.0-255,7156,119532,64,383974
664,0.001379,172.31.40.0-255,66,119598,64,383974
665,0.001426,74.125.200.0-255,6438,126036,64,383974
666,0.001429,172.31.40.0-255,66,126102,64,383974
667,0.001436,74.125.200.0-255,7156,133258,64,383974
668,0.001438,172.31.40.0-255,66,133324,64,383974
669,0.001441,74.125.200.0-255,1484,134808,64,383974
670,0.001472,74.125.200.0-255,1484,136292,64,383974
671,0.001474,172.31.40.0-255,66,136358,64,383974
672,0.001498,74.125.200.0-255,1484,137842,64,383974
673,0.001505,74.125.200.0-255,5738,143580,64,383974
674,0.001508,172.31.40.0-255,66,143646,64,383974
675,0.001515,74.125.200.0-255,7156,150802,64,383974
676,0.001517,172.31.40.0-255,66,150868,64,383974
677,0.001554,172.31.40.0-255,66,150934,64,383974
678,0.001581,74.125.200.0-255,766,151700,64,383974
679,0.001689,74.125.200.0-255,1484,153184,64,383974
680,0.001694,172.31.40.0-255,66,153250,64,383974
681,0.001711,74.125.200.0-255,1484,154734,64,383974
682,0.001726,74.125.200.0-255,1484,156218,64,383974
683,0.001728,172.31.40.0-255,66,156284,64,383974
684,0.001736,74.125.200.0-255,5738,162022,64,383974
685,0.001739,172.31.40.0-255,66,162088,64,383974
686,0.001742,74.125.200.0-255,1484,163572,64,383974
687,0.001764,74.125.200.0-255,1484,165056,64,383974
688,0.001766,172.31.40.0-255,66,165122,64,383974
689,0.001772,74.125.200.0-255,4320,169442,64,383974
690,0.001774,172.31.40.0-255,66,169508,64,383974
691,0.001777,74.125.200.0-255,1484,170992,64,383974
692,0.001797,74.125.200.0-255,7156,178148,64,383974
693,0.001801,172.31.40.0-255,66,178214,64,383974
694,0.001805,74.125.200.0-255,2902,181116,64,383974
695,0.001808,172.31.40.0-255,66,181182,64,383974
696,0.001853,74.125.200.0-255,5020,186202,64,383974
697,0.001857,172.31.40.0-255,66,186268,64,383974
698,0.001953,74.125.200.0-255,1484,187752,64,383974
699,0.00196,74.125.200.0-255,2902,190654,64,383974
700,0.001963,172.31.40.0-255,66,190720,64,383974
701,0.00197,74.125.200.0-255,5738,196458,64,383974
702,0.001973,172.31.40.0-255,66,196524,64,383974
703,0.002011,172.31.40.0-255,66,196590,64,383974
704,0.002059,74.125.200.0-255,4320,200910,64,383974
705,0.002063,172.31.40.0-255,66,200976,64,383974
706,0.002085,74.125.200.0-255,6438,207414,64,383974
707,0.002088,172.31.40.0-255,66,207480,64,383974
708,0.002126,74.125.200.0-255,5738,213218,64,383974
709,0.002129,172.31.40.0-255,66,213284,64,383974
710,0.002149,74.125.200.0-255,2902,216186,64,383974
711,0.002151,172.31.40.0-255,66,216252,64,383974
712,0.002156,74.125.200.0-255,2902,219154,64,383974
713,0.002158,172.31.40.0-255,66,219220,64,383974
714,0.002189,74.125.200.0-255,4320,223540,64,383974
715,0.002192,172.31.40.0-255,66,223606,64,383974
716,0.002227,74.125.200.0-255,2902,226508,64,383974
717,0.00223,172.31.40.0-255,66,226574,64,383974
718,0.002258,74.125.200.0-255,5738,232312,64,383974
719,0.002261,172.31.40.0-255,66,232378,64,383974
720,0.002271,172.31.40.0-255,66,232444,64,383974
721,0.002287,74.125.200.0-255,1484,233928,64,383974
722,0.00229,74.125.200.0-255,1484,235412,64,383974
723,0.002292,172.31.40.0-255,66,235478,64,383974
724,0.002311,74.125.200.0-255,1484,236962,64,383974
725,0.002314,74.125.200.0-255,1484,238446,64,383974
726,0.002315,172.31.40.0-255,66,238512,64,383974
727,0.002337,74.125.200.0-255,4320,242832,64,383974
728,0.00234,172.31.40.0-255,66,242898,64,383974
729,0.002359,74.125.200.0-255,5738,248636,64,383974
730,0.002362,172.31.40.0-255,66,248702,64,383974
731,0.002369,74.125.200.0-255,7156,255858,64,383974
732,0.002371,172.31.40.0-255,66,255924,64,383974
733,0.002402,74.125.200.0-255,4320,260244,64,383974
734,0.002423,74.125.200.0-255,6438,266682,64,383974
735,0.002469,74.125.200.0-255,1484,268166,64,383974
736,0.002473,74.125.200.0-255,1484,269650,64,383974
737,0.002483,74.125.200.0-255,1484,271134,64,383974
738,0.002525,74.125.200.0-255,1484,272618,64,383974
739,0.002541,74.125.200.0-255,2902,275520,64,383974
740,0.002547,74.125.200.0-255,5738,281258,64,383974
741,0.002559,74.125.200.0-255,4320,285578,64,383974
742,0.002571,74.125.200.0-255,2902,288480,64,383974
743,0.008101,172.31.40.0-255,66,288546,64,383974
744,0.009696,172.31.40.0-255,101,288647,64,383974
745,0.010633,74.125.200.0-255,5738,294385,64,383974
746,0.010639,172.31.40.0-255,66,294451,64,383974
747,0.012186,74.125.200.0-255,66,294517,64,383974
748,0.013187,74.125.200.0-255,5738,300255,64,383974
749,0.013193,172.31.40.0-255,66,300321,64,383974
750,0.015743,74.125.200.0-255,5738,306059,64,383974
751,0.015752,172.31.40.0-255,66,306125,64,383974
752,0.018305,74.125.200.0-255,5738,311863,64,383974
753,0.018315,172.31.40.0-255,66,311929,64,383974
754,0.020843,74.125.200.0-255,1484,313413,64,383974
755,0.02086,74.125.200.0-255,2902,316315,64,383974
756,0.020864,172.31.40.0-255,66,316381,64,383974
757,0.020879,74.125.200.0-255,1484,317865,64,383974
758,0.023397,74.125.200.0-255,4320,322185,64,383974
759,0.023405,172.31.40.0-255,66,322251,64,383974
760,0.025939,74.125.200.0-255,5738,327989,64,383974
761,0.025946,172.31.40.0-255,66,328055,64,383974
762,0.028494,74.125.200.0-255,5738,333793,64,383974
763,0.0285,172.31.40.0-255,66,333859,64,383974
764,0.031031,74.125.200.0-255,5738,339597,64,383974
765,0.031037,172.31.40.0-255,66,339663,64,383974
766,0.033414,172.31.40.0-255,172,339835,64,383974
767,0.033447,172.31.40.0-255,1112,340947,64,383974
768,0.033503,172.31.40.0-255,1514,342461,64,383974
769,0.033505,172.31.40.0-255,1296,343757,64,383974
770,0.03356,74.125.200.0-255,5738,349495,64,383974
771,0.033565,172.31.40.0-255,66,349561,64,383974
772,0.035036,104.244.42.0-255,66,349627,64,383974
773,0.035045,104.244.42.0-255,66,349693,64,383974
774,0.035136,104.244.42.0-255,66,349759,64,383974
775,0.036104,74.125.200.0-255,5738,355497,64,383974
776,0.036111,172.31.40.0-255,66,355563,64,383974
777,0.038663,74.125.200.0-255,5738,361301,64,383974
778,0.038669,172.31.40.0-255,66,361367,64,383974
779,0.041235,74.125.200.0-255,5738,367105,64,383974
780,0.041242,172.31.40.0-255,66,367171,64,383974
781,0.043758,74.125.200.0-255,1484,368655,64,383974
782,0.043781,74.125.200.0-255,4320,372975,64,383974
783,0.043786,172.31.40.0-255,66,373041,64,383974
784,0.046326,74.125.200.0-255,5738,378779,64,383974
785,0.046331,172.31.40.0-255,66,378845,64,383974
786,0.04888,74.125.200.0-255,4892,383737,64,383974
787,0.048887,172.31.40.0-255,66,383803,64,383974
788,0.049076,172.31.40.0-255,105,383908,64,383974
789,0.057331,74.125.200.0-255,66,383974,64,383974
790,0.0,172.217.194.0-255,146,146,64,210601
791,2.3e-05,172.31.40.0-255,66,212,64,210601
792,3e-05,172.217.194.0-255,1484,1696,64,210601
793,3.4e-05,172.31.40.0-255,66,1762,64,210601
794,4e-05,172.217.194.0-255,2902,4664,64,210601
795,4.3e-05,172.31.40.0-255,66,4730,64,210601
796,5.7e-05,172.217.194.0-255,7156,11886,64,210601
797,6.1e-05,172.31.40.0-255,66,11952,64,210601
798,6.5e-05,172.217.194.0-255,1993,13945,64,210601
799,6.8e-05,172.31.40.0-255,66,14011,64,210601
800,0.000135,172.217.194.0-255,1484,15495,64,210601
801,0.000139,172.31.40.0-255,66,15561,64,210601
802,0.000145,172.217.194.0-255,2902,18463,64,210601
803,0.000147,172.31.40.0-255,66,18529,64,210601
804,0.000181,172.217.194.0-255,5738,24267,64,210601
805,0.000184,172.31.40.0-255,66,24333,64,210601
806,0.000214,172.217.194.0-255,6797,31130,64,210601
807,0.000217,172.31.40.0-255,66,31196,64,210601
808,0.000304,172.217.194.0-255,1484,32680,64,210601
809,0.000308,172.31.40.0-255,66,32746,64,210601
810,0.000311,172.217.194.0-255,1484,34230,64,210601
811,0.000313,172.31.40.0-255,66,34296,64,210601
812,0.000346,172.217.194.0-255,1484,35780,64,210601
813,0.000349,172.31.40.0-255,66,35846,64,210601
814,0.000356,172.217.194.0-255,5738,41584,64,210601
815,0.000359,172.31.40.0-255,66,41650,64,210601
816,0.00037,172.217.194.0-255,6797,48447,64,210601
817,0.000373,172.31.40.0-255,66,48513,64,210601
818,0.000392,172.217.194.0-255,1484,49997,64,210601
819,0.000394,172.31.40.0-255,66,50063,64,210601
820,0.000423,172.31.40.0-255,66,50129,64,210601
821,0.000428,172.217.194.0-255,2543,52672,64,210601
822,0.000429,172.31.40.0-255,66,52738,64,210601
823,0.000432,172.217.194.0-255,645,53383,64,210601
824,0.000597,172.217.194.0-255,1484,54867,64,210601
825,0.000602,172.217.194.0-255,2902,57769,64,210601
826,0.000607,172.31.40.0-255,66,57835,64,210601
827,0.000611,172.31.40.0-255,66,57901,64,210601
828,0.000644,172.217.194.0-255,5738,63639,64,210601
829,0.000647,172.31.40.0-255,66,63705,64,210601
830,0.000661,172.31.40.0-255,66,63771,64,210601
831,0.000666,172.217.194.0-255,4320,68091,64,210601
832,0.000668,172.31.40.0-255,66,68157,64,210601
833,0.000682,172.217.194.0-255,4320,72477,64,210601
834,0.000684,172.31.40.0-255,66,72543,64,210601
835,0.000712,172.217.194.0-255,2184,74727,64,210601
836,0.000715,172.31.40.0-255,66,74793,64,210601
837,0.00115,172.217.194.0-255,1484,76277,64,210601
838,0.001157,172.217.194.0-255,2902,79179,64,210601
839,0.00116,172.31.40.0-255,66,79245,64,210601
840,0.001167,172.217.194.0-255,4320,83565,64,210601
841,0.001169,172.31.40.0-255,66,83631,64,210601
842,0.001188,172.217.194.0-255,1484,85115,64,210601
843,0.001207,172.31.40.0-255,66,85181,64,210601
844,0.001234,172.217.194.0-255,4320,89501,64,210601
845,0.001237,172.31.40.0-255,66,89567,64,210601
846,0.001271,172.217.194.0-255,6438,96005,64,210601
847,0.001274,172.31.40.0-255,66,96071,64,210601
848,0.001385,172.217.194.0-255,1484,97555,64,210601
849,0.001388,172.217.194.0-255,1484,99039,64,210601
850,0.001395,172.31.40.0-255,66,99105,64,210601
851,0.001404,172.217.194.0-255,1484,100589,64,210601
852,0.001414,172.217.194.0-255,4320,104909,64,210601
853,0.001416,172.31.40.0-255,66,104975,64,210601
854,0.001444,172.217.194.0-255,1484,106459,64,210601
855,0.001449,172.217.194.0-255,4320,110779,64,210601
856,0.001452,172.31.40.0-255,66,110845,64,210601
857,0.001469,172.31.40.0-255,66,110911,64,210601
858,0.001503,172.31.40.0-255,66,110977,64,210601
859,0.001529,172.217.194.0-255,1484,112461,64,210601
860,0.001534,172.217.194.0-255,2902,115363,64,210601
861,0.001536,172.31.40.0-255,66,115429,64,210601
862,0.001573,172.217.194.0-255,5738,121167,64,210601
863,0.001576,172.31.40.0-255,66,121233,64,210601
864,0.001583,172.217.194.0-255,7156,128389,64,210601
865,0.001586,172.31.40.0-255,66,128455,64,210601
866,0.001609,172.217.194.0-255,5738,134193,64,210601
867,0.001612,172.31.40.0-255,66,134259,64,210601
868,0.001615,172.217.194.0-255,1484,135743,64,210601
869,0.001648,172.31.40.0-255,66,135809,64,210601
870,0.001702,172.217.194.0-255,1484,137293,64,210601
871,0.00172,172.217.194.0-255,2902,140195,64,210601
872,0.001723,172.31.40.0-255,66,140261,64,210601
873,0.001758,172.217.194.0-255,5738,145999,64,210601
874,0.001762,172.31.40.0-255,66,146065,64,210601
875,0.001767,172.217.194.0-255,4320,150385,64,210601
876,0.00177,172.31.40.0-255,66,150451,64,210601
877,0.001787,172.31.40.0-255,66,150517,64,210601
878,0.001824,172.217.194.0-255,4320,154837,64,210601
879,0.001826,172.31.40.0-255,66,154903,64,210601
880,0.001859,172.217.194.0-255,3602,158505,64,210601
881,0.001861,172.31.40.0-255,66,158571,64,210601
882,0.001865,172.217.194.0-255,1484,160055,64,210601
883,0.001869,172.217.194.0-255,2902,162957,64,210601
884,0.001871,172.31.40.0-255,66,163023,64,210601
885,0.001877,172.217.194.0-255,5738,168761,64,210601
886,0.001879,172.31.40.0-255,66,168827,64,210601
887,0.001929,172.31.40.0-255,66,168893,64,210601
888,0.001941,172.31.40.0-255,66,168959,64,210601
889,0.001966,172.217.194.0-255,5020,173979,64,210601
890,0.001969,172.31.40.0-255,66,174045,64,210601
891,0.00198,172.217.194.0-255,5738,179783,64,210601
892,0.001982,172.31.40.0-255,66,179849,64,210601
893,0.002003,172.217.194.0-255,5738,185587,64,210601
894,0.002006,172.31.40.0-255,66,185653,64,210601
895,0.002019,172.217.194.0-255,7156,192809,64,210601
896,0.002021,172.31.40.0-255,66,192875,64,210601
897,0.002095,172.31.40.0-255,66,192941,64,210601
898,0.002134,172.217.194.0-255,7156,200097,64,210601
899,0.002141,172.31.40.0-255,66,200163,64,210601
900,0.00224,172.217.194.0-255,2902,203065,64,210601
901,0.002372,172.217.194.0-255,2902,205967,64,210601
902,0.002433,172.217.194.0-255,105,206072,64,210601
903,0.010514,172.31.40.0-255,66,206138,64,210601
904,0.012967,172.31.40.0-255,105,206243,64,210601
905,0.015593,172.217.194.0-255,66,206309,64,210601
906,0.036529,172.31.40.0-255,172,206481,64,210601
907,0.03656,172.31.40.0-255,1112,207593,64,210601
908,0.036623,172.31.40.0-255,1514,209107,64,210601
909,0.036625,172.31.40.0-255,1296,210403,64,210601
910,0.038088,104.244.42.0-255,66,210469,64,210601
911,0.03813,104.244.42.0-255,66,210535,64,210601
912,0.038234,104.244.42.0-255,66,210601,64,210601
913,0.0,74.125.200.0-255,143,143,64,382837
914,2.2e-05,172.31.40.0-255,66,209,64,382837
915,2.9e-05,74.125.200.0-255,1484,1693,64,382837
916,3.4e-05,172.31.40.0-255,66,1759,64,382837
917,4e-05,74.125.200.0-255,2902,4661,64,382837
918,4.3e-05,172.31.40.0-255,66,4727,64,382837
919,5.1e-05,74.125.200.0-255,7156,11883,64,382837
920,5.6e-05,172.31.40.0-255,66,11949,64,382837
921,0.000118,74.125.200.0-255,2029,13978,64,382837
922,0.000123,172.31.40.0-255,66,14044,64,382837
923,0.000127,74.125.200.0-255,2902,16946,64,382837
924,0.00013,172.31.40.0-255,66,17012,64,382837
925,0.000137,74.125.200.0-255,7156,24168,64,382837
926,0.000139,172.31.40.0-255,66,24234,64,382837
927,0.000147,74.125.200.0-255,6797,31031,64,382837
928,0.00015,172.31.40.0-255,66,31097,64,382837
929,0.000197,74.125.200.0-255,1484,32581,64,382837
930,0.000199,172.31.40.0-255,66,32647,64,382837
931,0.000215,74.125.200.0-255,2902,35549,64,382837
932,0.000217,74.125.200.0-255,1484,37033,64,382837
933,0.00022,172.31.40.0-255,66,37099,64,382837
934,0.000227,172.31.40.0-255,66,37165,64,382837
935,0.000233,74.125.200.0-255,2902,40067,64,382837
936,0.000236,172.31.40.0-255,66,40133,64,382837
937,0.000276,172.31.40.0-255,66,40199,64,382837
938,0.00028,74.125.200.0-255,2902,43101,64,382837
939,0.000282,172.31.40.0-255,66,43167,64,382837
940,0.000306,74.125.200.0-255,1484,44651,64,382837
941,0.000309,172.31.40.0-255,66,44717,64,382837
942,0.000335,172.31.40.0-255,66,44783,64,382837
943,0.000337,74.125.200.0-255,766,45549,64,382837
944,0.000362,74.125.200.0-255,402,45951,64,382837
945,0.000389,74.125.200.0-255,111,46062,64,382837
946,0.000456,74.125.200.0-255,1484,47546,64,382837
947,0.00046,172.31.40.0-255,66,47612,64,382837
948,0.000465,74.125.200.0-255,2902,50514,64,382837
949,0.000468,172.31.40.0-255,66,50580,64,382837
950,0.000493,74.125.200.0-255,4320,54900,64,382837
951,0.000495,172.31.40.0-255,66,54966,64,382837
952,0.000515,74.125.200.0-255,2902,57868,64,382837
953,0.000517,172.31.40.0-255,66,57934,64,382837
954,0.000543,74.125.200.0-255,5738,63672,64,382837
955,0.000546,172.31.40.0-255,66,63738,64,382837
956,0.000551,74.125.200.0-255,2902,66640,64,382837
957,0.000553,172.31.40.0-255,66,66706,64,382837
958,0.000565,172.31.40.0-255,66,66772,64,382837
959,0.000588,74.125.200.0-255,4320,71092,64,382837
960,0.00059,172.31.40.0-255,66,71158,64,382837
961,0.000593,74.125.200.0-255,766,71924,64,382837
962,0.000638,74.125.200.0-255,329,72253,64,382837
963,0.000792,74.125.200.0-255,1484,73737,64,382837
964,0.000797,172.31.40.0-255,66,73803,64,382837
965,0.000803,74.125.200.0-255,2902,76705,64,382837
966,0.000806,172.31.40.0-255,66,76771,64,382837
967,0.000812,74.125.200.0-255,5738,82509,64,382837
968,0.000815,172.31.40.0-255,66,82575,64,382837
969,0.000839,74.125.200.0-255,1484,84059,64,382837
970,0.00086,74.125.200.0-255,4320,88379,64,382837
971,0.000863,172.31.40.0-255,66,88445,64,382837
972,0.000868,74.125.200.0-255,4320,92765,64,382837
973,0.00087,172.31.40.0-255,66,92831,64,382837
974,0.000887,74.125.200.0-255,2902,95733,64,382837
975,0.000889,172.31.40.0-255,66,95799,64,382837
976,0.000893,74.125.200.0-255,2902,98701,64,382837
977,0.000895,172.31.40.0-255,66,98767,64,382837
978,0.0009,74.125.200.0-255,4320,103087,64,382837
979,0.000902,172.31.40.0-255,66,103153,64,382837
980,0.000935,74.125.200.0-255,3602,106755,64,382837
981,0.000938,172.31.40.0-255,66,106821,64,382837
982,0.000985,74.125.200.0-255,1484,108305,64,382837
983,0.00099,74.125.200.0-255,2902,111207,64,382837
984,0.000993,172.31.40.0-255,66,111273,64,382837
985,0.00101,74.125.200.0-255,2902,114175,64,382837
986,0.001013,172.31.40.0-255,66,114241,64,382837
987,0.001021,74.125.200.0-255,2902,117143,64,382837
988,0.001023,172.31.40.0-255,66,117209,64,382837
989,0.001025,74.125.200.0-255,1484,118693,64,382837
990,0.001056,74.125.200.0-255,2902,121595,64,382837
991,0.001059,172.31.40.0-255,66,121661,64,382837
992,0.00108,74.125.200.0-255,5738,127399,64,382837
993,0.001082,172.31.40.0-255,66,127465,64,382837
994,0.001084,74.125.200.0-255,1484,128949,64,382837
995,0.001096,74.125.200.0-255,1484,130433,64,382837
996,0.001099,172.31.40.0-255,66,130499,64,382837
997,0.001113,74.125.200.0-255,7156,137655,64,382837
998,0.001116,172.31.40.0-255,66,137721,64,382837
999,0.00114,74.125.200.0-255,3602,141323,64,382837
1000,0.001142,172.31.40.0-255,66,141389,64,382837
1001,0.001204,74.125.200.0-255,1484,142873,64,382837
1002,0.001216,74.125.200.0-255,2902,145775,64,382837
1003,0.001223,172.31.40.0-255,66,145841,64,382837
1004,0.001227,74.125.200.0-255,2902,148743,64,382837
1005,0.001229,172.31.40.0-255,66,148809,64,382837
1006,0.001241,74.125.200.0-255,1484,150293,64,382837
1007,0.001247,74.125.200.0-255,2902,153195,64,382837
1008,0.001249,172.31.40.0-255,66,153261,64,382837
1009,0.001269,74.125.200.0-255,2902,156163,64,382837
1010,0.001271,172.31.40.0-255,66,156229,64,382837
1011,0.001286,74.125.200.0-255,2902,159131,64,382837
1012,0.001288,172.31.40.0-255,66,159197,64,382837
1013,0.001312,74.125.200.0-255,4320,163517,64,382837
1014,0.001315,172.31.40.0-255,66,163583,64,382837
1015,0.001322,74.125.200.0-255,7156,170739,64,382837
1016,0.001324,172.31.40.0-255,66,170805,64,382837
1017,0.001341,74.125.200.0-255,1484,172289,64,382837
1018,0.001344,74.125.200.0-255,2902,175191,64,382837
1019,0.001346,172.31.40.0-255,66,175257,64,382837
1020,0.001371,74.125.200.0-255,766,176023,64,382837
1021,0.001545,74.125.200.0-255,1484,177507,64,382837
1022,0.001549,172.31.40.0-255,66,177573,64,382837
1023,0.001569,74.125.200.0-255,2902,180475,64,382837
1024,0.001571,172.31.40.0-255,66,180541,64,382837
1025,0.001593,74.125.200.0-255,4320,184861,64,382837
1026,0.001595,172.31.40.0-255,66,184927,64,382837
1027,0.001617,74.125.200.0-255,5738,190665,64,382837
1028,0.00162,172.31.40.0-255,66,190731,64,382837
1029,0.001639,74.125.200.0-255,2902,193633,64,382837
1030,0.001641,172.31.40.0-255,66,193699,64,382837
1031,0.001694,74.125.200.0-255,4320,198019,64,382837
1032,0.001697,172.31.40.0-255,66,198085,64,382837
1033,0.001701,74.125.200.0-255,4320,202405,64,382837
1034,0.001703,172.31.40.0-255,66,202471,64,382837
1035,0.001708,74.125.200.0-255,5738,208209,64,382837
1036,0.00171,172.31.40.0-255,66,208275,64,382837
1037,0.001731,74.125.200.0-255,2184,210459,64,382837
1038,0.001734,172.31.40.0-255,66,210525,64,382837
1039,0.001888,74.125.200.0-255,1484,212009,64,382837
1040,0.001893,74.125.200.0-255,2902,214911,64,382837
1041,0.001896,172.31.40.0-255,66,214977,64,382837
1042,0.001921,74.125.200.0-255,5738,220715,64,382837
1043,0.001923,172.31.40.0-255,66,220781,64,382837
1044,0.001957,172.31.40.0-255,66,220847,64,382837
1045,0.001963,74.125.200.0-255,5738,226585,64,382837
1046,0.001965,172.31.40.0-255,66,226651,64,382837
1047,0.001984,74.125.200.0-255,5738,232389,64,382837
1048,0.001986,172.31.40.0-255,66,232455,64,382837
1049,0.001988,74.125.200.0-255,1484,233939,64,382837
1050,0.003935,74.125.200.0-255,4320,238259,64,382837
1051,0.003941,172.31.40.0-255,66,238325,64,382837
1052,0.005894,74.125.200.0-255,5738,244063,64,382837
1053,0.005898,172.31.40.0-255,66,244129,64,382837
1054,0.00785,74.125.200.0-255,5738,249867,64,382837
1055,0.007856,172.31.40.0-255,66,249933,64,382837
1056,0.009834,74.125.200.0-255,5738,255671,64,382837
1057,0.009848,172.31.40.0-255,66,255737,64,382837
1058,0.011823,74.125.200.0-255,5738,261475,64,382837
1059,0.011835,172.31.40.0-255,66,261541,64,382837
1060,0.013799,74.125.200.0-255,5738,267279,64,382837
1061,0.013812,172.31.40.0-255,66,267345,64,382837
1062,0.015784,74.125.200.0-255,5738,273083,64,382837
1063,0.015796,172.31.40.0-255,66,273149,64,382837
1064,0.017773,74.125.200.0-255,5738,278887,64,382837
1065,0.017787,172.31.40.0-255,66,278953,64,382837
1066,0.019768,74.125.200.0-255,5738,284691,64,382837
1067,0.019782,172.31.40.0-255,66,284757,64,382837
1068,0.02176,74.125.200.0-255,5738,290495,64,382837
1069,0.021768,172.31.40.0-255,66,290561,64,382837
1070,0.023736,74.125.200.0-255,5738,296299,64,382837
1071,0.023743,172.31.40.0-255,66,296365,64,382837
1072,0.025697,74.125.200.0-255,5738,302103,64,382837
1073,0.025705,172.31.40.0-255,66,302169,64,382837
1074,0.027666,74.125.200.0-255,5738,307907,64,382837
1075,0.027675,172.31.40.0-255,66,307973,64,382837
1076,0.029641,74.125.200.0-255,5738,313711,64,382837
1077,0.029649,172.31.40.0-255,66,313777,64,382837
1078,0.031618,74.125.200.0-255,5738,319515,64,382837
1079,0.031625,172.31.40.0-255,66,319581,64,382837
1080,0.033584,74.125.200.0-255,5738,325319,64,382837
1081,0.033591,172.31.40.0-255,66,325385,64,382837
1082,0.035553,74.125.200.0-255,5738,331123,64,382837
1083,0.035559,172.31.40.0-255,66,331189,64,382837
1084,0.037518,74.125.200.0-255,5738,336927,64,382837
1085,0.037526,172.31.40.0-255,66,336993,64,382837
1086,0.03949,74.125.200.0-255,5738,342731,64,382837
1087,0.039497,172.31.40.0-255,66,342797,64,382837
1088,0.041458,74.125.200.0-255,5738,348535,64,382837
1089,0.041467,172.31.40.0-255,66,348601,64,382837
1090,0.043428,74.125.200.0-255,5738,354339,64,382837
1091,0.043435,172.31.40.0-255,66,354405,64,382837
1092,0.043545,172.31.40.0-255,101,354506,64,382837
1093,0.045399,74.125.200.0-255,5738,360244,64,382837
1094,0.045406,172.31.40.0-255,66,360310,64,382837
1095,0.045453,74.125.200.0-255,66,360376,64,382837
1096,0.047365,74.125.200.0-255,5738,366114,64,382837
1097,0.047373,172.31.40.0-255,66,366180,64,382837
1098,0.049397,74.125.200.0-255,5738,371918,64,382837
1099,0.049408,172.31.40.0-255,66,371984,64,382837
1100,0.051362,74.125.200.0-255,5738,377722,64,382837
1101,0.051369,172.31.40.0-255,66,377788,64,382837
1102,0.053313,74.125.200.0-255,650,378438,64,382837
1103,0.054838,172.31.40.0-255,105,378543,64,382837
1104,0.055209,172.31.40.0-255,172,378715,64,382837
1105,0.055242,172.31.40.0-255,1112,379827,64,382837
1106,0.055304,172.31.40.0-255,1514,381341,64,382837
1107,0.055305,172.31.40.0-255,1298,382639,64,382837
1108,0.056735,104.244.42.0-255,66,382705,64,382837
1109,0.056772,104.244.42.0-255,66,382771,64,382837
1110,0.056864,104.244.42.0-255,66,382837,64,382837
1111,0.0,172.217.194.0-255,146,146,64,303227
1112,2.5e-05,172.31.40.0-255,66,212,64,303227
1113,3.2e-05,172.217.194.0-255,1484,1696,64,303227
1114,3.7e-05,172.31.40.0-255,66,1762,64,303227
1115,5e-05,172.217.194.0-255,2902,4664,64,303227
1116,5.2e-05,172.31.40.0-255,66,4730,64,303227
1117,6.1e-05,172.217.194.0-255,7156,11886,64,303227
1118,6.4e-05,172.31.40.0-255,66,11952,64,303227
1119,6.8e-05,172.217.194.0-255,1950,13902,64,303227
1120,7e-05,172.31.40.0-255,66,13968,64,303227
1121,0.000101,172.31.40.0-255,66,14034,64,303227
1122,0.000104,172.217.194.0-255,1484,15518,64,303227
1123,0.000106,172.31.40.0-255,66,15584,64,303227
1124,0.00014,172.217.194.0-255,3961,19545,64,303227
1125,0.000144,172.31.40.0-255,66,19611,64,303227
1126,0.000301,172.217.194.0-255,1484,21095,64,303227
1127,0.000305,172.31.40.0-255,66,21161,64,303227
1128,0.000311,172.217.194.0-255,2902,24063,64,303227
1129,0.000314,172.31.40.0-255,66,24129,64,303227
1130,0.000337,172.217.194.0-255,5738,29867,64,303227
1131,0.00034,172.31.40.0-255,66,29933,64,303227
1132,0.000377,172.31.40.0-255,66,29999,64,303227
1133,0.000383,172.217.194.0-255,4320,34319,64,303227
1134,0.000385,172.31.40.0-255,66,34385,64,303227
1135,0.000413,172.217.194.0-255,4320,38705,64,303227
1136,0.000416,172.31.40.0-255,66,38771,64,303227
1137,0.000428,172.217.194.0-255,6797,45568,64,303227
1138,0.000431,172.31.40.0-255,66,45634,64,303227
1139,0.000433,172.217.194.0-255,383,46017,64,303227
1140,0.000435,172.31.40.0-255,66,46083,64,303227
1141,0.000521,172.217.194.0-255,1484,47567,64,303227
1142,0.000525,172.31.40.0-255,66,47633,64,303227
1143,0.000544,172.217.194.0-255,2902,50535,64,303227
1144,0.000547,172.31.40.0-255,66,50601,64,303227
1145,0.000554,172.217.194.0-255,5738,56339,64,303227
1146,0.000556,172.31.40.0-255,66,56405,64,303227
1147,0.000581,172.217.194.0-255,4320,60725,64,303227
1148,0.000587,172.31.40.0-255,66,60791,64,303227
1149,0.000613,172.217.194.0-255,2257,63048,64,303227
1150,0.000615,172.31.40.0-255,66,63114,64,303227
1151,0.000712,172.217.194.0-255,1484,64598,64,303227
1152,0.000715,172.31.40.0-255,66,64664,64,303227
1153,0.00072,172.217.194.0-255,2902,67566,64,303227
1154,0.000723,172.31.40.0-255,66,67632,64,303227
1155,0.000755,172.217.194.0-255,2902,70534,64,303227
1156,0.000758,172.31.40.0-255,66,70600,64,303227
1157,0.000766,172.217.194.0-255,7156,77756,64,303227
1158,0.000768,172.31.40.0-255,66,77822,64,303227
1159,0.000814,172.31.40.0-255,66,77888,64,303227
1160,0.000846,172.217.194.0-255,3602,81490,64,303227
1161,0.000849,172.31.40.0-255,66,81556,64,303227
1162,0.00089,172.217.194.0-255,1484,83040,64,303227
1163,0.00091,172.217.194.0-255,2902,85942,64,303227
1164,0.000917,172.217.194.0-255,4320,90262,64,303227
1165,0.000929,172.217.194.0-255,1484,91746,64,303227
1166,0.000944,172.217.194.0-255,5738,97484,64,303227
1167,0.000949,172.31.40.0-255,66,97550,64,303227
1168,0.000976,172.217.194.0-255,4320,101870,64,303227
1169,0.000981,172.217.194.0-255,2902,104772,64,303227
1170,0.000991,172.31.40.0-255,66,104838,64,303227
1171,0.001036,172.31.40.0-255,66,104904,64,303227
1172,0.001269,172.217.194.0-255,1484,106388,64,303227
1173,0.001275,172.217.194.0-255,2902,109290,64,303227
1174,0.001279,172.31.40.0-255,66,109356,64,303227
1175,0.001344,172.217.194.0-255,5738,115094,64,303227
1176,0.001362,172.217.194.0-255,5738,120832,64,303227
1177,0.001396,172.217.194.0-255,5020,125852,64,303227
1178,0.001433,172.217.194.0-255,5738,131590,64,303227
1179,0.001448,172.217.194.0-255,2902,134492,64,303227
1180,0.001467,172.217.194.0-255,4320,138812,64,303227
1181,0.001522,172.217.194.0-255,5738,144550,64,303227
1182,0.001529,172.217.194.0-255,5738,150288,64,303227
1183,0.001555,172.217.194.0-255,2902,153190,64,303227
1184,0.001586,172.217.194.0-255,4320,157510,64,303227
1185,0.001625,172.217.194.0-255,3602,161112,64,303227
1186,0.001684,172.217.194.0-255,1484,162596,64,303227
1187,0.001705,172.217.194.0-255,2902,165498,64,303227
1188,0.001709,172.217.194.0-255,1484,166982,64,303227
1189,0.001728,172.217.194.0-255,4320,171302,64,303227
1190,0.001745,172.217.194.0-255,4320,175622,64,303227
1191,0.001769,172.217.194.0-255,7156,182778,64,303227
1192,0.001811,172.217.194.0-255,3602,186380,64,303227
1193,0.00193,172.217.194.0-255,1484,187864,64,303227
1194,0.001935,172.217.194.0-255,1484,189348,64,303227
1195,0.001947,172.217.194.0-255,1484,190832,64,303227
1196,0.001949,172.217.194.0-255,1484,192316,64,303227
1197,0.001965,172.217.194.0-255,4320,196636,64,303227
1198,0.001981,172.217.194.0-255,2902,199538,64,303227
1199,0.002,172.217.194.0-255,7156,206694,64,303227
1200,0.002046,172.217.194.0-255,3602,210296,64,303227
1201,0.005415,172.31.40.0-255,66,210362,64,303227
1202,0.007501,172.217.194.0-255,5738,216100,64,303227
1203,0.007512,172.31.40.0-255,66,216166,64,303227
1204,0.009582,172.217.194.0-255,5738,221904,64,303227
1205,0.009596,172.31.40.0-255,66,221970,64,303227
1206,0.011709,172.217.194.0-255,4320,226290,64,303227
1207,0.011724,172.31.40.0-255,66,226356,64,303227
1208,0.011755,172.217.194.0-255,1484,227840,64,303227
1209,0.013788,172.217.194.0-255,4320,232160,64,303227
1210,0.013795,172.31.40.0-255,66,232226,64,303227
1211,0.015895,172.217.194.0-255,5738,237964,64,303227
1212,0.015913,172.31.40.0-255,66,238030,64,303227
1213,0.017964,172.217.194.0-255,5738,243768,64,303227
1214,0.017979,172.31.40.0-255,66,243834,64,303227
1215,0.020002,172.217.194.0-255,5738,249572,64,303227
1216,0.02001,172.31.40.0-255,66,249638,64,303227
1217,0.022083,172.217.194.0-255,5738,255376,64,303227
1218,0.022091,172.31.40.0-255,66,255442,64,303227
1219,0.024112,172.217.194.0-255,5738,261180,64,303227
1220,0.024119,172.31.40.0-255,66,261246,64,303227
1221,0.026174,172.217.194.0-255,5738,266984,64,303227
1222,0.026182,172.31.40.0-255,66,267050,64,303227
1223,0.028217,172.217.194.0-255,5738,272788,64,303227
1224,0.028233,172.31.40.0-255,66,272854,64,303227
1225,0.030262,172.217.194.0-255,5738,278592,64,303227
1226,0.030281,172.31.40.0-255,66,278658,64,303227
1227,0.032374,172.217.194.0-255,5738,284396,64,303227
1228,0.032388,172.31.40.0-255,66,284462,64,303227
1229,0.034465,172.217.194.0-255,5738,290200,64,303227
1230,0.034474,172.31.40.0-255,66,290266,64,303227
1231,0.036534,172.217.194.0-255,5738,296004,64,303227
1232,0.036549,172.31.40.0-255,66,296070,64,303227
1233,0.03862,172.217.194.0-255,5738,301808,64,303227
1234,0.038626,172.31.40.0-255,66,301874,64,303227
1235,0.04068,172.217.194.0-255,1116,302990,64,303227
1236,0.040793,172.31.40.0-255,66,303056,64,303227
1237,0.040833,172.31.40.0-255,105,303161,64,303227
1238,0.042841,172.217.194.0-255,66,303227,64,303227
1239,0.0,74.125.24.0-255,146,146,64,150721
1240,1.3e-05,172.31.40.0-255,66,212,64,150721
1241,1.9e-05,74.125.24.0-255,1484,1696,64,150721
1242,2.4e-05,172.31.40.0-255,66,1762,64,150721
1243,3.1e-05,74.125.24.0-255,2902,4664,64,150721
1244,3.4e-05,172.31.40.0-255,66,4730,64,150721
1245,4.2e-05,74.125.24.0-255,7156,11886,64,150721
1246,4.6e-05,172.31.40.0-255,66,11952,64,150721
1247,5.1e-05,74.125.24.0-255,2033,13985,64,150721
1248,5.5e-05,172.31.40.0-255,66,14051,64,150721
1249,8.7e-05,172.31.40.0-255,66,14117,64,150721
1250,0.000135,74.125.24.0-255,5379,19496,64,150721
1251,0.000137,172.31.40.0-255,66,19562,64,150721
1252,0.000154,74.125.24.0-255,1484,21046,64,150721
1253,0.000156,172.31.40.0-255,66,21112,64,150721
1254,0.000161,74.125.24.0-255,2902,24014,64,150721
1255,0.000163,172.31.40.0-255,66,24080,64,150721
1256,0.000188,74.125.24.0-255,5738,29818,64,150721
1257,0.00019,172.31.40.0-255,66,29884,64,150721
1258,0.000196,74.125.24.0-255,5738,35622,64,150721
1259,0.000199,172.31.40.0-255,66,35688,64,150721
1260,0.000217,74.125.24.0-255,7156,42844,64,150721
1261,0.00022,172.31.40.0-255,66,42910,64,150721
1262,0.000231,172.31.40.0-255,66,42976,64,150721
1263,0.000255,74.125.24.0-255,2484,45460,64,150721
1264,0.000257,172.31.40.0-255,66,45526,64,150721
1265,0.000285,74.125.24.0-255,127,45653,64,150721
1266,0.000287,172.31.40.0-255,66,45719,64,150721
1267,0.000471,74.125.24.0-255,1484,47203,64,150721
1268,0.000476,172.31.40.0-255,66,47269,64,150721
1269,0.000483,74.125.24.0-255,2902,50171,64,150721
1270,0.000485,172.31.40.0-255,66,50237,64,150721
1271,0.000511,74.125.24.0-255,5738,55975,64,150721
1272,0.000513,172.31.40.0-255,66,56041,64,150721
1273,0.000536,172.31.40.0-255,66,56107,64,150721
1274,0.000554,74.125.24.0-255,1484,57591,64,150721
1275,0.00056,74.125.24.0-255,4320,61911,64,150721
1276,0.000563,172.31.40.0-255,66,61977,64,150721
1277,0.000613,172.31.40.0-255,66,62043,64,150721
1278,0.000625,172.31.40.0-255,66,62109,64,150721
1279,0.000669,172.31.40.0-255,66,62175,64,150721
1280,0.000716,74.125.24.0-255,1484,63659,64,150721
1281,0.00072,74.125.24.0-255,1484,65143,64,150721
1282,0.000723,172.31.40.0-255,66,65209,64,150721
1283,0.000743,74.125.24.0-255,1484,66693,64,150721
1284,0.00075,74.125.24.0-255,5738,72431,64,150721
1285,0.000753,172.31.40.0-255,66,72497,64,150721
1286,0.000758,74.125.24.0-255,4320,76817,64,150721
1287,0.00076,172.31.40.0-255,66,76883,64,150721
1288,0.000798,172.31.40.0-255,66,76949,64,150721
1289,0.00081,172.31.40.0-255,66,77015,64,150721
1290,0.000891,74.125.24.0-255,1484,78499,64,150721
1291,0.000896,74.125.24.0-255,2902,81401,64,150721
1292,0.000899,172.31.40.0-255,66,81467,64,150721
1293,0.000904,74.125.24.0-255,2902,84369,64,150721
1294,0.000906,172.31.40.0-255,66,84435,64,150721
1295,0.000922,74.125.24.0-255,2902,87337,64,150721
1296,0.000925,172.31.40.0-255,66,87403,64,150721
1297,0.000938,172.31.40.0-255,66,87469,64,150721
1298,0.000951,74.125.24.0-255,1484,88953,64,150721
1299,0.000956,74.125.24.0-255,4320,93273,64,150721
1300,0.000959,172.31.40.0-255,66,93339,64,150721
1301,0.000979,172.31.40.0-255,66,93405,64,150721
1302,0.00102,74.125.24.0-255,7156,100561,64,150721
1303,0.001023,172.31.40.0-255,66,100627,64,150721
1304,0.001052,172.31.40.0-255,66,100693,64,150721
1305,0.001065,172.31.40.0-255,66,100759,64,150721
1306,0.001096,74.125.24.0-255,4320,105079,64,150721
1307,0.001099,172.31.40.0-255,66,105145,64,150721
1308,0.001105,74.125.24.0-255,5738,110883,64,150721
1309,0.001108,172.31.40.0-255,66,110949,64,150721
1310,0.001127,172.31.40.0-255,66,111015,64,150721
1311,0.001136,74.125.24.0-255,1484,112499,64,150721
1312,0.00117,172.31.40.0-255,66,112565,64,150721
1313,0.001185,74.125.24.0-255,4320,116885,64,150721
1314,0.001199,172.31.40.0-255,66,116951,64,150721
1315,0.00124,74.125.24.0-255,2902,119853,64,150721
1316,0.001244,172.31.40.0-255,66,119919,64,150721
1317,0.001261,74.125.24.0-255,5738,125657,64,150721
1318,0.001276,172.31.40.0-255,66,125723,64,150721
1319,0.001304,74.125.24.0-255,5020,130743,64,150721
1320,0.00131,172.31.40.0-255,66,130809,64,150721
1321,0.001324,74.125.24.0-255,5738,136547,64,150721
1322,0.001359,74.125.24.0-255,5738,142285,64,150721
1323,0.001372,74.125.24.0-255,2184,144469,64,150721
1324,0.001378,172.31.40.0-255,66,144535,64,150721
1325,0.001396,74.125.24.0-255,1484,146019,64,150721
1326,0.001422,172.31.40.0-255,66,146085,64,150721
1327,0.001472,74.125.24.0-255,105,146190,64,150721
1328,0.001531,172.31.40.0-255,66,146256,64,150721
1329,0.009355,172.31.40.0-255,105,146361,64,150721
1330,0.011607,74.125.24.0-255,66,146427,64,150721
1331,0.032039,172.31.40.0-255,172,146599,64,150721
1332,0.032073,172.31.40.0-255,1111,147710,64,150721
1333,0.032138,172.31.40.0-255,1514,149224,64,150721
1334,0.03214,172.31.40.0-255,1299,150523,64,150721
1335,0.033551,104.244.42.0-255,66,150589,64,150721
1336,0.033582,104.244.42.0-255,66,150655,64,150721
1337,0.033685,104.244.42.0-255,66,150721,64,150721
1338,0.0,74.125.24.0-255,158,158,64,227028
1339,1.6e-05,172.31.40.0-255,66,224,64,227028
1340,2.2e-05,74.125.24.0-255,1484,1708,64,227028
1341,2.7e-05,172.31.40.0-255,66,1774,64,227028
1342,3.2e-05,74.125.24.0-255,2902,4676,64,227028
1343,4.1e-05,172.31.40.0-255,66,4742,64,227028
1344,5e-05,74.125.24.0-255,7156,11898,64,227028
1345,5.4e-05,172.31.40.0-255,66,11964,64,227028
1346,6e-05,74.125.24.0-255,3354,15318,64,227028
1347,6.2e-05,172.31.40.0-255,66,15384,64,227028
1348,7.5e-05,172.31.40.0-255,66,15450,64,227028
1349,9.2e-05,74.125.24.0-255,2902,18352,64,227028
1350,0.0001,172.31.40.0-255,66,18418,64,227028
1351,0.000104,74.125.24.0-255,2543,20961,64,227028
1352,0.000107,172.31.40.0-255,66,21027,64,227028
1353,0.000134,74.125.24.0-255,2902,23929,64,227028
1354,0.000137,172.31.40.0-255,66,23995,64,227028
1355,0.000144,74.125.24.0-255,5738,29733,64,227028
1356,0.000146,172.31.40.0-255,66,29799,64,227028
1357,0.000186,74.125.24.0-255,1484,31283,64,227028
1358,0.000188,172.31.40.0-255,66,31349,64,227028
1359,0.000201,172.31.40.0-255,66,31415,64,227028
1360,0.000218,172.31.40.0-255,66,31481,64,227028
1361,0.000221,74.125.24.0-255,129,31610,64,227028
1362,0.000223,172.31.40.0-255,66,31676,64,227028
1363,0.000443,74.125.24.0-255,1484,33160,64,227028
1364,0.000448,172.31.40.0-255,66,33226,64,227028
1365,0.000455,74.125.24.0-255,2902,36128,64,227028
1366,0.000458,172.31.40.0-255,66,36194,64,227028
1367,0.00047,74.125.24.0-255,5738,41932,64,227028
1368,0.000473,172.31.40.0-255,66,41998,64,227028
1369,0.000527,172.31.40.0-255,66,42064,64,227028
1370,0.000566,172.31.40.0-255,66,42130,64,227028
1371,0.000569,74.125.24.0-255,346,42476,64,227028
1372,0.001182,74.125.24.0-255,1484,43960,64,227028
1373,0.001187,172.31.40.0-255,66,44026,64,227028
1374,0.001192,74.125.24.0-255,2902,46928,64,227028
1375,0.001194,172.31.40.0-255,66,46994,64,227028
1376,0.001199,74.125.24.0-255,2902,49896,64,227028
1377,0.001201,172.31.40.0-255,66,49962,64,227028
1378,0.00124,74.125.24.0-255,2902,52864,64,227028
1379,0.001243,172.31.40.0-255,66,52930,64,227028
1380,0.001255,172.31.40.0-255,66,52996,64,227028
1381,0.001274,172.31.40.0-255,66,53062,64,227028
1382,0.001305,74.125.24.0-255,2184,55246,64,227028
1383,0.001308,172.31.40.0-255,66,55312,64,227028
1384,0.001649,74.125.24.0-255,1484,56796,64,227028
1385,0.001672,74.125.24.0-255,2902,59698,64,227028
1386,0.001676,172.31.40.0-255,66,59764,64,227028
1387,0.00168,74.125.24.0-255,1484,61248,64,227028
1388,0.001715,74.125.24.0-255,4320,65568,64,227028
1389,0.001717,172.31.40.0-255,66,65634,64,227028
1390,0.00173,172.31.40.0-255,66,65700,64,227028
1391,0.001742,74.125.24.0-255,7156,72856,64,227028
1392,0.001744,172.31.40.0-255,66,72922,64,227028
1393,0.001772,74.125.24.0-255,5020,77942,64,227028
1394,0.001774,172.31.40.0-255,66,78008,64,227028
1395,0.004062,74.125.24.0-255,4320,82328,64,227028
1396,0.00407,172.31.40.0-255,66,82394,64,227028
1397,0.004096,74.125.24.0-255,1484,83878,64,227028
1398,0.006348,74.125.24.0-255,4320,88198,64,227028
1399,0.006351,172.31.40.0-255,66,88264,64,227028
1400,0.008615,74.125.24.0-255,5738,94002,64,227028
1401,0.008621,172.31.40.0-255,66,94068,64,227028
1402,0.010913,74.125.24.0-255,5738,99806,64,227028
1403,0.010921,172.31.40.0-255,66,99872,64,227028
1404,0.013203,74.125.24.0-255,5738,105610,64,227028
1405,0.01321,172.31.40.0-255,66,105676,64,227028
1406,0.015505,74.125.24.0-255,5738,111414,64,227028
1407,0.015512,172.31.40.0-255,66,111480,64,227028
1408,0.017816,74.125.24.0-255,5738,117218,64,227028
1409,0.017824,172.31.40.0-255,66,117284,64,227028
1410,0.020126,74.125.24.0-255,5738,123022,64,227028
1411,0.020136,172.31.40.0-255,66,123088,64,227028
1412,0.022416,74.125.24.0-255,5738,128826,64,227028
1413,0.022424,172.31.40.0-255,66,128892,64,227028
1414,0.024699,74.125.24.0-255,5738,134630,64,227028
1415,0.024708,172.31.40.0-255,66,134696,64,227028
1416,0.026965,74.125.24.0-255,5738,140434,64,227028
1417,0.026973,172.31.40.0-255,66,140500,64,227028
1418,0.027135,172.31.40.0-255,172,140672,64,227028
1419,0.027165,172.31.40.0-255,1111,141783,64,227028
1420,0.027229,172.31.40.0-255,1514,143297,64,227028
1421,0.027231,172.31.40.0-255,1514,144811,64,227028
1422,0.027232,172.31.40.0-255,697,145508,64,227028
1423,0.028696,104.244.42.0-255,66,145574,64,227028
1424,0.028883,104.244.42.0-255,66,145640,64,227028
1425,0.028889,104.244.42.0-255,66,145706,64,227028
1426,0.028892,104.244.42.0-255,66,145772,64,227028
1427,0.029233,74.125.24.0-255,5738,151510,64,227028
1428,0.02924,172.31.40.0-255,66,151576,64,227028
1429,0.031551,74.125.24.0-255,5738,157314,64,227028
1430,0.031559,172.31.40.0-255,66,157380,64,227028
1431,0.033848,74.125.24.0-255,5738,163118,64,227028
1432,0.033855,172.31.40.0-255,66,163184,64,227028
1433,0.036197,74.125.24.0-255,5738,168922,64,227028
1434,0.036214,172.31.40.0-255,66,168988,64,227028
1435,0.038492,74.125.24.0-255,5738,174726,64,227028
1436,0.038506,172.31.40.0-255,66,174792,64,227028
1437,0.040795,74.125.24.0-255,5738,180530,64,227028
1438,0.040812,172.31.40.0-255,66,180596,64,227028
1439,0.043116,74.125.24.0-255,5738,186334,64,227028
1440,0.043138,172.31.40.0-255,66,186400,64,227028
1441,0.045428,74.125.24.0-255,5738,192138,64,227028
1442,0.045444,172.31.40.0-255,66,192204,64,227028
1443,0.047747,74.125.24.0-255,5738,197942,64,227028
1444,0.047765,172.31.40.0-255,66,198008,64,227028
1445,0.050092,74.125.24.0-255,5738,203746,64,227028
1446,0.05013,172.31.40.0-255,66,203812,64,227028
1447,0.052429,74.125.24.0-255,5738,209550,64,227028
1448,0.052441,172.31.40.0-255,66,209616,64,227028
1449,0.054731,74.125.24.0-255,5738,215354,64,227028
1450,0.05475,172.31.40.0-255,66,215420,64,227028
1451,0.057033,74.125.24.0-255,5738,221158,64,227028
1452,0.05705,172.31.40.0-255,66,221224,64,227028
1453,0.059345,74.125.24.0-255,5738,226962,64,227028
1454,0.059363,172.31.40.0-255,66,227028,64,227028
1455,0.0,74.125.24.0-255,153,153,64,239251
1456,2.3e-05,172.31.40.0-255,66,219,64,239251
1457,3e-05,74.125.24.0-255,1484,1703,64,239251
1458,3.5e-05,172.31.40.0-255,66,1769,64,239251
1459,4.1e-05,74.125.24.0-255,2902,4671,64,239251
1460,4.5e-05,172.31.40.0-255,66,4737,64,239251
1461,5.2e-05,74.125.24.0-255,7156,11893,64,239251
1462,5.5e-05,172.31.40.0-255,66,11959,64,239251
1463,5.9e-05,74.125.24.0-255,2000,13959,64,239251
1464,6.2e-05,172.31.40.0-255,66,14025,64,239251
1465,0.000188,74.125.24.0-255,1484,15509,64,239251
1466,0.000193,172.31.40.0-255,66,15575,64,239251
1467,0.000198,74.125.24.0-255,2902,18477,64,239251
1468,0.000201,172.31.40.0-255,66,18543,64,239251
1469,0.000228,74.125.24.0-255,5738,24281,64,239251
1470,0.00023,172.31.40.0-255,66,24347,64,239251
1471,0.000254,74.125.24.0-255,1484,25831,64,239251
1472,0.000256,172.31.40.0-255,66,25897,64,239251
1473,0.000276,74.125.24.0-255,5379,31276,64,239251
1474,0.000279,172.31.40.0-255,66,31342,64,239251
1475,0.000363,74.125.24.0-255,1484,32826,64,239251
1476,0.000366,172.31.40.0-255,66,32892,64,239251
1477,0.000372,74.125.24.0-255,2902,35794,64,239251
1478,0.000374,172.31.40.0-255,66,35860,64,239251
1479,0.000378,74.125.24.0-255,2902,38762,64,239251
1480,0.000381,172.31.40.0-255,66,38828,64,239251
1481,0.000402,74.125.24.0-255,2902,41730,64,239251
1482,0.000405,172.31.40.0-255,66,41796,64,239251
1483,0.00041,74.125.24.0-255,4320,46116,64,239251
1484,0.000413,172.31.40.0-255,66,46182,64,239251
1485,0.000434,172.31.40.0-255,66,46248,64,239251
1486,0.000465,74.125.24.0-255,5738,51986,64,239251
1487,0.000468,172.31.40.0-255,66,52052,64,239251
1488,0.00051,74.125.24.0-255,5685,57737,64,239251
1489,0.000513,172.31.40.0-255,66,57803,64,239251
1490,0.000516,74.125.24.0-255,113,57916,64,239251
1491,0.000614,74.125.24.0-255,1484,59400,64,239251
1492,0.000619,172.31.40.0-255,66,59466,64,239251
1493,0.000637,74.125.24.0-255,2902,62368,64,239251
1494,0.00064,172.31.40.0-255,66,62434,64,239251
1495,0.000645,74.125.24.0-255,4320,66754,64,239251
1496,0.000648,172.31.40.0-255,66,66820,64,239251
1497,0.000663,74.125.24.0-255,1484,68304,64,239251
1498,0.000669,74.125.24.0-255,4320,72624,64,239251
1499,0.000672,172.31.40.0-255,66,72690,64,239251
1500,0.000702,172.31.40.0-255,66,72756,64,239251
1501,0.000835,172.31.40.0-255,66,72822,64,239251
1502,0.002884,74.125.24.0-255,5738,78560,64,239251
1503,0.002894,172.31.40.0-255,66,78626,64,239251
1504,0.004968,74.125.24.0-255,5738,84364,64,239251
1505,0.004972,172.31.40.0-255,66,84430,64,239251
1506,0.007038,74.125.24.0-255,5738,90168,64,239251
1507,0.007046,172.31.40.0-255,66,90234,64,239251
1508,0.009167,74.125.24.0-255,5738,95972,64,239251
1509,0.009175,172.31.40.0-255,66,96038,64,239251
1510,0.011227,74.125.24.0-255,5738,101776,64,239251
1511,0.011235,172.31.40.0-255,66,101842,64,239251
1512,0.013291,74.125.24.0-255,5738,107580,64,239251
1513,0.013297,172.31.40.0-255,66,107646,64,239251
1514,0.015385,74.125.24.0-255,5738,113384,64,239251
1515,0.015393,172.31.40.0-255,66,113450,64,239251
1516,0.01751,74.125.24.0-255,5738,119188,64,239251
1517,0.017521,172.31.40.0-255,66,119254,64,239251
1518,0.019589,74.125.24.0-255,5738,124992,64,239251
1519,0.019597,172.31.40.0-255,66,125058,64,239251
1520,0.021645,74.125.24.0-255,5738,130796,64,239251
1521,0.021651,172.31.40.0-255,66,130862,64,239251
1522,0.022623,172.31.40.0-255,172,131034,64,239251
1523,0.022656,172.31.40.0-255,1111,132145,64,239251
1524,0.022715,172.31.40.0-255,1514,133659,64,239251
1525,0.022717,172.31.40.0-255,1514,135173,64,239251
1526,0.022718,172.31.40.0-255,694,135867,64,239251
1527,0.02371,74.125.24.0-255,5738,141605,64,239251
1528,0.023718,172.31.40.0-255,66,141671,64,239251
1529,0.024199,104.244.42.0-255,66,141737,64,239251
1530,0.02423,104.244.42.0-255,66,141803,64,239251
1531,0.024291,104.244.42.0-255,66,141869,64,239251
1532,0.024297,104.244.42.0-255,66,141935,64,239251
1533,0.025822,74.125.24.0-255,5738,147673,64,239251
1534,0.025829,172.31.40.0-255,66,147739,64,239251
1535,0.027904,74.125.24.0-255,5738,153477,64,239251
1536,0.027911,172.31.40.0-255,66,153543,64,239251
1537,0.02996,74.125.24.0-255,5738,159281,64,239251
1538,0.029967,172.31.40.0-255,66,159347,64,239251
1539,0.032035,74.125.24.0-255,5738,165085,64,239251
1540,0.032041,172.31.40.0-255,66,165151,64,239251
1541,0.034136,74.125.24.0-255,5738,170889,64,239251
1542,0.034143,172.31.40.0-255,66,170955,64,239251
1543,0.03623,74.125.24.0-255,5738,176693,64,239251
1544,0.036237,172.31.40.0-255,66,176759,64,239251
1545,0.038345,74.125.24.0-255,5738,182497,64,239251
1546,0.038351,172.31.40.0-255,66,182563,64,239251
1547,0.040429,74.125.24.0-255,5738,188301,64,239251
1548,0.040436,172.31.40.0-255,66,188367,64,239251
1549,0.042541,74.125.24.0-255,5738,194105,64,239251
1550,0.042547,172.31.40.0-255,66,194171,64,239251
1551,0.04462,74.125.24.0-255,5738,199909,64,239251
1552,0.044627,172.31.40.0-255,66,199975,64,239251
1553,0.046682,74.125.24.0-255,4320,204295,64,239251
1554,0.046689,172.31.40.0-255,66,204361,64,239251
1555,0.046708,74.125.24.0-255,1484,205845,64,239251
1556,0.048783,74.125.24.0-255,4320,210165,64,239251
1557,0.04879,172.31.40.0-255,66,210231,64,239251
1558,0.050824,74.125.24.0-255,5738,215969,64,239251
1559,0.050831,172.31.40.0-255,66,216035,64,239251
1560,0.052887,74.125.24.0-255,5738,221773,64,239251
1561,0.052894,172.31.40.0-255,66,221839,64,239251
1562,0.054962,74.125.24.0-255,5738,227577,64,239251
1563,0.054968,172.31.40.0-255,66,227643,64,239251
1564,0.057009,74.125.24.0-255,5738,233381,64,239251
1565,0.057015,172.31.40.0-255,66,233447,64,239251
1566,0.059094,74.125.24.0-255,5738,239185,64,239251
1567,0.059101,172.31.40.0-255,66,239251,64,239251
1568,0.0,216.58.203.0-255,152,152,64,340116
1569,2.2e-05,172.31.40.0-255,66,218,64,340116
1570,5.4e-05,216.58.203.0-255,1484,1702,64,340116
1571,5.8e-05,172.31.40.0-255,66,1768,64,340116
1572,6.3e-05,216.58.203.0-255,2902,4670,64,340116
1573,6.5e-05,172.31.40.0-255,66,4736,64,340116
1574,7.1e-05,216.58.203.0-255,4320,9056,64,340116
1575,7.3e-05,172.31.40.0-255,66,9122,64,340116
1576,0.000105,216.58.203.0-255,5738,14860,64,340116
1577,0.000107,172.31.40.0-255,66,14926,64,340116
1578,0.000124,216.58.203.0-255,3486,18412,64,340116
1579,0.000126,172.31.40.0-255,66,18478,64,340116
1580,0.000131,216.58.203.0-255,4320,22798,64,340116
1581,0.000133,172.31.40.0-255,66,22864,64,340116
1582,0.000147,216.58.203.0-255,5738,28602,64,340116
1583,0.000149,172.31.40.0-255,66,28668,64,340116
1584,0.000168,216.58.203.0-255,2543,31211,64,340116
1585,0.00017,172.31.40.0-255,66,31277,64,340116
1586,0.000243,216.58.203.0-255,1484,32761,64,340116
1587,0.000246,172.31.40.0-255,66,32827,64,340116
1588,0.00025,216.58.203.0-255,2902,35729,64,340116
1589,0.000252,172.31.40.0-255,66,35795,64,340116
1590,0.000267,216.58.203.0-255,5738,41533,64,340116
1591,0.000269,172.31.40.0-255,66,41599,64,340116
1592,0.000298,216.58.203.0-255,6797,48396,64,340116
1593,0.0003,172.31.40.0-255,66,48462,64,340116
1594,0.000303,216.58.203.0-255,1484,49946,64,340116
1595,0.000304,172.31.40.0-255,66,50012,64,340116
1596,0.000341,172.31.40.0-255,66,50078,64,340116
1597,0.000344,216.58.203.0-255,2813,52891,64,340116
1598,0.000346,172.31.40.0-255,66,52957,64,340116
1599,0.000638,216.58.203.0-255,135,53092,64,340116
1600,0.000845,216.58.203.0-255,1484,54576,64,340116
1601,0.000849,172.31.40.0-255,66,54642,64,340116
1602,0.000855,216.58.203.0-255,2902,57544,64,340116
1603,0.000857,172.31.40.0-255,66,57610,64,340116
1604,0.000876,216.58.203.0-255,4320,61930,64,340116
1605,0.000879,172.31.40.0-255,66,61996,64,340116
1606,0.000893,216.58.203.0-255,1484,63480,64,340116
1607,0.000927,216.58.203.0-255,1484,64964,64,340116
1608,0.00093,172.31.40.0-255,66,65030,64,340116
1609,0.000943,216.58.203.0-255,2902,67932,64,340116
1610,0.000945,172.31.40.0-255,66,67998,64,340116
1611,0.000966,216.58.203.0-255,1484,69482,64,340116
1612,0.000989,216.58.203.0-255,5379,74861,64,340116
1613,0.000992,172.31.40.0-255,66,74927,64,340116
1614,0.000997,216.58.203.0-255,4320,79247,64,340116
1615,0.000999,172.31.40.0-255,66,79313,64,340116
1616,0.001025,216.58.203.0-255,2902,82215,64,340116
1617,0.001028,172.31.40.0-255,66,82281,64,340116
1618,0.001043,216.58.203.0-255,5379,87660,64,340116
1619,0.001045,172.31.40.0-255,66,87726,64,340116
1620,0.00128,216.58.203.0-255,1484,89210,64,340116
1621,0.001285,216.58.203.0-255,2902,92112,64,340116
1622,0.001291,172.31.40.0-255,66,92178,64,340116
1623,0.001313,216.58.203.0-255,5738,97916,64,340116
1624,0.001315,172.31.40.0-255,66,97982,64,340116
1625,0.001323,216.58.203.0-255,7156,105138,64,340116
1626,0.001325,172.31.40.0-255,66,105204,64,340116
1627,0.001346,216.58.203.0-255,5738,110942,64,340116
1628,0.001348,172.31.40.0-255,66,111008,64,340116
1629,0.00136,172.31.40.0-255,66,111074,64,340116
1630,0.001433,216.58.203.0-255,1484,112558,64,340116
1631,0.001446,216.58.203.0-255,2902,115460,64,340116
1632,0.00145,172.31.40.0-255,66,115526,64,340116
1633,0.001478,216.58.203.0-255,1484,117010,64,340116
1634,0.001482,216.58.203.0-255,1484,118494,64,340116
1635,0.001484,172.31.40.0-255,66,118560,64,340116
1636,0.001497,216.58.203.0-255,1484,120044,64,340116
1637,0.001501,216.58.203.0-255,2902,122946,64,340116
1638,0.001503,172.31.40.0-255,66,123012,64,340116
1639,0.001525,216.58.203.0-255,2902,125914,64,340116
1640,0.001528,172.31.40.0-255,66,125980,64,340116
1641,0.001542,172.31.40.0-255,66,126046,64,340116
1642,0.001549,216.58.203.0-255,6438,132484,64,340116
1643,0.001552,172.31.40.0-255,66,132550,64,340116
1644,0.003178,216.58.203.0-255,5738,138288,64,340116
1645,0.003185,172.31.40.0-255,66,138354,64,340116
1646,0.004814,216.58.203.0-255,5738,144092,64,340116
1647,0.004816,172.31.40.0-255,66,144158,64,340116
1648,0.006436,216.58.203.0-255,5738,149896,64,340116
1649,0.006439,172.31.40.0-255,66,149962,64,340116
1650,0.008062,216.58.203.0-255,2902,152864,64,340116
1651,0.008068,172.31.40.0-255,66,152930,64,340116
1652,0.008091,216.58.203.0-255,2902,155832,64,340116
1653,0.008095,172.31.40.0-255,66,155898,64,340116
1654,0.009704,216.58.203.0-255,5738,161636,64,340116
1655,0.009711,172.31.40.0-255,66,161702,64,340116
1656,0.01134,216.58.203.0-255,5738,167440,64,340116
1657,0.011346,172.31.40.0-255,66,167506,64,340116
1658,0.012974,216.58.203.0-255,5738,173244,64,340116
1659,0.012982,172.31.40.0-255,66,173310,64,340116
1660,0.014612,216.58.203.0-255,5738,179048,64,340116
1661,0.01462,172.31.40.0-255,66,179114,64,340116
1662,0.016249,216.58.203.0-255,5738,184852,64,340116
1663,0.016256,172.31.40.0-255,66,184918,64,340116
1664,0.017885,216.58.203.0-255,5738,190656,64,340116
1665,0.017893,172.31.40.0-255,66,190722,64,340116
1666,0.019561,216.58.203.0-255,5738,196460,64,340116
1667,0.019568,172.31.40.0-255,66,196526,64,340116
1668,0.021191,216.58.203.0-255,5738,202264,64,340116
1669,0.021197,172.31.40.0-255,66,202330,64,340116
1670,0.022828,216.58.203.0-255,5738,208068,64,340116
1671,0.022834,172.31.40.0-255,66,208134,64,340116
1672,0.024466,216.58.203.0-255,5738,213872,64,340116
1673,0.024473,172.31.40.0-255,66,213938,64,340116
1674,0.026118,216.58.203.0-255,5738,219676,64,340116
1675,0.026125,172.31.40.0-255,66,219742,64,340116
1676,0.027755,216.58.203.0-255,5738,225480,64,340116
1677,0.027768,172.31.40.0-255,66,225546,64,340116
1678,0.029412,216.58.203.0-255,5738,231284,64,340116
1679,0.029421,172.31.40.0-255,66,231350,64,340116
1680,0.031051,216.58.203.0-255,5738,237088,64,340116
1681,0.03106,172.31.40.0-255,66,237154,64,340116
1682,0.032694,216.58.203.0-255,5738,242892,64,340116
1683,0.032704,172.31.40.0-255,66,242958,64,340116
1684,0.034335,216.58.203.0-255,5738,248696,64,340116
1685,0.034346,172.31.40.0-255,66,248762,64,340116
1686,0.036014,216.58.203.0-255,5738,254500,64,340116
1687,0.036024,172.31.40.0-255,66,254566,64,340116
1688,0.037661,216.58.203.0-255,5738,260304,64,340116
1689,0.037672,172.31.40.0-255,66,260370,64,340116
1690,0.039337,216.58.203.0-255,5738,266108,64,340116
1691,0.03935,172.31.40.0-255,66,266174,64,340116
1692,0.040991,216.58.203.0-255,5738,271912,64,340116
1693,0.041003,172.31.40.0-255,66,271978,64,340116
1694,0.042627,216.58.203.0-255,5738,277716,64,340116
1695,0.042637,172.31.40.0-255,66,277782,64,340116
1696,0.044269,216.58.203.0-255,5738,283520,64,340116
1697,0.044276,172.31.40.0-255,66,283586,64,340116
1698,0.045937,216.58.203.0-255,5738,289324,64,340116
1699,0.045943,172.31.40.0-255,66,289390,64,340116
1700,0.047048,172.31.40.0-255,172,289562,64,340116
1701,0.047074,172.31.40.0-255,1112,290674,64,340116
1702,0.047124,172.31.40.0-255,1514,292188,64,340116
1703,0.047126,172.31.40.0-255,1298,293486,64,340116
1704,0.047565,216.58.203.0-255,5738,299224,64,340116
1705,0.04757,172.31.40.0-255,66,299290,64,340116
1706,0.048531,104.244.42.0-255,66,299356,64,340116
1707,0.048554,104.244.42.0-255,66,299422,64,340116
1708,0.048616,104.244.42.0-255,66,299488,64,340116
1709,0.049195,216.58.203.0-255,5738,305226,64,340116
1710,0.049201,172.31.40.0-255,66,305292,64,340116
1711,0.050845,216.58.203.0-255,5738,311030,64,340116
1712,0.050854,172.31.40.0-255,66,311096,64,340116
1713,0.052484,216.58.203.0-255,5738,316834,64,340116
1714,0.052494,172.31.40.0-255,66,316900,64,340116
1715,0.054124,216.58.203.0-255,5738,322638,64,340116
1716,0.054135,172.31.40.0-255,66,322704,64,340116
1717,0.055775,216.58.203.0-255,5738,328442,64,340116
1718,0.055787,172.31.40.0-255,66,328508,64,340116
1719,0.05742,216.58.203.0-255,5738,334246,64,340116
1720,0.057431,172.31.40.0-255,66,334312,64,340116
1721,0.059067,216.58.203.0-255,5738,340050,64,340116
1722,0.059078,172.31.40.0-255,66,340116,64,340116
1723,0.0,74.125.68.0-255,143,143,64,298570
1724,2.1e-05,172.31.40.0-255,66,209,64,298570
1725,2.8e-05,74.125.68.0-255,1484,1693,64,298570
1726,3.3e-05,172.31.40.0-255,66,1759,64,298570
1727,4.6e-05,74.125.68.0-255,2902,4661,64,298570
1728,4.9e-05,172.31.40.0-255,66,4727,64,298570
1729,8.7e-05,74.125.68.0-255,5738,10465,64,298570
1730,9e-05,172.31.40.0-255,66,10531,64,298570
1731,0.000119,74.125.68.0-255,3518,14049,64,298570
1732,0.000122,172.31.40.0-255,66,14115,64,298570
1733,0.000195,74.125.68.0-255,1484,15599,64,298570
1734,0.000199,172.31.40.0-255,66,15665,64,298570
1735,0.000223,74.125.68.0-255,2902,18567,64,298570
1736,0.000226,172.31.40.0-255,66,18633,64,298570
1737,0.000238,74.125.68.0-255,1484,20117,64,298570
1738,0.00024,172.31.40.0-255,66,20183,64,298570
1739,0.000259,74.125.68.0-255,2902,23085,64,298570
1740,0.000261,172.31.40.0-255,66,23151,64,298570
1741,0.000285,74.125.68.0-255,7156,30307,64,298570
1742,0.000288,172.31.40.0-255,66,30373,64,298570
1743,0.000338,74.125.68.0-255,1125,31498,64,298570
1744,0.000341,172.31.40.0-255,66,31564,64,298570
1745,0.000344,74.125.68.0-255,1484,33048,64,298570
1746,0.000346,172.31.40.0-255,66,33114,64,298570
1747,0.000352,74.125.68.0-255,4320,37434,64,298570
1748,0.000355,172.31.40.0-255,66,37500,64,298570
1749,0.000376,74.125.68.0-255,2902,40402,64,298570
1750,0.000378,172.31.40.0-255,66,40468,64,298570
1751,0.00041,74.125.68.0-255,4320,44788,64,298570
1752,0.000413,172.31.40.0-255,66,44854,64,298570
1753,0.000417,74.125.68.0-255,1484,46338,64,298570
1754,0.000419,172.31.40.0-255,66,46404,64,298570
1755,0.000435,74.125.68.0-255,2543,48947,64,298570
1756,0.00052,74.125.68.0-255,1484,50431,64,298570
1757,0.00054,74.125.68.0-255,2902,53333,64,298570
1758,0.000566,74.125.68.0-255,5738,59071,64,298570
1759,0.00057,74.125.68.0-255,1484,60555,64,298570
1760,0.000631,74.125.68.0-255,5379,65934,64,298570
1761,0.000658,172.31.40.0-255,66,66000,64,298570
1762,0.000714,74.125.68.0-255,1484,67484,64,298570
1763,0.000739,74.125.68.0-255,2902,70386,64,298570
1764,0.000759,74.125.68.0-255,5738,76124,64,298570
1765,0.000765,172.31.40.0-255,66,76190,64,298570
1766,0.000778,74.125.68.0-255,4320,80510,64,298570
1767,0.000801,74.125.68.0-255,1484,81994,64,298570
1768,0.000806,172.31.40.0-255,66,82060,64,298570
1769,0.000835,74.125.68.0-255,3123,85183,64,298570
1770,0.000841,74.125.68.0-255,4320,89503,64,298570
1771,0.000852,172.31.40.0-255,66,89569,64,298570
1772,0.000863,74.125.68.0-255,5738,95307,64,298570
1773,0.000883,74.125.68.0-255,5379,100686,64,298570
1774,0.000894,172.31.40.0-255,66,100752,64,298570
1775,0.0014,74.125.68.0-255,1484,102236,64,298570
1776,0.001414,74.125.68.0-255,2902,105138,64,298570
1777,0.001418,172.31.40.0-255,66,105204,64,298570
1778,0.001456,74.125.68.0-255,5738,110942,64,298570
1779,0.001463,74.125.68.0-255,5738,116680,64,298570
1780,0.001474,74.125.68.0-255,2902,119582,64,298570
1781,0.001477,172.31.40.0-255,66,119648,64,298570
1782,0.001505,74.125.68.0-255,4320,123968,64,298570
1783,0.001508,172.31.40.0-255,66,124034,64,298570
1784,0.001512,172.31.40.0-255,66,124100,64,298570
1785,0.00154,74.125.68.0-255,5738,129838,64,298570
1786,0.001543,74.125.68.0-255,1484,131322,64,298570
1787,0.001547,74.125.68.0-255,2902,134224,64,298570
1788,0.00155,74.125.68.0-255,766,134990,64,298570
1789,0.001556,172.31.40.0-255,66,135056,64,298570
1790,0.001658,74.125.68.0-255,1484,136540,64,298570
1791,0.001678,74.125.68.0-255,2902,139442,64,298570
1792,0.001694,74.125.68.0-255,4320,143762,64,298570
1793,0.001709,74.125.68.0-255,1484,145246,64,298570
1794,0.001713,74.125.68.0-255,2902,148148,64,298570
1795,0.001717,172.31.40.0-255,66,148214,64,298570
1796,0.001724,172.31.40.0-255,66,148280,64,298570
1797,0.001743,74.125.68.0-255,2902,151182,64,298570
1798,0.001751,74.125.68.0-255,7156,158338,64,298570
1799,0.001775,74.125.68.0-255,4320,162658,64,298570
1800,0.00179,74.125.68.0-255,4320,166978,64,298570
1801,0.001796,172.31.40.0-255,66,167044,64,298570
1802,0.001826,74.125.68.0-255,2184,169228,64,298570
1803,0.00184,172.31.40.0-255,66,169294,64,298570
1804,0.002513,74.125.68.0-255,1484,170778,64,298570
1805,0.00429,74.125.68.0-255,1484,172262,64,298570
1806,0.004297,172.31.40.0-255,66,172328,64,298570
1807,0.004334,74.125.68.0-255,2902,175230,64,298570
1808,0.006801,74.125.68.0-255,2902,178132,64,298570
1809,0.007978,172.31.40.0-255,66,178198,64,298570
1810,0.010482,74.125.68.0-255,5738,183936,64,298570
1811,0.01049,172.31.40.0-255,66,184002,64,298570
1812,0.012995,74.125.68.0-255,5738,189740,64,298570
1813,0.013003,172.31.40.0-255,66,189806,64,298570
1814,0.015526,74.125.68.0-255,5738,195544,64,298570
1815,0.016151,172.31.40.0-255,66,195610,64,298570
1816,0.01867,74.125.68.0-255,5738,201348,64,298570
1817,0.01868,172.31.40.0-255,66,201414,64,298570
1818,0.021194,74.125.68.0-255,5738,207152,64,298570
1819,0.021207,172.31.40.0-255,66,207218,64,298570
1820,0.023725,74.125.68.0-255,5738,212956,64,298570
1821,0.023738,172.31.40.0-255,66,213022,64,298570
1822,0.026308,74.125.68.0-255,5738,218760,64,298570
1823,0.026317,172.31.40.0-255,66,218826,64,298570
1824,0.028137,172.31.40.0-255,172,218998,64,298570
1825,0.02817,172.31.40.0-255,1113,220111,64,298570
1826,0.028229,172.31.40.0-255,1514,221625,64,298570
1827,0.02823,172.31.40.0-255,1295,222920,64,298570
1828,0.028827,74.125.68.0-255,5738,228658,64,298570
1829,0.028834,172.31.40.0-255,66,228724,64,298570
1830,0.029687,104.244.42.0-255,66,228790,64,298570
1831,0.029728,104.244.42.0-255,66,228856,64,298570
1832,0.029776,104.244.42.0-255,66,228922,64,298570
1833,0.031335,74.125.68.0-255,5738,234660,64,298570
1834,0.031341,172.31.40.0-255,66,234726,64,298570
1835,0.033844,74.125.68.0-255,5738,240464,64,298570
1836,0.03385,172.31.40.0-255,66,240530,64,298570
1837,0.036369,74.125.68.0-255,5738,246268,64,298570
1838,0.036376,172.31.40.0-255,66,246334,64,298570
1839,0.038904,74.125.68.0-255,5738,252072,64,298570
1840,0.038911,172.31.40.0-255,66,252138,64,298570
1841,0.041439,74.125.68.0-255,5738,257876,64,298570
1842,0.041458,172.31.40.0-255,66,257942,64,298570
1843,0.04398,74.125.68.0-255,5738,263680,64,298570
1844,0.043996,172.31.40.0-255,66,263746,64,298570
1845,0.046529,74.125.68.0-255,5738,269484,64,298570
1846,0.046547,172.31.40.0-255,66,269550,64,298570
1847,0.049068,74.125.68.0-255,5738,275288,64,298570
1848,0.049084,172.31.40.0-255,66,275354,64,298570
1849,0.051607,74.125.68.0-255,5738,281092,64,298570
1850,0.051625,172.31.40.0-255,66,281158,64,298570
1851,0.054148,74.125.68.0-255,5738,286896,64,298570
1852,0.054166,172.31.40.0-255,66,286962,64,298570
1853,0.056689,74.125.68.0-255,5738,292700,64,298570
1854,0.056714,172.31.40.0-255,66,292766,64,298570
1855,0.05924,74.125.68.0-255,5738,298504,64,298570
1856,0.059258,172.31.40.0-255,66,298570,64,298570
1857,0.0,172.217.194.0-255,153,153,64,304587
1858,2.3e-05,172.31.40.0-255,66,219,64,304587
1859,3e-05,172.217.194.0-255,1484,1703,64,304587
1860,3.4e-05,172.31.40.0-255,66,1769,64,304587
1861,4e-05,172.217.194.0-255,2902,4671,64,304587
1862,4.3e-05,172.31.40.0-255,66,4737,64,304587
1863,5.1e-05,172.217.194.0-255,7156,11893,64,304587
1864,5.3e-05,172.31.40.0-255,66,11959,64,304587
1865,6e-05,172.217.194.0-255,6419,18378,64,304587
1866,6.3e-05,172.31.40.0-255,66,18444,64,304587
1867,6.8e-05,172.217.194.0-255,4320,22764,64,304587
1868,7.1e-05,172.31.40.0-255,66,22830,64,304587
1869,9.6e-05,172.217.194.0-255,2902,25732,64,304587
1870,9.9e-05,172.31.40.0-255,66,25798,64,304587
1871,0.000105,172.217.194.0-255,5379,31177,64,304587
1872,0.000108,172.31.40.0-255,66,31243,64,304587
1873,0.000187,172.217.194.0-255,1484,32727,64,304587
1874,0.000191,172.31.40.0-255,66,32793,64,304587
1875,0.000197,172.217.194.0-255,2902,35695,64,304587
1876,0.000199,172.31.40.0-255,66,35761,64,304587
1877,0.000233,172.217.194.0-255,5738,41499,64,304587
1878,0.000236,172.31.40.0-255,66,41565,64,304587
1879,0.000249,172.217.194.0-255,1484,43049,64,304587
1880,0.000251,172.31.40.0-255,66,43115,64,304587
1881,0.000277,172.31.40.0-255,66,43181,64,304587
1882,0.000324,172.31.40.0-255,66,43247,64,304587
1883,0.000354,172.217.194.0-255,1484,44731,64,304587
1884,0.000356,172.31.40.0-255,66,44797,64,304587
1885,0.000361,172.217.194.0-255,2902,47699,64,304587
1886,0.000363,172.31.40.0-255,66,47765,64,304587
1887,0.000382,172.217.194.0-255,5738,53503,64,304587
1888,0.000385,172.31.40.0-255,66,53569,64,304587
1889,0.000403,172.217.194.0-255,2902,56471,64,304587
1890,0.000406,172.31.40.0-255,66,56537,64,304587
1891,0.000429,172.217.194.0-255,3992,60529,64,304587
1892,0.000432,172.31.40.0-255,66,60595,64,304587
1893,0.000439,172.217.194.0-255,7156,67751,64,304587
1894,0.000442,172.31.40.0-255,66,67817,64,304587
1895,0.000476,172.31.40.0-255,66,67883,64,304587
1896,0.000712,172.217.194.0-255,1484,69367,64,304587
1897,0.000717,172.31.40.0-255,66,69433,64,304587
1898,0.000722,172.217.194.0-255,2902,72335,64,304587
1899,0.000724,172.31.40.0-255,66,72401,64,304587
1900,0.00073,172.217.194.0-255,4320,76721,64,304587
1901,0.000733,172.31.40.0-255,66,76787,64,304587
1902,0.000755,172.217.194.0-255,1484,78271,64,304587
1903,0.000757,172.31.40.0-255,66,78337,64,304587
1904,0.00076,172.217.194.0-255,1484,79821,64,304587
1905,0.000762,172.31.40.0-255,66,79887,64,304587
1906,0.000779,172.217.194.0-255,7156,87043,64,304587
1907,0.000797,172.217.194.0-255,5379,92422,64,304587
1908,0.000801,172.31.40.0-255,66,92488,64,304587
1909,0.000812,172.217.194.0-255,2902,95390,64,304587
1910,0.000822,172.31.40.0-255,66,95456,64,304587
1911,0.000829,172.217.194.0-255,6797,102253,64,304587
1912,0.000857,172.217.194.0-255,1484,103737,64,304587
1913,0.000862,172.217.194.0-255,2902,106639,64,304587
1914,0.000868,172.31.40.0-255,66,106705,64,304587
1915,0.00089,172.217.194.0-255,5738,112443,64,304587
1916,0.000895,172.217.194.0-255,2902,115345,64,304587
1917,0.000916,172.31.40.0-255,66,115411,64,304587
1918,0.000947,172.31.40.0-255,66,115477,64,304587
1919,0.000965,172.217.194.0-255,5738,121215,64,304587
1920,0.001,172.31.40.0-255,66,121281,64,304587
1921,0.001005,172.31.40.0-255,66,121347,64,304587
1922,0.001037,172.31.40.0-255,66,121413,64,304587
1923,0.00106,172.217.194.0-255,2902,124315,64,304587
1924,0.001068,172.31.40.0-255,66,124381,64,304587
1925,0.001078,172.217.194.0-255,1484,125865,64,304587
1926,0.001117,172.217.194.0-255,7156,133021,64,304587
1927,0.00113,172.217.194.0-255,3602,136623,64,304587
1928,0.001137,172.31.40.0-255,66,136689,64,304587
1929,0.001343,172.217.194.0-255,1484,138173,64,304587
1930,0.001368,172.217.194.0-255,2902,141075,64,304587
1931,0.001375,172.31.40.0-255,66,141141,64,304587
1932,0.001383,172.217.194.0-255,2902,144043,64,304587
1933,0.001388,172.31.40.0-255,66,144109,64,304587
1934,0.001399,172.217.194.0-255,2902,147011,64,304587
1935,0.001417,172.31.40.0-255,66,147077,64,304587
1936,0.001427,172.217.194.0-255,4320,151397,64,304587
1937,0.001445,172.217.194.0-255,5738,157135,64,304587
1938,0.001449,172.31.40.0-255,66,157201,64,304587
1939,0.001458,172.217.194.0-255,1484,158685,64,304587
1940,0.001478,172.217.194.0-255,4320,163005,64,304587
1941,0.00149,172.31.40.0-255,66,163071,64,304587
1942,0.001509,172.217.194.0-255,1484,164555,64,304587
1943,0.001531,172.217.194.0-255,6438,170993,64,304587
1944,0.001537,172.31.40.0-255,66,171059,64,304587
1945,0.001745,172.217.194.0-255,1484,172543,64,304587
1946,0.001762,172.217.194.0-255,2902,175445,64,304587
1947,0.001765,172.31.40.0-255,66,175511,64,304587
1948,0.001781,172.217.194.0-255,5738,181249,64,304587
1949,0.001791,172.31.40.0-255,66,181315,64,304587
1950,0.0018,172.217.194.0-255,1484,182799,64,304587
1951,0.001832,172.217.194.0-255,4320,187119,64,304587
1952,0.00188,172.217.194.0-255,1484,188603,64,304587
1953,0.001883,172.31.40.0-255,66,188669,64,304587
1954,0.001907,172.217.194.0-255,5020,193689,64,304587
1955,0.001914,172.31.40.0-255,66,193755,64,304587
1956,0.003961,172.217.194.0-255,5738,199493,64,304587
1957,0.003969,172.31.40.0-255,66,199559,64,304587
1958,0.006046,172.217.194.0-255,5738,205297,64,304587
1959,0.008139,172.31.40.0-255,66,205363,64,304587
1960,0.010206,172.217.194.0-255,5738,211101,64,304587
1961,0.010213,172.31.40.0-255,66,211167,64,304587
1962,0.012267,172.217.194.0-255,5738,216905,64,304587
1963,0.012275,172.31.40.0-255,66,216971,64,304587
1964,0.014339,172.217.194.0-255,5738,222709,64,304587
1965,0.014348,172.31.40.0-255,66,222775,64,304587
1966,0.016411,172.217.194.0-255,5738,228513,64,304587
1967,0.016419,172.31.40.0-255,66,228579,64,304587
1968,0.018448,172.217.194.0-255,5738,234317,64,304587
1969,0.018456,172.31.40.0-255,66,234383,64,304587
1970,0.020552,172.217.194.0-255,5738,240121,64,304587
1971,0.020562,172.31.40.0-255,66,240187,64,304587
1972,0.022623,172.217.194.0-255,5738,245925,64,304587
1973,0.022633,172.31.40.0-255,66,245991,64,304587
1974,0.024716,172.217.194.0-255,5738,251729,64,304587
1975,0.024724,172.31.40.0-255,66,251795,64,304587
1976,0.026818,172.217.194.0-255,5738,257533,64,304587
1977,0.02683,172.31.40.0-255,66,257599,64,304587
1978,0.02891,172.217.194.0-255,5738,263337,64,304587
1979,0.028921,172.31.40.0-255,66,263403,64,304587
1980,0.030967,172.217.194.0-255,4320,267723,64,304587
1981,0.030974,172.31.40.0-255,66,267789,64,304587
1982,0.030995,172.217.194.0-255,1484,269273,64,304587
1983,0.031499,172.31.40.0-255,167,269440,64,304587
1984,0.031532,172.31.40.0-255,1107,270547,64,304587
1985,0.031624,172.31.40.0-255,1514,272061,64,304587
1986,0.031626,172.31.40.0-255,340,272401,64,304587
1987,0.03301,104.244.42.0-255,66,272467,64,304587
1988,0.033022,172.217.194.0-255,4320,276787,64,304587
1989,0.033028,172.31.40.0-255,66,276853,64,304587
1990,0.033088,104.244.42.0-255,66,276919,64,304587
1991,0.033184,104.244.42.0-255,66,276985,64,304587
1992,0.035108,172.217.194.0-255,5738,282723,64,304587
1993,0.035116,172.31.40.0-255,66,282789,64,304587
1994,0.037165,172.217.194.0-255,5738,288527,64,304587
1995,0.037173,172.31.40.0-255,66,288593,64,304587
1996,0.039233,172.217.194.0-255,5738,294331,64,304587
1997,0.039241,172.31.40.0-255,66,294397,64,304587
1998,0.041329,172.217.194.0-255,5738,300135,64,304587
1999,0.041336,172.31.40.0-255,66,300201,64,304587
2000,0.04343,172.217.194.0-255,4149,304350,64,304587
2001,0.043437,172.31.40.0-255,66,304416,64,304587
2002,0.043664,172.31.40.0-255,105,304521,64,304587
2003,0.045675,172.217.194.0-255,66,304587,64,304587
2004,0.0,172.31.40.0-255,105,105,64,459
2005,0.00021,172.31.40.0-255,90,195,64,459
2006,0.00022,172.31.40.0-255,66,261,64,459
2007,0.002479,74.125.68.0-255,66,327,64,459
2008,0.0025,74.125.68.0-255,66,393,64,459
2009,0.002515,172.31.40.0-255,66,459,64,459
2010,0.0,74.125.24.0-255,152,152,64,227951
2011,1.4e-05,172.31.40.0-255,66,218,64,227951
2012,2.1e-05,74.125.24.0-255,1484,1702,64,227951
2013,2.4e-05,172.31.40.0-255,66,1768,64,227951
2014,2.7e-05,74.125.24.0-255,1484,3252,64,227951
2015,3e-05,172.31.40.0-255,66,3318,64,227951
2016,4.8e-05,74.125.24.0-255,1484,4802,64,227951
2017,5e-05,172.31.40.0-255,66,4868,64,227951
2018,6e-05,74.125.24.0-255,7156,12024,64,227951
2019,6.2e-05,172.31.40.0-255,66,12090,64,227951
2020,0.000101,172.31.40.0-255,66,12156,64,227951
2021,0.000128,172.31.40.0-255,66,12222,64,227951
2022,0.000213,74.125.24.0-255,1484,13706,64,227951
2023,0.000216,172.31.40.0-255,66,13772,64,227951
2024,0.00022,74.125.24.0-255,1484,15256,64,227951
2025,0.000222,172.31.40.0-255,66,15322,64,227951
2026,0.000237,74.125.24.0-255,1484,16806,64,227951
2027,0.000239,172.31.40.0-255,66,16872,64,227951
2028,0.000245,74.125.24.0-255,5738,22610,64,227951
2029,0.000248,172.31.40.0-255,66,22676,64,227951
2030,0.000253,74.125.24.0-255,4320,26996,64,227951
2031,0.000256,172.31.40.0-255,66,27062,64,227951
2032,0.000294,74.125.24.0-255,4320,31382,64,227951
2033,0.000296,172.31.40.0-255,66,31448,64,227951
2034,0.000323,172.31.40.0-255,66,31514,64,227951
2035,0.000329,74.125.24.0-255,5738,37252,64,227951
2036,0.000332,172.31.40.0-255,66,37318,64,227951
2037,0.000389,74.125.24.0-255,1469,38787,64,227951
2038,0.000392,172.31.40.0-255,66,38853,64,227951
2039,0.000467,74.125.24.0-255,1484,40337,64,227951
2040,0.000482,74.125.24.0-255,2902,43239,64,227951
2041,0.000485,172.31.40.0-255,66,43305,64,227951
2042,0.000511,74.125.24.0-255,5738,49043,64,227951
2043,0.000514,172.31.40.0-255,66,49109,64,227951
2044,0.000521,74.125.24.0-255,5738,54847,64,227951
2045,0.000523,172.31.40.0-255,66,54913,64,227951
2046,0.000531,172.31.40.0-255,101,55014,64,227951
2047,0.000551,74.125.24.0-255,5738,60752,64,227951
2048,0.000555,172.31.40.0-255,66,60818,64,227951
2049,0.000588,172.31.40.0-255,66,60884,64,227951
2050,0.000593,74.125.24.0-255,4216,65100,64,227951
2051,0.000596,172.31.40.0-255,66,65166,64,227951
2052,0.000725,74.125.24.0-255,1484,66650,64,227951
2053,0.000731,74.125.24.0-255,2902,69552,64,227951
2054,0.000735,172.31.40.0-255,66,69618,64,227951
2055,0.000758,74.125.24.0-255,5738,75356,64,227951
2056,0.000761,172.31.40.0-255,66,75422,64,227951
2057,0.000767,74.125.24.0-255,5738,81160,64,227951
2058,0.000769,172.31.40.0-255,66,81226,64,227951
2059,0.000792,74.125.24.0-255,4320,85546,64,227951
2060,0.000795,172.31.40.0-255,66,85612,64,227951
2061,0.000823,172.31.40.0-255,66,85678,64,227951
2062,0.000829,74.125.24.0-255,5020,90698,64,227951
2063,0.000831,172.31.40.0-255,66,90764,64,227951
2064,0.000865,74.125.24.0-255,1484,92248,64,227951
2065,0.000885,74.125.24.0-255,2902,95150,64,227951
2066,0.000888,172.31.40.0-255,66,95216,64,227951
2067,0.000892,74.125.24.0-255,2902,98118,64,227951
2068,0.000894,172.31.40.0-255,66,98184,64,227951
2069,0.000914,74.125.24.0-255,2902,101086,64,227951
2070,0.000916,172.31.40.0-255,66,101152,64,227951
2071,0.000921,74.125.24.0-255,4320,105472,64,227951
2072,0.000923,172.31.40.0-255,66,105538,64,227951
2073,0.000947,74.125.24.0-255,7156,112694,64,227951
2074,0.000951,172.31.40.0-255,66,112760,64,227951
2075,0.00098,172.31.40.0-255,66,112826,64,227951
2076,0.001191,74.125.24.0-255,1484,114310,64,227951
2077,0.001198,74.125.24.0-255,2902,117212,64,227951
2078,0.001202,172.31.40.0-255,66,117278,64,227951
2079,0.001241,74.125.24.0-255,2902,120180,64,227951
2080,0.001244,172.31.40.0-255,66,120246,64,227951
2081,0.001265,74.125.24.0-255,2902,123148,64,227951
2082,0.001269,172.31.40.0-255,66,123214,64,227951
2083,0.001273,74.125.24.0-255,2902,126116,64,227951
2084,0.001275,172.31.40.0-255,66,126182,64,227951
2085,0.001287,172.31.40.0-255,66,126248,64,227951
2086,0.001298,172.31.40.0-255,66,126314,64,227951
2087,0.001311,74.125.24.0-255,2184,128498,64,227951
2088,0.001313,172.31.40.0-255,66,128564,64,227951
2089,0.001379,74.125.24.0-255,1484,130048,64,227951
2090,0.001384,74.125.24.0-255,1484,131532,64,227951
2091,0.001387,172.31.40.0-255,66,131598,64,227951
2092,0.001403,74.125.24.0-255,1484,133082,64,227951
2093,0.00141,74.125.24.0-255,5738,138820,64,227951
2094,0.001413,172.31.40.0-255,66,138886,64,227951
2095,0.001419,74.125.24.0-255,7156,146042,64,227951
2096,0.001422,172.31.40.0-255,66,146108,64,227951
2097,0.00146,172.31.40.0-255,66,146174,64,227951
2098,0.001464,74.125.24.0-255,2184,148358,64,227951
2099,0.001466,172.31.40.0-255,66,148424,64,227951
2100,0.001507,74.125.24.0-255,2902,151326,64,227951
2101,0.00151,172.31.40.0-255,66,151392,64,227951
2102,0.001513,74.125.24.0-255,1484,152876,64,227951
2103,0.001533,74.125.24.0-255,2902,155778,64,227951
2104,0.001536,172.31.40.0-255,66,155844,64,227951
2105,0.001551,172.31.40.0-255,66,155910,64,227951
2106,0.001576,74.125.24.0-255,7156,163066,64,227951
2107,0.00158,172.31.40.0-255,66,163132,64,227951
2108,0.00161,172.31.40.0-255,66,163198,64,227951
2109,0.001721,74.125.24.0-255,1484,164682,64,227951
2110,0.001727,74.125.24.0-255,1484,166166,64,227951
2111,0.00173,172.31.40.0-255,66,166232,64,227951
2112,0.001753,74.125.24.0-255,1484,167716,64,227951
2113,0.001759,74.125.24.0-255,5738,173454,64,227951
2114,0.001763,172.31.40.0-255,66,173520,64,227951
2115,0.00177,74.125.24.0-255,7156,180676,64,227951
2116,0.001772,172.31.40.0-255,66,180742,64,227951
2117,0.001815,172.31.40.0-255,66,180808,64,227951
2118,0.001819,74.125.24.0-255,2184,182992,64,227951
2119,0.001821,172.31.40.0-255,66,183058,64,227951
2120,0.001886,74.125.24.0-255,1484,184542,64,227951
2121,0.001901,74.125.24.0-255,2902,187444,64,227951
2122,0.001905,172.31.40.0-255,66,187510,64,227951
2123,0.001908,74.125.24.0-255,1484,188994,64,227951
2124,0.001927,74.125.24.0-255,4320,193314,64,227951
2125,0.00193,172.31.40.0-255,66,193380,64,227951
2126,0.001946,74.125.24.0-255,4320,197700,64,227951
2127,0.001948,172.31.40.0-255,66,197766,64,227951
2128,0.001973,172.31.40.0-255,66,197832,64,227951
2129,0.001985,172.31.40.0-255,66,197898,64,227951
2130,0.002033,74.125.24.0-255,1484,199382,64,227951
2131,0.00204,74.125.24.0-255,2902,202284,64,227951
2132,0.002042,172.31.40.0-255,66,202350,64,227951
2133,0.002049,74.125.24.0-255,5738,208088,64,227951
2134,0.002052,172.31.40.0-255,66,208154,64,227951
2135,0.002091,172.31.40.0-255,66,208220,64,227951
2136,0.002094,74.125.24.0-255,1484,209704,64,227951
2137,0.002107,172.31.40.0-255,66,209770,64,227951
2138,0.002178,172.31.40.0-255,66,209836,64,227951
2139,0.00219,172.31.40.0-255,66,209902,64,227951
2140,0.002208,74.125.24.0-255,3602,213504,64,227951
2141,0.002211,172.31.40.0-255,66,213570,64,227951
2142,0.00249,74.125.24.0-255,66,213636,64,227951
2143,0.00269,74.125.24.0-255,1484,215120,64,227951
2144,0.002708,74.125.24.0-255,2902,218022,64,227951
2145,0.002712,172.31.40.0-255,66,218088,64,227951
2146,0.002716,74.125.24.0-255,1484,219572,64,227951
2147,0.002732,74.125.24.0-255,2594,222166,64,227951
2148,0.002734,172.31.40.0-255,66,222232,64,227951
2149,0.002776,74.125.24.0-255,105,222337,64,227951
2150,0.008455,172.31.40.0-255,105,222442,64,227951
2151,0.01621,74.125.24.0-255,66,222508,64,227951
2152,0.027292,172.31.40.0-255,167,222675,64,227951
2153,0.027326,172.31.40.0-255,1112,223787,64,227951
2154,0.027388,172.31.40.0-255,1514,225301,64,227951
2155,0.027389,172.31.40.0-255,1514,226815,64,227951
2156,0.02739,172.31.40.0-255,698,227513,64,227951
2157,0.028798,104.244.42.0-255,66,227579,64,227951
2158,0.028826,104.244.42.0-255,66,227645,64,227951
2159,0.028898,104.244.42.0-255,66,227711,64,227951
2160,0.028912,104.244.42.0-255,66,227777,64,227951
2161,0.029495,104.244.42.0-255,108,227885,64,227951
2162,0.029501,172.31.40.0-255,66,227951,64,227951
2163,0.0,172.31.40.0-255,105,105,64,459
2164,0.000233,172.31.40.0-255,90,195,64,459
2165,0.000244,172.31.40.0-255,66,261,64,459
2166,0.002503,74.125.68.0-255,66,327,64,459
2167,0.002525,74.125.68.0-255,66,393,64,459
2168,0.002543,172.31.40.0-255,66,459,64,459
2169,0.0,74.125.24.0-255,150,150,64,292535
2170,1.9e-05,172.31.40.0-255,66,216,64,292535
2171,2.7e-05,74.125.24.0-255,1484,1700,64,292535
2172,3.2e-05,172.31.40.0-255,66,1766,64,292535
2173,3.8e-05,74.125.24.0-255,2902,4668,64,292535
2174,4.1e-05,172.31.40.0-255,66,4734,64,292535
2175,4.9e-05,74.125.24.0-255,7156,11890,64,292535
2176,5.2e-05,172.31.40.0-255,66,11956,64,292535
2177,5.6e-05,74.125.24.0-255,2100,14056,64,292535
2178,5.9e-05,172.31.40.0-255,66,14122,64,292535
2179,0.000252,74.125.24.0-255,1484,15606,64,292535
2180,0.000257,172.31.40.0-255,66,15672,64,292535
2181,0.000262,74.125.24.0-255,2902,18574,64,292535
2182,0.000265,172.31.40.0-255,66,18640,64,292535
2183,0.000269,74.125.24.0-255,2902,21542,64,292535
2184,0.000272,172.31.40.0-255,66,21608,64,292535
2185,0.000293,74.125.24.0-255,2902,24510,64,292535
2186,0.000296,172.31.40.0-255,66,24576,64,292535
2187,0.000312,74.125.24.0-255,2902,27478,64,292535
2188,0.000314,172.31.40.0-255,66,27544,64,292535
2189,0.000338,74.125.24.0-255,3961,31505,64,292535
2190,0.000341,172.31.40.0-255,66,31571,64,292535
2191,0.000524,74.125.24.0-255,1484,33055,64,292535
2192,0.000529,172.31.40.0-255,66,33121,64,292535
2193,0.000534,74.125.24.0-255,2902,36023,64,292535
2194,0.000537,172.31.40.0-255,66,36089,64,292535
2195,0.000543,74.125.24.0-255,5738,41827,64,292535
2196,0.000545,172.31.40.0-255,66,41893,64,292535
2197,0.000571,74.125.24.0-255,4320,46213,64,292535
2198,0.000574,172.31.40.0-255,66,46279,64,292535
2199,0.000592,74.125.24.0-255,2543,48822,64,292535
2200,0.000595,172.31.40.0-255,66,48888,64,292535
2201,0.00065,74.125.24.0-255,1484,50372,64,292535
2202,0.000654,74.125.24.0-255,1484,51856,64,292535
2203,0.000657,172.31.40.0-255,66,51922,64,292535
2204,0.000676,74.125.24.0-255,1484,53406,64,292535
2205,0.000682,74.125.24.0-255,5738,59144,64,292535
2206,0.000685,172.31.40.0-255,66,59210,64,292535
2207,0.000689,74.125.24.0-255,2902,62112,64,292535
2208,0.000691,172.31.40.0-255,66,62178,64,292535
2209,0.000725,74.125.24.0-255,3961,66139,64,292535
2210,0.000728,172.31.40.0-255,66,66205,64,292535
2211,0.001,74.125.24.0-255,646,66851,64,292535
2212,0.001092,172.31.40.0-255,66,66917,64,292535
2213,0.001204,74.125.24.0-255,1484,68401,64,292535
2214,0.001212,74.125.24.0-255,1484,69885,64,292535
2215,0.001215,172.31.40.0-255,66,69951,64,292535
2216,0.001235,74.125.24.0-255,1484,71435,64,292535
2217,0.00124,74.125.24.0-255,2902,74337,64,292535
2218,0.001242,172.31.40.0-255,66,74403,64,292535
2219,0.001247,74.125.24.0-255,4320,78723,64,292535
2220,0.001249,172.31.40.0-255,66,78789,64,292535
2221,0.001287,74.125.24.0-255,5379,84168,64,292535
2222,0.001289,172.31.40.0-255,66,84234,64,292535
2223,0.001345,74.125.24.0-255,4320,88554,64,292535
2224,0.001348,172.31.40.0-255,66,88620,64,292535
2225,0.001365,74.125.24.0-255,1484,90104,64,292535
2226,0.001371,74.125.24.0-255,4320,94424,64,292535
2227,0.001373,172.31.40.0-255,66,94490,64,292535
2228,0.001378,74.125.24.0-255,2902,97392,64,292535
2229,0.00138,172.31.40.0-255,66,97458,64,292535
2230,0.001398,74.125.24.0-255,3961,101419,64,292535
2231,0.0014,172.31.40.0-255,66,101485,64,292535
2232,0.001749,74.125.24.0-255,1484,102969,64,292535
2233,0.001758,74.125.24.0-255,2902,105871,64,292535
2234,0.001762,172.31.40.0-255,66,105937,64,292535
2235,0.00177,74.125.24.0-255,5738,111675,64,292535
2236,0.001772,172.31.40.0-255,66,111741,64,292535
2237,0.001791,74.125.24.0-255,5738,117479,64,292535
2238,0.001793,172.31.40.0-255,66,117545,64,292535
2239,0.001817,74.125.24.0-255,7156,124701,64,292535
2240,0.001819,172.31.40.0-255,66,124767,64,292535
2241,0.001829,172.31.40.0-255,66,124833,64,292535
2242,0.001854,74.125.24.0-255,2184,127017,64,292535
2243,0.001857,172.31.40.0-255,66,127083,64,292535
2244,0.003852,74.125.24.0-255,5738,132821,64,292535
2245,0.00386,172.31.40.0-255,66,132887,64,292535
2246,0.005887,74.125.24.0-255,4320,137207,64,292535
2247,0.005894,172.31.40.0-255,66,137273,64,292535
2248,0.005914,74.125.24.0-255,1484,138757,64,292535
2249,0.007942,74.125.24.0-255,4320,143077,64,292535
2250,0.007949,172.31.40.0-255,66,143143,64,292535
2251,0.009947,74.125.24.0-255,5738,148881,64,292535
2252,0.009954,172.31.40.0-255,66,148947,64,292535
2253,0.011954,74.125.24.0-255,5738,154685,64,292535
2254,0.011963,172.31.40.0-255,66,154751,64,292535
2255,0.013973,74.125.24.0-255,5738,160489,64,292535
2256,0.013983,172.31.40.0-255,66,160555,64,292535
2257,0.016001,74.125.24.0-255,5738,166293,64,292535
2258,0.01601,172.31.40.0-255,66,166359,64,292535
2259,0.018047,74.125.24.0-255,5738,172097,64,292535
2260,0.018055,172.31.40.0-255,66,172163,64,292535
2261,0.020067,74.125.24.0-255,5738,177901,64,292535
2262,0.020074,172.31.40.0-255,66,177967,64,292535
2263,0.022079,74.125.24.0-255,5738,183705,64,292535
2264,0.022087,172.31.40.0-255,66,183771,64,292535
2265,0.024076,74.125.24.0-255,5738,189509,64,292535
2266,0.024084,172.31.40.0-255,66,189575,64,292535
2267,0.026114,74.125.24.0-255,5738,195313,64,292535
2268,0.026122,172.31.40.0-255,66,195379,64,292535
2269,0.028155,74.125.24.0-255,5738,201117,64,292535
2270,0.028164,172.31.40.0-255,66,201183,64,292535
2271,0.030186,74.125.24.0-255,5738,206921,64,292535
2272,0.030194,172.31.40.0-255,66,206987,64,292535
2273,0.032214,74.125.24.0-255,5738,212725,64,292535
2274,0.032221,172.31.40.0-255,66,212791,64,292535
2275,0.034221,74.125.24.0-255,5738,218529,64,292535
2276,0.034228,172.31.40.0-255,66,218595,64,292535
2277,0.036256,74.125.24.0-255,5738,224333,64,292535
2278,0.036265,172.31.40.0-255,66,224399,64,292535
2279,0.038259,74.125.24.0-255,5738,230137,64,292535
2280,0.038266,172.31.40.0-255,66,230203,64,292535
2281,0.038436,172.31.40.0-255,172,230375,64,292535
2282,0.038467,172.31.40.0-255,1113,231488,64,292535
2283,0.038523,172.31.40.0-255,1514,233002,64,292535
2284,0.038525,172.31.40.0-255,1295,234297,64,292535
2285,0.039959,104.244.42.0-255,66,234363,64,292535
2286,0.040062,104.244.42.0-255,66,234429,64,292535
2287,0.040111,104.244.42.0-255,66,234495,64,292535
2288,0.040289,74.125.24.0-255,5738,240233,64,292535
2289,0.040295,172.31.40.0-255,66,240299,64,292535
2290,0.04231,74.125.24.0-255,5738,246037,64,292535
2291,0.042317,172.31.40.0-255,66,246103,64,292535
2292,0.044352,74.125.24.0-255,5738,251841,64,292535
2293,0.044375,172.31.40.0-255,66,251907,64,292535
2294,0.046439,74.125.24.0-255,5738,257645,64,292535
2295,0.046458,172.31.40.0-255,66,257711,64,292535
2296,0.048484,74.125.24.0-255,5738,263449,64,292535
2297,0.048496,172.31.40.0-255,66,263515,64,292535
2298,0.050575,74.125.24.0-255,5738,269253,64,292535
2299,0.050591,172.31.40.0-255,66,269319,64,292535
2300,0.052612,74.125.24.0-255,5738,275057,64,292535
2301,0.052629,172.31.40.0-255,66,275123,64,292535
2302,0.054679,74.125.24.0-255,5738,280861,64,292535
2303,0.054695,172.31.40.0-255,66,280927,64,292535
2304,0.056746,74.125.24.0-255,5738,286665,64,292535
2305,0.056757,172.31.40.0-255,66,286731,64,292535
2306,0.058812,74.125.24.0-255,5738,292469,64,292535
2307,0.058821,172.31.40.0-255,66,292535,64,292535
2308,0.0,172.217.194.0-255,143,143,64,245885
2309,2.2e-05,172.31.40.0-255,66,209,64,245885
2310,2.9e-05,172.217.194.0-255,1484,1693,64,245885
2311,3.4e-05,172.31.40.0-255,66,1759,64,245885
2312,4.6e-05,172.217.194.0-255,2902,4661,64,245885
2313,5e-05,172.31.40.0-255,66,4727,64,245885
2314,5.6e-05,172.217.194.0-255,4320,9047,64,245885
2315,5.9e-05,172.31.40.0-255,66,9113,64,245885
2316,7.6e-05,172.217.194.0-255,1484,10597,64,245885
2317,7.9e-05,172.31.40.0-255,66,10663,64,245885
2318,8.9e-05,172.217.194.0-255,3457,14120,64,245885
2319,9.2e-05,172.31.40.0-255,66,14186,64,245885
2320,0.000151,172.217.194.0-255,1484,15670,64,245885
2321,0.000154,172.31.40.0-255,66,15736,64,245885
2322,0.000172,172.217.194.0-255,2902,18638,64,245885
2323,0.000174,172.31.40.0-255,66,18704,64,245885
2324,0.000179,172.217.194.0-255,2902,21606,64,245885
2325,0.000181,172.31.40.0-255,66,21672,64,245885
2326,0.0002,172.217.194.0-255,2902,24574,64,245885
2327,0.000203,172.31.40.0-255,66,24640,64,245885
2328,0.000215,172.217.194.0-255,6797,31437,64,245885
2329,0.000217,172.31.40.0-255,66,31503,64,245885
2330,0.00025,172.217.194.0-255,4320,35823,64,245885
2331,0.000252,172.31.40.0-255,66,35889,64,245885
2332,0.000259,172.217.194.0-255,5738,41627,64,245885
2333,0.000261,172.31.40.0-255,66,41693,64,245885
2334,0.000305,172.217.194.0-255,6797,48490,64,245885
2335,0.000308,172.31.40.0-255,66,48556,64,245885
2336,0.000622,172.217.194.0-255,1484,50040,64,245885
2337,0.000637,172.31.40.0-255,66,50106,64,245885
2338,0.000644,172.217.194.0-255,2902,53008,64,245885
2339,0.000647,172.31.40.0-255,66,53074,64,245885
2340,0.000651,172.217.194.0-255,2902,55976,64,245885
2341,0.000657,172.31.40.0-255,66,56042,64,245885
2342,0.000664,172.217.194.0-255,7156,63198,64,245885
2343,0.000666,172.31.40.0-255,66,63264,64,245885
2344,0.000695,172.217.194.0-255,3123,66387,64,245885
2345,0.000697,172.31.40.0-255,66,66453,64,245885
2346,0.000734,172.217.194.0-255,2902,69355,64,245885
2347,0.000736,172.31.40.0-255,66,69421,64,245885
2348,0.000746,172.217.194.0-255,1484,70905,64,245885
2349,0.000754,172.217.194.0-255,2902,73807,64,245885
2350,0.000756,172.31.40.0-255,66,73873,64,245885
2351,0.000781,172.217.194.0-255,2902,76775,64,245885
2352,0.000783,172.31.40.0-255,66,76841,64,245885
2353,0.000811,172.217.194.0-255,6797,83638,64,245885
2354,0.000813,172.31.40.0-255,66,83704,64,245885
2355,0.001007,172.217.194.0-255,1484,85188,64,245885
2356,0.001013,172.217.194.0-255,2902,88090,64,245885
2357,0.001016,172.31.40.0-255,66,88156,64,245885
2358,0.001045,172.217.194.0-255,5738,93894,64,245885
2359,0.001048,172.31.40.0-255,66,93960,64,245885
2360,0.001055,172.217.194.0-255,7156,101116,64,245885
2361,0.001057,172.31.40.0-255,66,101182,64,245885
2362,0.001079,172.217.194.0-255,5738,106920,64,245885
2363,0.001082,172.31.40.0-255,66,106986,64,245885
2364,0.001117,172.31.40.0-255,66,107052,64,245885
2365,0.001121,172.217.194.0-255,2184,109236,64,245885
2366,0.001123,172.31.40.0-255,66,109302,64,245885
2367,0.001298,172.217.194.0-255,1484,110786,64,245885
2368,0.001303,172.217.194.0-255,2902,113688,64,245885
2369,0.001306,172.31.40.0-255,66,113754,64,245885
2370,0.001328,172.217.194.0-255,5738,119492,64,245885
2371,0.00133,172.31.40.0-255,66,119558,64,245885
2372,0.001361,172.31.40.0-255,66,119624,64,245885
2373,0.001367,172.217.194.0-255,5738,125362,64,245885
2374,0.001368,172.31.40.0-255,66,125428,64,245885
2375,0.00139,172.217.194.0-255,2902,128330,64,245885
2376,0.001393,172.31.40.0-255,66,128396,64,245885
2377,0.001398,172.217.194.0-255,5738,134134,64,245885
2378,0.0014,172.31.40.0-255,66,134200,64,245885
2379,0.001433,172.31.40.0-255,66,134266,64,245885
2380,0.001439,172.217.194.0-255,5020,139286,64,245885
2381,0.001441,172.31.40.0-255,66,139352,64,245885
2382,0.001475,172.217.194.0-255,5738,145090,64,245885
2383,0.001477,172.31.40.0-255,66,145156,64,245885
2384,0.001483,172.217.194.0-255,7156,152312,64,245885
2385,0.001485,172.31.40.0-255,66,152378,64,245885
2386,0.001489,172.217.194.0-255,2902,155280,64,245885
2387,0.001496,172.31.40.0-255,66,155346,64,245885
2388,0.001537,172.31.40.0-255,66,155412,64,245885
2389,0.001543,172.217.194.0-255,6438,161850,64,245885
2390,0.001545,172.31.40.0-255,66,161916,64,245885
2391,0.001558,172.217.194.0-255,1484,163400,64,245885
2392,0.001587,172.31.40.0-255,66,163466,64,245885
2393,0.001602,172.31.40.0-255,66,163532,64,245885
2394,0.001628,172.217.194.0-255,2902,166434,64,245885
2395,0.00163,172.31.40.0-255,66,166500,64,245885
2396,0.001663,172.31.40.0-255,66,166566,64,245885
2397,0.001701,172.31.40.0-255,66,166632,64,245885
2398,0.001717,172.31.40.0-255,66,166698,64,245885
2399,0.001743,172.217.194.0-255,4320,171018,64,245885
2400,0.001745,172.31.40.0-255,66,171084,64,245885
2401,0.001752,172.217.194.0-255,6438,177522,64,245885
2402,0.001917,172.217.194.0-255,1484,179006,64,245885
2403,0.001932,172.217.194.0-255,2902,181908,64,245885
2404,0.001935,172.217.194.0-255,1484,183392,64,245885
2405,0.001955,172.217.194.0-255,4320,187712,64,245885
2406,0.002028,172.217.194.0-255,2184,189896,64,245885
2407,0.002042,172.217.194.0-255,1484,191380,64,245885
2408,0.002053,172.217.194.0-255,1484,192864,64,245885
2409,0.002057,172.217.194.0-255,2902,195766,64,245885
2410,0.002076,172.217.194.0-255,4320,200086,64,245885
2411,0.002082,172.217.194.0-255,5738,205824,64,245885
2412,0.002102,172.217.194.0-255,5738,211562,64,245885
2413,0.002124,172.217.194.0-255,4320,215882,64,245885
2414,0.00214,172.217.194.0-255,1484,217366,64,245885
2415,0.002219,172.217.194.0-255,4320,221686,64,245885
2416,0.002257,172.217.194.0-255,7156,228842,64,245885
2417,0.002259,172.217.194.0-255,1484,230326,64,245885
2418,0.002277,172.217.194.0-255,5738,236064,64,245885
2419,0.002289,172.217.194.0-255,5020,241084,64,245885
2420,0.004615,172.31.40.0-255,66,241150,64,245885
2421,0.006888,172.217.194.0-255,105,241255,64,245885
2422,0.007331,172.31.40.0-255,101,241356,64,245885
2423,0.007644,172.31.40.0-255,105,241461,64,245885
2424,0.009805,172.217.194.0-255,66,241527,64,245885
2425,0.010112,172.217.194.0-255,66,241593,64,245885
2426,0.030135,172.31.40.0-255,172,241765,64,245885
2427,0.030167,172.31.40.0-255,1111,242876,64,245885
2428,0.03023,172.31.40.0-255,1514,244390,64,245885
2429,0.030232,172.31.40.0-255,1297,245687,64,245885
2430,0.031645,104.244.42.0-255,66,245753,64,245885
2431,0.031689,104.244.42.0-255,66,245819,64,245885
2432,0.031782,104.244.42.0-255,66,245885,64,245885
2433,0.0,74.125.68.0-255,153,153,64,284196
2434,2.3e-05,172.31.40.0-255,66,219,64,284196
2435,3.1e-05,74.125.68.0-255,1484,1703,64,284196
2436,3.5e-05,172.31.40.0-255,66,1769,64,284196
2437,4.1e-05,74.125.68.0-255,2902,4671,64,284196
2438,4.4e-05,172.31.40.0-255,66,4737,64,284196
2439,6.3e-05,74.125.68.0-255,1484,6221,64,284196
2440,6.6e-05,172.31.40.0-255,66,6287,64,284196
2441,8.4e-05,74.125.68.0-255,2902,9189,64,284196
2442,8.7e-05,172.31.40.0-255,66,9255,64,284196
2443,0.0001,74.125.68.0-255,1484,10739,64,284196
2444,0.000102,172.31.40.0-255,66,10805,64,284196
2445,0.000107,74.125.68.0-255,2902,13707,64,284196
2446,0.00011,172.31.40.0-255,66,13773,64,284196
2447,0.000143,74.125.68.0-255,4320,18093,64,284196
2448,0.000145,172.31.40.0-255,66,18159,64,284196
2449,0.000165,74.125.68.0-255,2100,20259,64,284196
2450,0.000168,172.31.40.0-255,66,20325,64,284196
2451,0.000173,74.125.68.0-255,2902,23227,64,284196
2452,0.000175,172.31.40.0-255,66,23293,64,284196
2453,0.000179,74.125.68.0-255,1484,24777,64,284196
2454,0.00018,172.31.40.0-255,66,24843,64,284196
2455,0.000207,74.125.68.0-255,2902,27745,64,284196
2456,0.000209,172.31.40.0-255,66,27811,64,284196
2457,0.000215,74.125.68.0-255,3961,31772,64,284196
2458,0.000217,172.31.40.0-255,66,31838,64,284196
2459,0.000301,74.125.68.0-255,1484,33322,64,284196
2460,0.000304,172.31.40.0-255,66,33388,64,284196
2461,0.000324,74.125.68.0-255,2902,36290,64,284196
2462,0.000326,172.31.40.0-255,66,36356,64,284196
2463,0.000354,74.125.68.0-255,5738,42094,64,284196
2464,0.000357,172.31.40.0-255,66,42160,64,284196
2465,0.000363,74.125.68.0-255,5738,47898,64,284196
2466,0.000365,172.31.40.0-255,66,47964,64,284196
2467,0.000386,74.125.68.0-255,1484,49448,64,284196
2468,0.000389,172.31.40.0-255,66,49514,64,284196
2469,0.000414,74.125.68.0-255,5379,54893,64,284196
2470,0.000417,172.31.40.0-255,66,54959,64,284196
2471,0.000421,74.125.68.0-255,2902,57861,64,284196
2472,0.000423,172.31.40.0-255,66,57927,64,284196
2473,0.000429,74.125.68.0-255,4320,62247,64,284196
2474,0.000431,172.31.40.0-255,66,62313,64,284196
2475,0.000471,74.125.68.0-255,4271,66584,64,284196
2476,0.000474,172.31.40.0-255,66,66650,64,284196
2477,0.000492,74.125.68.0-255,377,67027,64,284196
2478,0.000629,74.125.68.0-255,1484,68511,64,284196
2479,0.000647,74.125.68.0-255,2902,71413,64,284196
2480,0.000651,74.125.68.0-255,1484,72897,64,284196
2481,0.000668,74.125.68.0-255,4320,77217,64,284196
2482,0.000673,74.125.68.0-255,2902,80119,64,284196
2483,0.00069,74.125.68.0-255,4320,84439,64,284196
2484,0.000714,74.125.68.0-255,4320,88759,64,284196
2485,0.000765,74.125.68.0-255,3602,92361,64,284196
2486,0.001554,172.31.40.0-255,66,92427,64,284196
2487,0.001857,74.125.68.0-255,1484,93911,64,284196
2488,0.001864,74.125.68.0-255,2902,96813,64,284196
2489,0.001867,74.125.68.0-255,1484,98297,64,284196
2490,0.001882,74.125.68.0-255,2902,101199,64,284196
2491,0.001892,172.31.40.0-255,66,101265,64,284196
2492,0.001925,74.125.68.0-255,2902,104167,64,284196
2493,0.001937,172.31.40.0-255,66,104233,64,284196
2494,0.00195,74.125.68.0-255,4320,108553,64,284196
2495,0.002013,74.125.68.0-255,4320,112873,64,284196
2496,0.002017,74.125.68.0-255,4320,117193,64,284196
2497,0.00202,172.31.40.0-255,66,117259,64,284196
2498,0.002025,172.31.40.0-255,66,117325,64,284196
2499,0.003997,74.125.68.0-255,5738,123063,64,284196
2500,0.004003,172.31.40.0-255,66,123129,64,284196
2501,0.005964,74.125.68.0-255,5738,128867,64,284196
2502,0.005968,172.31.40.0-255,66,128933,64,284196
2503,0.007929,74.125.68.0-255,2902,131835,64,284196
2504,0.007942,74.125.68.0-255,2902,134737,64,284196
2505,0.009058,172.31.40.0-255,66,134803,64,284196
2506,0.011043,74.125.68.0-255,5738,140541,64,284196
2507,0.011055,172.31.40.0-255,66,140607,64,284196
2508,0.013024,74.125.68.0-255,5738,146345,64,284196
2509,0.013032,172.31.40.0-255,66,146411,64,284196
2510,0.015,74.125.68.0-255,5738,152149,64,284196
2511,0.015007,172.31.40.0-255,66,152215,64,284196
2512,0.016981,74.125.68.0-255,5738,157953,64,284196
2513,0.016992,172.31.40.0-255,66,158019,64,284196
2514,0.018969,74.125.68.0-255,5738,163757,64,284196
2515,0.018977,172.31.40.0-255,66,163823,64,284196
2516,0.020946,74.125.68.0-255,5738,169561,64,284196
2517,0.020954,172.31.40.0-255,66,169627,64,284196
2518,0.022928,74.125.68.0-255,5738,175365,64,284196
2519,0.022936,172.31.40.0-255,66,175431,64,284196
2520,0.024916,74.125.68.0-255,5738,181169,64,284196
2521,0.024926,172.31.40.0-255,66,181235,64,284196
2522,0.0269,74.125.68.0-255,5738,186973,64,284196
2523,0.026907,172.31.40.0-255,66,187039,64,284196
2524,0.028883,74.125.68.0-255,5738,192777,64,284196
2525,0.02889,172.31.40.0-255,66,192843,64,284196
2526,0.030866,74.125.68.0-255,5738,198581,64,284196
2527,0.030874,172.31.40.0-255,66,198647,64,284196
2528,0.032857,74.125.68.0-255,5738,204385,64,284196
2529,0.032864,172.31.40.0-255,66,204451,64,284196
2530,0.034136,172.31.40.0-255,171,204622,64,284196
2531,0.034167,172.31.40.0-255,1137,205759,64,284196
2532,0.034227,172.31.40.0-255,1514,207273,64,284196
2533,0.034229,172.31.40.0-255,1273,208546,64,284196
2534,0.034856,74.125.68.0-255,5738,214284,64,284196
2535,0.034863,172.31.40.0-255,66,214350,64,284196
2536,0.035619,104.244.42.0-255,66,214416,64,284196
2537,0.035656,104.244.42.0-255,66,214482,64,284196
2538,0.035724,104.244.42.0-255,66,214548,64,284196
2539,0.036841,74.125.68.0-255,5738,220286,64,284196
2540,0.036849,172.31.40.0-255,66,220352,64,284196
2541,0.038827,74.125.68.0-255,5738,226090,64,284196
2542,0.038841,172.31.40.0-255,66,226156,64,284196
2543,0.04083,74.125.68.0-255,5738,231894,64,284196
2544,0.040844,172.31.40.0-255,66,231960,64,284196
2545,0.042827,74.125.68.0-255,5738,237698,64,284196
2546,0.042841,172.31.40.0-255,66,237764,64,284196
2547,0.044817,74.125.68.0-255,5738,243502,64,284196
2548,0.044828,172.31.40.0-255,66,243568,64,284196
2549,0.046805,74.125.68.0-255,5738,249306,64,284196
2550,0.046826,172.31.40.0-255,66,249372,64,284196
2551,0.048808,74.125.68.0-255,5738,255110,64,284196
2552,0.048821,172.31.40.0-255,66,255176,64,284196
2553,0.05079,74.125.68.0-255,5738,260914,64,284196
2554,0.050798,172.31.40.0-255,66,260980,64,284196
2555,0.052766,74.125.68.0-255,5738,266718,64,284196
2556,0.052773,172.31.40.0-255,66,266784,64,284196
2557,0.05474,74.125.68.0-255,5738,272522,64,284196
2558,0.054749,172.31.40.0-255,66,272588,64,284196
2559,0.056734,74.125.68.0-255,5738,278326,64,284196
2560,0.056749,172.31.40.0-255,66,278392,64,284196
2561,0.058733,74.125.68.0-255,5738,284130,64,284196
2562,0.058748,172.31.40.0-255,66,284196,64,284196
2563,0.0,74.125.24.0-255,296,296,64,267383
2564,2.3e-05,172.31.40.0-255,66,362,64,267383
2565,3e-05,74.125.24.0-255,1484,1846,64,267383
2566,3.4e-05,172.31.40.0-255,66,1912,64,267383
2567,4.9e-05,74.125.24.0-255,4320,6232,64,267383
2568,5.3e-05,172.31.40.0-255,66,6298,64,267383
2569,5.8e-05,74.125.24.0-255,2902,9200,64,267383
2570,6.1e-05,172.31.40.0-255,66,9266,64,267383
2571,7.4e-05,172.31.40.0-255,66,9332,64,267383
2572,0.000136,172.31.40.0-255,66,9398,64,267383
2573,0.000173,74.125.24.0-255,1484,10882,64,267383
2574,0.000175,172.31.40.0-255,66,10948,64,267383
2575,0.000193,74.125.24.0-255,2902,13850,64,267383
2576,0.000196,172.31.40.0-255,66,13916,64,267383
2577,0.000202,74.125.24.0-255,5738,19654,64,267383
2578,0.000204,172.31.40.0-255,66,19720,64,267383
2579,0.000232,74.125.24.0-255,5738,25458,64,267383
2580,0.000234,172.31.40.0-255,66,25524,64,267383
2581,0.000266,172.31.40.0-255,66,25590,64,267383
2582,0.000274,74.125.24.0-255,7156,32746,64,267383
2583,0.000276,172.31.40.0-255,66,32812,64,267383
2584,0.000306,74.125.24.0-255,2814,35626,64,267383
2585,0.000311,172.31.40.0-255,66,35692,64,267383
2586,0.000322,74.125.24.0-255,384,36076,64,267383
2587,0.000328,172.31.40.0-255,66,36142,64,267383
2588,0.000531,74.125.24.0-255,1484,37626,64,267383
2589,0.000537,172.31.40.0-255,66,37692,64,267383
2590,0.000542,74.125.24.0-255,2902,40594,64,267383
2591,0.000544,172.31.40.0-255,66,40660,64,267383
2592,0.00055,74.125.24.0-255,4320,44980,64,267383
2593,0.000557,172.31.40.0-255,66,45046,64,267383
2594,0.000597,74.125.24.0-255,1484,46530,64,267383
2595,0.000611,172.31.40.0-255,66,46596,64,267383
2596,0.000629,172.31.40.0-255,66,46662,64,267383
2597,0.000665,74.125.24.0-255,1484,48146,64,267383
2598,0.000682,74.125.24.0-255,2902,51048,64,267383
2599,0.000684,172.31.40.0-255,66,51114,64,267383
2600,0.000692,74.125.24.0-255,5738,56852,64,267383
2601,0.000694,172.31.40.0-255,66,56918,64,267383
2602,0.000702,74.125.24.0-255,1484,58402,64,267383
2603,0.000727,74.125.24.0-255,5738,64140,64,267383
2604,0.00073,172.31.40.0-255,66,64206,64,267383
2605,0.000734,74.125.24.0-255,2902,67108,64,267383
2606,0.000737,172.31.40.0-255,66,67174,64,267383
2607,0.000765,172.31.40.0-255,66,67240,64,267383
2608,0.00077,74.125.24.0-255,2184,69424,64,267383
2609,0.000772,172.31.40.0-255,66,69490,64,267383
2610,0.000792,74.125.24.0-255,1484,70974,64,267383
2611,0.000811,74.125.24.0-255,2902,73876,64,267383
2612,0.000815,172.31.40.0-255,66,73942,64,267383
2613,0.000841,74.125.24.0-255,5738,79680,64,267383
2614,0.000844,172.31.40.0-255,66,79746,64,267383
2615,0.000857,172.31.40.0-255,66,79812,64,267383
2616,0.000872,172.31.40.0-255,66,79878,64,267383
2617,0.000897,74.125.24.0-255,2184,82062,64,267383
2618,0.0009,172.31.40.0-255,66,82128,64,267383
2619,0.001228,74.125.24.0-255,1484,83612,64,267383
2620,0.001233,74.125.24.0-255,1484,85096,64,267383
2621,0.001236,172.31.40.0-255,66,85162,64,267383
2622,0.001268,74.125.24.0-255,1484,86646,64,267383
2623,0.001273,74.125.24.0-255,2902,89548,64,267383
2624,0.001276,172.31.40.0-255,66,89614,64,267383
2625,0.001283,74.125.24.0-255,7156,96770,64,267383
2626,0.001285,172.31.40.0-255,66,96836,64,267383
2627,0.001319,172.31.40.0-255,66,96902,64,267383
2628,0.001349,74.125.24.0-255,5738,102640,64,267383
2629,0.001351,172.31.40.0-255,66,102706,64,267383
2630,0.001357,74.125.24.0-255,3053,105759,64,267383
2631,0.001359,172.31.40.0-255,66,105825,64,267383
2632,0.001368,74.125.24.0-255,1484,107309,64,267383
2633,0.001372,74.125.24.0-255,2902,110211,64,267383
2634,0.001374,172.31.40.0-255,66,110277,64,267383
2635,0.001473,74.125.24.0-255,5738,116015,64,267383
2636,0.001476,172.31.40.0-255,66,116081,64,267383
2637,0.001481,74.125.24.0-255,2902,118983,64,267383
2638,0.001483,172.31.40.0-255,66,119049,64,267383
2639,0.001498,172.31.40.0-255,66,119115,64,267383
2640,0.001504,74.125.24.0-255,5738,124853,64,267383
2641,0.001507,172.31.40.0-255,66,124919,64,267383
2642,0.001536,74.125.24.0-255,5020,129939,64,267383
2643,0.001539,172.31.40.0-255,66,130005,64,267383
2644,0.001586,74.125.24.0-255,1484,131489,64,267383
2645,0.0016,74.125.24.0-255,2902,134391,64,267383
2646,0.001603,172.31.40.0-255,66,134457,64,267383
2647,0.001607,74.125.24.0-255,1484,135941,64,267383
2648,0.001631,74.125.24.0-255,4320,140261,64,267383
2649,0.001638,74.125.24.0-255,7156,147417,64,267383
2650,0.001647,172.31.40.0-255,66,147483,64,267383
2651,0.001655,172.31.40.0-255,66,147549,64,267383
2652,0.001667,74.125.24.0-255,5738,153287,64,267383
2653,0.001669,172.31.40.0-255,66,153353,64,267383
2654,0.001681,172.31.40.0-255,66,153419,64,267383
2655,0.001875,74.125.24.0-255,1484,154903,64,267383
2656,0.001882,74.125.24.0-255,2902,157805,64,267383
2657,0.001886,172.31.40.0-255,66,157871,64,267383
2658,0.001891,74.125.24.0-255,2902,160773,64,267383
2659,0.001893,172.31.40.0-255,66,160839,64,267383
2660,0.001912,74.125.24.0-255,2902,163741,64,267383
2661,0.001915,172.31.40.0-255,66,163807,64,267383
2662,0.001925,74.125.24.0-255,5738,169545,64,267383
2663,0.001927,172.31.40.0-255,66,169611,64,267383
2664,0.001931,74.125.24.0-255,2902,172513,64,267383
2665,0.001934,172.31.40.0-255,66,172579,64,267383
2666,0.001979,172.31.40.0-255,66,172645,64,267383
2667,0.001986,74.125.24.0-255,5020,177665,64,267383
2668,0.001988,172.31.40.0-255,66,177731,64,267383
2669,0.002251,74.125.24.0-255,1484,179215,64,267383
2670,0.002256,74.125.24.0-255,1484,180699,64,267383
2671,0.002259,172.31.40.0-255,66,180765,64,267383
2672,0.002278,74.125.24.0-255,1484,182249,64,267383
2673,0.002284,74.125.24.0-255,5738,187987,64,267383
2674,0.002286,172.31.40.0-255,66,188053,64,267383
2675,0.002294,74.125.24.0-255,5738,193791,64,267383
2676,0.002296,172.31.40.0-255,66,193857,64,267383
2677,0.002334,74.125.24.0-255,7156,201013,64,267383
2678,0.002337,172.31.40.0-255,66,201079,64,267383
2679,0.002371,172.31.40.0-255,66,201145,64,267383
2680,0.00257,74.125.24.0-255,1484,202629,64,267383
2681,0.002576,74.125.24.0-255,2902,205531,64,267383
2682,0.002579,172.31.40.0-255,66,205597,64,267383
2683,0.002586,74.125.24.0-255,4320,209917,64,267383
2684,0.002588,172.31.40.0-255,66,209983,64,267383
2685,0.00262,74.125.24.0-255,1484,211467,64,267383
2686,0.002635,172.31.40.0-255,66,211533,64,267383
2687,0.002642,74.125.24.0-255,7156,218689,64,267383
2688,0.002644,172.31.40.0-255,66,218755,64,267383
2689,0.005266,74.125.24.0-255,5738,224493,64,267383
2690,0.005274,172.31.40.0-255,66,224559,64,267383
2691,0.007943,74.125.24.0-255,5738,230297,64,267383
2692,0.007958,172.31.40.0-255,66,230363,64,267383
2693,0.010577,74.125.24.0-255,5738,236101,64,267383
2694,0.01058,172.31.40.0-255,66,236167,64,267383
2695,0.013235,74.125.24.0-255,5738,241905,64,267383
2696,0.013249,172.31.40.0-255,66,241971,64,267383
2697,0.015878,74.125.24.0-255,5738,247709,64,267383
2698,0.015895,172.31.40.0-255,66,247775,64,267383
2699,0.018546,74.125.24.0-255,5738,253513,64,267383
2700,0.018564,172.31.40.0-255,66,253579,64,267383
2701,0.021166,74.125.24.0-255,5738,259317,64,267383
2702,0.021175,172.31.40.0-255,66,259383,64,267383
2703,0.023819,74.125.24.0-255,4440,263823,64,267383
2704,0.023834,172.31.40.0-255,66,263889,64,267383
2705,0.02414,172.31.40.0-255,105,263994,64,267383
2706,0.02673,74.125.24.0-255,66,264060,64,267383
2707,0.033401,172.31.40.0-255,166,264226,64,267383
2708,0.033434,172.31.40.0-255,1131,265357,64,267383
2709,0.033508,172.31.40.0-255,1514,266871,64,267383
2710,0.03351,172.31.40.0-255,314,267185,64,267383
2711,0.03497,104.244.42.0-255,66,267251,64,267383
2712,0.03505,104.244.42.0-255,66,267317,64,267383
2713,0.035104,104.244.42.0-255,66,267383,64,267383
2714,0.0,74.125.130.0-255,152,152,64,261984
2715,2e-05,172.31.40.0-255,66,218,64,261984
2716,2.7e-05,74.125.130.0-255,1484,1702,64,261984
2717,3.2e-05,172.31.40.0-255,66,1768,64,261984
2718,3.7e-05,74.125.130.0-255,2902,4670,64,261984
2719,4.8e-05,172.31.40.0-255,66,4736,64,261984
2720,5.6e-05,74.125.130.0-255,7156,11892,64,261984
2721,6e-05,172.31.40.0-255,66,11958,64,261984
2722,6.4e-05,74.125.130.0-255,2031,13989,64,261984
2723,6.7e-05,172.31.40.0-255,66,14055,64,261984
2724,9e-05,74.125.130.0-255,1484,15539,64,261984
2725,9.7e-05,172.31.40.0-255,66,15605,64,261984
2726,0.000102,74.125.130.0-255,2902,18507,64,261984
2727,0.000105,172.31.40.0-255,66,18573,64,261984
2728,0.000108,74.125.130.0-255,1484,20057,64,261984
2729,0.00011,172.31.40.0-255,66,20123,64,261984
2730,0.000139,74.125.130.0-255,4320,24443,64,261984
2731,0.000142,172.31.40.0-255,66,24509,64,261984
2732,0.000149,74.125.130.0-255,5738,30247,64,261984
2733,0.000152,172.31.40.0-255,66,30313,64,261984
2734,0.00018,74.125.130.0-255,1125,31438,64,261984
2735,0.000183,172.31.40.0-255,66,31504,64,261984
2736,0.000282,74.125.130.0-255,1484,32988,64,261984
2737,0.000286,172.31.40.0-255,66,33054,64,261984
2738,0.000314,74.125.130.0-255,2902,35956,64,261984
2739,0.000316,172.31.40.0-255,66,36022,64,261984
2740,0.000322,74.125.130.0-255,4320,40342,64,261984
2741,0.000324,172.31.40.0-255,66,40408,64,261984
2742,0.00033,74.125.130.0-255,4320,44728,64,261984
2743,0.000336,172.31.40.0-255,66,44794,64,261984
2744,0.000373,74.125.130.0-255,5379,50173,64,261984
2745,0.000377,172.31.40.0-255,66,50239,64,261984
2746,0.000389,172.31.40.0-255,66,50305,64,261984
2747,0.000392,74.125.130.0-255,1484,51789,64,261984
2748,0.000427,74.125.130.0-255,4271,56060,64,261984
2749,0.00043,172.31.40.0-255,66,56126,64,261984
2750,0.000433,74.125.130.0-255,98,56224,64,261984
2751,0.000516,74.125.130.0-255,1484,57708,64,261984
2752,0.00052,172.31.40.0-255,66,57774,64,261984
2753,0.000547,74.125.130.0-255,2902,60676,64,261984
2754,0.00055,172.31.40.0-255,66,60742,64,261984
2755,0.000556,74.125.130.0-255,5738,66480,64,261984
2756,0.000559,172.31.40.0-255,66,66546,64,261984
2757,0.000565,74.125.130.0-255,5738,72284,64,261984
2758,0.000567,172.31.40.0-255,66,72350,64,261984
2759,0.000596,74.125.130.0-255,1125,73475,64,261984
2760,0.000617,74.125.130.0-255,1484,74959,64,261984
2761,0.00062,172.31.40.0-255,66,75025,64,261984
2762,0.000653,74.125.130.0-255,4320,79345,64,261984
2763,0.000656,172.31.40.0-255,66,79411,64,261984
2764,0.000667,172.31.40.0-255,66,79477,64,261984
2765,0.000673,74.125.130.0-255,1125,80602,64,261984
2766,0.001185,74.125.130.0-255,1484,82086,64,261984
2767,0.00119,172.31.40.0-255,66,82152,64,261984
2768,0.001196,74.125.130.0-255,2902,85054,64,261984
2769,0.001198,172.31.40.0-255,66,85120,64,261984
2770,0.001224,74.125.130.0-255,5738,90858,64,261984
2771,0.001227,172.31.40.0-255,66,90924,64,261984
2772,0.001246,74.125.130.0-255,7156,98080,64,261984
2773,0.001249,172.31.40.0-255,66,98146,64,261984
2774,0.001256,74.125.130.0-255,7156,105302,64,261984
2775,0.001259,172.31.40.0-255,66,105368,64,261984
2776,0.001293,74.125.130.0-255,7156,112524,64,261984
2777,0.001296,172.31.40.0-255,66,112590,64,261984
2778,0.0013,74.125.130.0-255,2184,114774,64,261984
2779,0.001302,172.31.40.0-255,66,114840,64,261984
2780,0.00134,74.125.130.0-255,1484,116324,64,261984
2781,0.001355,74.125.130.0-255,2902,119226,64,261984
2782,0.001358,172.31.40.0-255,66,119292,64,261984
2783,0.001361,74.125.130.0-255,1484,120776,64,261984
2784,0.001389,74.125.130.0-255,5738,126514,64,261984
2785,0.001391,172.31.40.0-255,66,126580,64,261984
2786,0.001396,74.125.130.0-255,2902,129482,64,261984
2787,0.001399,172.31.40.0-255,66,129548,64,261984
2788,0.001433,172.31.40.0-255,66,129614,64,261984
2789,0.001462,74.125.130.0-255,1484,131098,64,261984
2790,0.001473,172.31.40.0-255,66,131164,64,261984
2791,0.001498,74.125.130.0-255,1484,132648,64,261984
2792,0.001502,74.125.130.0-255,2902,135550,64,261984
2793,0.001505,172.31.40.0-255,66,135616,64,261984
2794,0.00151,74.125.130.0-255,5738,141354,64,261984
2795,0.001513,172.31.40.0-255,66,141420,64,261984
2796,0.001554,74.125.130.0-255,4320,145740,64,261984
2797,0.001559,172.31.40.0-255,66,145806,64,261984
2798,0.001585,74.125.130.0-255,7156,152962,64,261984
2799,0.001588,172.31.40.0-255,66,153028,64,261984
2800,0.001601,172.31.40.0-255,66,153094,64,261984
2801,0.001651,74.125.130.0-255,1484,154578,64,261984
2802,0.001668,74.125.130.0-255,2902,157480,64,261984
2803,0.001671,172.31.40.0-255,66,157546,64,261984
2804,0.001675,74.125.130.0-255,1484,159030,64,261984
2805,0.0017,74.125.130.0-255,4320,163350,64,261984
2806,0.001703,172.31.40.0-255,66,163416,64,261984
2807,0.001714,172.31.40.0-255,66,163482,64,261984
2808,0.00175,74.125.130.0-255,2902,166384,64,261984
2809,0.001753,172.31.40.0-255,66,166450,64,261984
2810,0.001765,172.31.40.0-255,66,166516,64,261984
2811,0.001767,74.125.130.0-255,766,167282,64,261984
2812,0.001861,74.125.130.0-255,1484,168766,64,261984
2813,0.001866,172.31.40.0-255,66,168832,64,261984
2814,0.001871,74.125.130.0-255,2902,171734,64,261984
2815,0.001873,172.31.40.0-255,66,171800,64,261984
2816,0.001907,74.125.130.0-255,5738,177538,64,261984
2817,0.00191,172.31.40.0-255,66,177604,64,261984
2818,0.001927,172.31.40.0-255,66,177670,64,261984
2819,0.001958,74.125.130.0-255,2902,180572,64,261984
2820,0.001961,172.31.40.0-255,66,180638,64,261984
2821,0.001972,172.31.40.0-255,66,180704,64,261984
2822,0.001975,74.125.130.0-255,766,181470,64,261984
2823,0.00204,74.125.130.0-255,1484,182954,64,261984
2824,0.002044,172.31.40.0-255,66,183020,64,261984
2825,0.002049,74.125.130.0-255,2902,185922,64,261984
2826,0.002051,172.31.40.0-255,66,185988,64,261984
2827,0.002074,74.125.130.0-255,5738,191726,64,261984
2828,0.002077,172.31.40.0-255,66,191792,64,261984
2829,0.00208,74.125.130.0-255,1484,193276,64,261984
2830,0.002084,74.125.130.0-255,2902,196178,64,261984
2831,0.002086,172.31.40.0-255,66,196244,64,261984
2832,0.002094,74.125.130.0-255,5738,201982,64,261984
2833,0.002096,172.31.40.0-255,66,202048,64,261984
2834,0.002126,74.125.130.0-255,7156,209204,64,261984
2835,0.002129,172.31.40.0-255,66,209270,64,261984
2836,0.00216,74.125.130.0-255,5738,215008,64,261984
2837,0.002163,172.31.40.0-255,66,215074,64,261984
2838,0.002169,74.125.130.0-255,5020,220094,64,261984
2839,0.002171,172.31.40.0-255,66,220160,64,261984
2840,0.002178,74.125.130.0-255,5738,225898,64,261984
2841,0.00218,172.31.40.0-255,66,225964,64,261984
2842,0.002183,74.125.130.0-255,1484,227448,64,261984
2843,0.002234,172.31.40.0-255,66,227514,64,261984
2844,0.002246,172.31.40.0-255,66,227580,64,261984
2845,0.002279,172.31.40.0-255,66,227646,64,261984
2846,0.002325,172.31.40.0-255,66,227712,64,261984
2847,0.002328,74.125.130.0-255,1484,229196,64,261984
2848,0.002351,172.31.40.0-255,66,229262,64,261984
2849,0.002357,74.125.130.0-255,5738,235000,64,261984
2850,0.002359,172.31.40.0-255,66,235066,64,261984
2851,0.004628,74.125.130.0-255,5738,240804,64,261984
2852,0.004637,172.31.40.0-255,66,240870,64,261984
2853,0.006922,74.125.130.0-255,5738,246608,64,261984
2854,0.00694,172.31.40.0-255,66,246674,64,261984
2855,0.009219,74.125.130.0-255,5738,252412,64,261984
2856,0.009252,172.31.40.0-255,66,252478,64,261984
2857,0.011522,74.125.130.0-255,4978,257456,64,261984
2858,0.011529,172.31.40.0-255,66,257522,64,261984
2859,0.012762,172.31.40.0-255,105,257627,64,261984
2860,0.014982,74.125.130.0-255,66,257693,64,261984
2861,0.048704,172.31.40.0-255,171,257864,64,261984
2862,0.048741,172.31.40.0-255,1136,259000,64,261984
2863,0.048802,172.31.40.0-255,1514,260514,64,261984
2864,0.048804,172.31.40.0-255,1272,261786,64,261984
2865,0.050235,104.244.42.0-255,66,261852,64,261984
2866,0.050268,104.244.42.0-255,66,261918,64,261984
2867,0.050361,104.244.42.0-255,66,261984,64,261984
2868,0.0,74.125.24.0-255,157,157,64,106165
2869,3.7e-05,172.31.40.0-255,66,223,64,106165
2870,5e-05,74.125.24.0-255,1484,1707,64,106165
2871,5.6e-05,172.31.40.0-255,66,1773,64,106165
2872,7.5e-05,74.125.24.0-255,2902,4675,64,106165
2873,7.9e-05,172.31.40.0-255,66,4741,64,106165
2874,9.1e-05,74.125.24.0-255,7156,11897,64,106165
2875,9.5e-05,172.31.40.0-255,66,11963,64,106165
2876,0.000115,172.31.40.0-255,66,12029,64,106165
2877,0.000126,74.125.24.0-255,6797,18826,64,106165
2878,0.000129,172.31.40.0-255,66,18892,64,106165
2879,0.000139,74.125.24.0-255,7156,26048,64,106165
2880,0.000142,172.31.40.0-255,66,26114,64,106165
2881,0.000157,172.31.40.0-255,66,26180,64,106165
2882,0.000183,172.31.40.0-255,66,26246,64,106165
2883,0.000187,74.125.24.0-255,1066,27312,64,106165
2884,0.00019,172.31.40.0-255,66,27378,64,106165
2885,0.00023,74.125.24.0-255,380,27758,64,106165
2886,0.000233,172.31.40.0-255,66,27824,64,106165
2887,0.000367,74.125.24.0-255,1484,29308,64,106165
2888,0.000372,172.31.40.0-255,66,29374,64,106165
2889,0.00038,74.125.24.0-255,2902,32276,64,106165
2890,0.000383,172.31.40.0-255,66,32342,64,106165
2891,0.000398,74.125.24.0-255,5738,38080,64,106165
2892,0.0004,172.31.40.0-255,66,38146,64,106165
2893,0.000404,74.125.24.0-255,1484,39630,64,106165
2894,0.000406,172.31.40.0-255,66,39696,64,106165
2895,0.000464,172.31.40.0-255,66,39762,64,106165
2896,0.000486,172.31.40.0-255,66,39828,64,106165
2897,0.000488,74.125.24.0-255,766,40594,64,106165
2898,0.000559,74.125.24.0-255,1484,42078,64,106165
2899,0.000562,172.31.40.0-255,66,42144,64,106165
2900,0.00057,74.125.24.0-255,4320,46464,64,106165
2901,0.000573,172.31.40.0-255,66,46530,64,106165
2902,0.000585,74.125.24.0-255,4320,50850,64,106165
2903,0.000588,172.31.40.0-255,66,50916,64,106165
2904,0.000604,172.31.40.0-255,66,50982,64,106165
2905,0.00062,172.31.40.0-255,66,51048,64,106165
2906,0.000635,172.31.40.0-255,66,51114,64,106165
2907,0.000643,74.125.24.0-255,7156,58270,64,106165
2908,0.000645,172.31.40.0-255,66,58336,64,106165
2909,0.000678,74.125.24.0-255,2902,61238,64,106165
2910,0.00068,172.31.40.0-255,66,61304,64,106165
2911,0.000719,172.31.40.0-255,66,61370,64,106165
2912,0.00096,74.125.24.0-255,1484,62854,64,106165
2913,0.000978,74.125.24.0-255,2902,65756,64,106165
2914,0.000982,172.31.40.0-255,66,65822,64,106165
2915,0.00099,74.125.24.0-255,5738,71560,64,106165
2916,0.000992,172.31.40.0-255,66,71626,64,106165
2917,0.001026,172.31.40.0-255,66,71692,64,106165
2918,0.001041,74.125.24.0-255,1484,73176,64,106165
2919,0.00105,74.125.24.0-255,7156,80332,64,106165
2920,0.001056,172.31.40.0-255,66,80398,64,106165
2921,0.001072,74.125.24.0-255,3602,84000,64,106165
2922,0.001075,172.31.40.0-255,66,84066,64,106165
2923,0.001121,74.125.24.0-255,1484,85550,64,106165
2924,0.001126,74.125.24.0-255,2902,88452,64,106165
2925,0.001129,172.31.40.0-255,66,88518,64,106165
2926,0.001163,74.125.24.0-255,5738,94256,64,106165
2927,0.001166,172.31.40.0-255,66,94322,64,106165
2928,0.00119,172.31.40.0-255,66,94388,64,106165
2929,0.001206,172.31.40.0-255,66,94454,64,106165
2930,0.001272,172.31.40.0-255,66,94520,64,106165
2931,0.001292,172.31.40.0-255,66,94586,64,106165
2932,0.00131,172.31.40.0-255,66,94652,64,106165
2933,0.00137,172.31.40.0-255,66,94718,64,106165
2934,0.001397,74.125.24.0-255,1484,96202,64,106165
2935,0.001419,172.31.40.0-255,66,96268,64,106165
2936,0.001436,172.31.40.0-255,66,96334,64,106165
2937,0.001465,172.31.40.0-255,66,96400,64,106165
2938,0.001491,172.31.40.0-255,66,96466,64,106165
2939,0.00151,172.31.40.0-255,66,96532,64,106165
2940,0.001524,172.31.40.0-255,66,96598,64,106165
2941,0.001555,172.31.40.0-255,66,96664,64,106165
2942,0.001564,74.125.24.0-255,5894,102558,64,106165
2943,0.001566,172.31.40.0-255,66,102624,64,106165
2944,0.001569,74.125.24.0-255,105,102729,64,106165
2945,0.004723,172.31.40.0-255,66,102795,64,106165
2946,0.004763,172.31.40.0-255,105,102900,64,106165
2947,0.007003,74.125.24.0-255,66,102966,64,106165
2948,0.044068,172.31.40.0-255,172,103138,64,106165
2949,0.04411,172.31.40.0-255,1108,104246,64,106165
2950,0.044181,172.31.40.0-255,1514,105760,64,106165
2951,0.044183,172.31.40.0-255,339,106099,64,106165
2952,0.046206,104.244.42.0-255,66,106165,64,106165
2953,0.0,74.125.24.0-255,297,297,64,210764
2954,9e-06,172.31.40.0-255,66,363,64,210764
2955,1.2e-05,74.125.24.0-255,1484,1847,64,210764
2956,1.6e-05,172.31.40.0-255,66,1913,64,210764
2957,1.9e-05,74.125.24.0-255,1484,3397,64,210764
2958,2.1e-05,172.31.40.0-255,66,3463,64,210764
2959,6.1e-05,74.125.24.0-255,2902,6365,64,210764
2960,6.4e-05,172.31.40.0-255,66,6431,64,210764
2961,7.5e-05,172.31.40.0-255,66,6497,64,210764
2962,8.5e-05,74.125.24.0-255,5738,12235,64,210764
2963,8.7e-05,172.31.40.0-255,66,12301,64,210764
2964,0.00012,74.125.24.0-255,7156,19457,64,210764
2965,0.000123,172.31.40.0-255,66,19523,64,210764
2966,0.000147,74.125.24.0-255,2543,22066,64,210764
2967,0.000149,172.31.40.0-255,66,22132,64,210764
2968,0.000259,74.125.24.0-255,1484,23616,64,210764
2969,0.000262,172.31.40.0-255,66,23682,64,210764
2970,0.000266,74.125.24.0-255,1484,25166,64,210764
2971,0.000267,172.31.40.0-255,66,25232,64,210764
2972,0.000291,74.125.24.0-255,1484,26716,64,210764
2973,0.000298,172.31.40.0-255,66,26782,64,210764
2974,0.000304,74.125.24.0-255,5738,32520,64,210764
2975,0.000305,172.31.40.0-255,66,32586,64,210764
2976,0.000341,172.31.40.0-255,66,32652,64,210764
2977,0.000379,172.31.40.0-255,66,32718,64,210764
2978,0.00039,74.125.24.0-255,2814,35532,64,210764
2979,0.000398,172.31.40.0-255,66,35598,64,210764
2980,0.00042,74.125.24.0-255,384,35982,64,210764
2981,0.000422,172.31.40.0-255,66,36048,64,210764
2982,0.000537,74.125.24.0-255,1484,37532,64,210764
2983,0.000543,74.125.24.0-255,2902,40434,64,210764
2984,0.000546,172.31.40.0-255,66,40500,64,210764
2985,0.000549,74.125.24.0-255,1484,41984,64,210764
2986,0.000583,74.125.24.0-255,4320,46304,64,210764
2987,0.000586,172.31.40.0-255,66,46370,64,210764
2988,0.000593,74.125.24.0-255,5738,52108,64,210764
2989,0.000595,172.31.40.0-255,66,52174,64,210764
2990,0.000614,172.31.40.0-255,66,52240,64,210764
2991,0.000646,74.125.24.0-255,3961,56201,64,210764
2992,0.000649,172.31.40.0-255,66,56267,64,210764
2993,0.000655,74.125.24.0-255,3961,60228,64,210764
2994,0.000657,172.31.40.0-255,66,60294,64,210764
2995,0.000686,74.125.24.0-255,1484,61778,64,210764
2996,0.000691,74.125.24.0-255,2902,64680,64,210764
2997,0.000694,172.31.40.0-255,66,64746,64,210764
2998,0.000704,74.125.24.0-255,1484,66230,64,210764
2999,0.000725,74.125.24.0-255,4320,70550,64,210764
3000,0.000728,172.31.40.0-255,66,70616,64,210764
3001,0.000735,74.125.24.0-255,7156,77772,64,210764
3002,0.000738,172.31.40.0-255,66,77838,64,210764
3003,0.000741,74.125.24.0-255,1484,79322,64,210764
3004,0.000781,74.125.24.0-255,2184,81506,64,210764
3005,0.000789,172.31.40.0-255,66,81572,64,210764
3006,0.000792,172.31.40.0-255,66,81638,64,210764
3007,0.000841,74.125.24.0-255,1484,83122,64,210764
3008,0.000856,74.125.24.0-255,2902,86024,64,210764
3009,0.000859,172.31.40.0-255,66,86090,64,210764
3010,0.000864,74.125.24.0-255,2902,88992,64,210764
3011,0.000867,172.31.40.0-255,66,89058,64,210764
3012,0.000902,74.125.24.0-255,2902,91960,64,210764
3013,0.000905,172.31.40.0-255,66,92026,64,210764
3014,0.000911,74.125.24.0-255,4320,96346,64,210764
3015,0.000914,172.31.40.0-255,66,96412,64,210764
3016,0.000932,172.31.40.0-255,66,96478,64,210764
3017,0.000941,172.31.40.0-255,66,96544,64,210764
3018,0.000992,74.125.24.0-255,1484,98028,64,210764
3019,0.000997,74.125.24.0-255,2902,100930,64,210764
3020,0.001,172.31.40.0-255,66,100996,64,210764
3021,0.001027,74.125.24.0-255,5738,106734,64,210764
3022,0.00103,172.31.40.0-255,66,106800,64,210764
3023,0.001035,74.125.24.0-255,4320,111120,64,210764
3024,0.001037,172.31.40.0-255,66,111186,64,210764
3025,0.001063,74.125.24.0-255,2902,114088,64,210764
3026,0.001066,172.31.40.0-255,66,114154,64,210764
3027,0.001085,172.31.40.0-255,66,114220,64,210764
3028,0.001089,74.125.24.0-255,2184,116404,64,210764
3029,0.001091,172.31.40.0-255,66,116470,64,210764
3030,0.001155,74.125.24.0-255,1484,117954,64,210764
3031,0.001212,74.125.24.0-255,2902,120856,64,210764
3032,0.001215,172.31.40.0-255,66,120922,64,210764
3033,0.001221,74.125.24.0-255,5738,126660,64,210764
3034,0.001223,172.31.40.0-255,66,126726,64,210764
3035,0.001241,172.31.40.0-255,66,126792,64,210764
3036,0.001244,74.125.24.0-255,1484,128276,64,210764
3037,0.001273,74.125.24.0-255,1484,129760,64,210764
3038,0.001275,172.31.40.0-255,66,129826,64,210764
3039,0.001311,172.31.40.0-255,66,129892,64,210764
3040,0.001444,74.125.24.0-255,1484,131376,64,210764
3041,0.001468,74.125.24.0-255,2902,134278,64,210764
3042,0.001472,172.31.40.0-255,66,134344,64,210764
3043,0.001505,74.125.24.0-255,5738,140082,64,210764
3044,0.001507,172.31.40.0-255,66,140148,64,210764
3045,0.001511,74.125.24.0-255,1484,141632,64,210764
3046,0.001543,74.125.24.0-255,7156,148788,64,210764
3047,0.001545,172.31.40.0-255,66,148854,64,210764
3048,0.001583,172.31.40.0-255,66,148920,64,210764
3049,0.001612,74.125.24.0-255,6438,155358,64,210764
3050,0.001615,172.31.40.0-255,66,155424,64,210764
3051,0.00174,74.125.24.0-255,1484,156908,64,210764
3052,0.001743,74.125.24.0-255,1484,158392,64,210764
3053,0.001749,172.31.40.0-255,66,158458,64,210764
3054,0.001757,74.125.24.0-255,1484,159942,64,210764
3055,0.001764,74.125.24.0-255,5738,165680,64,210764
3056,0.001767,172.31.40.0-255,66,165746,64,210764
3057,0.001803,172.31.40.0-255,66,165812,64,210764
3058,0.001821,74.125.24.0-255,2902,168714,64,210764
3059,0.001823,172.31.40.0-255,66,168780,64,210764
3060,0.001836,172.31.40.0-255,66,168846,64,210764
3061,0.001887,172.31.40.0-255,66,168912,64,210764
3062,0.001902,172.31.40.0-255,66,168978,64,210764
3063,0.001942,172.31.40.0-255,66,169044,64,210764
3064,0.002004,172.31.40.0-255,66,169110,64,210764
3065,0.002009,74.125.24.0-255,2902,172012,64,210764
3066,0.002022,172.31.40.0-255,66,172078,64,210764
3067,0.002031,74.125.24.0-255,4320,176398,64,210764
3068,0.002034,172.31.40.0-255,66,176464,64,210764
3069,0.002066,74.125.24.0-255,5020,181484,64,210764
3070,0.002088,172.31.40.0-255,66,181550,64,210764
3071,0.002238,74.125.24.0-255,1484,183034,64,210764
3072,0.002244,74.125.24.0-255,2902,185936,64,210764
3073,0.002248,172.31.40.0-255,66,186002,64,210764
3074,0.002255,74.125.24.0-255,5738,191740,64,210764
3075,0.002257,172.31.40.0-255,66,191806,64,210764
3076,0.002326,74.125.24.0-255,2902,194708,64,210764
3077,0.002347,172.31.40.0-255,66,194774,64,210764
3078,0.002353,172.31.40.0-255,66,194840,64,210764
3079,0.004627,74.125.24.0-255,5738,200578,64,210764
3080,0.004632,172.31.40.0-255,66,200644,64,210764
3081,0.006909,74.125.24.0-255,5417,206061,64,210764
3082,0.006916,172.31.40.0-255,66,206127,64,210764
3083,0.011549,172.31.40.0-255,105,206232,64,210764
3084,0.013812,74.125.24.0-255,66,206298,64,210764
3085,0.03077,172.31.40.0-255,172,206470,64,210764
3086,0.030806,172.31.40.0-255,1112,207582,64,210764
3087,0.030868,172.31.40.0-255,1514,209096,64,210764
3088,0.030869,172.31.40.0-255,1296,210392,64,210764
3089,0.032307,104.244.42.0-255,66,210458,64,210764
3090,0.032391,104.244.42.0-255,66,210524,64,210764
3091,0.032465,104.244.42.0-255,66,210590,64,210764
3092,0.032977,104.244.42.0-255,108,210698,64,210764
3093,0.032983,172.31.40.0-255,66,210764,64,210764
3094,0.0,172.31.40.0-255,105,105,64,459
3095,0.00021,172.31.40.0-255,90,195,64,459
3096,0.000218,172.31.40.0-255,66,261,64,459
3097,0.003007,172.217.194.0-255,66,327,64,459
3098,0.003032,172.217.194.0-255,66,393,64,459
3099,0.003051,172.31.40.0-255,66,459,64,459
3100,0.0,172.217.194.0-255,153,153,64,128344
3101,2.1e-05,172.31.40.0-255,66,219,64,128344
3102,2.8e-05,172.217.194.0-255,1484,1703,64,128344
3103,3.2e-05,172.31.40.0-255,66,1769,64,128344
3104,4.4e-05,172.217.194.0-255,2902,4671,64,128344
3105,4.8e-05,172.31.40.0-255,66,4737,64,128344
3106,6.9e-05,172.217.194.0-255,7156,11893,64,128344
3107,7.3e-05,172.31.40.0-255,66,11959,64,128344
3108,0.000114,172.217.194.0-255,2000,13959,64,128344
3109,0.000117,172.31.40.0-255,66,14025,64,128344
3110,0.00051,172.217.194.0-255,1484,15509,64,128344
3111,0.000515,172.31.40.0-255,66,15575,64,128344
3112,0.000522,172.217.194.0-255,2902,18477,64,128344
3113,0.000524,172.31.40.0-255,66,18543,64,128344
3114,0.000536,172.217.194.0-255,5738,24281,64,128344
3115,0.000538,172.31.40.0-255,66,24347,64,128344
3116,0.000575,172.217.194.0-255,6797,31144,64,128344
3117,0.000579,172.31.40.0-255,66,31210,64,128344
3118,0.000587,172.217.194.0-255,7156,38366,64,128344
3119,0.000589,172.31.40.0-255,66,38432,64,128344
3120,0.000607,172.31.40.0-255,66,38498,64,128344
3121,0.000641,172.217.194.0-255,4320,42818,64,128344
3122,0.000645,172.31.40.0-255,66,42884,64,128344
3123,0.000662,172.31.40.0-255,66,42950,64,128344
3124,0.000665,172.217.194.0-255,677,43627,64,128344
3125,0.000667,172.31.40.0-255,66,43693,64,128344
3126,0.00067,172.217.194.0-255,1484,45177,64,128344
3127,0.000673,172.31.40.0-255,66,45243,64,128344
3128,0.000678,172.217.194.0-255,4320,49563,64,128344
3129,0.000681,172.31.40.0-255,66,49629,64,128344
3130,0.000686,172.217.194.0-255,2902,52531,64,128344
3131,0.000689,172.31.40.0-255,66,52597,64,128344
3132,0.000729,172.217.194.0-255,7156,59753,64,128344
3133,0.000732,172.31.40.0-255,66,59819,64,128344
3134,0.00075,172.31.40.0-255,66,59885,64,128344
3135,0.000753,172.217.194.0-255,1484,61369,64,128344
3136,0.000788,172.31.40.0-255,66,61435,64,128344
3137,0.000802,172.31.40.0-255,66,61501,64,128344
3138,0.000833,172.217.194.0-255,2902,64403,64,128344
3139,0.000836,172.31.40.0-255,66,64469,64,128344
3140,0.000844,172.217.194.0-255,6438,70907,64,128344
3141,0.000847,172.31.40.0-255,66,70973,64,128344
3142,0.000902,172.31.40.0-255,66,71039,64,128344
3143,0.000913,172.31.40.0-255,66,71105,64,128344
3144,0.000977,172.31.40.0-255,66,71171,64,128344
3145,0.000981,172.217.194.0-255,2902,74073,64,128344
3146,0.000983,172.31.40.0-255,66,74139,64,128344
3147,0.001026,172.31.40.0-255,66,74205,64,128344
3148,0.001062,172.217.194.0-255,1484,75689,64,128344
3149,0.001068,172.217.194.0-255,2902,78591,64,128344
3150,0.001083,172.217.194.0-255,5738,84329,64,128344
3151,0.00109,172.31.40.0-255,66,84395,64,128344
3152,0.0011,172.217.194.0-255,4320,88715,64,128344
3153,0.001105,172.31.40.0-255,66,88781,64,128344
3154,0.001163,172.31.40.0-255,66,88847,64,128344
3155,0.001219,172.217.194.0-255,1484,90331,64,128344
3156,0.001224,172.217.194.0-255,2902,93233,64,128344
3157,0.001228,172.217.194.0-255,1484,94717,64,128344
3158,0.001235,172.31.40.0-255,66,94783,64,128344
3159,0.001263,172.217.194.0-255,4320,99103,64,128344
3160,0.001311,172.31.40.0-255,66,99169,64,128344
3161,0.001382,172.31.40.0-255,66,99235,64,128344
3162,0.001397,172.217.194.0-255,766,100001,64,128344
3163,0.001415,172.31.40.0-255,66,100067,64,128344
3164,0.001438,172.217.194.0-255,1484,101551,64,128344
3165,0.001443,172.217.194.0-255,2902,104453,64,128344
3166,0.001446,172.217.194.0-255,1484,105937,64,128344
3167,0.001452,172.31.40.0-255,66,106003,64,128344
3168,0.001463,172.217.194.0-255,4320,110323,64,128344
3169,0.001465,172.217.194.0-255,1484,111807,64,128344
3170,0.001476,172.31.40.0-255,66,111873,64,128344
3171,0.00154,172.31.40.0-255,66,111939,64,128344
3172,0.001552,172.217.194.0-255,5738,117677,64,128344
3173,0.001557,172.31.40.0-255,66,117743,64,128344
3174,0.001674,172.217.194.0-255,5738,123481,64,128344
3175,0.001697,172.31.40.0-255,66,123547,64,128344
3176,0.001737,172.217.194.0-255,105,123652,64,128344
3177,0.001751,172.31.40.0-255,66,123718,64,128344
3178,0.003534,172.31.40.0-255,101,123819,64,128344
3179,0.005519,172.217.194.0-255,66,123885,64,128344
3180,0.012234,172.31.40.0-255,105,123990,64,128344
3181,0.014218,172.217.194.0-255,66,124056,64,128344
3182,0.03395,172.31.40.0-255,166,124222,64,128344
3183,0.033975,172.31.40.0-255,1135,125357,64,128344
3184,0.034027,172.31.40.0-255,1514,126871,64,128344
3185,0.034028,172.31.40.0-255,1275,128146,64,128344
3186,0.035529,104.244.42.0-255,66,128212,64,128344
3187,0.035538,104.244.42.0-255,66,128278,64,128344
3188,0.035565,104.244.42.0-255,66,128344,64,128344
3189,0.0,74.125.24.0-255,291,291,64,231447
3190,1.4e-05,172.31.40.0-255,66,357,64,231447
3191,2e-05,74.125.24.0-255,1484,1841,64,231447
3192,2.5e-05,172.31.40.0-255,66,1907,64,231447
3193,4e-05,74.125.24.0-255,4320,6227,64,231447
3194,4.3e-05,172.31.40.0-255,66,6293,64,231447
3195,5.1e-05,74.125.24.0-255,7156,13449,64,231447
3196,5.5e-05,172.31.40.0-255,66,13515,64,231447
3197,8.7e-05,74.125.24.0-255,537,14052,64,231447
3198,9.1e-05,172.31.40.0-255,66,14118,64,231447
3199,0.000185,74.125.24.0-255,1484,15602,64,231447
3200,0.000189,172.31.40.0-255,66,15668,64,231447
3201,0.000195,74.125.24.0-255,2902,18570,64,231447
3202,0.000197,172.31.40.0-255,66,18636,64,231447
3203,0.00023,74.125.24.0-255,5738,24374,64,231447
3204,0.000233,172.31.40.0-255,66,24440,64,231447
3205,0.000237,74.125.24.0-255,2902,27342,64,231447
3206,0.00024,172.31.40.0-255,66,27408,64,231447
3207,0.000262,74.125.24.0-255,3961,31369,64,231447
3208,0.000269,172.31.40.0-255,66,31435,64,231447
3209,0.000304,172.31.40.0-255,66,31501,64,231447
3210,0.000325,74.125.24.0-255,1484,32985,64,231447
3211,0.000328,172.31.40.0-255,66,33051,64,231447
3212,0.000334,74.125.24.0-255,3961,37012,64,231447
3213,0.000337,172.31.40.0-255,66,37078,64,231447
3214,0.000623,74.125.24.0-255,1484,38562,64,231447
3215,0.000632,172.31.40.0-255,66,38628,64,231447
3216,0.000638,74.125.24.0-255,2902,41530,64,231447
3217,0.00064,172.31.40.0-255,66,41596,64,231447
3218,0.000672,74.125.24.0-255,5738,47334,64,231447
3219,0.000676,172.31.40.0-255,66,47400,64,231447
3220,0.00071,74.125.24.0-255,7069,54469,64,231447
3221,0.000713,172.31.40.0-255,66,54535,64,231447
3222,0.000753,74.125.24.0-255,132,54667,64,231447
3223,0.000756,172.31.40.0-255,66,54733,64,231447
3224,0.000759,74.125.24.0-255,347,55080,64,231447
3225,0.000761,172.31.40.0-255,66,55146,64,231447
3226,0.000937,74.125.24.0-255,1484,56630,64,231447
3227,0.000941,172.31.40.0-255,66,56696,64,231447
3228,0.000947,74.125.24.0-255,2902,59598,64,231447
3229,0.000949,172.31.40.0-255,66,59664,64,231447
3230,0.000979,74.125.24.0-255,5738,65402,64,231447
3231,0.000982,172.31.40.0-255,66,65468,64,231447
3232,0.000999,74.125.24.0-255,4320,69788,64,231447
3233,0.001001,172.31.40.0-255,66,69854,64,231447
3234,0.001038,74.125.24.0-255,5738,75592,64,231447
3235,0.001041,172.31.40.0-255,66,75658,64,231447
3236,0.00106,172.31.40.0-255,66,75724,64,231447
3237,0.001064,74.125.24.0-255,2184,77908,64,231447
3238,0.001066,172.31.40.0-255,66,77974,64,231447
3239,0.002475,74.125.24.0-255,1484,79458,64,231447
3240,0.002482,172.31.40.0-255,66,79524,64,231447
3241,0.002491,74.125.24.0-255,2902,82426,64,231447
3242,0.002493,172.31.40.0-255,66,82492,64,231447
3243,0.002505,74.125.24.0-255,5738,88230,64,231447
3244,0.002507,172.31.40.0-255,66,88296,64,231447
3245,0.002515,74.125.24.0-255,7156,95452,64,231447
3246,0.002518,172.31.40.0-255,66,95518,64,231447
3247,0.002555,74.125.24.0-255,2902,98420,64,231447
3248,0.002561,172.31.40.0-255,66,98486,64,231447
3249,0.002574,172.31.40.0-255,66,98552,64,231447
3250,0.002578,74.125.24.0-255,2184,100736,64,231447
3251,0.00258,172.31.40.0-255,66,100802,64,231447
3252,0.005167,74.125.24.0-255,2902,103704,64,231447
3253,0.005175,172.31.40.0-255,66,103770,64,231447
3254,0.005202,74.125.24.0-255,2902,106672,64,231447
3255,0.005205,172.31.40.0-255,66,106738,64,231447
3256,0.007768,74.125.24.0-255,5738,112476,64,231447
3257,0.007774,172.31.40.0-255,66,112542,64,231447
3258,0.010372,74.125.24.0-255,5738,118280,64,231447
3259,0.010379,172.31.40.0-255,66,118346,64,231447
3260,0.012974,74.125.24.0-255,5738,124084,64,231447
3261,0.012981,172.31.40.0-255,66,124150,64,231447
3262,0.0156,74.125.24.0-255,5738,129888,64,231447
3263,0.015607,172.31.40.0-255,66,129954,64,231447
3264,0.018194,74.125.24.0-255,5738,135692,64,231447
3265,0.018203,172.31.40.0-255,66,135758,64,231447
3266,0.020771,74.125.24.0-255,5738,141496,64,231447
3267,0.020778,172.31.40.0-255,66,141562,64,231447
3268,0.023372,74.125.24.0-255,5738,147300,64,231447
3269,0.02338,172.31.40.0-255,66,147366,64,231447
3270,0.02444,172.31.40.0-255,172,147538,64,231447
3271,0.024474,172.31.40.0-255,1107,148645,64,231447
3272,0.02453,172.31.40.0-255,1514,150159,64,231447
3273,0.024532,172.31.40.0-255,1186,151345,64,231447
3274,0.025963,74.125.24.0-255,5738,157083,64,231447
3275,0.02597,172.31.40.0-255,66,157149,64,231447
3276,0.025999,104.244.42.0-255,66,157215,64,231447
3277,0.026021,104.244.42.0-255,66,157281,64,231447
3278,0.026163,104.244.42.0-255,66,157347,64,231447
3279,0.028538,74.125.24.0-255,5738,163085,64,231447
3280,0.028545,172.31.40.0-255,66,163151,64,231447
3281,0.031144,74.125.24.0-255,5738,168889,64,231447
3282,0.031151,172.31.40.0-255,66,168955,64,231447
3283,0.033745,74.125.24.0-255,4320,173275,64,231447
3284,0.03375,172.31.40.0-255,66,173341,64,231447
3285,0.033775,74.125.24.0-255,1484,174825,64,231447
3286,0.036369,74.125.24.0-255,4320,179145,64,231447
3287,0.036376,172.31.40.0-255,66,179211,64,231447
3288,0.038942,74.125.24.0-255,5738,184949,64,231447
3289,0.038994,172.31.40.0-255,66,185015,64,231447
3290,0.041592,74.125.24.0-255,5738,190753,64,231447
3291,0.041598,172.31.40.0-255,66,190819,64,231447
3292,0.044191,74.125.24.0-255,5738,196557,64,231447
3293,0.044196,172.31.40.0-255,66,196623,64,231447
3294,0.0468,74.125.24.0-255,5738,202361,64,231447
3295,0.046807,172.31.40.0-255,66,202427,64,231447
3296,0.049393,74.125.24.0-255,5738,208165,64,231447
3297,0.0494,172.31.40.0-255,66,208231,64,231447
3298,0.052004,74.125.24.0-255,5738,213969,64,231447
3299,0.052011,172.31.40.0-255,66,214035,64,231447
3300,0.054637,74.125.24.0-255,5738,219773,64,231447
3301,0.054645,172.31.40.0-255,66,219839,64,231447
3302,0.057247,74.125.24.0-255,5738,225577,64,231447
3303,0.057263,172.31.40.0-255,66,225643,64,231447
3304,0.059877,74.125.24.0-255,5738,231381,64,231447
3305,0.059889,172.31.40.0-255,66,231447,64,231447
3306,0.0,74.125.200.0-255,146,146,64,291221
3307,2.6e-05,172.31.40.0-255,66,212,64,291221
3308,3.5e-05,74.125.200.0-255,1484,1696,64,291221
3309,4e-05,172.31.40.0-255,66,1762,64,291221
3310,4.5e-05,74.125.200.0-255,2902,4664,64,291221
3311,4.8e-05,172.31.40.0-255,66,4730,64,291221
3312,5.5e-05,74.125.200.0-255,5738,10468,64,291221
3313,5.7e-05,172.31.40.0-255,66,10534,64,291221
3314,8.2e-05,74.125.200.0-255,3492,14026,64,291221
3315,8.5e-05,172.31.40.0-255,66,14092,64,291221
3316,8.8e-05,74.125.200.0-255,1484,15576,64,291221
3317,9.1e-05,172.31.40.0-255,66,15642,64,291221
3318,0.000104,74.125.200.0-255,2902,18544,64,291221
3319,0.000107,172.31.40.0-255,66,18610,64,291221
3320,0.000119,172.31.40.0-255,66,18676,64,291221
3321,0.000127,74.125.200.0-255,7156,25832,64,291221
3322,0.000131,172.31.40.0-255,66,25898,64,291221
3323,0.000169,74.125.200.0-255,2902,28800,64,291221
3324,0.000172,172.31.40.0-255,66,28866,64,291221
3325,0.000202,172.31.40.0-255,66,28932,64,291221
3326,0.00041,74.125.200.0-255,1484,30416,64,291221
3327,0.000415,172.31.40.0-255,66,30482,64,291221
3328,0.000456,74.125.200.0-255,2902,33384,64,291221
3329,0.000459,172.31.40.0-255,66,33450,64,291221
3330,0.000465,74.125.200.0-255,4320,37770,64,291221
3331,0.000467,172.31.40.0-255,66,37836,64,291221
3332,0.000494,74.125.200.0-255,4320,42156,64,291221
3333,0.000497,172.31.40.0-255,66,42222,64,291221
3334,0.000536,74.125.200.0-255,4317,46539,64,291221
3335,0.000538,172.31.40.0-255,66,46605,64,291221
3336,0.000735,74.125.200.0-255,1484,48089,64,291221
3337,0.000742,74.125.200.0-255,1484,49573,64,291221
3338,0.000747,74.125.200.0-255,2902,52475,64,291221
3339,0.000749,74.125.200.0-255,1484,53959,64,291221
3340,0.000755,172.31.40.0-255,66,54025,64,291221
3341,0.000766,74.125.200.0-255,4320,58345,64,291221
3342,0.000781,74.125.200.0-255,4320,62665,64,291221
3343,0.0008,74.125.200.0-255,5738,68403,64,291221
3344,0.000806,172.31.40.0-255,66,68469,64,291221
3345,0.000834,74.125.200.0-255,766,69235,64,291221
3346,0.000846,172.31.40.0-255,66,69301,64,291221
3347,0.001112,74.125.200.0-255,1484,70785,64,291221
3348,0.001119,74.125.200.0-255,2902,73687,64,291221
3349,0.001121,172.31.40.0-255,66,73753,64,291221
3350,0.001125,74.125.200.0-255,1484,75237,64,291221
3351,0.001128,74.125.200.0-255,1484,76721,64,291221
3352,0.001141,74.125.200.0-255,1484,78205,64,291221
3353,0.001151,172.31.40.0-255,66,78271,64,291221
3354,0.001161,74.125.200.0-255,2902,81173,64,291221
3355,0.001165,172.31.40.0-255,66,81239,64,291221
3356,0.001179,74.125.200.0-255,2902,84141,64,291221
3357,0.001194,74.125.200.0-255,2902,87043,64,291221
3358,0.001198,172.31.40.0-255,66,87109,64,291221
3359,0.001208,74.125.200.0-255,2902,90011,64,291221
3360,0.001212,172.31.40.0-255,66,90077,64,291221
3361,0.001221,74.125.200.0-255,4320,94397,64,291221
3362,0.001271,172.31.40.0-255,66,94463,64,291221
3363,0.001276,74.125.200.0-255,2184,96647,64,291221
3364,0.00128,74.125.200.0-255,4320,100967,64,291221
3365,0.001282,74.125.200.0-255,1484,102451,64,291221
3366,0.001288,172.31.40.0-255,66,102517,64,291221
3367,0.001302,74.125.200.0-255,7156,109673,64,291221
3368,0.001317,172.31.40.0-255,66,109739,64,291221
3369,0.001342,74.125.200.0-255,5738,115477,64,291221
3370,0.001348,74.125.200.0-255,5020,120497,64,291221
3371,0.001365,172.31.40.0-255,66,120563,64,291221
3372,0.001382,74.125.200.0-255,4320,124883,64,291221
3373,0.001397,74.125.200.0-255,1484,126367,64,291221
3374,0.001403,74.125.200.0-255,4320,130687,64,291221
3375,0.001413,172.31.40.0-255,66,130753,64,291221
3376,0.001422,74.125.200.0-255,4320,135073,64,291221
3377,0.001427,172.31.40.0-255,66,135139,64,291221
3378,0.001443,74.125.200.0-255,7156,142295,64,291221
3379,0.00146,74.125.200.0-255,2902,145197,64,291221
3380,0.001465,74.125.200.0-255,4320,149517,64,291221
3381,0.00147,172.31.40.0-255,66,149583,64,291221
3382,0.00149,74.125.200.0-255,2902,152485,64,291221
3383,0.001504,172.31.40.0-255,66,152551,64,291221
3384,0.001509,74.125.200.0-255,2184,154735,64,291221
3385,0.001514,172.31.40.0-255,66,154801,64,291221
3386,0.001557,74.125.200.0-255,1484,156285,64,291221
3387,0.001576,74.125.200.0-255,2902,159187,64,291221
3388,0.001581,172.31.40.0-255,66,159253,64,291221
3389,0.001597,74.125.200.0-255,4320,163573,64,291221
3390,0.001625,74.125.200.0-255,1484,165057,64,291221
3391,0.00163,74.125.200.0-255,2902,167959,64,291221
3392,0.001633,74.125.200.0-255,1484,169443,64,291221
3393,0.00165,74.125.200.0-255,2902,172345,64,291221
3394,0.001655,172.31.40.0-255,66,172411,64,291221
3395,0.001676,74.125.200.0-255,7156,179567,64,291221
3396,0.001688,74.125.200.0-255,1484,181051,64,291221
3397,0.001693,172.31.40.0-255,66,181117,64,291221
3398,0.001704,74.125.200.0-255,7156,188273,64,291221
3399,0.001706,74.125.200.0-255,766,189039,64,291221
3400,0.001744,172.31.40.0-255,66,189105,64,291221
3401,0.001764,74.125.200.0-255,1484,190589,64,291221
3402,0.00177,74.125.200.0-255,4320,194909,64,291221
3403,0.001775,74.125.200.0-255,2902,197811,64,291221
3404,0.00179,74.125.200.0-255,2902,200713,64,291221
3405,0.001802,74.125.200.0-255,7156,207869,64,291221
3406,0.001806,74.125.200.0-255,2902,210771,64,291221
3407,0.001836,172.31.40.0-255,66,210837,64,291221
3408,0.001843,74.125.200.0-255,1484,212321,64,291221
3409,0.001865,74.125.200.0-255,2902,215223,64,291221
3410,0.001875,172.31.40.0-255,66,215289,64,291221
3411,0.001885,74.125.200.0-255,4320,219609,64,291221
3412,0.001895,172.31.40.0-255,66,219675,64,291221
3413,0.001901,74.125.200.0-255,3602,223277,64,291221
3414,0.001906,74.125.200.0-255,4320,227597,64,291221
3415,0.001921,74.125.200.0-255,5738,233335,64,291221
3416,0.001944,74.125.200.0-255,1484,234819,64,291221
3417,0.001948,74.125.200.0-255,2902,237721,64,291221
3418,0.001953,172.31.40.0-255,66,237787,64,291221
3419,0.001984,74.125.200.0-255,2902,240689,64,291221
3420,0.001993,172.31.40.0-255,66,240755,64,291221
3421,0.002027,74.125.200.0-255,5738,246493,64,291221
3422,0.002034,172.31.40.0-255,66,246559,64,291221
3423,0.002044,74.125.200.0-255,5738,252297,64,291221
3424,0.002049,74.125.200.0-255,4320,256617,64,291221
3425,0.002055,172.31.40.0-255,66,256683,64,291221
3426,0.002079,74.125.200.0-255,2902,259585,64,291221
3427,0.002117,172.31.40.0-255,66,259651,64,291221
3428,0.002134,74.125.200.0-255,4320,263971,64,291221
3429,0.002162,172.31.40.0-255,66,264037,64,291221
3430,0.002198,172.31.40.0-255,66,264103,64,291221
3431,0.002215,74.125.200.0-255,4320,268423,64,291221
3432,0.002247,172.31.40.0-255,66,268489,64,291221
3433,0.002254,74.125.200.0-255,1484,269973,64,291221
3434,0.002278,74.125.200.0-255,4320,274293,64,291221
3435,0.002293,74.125.200.0-255,5738,280031,64,291221
3436,0.002304,172.31.40.0-255,66,280097,64,291221
3437,0.002316,74.125.200.0-255,1484,281581,64,291221
3438,0.002343,74.125.200.0-255,97,281678,64,291221
3439,0.002345,74.125.200.0-255,105,281783,64,291221
3440,0.00237,172.31.40.0-255,66,281849,64,291221
3441,0.004926,172.31.40.0-255,105,281954,64,291221
3442,0.00747,74.125.200.0-255,66,282020,64,291221
3443,0.05374,172.31.40.0-255,172,282192,64,291221
3444,0.053774,172.31.40.0-255,1112,283304,64,291221
3445,0.053839,172.31.40.0-255,1514,284818,64,291221
3446,0.053842,172.31.40.0-255,1514,286332,64,291221
3447,0.053847,172.31.40.0-255,1514,287846,64,291221
3448,0.053848,172.31.40.0-255,1514,289360,64,291221
3449,0.053867,172.31.40.0-255,1514,290874,64,291221
3450,0.053868,172.31.40.0-255,83,290957,64,291221
3451,0.055321,104.244.42.0-255,66,291023,64,291221
3452,0.055335,104.244.42.0-255,66,291089,64,291221
3453,0.055418,104.244.42.0-255,66,291155,64,291221
3454,0.055424,104.244.42.0-255,66,291221,64,291221
3455,0.0,74.125.24.0-255,153,153,64,225554
3456,2.5e-05,172.31.40.0-255,66,219,64,225554
3457,3.3e-05,74.125.24.0-255,1484,1703,64,225554
3458,3.8e-05,172.31.40.0-255,66,1769,64,225554
3459,4.5e-05,74.125.24.0-255,2902,4671,64,225554
3460,4.8e-05,172.31.40.0-255,66,4737,64,225554
3461,5.7e-05,74.125.24.0-255,7156,11893,64,225554
3462,5.9e-05,172.31.40.0-255,66,11959,64,225554
3463,6.4e-05,74.125.24.0-255,2030,13989,64,225554
3464,6.6e-05,172.31.40.0-255,66,14055,64,225554
3465,0.0002,74.125.24.0-255,1484,15539,64,225554
3466,0.000205,172.31.40.0-255,66,15605,64,225554
3467,0.000212,74.125.24.0-255,2902,18507,64,225554
3468,0.000214,172.31.40.0-255,66,18573,64,225554
3469,0.000221,74.125.24.0-255,5738,24311,64,225554
3470,0.000224,172.31.40.0-255,66,24377,64,225554
3471,0.000271,172.31.40.0-255,66,24443,64,225554
3472,0.000289,74.125.24.0-255,1125,25568,64,225554
3473,0.000291,172.31.40.0-255,66,25634,64,225554
3474,0.000304,172.31.40.0-255,66,25700,64,225554
3475,0.000309,74.125.24.0-255,3961,29661,64,225554
3476,0.000312,172.31.40.0-255,66,29727,64,225554
3477,0.000362,74.125.24.0-255,4320,34047,64,225554
3478,0.000365,172.31.40.0-255,66,34113,64,225554
3479,0.000377,172.31.40.0-255,66,34179,64,225554
3480,0.000382,74.125.24.0-255,2543,36722,64,225554
3481,0.000384,172.31.40.0-255,66,36788,64,225554
3482,0.00133,74.125.24.0-255,645,37433,64,225554
3483,0.001338,172.31.40.0-255,66,37499,64,225554
3484,0.001359,74.125.24.0-255,1484,38983,64,225554
3485,0.001368,74.125.24.0-255,4320,43303,64,225554
3486,0.001371,172.31.40.0-255,66,43369,64,225554
3487,0.001391,74.125.24.0-255,4320,47689,64,225554
3488,0.001395,172.31.40.0-255,66,47755,64,225554
3489,0.001429,74.125.24.0-255,5738,53493,64,225554
3490,0.001432,172.31.40.0-255,66,53559,64,225554
3491,0.001443,172.31.40.0-255,66,53625,64,225554
3492,0.001484,74.125.24.0-255,2902,56527,64,225554
3493,0.001488,172.31.40.0-255,66,56593,64,225554
3494,0.001506,74.125.24.0-255,5020,61613,64,225554
3495,0.001508,172.31.40.0-255,66,61679,64,225554
3496,0.003581,74.125.24.0-255,5738,67417,64,225554
3497,0.003588,172.31.40.0-255,66,67483,64,225554
3498,0.005696,74.125.24.0-255,5738,73221,64,225554
3499,0.0057,172.31.40.0-255,66,73287,64,225554
3500,0.00776,74.125.24.0-255,5738,79025,64,225554
3501,0.007768,172.31.40.0-255,66,79091,64,225554
3502,0.009847,74.125.24.0-255,5738,84829,64,225554
3503,0.009856,172.31.40.0-255,66,84895,64,225554
3504,0.011946,74.125.24.0-255,5738,90633,64,225554
3505,0.011954,172.31.40.0-255,66,90699,64,225554
3506,0.014051,74.125.24.0-255,5738,96437,64,225554
3507,0.014063,172.31.40.0-255,66,96503,64,225554
3508,0.016192,74.125.24.0-255,5738,102241,64,225554
3509,0.0162,172.31.40.0-255,66,102307,64,225554
3510,0.018287,74.125.24.0-255,5738,108045,64,225554
3511,0.018295,172.31.40.0-255,66,108111,64,225554
3512,0.020388,74.125.24.0-255,5738,113849,64,225554
3513,0.020396,172.31.40.0-255,66,113915,64,225554
3514,0.022476,74.125.24.0-255,5738,119653,64,225554
3515,0.022484,172.31.40.0-255,66,119719,64,225554
3516,0.024535,74.125.24.0-255,5738,125457,64,225554
3517,0.024541,172.31.40.0-255,66,125523,64,225554
3518,0.024559,172.31.40.0-255,172,125695,64,225554
3519,0.024588,172.31.40.0-255,1112,126807,64,225554
3520,0.024694,172.31.40.0-255,1514,128321,64,225554
3521,0.024696,172.31.40.0-255,1514,129835,64,225554
3522,0.024697,172.31.40.0-255,1514,131349,64,225554
3523,0.024723,172.31.40.0-255,1077,132426,64,225554
3524,0.02611,104.244.42.0-255,66,132492,64,225554
3525,0.026153,104.244.42.0-255,66,132558,64,225554
3526,0.026252,104.244.42.0-255,66,132624,64,225554
3527,0.026297,104.244.42.0-255,66,132690,64,225554
3528,0.026609,74.125.24.0-255,5738,138428,64,225554
3529,0.026613,172.31.40.0-255,66,138494,64,225554
3530,0.02868,74.125.24.0-255,5738,144232,64,225554
3531,0.028686,172.31.40.0-255,66,144298,64,225554
3532,0.03081,74.125.24.0-255,5738,150036,64,225554
3533,0.030816,172.31.40.0-255,66,150102,64,225554
3534,0.032932,74.125.24.0-255,5738,155840,64,225554
3535,0.032939,172.31.40.0-255,66,155906,64,225554
3536,0.035027,74.125.24.0-255,5738,161644,64,225554
3537,0.035034,172.31.40.0-255,66,161710,64,225554
3538,0.037103,74.125.24.0-255,5738,167448,64,225554
3539,0.03711,172.31.40.0-255,66,167514,64,225554
3540,0.039206,74.125.24.0-255,5738,173252,64,225554
3541,0.039213,172.31.40.0-255,66,173318,64,225554
3542,0.041294,74.125.24.0-255,5738,179056,64,225554
3543,0.041303,172.31.40.0-255,66,179122,64,225554
3544,0.04344,74.125.24.0-255,5738,184860,64,225554
3545,0.043447,172.31.40.0-255,66,184926,64,225554
3546,0.045539,74.125.24.0-255,5738,190664,64,225554
3547,0.045545,172.31.40.0-255,66,190730,64,225554
3548,0.047628,74.125.24.0-255,5738,196468,64,225554
3549,0.047635,172.31.40.0-255,66,196534,64,225554
3550,0.04975,74.125.24.0-255,5738,202272,64,225554
3551,0.049756,172.31.40.0-255,66,202338,64,225554
3552,0.051878,74.125.24.0-255,5738,208076,64,225554
3553,0.051885,172.31.40.0-255,66,208142,64,225554
3554,0.053965,74.125.24.0-255,5738,213880,64,225554
3555,0.053972,172.31.40.0-255,66,213946,64,225554
3556,0.056062,74.125.24.0-255,5738,219684,64,225554
3557,0.056067,172.31.40.0-255,66,219750,64,225554
3558,0.058168,74.125.24.0-255,5738,225488,64,225554
3559,0.058188,172.31.40.0-255,66,225554,64,225554
3560,0.0,216.58.203.0-255,152,152,64,319367
3561,2.4e-05,172.31.40.0-255,66,218,64,319367
3562,3.1e-05,216.58.203.0-255,1484,1702,64,319367
3563,3.5e-05,172.31.40.0-255,66,1768,64,319367
3564,4.8e-05,216.58.203.0-255,2902,4670,64,319367
3565,5.2e-05,172.31.40.0-255,66,4736,64,319367
3566,5.9e-05,216.58.203.0-255,5738,10474,64,319367
3567,6.3e-05,172.31.40.0-255,66,10540,64,319367
3568,6.9e-05,216.58.203.0-255,4320,14860,64,319367
3569,7.1e-05,172.31.40.0-255,66,14926,64,319367
3570,9.4e-05,216.58.203.0-255,4974,19900,64,319367
3571,9.7e-05,172.31.40.0-255,66,19966,64,319367
3572,0.000103,216.58.203.0-255,5738,25704,64,319367
3573,0.000106,172.31.40.0-255,66,25770,64,319367
3574,0.000136,216.58.203.0-255,4320,30090,64,319367
3575,0.000139,172.31.40.0-255,66,30156,64,319367
3576,0.000143,216.58.203.0-255,1125,31281,64,319367
3577,0.000145,172.31.40.0-255,66,31347,64,319367
3578,0.000251,216.58.203.0-255,1484,32831,64,319367
3579,0.000255,172.31.40.0-255,66,32897,64,319367
3580,0.000259,216.58.203.0-255,1484,34381,64,319367
3581,0.000261,172.31.40.0-255,66,34447,64,319367
3582,0.000284,216.58.203.0-255,1484,35931,64,319367
3583,0.000291,172.31.40.0-255,66,35997,64,319367
3584,0.000297,216.58.203.0-255,4320,40317,64,319367
3585,0.000299,172.31.40.0-255,66,40383,64,319367
3586,0.000339,172.31.40.0-255,66,40449,64,319367
3587,0.000344,216.58.203.0-255,4320,44769,64,319367
3588,0.000346,172.31.40.0-255,66,44835,64,319367
3589,0.000386,216.58.203.0-255,5738,50573,64,319367
3590,0.000389,172.31.40.0-255,66,50639,64,319367
3591,0.000414,216.58.203.0-255,5645,56284,64,319367
3592,0.000417,172.31.40.0-255,66,56350,64,319367
3593,0.000569,216.58.203.0-255,139,56489,64,319367
3594,0.000768,216.58.203.0-255,1484,57973,64,319367
3595,0.000772,172.31.40.0-255,66,58039,64,319367
3596,0.000777,216.58.203.0-255,1484,59523,64,319367
3597,0.0008,216.58.203.0-255,1484,61007,64,319367
3598,0.000803,172.31.40.0-255,66,61073,64,319367
3599,0.000811,216.58.203.0-255,5738,66811,64,319367
3600,0.000818,172.31.40.0-255,66,66877,64,319367
3601,0.000829,172.31.40.0-255,66,66943,64,319367
3602,0.000854,216.58.203.0-255,5379,72322,64,319367
3603,0.000862,172.31.40.0-255,66,72388,64,319367
3604,0.000873,172.31.40.0-255,66,72454,64,319367
3605,0.00114,216.58.203.0-255,1484,73938,64,319367
3606,0.001146,216.58.203.0-255,2902,76840,64,319367
3607,0.001149,172.31.40.0-255,66,76906,64,319367
3608,0.001181,216.58.203.0-255,2902,79808,64,319367
3609,0.001183,172.31.40.0-255,66,79874,64,319367
3610,0.001209,216.58.203.0-255,2902,82776,64,319367
3611,0.001212,172.31.40.0-255,66,82842,64,319367
3612,0.001228,172.31.40.0-255,66,82908,64,319367
3613,0.001264,172.31.40.0-255,66,82974,64,319367
3614,0.001557,216.58.203.0-255,1484,84458,64,319367
3615,0.00158,216.58.203.0-255,2902,87360,64,319367
3616,0.001584,172.31.40.0-255,66,87426,64,319367
3617,0.001591,216.58.203.0-255,5738,93164,64,319367
3618,0.001593,172.31.40.0-255,66,93230,64,319367
3619,0.001602,216.58.203.0-255,4320,97550,64,319367
3620,0.001605,172.31.40.0-255,66,97616,64,319367
3621,0.001611,216.58.203.0-255,5738,103354,64,319367
3622,0.001613,172.31.40.0-255,66,103420,64,319367
3623,0.00162,216.58.203.0-255,5738,109158,64,319367
3624,0.001621,172.31.40.0-255,66,109224,64,319367
3625,0.001661,216.58.203.0-255,5738,114962,64,319367
3626,0.001664,172.31.40.0-255,66,115028,64,319367
3627,0.001668,216.58.203.0-255,2184,117212,64,319367
3628,0.00167,172.31.40.0-255,66,117278,64,319367
3629,0.003348,216.58.203.0-255,2902,120180,64,319367
3630,0.003355,172.31.40.0-255,66,120246,64,319367
3631,0.003384,216.58.203.0-255,2902,123148,64,319367
3632,0.003387,172.31.40.0-255,66,123214,64,319367
3633,0.005014,216.58.203.0-255,2902,126116,64,319367
3634,0.005017,172.31.40.0-255,66,126182,64,319367
3635,0.005041,216.58.203.0-255,1484,127666,64,319367
3636,0.005053,216.58.203.0-255,1484,129150,64,319367
3637,0.005055,172.31.40.0-255,66,129216,64,319367
3638,0.006687,216.58.203.0-255,2902,132118,64,319367
3639,0.006691,172.31.40.0-255,66,132184,64,319367
3640,0.006717,216.58.203.0-255,2902,135086,64,319367
3641,0.006719,172.31.40.0-255,66,135152,64,319367
3642,0.008373,216.58.203.0-255,5738,140890,64,319367
3643,0.00838,172.31.40.0-255,66,140956,64,319367
3644,0.010052,216.58.203.0-255,5738,146694,64,319367
3645,0.01006,172.31.40.0-255,66,146760,64,319367
3646,0.011739,216.58.203.0-255,5738,152498,64,319367
3647,0.011747,172.31.40.0-255,66,152564,64,319367
3648,0.013419,216.58.203.0-255,5738,158302,64,319367
3649,0.013426,172.31.40.0-255,66,158368,64,319367
3650,0.015104,216.58.203.0-255,5738,164106,64,319367
3651,0.015113,172.31.40.0-255,66,164172,64,319367
3652,0.016794,216.58.203.0-255,5738,169910,64,319367
3653,0.016801,172.31.40.0-255,66,169976,64,319367
3654,0.018477,216.58.203.0-255,5738,175714,64,319367
3655,0.018484,172.31.40.0-255,66,175780,64,319367
3656,0.020169,216.58.203.0-255,5738,181518,64,319367
3657,0.020176,172.31.40.0-255,66,181584,64,319367
3658,0.021852,216.58.203.0-255,5738,187322,64,319367
3659,0.021859,172.31.40.0-255,66,187388,64,319367
3660,0.023542,216.58.203.0-255,5738,193126,64,319367
3661,0.023549,172.31.40.0-255,66,193192,64,319367
3662,0.025247,216.58.203.0-255,5738,198930,64,319367
3663,0.025254,172.31.40.0-255,66,198996,64,319367
3664,0.026937,216.58.203.0-255,5738,204734,64,319367
3665,0.026944,172.31.40.0-255,66,204800,64,319367
3666,0.02863,216.58.203.0-255,5738,210538,64,319367
3667,0.028644,172.31.40.0-255,66,210604,64,319367
3668,0.030321,216.58.203.0-255,5738,216342,64,319367
3669,0.030333,172.31.40.0-255,66,216408,64,319367
3670,0.032024,216.58.203.0-255,5738,222146,64,319367
3671,0.032034,172.31.40.0-255,66,222212,64,319367
3672,0.033711,216.58.203.0-255,5738,227950,64,319367
3673,0.033723,172.31.40.0-255,66,228016,64,319367
3674,0.035414,216.58.203.0-255,5738,233754,64,319367
3675,0.035426,172.31.40.0-255,66,233820,64,319367
3676,0.037104,216.58.203.0-255,5738,239558,64,319367
3677,0.037111,172.31.40.0-255,66,239624,64,319367
3678,0.038784,216.58.203.0-255,5738,245362,64,319367
3679,0.038795,172.31.40.0-255,66,245428,64,319367
3680,0.039451,172.31.40.0-255,171,245599,64,319367
3681,0.039484,172.31.40.0-255,1137,246736,64,319367
3682,0.039543,172.31.40.0-255,1514,248250,64,319367
3683,0.039544,172.31.40.0-255,1271,249521,64,319367
3684,0.04047,216.58.203.0-255,5738,255259,64,319367
3685,0.040477,172.31.40.0-255,66,255325,64,319367
3686,0.041015,104.244.42.0-255,66,255391,64,319367
3687,0.041189,104.244.42.0-255,66,255457,64,319367
3688,0.041235,104.244.42.0-255,66,255523,64,319367
3689,0.042151,216.58.203.0-255,5738,261261,64,319367
3690,0.042159,172.31.40.0-255,66,261327,64,319367
3691,0.043848,216.58.203.0-255,5738,267065,64,319367
3692,0.043858,172.31.40.0-255,66,267131,64,319367
3693,0.04553,216.58.203.0-255,5738,272869,64,319367
3694,0.04554,172.31.40.0-255,66,272935,64,319367
3695,0.047221,216.58.203.0-255,5738,278673,64,319367
3696,0.04723,172.31.40.0-255,66,278739,64,319367
3697,0.048912,216.58.203.0-255,5738,284477,64,319367
3698,0.048922,172.31.40.0-255,66,284543,64,319367
3699,0.050604,216.58.203.0-255,5738,290281,64,319367
3700,0.050617,172.31.40.0-255,66,290347,64,319367
3701,0.052294,216.58.203.0-255,5738,296085,64,319367
3702,0.0523,172.31.40.0-255,66,296151,64,319367
3703,0.053985,216.58.203.0-255,5738,301889,64,319367
3704,0.053997,172.31.40.0-255,66,301955,64,319367
3705,0.055683,216.58.203.0-255,5738,307693,64,319367
3706,0.055695,172.31.40.0-255,66,307759,64,319367
3707,0.057378,216.58.203.0-255,5738,313497,64,319367
3708,0.057392,172.31.40.0-255,66,313563,64,319367
3709,0.059075,216.58.203.0-255,5738,319301,64,319367
3710,0.059086,172.31.40.0-255,66,319367,64,319367
3711,0.0,74.125.24.0-255,154,154,64,260662
3712,1.8e-05,172.31.40.0-255,66,220,64,260662
3713,2.5e-05,74.125.24.0-255,1484,1704,64,260662
3714,3e-05,172.31.40.0-255,66,1770,64,260662
3715,3.6e-05,74.125.24.0-255,2902,4672,64,260662
3716,4.7e-05,172.31.40.0-255,66,4738,64,260662
3717,5.4e-05,74.125.24.0-255,7156,11894,64,260662
3718,5.8e-05,172.31.40.0-255,66,11960,64,260662
3719,6.2e-05,74.125.24.0-255,2002,13962,64,260662
3720,6.5e-05,172.31.40.0-255,66,14028,64,260662
3721,0.000186,74.125.24.0-255,1484,15512,64,260662
3722,0.00019,172.31.40.0-255,66,15578,64,260662
3723,0.000197,74.125.24.0-255,2902,18480,64,260662
3724,0.0002,172.31.40.0-255,66,18546,64,260662
3725,0.000211,74.125.24.0-255,5738,24284,64,260662
3726,0.000213,172.31.40.0-255,66,24350,64,260662
3727,0.00022,74.125.24.0-255,5738,30088,64,260662
3728,0.000222,172.31.40.0-255,66,30154,64,260662
3729,0.000255,74.125.24.0-255,1125,31279,64,260662
3730,0.000258,172.31.40.0-255,66,31345,64,260662
3731,0.000403,74.125.24.0-255,1484,32829,64,260662
3732,0.000407,172.31.40.0-255,66,32895,64,260662
3733,0.000431,74.125.24.0-255,1484,34379,64,260662
3734,0.000434,172.31.40.0-255,66,34445,64,260662
3735,0.000439,74.125.24.0-255,2902,37347,64,260662
3736,0.000442,172.31.40.0-255,66,37413,64,260662
3737,0.000451,74.125.24.0-255,2902,40315,64,260662
3738,0.000453,172.31.40.0-255,66,40381,64,260662
3739,0.000484,74.125.24.0-255,2902,43283,64,260662
3740,0.000487,172.31.40.0-255,66,43349,64,260662
3741,0.000493,74.125.24.0-255,4320,47669,64,260662
3742,0.000496,172.31.40.0-255,66,47735,64,260662
3743,0.000502,74.125.24.0-255,5738,53473,64,260662
3744,0.000511,172.31.40.0-255,66,53539,64,260662
3745,0.000543,74.125.24.0-255,6797,60336,64,260662
3746,0.00055,74.125.24.0-255,5379,65715,64,260662
3747,0.000553,74.125.24.0-255,412,66127,64,260662
3748,0.00058,172.31.40.0-255,66,66193,64,260662
3749,0.000608,74.125.24.0-255,333,66526,64,260662
3750,0.001007,74.125.24.0-255,1484,68010,64,260662
3751,0.001011,172.31.40.0-255,66,68076,64,260662
3752,0.001017,74.125.24.0-255,2902,70978,64,260662
3753,0.001022,74.125.24.0-255,2902,73880,64,260662
3754,0.001033,172.31.40.0-255,66,73946,64,260662
3755,0.001043,74.125.24.0-255,2902,76848,64,260662
3756,0.001069,74.125.24.0-255,1484,78332,64,260662
3757,0.001119,172.31.40.0-255,66,78398,64,260662
3758,0.001402,74.125.24.0-255,1484,79882,64,260662
3759,0.001416,74.125.24.0-255,2902,82784,64,260662
3760,0.001419,172.31.40.0-255,66,82850,64,260662
3761,0.001426,74.125.24.0-255,5738,88588,64,260662
3762,0.001448,74.125.24.0-255,5738,94326,64,260662
3763,0.001462,74.125.24.0-255,4320,98646,64,260662
3764,0.001473,172.31.40.0-255,66,98712,64,260662
3765,0.001477,74.125.24.0-255,2902,101614,64,260662
3766,0.001483,74.125.24.0-255,5738,107352,64,260662
3767,0.001493,172.31.40.0-255,66,107418,64,260662
3768,0.001504,74.125.24.0-255,5020,112438,64,260662
3769,0.001527,172.31.40.0-255,66,112504,64,260662
3770,0.001746,74.125.24.0-255,1484,113988,64,260662
3771,0.00175,74.125.24.0-255,1484,115472,64,260662
3772,0.001753,172.31.40.0-255,66,115538,64,260662
3773,0.001778,74.125.24.0-255,1484,117022,64,260662
3774,0.001784,74.125.24.0-255,5738,122760,64,260662
3775,0.00182,172.31.40.0-255,66,122826,64,260662
3776,0.001832,74.125.24.0-255,7156,129982,64,260662
3777,0.001849,172.31.40.0-255,66,130048,64,260662
3778,0.001878,172.31.40.0-255,66,130114,64,260662
3779,0.002011,74.125.24.0-255,1484,131598,64,260662
3780,0.002017,74.125.24.0-255,2902,134500,64,260662
3781,0.00202,172.31.40.0-255,66,134566,64,260662
3782,0.002026,74.125.24.0-255,4320,138886,64,260662
3783,0.002053,74.125.24.0-255,1484,140370,64,260662
3784,0.002073,172.31.40.0-255,66,140436,64,260662
3785,0.00208,74.125.24.0-255,1484,141920,64,260662
3786,0.002086,74.125.24.0-255,4320,146240,64,260662
3787,0.002104,74.125.24.0-255,6438,152678,64,260662
3788,0.002108,172.31.40.0-255,66,152744,64,260662
3789,0.002309,74.125.24.0-255,1484,154228,64,260662
3790,0.002315,74.125.24.0-255,2902,157130,64,260662
3791,0.002318,172.31.40.0-255,66,157196,64,260662
3792,0.002322,74.125.24.0-255,1484,158680,64,260662
3793,0.00235,74.125.24.0-255,4320,163000,64,260662
3794,0.002357,74.125.24.0-255,7156,170156,64,260662
3795,0.002362,74.125.24.0-255,4320,174476,64,260662
3796,0.00237,172.31.40.0-255,66,174542,64,260662
3797,0.002396,74.125.24.0-255,2184,176726,64,260662
3798,0.002416,172.31.40.0-255,66,176792,64,260662
3799,0.002444,74.125.24.0-255,7156,183948,64,260662
3800,0.002463,172.31.40.0-255,66,184014,64,260662
3801,0.002513,74.125.24.0-255,766,184780,64,260662
3802,0.002568,74.125.24.0-255,7156,191936,64,260662
3803,0.00258,74.125.24.0-255,1484,193420,64,260662
3804,0.002583,74.125.24.0-255,1484,194904,64,260662
3805,0.002607,74.125.24.0-255,6438,201342,64,260662
3806,0.00267,74.125.24.0-255,1484,202826,64,260662
3807,0.002674,74.125.24.0-255,1484,204310,64,260662
3808,0.00269,74.125.24.0-255,1484,205794,64,260662
3809,0.002693,74.125.24.0-255,1484,207278,64,260662
3810,0.002714,74.125.24.0-255,4320,211598,64,260662
3811,0.002717,74.125.24.0-255,1484,213082,64,260662
3812,0.002804,74.125.24.0-255,1484,214566,64,260662
3813,0.002823,74.125.24.0-255,2902,217468,64,260662
3814,0.002828,74.125.24.0-255,4320,221788,64,260662
3815,0.002845,74.125.24.0-255,1484,223272,64,260662
3816,0.002858,74.125.24.0-255,2902,226174,64,260662
3817,0.002873,74.125.24.0-255,4320,230494,64,260662
3818,0.002903,74.125.24.0-255,5738,236232,64,260662
3819,0.002907,74.125.24.0-255,2184,238416,64,260662
3820,0.00326,74.125.24.0-255,1484,239900,64,260662
3821,0.003266,74.125.24.0-255,2902,242802,64,260662
3822,0.003295,74.125.24.0-255,5738,248540,64,260662
3823,0.003299,74.125.24.0-255,2902,251442,64,260662
3824,0.003311,74.125.24.0-255,1484,252926,64,260662
3825,0.003349,74.125.24.0-255,1484,254410,64,260662
3826,0.003395,74.125.24.0-255,2398,256808,64,260662
3827,0.003428,74.125.24.0-255,105,256913,64,260662
3828,0.012057,172.31.40.0-255,66,256979,64,260662
3829,0.013475,74.125.24.0-255,105,257084,64,260662
3830,0.013487,172.31.40.0-255,78,257162,64,260662
3831,0.014119,172.31.40.0-255,105,257267,64,260662
3832,0.016647,74.125.24.0-255,66,257333,64,260662
3833,0.049547,172.31.40.0-255,172,257505,64,260662
3834,0.049579,172.31.40.0-255,1108,258613,64,260662
3835,0.049634,172.31.40.0-255,1514,260127,64,260662
3836,0.049636,172.31.40.0-255,337,260464,64,260662
3837,0.051126,104.244.42.0-255,66,260530,64,260662
3838,0.051152,104.244.42.0-255,66,260596,64,260662
3839,0.051168,104.244.42.0-255,66,260662,64,260662
3840,0.0,172.217.27.0-255,153,153,64,301980
3841,2.3e-05,172.31.40.0-255,66,219,64,301980
3842,3.1e-05,172.217.27.0-255,1484,1703,64,301980
3843,3.6e-05,172.31.40.0-255,66,1769,64,301980
3844,4.9e-05,172.217.27.0-255,2902,4671,64,301980
3845,5.2e-05,172.31.40.0-255,66,4737,64,301980
3846,5.5e-05,172.217.27.0-255,1484,6221,64,301980
3847,5.8e-05,172.31.40.0-255,66,6287,64,301980
3848,6.3e-05,172.217.27.0-255,1484,7771,64,301980
3849,6.5e-05,172.31.40.0-255,66,7837,64,301980
3850,7.1e-05,172.217.27.0-255,2902,10739,64,301980
3851,7.3e-05,172.31.40.0-255,66,10805,64,301980
3852,0.000129,172.217.27.0-255,3557,14362,64,301980
3853,0.000132,172.31.40.0-255,66,14428,64,301980
3854,0.000257,172.217.27.0-255,1484,15912,64,301980
3855,0.000262,172.31.40.0-255,66,15978,64,301980
3856,0.000267,172.217.27.0-255,2902,18880,64,301980
3857,0.00027,172.31.40.0-255,66,18946,64,301980
3858,0.000297,172.217.27.0-255,5738,24684,64,301980
3859,0.0003,172.31.40.0-255,66,24750,64,301980
3860,0.000308,172.217.27.0-255,6797,31547,64,301980
3861,0.00031,172.31.40.0-255,66,31613,64,301980
3862,0.000337,172.217.27.0-255,1484,33097,64,301980
3863,0.000339,172.31.40.0-255,66,33163,64,301980
3864,0.000343,172.217.27.0-255,2902,36065,64,301980
3865,0.000345,172.31.40.0-255,66,36131,64,301980
3866,0.000348,172.217.27.0-255,1484,37615,64,301980
3867,0.00035,172.31.40.0-255,66,37681,64,301980
3868,0.00038,172.217.27.0-255,2902,40583,64,301980
3869,0.000383,172.31.40.0-255,66,40649,64,301980
3870,0.000415,172.31.40.0-255,66,40715,64,301980
3871,0.000463,172.217.27.0-255,1484,42199,64,301980
3872,0.000467,172.217.27.0-255,1484,43683,64,301980
3873,0.00047,172.31.40.0-255,66,43749,64,301980
3874,0.000494,172.217.27.0-255,1484,45233,64,301980
3875,0.000501,172.217.27.0-255,5738,50971,64,301980
3876,0.000503,172.31.40.0-255,66,51037,64,301980
3877,0.000509,172.217.27.0-255,5738,56775,64,301980
3878,0.000512,172.31.40.0-255,66,56841,64,301980
3879,0.000515,172.217.27.0-255,1125,57966,64,301980
3880,0.000551,172.217.27.0-255,354,58320,64,301980
3881,0.001049,172.217.27.0-255,137,58457,64,301980
3882,0.001175,172.31.40.0-255,66,58523,64,301980
3883,0.001213,172.217.27.0-255,1484,60007,64,301980
3884,0.001217,172.217.27.0-255,1484,61491,64,301980
3885,0.001221,172.31.40.0-255,66,61557,64,301980
3886,0.00125,172.217.27.0-255,1484,63041,64,301980
3887,0.001256,172.217.27.0-255,5738,68779,64,301980
3888,0.001258,172.31.40.0-255,66,68845,64,301980
3889,0.001265,172.217.27.0-255,6797,75642,64,301980
3890,0.001267,172.31.40.0-255,66,75708,64,301980
3891,0.0013,172.217.27.0-255,1484,77192,64,301980
3892,0.00132,172.217.27.0-255,2902,80094,64,301980
3893,0.001323,172.31.40.0-255,66,80160,64,301980
3894,0.001327,172.217.27.0-255,2902,83062,64,301980
3895,0.001329,172.31.40.0-255,66,83128,64,301980
3896,0.001345,172.217.27.0-255,2902,86030,64,301980
3897,0.001348,172.31.40.0-255,66,86096,64,301980
3898,0.001351,172.217.27.0-255,1484,87580,64,301980
3899,0.001388,172.217.27.0-255,5379,92959,64,301980
3900,0.001391,172.31.40.0-255,66,93025,64,301980
3901,0.00301,172.217.27.0-255,5738,98763,64,301980
3902,0.003017,172.31.40.0-255,66,98829,64,301980
3903,0.004649,172.217.27.0-255,5738,104567,64,301980
3904,0.004653,172.31.40.0-255,66,104633,64,301980
3905,0.006269,172.217.27.0-255,4320,108953,64,301980
3906,0.006273,172.31.40.0-255,66,109019,64,301980
3907,0.006299,172.217.27.0-255,1484,110503,64,301980
3908,0.007921,172.217.27.0-255,4320,114823,64,301980
3909,0.007928,172.31.40.0-255,66,114889,64,301980
3910,0.009562,172.217.27.0-255,5738,120627,64,301980
3911,0.009569,172.31.40.0-255,66,120693,64,301980
3912,0.011186,172.217.27.0-255,5738,126431,64,301980
3913,0.011198,172.31.40.0-255,66,126497,64,301980
3914,0.012834,172.217.27.0-255,5738,132235,64,301980
3915,0.012843,172.31.40.0-255,66,132301,64,301980
3916,0.014488,172.217.27.0-255,5738,138039,64,301980
3917,0.014498,172.31.40.0-255,66,138105,64,301980
3918,0.016133,172.217.27.0-255,5738,143843,64,301980
3919,0.01614,172.31.40.0-255,66,143909,64,301980
3920,0.01778,172.217.27.0-255,5738,149647,64,301980
3921,0.017787,172.31.40.0-255,66,149713,64,301980
3922,0.019415,172.217.27.0-255,5738,155451,64,301980
3923,0.019421,172.31.40.0-255,66,155517,64,301980
3924,0.021047,172.217.27.0-255,5738,161255,64,301980
3925,0.021056,172.31.40.0-255,66,161321,64,301980
3926,0.022689,172.217.27.0-255,5738,167059,64,301980
3927,0.022697,172.31.40.0-255,66,167125,64,301980
3928,0.024334,172.217.27.0-255,5738,172863,64,301980
3929,0.024341,172.31.40.0-255,66,172929,64,301980
3930,0.025966,172.217.27.0-255,5738,178667,64,301980
3931,0.025973,172.31.40.0-255,66,178733,64,301980
3932,0.027645,172.217.27.0-255,5738,184471,64,301980
3933,0.027651,172.31.40.0-255,66,184537,64,301980
3934,0.02867,172.31.40.0-255,172,184709,64,301980
3935,0.028706,172.31.40.0-255,1113,185822,64,301980
3936,0.02877,172.31.40.0-255,1514,187336,64,301980
3937,0.028772,172.31.40.0-255,1514,188850,64,301980
3938,0.028773,172.31.40.0-255,1514,190364,64,301980
3939,0.028774,172.31.40.0-255,1076,191440,64,301980
3940,0.029272,172.217.27.0-255,5738,197178,64,301980
3941,0.029279,172.31.40.0-255,66,197244,64,301980
3942,0.030242,104.244.42.0-255,66,197310,64,301980
3943,0.030298,104.244.42.0-255,66,197376,64,301980
3944,0.030333,104.244.42.0-255,66,197442,64,301980
3945,0.030347,104.244.42.0-255,66,197508,64,301980
3946,0.030924,172.217.27.0-255,5738,203246,64,301980
3947,0.03093,172.31.40.0-255,66,203312,64,301980
3948,0.032571,172.217.27.0-255,5738,209050,64,301980
3949,0.032579,172.31.40.0-255,66,209116,64,301980
3950,0.034211,172.217.27.0-255,5738,214854,64,301980
3951,0.034218,172.31.40.0-255,66,214920,64,301980
3952,0.035852,172.217.27.0-255,5738,220658,64,301980
3953,0.035859,172.31.40.0-255,66,220724,64,301980
3954,0.037497,172.217.27.0-255,5738,226462,64,301980
3955,0.037504,172.31.40.0-255,66,226528,64,301980
3956,0.039128,172.217.27.0-255,5738,232266,64,301980
3957,0.039135,172.31.40.0-255,66,232332,64,301980
3958,0.040772,172.217.27.0-255,5738,238070,64,301980
3959,0.040778,172.31.40.0-255,66,238136,64,301980
3960,0.042409,172.217.27.0-255,5738,243874,64,301980
3961,0.042417,172.31.40.0-255,66,243940,64,301980
3962,0.044068,172.217.27.0-255,5738,249678,64,301980
3963,0.044084,172.31.40.0-255,66,249744,64,301980
3964,0.045728,172.217.27.0-255,5738,255482,64,301980
3965,0.045743,172.31.40.0-255,66,255548,64,301980
3966,0.047371,172.217.27.0-255,5738,261286,64,301980
3967,0.047382,172.31.40.0-255,66,261352,64,301980
3968,0.049012,172.217.27.0-255,5738,267090,64,301980
3969,0.049022,172.31.40.0-255,66,267156,64,301980
3970,0.050663,172.217.27.0-255,5738,272894,64,301980
3971,0.050675,172.31.40.0-255,66,272960,64,301980
3972,0.052305,172.217.27.0-255,5738,278698,64,301980
3973,0.052316,172.31.40.0-255,66,278764,64,301980
3974,0.053946,172.217.27.0-255,5738,284502,64,301980
3975,0.053955,172.31.40.0-255,66,284568,64,301980
3976,0.05559,172.217.27.0-255,5738,290306,64,301980
3977,0.055603,172.31.40.0-255,66,290372,64,301980
3978,0.057242,172.217.27.0-255,5738,296110,64,301980
3979,0.057252,172.31.40.0-255,66,296176,64,301980
3980,0.058884,172.217.27.0-255,5738,301914,64,301980
3981,0.058892,172.31.40.0-255,66,301980,64,301980
3982,0.0,74.125.200.0-255,146,146,64,347516
3983,2.3e-05,172.31.40.0-255,66,212,64,347516
3984,3e-05,74.125.200.0-255,1484,1696,64,347516
3985,3.4e-05,172.31.40.0-255,66,1762,64,347516
3986,3.9e-05,74.125.200.0-255,2902,4664,64,347516
3987,4.3e-05,172.31.40.0-255,66,4730,64,347516
3988,4.9e-05,74.125.200.0-255,4320,9050,64,347516
3989,5.3e-05,172.31.40.0-255,66,9116,64,347516
3990,7.4e-05,74.125.200.0-255,2902,12018,64,347516
3991,7.7e-05,172.31.40.0-255,66,12084,64,347516
3992,9.3e-05,74.125.200.0-255,2101,14185,64,347516
3993,9.6e-05,172.31.40.0-255,66,14251,64,347516
3994,0.000202,74.125.200.0-255,1484,15735,64,347516
3995,0.000205,172.31.40.0-255,66,15801,64,347516
3996,0.000211,74.125.200.0-255,2902,18703,64,347516
3997,0.000213,172.31.40.0-255,66,18769,64,347516
3998,0.000232,74.125.200.0-255,5738,24507,64,347516
3999,0.000234,172.31.40.0-255,66,24573,64,347516
4000,0.000254,74.125.200.0-255,6797,31370,64,347516
4001,0.000257,172.31.40.0-255,66,31436,64,347516
4002,0.000281,74.125.200.0-255,1484,32920,64,347516
4003,0.000284,172.31.40.0-255,66,32986,64,347516
4004,0.000303,74.125.200.0-255,2902,35888,64,347516
4005,0.000306,172.31.40.0-255,66,35954,64,347516
4006,0.000313,74.125.200.0-255,5738,41692,64,347516
4007,0.000316,172.31.40.0-255,66,41758,64,347516
4008,0.00033,74.125.200.0-255,4320,46078,64,347516
4009,0.000333,172.31.40.0-255,66,46144,64,347516
4010,0.00038,74.125.200.0-255,2543,48687,64,347516
4011,0.000383,172.31.40.0-255,66,48753,64,347516
4012,0.000816,74.125.200.0-255,1484,50237,64,347516
4013,0.000821,172.31.40.0-255,66,50303,64,347516
4014,0.000827,74.125.200.0-255,2902,53205,64,347516
4015,0.000829,172.31.40.0-255,66,53271,64,347516
4016,0.000833,74.125.200.0-255,1484,54755,64,347516
4017,0.000835,172.31.40.0-255,66,54821,64,347516
4018,0.00084,74.125.200.0-255,2902,57723,64,347516
4019,0.000842,172.31.40.0-255,66,57789,64,347516
4020,0.000881,74.125.200.0-255,5738,63527,64,347516
4021,0.000884,172.31.40.0-255,66,63593,64,347516
4022,0.000889,74.125.200.0-255,2902,66495,64,347516
4023,0.000891,172.31.40.0-255,66,66561,64,347516
4024,0.000918,74.125.200.0-255,3961,70522,64,347516
4025,0.000921,172.31.40.0-255,66,70588,64,347516
4026,0.000929,74.125.200.0-255,7156,77744,64,347516
4027,0.000932,172.31.40.0-255,66,77810,64,347516
4028,0.000937,74.125.200.0-255,4320,82130,64,347516
4029,0.000939,172.31.40.0-255,66,82196,64,347516
4030,0.000965,74.125.200.0-255,1706,83902,64,347516
4031,0.000968,172.31.40.0-255,66,83968,64,347516
4032,0.000985,74.125.200.0-255,1484,85452,64,347516
4033,0.000988,172.31.40.0-255,66,85518,64,347516
4034,0.001005,74.125.200.0-255,2902,88420,64,347516
4035,0.001008,172.31.40.0-255,66,88486,64,347516
4036,0.001014,74.125.200.0-255,5738,94224,64,347516
4037,0.001017,172.31.40.0-255,66,94290,64,347516
4038,0.001048,172.31.40.0-255,66,94356,64,347516
4039,0.001054,74.125.200.0-255,5738,100094,64,347516
4040,0.001056,172.31.40.0-255,66,100160,64,347516
4041,0.001088,74.125.200.0-255,2902,103062,64,347516
4042,0.001091,172.31.40.0-255,66,103128,64,347516
4043,0.001112,74.125.200.0-255,2937,106065,64,347516
4044,0.001114,172.31.40.0-255,66,106131,64,347516
4045,0.00112,74.125.200.0-255,4320,110451,64,347516
4046,0.001122,172.31.40.0-255,66,110517,64,347516
4047,0.001138,74.125.200.0-255,2902,113419,64,347516
4048,0.001141,172.31.40.0-255,66,113485,64,347516
4049,0.001148,74.125.200.0-255,7156,120641,64,347516
4050,0.00115,172.31.40.0-255,66,120707,64,347516
4051,0.001197,74.125.200.0-255,3239,123946,64,347516
4052,0.001201,172.31.40.0-255,66,124012,64,347516
4053,0.001233,74.125.200.0-255,4320,128332,64,347516
4054,0.001237,172.31.40.0-255,66,128398,64,347516
4055,0.00125,74.125.200.0-255,4320,132718,64,347516
4056,0.001254,172.31.40.0-255,66,132784,64,347516
4057,0.00126,74.125.200.0-255,5738,138522,64,347516
4058,0.001262,172.31.40.0-255,66,138588,64,347516
4059,0.001292,74.125.200.0-255,1484,140072,64,347516
4060,0.001295,172.31.40.0-255,66,140138,64,347516
4061,0.001328,172.31.40.0-255,66,140204,64,347516
4062,0.001364,172.31.40.0-255,66,140270,64,347516
4063,0.00138,74.125.200.0-255,766,141036,64,347516
4064,0.001383,172.31.40.0-255,66,141102,64,347516
4065,0.001738,74.125.200.0-255,1484,142586,64,347516
4066,0.001743,172.31.40.0-255,66,142652,64,347516
4067,0.001748,74.125.200.0-255,2902,145554,64,347516
4068,0.00175,172.31.40.0-255,66,145620,64,347516
4069,0.001755,74.125.200.0-255,4320,149940,64,347516
4070,0.001757,172.31.40.0-255,66,150006,64,347516
4071,0.001777,74.125.200.0-255,5738,155744,64,347516
4072,0.001781,172.31.40.0-255,66,155810,64,347516
4073,0.001789,74.125.200.0-255,2902,158712,64,347516
4074,0.001792,172.31.40.0-255,66,158778,64,347516
4075,0.001795,74.125.200.0-255,1484,160262,64,347516
4076,0.001821,74.125.200.0-255,7156,167418,64,347516
4077,0.001833,172.31.40.0-255,66,167484,64,347516
4078,0.001851,74.125.200.0-255,1484,168968,64,347516
4079,0.001873,74.125.200.0-255,6438,175406,64,347516
4080,0.001888,172.31.40.0-255,66,175472,64,347516
4081,0.001901,74.125.200.0-255,1484,176956,64,347516
4082,0.001925,74.125.200.0-255,2902,179858,64,347516
4083,0.001936,172.31.40.0-255,66,179924,64,347516
4084,0.001949,74.125.200.0-255,5738,185662,64,347516
4085,0.001953,74.125.200.0-255,2902,188564,64,347516
4086,0.001956,74.125.200.0-255,1484,190048,64,347516
4087,0.001959,172.31.40.0-255,66,190114,64,347516
4088,0.001975,74.125.200.0-255,2902,193016,64,347516
4089,0.001989,172.31.40.0-255,66,193082,64,347516
4090,0.002009,74.125.200.0-255,5738,198820,64,347516
4091,0.002019,172.31.40.0-255,66,198886,64,347516
4092,0.002022,74.125.200.0-255,1484,200370,64,347516
4093,0.002037,74.125.200.0-255,766,201136,64,347516
4094,0.002046,172.31.40.0-255,66,201202,64,347516
4095,0.002184,74.125.200.0-255,1484,202686,64,347516
4096,0.002198,74.125.200.0-255,2902,205588,64,347516
4097,0.002201,172.31.40.0-255,66,205654,64,347516
4098,0.002204,74.125.200.0-255,1484,207138,64,347516
4099,0.002207,74.125.200.0-255,1484,208622,64,347516
4100,0.00222,74.125.200.0-255,1484,210106,64,347516
4101,0.002223,74.125.200.0-255,1484,211590,64,347516
4102,0.002232,172.31.40.0-255,66,211656,64,347516
4103,0.002248,74.125.200.0-255,4320,215976,64,347516
4104,0.002266,74.125.200.0-255,5738,221714,64,347516
4105,0.002282,74.125.200.0-255,2902,224616,64,347516
4106,0.011655,74.125.200.0-255,1484,226100,64,347516
4107,0.012634,172.31.40.0-255,66,226166,64,347516
4108,0.014885,74.125.200.0-255,5738,231904,64,347516
4109,0.014891,172.31.40.0-255,66,231970,64,347516
4110,0.017167,74.125.200.0-255,5738,237708,64,347516
4111,0.017177,172.31.40.0-255,66,237774,64,347516
4112,0.019445,74.125.200.0-255,5738,243512,64,347516
4113,0.019461,172.31.40.0-255,66,243578,64,347516
4114,0.021705,74.125.200.0-255,5738,249316,64,347516
4115,0.021713,172.31.40.0-255,66,249382,64,347516
4116,0.02398,74.125.200.0-255,5738,255120,64,347516
4117,0.023988,172.31.40.0-255,66,255186,64,347516
4118,0.02625,74.125.200.0-255,5738,260924,64,347516
4119,0.026258,172.31.40.0-255,66,260990,64,347516
4120,0.028512,74.125.200.0-255,5738,266728,64,347516
4121,0.028522,172.31.40.0-255,66,266794,64,347516
4122,0.030788,74.125.200.0-255,5738,272532,64,347516
4123,0.030804,172.31.40.0-255,66,272598,64,347516
4124,0.033053,74.125.200.0-255,5738,278336,64,347516
4125,0.033061,172.31.40.0-255,66,278402,64,347516
4126,0.035312,74.125.200.0-255,5738,284140,64,347516
4127,0.035323,172.31.40.0-255,66,284206,64,347516
4128,0.037587,74.125.200.0-255,5738,289944,64,347516
4129,0.037605,172.31.40.0-255,66,290010,64,347516
4130,0.039856,74.125.200.0-255,5738,295748,64,347516
4131,0.039863,172.31.40.0-255,66,295814,64,347516
4132,0.042147,74.125.200.0-255,5738,301552,64,347516
4133,0.042175,172.31.40.0-255,66,301618,64,347516
4134,0.044449,74.125.200.0-255,5738,307356,64,347516
4135,0.044466,172.31.40.0-255,66,307422,64,347516
4136,0.046722,74.125.200.0-255,5738,313160,64,347516
4137,0.04673,172.31.40.0-255,66,313226,64,347516
4138,0.049033,74.125.200.0-255,5738,318964,64,347516
4139,0.049049,172.31.40.0-255,66,319030,64,347516
4140,0.051335,74.125.200.0-255,5738,324768,64,347516
4141,0.051356,172.31.40.0-255,66,324834,64,347516
4142,0.053625,74.125.200.0-255,5738,330572,64,347516
4143,0.053641,172.31.40.0-255,66,330638,64,347516
4144,0.055896,74.125.200.0-255,5738,336376,64,347516
4145,0.055905,172.31.40.0-255,66,336442,64,347516
4146,0.055998,172.31.40.0-255,171,336613,64,347516
4147,0.056025,172.31.40.0-255,1137,337750,64,347516
4148,0.056144,172.31.40.0-255,1514,339264,64,347516
4149,0.056146,172.31.40.0-255,1514,340778,64,347516
4150,0.056147,172.31.40.0-255,670,341448,64,347516
4151,0.05754,104.244.42.0-255,66,341514,64,347516
4152,0.057571,104.244.42.0-255,66,341580,64,347516
4153,0.057704,104.244.42.0-255,66,341646,64,347516
4154,0.057709,104.244.42.0-255,66,341712,64,347516
4155,0.058153,74.125.200.0-255,5738,347450,64,347516
4156,0.058161,172.31.40.0-255,66,347516,64,347516
4157,0.0,74.125.200.0-255,146,146,64,308879
4158,2.2e-05,172.31.40.0-255,66,212,64,308879
4159,2.9e-05,74.125.200.0-255,1484,1696,64,308879
4160,3.4e-05,172.31.40.0-255,66,1762,64,308879
4161,4e-05,74.125.200.0-255,2902,4664,64,308879
4162,4.3e-05,172.31.40.0-255,66,4730,64,308879
4163,5e-05,74.125.200.0-255,5738,10468,64,308879
4164,5.3e-05,172.31.40.0-255,66,10534,64,308879
4165,9.8e-05,74.125.200.0-255,3509,14043,64,308879
4166,0.000101,172.31.40.0-255,66,14109,64,308879
4167,0.000171,74.125.200.0-255,1484,15593,64,308879
4168,0.000175,172.31.40.0-255,66,15659,64,308879
4169,0.000179,74.125.200.0-255,2902,18561,64,308879
4170,0.000181,172.31.40.0-255,66,18627,64,308879
4171,0.000198,74.125.200.0-255,5738,24365,64,308879
4172,0.0002,172.31.40.0-255,66,24431,64,308879
4173,0.000211,74.125.200.0-255,1484,25915,64,308879
4174,0.000213,172.31.40.0-255,66,25981,64,308879
4175,0.00023,74.125.200.0-255,5379,31360,64,308879
4176,0.000233,172.31.40.0-255,66,31426,64,308879
4177,0.000255,74.125.200.0-255,7156,38582,64,308879
4178,0.000258,172.31.40.0-255,66,38648,64,308879
4179,0.000285,74.125.200.0-255,4320,42968,64,308879
4180,0.000287,172.31.40.0-255,66,43034,64,308879
4181,0.000306,74.125.200.0-255,2902,45936,64,308879
4182,0.000308,172.31.40.0-255,66,46002,64,308879
4183,0.000319,172.31.40.0-255,66,46068,64,308879
4184,0.000323,74.125.200.0-255,2902,48970,64,308879
4185,0.000326,172.31.40.0-255,66,49036,64,308879
4186,0.000362,172.31.40.0-255,66,49102,64,308879
4187,0.000365,74.125.200.0-255,412,49514,64,308879
4188,0.000367,172.31.40.0-255,66,49580,64,308879
4189,0.000618,74.125.200.0-255,332,49912,64,308879
4190,0.000624,172.31.40.0-255,66,49978,64,308879
4191,0.000662,74.125.200.0-255,1484,51462,64,308879
4192,0.000667,172.31.40.0-255,66,51528,64,308879
4193,0.000672,74.125.200.0-255,2902,54430,64,308879
4194,0.000674,172.31.40.0-255,66,54496,64,308879
4195,0.000691,74.125.200.0-255,4320,58816,64,308879
4196,0.000694,172.31.40.0-255,66,58882,64,308879
4197,0.000722,172.31.40.0-255,66,58948,64,308879
4198,0.000727,74.125.200.0-255,2902,61850,64,308879
4199,0.000729,172.31.40.0-255,66,61916,64,308879
4200,0.000756,74.125.200.0-255,2902,64818,64,308879
4201,0.00076,172.31.40.0-255,66,64884,64,308879
4202,0.000767,74.125.200.0-255,7156,72040,64,308879
4203,0.00078,74.125.200.0-255,1484,73524,64,308879
4204,0.000793,172.31.40.0-255,66,73590,64,308879
4205,0.000797,74.125.200.0-255,2184,75774,64,308879
4206,0.000802,172.31.40.0-255,66,75840,64,308879
4207,0.000863,74.125.200.0-255,1484,77324,64,308879
4208,0.000878,74.125.200.0-255,2902,80226,64,308879
4209,0.000883,172.31.40.0-255,66,80292,64,308879
4210,0.000902,74.125.200.0-255,5738,86030,64,308879
4211,0.000917,74.125.200.0-255,2902,88932,64,308879
4212,0.00092,172.31.40.0-255,66,88998,64,308879
4213,0.000925,172.31.40.0-255,66,89064,64,308879
4214,0.000955,74.125.200.0-255,4320,93384,64,308879
4215,0.000966,172.31.40.0-255,66,93450,64,308879
4216,0.001001,74.125.200.0-255,6438,99888,64,308879
4217,0.001015,172.31.40.0-255,66,99954,64,308879
4218,0.001085,74.125.200.0-255,1484,101438,64,308879
4219,0.0011,74.125.200.0-255,2902,104340,64,308879
4220,0.001117,74.125.200.0-255,4320,108660,64,308879
4221,0.001122,172.31.40.0-255,66,108726,64,308879
4222,0.001135,74.125.200.0-255,1484,110210,64,308879
4223,0.001138,74.125.200.0-255,1484,111694,64,308879
4224,0.001155,74.125.200.0-255,5738,117432,64,308879
4225,0.001161,74.125.200.0-255,4320,121752,64,308879
4226,0.001167,172.31.40.0-255,66,121818,64,308879
4227,0.001179,74.125.200.0-255,4320,126138,64,308879
4228,0.001203,74.125.200.0-255,5738,131876,64,308879
4229,0.001206,172.31.40.0-255,66,131942,64,308879
4230,0.001211,172.31.40.0-255,66,132008,64,308879
4231,0.001223,74.125.200.0-255,2184,134192,64,308879
4232,0.001241,172.31.40.0-255,66,134258,64,308879
4233,0.001288,74.125.200.0-255,1484,135742,64,308879
4234,0.001295,74.125.200.0-255,2902,138644,64,308879
4235,0.001307,74.125.200.0-255,2902,141546,64,308879
4236,0.001319,74.125.200.0-255,2902,144448,64,308879
4237,0.001324,172.31.40.0-255,66,144514,64,308879
4238,0.001337,74.125.200.0-255,1484,145998,64,308879
4239,0.001431,74.125.200.0-255,2184,148182,64,308879
4240,0.001441,172.31.40.0-255,66,148248,64,308879
4241,0.001565,74.125.200.0-255,1484,149732,64,308879
4242,0.00158,74.125.200.0-255,2902,152634,64,308879
4243,0.001593,172.31.40.0-255,66,152700,64,308879
4244,0.001598,74.125.200.0-255,2902,155602,64,308879
4245,0.001601,74.125.200.0-255,1484,157086,64,308879
4246,0.001606,172.31.40.0-255,66,157152,64,308879
4247,0.001615,74.125.200.0-255,2902,160054,64,308879
4248,0.001641,74.125.200.0-255,5738,165792,64,308879
4249,0.001659,74.125.200.0-255,1484,167276,64,308879
4250,0.001664,172.31.40.0-255,66,167342,64,308879
4251,0.001682,74.125.200.0-255,5738,173080,64,308879
4252,0.001694,172.31.40.0-255,66,173146,64,308879
4253,0.001711,74.125.200.0-255,1484,174630,64,308879
4254,0.00174,74.125.200.0-255,7156,181786,64,308879
4255,0.001749,74.125.200.0-255,7156,188942,64,308879
4256,0.001761,74.125.200.0-255,2902,191844,64,308879
4257,0.001768,172.31.40.0-255,66,191910,64,308879
4258,0.001799,74.125.200.0-255,5738,197648,64,308879
4259,0.001822,74.125.200.0-255,2184,199832,64,308879
4260,0.001828,172.31.40.0-255,66,199898,64,308879
4261,0.001871,74.125.200.0-255,1484,201382,64,308879
4262,0.001876,74.125.200.0-255,2902,204284,64,308879
4263,0.001885,172.31.40.0-255,66,204350,64,308879
4264,0.001902,74.125.200.0-255,5738,210088,64,308879
4265,0.001906,74.125.200.0-255,2902,212990,64,308879
4266,0.001923,172.31.40.0-255,66,213056,64,308879
4267,0.002004,74.125.200.0-255,4320,217376,64,308879
4268,0.002013,74.125.200.0-255,7156,224532,64,308879
4269,0.002023,172.31.40.0-255,66,224598,64,308879
4270,0.002037,74.125.200.0-255,1484,226082,64,308879
4271,0.002044,74.125.200.0-255,5738,231820,64,308879
4272,0.00205,74.125.200.0-255,3602,235422,64,308879
4273,0.002065,172.31.40.0-255,66,235488,64,308879
4274,0.002073,74.125.200.0-255,1484,236972,64,308879
4275,0.002086,74.125.200.0-255,2902,239874,64,308879
4276,0.002101,74.125.200.0-255,1484,241358,64,308879
4277,0.002107,172.31.40.0-255,66,241424,64,308879
4278,0.002124,74.125.200.0-255,2902,244326,64,308879
4279,0.002136,172.31.40.0-255,66,244392,64,308879
4280,0.002161,74.125.200.0-255,4320,248712,64,308879
4281,0.002179,74.125.200.0-255,7156,255868,64,308879
4282,0.002189,172.31.40.0-255,66,255934,64,308879
4283,0.0022,74.125.200.0-255,2902,258836,64,308879
4284,0.002202,74.125.200.0-255,766,259602,64,308879
4285,0.002205,74.125.200.0-255,1484,261086,64,308879
4286,0.00221,74.125.200.0-255,4320,265406,64,308879
4287,0.002221,74.125.200.0-255,1484,266890,64,308879
4288,0.002235,172.31.40.0-255,66,266956,64,308879
4289,0.002276,74.125.200.0-255,1484,268440,64,308879
4290,0.00228,74.125.200.0-255,2902,271342,64,308879
4291,0.002286,74.125.200.0-255,5738,277080,64,308879
4292,0.002323,74.125.200.0-255,1484,278564,64,308879
4293,0.00234,74.125.200.0-255,4320,282884,64,308879
4294,0.002347,74.125.200.0-255,7156,290040,64,308879
4295,0.002354,74.125.200.0-255,5738,295778,64,308879
4296,0.002368,172.31.40.0-255,66,295844,64,308879
4297,0.002374,74.125.200.0-255,5020,300864,64,308879
4298,0.002384,172.31.40.0-255,66,300930,64,308879
4299,0.004719,74.125.200.0-255,3420,304350,64,308879
4300,0.004725,172.31.40.0-255,66,304416,64,308879
4301,0.024884,172.31.40.0-255,105,304521,64,308879
4302,0.027188,74.125.200.0-255,66,304587,64,308879
4303,0.05351,172.31.40.0-255,172,304759,64,308879
4304,0.053547,172.31.40.0-255,1112,305871,64,308879
4305,0.05361,172.31.40.0-255,1514,307385,64,308879
4306,0.053612,172.31.40.0-255,1296,308681,64,308879
4307,0.055047,104.244.42.0-255,66,308747,64,308879
4308,0.055057,104.244.42.0-255,66,308813,64,308879
4309,0.055138,104.244.42.0-255,66,308879,64,308879
4310,0.0,74.125.200.0-255,150,150,64,341271
4311,2.2e-05,172.31.40.0-255,66,216,64,341271
4312,2.9e-05,74.125.200.0-255,1484,1700,64,341271
4313,3.4e-05,172.31.40.0-255,66,1766,64,341271
4314,4e-05,74.125.200.0-255,2902,4668,64,341271
4315,5.4e-05,172.31.40.0-255,66,4734,64,341271
4316,6.2e-05,74.125.200.0-255,5738,10472,64,341271
4317,6.7e-05,172.31.40.0-255,66,10538,64,341271
4318,7.2e-05,74.125.200.0-255,3492,14030,64,341271
4319,7.4e-05,172.31.40.0-255,66,14096,64,341271
4320,0.000157,74.125.200.0-255,1484,15580,64,341271
4321,0.000161,172.31.40.0-255,66,15646,64,341271
4322,0.000165,74.125.200.0-255,1484,17130,64,341271
4323,0.000167,172.31.40.0-255,66,17196,64,341271
4324,0.000192,74.125.200.0-255,1484,18680,64,341271
4325,0.000195,172.31.40.0-255,66,18746,64,341271
4326,0.000207,74.125.200.0-255,5738,24484,64,341271
4327,0.000209,172.31.40.0-255,66,24550,64,341271
4328,0.000213,74.125.200.0-255,2902,27452,64,341271
4329,0.000215,172.31.40.0-255,66,27518,64,341271
4330,0.000251,74.125.200.0-255,3961,31479,64,341271
4331,0.000254,172.31.40.0-255,66,31545,64,341271
4332,0.000258,74.125.200.0-255,2902,34447,64,341271
4333,0.00026,172.31.40.0-255,66,34513,64,341271
4334,0.000286,74.125.200.0-255,1484,35997,64,341271
4335,0.000293,172.31.40.0-255,66,36063,64,341271
4336,0.000299,74.125.200.0-255,5738,41801,64,341271
4337,0.000301,172.31.40.0-255,66,41867,64,341271
4338,0.000305,74.125.200.0-255,2902,44769,64,341271
4339,0.000307,172.31.40.0-255,66,44835,64,341271
4340,0.00033,74.125.200.0-255,3961,48796,64,341271
4341,0.000333,172.31.40.0-255,66,48862,64,341271
4342,0.000371,74.125.200.0-255,5738,54600,64,341271
4343,0.000377,74.125.200.0-255,2902,57502,64,341271
4344,0.000398,74.125.200.0-255,4320,61822,64,341271
4345,0.000417,74.125.200.0-255,3961,65783,64,341271
4346,0.000543,74.125.200.0-255,645,66428,64,341271
4347,0.000591,172.31.40.0-255,66,66494,64,341271
4348,0.000672,74.125.200.0-255,1484,67978,64,341271
4349,0.000678,74.125.200.0-255,2902,70880,64,341271
4350,0.000697,74.125.200.0-255,5738,76618,64,341271
4351,0.000703,172.31.40.0-255,66,76684,64,341271
4352,0.000711,74.125.200.0-255,1484,78168,64,341271
4353,0.000737,74.125.200.0-255,5379,83547,64,341271
4354,0.000745,74.125.200.0-255,7156,90703,64,341271
4355,0.000761,74.125.200.0-255,4320,95023,64,341271
4356,0.000773,74.125.200.0-255,2902,97925,64,341271
4357,0.000783,172.31.40.0-255,66,97991,64,341271
4358,0.000814,74.125.200.0-255,2543,100534,64,341271
4359,0.000833,172.31.40.0-255,66,100600,64,341271
4360,0.000951,74.125.200.0-255,1484,102084,64,341271
4361,0.000956,74.125.200.0-255,2902,104986,64,341271
4362,0.000962,172.31.40.0-255,66,105052,64,341271
4363,0.000992,74.125.200.0-255,2902,107954,64,341271
4364,0.001003,74.125.200.0-255,1484,109438,64,341271
4365,0.00101,172.31.40.0-255,66,109504,64,341271
4366,0.00104,74.125.200.0-255,7156,116660,64,341271
4367,0.001047,172.31.40.0-255,66,116726,64,341271
4368,0.001055,74.125.200.0-255,1484,118210,64,341271
4369,0.001057,74.125.200.0-255,1484,119694,64,341271
4370,0.001062,172.31.40.0-255,66,119760,64,341271
4371,0.001098,74.125.200.0-255,5738,125498,64,341271
4372,0.00111,74.125.200.0-255,766,126264,64,341271
4373,0.001132,172.31.40.0-255,66,126330,64,341271
4374,0.001174,74.125.200.0-255,1484,127814,64,341271
4375,0.001187,74.125.200.0-255,2902,130716,64,341271
4376,0.001201,172.31.40.0-255,66,130782,64,341271
4377,0.001211,74.125.200.0-255,5738,136520,64,341271
4378,0.001214,74.125.200.0-255,1484,138004,64,341271
4379,0.001219,172.31.40.0-255,66,138070,64,341271
4380,0.001245,74.125.200.0-255,4320,142390,64,341271
4381,0.001254,74.125.200.0-255,7156,149546,64,341271
4382,0.001264,74.125.200.0-255,1484,151030,64,341271
4383,0.001306,74.125.200.0-255,766,151796,64,341271
4384,0.001313,172.31.40.0-255,66,151862,64,341271
4385,0.001377,74.125.200.0-255,1484,153346,64,341271
4386,0.001383,74.125.200.0-255,2902,156248,64,341271
4387,0.001399,74.125.200.0-255,4320,160568,64,341271
4388,0.001409,74.125.200.0-255,1484,162052,64,341271
4389,0.001412,74.125.200.0-255,1484,163536,64,341271
4390,0.001418,172.31.40.0-255,66,163602,64,341271
4391,0.001426,74.125.200.0-255,2902,166504,64,341271
4392,0.001432,172.31.40.0-255,66,166570,64,341271
4393,0.001439,74.125.200.0-255,1484,168054,64,341271
4394,0.00145,74.125.200.0-255,7156,175210,64,341271
4395,0.001499,74.125.200.0-255,2184,177394,64,341271
4396,0.00151,172.31.40.0-255,66,177460,64,341271
4397,0.001642,74.125.200.0-255,1484,178944,64,341271
4398,0.001659,74.125.200.0-255,2902,181846,64,341271
4399,0.00167,74.125.200.0-255,1484,183330,64,341271
4400,0.001673,74.125.200.0-255,1484,184814,64,341271
4401,0.001677,172.31.40.0-255,66,184880,64,341271
4402,0.001696,74.125.200.0-255,1484,186364,64,341271
4403,0.001701,74.125.200.0-255,2902,189266,64,341271
4404,0.001714,74.125.200.0-255,2902,192168,64,341271
4405,0.001721,172.31.40.0-255,66,192234,64,341271
4406,0.001781,74.125.200.0-255,4320,196554,64,341271
4407,0.001787,172.31.40.0-255,66,196620,64,341271
4408,0.001813,74.125.200.0-255,3602,200222,64,341271
4409,0.001817,74.125.200.0-255,1484,201706,64,341271
4410,0.001837,74.125.200.0-255,2902,204608,64,341271
4411,0.001844,172.31.40.0-255,66,204674,64,341271
4412,0.001859,74.125.200.0-255,5738,210412,64,341271
4413,0.001904,74.125.200.0-255,1484,211896,64,341271
4414,0.001931,74.125.200.0-255,4320,216216,64,341271
4415,0.001939,74.125.200.0-255,7156,223372,64,341271
4416,0.001951,74.125.200.0-255,1484,224856,64,341271
4417,0.001963,172.31.40.0-255,66,224922,64,341271
4418,0.00199,172.31.40.0-255,66,224988,64,341271
4419,0.001998,74.125.200.0-255,7156,232144,64,341271
4420,0.002015,74.125.200.0-255,1484,233628,64,341271
4421,0.002031,74.125.200.0-255,5738,239366,64,341271
4422,0.00205,74.125.200.0-255,4320,243686,64,341271
4423,0.002055,74.125.200.0-255,2902,246588,64,341271
4424,0.002058,74.125.200.0-255,1484,248072,64,341271
4425,0.002071,74.125.200.0-255,2184,250256,64,341271
4426,0.002074,74.125.200.0-255,1484,251740,64,341271
4427,0.002084,172.31.40.0-255,66,251806,64,341271
4428,0.002096,74.125.200.0-255,2902,254708,64,341271
4429,0.002121,74.125.200.0-255,1484,256192,64,341271
4430,0.002133,74.125.200.0-255,1484,257676,64,341271
4431,0.00214,172.31.40.0-255,66,257742,64,341271
4432,0.002148,74.125.200.0-255,1484,259226,64,341271
4433,0.002151,74.125.200.0-255,1484,260710,64,341271
4434,0.002176,74.125.200.0-255,1484,262194,64,341271
4435,0.002183,172.31.40.0-255,66,262260,64,341271
4436,0.00221,74.125.200.0-255,4320,266580,64,341271
4437,0.002214,74.125.200.0-255,2902,269482,64,341271
4438,0.002242,172.31.40.0-255,66,269548,64,341271
4439,0.002246,74.125.200.0-255,1484,271032,64,341271
4440,0.002251,74.125.200.0-255,2184,273216,64,341271
4441,0.002253,74.125.200.0-255,1484,274700,64,341271
4442,0.002261,74.125.200.0-255,2902,277602,64,341271
4443,0.002269,172.31.40.0-255,66,277668,64,341271
4444,0.002287,74.125.200.0-255,4320,281988,64,341271
4445,0.002294,74.125.200.0-255,5738,287726,64,341271
4446,0.00231,172.31.40.0-255,66,287792,64,341271
4447,0.002322,74.125.200.0-255,5738,293530,64,341271
4448,0.002341,74.125.200.0-255,1484,295014,64,341271
4449,0.002344,74.125.200.0-255,1484,296498,64,341271
4450,0.002347,74.125.200.0-255,1484,297982,64,341271
4451,0.00235,74.125.200.0-255,2902,300884,64,341271
4452,0.002372,74.125.200.0-255,1484,302368,64,341271
4453,0.002375,172.31.40.0-255,66,302434,64,341271
4454,0.002382,74.125.200.0-255,1484,303918,64,341271
4455,0.002387,172.31.40.0-255,66,303984,64,341271
4456,0.00241,74.125.200.0-255,3602,307586,64,341271
4457,0.002417,74.125.200.0-255,5738,313324,64,341271
4458,0.00244,74.125.200.0-255,5738,319062,64,341271
4459,0.002443,172.31.40.0-255,66,319128,64,341271
4460,0.002448,172.31.40.0-255,66,319194,64,341271
4461,0.002486,74.125.200.0-255,7156,326350,64,341271
4462,0.002492,74.125.200.0-255,5738,332088,64,341271
4463,0.002497,74.125.200.0-255,4320,336408,64,341271
4464,0.002527,74.125.200.0-255,97,336505,64,341271
4465,0.002529,172.31.40.0-255,66,336571,64,341271
4466,0.002535,172.31.40.0-255,66,336637,64,341271
4467,0.002577,74.125.200.0-255,105,336742,64,341271
4468,0.00499,172.31.40.0-255,66,336808,64,341271
4469,0.00503,172.31.40.0-255,105,336913,64,341271
4470,0.00706,74.125.200.0-255,66,336979,64,341271
4471,0.032805,172.31.40.0-255,172,337151,64,341271
4472,0.032841,172.31.40.0-255,1112,338263,64,341271
4473,0.032904,172.31.40.0-255,1514,339777,64,341271
4474,0.032905,172.31.40.0-255,1296,341073,64,341271
4475,0.034368,104.244.42.0-255,66,341139,64,341271
4476,0.034419,104.244.42.0-255,66,341205,64,341271
4477,0.034469,104.244.42.0-255,66,341271,64,341271
4478,0.0,74.125.130.0-255,288,288,64,329894
4479,2.4e-05,172.31.40.0-255,66,354,64,329894
4480,3e-05,74.125.130.0-255,1484,1838,64,329894
4481,3.5e-05,172.31.40.0-255,66,1904,64,329894
4482,4.8e-05,74.125.130.0-255,2902,4806,64,329894
4483,5.2e-05,172.31.40.0-255,66,4872,64,329894
4484,5.9e-05,74.125.130.0-255,5738,10610,64,329894
4485,6.2e-05,172.31.40.0-255,66,10676,64,329894
4486,6.7e-05,74.125.130.0-255,3254,13930,64,329894
4487,7e-05,172.31.40.0-255,66,13996,64,329894
4488,0.000189,74.125.130.0-255,1484,15480,64,329894
4489,0.000193,172.31.40.0-255,66,15546,64,329894
4490,0.000199,74.125.130.0-255,2902,18448,64,329894
4491,0.000201,172.31.40.0-255,66,18514,64,329894
4492,0.000213,74.125.130.0-255,5738,24252,64,329894
4493,0.000215,172.31.40.0-255,66,24318,64,329894
4494,0.000223,74.125.130.0-255,5738,30056,64,329894
4495,0.000226,172.31.40.0-255,66,30122,64,329894
4496,0.000269,74.125.130.0-255,6797,36919,64,329894
4497,0.000272,172.31.40.0-255,66,36985,64,329894
4498,0.00029,74.125.130.0-255,5738,42723,64,329894
4499,0.000296,172.31.40.0-255,66,42789,64,329894
4500,0.000315,74.125.130.0-255,1484,44273,64,329894
4501,0.000317,172.31.40.0-255,66,44339,64,329894
4502,0.000323,74.125.130.0-255,3961,48300,64,329894
4503,0.000325,172.31.40.0-255,66,48366,64,329894
4504,0.000373,74.125.130.0-255,1484,49850,64,329894
4505,0.000376,172.31.40.0-255,66,49916,64,329894
4506,0.000403,74.125.130.0-255,2902,52818,64,329894
4507,0.000406,172.31.40.0-255,66,52884,64,329894
4508,0.000412,74.125.130.0-255,5738,58622,64,329894
4509,0.000414,172.31.40.0-255,66,58688,64,329894
4510,0.000418,74.125.130.0-255,2902,61590,64,329894
4511,0.000421,172.31.40.0-255,66,61656,64,329894
4512,0.000443,74.125.130.0-255,1484,63140,64,329894
4513,0.000482,74.125.130.0-255,3123,66263,64,329894
4514,0.000561,172.31.40.0-255,66,66329,64,329894
4515,0.000649,74.125.130.0-255,1484,67813,64,329894
4516,0.000653,74.125.130.0-255,1484,69297,64,329894
4517,0.000658,172.31.40.0-255,66,69363,64,329894
4518,0.00067,74.125.130.0-255,1484,70847,64,329894
4519,0.000675,74.125.130.0-255,2902,73749,64,329894
4520,0.000698,74.125.130.0-255,4320,78069,64,329894
4521,0.000705,172.31.40.0-255,66,78135,64,329894
4522,0.000748,172.31.40.0-255,66,78201,64,329894
4523,0.000776,74.125.130.0-255,2543,80744,64,329894
4524,0.000797,172.31.40.0-255,66,80810,64,329894
4525,0.000912,74.125.130.0-255,1484,82294,64,329894
4526,0.000933,74.125.130.0-255,2902,85196,64,329894
4527,0.000937,172.31.40.0-255,66,85262,64,329894
4528,0.000971,74.125.130.0-255,5738,91000,64,329894
4529,0.000974,74.125.130.0-255,1484,92484,64,329894
4530,0.001002,172.31.40.0-255,66,92550,64,329894
4531,0.001036,74.125.130.0-255,7156,99706,64,329894
4532,0.001043,172.31.40.0-255,66,99772,64,329894
4533,0.001053,74.125.130.0-255,3602,103374,64,329894
4534,0.001062,172.31.40.0-255,66,103440,64,329894
4535,0.001123,74.125.130.0-255,1484,104924,64,329894
4536,0.001142,74.125.130.0-255,2902,107826,64,329894
4537,0.001155,74.125.130.0-255,2902,110728,64,329894
4538,0.001167,74.125.130.0-255,2902,113630,64,329894
4539,0.001176,172.31.40.0-255,66,113696,64,329894
4540,0.001199,74.125.130.0-255,5738,119434,64,329894
4541,0.001203,74.125.130.0-255,1484,120918,64,329894
4542,0.001212,172.31.40.0-255,66,120984,64,329894
4543,0.001225,74.125.130.0-255,5738,126722,64,329894
4544,0.001272,74.125.130.0-255,4320,131042,64,329894
4545,0.001289,74.125.130.0-255,6438,137480,64,329894
4546,0.001307,172.31.40.0-255,66,137546,64,329894
4547,0.001335,74.125.130.0-255,1484,139030,64,329894
4548,0.001349,74.125.130.0-255,2902,141932,64,329894
4549,0.00136,172.31.40.0-255,66,141998,64,329894
4550,0.00137,74.125.130.0-255,1484,143482,64,329894
4551,0.001391,74.125.130.0-255,4320,147802,64,329894
4552,0.001396,74.125.130.0-255,4320,152122,64,329894
4553,0.001402,74.125.130.0-255,5738,157860,64,329894
4554,0.001429,74.125.130.0-255,5738,163598,64,329894
4555,0.001432,172.31.40.0-255,66,163664,64,329894
4556,0.001437,172.31.40.0-255,66,163730,64,329894
4557,0.001465,74.125.130.0-255,5738,169468,64,329894
4558,0.00147,74.125.130.0-255,2184,171652,64,329894
4559,0.001478,172.31.40.0-255,66,171718,64,329894
4560,0.001545,74.125.130.0-255,1484,173202,64,329894
4561,0.001565,74.125.130.0-255,2902,176104,64,329894
4562,0.001574,74.125.130.0-255,5738,181842,64,329894
4563,0.001586,74.125.130.0-255,2902,184744,64,329894
4564,0.001589,74.125.130.0-255,1484,186228,64,329894
4565,0.001598,172.31.40.0-255,66,186294,64,329894
4566,0.001608,74.125.130.0-255,2902,189196,64,329894
4567,0.001612,172.31.40.0-255,66,189262,64,329894
4568,0.001634,74.125.130.0-255,2902,192164,64,329894
4569,0.00166,74.125.130.0-255,2902,195066,64,329894
4570,0.001663,172.31.40.0-255,66,195132,64,329894
4571,0.001668,172.31.40.0-255,66,195198,64,329894
4572,0.001695,74.125.130.0-255,2184,197382,64,329894
4573,0.001709,172.31.40.0-255,66,197448,64,329894
4574,0.001787,74.125.130.0-255,1484,198932,64,329894
4575,0.001801,74.125.130.0-255,2902,201834,64,329894
4576,0.001817,172.31.40.0-255,66,201900,64,329894
4577,0.00183,74.125.130.0-255,5738,207638,64,329894
4578,0.001865,74.125.130.0-255,5738,213376,64,329894
4579,0.001871,74.125.130.0-255,7156,220532,64,329894
4580,0.001875,172.31.40.0-255,66,220598,64,329894
4581,0.00188,172.31.40.0-255,66,220664,64,329894
4582,0.001942,74.125.130.0-255,5738,226402,64,329894
4583,0.001957,172.31.40.0-255,66,226468,64,329894
4584,0.001975,74.125.130.0-255,5738,232206,64,329894
4585,0.001979,74.125.130.0-255,4320,236526,64,329894
4586,0.001995,74.125.130.0-255,5738,242264,64,329894
4587,0.00202,74.125.130.0-255,766,243030,64,329894
4588,0.002035,172.31.40.0-255,66,243096,64,329894
4589,0.002078,172.31.40.0-255,66,243162,64,329894
4590,0.002088,74.125.130.0-255,1484,244646,64,329894
4591,0.002131,74.125.130.0-255,4320,248966,64,329894
4592,0.002134,74.125.130.0-255,766,249732,64,329894
4593,0.002145,172.31.40.0-255,66,249798,64,329894
4594,0.002308,74.125.130.0-255,1484,251282,64,329894
4595,0.00446,74.125.130.0-255,4320,255602,64,329894
4596,0.004466,172.31.40.0-255,66,255668,64,329894
4597,0.006755,74.125.130.0-255,5738,261406,64,329894
4598,0.006763,172.31.40.0-255,66,261472,64,329894
4599,0.009052,74.125.130.0-255,5738,267210,64,329894
4600,0.00906,172.31.40.0-255,66,267276,64,329894
4601,0.011356,74.125.130.0-255,5738,273014,64,329894
4602,0.011363,172.31.40.0-255,66,273080,64,329894
4603,0.013666,74.125.130.0-255,5738,278818,64,329894
4604,0.013674,172.31.40.0-255,66,278884,64,329894
4605,0.015972,74.125.130.0-255,5738,284622,64,329894
4606,0.015981,172.31.40.0-255,66,284688,64,329894
4607,0.01828,74.125.130.0-255,5738,290426,64,329894
4608,0.018292,172.31.40.0-255,66,290492,64,329894
4609,0.020587,74.125.130.0-255,5738,296230,64,329894
4610,0.020596,172.31.40.0-255,66,296296,64,329894
4611,0.02218,172.31.40.0-255,101,296397,64,329894
4612,0.022874,74.125.130.0-255,5738,302135,64,329894
4613,0.022881,172.31.40.0-255,66,302201,64,329894
4614,0.024433,74.125.130.0-255,66,302267,64,329894
4615,0.025168,74.125.130.0-255,5738,308005,64,329894
4616,0.025176,172.31.40.0-255,66,308071,64,329894
4617,0.027463,74.125.130.0-255,2902,310973,64,329894
4618,0.027468,172.31.40.0-255,66,311039,64,329894
4619,0.027496,74.125.130.0-255,2902,313941,64,329894
4620,0.027499,172.31.40.0-255,66,314007,64,329894
4621,0.029753,74.125.130.0-255,1484,315491,64,329894
4622,0.029775,74.125.130.0-255,4320,319811,64,329894
4623,0.029781,172.31.40.0-255,66,319877,64,329894
4624,0.032066,74.125.130.0-255,5494,325371,64,329894
4625,0.032073,172.31.40.0-255,66,325437,64,329894
4626,0.032246,172.31.40.0-255,105,325542,64,329894
4627,0.036583,172.31.40.0-255,166,325708,64,329894
4628,0.036615,172.31.40.0-255,1135,326843,64,329894
4629,0.036676,172.31.40.0-255,1514,328357,64,329894
4630,0.036678,172.31.40.0-255,1273,329630,64,329894
4631,0.038166,104.244.42.0-255,66,329696,64,329894
4632,0.038204,104.244.42.0-255,66,329762,64,329894
4633,0.038267,104.244.42.0-255,66,329828,64,329894
4634,0.038789,74.125.130.0-255,66,329894,64,329894
4635,0.0,172.217.194.0-255,150,150,64,274187
4636,2e-05,172.31.40.0-255,66,216,64,274187
4637,2.7e-05,172.217.194.0-255,1484,1700,64,274187
4638,3.2e-05,172.31.40.0-255,66,1766,64,274187
4639,3.9e-05,172.217.194.0-255,2902,4668,64,274187
4640,4.3e-05,172.31.40.0-255,66,4734,64,274187
4641,4.9e-05,172.217.194.0-255,5738,10472,64,274187
4642,5.2e-05,172.31.40.0-255,66,10538,64,274187
4643,9.5e-05,172.31.40.0-255,66,10604,64,274187
4644,0.000102,172.217.194.0-255,6797,17401,64,274187
4645,0.000104,172.31.40.0-255,66,17467,64,274187
4646,0.000212,172.217.194.0-255,1484,18951,64,274187
4647,0.000216,172.31.40.0-255,66,19017,64,274187
4648,0.00022,172.217.194.0-255,1484,20501,64,274187
4649,0.000222,172.31.40.0-255,66,20567,64,274187
4650,0.000242,172.217.194.0-255,1484,22051,64,274187
4651,0.000244,172.31.40.0-255,66,22117,64,274187
4652,0.000251,172.217.194.0-255,4320,26437,64,274187
4653,0.000253,172.31.40.0-255,66,26503,64,274187
4654,0.0003,172.31.40.0-255,66,26569,64,274187
4655,0.000306,172.217.194.0-255,4320,30889,64,274187
4656,0.000308,172.31.40.0-255,66,30955,64,274187
4657,0.000323,172.217.194.0-255,2902,33857,64,274187
4658,0.000326,172.31.40.0-255,66,33923,64,274187
4659,0.000373,172.217.194.0-255,7156,41079,64,274187
4660,0.000377,172.31.40.0-255,66,41145,64,274187
4661,0.000397,172.217.194.0-255,1414,42559,64,274187
4662,0.000399,172.31.40.0-255,66,42625,64,274187
4663,0.000402,172.217.194.0-255,99,42724,64,274187
4664,0.000404,172.31.40.0-255,66,42790,64,274187
4665,0.000407,172.217.194.0-255,363,43153,64,274187
4666,0.000867,172.217.194.0-255,1484,44637,64,274187
4667,0.000872,172.31.40.0-255,66,44703,64,274187
4668,0.000877,172.217.194.0-255,2902,47605,64,274187
4669,0.000896,172.217.194.0-255,5738,53343,64,274187
4670,0.000898,172.217.194.0-255,1484,54827,64,274187
4671,0.0009,172.31.40.0-255,66,54893,64,274187
4672,0.000905,172.31.40.0-255,66,54959,64,274187
4673,0.000927,172.217.194.0-255,7156,62115,64,274187
4674,0.000943,172.217.194.0-255,4320,66435,64,274187
4675,0.000947,172.31.40.0-255,66,66501,64,274187
4676,0.000959,172.217.194.0-255,5738,72239,64,274187
4677,0.000965,172.217.194.0-255,5020,77259,64,274187
4678,0.000985,172.31.40.0-255,66,77325,64,274187
4679,0.001038,172.217.194.0-255,1484,78809,64,274187
4680,0.001043,172.217.194.0-255,2902,81711,64,274187
4681,0.001045,172.31.40.0-255,66,81777,64,274187
4682,0.001065,172.217.194.0-255,5738,87515,64,274187
4683,0.001069,172.31.40.0-255,66,87581,64,274187
4684,0.001093,172.217.194.0-255,7156,94737,64,274187
4685,0.001107,172.217.194.0-255,5738,100475,64,274187
4686,0.001123,172.31.40.0-255,66,100541,64,274187
4687,0.001137,172.217.194.0-255,2184,102725,64,274187
4688,0.001156,172.31.40.0-255,66,102791,64,274187
4689,0.001162,172.217.194.0-255,5738,108529,64,274187
4690,0.001166,172.31.40.0-255,66,108595,64,274187
4691,0.00118,172.217.194.0-255,7156,115751,64,274187
4692,0.001183,172.217.194.0-255,1484,117235,64,274187
4693,0.001195,172.31.40.0-255,66,117301,64,274187
4694,0.001216,172.217.194.0-255,5738,123039,64,274187
4695,0.00122,172.31.40.0-255,66,123105,64,274187
4696,0.001239,172.217.194.0-255,766,123871,64,274187
4697,0.001271,172.217.194.0-255,1484,125355,64,274187
4698,0.001277,172.31.40.0-255,66,125421,64,274187
4699,0.001297,172.217.194.0-255,4320,129741,64,274187
4700,0.001309,172.31.40.0-255,66,129807,64,274187
4701,0.001326,172.217.194.0-255,4320,134127,64,274187
4702,0.00133,172.31.40.0-255,66,134193,64,274187
4703,0.00134,172.217.194.0-255,5738,139931,64,274187
4704,0.001364,172.31.40.0-255,66,139997,64,274187
4705,0.001369,172.217.194.0-255,4320,144317,64,274187
4706,0.001374,172.31.40.0-255,66,144383,64,274187
4707,0.001381,172.217.194.0-255,2902,147285,64,274187
4708,0.001399,172.217.194.0-255,2184,149469,64,274187
4709,0.001409,172.31.40.0-255,66,149535,64,274187
4710,0.001414,172.31.40.0-255,66,149601,64,274187
4711,0.00143,172.217.194.0-255,1484,151085,64,274187
4712,0.001436,172.217.194.0-255,4320,155405,64,274187
4713,0.001468,172.31.40.0-255,66,155471,64,274187
4714,0.0015,172.31.40.0-255,66,155537,64,274187
4715,0.001534,172.217.194.0-255,5020,160557,64,274187
4716,0.001547,172.31.40.0-255,66,160623,64,274187
4717,0.001556,172.217.194.0-255,4320,164943,64,274187
4718,0.001561,172.31.40.0-255,66,165009,64,274187
4719,0.001571,172.217.194.0-255,1484,166493,64,274187
4720,0.001573,172.217.194.0-255,1484,167977,64,274187
4721,0.001601,172.31.40.0-255,66,168043,64,274187
4722,0.001617,172.217.194.0-255,7156,175199,64,274187
4723,0.001623,172.31.40.0-255,66,175265,64,274187
4724,0.001647,172.217.194.0-255,766,176031,64,274187
4725,0.001667,172.31.40.0-255,66,176097,64,274187
4726,0.001687,172.217.194.0-255,5738,181835,64,274187
4727,0.001693,172.217.194.0-255,4320,186155,64,274187
4728,0.001698,172.31.40.0-255,66,186221,64,274187
4729,0.001709,172.217.194.0-255,2902,189123,64,274187
4730,0.001717,172.217.194.0-255,5738,194861,64,274187
4731,0.001743,172.31.40.0-255,66,194927,64,274187
4732,0.001753,172.31.40.0-255,66,194993,64,274187
4733,0.001781,172.217.194.0-255,1484,196477,64,274187
4734,0.001801,172.217.194.0-255,5020,201497,64,274187
4735,0.001815,172.31.40.0-255,66,201563,64,274187
4736,0.001909,172.217.194.0-255,1484,203047,64,274187
4737,0.001916,172.217.194.0-255,2902,205949,64,274187
4738,0.001922,172.217.194.0-255,5738,211687,64,274187
4739,0.001934,172.217.194.0-255,1484,213171,64,274187
4740,0.001942,172.31.40.0-255,66,213237,64,274187
4741,0.00201,172.31.40.0-255,66,213303,64,274187
4742,0.002026,172.217.194.0-255,766,214069,64,274187
4743,0.002044,172.31.40.0-255,66,214135,64,274187
4744,0.002383,172.217.194.0-255,1484,215619,64,274187
4745,0.002388,172.217.194.0-255,1484,217103,64,274187
4746,0.002391,172.31.40.0-255,66,217169,64,274187
4747,0.002412,172.217.194.0-255,1484,218653,64,274187
4748,0.002418,172.217.194.0-255,5738,224391,64,274187
4749,0.002421,172.217.194.0-255,1484,225875,64,274187
4750,0.002445,172.31.40.0-255,66,225941,64,274187
4751,0.002469,172.31.40.0-255,66,226007,64,274187
4752,0.002477,172.217.194.0-255,1484,227491,64,274187
4753,0.002479,172.217.194.0-255,766,228257,64,274187
4754,0.0025,172.31.40.0-255,66,228323,64,274187
4755,0.00506,172.217.194.0-255,2902,231225,64,274187
4756,0.005069,172.31.40.0-255,66,231291,64,274187
4757,0.005149,172.217.194.0-255,2902,234193,64,274187
4758,0.007638,172.217.194.0-255,2902,237095,64,274187
4759,0.014008,172.31.40.0-255,66,237161,64,274187
4760,0.015975,172.217.194.0-255,1484,238645,64,274187
4761,0.016643,172.217.194.0-255,4320,242965,64,274187
4762,0.016649,172.31.40.0-255,66,243031,64,274187
4763,0.019276,172.217.194.0-255,5738,248769,64,274187
4764,0.019285,172.31.40.0-255,66,248835,64,274187
4765,0.021908,172.217.194.0-255,5738,254573,64,274187
4766,0.021918,172.31.40.0-255,66,254639,64,274187
4767,0.024565,172.217.194.0-255,5738,260377,64,274187
4768,0.024585,172.31.40.0-255,66,260443,64,274187
4769,0.027166,172.217.194.0-255,5738,266181,64,274187
4770,0.027176,172.31.40.0-255,66,266247,64,274187
4771,0.029795,172.217.194.0-255,3407,269654,64,274187
4772,0.029803,172.31.40.0-255,66,269720,64,274187
4773,0.029989,172.31.40.0-255,105,269825,64,274187
4774,0.032526,172.217.194.0-255,66,269891,64,274187
4775,0.044882,172.31.40.0-255,176,270067,64,274187
4776,0.044911,172.31.40.0-255,1112,271179,64,274187
4777,0.044961,172.31.40.0-255,1514,272693,64,274187
4778,0.044963,172.31.40.0-255,1296,273989,64,274187
4779,0.046471,104.244.42.0-255,66,274055,64,274187
4780,0.046483,104.244.42.0-255,66,274121,64,274187
4781,0.046552,104.244.42.0-255,66,274187,64,274187
4782,0.0,172.217.194.0-255,153,153,64,288521
4783,2.5e-05,172.31.40.0-255,66,219,64,288521
4784,3.3e-05,172.217.194.0-255,1484,1703,64,288521
4785,3.8e-05,172.31.40.0-255,66,1769,64,288521
4786,5.3e-05,172.217.194.0-255,2902,4671,64,288521
4787,5.7e-05,172.31.40.0-255,66,4737,64,288521
4788,6.6e-05,172.217.194.0-255,7156,11893,64,288521
4789,7e-05,172.31.40.0-255,66,11959,64,288521
4790,7.2e-05,172.217.194.0-255,1484,13443,64,288521
4791,7.5e-05,172.31.40.0-255,66,13509,64,288521
4792,7.8e-05,172.217.194.0-255,484,13993,64,288521
4793,8.1e-05,172.31.40.0-255,66,14059,64,288521
4794,8.4e-05,172.217.194.0-255,1484,15543,64,288521
4795,8.7e-05,172.31.40.0-255,66,15609,64,288521
4796,9.3e-05,172.217.194.0-255,4320,19929,64,288521
4797,9.5e-05,172.31.40.0-255,66,19995,64,288521
4798,0.000132,172.31.40.0-255,66,20061,64,288521
4799,0.000168,172.217.194.0-255,1484,21545,64,288521
4800,0.00017,172.31.40.0-255,66,21611,64,288521
4801,0.000201,172.31.40.0-255,66,21677,64,288521
4802,0.000234,172.31.40.0-255,66,21743,64,288521
4803,0.000268,172.31.40.0-255,66,21809,64,288521
4804,0.000276,172.217.194.0-255,6797,28606,64,288521
4805,0.000278,172.31.40.0-255,66,28672,64,288521
4806,0.000325,172.217.194.0-255,379,29051,64,288521
4807,0.000327,172.31.40.0-255,66,29117,64,288521
4808,0.00035,172.217.194.0-255,98,29215,64,288521
4809,0.000352,172.31.40.0-255,66,29281,64,288521
4810,0.000403,172.217.194.0-255,1484,30765,64,288521
4811,0.000429,172.217.194.0-255,2902,33667,64,288521
4812,0.000431,172.31.40.0-255,66,33733,64,288521
4813,0.000435,172.217.194.0-255,1484,35217,64,288521
4814,0.000441,172.217.194.0-255,4320,39537,64,288521
4815,0.000443,172.31.40.0-255,66,39603,64,288521
4816,0.000476,172.217.194.0-255,4320,43923,64,288521
4817,0.000479,172.31.40.0-255,66,43989,64,288521
4818,0.000484,172.217.194.0-255,2543,46532,64,288521
4819,0.000486,172.31.40.0-255,66,46598,64,288521
4820,0.00049,172.217.194.0-255,2902,49500,64,288521
4821,0.000497,172.31.40.0-255,66,49566,64,288521
4822,0.000504,172.217.194.0-255,5738,55304,64,288521
4823,0.000507,172.31.40.0-255,66,55370,64,288521
4824,0.000536,172.217.194.0-255,1484,56854,64,288521
4825,0.000543,172.217.194.0-255,5738,62592,64,288521
4826,0.000546,172.31.40.0-255,66,62658,64,288521
4827,0.00055,172.217.194.0-255,1125,63783,64,288521
4828,0.000645,172.217.194.0-255,1484,65267,64,288521
4829,0.000649,172.31.40.0-255,66,65333,64,288521
4830,0.000654,172.217.194.0-255,2902,68235,64,288521
4831,0.000657,172.31.40.0-255,66,68301,64,288521
4832,0.00066,172.217.194.0-255,1484,69785,64,288521
4833,0.000689,172.217.194.0-255,4320,74105,64,288521
4834,0.000691,172.31.40.0-255,66,74171,64,288521
4835,0.000697,172.217.194.0-255,5738,79909,64,288521
4836,0.0007,172.31.40.0-255,66,79975,64,288521
4837,0.000724,172.217.194.0-255,7156,87131,64,288521
4838,0.000731,172.31.40.0-255,66,87197,64,288521
4839,0.000742,172.31.40.0-255,66,87263,64,288521
4840,0.000791,172.31.40.0-255,66,87329,64,288521
4841,0.000821,172.217.194.0-255,1901,89230,64,288521
4842,0.000823,172.31.40.0-255,66,89296,64,288521
4843,0.000841,172.31.40.0-255,66,89362,64,288521
4844,0.000848,172.217.194.0-255,5020,94382,64,288521
4845,0.00085,172.31.40.0-255,66,94448,64,288521
4846,0.000886,172.217.194.0-255,1484,95932,64,288521
4847,0.000891,172.217.194.0-255,2902,98834,64,288521
4848,0.000893,172.31.40.0-255,66,98900,64,288521
4849,0.000927,172.217.194.0-255,1484,100384,64,288521
4850,0.000953,172.217.194.0-255,4320,104704,64,288521
4851,0.000956,172.31.40.0-255,66,104770,64,288521
4852,0.00096,172.217.194.0-255,2902,107672,64,288521
4853,0.000962,172.31.40.0-255,66,107738,64,288521
4854,0.000968,172.217.194.0-255,4320,112058,64,288521
4855,0.00097,172.31.40.0-255,66,112124,64,288521
4856,0.000986,172.31.40.0-255,66,112190,64,288521
4857,0.000991,172.217.194.0-255,4320,116510,64,288521
4858,0.000994,172.31.40.0-255,66,116576,64,288521
4859,0.001041,172.217.194.0-255,3602,120178,64,288521
4860,0.001044,172.31.40.0-255,66,120244,64,288521
4861,0.001162,172.217.194.0-255,1484,121728,64,288521
4862,0.001181,172.217.194.0-255,2902,124630,64,288521
4863,0.001185,172.31.40.0-255,66,124696,64,288521
4864,0.001191,172.217.194.0-255,2902,127598,64,288521
4865,0.001193,172.31.40.0-255,66,127664,64,288521
4866,0.001216,172.217.194.0-255,2902,130566,64,288521
4867,0.001223,172.31.40.0-255,66,130632,64,288521
4868,0.001245,172.217.194.0-255,6797,137429,64,288521
4869,0.001248,172.31.40.0-255,66,137495,64,288521
4870,0.001285,172.217.194.0-255,7156,144651,64,288521
4871,0.001288,172.31.40.0-255,66,144717,64,288521
4872,0.001296,172.217.194.0-255,7156,151873,64,288521
4873,0.001298,172.31.40.0-255,66,151939,64,288521
4874,0.001337,172.31.40.0-255,66,152005,64,288521
4875,0.001376,172.217.194.0-255,5738,157743,64,288521
4876,0.001379,172.31.40.0-255,66,157809,64,288521
4877,0.001417,172.217.194.0-255,5020,162829,64,288521
4878,0.00142,172.31.40.0-255,66,162895,64,288521
4879,0.001638,172.217.194.0-255,1484,164379,64,288521
4880,0.001644,172.217.194.0-255,2902,167281,64,288521
4881,0.001648,172.31.40.0-255,66,167347,64,288521
4882,0.001653,172.217.194.0-255,2902,170249,64,288521
4883,0.001656,172.31.40.0-255,66,170315,64,288521
4884,0.001677,172.217.194.0-255,2902,173217,64,288521
4885,0.00168,172.31.40.0-255,66,173283,64,288521
4886,0.001697,172.31.40.0-255,66,173349,64,288521
4887,0.001717,172.217.194.0-255,1484,174833,64,288521
4888,0.001733,172.31.40.0-255,66,174899,64,288521
4889,0.001747,172.217.194.0-255,2184,177083,64,288521
4890,0.001753,172.31.40.0-255,66,177149,64,288521
4891,0.002034,172.217.194.0-255,1484,178633,64,288521
4892,0.00204,172.217.194.0-255,2902,181535,64,288521
4893,0.002051,172.31.40.0-255,66,181601,64,288521
4894,0.002059,172.217.194.0-255,5738,187339,64,288521
4895,0.002061,172.31.40.0-255,66,187405,64,288521
4896,0.002096,172.31.40.0-255,66,187471,64,288521
4897,0.002111,172.217.194.0-255,4320,191791,64,288521
4898,0.002114,172.31.40.0-255,66,191857,64,288521
4899,0.002132,172.31.40.0-255,66,191923,64,288521
4900,0.004226,172.217.194.0-255,5738,197661,64,288521
4901,0.004237,172.31.40.0-255,66,197727,64,288521
4902,0.006308,172.217.194.0-255,5738,203465,64,288521
4903,0.006329,172.31.40.0-255,66,203531,64,288521
4904,0.008413,172.217.194.0-255,5738,209269,64,288521
4905,0.008427,172.31.40.0-255,66,209335,64,288521
4906,0.010528,172.217.194.0-255,5738,215073,64,288521
4907,0.010539,172.31.40.0-255,66,215139,64,288521
4908,0.012629,172.217.194.0-255,5738,220877,64,288521
4909,0.012633,172.31.40.0-255,66,220943,64,288521
4910,0.014711,172.217.194.0-255,5738,226681,64,288521
4911,0.014721,172.31.40.0-255,66,226747,64,288521
4912,0.016813,172.217.194.0-255,5738,232485,64,288521
4913,0.016829,172.31.40.0-255,66,232551,64,288521
4914,0.018932,172.217.194.0-255,5738,238289,64,288521
4915,0.018948,172.31.40.0-255,66,238355,64,288521
4916,0.021049,172.217.194.0-255,5738,244093,64,288521
4917,0.021067,172.31.40.0-255,66,244159,64,288521
4918,0.023163,172.217.194.0-255,5738,249897,64,288521
4919,0.023178,172.31.40.0-255,66,249963,64,288521
4920,0.02526,172.217.194.0-255,5738,255701,64,288521
4921,0.025274,172.31.40.0-255,66,255767,64,288521
4922,0.027354,172.217.194.0-255,5738,261505,64,288521
4923,0.027369,172.31.40.0-255,66,261571,64,288521
4924,0.029466,172.217.194.0-255,5738,267309,64,288521
4925,0.029478,172.31.40.0-255,66,267375,64,288521
4926,0.031557,172.217.194.0-255,5738,273113,64,288521
4927,0.031568,172.31.40.0-255,66,273179,64,288521
4928,0.033636,172.217.194.0-255,5738,278917,64,288521
4929,0.033646,172.31.40.0-255,66,278983,64,288521
4930,0.035735,172.217.194.0-255,4034,283017,64,288521
4931,0.035752,172.31.40.0-255,66,283083,64,288521
4932,0.035939,172.31.40.0-255,105,283188,64,288521
4933,0.037998,172.217.194.0-255,66,283254,64,288521
4934,0.05774,172.31.40.0-255,167,283421,64,288521
4935,0.057833,172.31.40.0-255,1111,284532,64,288521
4936,0.057908,172.31.40.0-255,1514,286046,64,288521
4937,0.05791,172.31.40.0-255,1514,287560,64,288521
4938,0.057911,172.31.40.0-255,697,288257,64,288521
4939,0.05931,104.244.42.0-255,66,288323,64,288521
4940,0.059413,104.244.42.0-255,66,288389,64,288521
4941,0.05951,104.244.42.0-255,66,288455,64,288521
4942,0.059515,104.244.42.0-255,66,288521,64,288521
4943,0.0,172.217.194.0-255,143,143,64,252157
4944,2e-05,172.31.40.0-255,66,209,64,252157
4945,2.7e-05,172.217.194.0-255,1484,1693,64,252157
4946,3.3e-05,172.31.40.0-255,66,1759,64,252157
4947,4.6e-05,172.217.194.0-255,2902,4661,64,252157
4948,5e-05,172.31.40.0-255,66,4727,64,252157
4949,5.7e-05,172.217.194.0-255,7156,11883,64,252157
4950,6.1e-05,172.31.40.0-255,66,11949,64,252157
4951,9.6e-05,172.217.194.0-255,1982,13931,64,252157
4952,9.8e-05,172.31.40.0-255,66,13997,64,252157
4953,0.000103,172.217.194.0-255,2902,16899,64,252157
4954,0.000106,172.31.40.0-255,66,16965,64,252157
4955,0.000137,172.217.194.0-255,7156,24121,64,252157
4956,0.00014,172.31.40.0-255,66,24187,64,252157
4957,0.000164,172.217.194.0-255,2902,27089,64,252157
4958,0.000167,172.31.40.0-255,66,27155,64,252157
4959,0.000197,172.31.40.0-255,66,27221,64,252157
4960,0.00022,172.31.40.0-255,66,27287,64,252157
4961,0.000567,172.217.194.0-255,1484,28771,64,252157
4962,0.000573,172.31.40.0-255,66,28837,64,252157
4963,0.000604,172.217.194.0-255,2902,31739,64,252157
4964,0.000607,172.31.40.0-255,66,31805,64,252157
4965,0.000614,172.217.194.0-255,5738,37543,64,252157
4966,0.000617,172.31.40.0-255,66,37609,64,252157
4967,0.000642,172.217.194.0-255,1484,39093,64,252157
4968,0.000644,172.31.40.0-255,66,39159,64,252157
4969,0.00067,172.217.194.0-255,5959,45118,64,252157
4970,0.000673,172.31.40.0-255,66,45184,64,252157
4971,0.000722,172.217.194.0-255,1484,46668,64,252157
4972,0.000725,172.31.40.0-255,66,46734,64,252157
4973,0.000759,172.217.194.0-255,2902,49636,64,252157
4974,0.000763,172.31.40.0-255,66,49702,64,252157
4975,0.000766,172.217.194.0-255,1484,51186,64,252157
4976,0.000787,172.217.194.0-255,2902,54088,64,252157
4977,0.00079,172.31.40.0-255,66,54154,64,252157
4978,0.000796,172.217.194.0-255,5738,59892,64,252157
4979,0.000799,172.31.40.0-255,66,59958,64,252157
4980,0.000823,172.217.194.0-255,3961,63919,64,252157
4981,0.000826,172.31.40.0-255,66,63985,64,252157
4982,0.0009,172.217.194.0-255,6797,70782,64,252157
4983,0.000909,172.31.40.0-255,66,70848,64,252157
4984,0.001176,172.217.194.0-255,1484,72332,64,252157
4985,0.001182,172.217.194.0-255,2902,75234,64,252157
4986,0.001186,172.31.40.0-255,66,75300,64,252157
4987,0.001191,172.217.194.0-255,2902,78202,64,252157
4988,0.001193,172.31.40.0-255,66,78268,64,252157
4989,0.00123,172.217.194.0-255,2902,81170,64,252157
4990,0.001233,172.31.40.0-255,66,81236,64,252157
4991,0.00124,172.217.194.0-255,7156,88392,64,252157
4992,0.001243,172.31.40.0-255,66,88458,64,252157
4993,0.001262,172.31.40.0-255,66,88524,64,252157
4994,0.001266,172.217.194.0-255,2902,91426,64,252157
4995,0.001269,172.31.40.0-255,66,91492,64,252157
4996,0.001317,172.217.194.0-255,1484,92976,64,252157
4997,0.001329,172.31.40.0-255,66,93042,64,252157
4998,0.001336,172.217.194.0-255,7156,100198,64,252157
4999,0.001341,172.31.40.0-255,66,100264,64,252157
5000,0.001378,172.217.194.0-255,7156,107420,64,252157
5001,0.001385,172.217.194.0-255,5020,112440,64,252157
5002,0.001392,172.31.40.0-255,66,112506,64,252157
5003,0.001541,172.217.194.0-255,1484,113990,64,252157
5004,0.001546,172.217.194.0-255,2902,116892,64,252157
5005,0.001552,172.217.194.0-255,4320,121212,64,252157
5006,0.001564,172.217.194.0-255,1484,122696,64,252157
5007,0.001573,172.31.40.0-255,66,122762,64,252157
5008,0.0016,172.31.40.0-255,66,122828,64,252157
5009,0.001624,172.217.194.0-255,1484,124312,64,252157
5010,0.001644,172.31.40.0-255,66,124378,64,252157
5011,0.00177,172.217.194.0-255,1484,125862,64,252157
5012,0.001776,172.217.194.0-255,2902,128764,64,252157
5013,0.00178,172.217.194.0-255,1484,130248,64,252157
5014,0.001786,172.31.40.0-255,66,130314,64,252157
5015,0.001799,172.217.194.0-255,4320,134634,64,252157
5016,0.001806,172.217.194.0-255,1484,136118,64,252157
5017,0.001813,172.217.194.0-255,7156,143274,64,252157
5018,0.001831,172.217.194.0-255,1484,144758,64,252157
5019,0.001838,172.31.40.0-255,66,144824,64,252157
5020,0.001847,172.217.194.0-255,2902,147726,64,252157
5021,0.001865,172.217.194.0-255,7156,154882,64,252157
5022,0.001868,172.31.40.0-255,66,154948,64,252157
5023,0.001897,172.217.194.0-255,3602,158550,64,252157
5024,0.001907,172.31.40.0-255,66,158616,64,252157
5025,0.001991,172.217.194.0-255,1484,160100,64,252157
5026,0.001997,172.217.194.0-255,2902,163002,64,252157
5027,0.001999,172.31.40.0-255,66,163068,64,252157
5028,0.002005,172.217.194.0-255,4320,167388,64,252157
5029,0.002028,172.217.194.0-255,1484,168872,64,252157
5030,0.002034,172.217.194.0-255,5738,174610,64,252157
5031,0.002046,172.31.40.0-255,66,174676,64,252157
5032,0.00208,172.217.194.0-255,5020,179696,64,252157
5033,0.002086,172.31.40.0-255,66,179762,64,252157
5034,0.002141,172.217.194.0-255,1484,181246,64,252157
5035,0.002147,172.217.194.0-255,2902,184148,64,252157
5036,0.002193,172.217.194.0-255,1484,185632,64,252157
5037,0.002197,172.31.40.0-255,66,185698,64,252157
5038,0.002214,172.217.194.0-255,4320,190018,64,252157
5039,0.00223,172.31.40.0-255,66,190084,64,252157
5040,0.002241,172.217.194.0-255,2902,192986,64,252157
5041,0.002281,172.31.40.0-255,66,193052,64,252157
5042,0.002328,172.217.194.0-255,2902,195954,64,252157
5043,0.002339,172.217.194.0-255,2902,198856,64,252157
5044,0.002344,172.31.40.0-255,66,198922,64,252157
5045,0.002387,172.31.40.0-255,66,198988,64,252157
5046,0.00243,172.31.40.0-255,66,199054,64,252157
5047,0.002452,172.217.194.0-255,6438,205492,64,252157
5048,0.002465,172.217.194.0-255,766,206258,64,252157
5049,0.002485,172.31.40.0-255,66,206324,64,252157
5050,0.004908,172.217.194.0-255,5738,212062,64,252157
5051,0.004914,172.31.40.0-255,66,212128,64,252157
5052,0.007241,172.217.194.0-255,5738,217866,64,252157
5053,0.007245,172.31.40.0-255,66,217932,64,252157
5054,0.009535,172.217.194.0-255,2902,220834,64,252157
5055,0.009541,172.31.40.0-255,66,220900,64,252157
5056,0.009569,172.217.194.0-255,2902,223802,64,252157
5057,0.009571,172.31.40.0-255,66,223868,64,252157
5058,0.011873,172.217.194.0-255,5738,229606,64,252157
5059,0.011891,172.31.40.0-255,66,229672,64,252157
5060,0.014206,172.217.194.0-255,5738,235410,64,252157
5061,0.014225,172.31.40.0-255,66,235476,64,252157
5062,0.016524,172.217.194.0-255,5738,241214,64,252157
5063,0.016542,172.31.40.0-255,66,241280,64,252157
5064,0.0189,172.217.194.0-255,4435,245715,64,252157
5065,0.018909,172.31.40.0-255,66,245781,64,252157
5066,0.024302,172.31.40.0-255,105,245886,64,252157
5067,0.026562,172.217.194.0-255,66,245952,64,252157
5068,0.046744,172.31.40.0-255,172,246124,64,252157
5069,0.04678,172.31.40.0-255,1108,247232,64,252157
5070,0.046847,172.31.40.0-255,1514,248746,64,252157
5071,0.046849,172.31.40.0-255,1514,250260,64,252157
5072,0.04685,172.31.40.0-255,1514,251774,64,252157
5073,0.046852,172.31.40.0-255,119,251893,64,252157
5074,0.048284,104.244.42.0-255,66,251959,64,252157
5075,0.04833,104.244.42.0-255,66,252025,64,252157
5076,0.048412,104.244.42.0-255,66,252091,64,252157
5077,0.048417,104.244.42.0-255,66,252157,64,252157
5078,0.0,172.253.118.0-255,296,296,64,244133
5079,2.2e-05,172.31.40.0-255,66,362,64,244133
5080,2.8e-05,172.253.118.0-255,1484,1846,64,244133
5081,3.3e-05,172.31.40.0-255,66,1912,64,244133
5082,4.6e-05,172.253.118.0-255,4320,6232,64,244133
5083,5e-05,172.31.40.0-255,66,6298,64,244133
5084,6.1e-05,172.31.40.0-255,66,6364,64,244133
5085,9.1e-05,172.31.40.0-255,66,6430,64,244133
5086,0.00013,172.253.118.0-255,2543,8973,64,244133
5087,0.000133,172.31.40.0-255,66,9039,64,244133
5088,0.000237,172.253.118.0-255,1484,10523,64,244133
5089,0.00024,172.31.40.0-255,66,10589,64,244133
5090,0.00027,172.253.118.0-255,2902,13491,64,244133
5091,0.000273,172.31.40.0-255,66,13557,64,244133
5092,0.000279,172.253.118.0-255,5738,19295,64,244133
5093,0.000281,172.31.40.0-255,66,19361,64,244133
5094,0.000329,172.31.40.0-255,66,19427,64,244133
5095,0.000338,172.31.40.0-255,66,19493,64,244133
5096,0.000373,172.253.118.0-255,3961,23454,64,244133
5097,0.000375,172.31.40.0-255,66,23520,64,244133
5098,0.000651,172.253.118.0-255,646,24166,64,244133
5099,0.000655,172.31.40.0-255,66,24232,64,244133
5100,0.000937,172.253.118.0-255,1484,25716,64,244133
5101,0.00094,172.31.40.0-255,66,25782,64,244133
5102,0.000944,172.253.118.0-255,1484,27266,64,244133
5103,0.000946,172.31.40.0-255,66,27332,64,244133
5104,0.000966,172.253.118.0-255,1484,28816,64,244133
5105,0.000968,172.31.40.0-255,66,28882,64,244133
5106,0.000978,172.253.118.0-255,5738,34620,64,244133
5107,0.00098,172.31.40.0-255,66,34686,64,244133
5108,0.000985,172.253.118.0-255,5738,40424,64,244133
5109,0.000987,172.31.40.0-255,66,40490,64,244133
5110,0.001026,172.253.118.0-255,7156,47646,64,244133
5111,0.001028,172.31.40.0-255,66,47712,64,244133
5112,0.001038,172.31.40.0-255,66,47778,64,244133
5113,0.001055,172.253.118.0-255,2184,49962,64,244133
5114,0.00106,172.31.40.0-255,66,50028,64,244133
5115,0.001954,172.253.118.0-255,1484,51512,64,244133
5116,0.001963,172.253.118.0-255,2902,54414,64,244133
5117,0.001967,172.31.40.0-255,66,54480,64,244133
5118,0.001974,172.253.118.0-255,5738,60218,64,244133
5119,0.001976,172.31.40.0-255,66,60284,64,244133
5120,0.001979,172.253.118.0-255,1484,61768,64,244133
5121,0.002017,172.31.40.0-255,66,61834,64,244133
5122,0.002023,172.253.118.0-255,7156,68990,64,244133
5123,0.002025,172.31.40.0-255,66,69056,64,244133
5124,0.002051,172.253.118.0-255,3602,72658,64,244133
5125,0.002053,172.31.40.0-255,66,72724,64,244133
5126,0.002161,172.253.118.0-255,1484,74208,64,244133
5127,0.002167,172.253.118.0-255,2902,77110,64,244133
5128,0.00217,172.31.40.0-255,66,77176,64,244133
5129,0.002176,172.253.118.0-255,2902,80078,64,244133
5130,0.002178,172.31.40.0-255,66,80144,64,244133
5131,0.002205,172.253.118.0-255,2902,83046,64,244133
5132,0.002207,172.31.40.0-255,66,83112,64,244133
5133,0.002221,172.31.40.0-255,66,83178,64,244133
5134,0.00225,172.253.118.0-255,2902,86080,64,244133
5135,0.002252,172.31.40.0-255,66,86146,64,244133
5136,0.002263,172.31.40.0-255,66,86212,64,244133
5137,0.002291,172.253.118.0-255,1484,87696,64,244133
5138,0.002295,172.253.118.0-255,2902,90598,64,244133
5139,0.002298,172.31.40.0-255,66,90664,64,244133
5140,0.002346,172.253.118.0-255,5738,96402,64,244133
5141,0.002349,172.31.40.0-255,66,96468,64,244133
5142,0.002353,172.253.118.0-255,4320,100788,64,244133
5143,0.002355,172.31.40.0-255,66,100854,64,244133
5144,0.004667,172.253.118.0-255,1484,102338,64,244133
5145,0.004681,172.253.118.0-255,4320,106658,64,244133
5146,0.004685,172.31.40.0-255,66,106724,64,244133
5147,0.007005,172.253.118.0-255,5738,112462,64,244133
5148,0.007012,172.31.40.0-255,66,112528,64,244133
5149,0.009342,172.253.118.0-255,5738,118266,64,244133
5150,0.009351,172.31.40.0-255,66,118332,64,244133
5151,0.011688,172.253.118.0-255,5738,124070,64,244133
5152,0.011698,172.31.40.0-255,66,124136,64,244133
5153,0.014038,172.253.118.0-255,5738,129874,64,244133
5154,0.014048,172.31.40.0-255,66,129940,64,244133
5155,0.016366,172.253.118.0-255,5738,135678,64,244133
5156,0.016375,172.31.40.0-255,66,135744,64,244133
5157,0.018704,172.253.118.0-255,5738,141482,64,244133
5158,0.018713,172.31.40.0-255,66,141548,64,244133
5159,0.021043,172.253.118.0-255,5738,147286,64,244133
5160,0.021051,172.31.40.0-255,66,147352,64,244133
5161,0.023364,172.253.118.0-255,5738,153090,64,244133
5162,0.023371,172.31.40.0-255,66,153156,64,244133
5163,0.025689,172.253.118.0-255,5738,158894,64,244133
5164,0.025696,172.31.40.0-255,66,158960,64,244133
5165,0.028038,172.253.118.0-255,5738,164698,64,244133
5166,0.028046,172.31.40.0-255,66,164764,64,244133
5167,0.030366,172.253.118.0-255,5738,170502,64,244133
5168,0.030373,172.31.40.0-255,66,170568,64,244133
5169,0.032714,172.253.118.0-255,5738,176306,64,244133
5170,0.032723,172.31.40.0-255,66,176372,64,244133
5171,0.035047,172.253.118.0-255,5738,182110,64,244133
5172,0.035055,172.31.40.0-255,66,182176,64,244133
5173,0.037301,172.31.40.0-255,172,182348,64,244133
5174,0.037334,172.31.40.0-255,1111,183459,64,244133
5175,0.037387,172.253.118.0-255,5738,189197,64,244133
5176,0.037392,172.31.40.0-255,66,189263,64,244133
5177,0.037429,172.31.40.0-255,1514,190777,64,244133
5178,0.037431,172.31.40.0-255,1514,192291,64,244133
5179,0.037455,172.31.40.0-255,694,192985,64,244133
5180,0.03885,104.244.42.0-255,66,193051,64,244133
5181,0.038898,104.244.42.0-255,66,193117,64,244133
5182,0.039,104.244.42.0-255,66,193183,64,244133
5183,0.039006,104.244.42.0-255,66,193249,64,244133
5184,0.039719,172.253.118.0-255,5738,198987,64,244133
5185,0.039727,172.31.40.0-255,66,199053,64,244133
5186,0.042091,172.253.118.0-255,5738,204791,64,244133
5187,0.042098,172.31.40.0-255,66,204857,64,244133
5188,0.044424,172.253.118.0-255,5738,210595,64,244133
5189,0.044435,172.31.40.0-255,66,210661,64,244133
5190,0.046767,172.253.118.0-255,5738,216399,64,244133
5191,0.046774,172.31.40.0-255,66,216465,64,244133
5192,0.049117,172.253.118.0-255,5738,222203,64,244133
5193,0.049125,172.31.40.0-255,66,222269,64,244133
5194,0.051458,172.253.118.0-255,4320,226589,64,244133
5195,0.051465,172.31.40.0-255,66,226655,64,244133
5196,0.051492,172.253.118.0-255,1484,228139,64,244133
5197,0.053784,172.253.118.0-255,4320,232459,64,244133
5198,0.05379,172.31.40.0-255,66,232525,64,244133
5199,0.056125,172.253.118.0-255,5738,238263,64,244133
5200,0.056134,172.31.40.0-255,66,238329,64,244133
5201,0.058462,172.253.118.0-255,5738,244067,64,244133
5202,0.058469,172.31.40.0-255,66,244133,64,244133
5203,0.0,172.31.40.0-255,105,105,64,459
5204,0.000157,172.31.40.0-255,90,195,64,459
5205,0.000168,172.31.40.0-255,66,261,64,459
5206,0.00277,172.217.194.0-255,66,327,64,459
5207,0.0028,172.217.194.0-255,66,393,64,459
5208,0.002822,172.31.40.0-255,66,459,64,459
5209,0.0,172.217.194.0-255,152,152,64,180796
5210,2.1e-05,172.31.40.0-255,66,218,64,180796
5211,2.8e-05,172.217.194.0-255,1484,1702,64,180796
5212,3.3e-05,172.31.40.0-255,66,1768,64,180796
5213,3.9e-05,172.217.194.0-255,2902,4670,64,180796
5214,4.3e-05,172.31.40.0-255,66,4736,64,180796
5215,4.6e-05,172.217.194.0-255,1484,6220,64,180796
5216,4.9e-05,172.31.40.0-255,66,6286,64,180796
5217,7.3e-05,172.217.194.0-255,4320,10606,64,180796
5218,7.6e-05,172.31.40.0-255,66,10672,64,180796
5219,8.2e-05,172.217.194.0-255,3394,14066,64,180796
5220,8.5e-05,172.31.40.0-255,66,14132,64,180796
5221,0.000129,172.217.194.0-255,1484,15616,64,180796
5222,0.000132,172.31.40.0-255,66,15682,64,180796
5223,0.000137,172.217.194.0-255,2902,18584,64,180796
5224,0.000139,172.31.40.0-255,66,18650,64,180796
5225,0.000153,172.217.194.0-255,2902,21552,64,180796
5226,0.000157,172.31.40.0-255,66,21618,64,180796
5227,0.000178,172.217.194.0-255,2902,24520,64,180796
5228,0.00018,172.31.40.0-255,66,24586,64,180796
5229,0.000186,172.217.194.0-255,4320,28906,64,180796
5230,0.000188,172.31.40.0-255,66,28972,64,180796
5231,0.000231,172.217.194.0-255,2902,31874,64,180796
5232,0.000233,172.31.40.0-255,66,31940,64,180796
5233,0.000254,172.217.194.0-255,5738,37678,64,180796
5234,0.000258,172.31.40.0-255,66,37744,64,180796
5235,0.00027,172.31.40.0-255,66,37810,64,180796
5236,0.000272,172.217.194.0-255,766,38576,64,180796
5237,0.000274,172.31.40.0-255,66,38642,64,180796
5238,0.001519,172.217.194.0-255,1484,40126,64,180796
5239,0.001527,172.31.40.0-255,66,40192,64,180796
5240,0.001558,172.217.194.0-255,1484,41676,64,180796
5241,0.001571,172.217.194.0-255,1484,43160,64,180796
5242,0.001573,172.31.40.0-255,66,43226,64,180796
5243,0.001587,172.217.194.0-255,1484,44710,64,180796
5244,0.001595,172.217.194.0-255,5738,50448,64,180796
5245,0.001597,172.31.40.0-255,66,50514,64,180796
5246,0.001609,172.217.194.0-255,1484,51998,64,180796
5247,0.001627,172.217.194.0-255,4252,56250,64,180796
5248,0.001629,172.31.40.0-255,66,56316,64,180796
5249,0.001632,172.217.194.0-255,99,56415,64,180796
5250,0.004269,172.217.194.0-255,4320,60735,64,180796
5251,0.004273,172.31.40.0-255,66,60801,64,180796
5252,0.006932,172.217.194.0-255,5738,66539,64,180796
5253,0.006939,172.31.40.0-255,66,66605,64,180796
5254,0.009586,172.217.194.0-255,5738,72343,64,180796
5255,0.009594,172.31.40.0-255,66,72409,64,180796
5256,0.012293,172.217.194.0-255,5738,78147,64,180796
5257,0.012301,172.31.40.0-255,66,78213,64,180796
5258,0.014993,172.217.194.0-255,5738,83951,64,180796
5259,0.015005,172.31.40.0-255,66,84017,64,180796
5260,0.017648,172.217.194.0-255,4320,88337,64,180796
5261,0.017655,172.31.40.0-255,66,88403,64,180796
5262,0.017677,172.217.194.0-255,1484,89887,64,180796
5263,0.020284,172.217.194.0-255,4320,94207,64,180796
5264,0.020292,172.31.40.0-255,66,94273,64,180796
5265,0.02292,172.217.194.0-255,5738,100011,64,180796
5266,0.022927,172.31.40.0-255,66,100077,64,180796
5267,0.024077,172.31.40.0-255,167,100244,64,180796
5268,0.024112,172.31.40.0-255,1111,101355,64,180796
5269,0.024175,172.31.40.0-255,1514,102869,64,180796
5270,0.024177,172.31.40.0-255,1514,104383,64,180796
5271,0.024205,172.31.40.0-255,697,105080,64,180796
5272,0.025573,172.217.194.0-255,5738,110818,64,180796
5273,0.02558,172.31.40.0-255,66,110884,64,180796
5274,0.025605,104.244.42.0-255,66,110950,64,180796
5275,0.025655,104.244.42.0-255,66,111016,64,180796
5276,0.02574,104.244.42.0-255,66,111082,64,180796
5277,0.025745,104.244.42.0-255,66,111148,64,180796
5278,0.02824,172.217.194.0-255,5738,116886,64,180796
5279,0.028248,172.31.40.0-255,66,116952,64,180796
5280,0.03093,172.217.194.0-255,5738,122690,64,180796
5281,0.030944,172.31.40.0-255,66,122756,64,180796
5282,0.033594,172.217.194.0-255,5738,128494,64,180796
5283,0.033601,172.31.40.0-255,66,128560,64,180796
5284,0.03622,172.217.194.0-255,5738,134298,64,180796
5285,0.036227,172.31.40.0-255,66,134364,64,180796
5286,0.038925,172.217.194.0-255,5738,140102,64,180796
5287,0.038933,172.31.40.0-255,66,140168,64,180796
5288,0.041606,172.217.194.0-255,5738,145906,64,180796
5289,0.041612,172.31.40.0-255,66,145972,64,180796
5290,0.044258,172.217.194.0-255,5738,151710,64,180796
5291,0.044265,172.31.40.0-255,66,151776,64,180796
5292,0.046921,172.217.194.0-255,5738,157514,64,180796
5293,0.046926,172.31.40.0-255,66,157580,64,180796
5294,0.049541,172.217.194.0-255,5738,163318,64,180796
5295,0.049548,172.31.40.0-255,66,163384,64,180796
5296,0.052224,172.217.194.0-255,5738,169122,64,180796
5297,0.052229,172.31.40.0-255,66,169188,64,180796
5298,0.054876,172.217.194.0-255,5738,174926,64,180796
5299,0.054887,172.31.40.0-255,66,174992,64,180796
5300,0.057537,172.217.194.0-255,5738,180730,64,180796
5301,0.057543,172.31.40.0-255,66,180796,64,180796
5302,0.0,74.125.200.0-255,153,153,64,258886
5303,2.3e-05,172.31.40.0-255,66,219,64,258886
5304,3e-05,74.125.200.0-255,1484,1703,64,258886
5305,3.5e-05,172.31.40.0-255,66,1769,64,258886
5306,3.8e-05,74.125.200.0-255,1484,3253,64,258886
5307,4.2e-05,172.31.40.0-255,66,3319,64,258886
5308,5.4e-05,74.125.200.0-255,1484,4803,64,258886
5309,5.7e-05,172.31.40.0-255,66,4869,64,258886
5310,7.7e-05,74.125.200.0-255,1484,6353,64,258886
5311,8e-05,172.31.40.0-255,66,6419,64,258886
5312,9.2e-05,74.125.200.0-255,5738,12157,64,258886
5313,9.5e-05,172.31.40.0-255,66,12223,64,258886
5314,9.9e-05,74.125.200.0-255,2002,14225,64,258886
5315,0.000102,172.31.40.0-255,66,14291,64,258886
5316,0.000174,74.125.200.0-255,1484,15775,64,258886
5317,0.000177,172.31.40.0-255,66,15841,64,258886
5318,0.000182,74.125.200.0-255,2902,18743,64,258886
5319,0.000185,172.31.40.0-255,66,18809,64,258886
5320,0.000188,74.125.200.0-255,1484,20293,64,258886
5321,0.000189,172.31.40.0-255,66,20359,64,258886
5322,0.000214,74.125.200.0-255,2902,23261,64,258886
5323,0.000217,172.31.40.0-255,66,23327,64,258886
5324,0.000246,74.125.200.0-255,5738,29065,64,258886
5325,0.000249,172.31.40.0-255,66,29131,64,258886
5326,0.000254,74.125.200.0-255,2543,31674,64,258886
5327,0.000256,172.31.40.0-255,66,31740,64,258886
5328,0.000439,74.125.200.0-255,1484,33224,64,258886
5329,0.000443,172.31.40.0-255,66,33290,64,258886
5330,0.000449,74.125.200.0-255,2902,36192,64,258886
5331,0.000452,172.31.40.0-255,66,36258,64,258886
5332,0.00048,74.125.200.0-255,4320,40578,64,258886
5333,0.000483,172.31.40.0-255,66,40644,64,258886
5334,0.000505,74.125.200.0-255,1484,42128,64,258886
5335,0.000522,74.125.200.0-255,4320,46448,64,258886
5336,0.000525,172.31.40.0-255,66,46514,64,258886
5337,0.000555,74.125.200.0-255,2902,49416,64,258886
5338,0.000559,172.31.40.0-255,66,49482,64,258886
5339,0.000573,74.125.200.0-255,3961,53443,64,258886
5340,0.000576,172.31.40.0-255,66,53509,64,258886
5341,0.000588,74.125.200.0-255,7156,60665,64,258886
5342,0.000591,172.31.40.0-255,66,60731,64,258886
5343,0.000626,74.125.200.0-255,5379,66110,64,258886
5344,0.00063,172.31.40.0-255,66,66176,64,258886
5345,0.000836,74.125.200.0-255,412,66588,64,258886
5346,0.000877,74.125.200.0-255,331,66919,64,258886
5347,0.001081,172.31.40.0-255,66,66985,64,258886
5348,0.001123,74.125.200.0-255,1484,68469,64,258886
5349,0.001144,74.125.200.0-255,2902,71371,64,258886
5350,0.001147,172.31.40.0-255,66,71437,64,258886
5351,0.001175,74.125.200.0-255,5738,77175,64,258886
5352,0.001177,172.31.40.0-255,66,77241,64,258886
5353,0.001182,74.125.200.0-255,2902,80143,64,258886
5354,0.001183,172.31.40.0-255,66,80209,64,258886
5355,0.001205,74.125.200.0-255,4320,84529,64,258886
5356,0.001207,172.31.40.0-255,66,84595,64,258886
5357,0.001234,74.125.200.0-255,4320,88915,64,258886
5358,0.00124,172.31.40.0-255,66,88981,64,258886
5359,0.001246,74.125.200.0-255,5738,94719,64,258886
5360,0.001247,172.31.40.0-255,66,94785,64,258886
5361,0.001277,74.125.200.0-255,5738,100523,64,258886
5362,0.001279,172.31.40.0-255,66,100589,64,258886
5363,0.001304,74.125.200.0-255,766,101355,64,258886
5364,0.001494,172.31.40.0-255,66,101421,64,258886
5365,0.00187,74.125.200.0-255,1484,102905,64,258886
5366,0.001897,74.125.200.0-255,2902,105807,64,258886
5367,0.001901,172.31.40.0-255,66,105873,64,258886
5368,0.001928,74.125.200.0-255,4320,110193,64,258886
5369,0.00193,172.31.40.0-255,66,110259,64,258886
5370,0.001934,74.125.200.0-255,2902,113161,64,258886
5371,0.001936,172.31.40.0-255,66,113227,64,258886
5372,0.001957,74.125.200.0-255,2902,116129,64,258886
5373,0.001962,172.31.40.0-255,66,116195,64,258886
5374,0.001988,172.31.40.0-255,66,116261,64,258886
5375,0.002017,172.31.40.0-255,66,116327,64,258886
5376,0.00202,74.125.200.0-255,766,117093,64,258886
5377,0.004328,74.125.200.0-255,4320,121413,64,258886
5378,0.004332,172.31.40.0-255,66,121479,64,258886
5379,0.006638,74.125.200.0-255,5738,127217,64,258886
5380,0.006645,172.31.40.0-255,66,127283,64,258886
5381,0.008962,74.125.200.0-255,5738,133021,64,258886
5382,0.00897,172.31.40.0-255,66,133087,64,258886
5383,0.011289,74.125.200.0-255,5738,138825,64,258886
5384,0.011297,172.31.40.0-255,66,138891,64,258886
5385,0.013622,74.125.200.0-255,5738,144629,64,258886
5386,0.013632,172.31.40.0-255,66,144695,64,258886
5387,0.015944,74.125.200.0-255,5738,150433,64,258886
5388,0.015952,172.31.40.0-255,66,150499,64,258886
5389,0.018261,74.125.200.0-255,5738,156237,64,258886
5390,0.018269,172.31.40.0-255,66,156303,64,258886
5391,0.020585,74.125.200.0-255,5738,162041,64,258886
5392,0.020593,172.31.40.0-255,66,162107,64,258886
5393,0.022908,74.125.200.0-255,5738,167845,64,258886
5394,0.022915,172.31.40.0-255,66,167911,64,258886
5395,0.025218,74.125.200.0-255,5738,173649,64,258886
5396,0.025226,172.31.40.0-255,66,173715,64,258886
5397,0.02754,74.125.200.0-255,5738,179453,64,258886
5398,0.027547,172.31.40.0-255,66,179519,64,258886
5399,0.029869,74.125.200.0-255,5738,185257,64,258886
5400,0.029877,172.31.40.0-255,66,185323,64,258886
5401,0.032188,74.125.200.0-255,5738,191061,64,258886
5402,0.032195,172.31.40.0-255,66,191127,64,258886
5403,0.033009,172.31.40.0-255,167,191294,64,258886
5404,0.033042,172.31.40.0-255,1112,192406,64,258886
5405,0.03313,172.31.40.0-255,1514,193920,64,258886
5406,0.033133,172.31.40.0-255,1514,195434,64,258886
5407,0.033157,172.31.40.0-255,696,196130,64,258886
5408,0.034501,74.125.200.0-255,4320,200450,64,258886
5409,0.034508,172.31.40.0-255,66,200516,64,258886
5410,0.034541,104.244.42.0-255,66,200582,64,258886
5411,0.034547,74.125.200.0-255,1484,202066,64,258886
5412,0.034573,104.244.42.0-255,66,202132,64,258886
5413,0.034698,104.244.42.0-255,66,202198,64,258886
5414,0.034704,104.244.42.0-255,66,202264,64,258886
5415,0.036825,74.125.200.0-255,4320,206584,64,258886
5416,0.036831,172.31.40.0-255,66,206650,64,258886
5417,0.039138,74.125.200.0-255,5738,212388,64,258886
5418,0.039146,172.31.40.0-255,66,212454,64,258886
5419,0.041476,74.125.200.0-255,5738,218192,64,258886
5420,0.041485,172.31.40.0-255,66,218258,64,258886
5421,0.043796,74.125.200.0-255,5738,223996,64,258886
5422,0.043803,172.31.40.0-255,66,224062,64,258886
5423,0.046113,74.125.200.0-255,5738,229800,64,258886
5424,0.046118,172.31.40.0-255,66,229866,64,258886
5425,0.048432,74.125.200.0-255,5738,235604,64,258886
5426,0.048438,172.31.40.0-255,66,235670,64,258886
5427,0.050789,74.125.200.0-255,5738,241408,64,258886
5428,0.050808,172.31.40.0-255,66,241474,64,258886
5429,0.053146,74.125.200.0-255,5738,247212,64,258886
5430,0.053159,172.31.40.0-255,66,247278,64,258886
5431,0.05548,74.125.200.0-255,5738,253016,64,258886
5432,0.055493,172.31.40.0-255,66,253082,64,258886
5433,0.057811,74.125.200.0-255,5738,258820,64,258886
5434,0.057825,172.31.40.0-255,66,258886,64,258886
5435,0.0,172.31.40.0-255,105,105,64,276
5436,0.001493,157.240.7.0-255,105,210,64,276
5437,0.00151,172.31.40.0-255,66,276,64,276
5438,0.0,172.217.160.0-255,153,153,64,319138
5439,2.2e-05,172.31.40.0-255,66,219,64,319138
5440,2.9e-05,172.217.160.0-255,1484,1703,64,319138
5441,3.4e-05,172.31.40.0-255,66,1769,64,319138
5442,5.3e-05,172.217.160.0-255,2902,4671,64,319138
5443,5.6e-05,172.31.40.0-255,66,4737,64,319138
5444,6.6e-05,172.217.160.0-255,7156,11893,64,319138
5445,7.2e-05,172.31.40.0-255,66,11959,64,319138
5446,0.000114,172.31.40.0-255,66,12025,64,319138
5447,0.000141,172.217.160.0-255,502,12527,64,319138
5448,0.000144,172.31.40.0-255,66,12593,64,319138
5449,0.000153,172.217.160.0-255,6797,19390,64,319138
5450,0.000156,172.31.40.0-255,66,19456,64,319138
5451,0.000159,172.217.160.0-255,1484,20940,64,319138
5452,0.000161,172.31.40.0-255,66,21006,64,319138
5453,0.000165,172.217.160.0-255,2902,23908,64,319138
5454,0.000167,172.31.40.0-255,66,23974,64,319138
5455,0.00017,172.217.160.0-255,1484,25458,64,319138
5456,0.000172,172.31.40.0-255,66,25524,64,319138
5457,0.000203,172.217.160.0-255,4320,29844,64,319138
5458,0.000205,172.31.40.0-255,66,29910,64,319138
5459,0.000212,172.217.160.0-255,7156,37066,64,319138
5460,0.000215,172.31.40.0-255,66,37132,64,319138
5461,0.000232,172.217.160.0-255,1125,38257,64,319138
5462,0.000234,172.31.40.0-255,66,38323,64,319138
5463,0.000242,172.217.160.0-255,7156,45479,64,319138
5464,0.000244,172.31.40.0-255,66,45545,64,319138
5465,0.00027,172.217.160.0-255,1484,47029,64,319138
5466,0.000272,172.31.40.0-255,66,47095,64,319138
5467,0.00028,172.217.160.0-255,6797,53892,64,319138
5468,0.000282,172.31.40.0-255,66,53958,64,319138
5469,0.000285,172.217.160.0-255,374,54332,64,319138
5470,0.000862,172.217.160.0-255,103,54435,64,319138
5471,0.000968,172.217.160.0-255,1484,55919,64,319138
5472,0.000974,172.31.40.0-255,66,55985,64,319138
5473,0.000981,172.217.160.0-255,2902,58887,64,319138
5474,0.000984,172.31.40.0-255,66,58953,64,319138
5475,0.000988,172.217.160.0-255,2902,61855,64,319138
5476,0.00099,172.31.40.0-255,66,61921,64,319138
5477,0.001019,172.217.160.0-255,2902,64823,64,319138
5478,0.001023,172.31.40.0-255,66,64889,64,319138
5479,0.00103,172.217.160.0-255,6797,71686,64,319138
5480,0.001032,172.31.40.0-255,66,71752,64,319138
5481,0.001047,172.31.40.0-255,66,71818,64,319138
5482,0.001051,172.217.160.0-255,2543,74361,64,319138
5483,0.001053,172.31.40.0-255,66,74427,64,319138
5484,0.001056,172.217.160.0-255,364,74791,64,319138
5485,0.00115,172.217.160.0-255,1484,76275,64,319138
5486,0.001154,172.31.40.0-255,66,76341,64,319138
5487,0.001159,172.217.160.0-255,2902,79243,64,319138
5488,0.001161,172.31.40.0-255,66,79309,64,319138
5489,0.001166,172.217.160.0-255,2902,82211,64,319138
5490,0.001168,172.31.40.0-255,66,82277,64,319138
5491,0.001195,172.217.160.0-255,2902,85179,64,319138
5492,0.001198,172.31.40.0-255,66,85245,64,319138
5493,0.001204,172.217.160.0-255,4320,89565,64,319138
5494,0.001207,172.31.40.0-255,66,89631,64,319138
5495,0.001226,172.31.40.0-255,66,89697,64,319138
5496,0.00123,172.217.160.0-255,2902,92599,64,319138
5497,0.001232,172.31.40.0-255,66,92665,64,319138
5498,0.001266,172.31.40.0-255,66,92731,64,319138
5499,0.001371,172.217.160.0-255,1484,94215,64,319138
5500,0.001378,172.217.160.0-255,2902,97117,64,319138
5501,0.001381,172.31.40.0-255,66,97183,64,319138
5502,0.001388,172.217.160.0-255,5738,102921,64,319138
5503,0.00139,172.31.40.0-255,66,102987,64,319138
5504,0.001419,172.31.40.0-255,66,103053,64,319138
5505,0.00145,172.217.160.0-255,2902,105955,64,319138
5506,0.001452,172.31.40.0-255,66,106021,64,319138
5507,0.001465,172.31.40.0-255,66,106087,64,319138
5508,0.001539,172.217.160.0-255,1484,107571,64,319138
5509,0.001545,172.217.160.0-255,2902,110473,64,319138
5510,0.001548,172.31.40.0-255,66,110539,64,319138
5511,0.001553,172.217.160.0-255,2902,113441,64,319138
5512,0.001556,172.31.40.0-255,66,113507,64,319138
5513,0.001569,172.217.160.0-255,2902,116409,64,319138
5514,0.001571,172.31.40.0-255,66,116475,64,319138
5515,0.001582,172.31.40.0-255,66,116541,64,319138
5516,0.001631,172.217.160.0-255,7156,123697,64,319138
5517,0.001634,172.31.40.0-255,66,123763,64,319138
5518,0.001662,172.31.40.0-255,66,123829,64,319138
5519,0.001705,172.217.160.0-255,1484,125313,64,319138
5520,0.00171,172.217.160.0-255,2902,128215,64,319138
5521,0.001712,172.31.40.0-255,66,128281,64,319138
5522,0.001718,172.217.160.0-255,5738,134019,64,319138
5523,0.001721,172.31.40.0-255,66,134085,64,319138
5524,0.001727,172.217.160.0-255,5738,139823,64,319138
5525,0.001729,172.31.40.0-255,66,139889,64,319138
5526,0.001757,172.217.160.0-255,7156,147045,64,319138
5527,0.00176,172.31.40.0-255,66,147111,64,319138
5528,0.001767,172.217.160.0-255,7156,154267,64,319138
5529,0.001769,172.31.40.0-255,66,154333,64,319138
5530,0.001823,172.217.160.0-255,3602,157935,64,319138
5531,0.001827,172.31.40.0-255,66,158001,64,319138
5532,0.001861,172.217.160.0-255,1484,159485,64,319138
5533,0.001866,172.217.160.0-255,2902,162387,64,319138
5534,0.001869,172.31.40.0-255,66,162453,64,319138
5535,0.001872,172.217.160.0-255,1484,163937,64,319138
5536,0.001892,172.217.160.0-255,4320,168257,64,319138
5537,0.001913,172.31.40.0-255,66,168323,64,319138
5538,0.00192,172.31.40.0-255,66,168389,64,319138
5539,0.001925,172.217.160.0-255,2902,171291,64,319138
5540,0.001927,172.31.40.0-255,66,171357,64,319138
5541,0.00194,172.31.40.0-255,66,171423,64,319138
5542,0.00388,172.217.160.0-255,5738,177161,64,319138
5543,0.003888,172.31.40.0-255,66,177227,64,319138
5544,0.005839,172.217.160.0-255,5738,182965,64,319138
5545,0.005856,172.31.40.0-255,66,183031,64,319138
5546,0.00782,172.217.160.0-255,5738,188769,64,319138
5547,0.007834,172.31.40.0-255,66,188835,64,319138
5548,0.009779,172.217.160.0-255,5738,194573,64,319138
5549,0.009794,172.31.40.0-255,66,194639,64,319138
5550,0.011736,172.217.160.0-255,5738,200377,64,319138
5551,0.011745,172.31.40.0-255,66,200443,64,319138
5552,0.013707,172.217.160.0-255,5738,206181,64,319138
5553,0.013725,172.31.40.0-255,66,206247,64,319138
5554,0.01567,172.217.160.0-255,5738,211985,64,319138
5555,0.015682,172.31.40.0-255,66,212051,64,319138
5556,0.017652,172.217.160.0-255,5738,217789,64,319138
5557,0.017673,172.31.40.0-255,66,217855,64,319138
5558,0.019645,172.217.160.0-255,5738,223593,64,319138
5559,0.01966,172.31.40.0-255,66,223659,64,319138
5560,0.021616,172.217.160.0-255,5738,229397,64,319138
5561,0.021627,172.31.40.0-255,66,229463,64,319138
5562,0.023591,172.217.160.0-255,5738,235201,64,319138
5563,0.023605,172.31.40.0-255,66,235267,64,319138
5564,0.025562,172.217.160.0-255,5738,241005,64,319138
5565,0.025582,172.31.40.0-255,66,241071,64,319138
5566,0.027526,172.217.160.0-255,5738,246809,64,319138
5567,0.027536,172.31.40.0-255,66,246875,64,319138
5568,0.029497,172.217.160.0-255,5738,252613,64,319138
5569,0.029519,172.31.40.0-255,66,252679,64,319138
5570,0.031474,172.217.160.0-255,5738,258417,64,319138
5571,0.03149,172.31.40.0-255,66,258483,64,319138
5572,0.033426,172.217.160.0-255,5738,264221,64,319138
5573,0.033433,172.31.40.0-255,66,264287,64,319138
5574,0.03541,172.217.160.0-255,5738,270025,64,319138
5575,0.035428,172.31.40.0-255,66,270091,64,319138
5576,0.037372,172.217.160.0-255,5738,275829,64,319138
5577,0.037383,172.31.40.0-255,66,275895,64,319138
5578,0.039331,172.217.160.0-255,5738,281633,64,319138
5579,0.039344,172.31.40.0-255,66,281699,64,319138
5580,0.041303,172.217.160.0-255,5738,287437,64,319138
5581,0.041327,172.31.40.0-255,66,287503,64,319138
5582,0.043312,172.217.160.0-255,5738,293241,64,319138
5583,0.04332,172.31.40.0-255,66,293307,64,319138
5584,0.045276,172.217.160.0-255,5738,299045,64,319138
5585,0.045297,172.31.40.0-255,66,299111,64,319138
5586,0.047253,172.217.160.0-255,5738,304849,64,319138
5587,0.047268,172.31.40.0-255,66,304915,64,319138
5588,0.049214,172.217.160.0-255,5738,310653,64,319138
5589,0.049225,172.31.40.0-255,66,310719,64,319138
5590,0.051181,172.217.160.0-255,2911,313630,64,319138
5591,0.051198,172.31.40.0-255,66,313696,64,319138
5592,0.051457,172.31.40.0-255,105,313801,64,319138
5593,0.053364,172.217.160.0-255,66,313867,64,319138
5594,0.057204,172.31.40.0-255,171,314038,64,319138
5595,0.057235,172.31.40.0-255,1135,315173,64,319138
5596,0.057302,172.31.40.0-255,1514,316687,64,319138
5597,0.057304,172.31.40.0-255,1514,318201,64,319138
5598,0.057305,172.31.40.0-255,673,318874,64,319138
5599,0.058758,104.244.42.0-255,66,318940,64,319138
5600,0.058801,104.244.42.0-255,66,319006,64,319138
5601,0.058886,104.244.42.0-255,66,319072,64,319138
5602,0.05889,104.244.42.0-255,66,319138,64,319138
5603,0.0,172.31.40.0-255,105,105,64,459
5604,0.000359,172.31.40.0-255,90,195,64,459
5605,0.000379,172.31.40.0-255,66,261,64,459
5606,0.002677,74.125.130.0-255,66,327,64,459
5607,0.002699,74.125.130.0-255,66,393,64,459
5608,0.002715,172.31.40.0-255,66,459,64,459
5609,0.0,172.217.194.0-255,153,153,64,266225
5610,2.3e-05,172.31.40.0-255,66,219,64,266225
5611,3.1e-05,172.217.194.0-255,1484,1703,64,266225
5612,3.6e-05,172.31.40.0-255,66,1769,64,266225
5613,5e-05,172.217.194.0-255,2902,4671,64,266225
5614,5.5e-05,172.31.40.0-255,66,4737,64,266225
5615,6e-05,172.217.194.0-255,4320,9057,64,266225
5616,6.4e-05,172.31.40.0-255,66,9123,64,266225
5617,7.1e-05,172.217.194.0-255,7156,16279,64,266225
5618,7.4e-05,172.31.40.0-255,66,16345,64,266225
5619,0.000111,172.217.194.0-255,2099,18444,64,266225
5620,0.000113,172.31.40.0-255,66,18510,64,266225
5621,0.000125,172.31.40.0-255,66,18576,64,266225
5622,0.000129,172.217.194.0-255,2543,21119,64,266225
5623,0.000131,172.31.40.0-255,66,21185,64,266225
5624,0.000183,172.217.194.0-255,1484,22669,64,266225
5625,0.000186,172.31.40.0-255,66,22735,64,266225
5626,0.000191,172.217.194.0-255,2902,25637,64,266225
5627,0.000193,172.31.40.0-255,66,25703,64,266225
5628,0.000227,172.217.194.0-255,5738,31441,64,266225
5629,0.00023,172.31.40.0-255,66,31507,64,266225
5630,0.000236,172.217.194.0-255,5738,37245,64,266225
5631,0.000238,172.31.40.0-255,66,37311,64,266225
5632,0.000277,172.31.40.0-255,66,37377,64,266225
5633,0.000283,172.217.194.0-255,5020,42397,64,266225
5634,0.000285,172.31.40.0-255,66,42463,64,266225
5635,0.00031,172.217.194.0-255,409,42872,64,266225
5636,0.000312,172.31.40.0-255,66,42938,64,266225
5637,0.000382,172.217.194.0-255,1484,44422,64,266225
5638,0.000385,172.31.40.0-255,66,44488,64,266225
5639,0.00039,172.217.194.0-255,2902,47390,64,266225
5640,0.000392,172.31.40.0-255,66,47456,64,266225
5641,0.000423,172.217.194.0-255,5738,53194,64,266225
5642,0.000426,172.31.40.0-255,66,53260,64,266225
5643,0.000431,172.217.194.0-255,2902,56162,64,266225
5644,0.000433,172.31.40.0-255,66,56228,64,266225
5645,0.000459,172.217.194.0-255,7156,63384,64,266225
5646,0.000463,172.31.40.0-255,66,63450,64,266225
5647,0.000485,172.217.194.0-255,5738,69188,64,266225
5648,0.000488,172.31.40.0-255,66,69254,64,266225
5649,0.000526,172.31.40.0-255,66,69320,64,266225
5650,0.00071,172.217.194.0-255,1484,70804,64,266225
5651,0.000717,172.217.194.0-255,2902,73706,64,266225
5652,0.000721,172.31.40.0-255,66,73772,64,266225
5653,0.000752,172.217.194.0-255,5738,79510,64,266225
5654,0.000755,172.31.40.0-255,66,79576,64,266225
5655,0.000781,172.217.194.0-255,1484,81060,64,266225
5656,0.000807,172.217.194.0-255,5379,86439,64,266225
5657,0.000811,172.31.40.0-255,66,86505,64,266225
5658,0.001282,172.217.194.0-255,1484,87989,64,266225
5659,0.001289,172.217.194.0-255,2902,90891,64,266225
5660,0.001293,172.31.40.0-255,66,90957,64,266225
5661,0.001326,172.217.194.0-255,5738,96695,64,266225
5662,0.001329,172.31.40.0-255,66,96761,64,266225
5663,0.001335,172.217.194.0-255,5738,102499,64,266225
5664,0.001338,172.31.40.0-255,66,102565,64,266225
5665,0.001375,172.217.194.0-255,7156,109721,64,266225
5666,0.001379,172.31.40.0-255,66,109787,64,266225
5667,0.001395,172.31.40.0-255,66,109853,64,266225
5668,0.001833,172.217.194.0-255,1484,111337,64,266225
5669,0.001838,172.217.194.0-255,2902,114239,64,266225
5670,0.001842,172.31.40.0-255,66,114305,64,266225
5671,0.001846,172.217.194.0-255,1484,115789,64,266225
5672,0.001879,172.217.194.0-255,4320,120109,64,266225
5673,0.001881,172.31.40.0-255,66,120175,64,266225
5674,0.001898,172.31.40.0-255,66,120241,64,266225
5675,0.001901,172.217.194.0-255,1484,121725,64,266225
5676,0.001933,172.31.40.0-255,66,121791,64,266225
5677,0.002444,172.217.194.0-255,1484,123275,64,266225
5678,0.002451,172.217.194.0-255,2902,126177,64,266225
5679,0.002455,172.31.40.0-255,66,126243,64,266225
5680,0.002459,172.217.194.0-255,1484,127727,64,266225
5681,0.002484,172.217.194.0-255,4320,132047,64,266225
5682,0.002486,172.31.40.0-255,66,132113,64,266225
5683,0.00249,172.217.194.0-255,2902,135015,64,266225
5684,0.002492,172.31.40.0-255,66,135081,64,266225
5685,0.002528,172.31.40.0-255,66,135147,64,266225
5686,0.002567,172.31.40.0-255,66,135213,64,266225
5687,0.005105,172.217.194.0-255,5738,140951,64,266225
5688,0.005112,172.31.40.0-255,66,141017,64,266225
5689,0.007642,172.217.194.0-255,5738,146755,64,266225
5690,0.007648,172.31.40.0-255,66,146821,64,266225
5691,0.010197,172.217.194.0-255,5738,152559,64,266225
5692,0.010207,172.31.40.0-255,66,152625,64,266225
5693,0.01276,172.217.194.0-255,5738,158363,64,266225
5694,0.012772,172.31.40.0-255,66,158429,64,266225
5695,0.015326,172.217.194.0-255,5738,164167,64,266225
5696,0.015338,172.31.40.0-255,66,164233,64,266225
5697,0.017897,172.217.194.0-255,5738,169971,64,266225
5698,0.01791,172.31.40.0-255,66,170037,64,266225
5699,0.020485,172.217.194.0-255,5738,175775,64,266225
5700,0.020503,172.31.40.0-255,66,175841,64,266225
5701,0.023069,172.217.194.0-255,5738,181579,64,266225
5702,0.023085,172.31.40.0-255,66,181645,64,266225
5703,0.025631,172.217.194.0-255,5738,187383,64,266225
5704,0.025652,172.31.40.0-255,66,187449,64,266225
5705,0.028182,172.217.194.0-255,5738,193187,64,266225
5706,0.028196,172.31.40.0-255,66,193253,64,266225
5707,0.03073,172.217.194.0-255,5738,198991,64,266225
5708,0.030737,172.31.40.0-255,66,199057,64,266225
5709,0.033298,172.217.194.0-255,5738,204795,64,266225
5710,0.033316,172.31.40.0-255,66,204861,64,266225
5711,0.035864,172.217.194.0-255,5738,210599,64,266225
5712,0.035875,172.31.40.0-255,66,210665,64,266225
5713,0.038431,172.31.40.0-255,167,210832,64,266225
5714,0.038474,172.217.194.0-255,5738,216570,64,266225
5715,0.038481,172.31.40.0-255,66,216636,64,266225
5716,0.038512,172.31.40.0-255,1107,217743,64,266225
5717,0.038576,172.31.40.0-255,1514,219257,64,266225
5718,0.038596,172.31.40.0-255,338,219595,64,266225
5719,0.039956,104.244.42.0-255,66,219661,64,266225
5720,0.040042,104.244.42.0-255,66,219727,64,266225
5721,0.04014,104.244.42.0-255,66,219793,64,266225
5722,0.041003,172.217.194.0-255,5738,225531,64,266225
5723,0.041009,172.31.40.0-255,66,225597,64,266225
5724,0.043576,172.217.194.0-255,5738,231335,64,266225
5725,0.043585,172.31.40.0-255,66,231401,64,266225
5726,0.046127,172.217.194.0-255,5738,237139,64,266225
5727,0.046134,172.31.40.0-255,66,237205,64,266225
5728,0.048685,172.217.194.0-255,5738,242943,64,266225
5729,0.048693,172.31.40.0-255,66,243009,64,266225
5730,0.051246,172.217.194.0-255,5738,248747,64,266225
5731,0.051253,172.31.40.0-255,66,248813,64,266225
5732,0.053813,172.217.194.0-255,5738,254551,64,266225
5733,0.053821,172.31.40.0-255,66,254617,64,266225
5734,0.056356,172.217.194.0-255,5738,260355,64,266225
5735,0.056363,172.31.40.0-255,66,260421,64,266225
5736,0.058903,172.217.194.0-255,5738,266159,64,266225
5737,0.058911,172.31.40.0-255,66,266225,64,266225
5738,0.0,172.217.194.0-255,153,153,64,181769
5739,1.5e-05,172.31.40.0-255,66,219,64,181769
5740,2.1e-05,172.217.194.0-255,1484,1703,64,181769
5741,2.5e-05,172.31.40.0-255,66,1769,64,181769
5742,3.1e-05,172.217.194.0-255,2902,4671,64,181769
5743,4.2e-05,172.31.40.0-255,66,4737,64,181769
5744,4.9e-05,172.217.194.0-255,7156,11893,64,181769
5745,5.3e-05,172.31.40.0-255,66,11959,64,181769
5746,8.5e-05,172.217.194.0-255,2027,13986,64,181769
5747,8.8e-05,172.31.40.0-255,66,14052,64,181769
5748,9.3e-05,172.217.194.0-255,2902,16954,64,181769
5749,9.6e-05,172.31.40.0-255,66,17020,64,181769
5750,0.000127,172.217.194.0-255,7156,24176,64,181769
5751,0.00013,172.31.40.0-255,66,24242,64,181769
5752,0.000135,172.217.194.0-255,4320,28562,64,181769
5753,0.000137,172.31.40.0-255,66,28628,64,181769
5754,0.000176,172.217.194.0-255,2543,31171,64,181769
5755,0.000179,172.31.40.0-255,66,31237,64,181769
5756,0.000393,172.217.194.0-255,1484,32721,64,181769
5757,0.000398,172.31.40.0-255,66,32787,64,181769
5758,0.000404,172.217.194.0-255,2902,35689,64,181769
5759,0.000407,172.31.40.0-255,66,35755,64,181769
5760,0.000434,172.217.194.0-255,5738,41493,64,181769
5761,0.000437,172.31.40.0-255,66,41559,64,181769
5762,0.000467,172.217.194.0-255,6797,48356,64,181769
5763,0.00047,172.31.40.0-255,66,48422,64,181769
5764,0.000473,172.217.194.0-255,1484,49906,64,181769
5765,0.000475,172.31.40.0-255,66,49972,64,181769
5766,0.000506,172.217.194.0-255,5738,55710,64,181769
5767,0.000509,172.31.40.0-255,66,55776,64,181769
5768,0.000523,172.217.194.0-255,7156,62932,64,181769
5769,0.000525,172.31.40.0-255,66,62998,64,181769
5770,0.000549,172.217.194.0-255,2801,65799,64,181769
5771,0.000552,172.31.40.0-255,66,65865,64,181769
5772,0.00064,172.217.194.0-255,117,65982,64,181769
5773,0.000673,172.217.194.0-255,377,66359,64,181769
5774,0.001447,172.217.194.0-255,1484,67843,64,181769
5775,0.001455,172.31.40.0-255,66,67909,64,181769
5776,0.001462,172.217.194.0-255,2902,70811,64,181769
5777,0.001464,172.31.40.0-255,66,70877,64,181769
5778,0.001475,172.217.194.0-255,5738,76615,64,181769
5779,0.001477,172.31.40.0-255,66,76681,64,181769
5780,0.001481,172.217.194.0-255,1484,78165,64,181769
5781,0.001524,172.31.40.0-255,66,78231,64,181769
5782,0.001537,172.31.40.0-255,66,78297,64,181769
5783,0.002474,172.217.194.0-255,1484,79781,64,181769
5784,0.002482,172.217.194.0-255,2902,82683,64,181769
5785,0.002487,172.31.40.0-255,66,82749,64,181769
5786,0.002519,172.217.194.0-255,5738,88487,64,181769
5787,0.002521,172.31.40.0-255,66,88553,64,181769
5788,0.002579,172.217.194.0-255,1484,90037,64,181769
5789,0.002593,172.217.194.0-255,2902,92939,64,181769
5790,0.002595,172.31.40.0-255,66,93005,64,181769
5791,0.002601,172.217.194.0-255,5738,98743,64,181769
5792,0.002604,172.31.40.0-255,66,98809,64,181769
5793,0.002614,172.217.194.0-255,2902,101711,64,181769
5794,0.002616,172.31.40.0-255,66,101777,64,181769
5795,0.002653,172.31.40.0-255,66,101843,64,181769
5796,0.002656,172.217.194.0-255,766,102609,64,181769
5797,0.002955,172.217.194.0-255,1484,104093,64,181769
5798,0.002957,172.31.40.0-255,66,104159,64,181769
5799,0.002985,172.217.194.0-255,2902,107061,64,181769
5800,0.002987,172.31.40.0-255,66,107127,64,181769
5801,0.003018,172.217.194.0-255,5738,112865,64,181769
5802,0.003021,172.31.40.0-255,66,112931,64,181769
5803,0.003059,172.31.40.0-255,66,112997,64,181769
5804,0.003085,172.217.194.0-255,5738,118735,64,181769
5805,0.003088,172.31.40.0-255,66,118801,64,181769
5806,0.003117,172.217.194.0-255,5020,123821,64,181769
5807,0.003119,172.31.40.0-255,66,123887,64,181769
5808,0.003184,172.217.194.0-255,1484,125371,64,181769
5809,0.003198,172.217.194.0-255,2902,128273,64,181769
5810,0.0032,172.31.40.0-255,66,128339,64,181769
5811,0.003205,172.217.194.0-255,4320,132659,64,181769
5812,0.003208,172.31.40.0-255,66,132725,64,181769
5813,0.00323,172.217.194.0-255,1484,134209,64,181769
5814,0.003248,172.31.40.0-255,66,134275,64,181769
5815,0.003297,172.31.40.0-255,66,134341,64,181769
5816,0.003336,172.217.194.0-255,1484,135825,64,181769
5817,0.003341,172.217.194.0-255,2902,138727,64,181769
5818,0.003343,172.31.40.0-255,66,138793,64,181769
5819,0.003364,172.217.194.0-255,5738,144531,64,181769
5820,0.003366,172.31.40.0-255,66,144597,64,181769
5821,0.003396,172.31.40.0-255,66,144663,64,181769
5822,0.003403,172.217.194.0-255,7156,151819,64,181769
5823,0.003405,172.31.40.0-255,66,151885,64,181769
5824,0.003429,172.217.194.0-255,2902,154787,64,181769
5825,0.003431,172.31.40.0-255,66,154853,64,181769
5826,0.00347,172.31.40.0-255,66,154919,64,181769
5827,0.00351,172.31.40.0-255,66,154985,64,181769
5828,0.003521,172.31.40.0-255,66,155051,64,181769
5829,0.003586,172.31.40.0-255,66,155117,64,181769
5830,0.003606,172.31.40.0-255,66,155183,64,181769
5831,0.003629,172.31.40.0-255,66,155249,64,181769
5832,0.003647,172.31.40.0-255,66,155315,64,181769
5833,0.003651,172.217.194.0-255,2184,157499,64,181769
5834,0.003653,172.31.40.0-255,66,157565,64,181769
5835,0.00368,172.217.194.0-255,5738,163303,64,181769
5836,0.003682,172.31.40.0-255,66,163369,64,181769
5837,0.00372,172.31.40.0-255,66,163435,64,181769
5838,0.003741,172.31.40.0-255,66,163501,64,181769
5839,0.003746,172.217.194.0-255,3602,167103,64,181769
5840,0.003748,172.31.40.0-255,66,167169,64,181769
5841,0.003827,172.217.194.0-255,4320,171489,64,181769
5842,0.003845,172.217.194.0-255,2771,174260,64,181769
5843,0.003848,172.217.194.0-255,105,174365,64,181769
5844,0.004193,172.31.40.0-255,66,174431,64,181769
5845,0.010005,172.31.40.0-255,105,174536,64,181769
5846,0.012504,172.217.194.0-255,66,174602,64,181769
5847,0.032509,172.31.40.0-255,172,174774,64,181769
5848,0.032537,172.31.40.0-255,1112,175886,64,181769
5849,0.032591,172.31.40.0-255,1514,177400,64,181769
5850,0.032593,172.31.40.0-255,1514,178914,64,181769
5851,0.032598,172.31.40.0-255,1514,180428,64,181769
5852,0.032599,172.31.40.0-255,1077,181505,64,181769
5853,0.034084,104.244.42.0-255,66,181571,64,181769
5854,0.034109,104.244.42.0-255,66,181637,64,181769
5855,0.034132,104.244.42.0-255,66,181703,64,181769
5856,0.03415,104.244.42.0-255,66,181769,64,181769
5857,0.0,74.125.24.0-255,153,153,64,249824
5858,2.1e-05,172.31.40.0-255,66,219,64,249824
5859,2.8e-05,74.125.24.0-255,1484,1703,64,249824
5860,3.2e-05,172.31.40.0-255,66,1769,64,249824
5861,4.9e-05,74.125.24.0-255,2902,4671,64,249824
5862,5.2e-05,172.31.40.0-255,66,4737,64,249824
5863,5.9e-05,74.125.24.0-255,5738,10475,64,249824
5864,6.1e-05,172.31.40.0-255,66,10541,64,249824
5865,7.9e-05,74.125.24.0-255,1484,12025,64,249824
5866,8.1e-05,172.31.40.0-255,66,12091,64,249824
5867,8.6e-05,74.125.24.0-255,2126,14217,64,249824
5868,8.8e-05,172.31.40.0-255,66,14283,64,249824
5869,0.001055,74.125.24.0-255,1484,15767,64,249824
5870,0.001063,172.31.40.0-255,66,15833,64,249824
5871,0.001073,74.125.24.0-255,2902,18735,64,249824
5872,0.001075,172.31.40.0-255,66,18801,64,249824
5873,0.001082,74.125.24.0-255,5738,24539,64,249824
5874,0.001085,172.31.40.0-255,66,24605,64,249824
5875,0.00109,74.125.24.0-255,2902,27507,64,249824
5876,0.001092,172.31.40.0-255,66,27573,64,249824
5877,0.001141,74.125.24.0-255,1484,29057,64,249824
5878,0.001144,172.31.40.0-255,66,29123,64,249824
5879,0.001171,172.31.40.0-255,66,29189,64,249824
5880,0.001182,172.31.40.0-255,66,29255,64,249824
5881,0.00121,74.125.24.0-255,2902,32157,64,249824
5882,0.001212,172.31.40.0-255,66,32223,64,249824
5883,0.001219,74.125.24.0-255,7156,39379,64,249824
5884,0.001222,172.31.40.0-255,66,39445,64,249824
5885,0.00124,74.125.24.0-255,4320,43765,64,249824
5886,0.001242,172.31.40.0-255,66,43831,64,249824
5887,0.001256,74.125.24.0-255,3602,47433,64,249824
5888,0.001258,172.31.40.0-255,66,47499,64,249824
5889,0.001785,74.125.24.0-255,646,48145,64,249824
5890,0.001965,74.125.24.0-255,1484,49629,64,249824
5891,0.001968,172.31.40.0-255,66,49695,64,249824
5892,0.001974,74.125.24.0-255,2902,52597,64,249824
5893,0.001976,172.31.40.0-255,66,52663,64,249824
5894,0.001999,74.125.24.0-255,5738,58401,64,249824
5895,0.002002,172.31.40.0-255,66,58467,64,249824
5896,0.002022,74.125.24.0-255,7156,65623,64,249824
5897,0.002025,172.31.40.0-255,66,65689,64,249824
5898,0.002046,74.125.24.0-255,2902,68591,64,249824
5899,0.002048,172.31.40.0-255,66,68657,64,249824
5900,0.002055,74.125.24.0-255,7156,75813,64,249824
5901,0.002058,172.31.40.0-255,66,75879,64,249824
5902,0.002074,74.125.24.0-255,6438,82317,64,249824
5903,0.002076,172.31.40.0-255,66,82383,64,249824
5904,0.002145,74.125.24.0-255,1484,83867,64,249824
5905,0.002172,74.125.24.0-255,2902,86769,64,249824
5906,0.002175,172.31.40.0-255,66,86835,64,249824
5907,0.002213,74.125.24.0-255,4320,91155,64,249824
5908,0.002216,172.31.40.0-255,66,91221,64,249824
5909,0.002233,74.125.24.0-255,1484,92705,64,249824
5910,0.002252,74.125.24.0-255,4320,97025,64,249824
5911,0.002254,172.31.40.0-255,66,97091,64,249824
5912,0.002329,74.125.24.0-255,1484,98575,64,249824
5913,0.002347,74.125.24.0-255,2902,101477,64,249824
5914,0.00235,172.31.40.0-255,66,101543,64,249824
5915,0.002353,74.125.24.0-255,1484,103027,64,249824
5916,0.002357,74.125.24.0-255,2902,105929,64,249824
5917,0.00236,172.31.40.0-255,66,105995,64,249824
5918,0.002386,74.125.24.0-255,5738,111733,64,249824
5919,0.002389,172.31.40.0-255,66,111799,64,249824
5920,0.002424,74.125.24.0-255,5020,116819,64,249824
5921,0.002427,172.31.40.0-255,66,116885,64,249824
5922,0.002588,74.125.24.0-255,1484,118369,64,249824
5923,0.002591,74.125.24.0-255,1484,119853,64,249824
5924,0.002593,172.31.40.0-255,66,119919,64,249824
5925,0.002609,74.125.24.0-255,1484,121403,64,249824
5926,0.002614,74.125.24.0-255,4320,125723,64,249824
5927,0.002617,172.31.40.0-255,66,125789,64,249824
5928,0.00526,74.125.24.0-255,5738,131527,64,249824
5929,0.005267,172.31.40.0-255,66,131593,64,249824
5930,0.007902,74.125.24.0-255,5738,137331,64,249824
5931,0.00791,172.31.40.0-255,66,137397,64,249824
5932,0.010565,74.125.24.0-255,5738,143135,64,249824
5933,0.010573,172.31.40.0-255,66,143201,64,249824
5934,0.013228,74.125.24.0-255,5738,148939,64,249824
5935,0.013238,172.31.40.0-255,66,149005,64,249824
5936,0.015852,74.125.24.0-255,5738,154743,64,249824
5937,0.01586,172.31.40.0-255,66,154809,64,249824
5938,0.018501,74.125.24.0-255,5738,160547,64,249824
5939,0.018511,172.31.40.0-255,66,160613,64,249824
5940,0.019952,172.31.40.0-255,172,160785,64,249824
5941,0.01998,172.31.40.0-255,1107,161892,64,249824
5942,0.020034,172.31.40.0-255,1514,163406,64,249824
5943,0.020035,172.31.40.0-255,338,163744,64,249824
5944,0.021122,74.125.24.0-255,5738,169482,64,249824
5945,0.021129,172.31.40.0-255,66,169548,64,249824
5946,0.02147,104.244.42.0-255,66,169614,64,249824
5947,0.021528,104.244.42.0-255,66,169680,64,249824
5948,0.021619,104.244.42.0-255,66,169746,64,249824
5949,0.022338,104.244.42.0-255,108,169854,64,249824
5950,0.022344,172.31.40.0-255,66,169920,64,249824
5951,0.023727,74.125.24.0-255,5738,175658,64,249824
5952,0.023733,172.31.40.0-255,66,175724,64,249824
5953,0.026348,74.125.24.0-255,5738,181462,64,249824
5954,0.026353,172.31.40.0-255,66,181528,64,249824
5955,0.028975,74.125.24.0-255,5738,187266,64,249824
5956,0.028981,172.31.40.0-255,66,187332,64,249824
5957,0.031594,74.125.24.0-255,5738,193070,64,249824
5958,0.0316,172.31.40.0-255,66,193136,64,249824
5959,0.034209,74.125.24.0-255,5738,198874,64,249824
5960,0.034215,172.31.40.0-255,66,198940,64,249824
5961,0.036846,74.125.24.0-255,5738,204678,64,249824
5962,0.036852,172.31.40.0-255,66,204744,64,249824
5963,0.039491,74.125.24.0-255,5738,210482,64,249824
5964,0.0395,172.31.40.0-255,66,210548,64,249824
5965,0.042133,74.125.24.0-255,5738,216286,64,249824
5966,0.042139,172.31.40.0-255,66,216352,64,249824
5967,0.044765,74.125.24.0-255,5738,222090,64,249824
5968,0.044772,172.31.40.0-255,66,222156,64,249824
5969,0.047399,74.125.24.0-255,4320,226476,64,249824
5970,0.047404,172.31.40.0-255,66,226542,64,249824
5971,0.047421,74.125.24.0-255,1484,228026,64,249824
5972,0.050013,74.125.24.0-255,4320,232346,64,249824
5973,0.05002,172.31.40.0-255,66,232412,64,249824
5974,0.052654,74.125.24.0-255,5738,238150,64,249824
5975,0.05266,172.31.40.0-255,66,238216,64,249824
5976,0.055303,74.125.24.0-255,5738,243954,64,249824
5977,0.055319,172.31.40.0-255,66,244020,64,249824
5978,0.057944,74.125.24.0-255,5738,249758,64,249824
5979,0.057951,172.31.40.0-255,66,249824,64,249824
5980,0.0,172.217.194.0-255,152,152,64,253967
5981,1.4e-05,172.31.40.0-255,66,218,64,253967
5982,2.1e-05,172.217.194.0-255,1484,1702,64,253967
5983,2.5e-05,172.31.40.0-255,66,1768,64,253967
5984,3.2e-05,172.217.194.0-255,2902,4670,64,253967
5985,3.7e-05,172.31.40.0-255,66,4736,64,253967
5986,4.4e-05,172.217.194.0-255,7156,11892,64,253967
5987,4.7e-05,172.31.40.0-255,66,11958,64,253967
5988,7.6e-05,172.217.194.0-255,4866,16824,64,253967
5989,7.8e-05,172.31.40.0-255,66,16890,64,253967
5990,9.2e-05,172.217.194.0-255,4320,21210,64,253967
5991,9.5e-05,172.31.40.0-255,66,21276,64,253967
5992,0.00013,172.31.40.0-255,66,21342,64,253967
5993,0.000162,172.217.194.0-255,1484,22826,64,253967
5994,0.000164,172.31.40.0-255,66,22892,64,253967
5995,0.000169,172.217.194.0-255,2902,25794,64,253967
5996,0.000172,172.31.40.0-255,66,25860,64,253967
5997,0.00019,172.217.194.0-255,5738,31598,64,253967
5998,0.000193,172.31.40.0-255,66,31664,64,253967
5999,0.000219,172.217.194.0-255,7156,38820,64,253967
6000,0.000222,172.31.40.0-255,66,38886,64,253967
6001,0.000242,172.217.194.0-255,2543,41429,64,253967
6002,0.000245,172.31.40.0-255,66,41495,64,253967
6003,0.000262,172.217.194.0-255,4320,45815,64,253967
6004,0.000265,172.31.40.0-255,66,45881,64,253967
6005,0.000294,172.31.40.0-255,66,45947,64,253967
6006,0.000297,172.217.194.0-255,99,46046,64,253967
6007,0.000299,172.31.40.0-255,66,46112,64,253967
6008,0.000356,172.217.194.0-255,1484,47596,64,253967
6009,0.000359,172.31.40.0-255,66,47662,64,253967
6010,0.000365,172.217.194.0-255,2902,50564,64,253967
6011,0.000367,172.31.40.0-255,66,50630,64,253967
6012,0.000381,172.217.194.0-255,4320,54950,64,253967
6013,0.000384,172.31.40.0-255,66,55016,64,253967
6014,0.000401,172.217.194.0-255,1484,56500,64,253967
6015,0.000409,172.217.194.0-255,7156,63656,64,253967
6016,0.000412,172.31.40.0-255,66,63722,64,253967
6017,0.000438,172.217.194.0-255,6797,70519,64,253967
6018,0.000441,172.31.40.0-255,66,70585,64,253967
6019,0.000452,172.31.40.0-255,66,70651,64,253967
6020,0.00125,172.217.194.0-255,1484,72135,64,253967
6021,0.001257,172.217.194.0-255,2902,75037,64,253967
6022,0.001261,172.31.40.0-255,66,75103,64,253967
6023,0.001265,172.217.194.0-255,1484,76587,64,253967
6024,0.001286,172.217.194.0-255,4320,80907,64,253967
6025,0.001289,172.31.40.0-255,66,80973,64,253967
6026,0.001295,172.217.194.0-255,5738,86711,64,253967
6027,0.001297,172.31.40.0-255,66,86777,64,253967
6028,0.001301,172.217.194.0-255,2902,89679,64,253967
6029,0.001303,172.31.40.0-255,66,89745,64,253967
6030,0.001346,172.31.40.0-255,66,89811,64,253967
6031,0.001353,172.217.194.0-255,5020,94831,64,253967
6032,0.001355,172.31.40.0-255,66,94897,64,253967
6033,0.001402,172.217.194.0-255,1484,96381,64,253967
6034,0.001407,172.217.194.0-255,2902,99283,64,253967
6035,0.00141,172.31.40.0-255,66,99349,64,253967
6036,0.001416,172.217.194.0-255,5738,105087,64,253967
6037,0.001418,172.31.40.0-255,66,105153,64,253967
6038,0.001433,172.217.194.0-255,2902,108055,64,253967
6039,0.001436,172.31.40.0-255,66,108121,64,253967
6040,0.001451,172.217.194.0-255,7156,115277,64,253967
6041,0.001455,172.31.40.0-255,66,115343,64,253967
6042,0.001492,172.217.194.0-255,2902,118245,64,253967
6043,0.001495,172.31.40.0-255,66,118311,64,253967
6044,0.001522,172.31.40.0-255,66,118377,64,253967
6045,0.001546,172.217.194.0-255,2184,120561,64,253967
6046,0.001549,172.31.40.0-255,66,120627,64,253967
6047,0.001557,172.217.194.0-255,7156,127783,64,253967
6048,0.001559,172.31.40.0-255,66,127849,64,253967
6049,0.001569,172.31.40.0-255,66,127915,64,253967
6050,0.001604,172.31.40.0-255,66,127981,64,253967
6051,0.001607,172.217.194.0-255,766,128747,64,253967
6052,0.001647,172.217.194.0-255,5738,134485,64,253967
6053,0.00165,172.31.40.0-255,66,134551,64,253967
6054,0.001677,172.217.194.0-255,7156,141707,64,253967
6055,0.001681,172.31.40.0-255,66,141773,64,253967
6056,0.001695,172.31.40.0-255,66,141839,64,253967
6057,0.001725,172.217.194.0-255,6737,148576,64,253967
6058,0.001727,172.31.40.0-255,66,148642,64,253967
6059,0.001861,172.217.194.0-255,1484,150126,64,253967
6060,0.001879,172.217.194.0-255,2902,153028,64,253967
6061,0.001883,172.31.40.0-255,66,153094,64,253967
6062,0.001889,172.217.194.0-255,4320,157414,64,253967
6063,0.001891,172.31.40.0-255,66,157480,64,253967
6064,0.001926,172.217.194.0-255,4320,161800,64,253967
6065,0.001929,172.31.40.0-255,66,161866,64,253967
6066,0.001974,172.217.194.0-255,4320,166186,64,253967
6067,0.001978,172.31.40.0-255,66,166252,64,253967
6068,0.00199,172.31.40.0-255,66,166318,64,253967
6069,0.001994,172.217.194.0-255,2902,169220,64,253967
6070,0.001996,172.31.40.0-255,66,169286,64,253967
6071,0.002027,172.217.194.0-255,5020,174306,64,253967
6072,0.002031,172.31.40.0-255,66,174372,64,253967
6073,0.002337,172.217.194.0-255,1484,175856,64,253967
6074,0.002344,172.217.194.0-255,2902,178758,64,253967
6075,0.002347,172.31.40.0-255,66,178824,64,253967
6076,0.002367,172.217.194.0-255,4320,183144,64,253967
6077,0.00237,172.31.40.0-255,66,183210,64,253967
6078,0.002394,172.217.194.0-255,1484,184694,64,253967
6079,0.0024,172.217.194.0-255,2902,187596,64,253967
6080,0.002402,172.31.40.0-255,66,187662,64,253967
6081,0.002405,172.217.194.0-255,1484,189146,64,253967
6082,0.002411,172.217.194.0-255,4320,193466,64,253967
6083,0.002413,172.31.40.0-255,66,193532,64,253967
6084,0.002428,172.217.194.0-255,1484,195016,64,253967
6085,0.002431,172.217.194.0-255,1484,196500,64,253967
6086,0.002433,172.31.40.0-255,66,196566,64,253967
6087,0.002436,172.217.194.0-255,1484,198050,64,253967
6088,0.002449,172.217.194.0-255,2902,200952,64,253967
6089,0.002451,172.31.40.0-255,66,201018,64,253967
6090,0.002478,172.217.194.0-255,5738,206756,64,253967
6091,0.002481,172.31.40.0-255,66,206822,64,253967
6092,0.002501,172.217.194.0-255,2184,209006,64,253967
6093,0.002504,172.31.40.0-255,66,209072,64,253967
6094,0.002598,172.217.194.0-255,1484,210556,64,253967
6095,0.002602,172.217.194.0-255,1484,212040,64,253967
6096,0.002605,172.31.40.0-255,66,212106,64,253967
6097,0.002632,172.217.194.0-255,4320,216426,64,253967
6098,0.002635,172.31.40.0-255,66,216492,64,253967
6099,0.002638,172.217.194.0-255,1484,217976,64,253967
6100,0.00267,172.31.40.0-255,66,218042,64,253967
6101,0.002725,172.217.194.0-255,1484,219526,64,253967
6102,0.002741,172.217.194.0-255,5020,224546,64,253967
6103,0.002746,172.31.40.0-255,66,224612,64,253967
6104,0.002754,172.31.40.0-255,66,224678,64,253967
6105,0.00276,172.217.194.0-255,5738,230416,64,253967
6106,0.002763,172.31.40.0-255,66,230482,64,253967
6107,0.002797,172.31.40.0-255,66,230548,64,253967
6108,0.00281,172.31.40.0-255,66,230614,64,253967
6109,0.002821,172.31.40.0-255,66,230680,64,253967
6110,0.002827,172.217.194.0-255,4320,235000,64,253967
6111,0.002829,172.31.40.0-255,66,235066,64,253967
6112,0.002856,172.217.194.0-255,5738,240804,64,253967
6113,0.002859,172.31.40.0-255,66,240870,64,253967
6114,0.002862,172.217.194.0-255,1484,242354,64,253967
6115,0.002893,172.31.40.0-255,66,242420,64,253967
6116,0.002908,172.217.194.0-255,1484,243904,64,253967
6117,0.002929,172.217.194.0-255,5324,249228,64,253967
6118,0.002932,172.31.40.0-255,66,249294,64,253967
6119,0.003014,172.217.194.0-255,105,249399,64,253967
6120,0.013197,172.31.40.0-255,66,249465,64,253967
6121,0.013252,172.31.40.0-255,105,249570,64,253967
6122,0.015521,172.217.194.0-255,66,249636,64,253967
6123,0.055536,172.31.40.0-255,171,249807,64,253967
6124,0.055569,172.31.40.0-255,1136,250943,64,253967
6125,0.055632,172.31.40.0-255,1514,252457,64,253967
6126,0.055634,172.31.40.0-255,1312,253769,64,253967
6127,0.057082,104.244.42.0-255,66,253835,64,253967
6128,0.057114,104.244.42.0-255,66,253901,64,253967
6129,0.057222,104.244.42.0-255,66,253967,64,253967
6130,0.0,74.125.24.0-255,156,156,64,328639
6131,1.6e-05,172.31.40.0-255,66,222,64,328639
6132,2.3e-05,74.125.24.0-255,1484,1706,64,328639
6133,2.8e-05,172.31.40.0-255,66,1772,64,328639
6134,4.6e-05,74.125.24.0-255,1484,3256,64,328639
6135,4.9e-05,172.31.40.0-255,66,3322,64,328639
6136,6.9e-05,74.125.24.0-255,1484,4806,64,328639
6137,7.1e-05,172.31.40.0-255,66,4872,64,328639
6138,8.8e-05,74.125.24.0-255,4320,9192,64,328639
6139,9.2e-05,172.31.40.0-255,66,9258,64,328639
6140,0.000128,74.125.24.0-255,4954,14212,64,328639
6141,0.000131,172.31.40.0-255,66,14278,64,328639
6142,0.000149,74.125.24.0-255,2902,17180,64,328639
6143,0.000152,172.31.40.0-255,66,17246,64,328639
6144,0.000178,74.125.24.0-255,2902,20148,64,328639
6145,0.000181,172.31.40.0-255,66,20214,64,328639
6146,0.000189,74.125.24.0-255,7156,27370,64,328639
6147,0.000191,172.31.40.0-255,66,27436,64,328639
6148,0.000228,74.125.24.0-255,3961,31397,64,328639
6149,0.000231,172.31.40.0-255,66,31463,64,328639
6150,0.000252,74.125.24.0-255,1484,32947,64,328639
6151,0.000255,172.31.40.0-255,66,33013,64,328639
6152,0.000258,74.125.24.0-255,1484,34497,64,328639
6153,0.00026,172.31.40.0-255,66,34563,64,328639
6154,0.000277,74.125.24.0-255,1484,36047,64,328639
6155,0.000279,172.31.40.0-255,66,36113,64,328639
6156,0.000285,74.125.24.0-255,5738,41851,64,328639
6157,0.000288,172.31.40.0-255,66,41917,64,328639
6158,0.00029,74.125.24.0-255,1484,43401,64,328639
6159,0.000293,172.31.40.0-255,66,43467,64,328639
6160,0.000317,74.125.24.0-255,5379,48846,64,328639
6161,0.000319,172.31.40.0-255,66,48912,64,328639
6162,0.000334,172.31.40.0-255,66,48978,64,328639
6163,0.00036,74.125.24.0-255,3961,52939,64,328639
6164,0.000363,172.31.40.0-255,66,53005,64,328639
6165,0.000366,74.125.24.0-255,393,53398,64,328639
6166,0.0008,74.125.24.0-255,113,53511,64,328639
6167,0.000845,74.125.24.0-255,1484,54995,64,328639
6168,0.00085,172.31.40.0-255,66,55061,64,328639
6169,0.000864,74.125.24.0-255,2902,57963,64,328639
6170,0.000867,172.31.40.0-255,66,58029,64,328639
6171,0.000891,74.125.24.0-255,4320,62349,64,328639
6172,0.000893,172.31.40.0-255,66,62415,64,328639
6173,0.000912,74.125.24.0-255,1484,63899,64,328639
6174,0.000919,74.125.24.0-255,7156,71055,64,328639
6175,0.000922,172.31.40.0-255,66,71121,64,328639
6176,0.000946,74.125.24.0-255,5738,76859,64,328639
6177,0.000949,172.31.40.0-255,66,76925,64,328639
6178,0.000962,172.31.40.0-255,66,76991,64,328639
6179,0.000964,74.125.24.0-255,333,77324,64,328639
6180,0.001288,74.125.24.0-255,1484,78808,64,328639
6181,0.001293,172.31.40.0-255,66,78874,64,328639
6182,0.001298,74.125.24.0-255,2902,81776,64,328639
6183,0.0013,172.31.40.0-255,66,81842,64,328639
6184,0.001304,74.125.24.0-255,2902,84744,64,328639
6185,0.001307,172.31.40.0-255,66,84810,64,328639
6186,0.001323,74.125.24.0-255,2902,87712,64,328639
6187,0.001325,172.31.40.0-255,66,87778,64,328639
6188,0.001336,172.31.40.0-255,66,87844,64,328639
6189,0.001357,74.125.24.0-255,4320,92164,64,328639
6190,0.001359,172.31.40.0-255,66,92230,64,328639
6191,0.001382,74.125.24.0-255,1484,93714,64,328639
6192,0.001394,74.125.24.0-255,2902,96616,64,328639
6193,0.001397,172.31.40.0-255,66,96682,64,328639
6194,0.00142,74.125.24.0-255,6438,103120,64,328639
6195,0.001424,172.31.40.0-255,66,103186,64,328639
6196,0.001639,74.125.24.0-255,1484,104670,64,328639
6197,0.001644,74.125.24.0-255,2902,107572,64,328639
6198,0.001647,172.31.40.0-255,66,107638,64,328639
6199,0.001673,74.125.24.0-255,4320,111958,64,328639
6200,0.001675,172.31.40.0-255,66,112024,64,328639
6201,0.001687,74.125.24.0-255,1484,113508,64,328639
6202,0.001692,74.125.24.0-255,4320,117828,64,328639
6203,0.001695,172.31.40.0-255,66,117894,64,328639
6204,0.00173,172.31.40.0-255,66,117960,64,328639
6205,0.001739,172.31.40.0-255,66,118026,64,328639
6206,0.001776,74.125.24.0-255,2184,120210,64,328639
6207,0.001778,172.31.40.0-255,66,120276,64,328639
6208,0.00185,74.125.24.0-255,2902,123178,64,328639
6209,0.001853,172.31.40.0-255,66,123244,64,328639
6210,0.001857,74.125.24.0-255,1484,124728,64,328639
6211,0.001863,74.125.24.0-255,5738,130466,64,328639
6212,0.001865,172.31.40.0-255,66,130532,64,328639
6213,0.00189,74.125.24.0-255,7156,137688,64,328639
6214,0.001892,172.31.40.0-255,66,137754,64,328639
6215,0.001914,74.125.24.0-255,5738,143492,64,328639
6216,0.001917,172.31.40.0-255,66,143558,64,328639
6217,0.001922,74.125.24.0-255,2902,146460,64,328639
6218,0.001924,172.31.40.0-255,66,146526,64,328639
6219,0.001937,74.125.24.0-255,1484,148010,64,328639
6220,0.001953,74.125.24.0-255,2902,150912,64,328639
6221,0.001956,172.31.40.0-255,66,150978,64,328639
6222,0.00197,74.125.24.0-255,3602,154580,64,328639
6223,0.001972,172.31.40.0-255,66,154646,64,328639
6224,0.002112,74.125.24.0-255,1484,156130,64,328639
6225,0.002116,74.125.24.0-255,2902,159032,64,328639
6226,0.002119,172.31.40.0-255,66,159098,64,328639
6227,0.002134,74.125.24.0-255,1484,160582,64,328639
6228,0.002146,74.125.24.0-255,2902,163484,64,328639
6229,0.002148,172.31.40.0-255,66,163550,64,328639
6230,0.002165,74.125.24.0-255,1484,165034,64,328639
6231,0.002169,74.125.24.0-255,2902,167936,64,328639
6232,0.002172,172.31.40.0-255,66,168002,64,328639
6233,0.002199,172.31.40.0-255,66,168068,64,328639
6234,0.002231,74.125.24.0-255,2902,170970,64,328639
6235,0.002234,172.31.40.0-255,66,171036,64,328639
6236,0.002264,172.31.40.0-255,66,171102,64,328639
6237,0.00228,74.125.24.0-255,1484,172586,64,328639
6238,0.002295,74.125.24.0-255,2902,175488,64,328639
6239,0.002297,172.31.40.0-255,66,175554,64,328639
6240,0.0023,74.125.24.0-255,1484,177038,64,328639
6241,0.002317,74.125.24.0-255,2902,179940,64,328639
6242,0.00232,172.31.40.0-255,66,180006,64,328639
6243,0.002335,172.31.40.0-255,66,180072,64,328639
6244,0.002358,74.125.24.0-255,4320,184392,64,328639
6245,0.002361,172.31.40.0-255,66,184458,64,328639
6246,0.002391,172.31.40.0-255,66,184524,64,328639
6247,0.002624,74.125.24.0-255,1484,186008,64,328639
6248,0.002629,74.125.24.0-255,2902,188910,64,328639
6249,0.002633,172.31.40.0-255,66,188976,64,328639
6250,0.002636,74.125.24.0-255,1484,190460,64,328639
6251,0.002656,74.125.24.0-255,4320,194780,64,328639
6252,0.002659,172.31.40.0-255,66,194846,64,328639
6253,0.005172,74.125.24.0-255,5738,200584,64,328639
6254,0.005187,172.31.40.0-255,66,200650,64,328639
6255,0.007549,74.125.24.0-255,4320,204970,64,328639
6256,0.007554,172.31.40.0-255,66,205036,64,328639
6257,0.007567,74.125.24.0-255,1484,206520,64,328639
6258,0.009888,74.125.24.0-255,4320,210840,64,328639
6259,0.009903,172.31.40.0-255,66,210906,64,328639
6260,0.012336,74.125.24.0-255,5738,216644,64,328639
6261,0.012351,172.31.40.0-255,66,216710,64,328639
6262,0.014656,74.125.24.0-255,5738,222448,64,328639
6263,0.014664,172.31.40.0-255,66,222514,64,328639
6264,0.017031,74.125.24.0-255,5738,228252,64,328639
6265,0.017038,172.31.40.0-255,66,228318,64,328639
6266,0.019478,74.125.24.0-255,5738,234056,64,328639
6267,0.019485,172.31.40.0-255,66,234122,64,328639
6268,0.021814,74.125.24.0-255,5738,239860,64,328639
6269,0.021822,172.31.40.0-255,66,239926,64,328639
6270,0.024153,74.125.24.0-255,5738,245664,64,328639
6271,0.024161,172.31.40.0-255,66,245730,64,328639
6272,0.026515,74.125.24.0-255,5738,251468,64,328639
6273,0.026522,172.31.40.0-255,66,251534,64,328639
6274,0.028894,74.125.24.0-255,5738,257272,64,328639
6275,0.028903,172.31.40.0-255,66,257338,64,328639
6276,0.031455,74.125.24.0-255,5738,263076,64,328639
6277,0.031463,172.31.40.0-255,66,263142,64,328639
6278,0.033921,74.125.24.0-255,5738,268880,64,328639
6279,0.033929,172.31.40.0-255,66,268946,64,328639
6280,0.036264,74.125.24.0-255,4320,273266,64,328639
6281,0.036273,172.31.40.0-255,66,273332,64,328639
6282,0.036292,74.125.24.0-255,1484,274816,64,328639
6283,0.03862,74.125.24.0-255,4320,279136,64,328639
6284,0.038627,172.31.40.0-255,66,279202,64,328639
6285,0.038671,172.31.40.0-255,171,279373,64,328639
6286,0.038697,172.31.40.0-255,1131,280504,64,328639
6287,0.038794,172.31.40.0-255,1514,282018,64,328639
6288,0.038796,172.31.40.0-255,1277,283295,64,328639
6289,0.040232,104.244.42.0-255,66,283361,64,328639
6290,0.040241,104.244.42.0-255,66,283427,64,328639
6291,0.040376,104.244.42.0-255,66,283493,64,328639
6292,0.040989,74.125.24.0-255,5738,289231,64,328639
6293,0.040996,172.31.40.0-255,66,289297,64,328639
6294,0.04335,74.125.24.0-255,1484,290781,64,328639
6295,0.04337,74.125.24.0-255,2902,293683,64,328639
6296,0.043375,172.31.40.0-255,66,293749,64,328639
6297,0.043397,74.125.24.0-255,1484,295233,64,328639
6298,0.045776,74.125.24.0-255,4320,299553,64,328639
6299,0.045783,172.31.40.0-255,66,299619,64,328639
6300,0.048123,74.125.24.0-255,5738,305357,64,328639
6301,0.048129,172.31.40.0-255,66,305423,64,328639
6302,0.050519,74.125.24.0-255,5738,311161,64,328639
6303,0.050525,172.31.40.0-255,66,311227,64,328639
6304,0.052936,74.125.24.0-255,5738,316965,64,328639
6305,0.052942,172.31.40.0-255,66,317031,64,328639
6306,0.055318,74.125.24.0-255,5738,322769,64,328639
6307,0.055324,172.31.40.0-255,66,322835,64,328639
6308,0.05772,74.125.24.0-255,5738,328573,64,328639
6309,0.057726,172.31.40.0-255,66,328639,64,328639
6310,0.0,172.217.194.0-255,153,153,64,304145
6311,2.2e-05,172.31.40.0-255,66,219,64,304145
6312,2.9e-05,172.217.194.0-255,1484,1703,64,304145
6313,3.4e-05,172.31.40.0-255,66,1769,64,304145
6314,3.8e-05,172.217.194.0-255,1484,3253,64,304145
6315,4.1e-05,172.31.40.0-255,66,3319,64,304145
6316,4.8e-05,172.217.194.0-255,2902,6221,64,304145
6317,5.1e-05,172.31.40.0-255,66,6287,64,304145
6318,5.7e-05,172.217.194.0-255,5738,12025,64,304145
6319,6e-05,172.31.40.0-255,66,12091,64,304145
6320,8.6e-05,172.217.194.0-255,7156,19247,64,304145
6321,8.9e-05,172.31.40.0-255,66,19313,64,304145
6322,0.00011,172.217.194.0-255,3484,22797,64,304145
6323,0.000112,172.31.40.0-255,66,22863,64,304145
6324,0.000137,172.217.194.0-255,5738,28601,64,304145
6325,0.00014,172.31.40.0-255,66,28667,64,304145
6326,0.00016,172.217.194.0-255,2543,31210,64,304145
6327,0.000163,172.31.40.0-255,66,31276,64,304145
6328,0.000221,172.217.194.0-255,1484,32760,64,304145
6329,0.000223,172.31.40.0-255,66,32826,64,304145
6330,0.000229,172.217.194.0-255,2902,35728,64,304145
6331,0.000231,172.31.40.0-255,66,35794,64,304145
6332,0.000244,172.217.194.0-255,1484,37278,64,304145
6333,0.000246,172.31.40.0-255,66,37344,64,304145
6334,0.000272,172.217.194.0-255,4320,41664,64,304145
6335,0.000275,172.31.40.0-255,66,41730,64,304145
6336,0.000289,172.31.40.0-255,66,41796,64,304145
6337,0.000312,172.217.194.0-255,2543,44339,64,304145
6338,0.000315,172.31.40.0-255,66,44405,64,304145
6339,0.000327,172.31.40.0-255,66,44471,64,304145
6340,0.000329,172.217.194.0-255,1125,45596,64,304145
6341,0.000575,172.217.194.0-255,364,45960,64,304145
6342,0.000634,172.217.194.0-255,1484,47444,64,304145
6343,0.00064,172.31.40.0-255,66,47510,64,304145
6344,0.000651,172.217.194.0-255,2902,50412,64,304145
6345,0.000655,172.31.40.0-255,66,50478,64,304145
6346,0.000667,172.217.194.0-255,5738,56216,64,304145
6347,0.000669,172.31.40.0-255,66,56282,64,304145
6348,0.000706,172.217.194.0-255,6797,63079,64,304145
6349,0.00071,172.31.40.0-255,66,63145,64,304145
6350,0.000718,172.217.194.0-255,7156,70301,64,304145
6351,0.00072,172.31.40.0-255,66,70367,64,304145
6352,0.000748,172.217.194.0-255,5738,76105,64,304145
6353,0.000751,172.31.40.0-255,66,76171,64,304145
6354,0.000773,172.217.194.0-255,3961,80132,64,304145
6355,0.000779,172.31.40.0-255,66,80198,64,304145
6356,0.000829,172.217.194.0-255,381,80579,64,304145
6357,0.001394,172.217.194.0-255,1484,82063,64,304145
6358,0.001399,172.217.194.0-255,2902,84965,64,304145
6359,0.001404,172.31.40.0-255,66,85031,64,304145
6360,0.001407,172.31.40.0-255,66,85097,64,304145
6361,0.001427,172.217.194.0-255,5738,90835,64,304145
6362,0.00143,172.31.40.0-255,66,90901,64,304145
6363,0.001436,172.217.194.0-255,5738,96639,64,304145
6364,0.001438,172.31.40.0-255,66,96705,64,304145
6365,0.001464,172.217.194.0-255,7156,103861,64,304145
6366,0.001467,172.31.40.0-255,66,103927,64,304145
6367,0.001506,172.31.40.0-255,66,103993,64,304145
6368,0.001542,172.217.194.0-255,7156,111149,64,304145
6369,0.001545,172.31.40.0-255,66,111215,64,304145
6370,0.001562,172.217.194.0-255,4320,115535,64,304145
6371,0.001564,172.31.40.0-255,66,115601,64,304145
6372,0.001571,172.217.194.0-255,7156,122757,64,304145
6373,0.001573,172.31.40.0-255,66,122823,64,304145
6374,0.001576,172.217.194.0-255,1484,124307,64,304145
6375,0.001605,172.31.40.0-255,66,124373,64,304145
6376,0.001771,172.217.194.0-255,1484,125857,64,304145
6377,0.001776,172.217.194.0-255,1484,127341,64,304145
6378,0.00178,172.31.40.0-255,66,127407,64,304145
6379,0.001801,172.217.194.0-255,1484,128891,64,304145
6380,0.001807,172.217.194.0-255,5738,134629,64,304145
6381,0.001809,172.31.40.0-255,66,134695,64,304145
6382,0.00182,172.31.40.0-255,66,134761,64,304145
6383,0.001842,172.217.194.0-255,4320,139081,64,304145
6384,0.001845,172.31.40.0-255,66,139147,64,304145
6385,0.001856,172.31.40.0-255,66,139213,64,304145
6386,0.001878,172.217.194.0-255,766,139979,64,304145
6387,0.002424,172.31.40.0-255,66,140045,64,304145
6388,0.003874,172.217.194.0-255,4320,144365,64,304145
6389,0.003881,172.31.40.0-255,66,144431,64,304145
6390,0.004373,172.217.194.0-255,1484,145915,64,304145
6391,0.005859,172.217.194.0-255,4320,150235,64,304145
6392,0.005865,172.31.40.0-255,66,150301,64,304145
6393,0.00792,172.217.194.0-255,5738,156039,64,304145
6394,0.007926,172.31.40.0-255,66,156105,64,304145
6395,0.009937,172.217.194.0-255,5738,161843,64,304145
6396,0.009944,172.31.40.0-255,66,161909,64,304145
6397,0.011985,172.217.194.0-255,5738,167647,64,304145
6398,0.011993,172.31.40.0-255,66,167713,64,304145
6399,0.014036,172.217.194.0-255,5738,173451,64,304145
6400,0.014043,172.31.40.0-255,66,173517,64,304145
6401,0.016023,172.217.194.0-255,5738,179255,64,304145
6402,0.016032,172.31.40.0-255,66,179321,64,304145
6403,0.017999,172.217.194.0-255,5738,185059,64,304145
6404,0.018008,172.31.40.0-255,66,185125,64,304145
6405,0.020029,172.217.194.0-255,5738,190863,64,304145
6406,0.020036,172.31.40.0-255,66,190929,64,304145
6407,0.022007,172.217.194.0-255,5738,196667,64,304145
6408,0.022022,172.31.40.0-255,66,196733,64,304145
6409,0.024044,172.217.194.0-255,5738,202471,64,304145
6410,0.024058,172.31.40.0-255,66,202537,64,304145
6411,0.026087,172.217.194.0-255,5738,208275,64,304145
6412,0.026099,172.31.40.0-255,66,208341,64,304145
6413,0.028124,172.217.194.0-255,5738,214079,64,304145
6414,0.028135,172.31.40.0-255,66,214145,64,304145
6415,0.03011,172.217.194.0-255,5738,219883,64,304145
6416,0.030117,172.31.40.0-255,66,219949,64,304145
6417,0.032159,172.217.194.0-255,5738,225687,64,304145
6418,0.032173,172.31.40.0-255,66,225753,64,304145
6419,0.034156,172.217.194.0-255,5738,231491,64,304145
6420,0.034165,172.31.40.0-255,66,231557,64,304145
6421,0.036168,172.217.194.0-255,5738,237295,64,304145
6422,0.036185,172.31.40.0-255,66,237361,64,304145
6423,0.03816,172.217.194.0-255,5738,243099,64,304145
6424,0.038168,172.31.40.0-255,66,243165,64,304145
6425,0.040195,172.217.194.0-255,5738,248903,64,304145
6426,0.040207,172.31.40.0-255,66,248969,64,304145
6427,0.042171,172.217.194.0-255,5738,254707,64,304145
6428,0.042179,172.31.40.0-255,66,254773,64,304145
6429,0.043922,172.31.40.0-255,172,254945,64,304145
6430,0.043954,172.31.40.0-255,1112,256057,64,304145
6431,0.044014,172.31.40.0-255,1514,257571,64,304145
6432,0.044016,172.31.40.0-255,1296,258867,64,304145
6433,0.04419,172.217.194.0-255,5738,264605,64,304145
6434,0.044201,172.31.40.0-255,66,264671,64,304145
6435,0.045497,104.244.42.0-255,66,264737,64,304145
6436,0.04558,104.244.42.0-255,66,264803,64,304145
6437,0.045584,104.244.42.0-255,66,264869,64,304145
6438,0.046239,172.217.194.0-255,5738,270607,64,304145
6439,0.04625,172.31.40.0-255,66,270673,64,304145
6440,0.048233,172.217.194.0-255,4320,274993,64,304145
6441,0.048242,172.31.40.0-255,66,275059,64,304145
6442,0.048265,172.217.194.0-255,1484,276543,64,304145
6443,0.050247,172.217.194.0-255,4320,280863,64,304145
6444,0.050263,172.31.40.0-255,66,280929,64,304145
6445,0.052261,172.217.194.0-255,5738,286667,64,304145
6446,0.052278,172.31.40.0-255,66,286733,64,304145
6447,0.054353,172.217.194.0-255,5738,292471,64,304145
6448,0.054367,172.31.40.0-255,66,292537,64,304145
6449,0.056384,172.217.194.0-255,5738,298275,64,304145
6450,0.056395,172.31.40.0-255,66,298341,64,304145
6451,0.058384,172.217.194.0-255,5738,304079,64,304145
6452,0.058398,172.31.40.0-255,66,304145,64,304145
6453,0.0,172.217.194.0-255,156,156,64,85850
6454,2.2e-05,172.31.40.0-255,66,222,64,85850
6455,2.9e-05,172.217.194.0-255,1484,1706,64,85850
6456,3.3e-05,172.31.40.0-255,66,1772,64,85850
6457,3.8e-05,172.217.194.0-255,2902,4674,64,85850
6458,4.2e-05,172.31.40.0-255,66,4740,64,85850
6459,5e-05,172.217.194.0-255,7156,11896,64,85850
6460,5.4e-05,172.31.40.0-255,66,11962,64,85850
6461,0.000109,172.217.194.0-255,5738,17700,64,85850
6462,0.000112,172.31.40.0-255,66,17766,64,85850
6463,0.000144,172.31.40.0-255,66,17832,64,85850
6464,0.000259,172.217.194.0-255,4320,22152,64,85850
6465,0.000263,172.31.40.0-255,66,22218,64,85850
6466,0.000308,172.31.40.0-255,66,22284,64,85850
6467,0.000436,172.31.40.0-255,66,22350,64,85850
6468,0.00046,172.217.194.0-255,6797,29147,64,85850
6469,0.000463,172.31.40.0-255,66,29213,64,85850
6470,0.00058,172.217.194.0-255,1738,30951,64,85850
6471,0.000585,172.31.40.0-255,66,31017,64,85850
6472,0.00059,172.217.194.0-255,1484,32501,64,85850
6473,0.000592,172.31.40.0-255,66,32567,64,85850
6474,0.000638,172.31.40.0-255,66,32633,64,85850
6475,0.000805,172.31.40.0-255,66,32699,64,85850
6476,0.000821,172.217.194.0-255,766,33465,64,85850
6477,0.000824,172.31.40.0-255,66,33531,64,85850
6478,0.00091,172.217.194.0-255,5738,39269,64,85850
6479,0.000914,172.31.40.0-255,66,39335,64,85850
6480,0.000939,172.217.194.0-255,7156,46491,64,85850
6481,0.000941,172.31.40.0-255,66,46557,64,85850
6482,0.001038,172.217.194.0-255,5738,52295,64,85850
6483,0.001043,172.31.40.0-255,66,52361,64,85850
6484,0.001099,172.31.40.0-255,66,52427,64,85850
6485,0.001221,172.217.194.0-255,5738,58165,64,85850
6486,0.001225,172.31.40.0-255,66,58231,64,85850
6487,0.001262,172.31.40.0-255,66,58297,64,85850
6488,0.001446,172.217.194.0-255,4320,62617,64,85850
6489,0.00145,172.31.40.0-255,66,62683,64,85850
6490,0.001474,172.31.40.0-255,66,62749,64,85850
6491,0.001555,172.31.40.0-255,66,62815,64,85850
6492,0.001623,172.31.40.0-255,66,62881,64,85850
6493,0.001901,172.217.194.0-255,7156,70037,64,85850
6494,0.001905,172.31.40.0-255,66,70103,64,85850
6495,0.001956,172.31.40.0-255,66,70169,64,85850
6496,0.002165,172.217.194.0-255,4320,74489,64,85850
6497,0.002169,172.31.40.0-255,66,74555,64,85850
6498,0.003397,172.217.194.0-255,4320,78875,64,85850
6499,0.01157,172.217.194.0-255,1287,80162,64,85850
6500,0.011591,172.31.40.0-255,78,80240,64,85850
6501,0.014095,172.31.40.0-255,101,80341,64,85850
6502,0.015011,172.31.40.0-255,105,80446,64,85850
6503,0.016287,172.217.194.0-255,66,80512,64,85850
6504,0.01722,172.217.194.0-255,66,80578,64,85850
6505,0.048198,172.31.40.0-255,172,80750,64,85850
6506,0.048226,172.31.40.0-255,1111,81861,64,85850
6507,0.048277,172.31.40.0-255,1514,83375,64,85850
6508,0.048278,172.31.40.0-255,1514,84889,64,85850
6509,0.048302,172.31.40.0-255,697,85586,64,85850
6510,0.049721,104.244.42.0-255,66,85652,64,85850
6511,0.049732,104.244.42.0-255,66,85718,64,85850
6512,0.049786,104.244.42.0-255,66,85784,64,85850
6513,0.049839,104.244.42.0-255,66,85850,64,85850
6514,0.0,172.217.194.0-255,297,297,64,262556
6515,1.3e-05,172.31.40.0-255,66,363,64,262556
6516,2e-05,172.217.194.0-255,1484,1847,64,262556
6517,2.5e-05,172.31.40.0-255,66,1913,64,262556
6518,3.8e-05,172.217.194.0-255,4320,6233,64,262556
6519,4.1e-05,172.31.40.0-255,66,6299,64,262556
6520,5.3e-05,172.31.40.0-255,66,6365,64,262556
6521,0.000107,172.217.194.0-255,1484,7849,64,262556
6522,0.000109,172.31.40.0-255,66,7915,64,262556
6523,0.000113,172.217.194.0-255,1484,9399,64,262556
6524,0.000115,172.31.40.0-255,66,9465,64,262556
6525,0.000139,172.217.194.0-255,1484,10949,64,262556
6526,0.000141,172.31.40.0-255,66,11015,64,262556
6527,0.000152,172.217.194.0-255,5738,16753,64,262556
6528,0.000155,172.31.40.0-255,66,16819,64,262556
6529,0.000161,172.217.194.0-255,5738,22557,64,262556
6530,0.000163,172.31.40.0-255,66,22623,64,262556
6531,0.000191,172.217.194.0-255,1125,23748,64,262556
6532,0.000193,172.31.40.0-255,66,23814,64,262556
6533,0.000249,172.217.194.0-255,1484,25298,64,262556
6534,0.000251,172.31.40.0-255,66,25364,64,262556
6535,0.000279,172.217.194.0-255,2902,28266,64,262556
6536,0.000282,172.31.40.0-255,66,28332,64,262556
6537,0.000289,172.217.194.0-255,5738,34070,64,262556
6538,0.000291,172.31.40.0-255,66,34136,64,262556
6539,0.000294,172.217.194.0-255,1484,35620,64,262556
6540,0.000301,172.31.40.0-255,66,35686,64,262556
6541,0.000329,172.217.194.0-255,4320,40006,64,262556
6542,0.000331,172.31.40.0-255,66,40072,64,262556
6543,0.000345,172.31.40.0-255,66,40138,64,262556
6544,0.000354,172.217.194.0-255,3961,44099,64,262556
6545,0.000397,172.217.194.0-255,368,44467,64,262556
6546,0.0004,172.217.194.0-255,379,44846,64,262556
6547,0.000532,172.31.40.0-255,66,44912,64,262556
6548,0.000575,172.217.194.0-255,1484,46396,64,262556
6549,0.000578,172.217.194.0-255,1484,47880,64,262556
6550,0.000584,172.31.40.0-255,66,47946,64,262556
6551,0.00061,172.217.194.0-255,1484,49430,64,262556
6552,0.000617,172.217.194.0-255,5738,55168,64,262556
6553,0.000618,172.217.194.0-255,1484,56652,64,262556
6554,0.000648,172.31.40.0-255,66,56718,64,262556
6555,0.000669,172.217.194.0-255,7156,63874,64,262556
6556,0.000679,172.31.40.0-255,66,63940,64,262556
6557,0.000685,172.217.194.0-255,6438,70378,64,262556
6558,0.000689,172.31.40.0-255,66,70444,64,262556
6559,0.00087,172.217.194.0-255,1484,71928,64,262556
6560,0.000874,172.217.194.0-255,1484,73412,64,262556
6561,0.000884,172.217.194.0-255,1484,74896,64,262556
6562,0.000894,172.31.40.0-255,66,74962,64,262556
6563,0.000917,172.217.194.0-255,5738,80700,64,262556
6564,0.000923,172.217.194.0-255,5738,86438,64,262556
6565,0.000928,172.217.194.0-255,5738,92176,64,262556
6566,0.000934,172.31.40.0-255,66,92242,64,262556
6567,0.000954,172.217.194.0-255,7156,99398,64,262556
6568,0.000957,172.217.194.0-255,1484,100882,64,262556
6569,0.00097,172.217.194.0-255,3602,104484,64,262556
6570,0.000974,172.31.40.0-255,66,104550,64,262556
6571,0.000978,172.31.40.0-255,66,104616,64,262556
6572,0.00102,172.217.194.0-255,1484,106100,64,262556
6573,0.001023,172.217.194.0-255,1484,107584,64,262556
6574,0.001026,172.31.40.0-255,66,107650,64,262556
6575,0.00105,172.217.194.0-255,1484,109134,64,262556
6576,0.001056,172.217.194.0-255,5738,114872,64,262556
6577,0.001069,172.31.40.0-255,66,114938,64,262556
6578,0.001115,172.217.194.0-255,4320,119258,64,262556
6579,0.001126,172.31.40.0-255,66,119324,64,262556
6580,0.001157,172.31.40.0-255,66,119390,64,262556
6581,0.001227,172.217.194.0-255,1484,120874,64,262556
6582,0.001239,172.217.194.0-255,2902,123776,64,262556
6583,0.001246,172.31.40.0-255,66,123842,64,262556
6584,0.001256,172.217.194.0-255,5738,129580,64,262556
6585,0.001258,172.217.194.0-255,1484,131064,64,262556
6586,0.001272,172.217.194.0-255,2902,133966,64,262556
6587,0.001283,172.31.40.0-255,66,134032,64,262556
6588,0.001324,172.217.194.0-255,2902,136934,64,262556
6589,0.001328,172.31.40.0-255,66,137000,64,262556
6590,0.001347,172.217.194.0-255,5020,142020,64,262556
6591,0.001359,172.31.40.0-255,66,142086,64,262556
6592,0.001402,172.217.194.0-255,1484,143570,64,262556
6593,0.001407,172.217.194.0-255,2902,146472,64,262556
6594,0.001415,172.31.40.0-255,66,146538,64,262556
6595,0.001438,172.217.194.0-255,5738,152276,64,262556
6596,0.001444,172.217.194.0-255,5738,158014,64,262556
6597,0.001453,172.31.40.0-255,66,158080,64,262556
6598,0.001472,172.217.194.0-255,7156,165236,64,262556
6599,0.001492,172.217.194.0-255,2184,167420,64,262556
6600,0.001496,172.31.40.0-255,66,167486,64,262556
6601,0.0015,172.31.40.0-255,66,167552,64,262556
6602,0.00166,172.217.194.0-255,1484,169036,64,262556
6603,0.001671,172.217.194.0-255,2902,171938,64,262556
6604,0.001674,172.31.40.0-255,66,172004,64,262556
6605,0.001701,172.217.194.0-255,5738,177742,64,262556
6606,0.00173,172.217.194.0-255,1484,179226,64,262556
6607,0.001739,172.31.40.0-255,66,179292,64,262556
6608,0.001763,172.217.194.0-255,5738,185030,64,262556
6609,0.001777,172.217.194.0-255,2184,187214,64,262556
6610,0.001786,172.31.40.0-255,66,187280,64,262556
6611,0.001813,172.217.194.0-255,1484,188764,64,262556
6612,0.001816,172.217.194.0-255,1484,190248,64,262556
6613,0.00183,172.217.194.0-255,1484,191732,64,262556
6614,0.001836,172.217.194.0-255,5738,197470,64,262556
6615,0.001838,172.31.40.0-255,66,197536,64,262556
6616,0.001843,172.31.40.0-255,66,197602,64,262556
6617,0.001868,172.217.194.0-255,7156,204758,64,262556
6618,0.001875,172.217.194.0-255,7156,211914,64,262556
6619,0.001888,172.217.194.0-255,7156,219070,64,262556
6620,0.001897,172.31.40.0-255,66,219136,64,262556
6621,0.001946,172.31.40.0-255,66,219202,64,262556
6622,0.001956,172.217.194.0-255,1484,220686,64,262556
6623,0.001994,172.217.194.0-255,1484,222170,64,262556
6624,0.001998,172.31.40.0-255,66,222236,64,262556
6625,0.002014,172.217.194.0-255,4320,226556,64,262556
6626,0.002025,172.31.40.0-255,66,226622,64,262556
6627,0.002067,172.31.40.0-255,66,226688,64,262556
6628,0.002072,172.217.194.0-255,766,227454,64,262556
6629,0.002082,172.217.194.0-255,7156,234610,64,262556
6630,0.002088,172.31.40.0-255,66,234676,64,262556
6631,0.004118,172.217.194.0-255,5738,240414,64,262556
6632,0.004126,172.31.40.0-255,66,240480,64,262556
6633,0.006175,172.217.194.0-255,5738,246218,64,262556
6634,0.013044,172.31.40.0-255,66,246284,64,262556
6635,0.013153,172.217.194.0-255,1484,247768,64,262556
6636,0.015089,172.217.194.0-255,4320,252088,64,262556
6637,0.015101,172.31.40.0-255,66,252154,64,262556
6638,0.017125,172.217.194.0-255,2084,254238,64,262556
6639,0.017132,172.31.40.0-255,66,254304,64,262556
6640,0.017305,172.31.40.0-255,105,254409,64,262556
6641,0.019304,172.217.194.0-255,66,254475,64,262556
6642,0.052353,172.31.40.0-255,172,254647,64,262556
6643,0.052403,172.31.40.0-255,1111,255758,64,262556
6644,0.052465,172.31.40.0-255,1514,257272,64,262556
6645,0.052486,172.31.40.0-255,1514,258786,64,262556
6646,0.052491,172.31.40.0-255,1514,260300,64,262556
6647,0.052506,172.31.40.0-255,1514,261814,64,262556
6648,0.052509,172.31.40.0-255,478,262292,64,262556
6649,0.053896,104.244.42.0-255,66,262358,64,262556
6650,0.05392,104.244.42.0-255,66,262424,64,262556
6651,0.054004,104.244.42.0-255,66,262490,64,262556
6652,0.05404,104.244.42.0-255,66,262556,64,262556
6653,0.0,74.125.24.0-255,153,153,64,263801
6654,2e-05,172.31.40.0-255,66,219,64,263801
6655,2.7e-05,74.125.24.0-255,1484,1703,64,263801
6656,3.1e-05,172.31.40.0-255,66,1769,64,263801
6657,3.8e-05,74.125.24.0-255,2902,4671,64,263801
6658,4.9e-05,172.31.40.0-255,66,4737,64,263801
6659,5.7e-05,74.125.24.0-255,7156,11893,64,263801
6660,6e-05,172.31.40.0-255,66,11959,64,263801
6661,6.4e-05,74.125.24.0-255,2000,13959,64,263801
6662,6.7e-05,172.31.40.0-255,66,14025,64,263801
6663,0.000167,74.125.24.0-255,1484,15509,64,263801
6664,0.000171,172.31.40.0-255,66,15575,64,263801
6665,0.000189,74.125.24.0-255,2902,18477,64,263801
6666,0.000192,172.31.40.0-255,66,18543,64,263801
6667,0.000195,74.125.24.0-255,1484,20027,64,263801
6668,0.000197,172.31.40.0-255,66,20093,64,263801
6669,0.00023,74.125.24.0-255,1484,21577,64,263801
6670,0.000233,172.31.40.0-255,66,21643,64,263801
6671,0.00024,74.125.24.0-255,7156,28799,64,263801
6672,0.000242,172.31.40.0-255,66,28865,64,263801
6673,0.000268,74.125.24.0-255,2543,31408,64,263801
6674,0.000271,172.31.40.0-255,66,31474,64,263801
6675,0.000512,74.125.24.0-255,1484,32958,64,263801
6676,0.000518,74.125.24.0-255,2902,35860,64,263801
6677,0.000523,172.31.40.0-255,66,35926,64,263801
6678,0.00053,172.31.40.0-255,66,35992,64,263801
6679,0.000533,74.125.24.0-255,1484,37476,64,263801
6680,0.000535,172.31.40.0-255,66,37542,64,263801
6681,0.000556,74.125.24.0-255,4320,41862,64,263801
6682,0.000559,172.31.40.0-255,66,41928,64,263801
6683,0.0006,172.31.40.0-255,66,41994,64,263801
6684,0.000629,74.125.24.0-255,1484,43478,64,263801
6685,0.000661,74.125.24.0-255,1125,44603,64,263801
6686,0.000663,74.125.24.0-255,400,45003,64,263801
6687,0.000667,172.31.40.0-255,66,45069,64,263801
6688,0.00069,74.125.24.0-255,108,45177,64,263801
6689,0.000692,172.31.40.0-255,66,45243,64,263801
6690,0.001267,74.125.24.0-255,332,45575,64,263801
6691,0.001639,74.125.24.0-255,1484,47059,64,263801
6692,0.001646,172.31.40.0-255,66,47125,64,263801
6693,0.001653,74.125.24.0-255,2902,50027,64,263801
6694,0.001656,172.31.40.0-255,66,50093,64,263801
6695,0.001666,74.125.24.0-255,2902,52995,64,263801
6696,0.001668,172.31.40.0-255,66,53061,64,263801
6697,0.001702,74.125.24.0-255,2902,55963,64,263801
6698,0.001705,172.31.40.0-255,66,56029,64,263801
6699,0.001712,74.125.24.0-255,5738,61767,64,263801
6700,0.001714,172.31.40.0-255,66,61833,64,263801
6701,0.001721,74.125.24.0-255,5738,67571,64,263801
6702,0.001723,172.31.40.0-255,66,67637,64,263801
6703,0.001763,74.125.24.0-255,7156,74793,64,263801
6704,0.001765,172.31.40.0-255,66,74859,64,263801
6705,0.001771,74.125.24.0-255,5020,79879,64,263801
6706,0.001774,172.31.40.0-255,66,79945,64,263801
6707,0.003442,74.125.24.0-255,1484,81429,64,263801
6708,0.003457,74.125.24.0-255,2902,84331,64,263801
6709,0.003459,172.31.40.0-255,66,84397,64,263801
6710,0.003465,74.125.24.0-255,4320,88717,64,263801
6711,0.003467,172.31.40.0-255,66,88783,64,263801
6712,0.003487,74.125.24.0-255,1484,90267,64,263801
6713,0.003521,74.125.24.0-255,2902,93169,64,263801
6714,0.003523,172.31.40.0-255,66,93235,64,263801
6715,0.003556,172.31.40.0-255,66,93301,64,263801
6716,0.003592,172.31.40.0-255,66,93367,64,263801
6717,0.003638,74.125.24.0-255,1484,94851,64,263801
6718,0.003643,74.125.24.0-255,2902,97753,64,263801
6719,0.003646,172.31.40.0-255,66,97819,64,263801
6720,0.003671,74.125.24.0-255,5738,103557,64,263801
6721,0.003674,172.31.40.0-255,66,103623,64,263801
6722,0.003681,74.125.24.0-255,5738,109361,64,263801
6723,0.003683,172.31.40.0-255,66,109427,64,263801
6724,0.003706,74.125.24.0-255,4320,113747,64,263801
6725,0.003709,172.31.40.0-255,66,113813,64,263801
6726,0.003712,74.125.24.0-255,2902,116715,64,263801
6727,0.003714,172.31.40.0-255,66,116781,64,263801
6728,0.003751,172.31.40.0-255,66,116847,64,263801
6729,0.003763,172.31.40.0-255,66,116913,64,263801
6730,0.003799,74.125.24.0-255,4320,121233,64,263801
6731,0.003801,172.31.40.0-255,66,121299,64,263801
6732,0.003807,74.125.24.0-255,7156,128455,64,263801
6733,0.00381,172.31.40.0-255,66,128521,64,263801
6734,0.003813,74.125.24.0-255,1484,130005,64,263801
6735,0.003845,172.31.40.0-255,66,130071,64,263801
6736,0.004165,74.125.24.0-255,1484,131555,64,263801
6737,0.00418,74.125.24.0-255,2902,134457,64,263801
6738,0.004183,172.31.40.0-255,66,134523,64,263801
6739,0.004216,74.125.24.0-255,5738,140261,64,263801
6740,0.004219,172.31.40.0-255,66,140327,64,263801
6741,0.004245,74.125.24.0-255,2902,143229,64,263801
6742,0.004248,172.31.40.0-255,66,143295,64,263801
6743,0.004273,74.125.24.0-255,4320,147615,64,263801
6744,0.004276,172.31.40.0-255,66,147681,64,263801
6745,0.00428,74.125.24.0-255,2902,150583,64,263801
6746,0.004283,172.31.40.0-255,66,150649,64,263801
6747,0.004303,74.125.24.0-255,2902,153551,64,263801
6748,0.004309,172.31.40.0-255,66,153617,64,263801
6749,0.004326,74.125.24.0-255,2902,156519,64,263801
6750,0.004329,172.31.40.0-255,66,156585,64,263801
6751,0.004364,172.31.40.0-255,66,156651,64,263801
6752,0.004476,74.125.24.0-255,1484,158135,64,263801
6753,0.004489,74.125.24.0-255,2902,161037,64,263801
6754,0.004492,172.31.40.0-255,66,161103,64,263801
6755,0.004505,74.125.24.0-255,2902,164005,64,263801
6756,0.004512,172.31.40.0-255,66,164071,64,263801
6757,0.004544,74.125.24.0-255,2902,166973,64,263801
6758,0.004546,172.31.40.0-255,66,167039,64,263801
6759,0.004556,74.125.24.0-255,4320,171359,64,263801
6760,0.004563,172.31.40.0-255,66,171425,64,263801
6761,0.004569,74.125.24.0-255,5738,177163,64,263801
6762,0.004572,172.31.40.0-255,66,177229,64,263801
6763,0.004583,172.31.40.0-255,66,177295,64,263801
6764,0.004617,74.125.24.0-255,2902,180197,64,263801
6765,0.004619,172.31.40.0-255,66,180263,64,263801
6766,0.004646,74.125.24.0-255,2184,182447,64,263801
6767,0.004649,172.31.40.0-255,66,182513,64,263801
6768,0.004742,74.125.24.0-255,1484,183997,64,263801
6769,0.004748,74.125.24.0-255,2902,186899,64,263801
6770,0.004752,172.31.40.0-255,66,186965,64,263801
6771,0.004784,74.125.24.0-255,4320,191285,64,263801
6772,0.004787,172.31.40.0-255,66,191351,64,263801
6773,0.004793,74.125.24.0-255,5738,197089,64,263801
6774,0.004796,172.31.40.0-255,66,197155,64,263801
6775,0.004817,74.125.24.0-255,5738,202893,64,263801
6776,0.00482,172.31.40.0-255,66,202959,64,263801
6777,0.004854,74.125.24.0-255,5738,208697,64,263801
6778,0.004857,172.31.40.0-255,66,208763,64,263801
6779,0.004862,74.125.24.0-255,2902,211665,64,263801
6780,0.004865,172.31.40.0-255,66,211731,64,263801
6781,0.004871,74.125.24.0-255,4320,216051,64,263801
6782,0.004873,172.31.40.0-255,66,216117,64,263801
6783,0.004876,74.125.24.0-255,766,216883,64,263801
6784,0.005088,74.125.24.0-255,1484,218367,64,263801
6785,0.005093,172.31.40.0-255,66,218433,64,263801
6786,0.005119,74.125.24.0-255,2902,221335,64,263801
6787,0.005123,172.31.40.0-255,66,221401,64,263801
6788,0.005128,74.125.24.0-255,2902,224303,64,263801
6789,0.00513,172.31.40.0-255,66,224369,64,263801
6790,0.005161,74.125.24.0-255,2902,227271,64,263801
6791,0.005164,172.31.40.0-255,66,227337,64,263801
6792,0.005171,74.125.24.0-255,5738,233075,64,263801
6793,0.005173,172.31.40.0-255,66,233141,64,263801
6794,0.005185,172.31.40.0-255,66,233207,64,263801
6795,0.005211,74.125.24.0-255,2902,236109,64,263801
6796,0.005214,172.31.40.0-255,66,236175,64,263801
6797,0.005221,74.125.24.0-255,5020,241195,64,263801
6798,0.005223,172.31.40.0-255,66,241261,64,263801
6799,0.005274,172.31.40.0-255,66,241327,64,263801
6800,0.005279,74.125.24.0-255,2902,244229,64,263801
6801,0.005281,172.31.40.0-255,66,244295,64,263801
6802,0.005325,172.31.40.0-255,66,244361,64,263801
6803,0.005335,172.31.40.0-255,66,244427,64,263801
6804,0.005374,74.125.24.0-255,3602,248029,64,263801
6805,0.005377,172.31.40.0-255,66,248095,64,263801
6806,0.00539,172.31.40.0-255,66,248161,64,263801
6807,0.005395,74.125.24.0-255,4320,252481,64,263801
6808,0.005398,172.31.40.0-255,66,252547,64,263801
6809,0.005431,172.31.40.0-255,66,252613,64,263801
6810,0.005434,74.125.24.0-255,1484,254097,64,263801
6811,0.005449,74.125.24.0-255,3188,257285,64,263801
6812,0.005456,172.31.40.0-255,66,257351,64,263801
6813,0.005526,74.125.24.0-255,105,257456,64,263801
6814,0.011549,172.31.40.0-255,101,257557,64,263801
6815,0.012625,172.31.40.0-255,105,257662,64,263801
6816,0.01384,74.125.24.0-255,66,257728,64,263801
6817,0.014856,74.125.24.0-255,66,257794,64,263801
6818,0.041616,172.31.40.0-255,172,257966,64,263801
6819,0.041655,172.31.40.0-255,1108,259074,64,263801
6820,0.041719,172.31.40.0-255,1514,260588,64,263801
6821,0.041722,172.31.40.0-255,1514,262102,64,263801
6822,0.041723,172.31.40.0-255,1514,263616,64,263801
6823,0.041724,172.31.40.0-255,119,263735,64,263801
6824,0.043787,104.244.42.0-255,66,263801,64,263801
6825,0.0,74.125.24.0-255,143,143,64,258269
6826,3.3e-05,172.31.40.0-255,66,209,64,258269
6827,3.9e-05,74.125.24.0-255,1484,1693,64,258269
6828,4.5e-05,172.31.40.0-255,66,1759,64,258269
6829,4.9e-05,74.125.24.0-255,2902,4661,64,258269
6830,5.2e-05,172.31.40.0-255,66,4727,64,258269
6831,5.8e-05,74.125.24.0-255,7156,11883,64,258269
6832,6.1e-05,172.31.40.0-255,66,11949,64,258269
6833,9.2e-05,172.31.40.0-255,66,12015,64,258269
6834,0.000117,74.125.24.0-255,6394,18409,64,258269
6835,0.00012,172.31.40.0-255,66,18475,64,258269
6836,0.000139,74.125.24.0-255,2543,21018,64,258269
6837,0.000142,172.31.40.0-255,66,21084,64,258269
6838,0.000189,74.125.24.0-255,1484,22568,64,258269
6839,0.000192,172.31.40.0-255,66,22634,64,258269
6840,0.000196,74.125.24.0-255,2902,25536,64,258269
6841,0.000198,172.31.40.0-255,66,25602,64,258269
6842,0.000219,74.125.24.0-255,5738,31340,64,258269
6843,0.000222,172.31.40.0-255,66,31406,64,258269
6844,0.000225,74.125.24.0-255,1484,32890,64,258269
6845,0.000228,172.31.40.0-255,66,32956,64,258269
6846,0.000249,74.125.24.0-255,5379,38335,64,258269
6847,0.000252,172.31.40.0-255,66,38401,64,258269
6848,0.000282,74.125.24.0-255,1484,39885,64,258269
6849,0.000284,172.31.40.0-255,66,39951,64,258269
6850,0.000289,74.125.24.0-255,2902,42853,64,258269
6851,0.000292,172.31.40.0-255,66,42919,64,258269
6852,0.000304,74.125.24.0-255,2902,45821,64,258269
6853,0.000306,172.31.40.0-255,66,45887,64,258269
6854,0.000329,74.125.24.0-255,2902,48789,64,258269
6855,0.000332,172.31.40.0-255,66,48855,64,258269
6856,0.000339,74.125.24.0-255,6797,55652,64,258269
6857,0.000342,172.31.40.0-255,66,55718,64,258269
6858,0.000362,74.125.24.0-255,361,56079,64,258269
6859,0.00066,74.125.24.0-255,383,56462,64,258269
6860,0.000789,74.125.24.0-255,1484,57946,64,258269
6861,0.000794,172.31.40.0-255,66,58012,64,258269
6862,0.0008,74.125.24.0-255,2902,60914,64,258269
6863,0.000802,172.31.40.0-255,66,60980,64,258269
6864,0.000805,74.125.24.0-255,1484,62464,64,258269
6865,0.000822,74.125.24.0-255,4320,66784,64,258269
6866,0.000825,172.31.40.0-255,66,66850,64,258269
6867,0.000828,74.125.24.0-255,1484,68334,64,258269
6868,0.000845,74.125.24.0-255,5379,73713,64,258269
6869,0.00085,172.31.40.0-255,66,73779,64,258269
6870,0.001018,74.125.24.0-255,1484,75263,64,258269
6871,0.001036,74.125.24.0-255,2902,78165,64,258269
6872,0.00104,172.31.40.0-255,66,78231,64,258269
6873,0.001043,74.125.24.0-255,1484,79715,64,258269
6874,0.00106,74.125.24.0-255,2902,82617,64,258269
6875,0.001062,172.31.40.0-255,66,82683,64,258269
6876,0.001091,74.125.24.0-255,2902,85585,64,258269
6877,0.001094,172.31.40.0-255,66,85651,64,258269
6878,0.001109,74.125.24.0-255,5379,91030,64,258269
6879,0.001112,172.31.40.0-255,66,91096,64,258269
6880,0.002269,74.125.24.0-255,1484,92580,64,258269
6881,0.00228,74.125.24.0-255,2902,95482,64,258269
6882,0.002284,172.31.40.0-255,66,95548,64,258269
6883,0.002291,74.125.24.0-255,5738,101286,64,258269
6884,0.002293,172.31.40.0-255,66,101352,64,258269
6885,0.002316,74.125.24.0-255,4320,105672,64,258269
6886,0.002318,172.31.40.0-255,66,105738,64,258269
6887,0.004578,74.125.24.0-255,1484,107222,64,258269
6888,0.004599,74.125.24.0-255,4320,111542,64,258269
6889,0.004603,172.31.40.0-255,66,111608,64,258269
6890,0.006875,74.125.24.0-255,5738,117346,64,258269
6891,0.006879,172.31.40.0-255,66,117412,64,258269
6892,0.009143,74.125.24.0-255,5738,123150,64,258269
6893,0.009151,172.31.40.0-255,66,123216,64,258269
6894,0.011414,74.125.24.0-255,5738,128954,64,258269
6895,0.011422,172.31.40.0-255,66,129020,64,258269
6896,0.013703,74.125.24.0-255,5738,134758,64,258269
6897,0.013713,172.31.40.0-255,66,134824,64,258269
6898,0.016035,74.125.24.0-255,5738,140562,64,258269
6899,0.016043,172.31.40.0-255,66,140628,64,258269
6900,0.01837,74.125.24.0-255,5738,146366,64,258269
6901,0.018379,172.31.40.0-255,66,146432,64,258269
6902,0.020705,74.125.24.0-255,5738,152170,64,258269
6903,0.020713,172.31.40.0-255,66,152236,64,258269
6904,0.023,74.125.24.0-255,5738,157974,64,258269
6905,0.023009,172.31.40.0-255,66,158040,64,258269
6906,0.025325,74.125.24.0-255,5738,163778,64,258269
6907,0.025332,172.31.40.0-255,66,163844,64,258269
6908,0.027595,74.125.24.0-255,5738,169582,64,258269
6909,0.027601,172.31.40.0-255,66,169648,64,258269
6910,0.029884,74.125.24.0-255,5738,175386,64,258269
6911,0.029893,172.31.40.0-255,66,175452,64,258269
6912,0.032155,74.125.24.0-255,5738,181190,64,258269
6913,0.032161,172.31.40.0-255,66,181256,64,258269
6914,0.032324,172.31.40.0-255,172,181428,64,258269
6915,0.032354,172.31.40.0-255,1113,182541,64,258269
6916,0.032514,172.31.40.0-255,1514,184055,64,258269
6917,0.032516,172.31.40.0-255,1514,185569,64,258269
6918,0.032517,172.31.40.0-255,1514,187083,64,258269
6919,0.032518,172.31.40.0-255,1076,188159,64,258269
6920,0.033909,104.244.42.0-255,66,188225,64,258269
6921,0.033916,104.244.42.0-255,66,188291,64,258269
6922,0.034086,104.244.42.0-255,66,188357,64,258269
6923,0.034471,74.125.24.0-255,2902,191259,64,258269
6924,0.034475,172.31.40.0-255,66,191325,64,258269
6925,0.034494,74.125.24.0-255,2902,194227,64,258269
6926,0.034497,172.31.40.0-255,66,194293,64,258269
6927,0.036819,74.125.24.0-255,2902,197195,64,258269
6928,0.036827,172.31.40.0-255,66,197261,64,258269
6929,0.036846,74.125.24.0-255,2902,200163,64,258269
6930,0.03685,172.31.40.0-255,66,200229,64,258269
6931,0.039153,74.125.24.0-255,5738,205967,64,258269
6932,0.039164,172.31.40.0-255,66,206033,64,258269
6933,0.041453,74.125.24.0-255,5738,211771,64,258269
6934,0.041458,172.31.40.0-255,66,211837,64,258269
6935,0.043768,74.125.24.0-255,5738,217575,64,258269
6936,0.043773,172.31.40.0-255,66,217641,64,258269
6937,0.046039,74.125.24.0-255,5738,223379,64,258269
6938,0.04606,172.31.40.0-255,66,223445,64,258269
6939,0.048334,74.125.24.0-255,5738,229183,64,258269
6940,0.048339,172.31.40.0-255,66,229249,64,258269
6941,0.050625,74.125.24.0-255,5738,234987,64,258269
6942,0.050631,172.31.40.0-255,66,235053,64,258269
6943,0.052963,74.125.24.0-255,5738,240791,64,258269
6944,0.05297,172.31.40.0-255,66,240857,64,258269
6945,0.055242,74.125.24.0-255,5738,246595,64,258269
6946,0.055249,172.31.40.0-255,66,246661,64,258269
6947,0.057587,74.125.24.0-255,5738,252399,64,258269
6948,0.057607,172.31.40.0-255,66,252465,64,258269
6949,0.059901,74.125.24.0-255,5738,258203,64,258269
6950,0.059919,172.31.40.0-255,66,258269,64,258269
6951,0.0,74.125.24.0-255,152,152,64,218455
6952,1.7e-05,172.31.40.0-255,66,218,64,218455
6953,2.5e-05,74.125.24.0-255,1484,1702,64,218455
6954,3e-05,172.31.40.0-255,66,1768,64,218455
6955,3.5e-05,74.125.24.0-255,2902,4670,64,218455
6956,4.5e-05,172.31.40.0-255,66,4736,64,218455
6957,7.6e-05,74.125.24.0-255,4320,9056,64,218455
6958,7.9e-05,172.31.40.0-255,66,9122,64,218455
6959,8.5e-05,74.125.24.0-255,4903,14025,64,218455
6960,8.8e-05,172.31.40.0-255,66,14091,64,218455
6961,0.000352,74.125.24.0-255,1484,15575,64,218455
6962,0.000358,172.31.40.0-255,66,15641,64,218455
6963,0.000364,74.125.24.0-255,2902,18543,64,218455
6964,0.000367,172.31.40.0-255,66,18609,64,218455
6965,0.000372,74.125.24.0-255,2902,21511,64,218455
6966,0.000379,172.31.40.0-255,66,21577,64,218455
6967,0.000406,74.125.24.0-255,2902,24479,64,218455
6968,0.000408,172.31.40.0-255,66,24545,64,218455
6969,0.000424,172.31.40.0-255,66,24611,64,218455
6970,0.000456,74.125.24.0-255,3961,28572,64,218455
6971,0.000464,172.31.40.0-255,66,28638,64,218455
6972,0.000477,172.31.40.0-255,66,28704,64,218455
6973,0.000482,74.125.24.0-255,2902,31606,64,218455
6974,0.000485,172.31.40.0-255,66,31672,64,218455
6975,0.000535,172.31.40.0-255,66,31738,64,218455
6976,0.000538,74.125.24.0-255,363,32101,64,218455
6977,0.00054,172.31.40.0-255,66,32167,64,218455
6978,0.00109,74.125.24.0-255,380,32547,64,218455
6979,0.00111,172.31.40.0-255,66,32613,64,218455
6980,0.001115,74.125.24.0-255,1484,34097,64,218455
6981,0.001141,74.125.24.0-255,4320,38417,64,218455
6982,0.001144,172.31.40.0-255,66,38483,64,218455
6983,0.001155,172.31.40.0-255,66,38549,64,218455
6984,0.001171,74.125.24.0-255,1484,40033,64,218455
6985,0.001193,74.125.24.0-255,5738,45771,64,218455
6986,0.001196,172.31.40.0-255,66,45837,64,218455
6987,0.001237,172.31.40.0-255,66,45903,64,218455
6988,0.001798,74.125.24.0-255,1484,47387,64,218455
6989,0.001808,74.125.24.0-255,2902,50289,64,218455
6990,0.001812,172.31.40.0-255,66,50355,64,218455
6991,0.00182,74.125.24.0-255,5738,56093,64,218455
6992,0.001822,172.31.40.0-255,66,56159,64,218455
6993,0.001861,172.31.40.0-255,66,56225,64,218455
6994,0.001887,74.125.24.0-255,2902,59127,64,218455
6995,0.00189,172.31.40.0-255,66,59193,64,218455
6996,0.001927,172.31.40.0-255,66,59259,64,218455
6997,0.002265,74.125.24.0-255,1484,60743,64,218455
6998,0.002274,74.125.24.0-255,2902,63645,64,218455
6999,0.002278,172.31.40.0-255,66,63711,64,218455
7000,0.002285,74.125.24.0-255,5738,69449,64,218455
7001,0.002287,172.31.40.0-255,66,69515,64,218455
7002,0.002323,172.31.40.0-255,66,69581,64,218455
7003,0.002328,74.125.24.0-255,2902,72483,64,218455
7004,0.00233,172.31.40.0-255,66,72549,64,218455
7005,0.002388,172.31.40.0-255,66,72615,64,218455
7006,0.002405,74.125.24.0-255,2184,74799,64,218455
7007,0.002407,172.31.40.0-255,66,74865,64,218455
7008,0.00468,74.125.24.0-255,5738,80603,64,218455
7009,0.004685,172.31.40.0-255,66,80669,64,218455
7010,0.00695,74.125.24.0-255,5738,86407,64,218455
7011,0.006957,172.31.40.0-255,66,86473,64,218455
7012,0.009249,74.125.24.0-255,5738,92211,64,218455
7013,0.009256,172.31.40.0-255,66,92277,64,218455
7014,0.011521,74.125.24.0-255,5738,98015,64,218455
7015,0.01153,172.31.40.0-255,66,98081,64,218455
7016,0.013847,74.125.24.0-255,5738,103819,64,218455
7017,0.013855,172.31.40.0-255,66,103885,64,218455
7018,0.016175,74.125.24.0-255,5738,109623,64,218455
7019,0.016182,172.31.40.0-255,66,109689,64,218455
7020,0.018445,74.125.24.0-255,5738,115427,64,218455
7021,0.018455,172.31.40.0-255,66,115493,64,218455
7022,0.020781,74.125.24.0-255,5738,121231,64,218455
7023,0.020794,172.31.40.0-255,66,121297,64,218455
7024,0.023107,74.125.24.0-255,5738,127035,64,218455
7025,0.023114,172.31.40.0-255,66,127101,64,218455
7026,0.025412,74.125.24.0-255,5738,132839,64,218455
7027,0.02542,172.31.40.0-255,66,132905,64,218455
7028,0.027673,74.125.24.0-255,5738,138643,64,218455
7029,0.027681,172.31.40.0-255,66,138709,64,218455
7030,0.029959,74.125.24.0-255,5738,144447,64,218455
7031,0.029966,172.31.40.0-255,66,144513,64,218455
7032,0.030401,172.31.40.0-255,172,144685,64,218455
7033,0.030431,172.31.40.0-255,1112,145797,64,218455
7034,0.030486,172.31.40.0-255,1514,147311,64,218455
7035,0.030488,172.31.40.0-255,1298,148609,64,218455
7036,0.031957,104.244.42.0-255,66,148675,64,218455
7037,0.031999,104.244.42.0-255,66,148741,64,218455
7038,0.03204,104.244.42.0-255,66,148807,64,218455
7039,0.032281,74.125.24.0-255,5738,154545,64,218455
7040,0.032287,172.31.40.0-255,66,154611,64,218455
7041,0.034598,74.125.24.0-255,5738,160349,64,218455
7042,0.034604,172.31.40.0-255,66,160415,64,218455
7043,0.036893,74.125.24.0-255,5738,166153,64,218455
7044,0.036912,172.31.40.0-255,66,166219,64,218455
7045,0.039245,74.125.24.0-255,5738,171957,64,218455
7046,0.039262,172.31.40.0-255,66,172023,64,218455
7047,0.041558,74.125.24.0-255,5738,177761,64,218455
7048,0.041576,172.31.40.0-255,66,177827,64,218455
7049,0.043878,74.125.24.0-255,5738,183565,64,218455
7050,0.043895,172.31.40.0-255,66,183631,64,218455
7051,0.046174,74.125.24.0-255,5738,189369,64,218455
7052,0.046192,172.31.40.0-255,66,189435,64,218455
7053,0.048518,74.125.24.0-255,5738,195173,64,218455
7054,0.048537,172.31.40.0-255,66,195239,64,218455
7055,0.050857,74.125.24.0-255,5738,200977,64,218455
7056,0.050877,172.31.40.0-255,66,201043,64,218455
7057,0.053161,74.125.24.0-255,5738,206781,64,218455
7058,0.053175,172.31.40.0-255,66,206847,64,218455
7059,0.055466,74.125.24.0-255,5738,212585,64,218455
7060,0.055486,172.31.40.0-255,66,212651,64,218455
7061,0.057826,74.125.24.0-255,5738,218389,64,218455
7062,0.057845,172.31.40.0-255,66,218455,64,218455
7063,0.0,216.58.203.0-255,153,153,64,287392
7064,2.3e-05,172.31.40.0-255,66,219,64,287392
7065,3.1e-05,216.58.203.0-255,1484,1703,64,287392
7066,3.5e-05,172.31.40.0-255,66,1769,64,287392
7067,4.1e-05,216.58.203.0-255,2902,4671,64,287392
7068,4.4e-05,172.31.40.0-255,66,4737,64,287392
7069,5.2e-05,216.58.203.0-255,7156,11893,64,287392
7070,5.6e-05,172.31.40.0-255,66,11959,64,287392
7071,6e-05,216.58.203.0-255,2069,14028,64,287392
7072,6.3e-05,172.31.40.0-255,66,14094,64,287392
7073,0.000148,216.58.203.0-255,1484,15578,64,287392
7074,0.000151,172.31.40.0-255,66,15644,64,287392
7075,0.000179,216.58.203.0-255,2902,18546,64,287392
7076,0.000182,172.31.40.0-255,66,18612,64,287392
7077,0.000189,216.58.203.0-255,5738,24350,64,287392
7078,0.000191,172.31.40.0-255,66,24416,64,287392
7079,0.000195,216.58.203.0-255,2902,27318,64,287392
7080,0.000197,172.31.40.0-255,66,27384,64,287392
7081,0.000202,216.58.203.0-255,3961,31345,64,287392
7082,0.000205,172.31.40.0-255,66,31411,64,287392
7083,0.000265,216.58.203.0-255,1484,32895,64,287392
7084,0.000268,172.31.40.0-255,66,32961,64,287392
7085,0.000296,216.58.203.0-255,2902,35863,64,287392
7086,0.000299,172.31.40.0-255,66,35929,64,287392
7087,0.000304,216.58.203.0-255,2902,38831,64,287392
7088,0.000307,172.31.40.0-255,66,38897,64,287392
7089,0.00032,216.58.203.0-255,1484,40381,64,287392
7090,0.000322,172.31.40.0-255,66,40447,64,287392
7091,0.000361,216.58.203.0-255,7156,47603,64,287392
7092,0.000364,172.31.40.0-255,66,47669,64,287392
7093,0.000381,216.58.203.0-255,1125,48794,64,287392
7094,0.000383,172.31.40.0-255,66,48860,64,287392
7095,0.000438,216.58.203.0-255,1484,50344,64,287392
7096,0.000455,216.58.203.0-255,2902,53246,64,287392
7097,0.000461,216.58.203.0-255,4320,57566,64,287392
7098,0.000472,216.58.203.0-255,1484,59050,64,287392
7099,0.000488,216.58.203.0-255,4320,63370,64,287392
7100,0.000502,216.58.203.0-255,2543,65913,64,287392
7101,0.000527,216.58.203.0-255,351,66264,64,287392
7102,0.000568,172.31.40.0-255,66,66330,64,287392
7103,0.000816,216.58.203.0-255,391,66721,64,287392
7104,0.00096,216.58.203.0-255,1484,68205,64,287392
7105,0.000966,216.58.203.0-255,2902,71107,64,287392
7106,0.000987,216.58.203.0-255,5738,76845,64,287392
7107,0.000993,216.58.203.0-255,5738,82583,64,287392
7108,0.001,172.31.40.0-255,66,82649,64,287392
7109,0.001013,216.58.203.0-255,1125,83774,64,287392
7110,0.001022,216.58.203.0-255,7156,90930,64,287392
7111,0.001046,216.58.203.0-255,2902,93832,64,287392
7112,0.00106,172.31.40.0-255,66,93898,64,287392
7113,0.001067,216.58.203.0-255,6797,100695,64,287392
7114,0.001072,172.31.40.0-255,66,100761,64,287392
7115,0.001682,216.58.203.0-255,1484,102245,64,287392
7116,0.001691,216.58.203.0-255,1484,103729,64,287392
7117,0.001695,172.31.40.0-255,66,103795,64,287392
7118,0.002747,216.58.203.0-255,2902,106697,64,287392
7119,0.003364,216.58.203.0-255,2902,109599,64,287392
7120,0.007893,172.31.40.0-255,66,109665,64,287392
7121,0.009569,216.58.203.0-255,5738,115403,64,287392
7122,0.009577,172.31.40.0-255,66,115469,64,287392
7123,0.011259,216.58.203.0-255,5738,121207,64,287392
7124,0.013939,172.31.40.0-255,66,121273,64,287392
7125,0.015614,216.58.203.0-255,5738,127011,64,287392
7126,0.015622,172.31.40.0-255,66,127077,64,287392
7127,0.017304,216.58.203.0-255,1484,128561,64,287392
7128,0.017328,216.58.203.0-255,4320,132881,64,287392
7129,0.017333,172.31.40.0-255,66,132947,64,287392
7130,0.019028,216.58.203.0-255,5738,138685,64,287392
7131,0.019036,172.31.40.0-255,66,138751,64,287392
7132,0.020732,216.58.203.0-255,5738,144489,64,287392
7133,0.020739,172.31.40.0-255,66,144555,64,287392
7134,0.02243,216.58.203.0-255,5738,150293,64,287392
7135,0.022437,172.31.40.0-255,66,150359,64,287392
7136,0.024121,216.58.203.0-255,5738,156097,64,287392
7137,0.024128,172.31.40.0-255,66,156163,64,287392
7138,0.025828,216.58.203.0-255,5738,161901,64,287392
7139,0.025835,172.31.40.0-255,66,161967,64,287392
7140,0.027511,216.58.203.0-255,5738,167705,64,287392
7141,0.027519,172.31.40.0-255,66,167771,64,287392
7142,0.029189,216.58.203.0-255,5738,173509,64,287392
7143,0.029195,172.31.40.0-255,66,173575,64,287392
7144,0.030371,172.31.40.0-255,172,173747,64,287392
7145,0.030404,172.31.40.0-255,1112,174859,64,287392
7146,0.030463,172.31.40.0-255,1514,176373,64,287392
7147,0.030465,172.31.40.0-255,1514,177887,64,287392
7148,0.030466,172.31.40.0-255,1514,179401,64,287392
7149,0.030492,172.31.40.0-255,1077,180478,64,287392
7150,0.030865,216.58.203.0-255,2902,183380,64,287392
7151,0.030872,172.31.40.0-255,66,183446,64,287392
7152,0.030889,216.58.203.0-255,2902,186348,64,287392
7153,0.030972,172.31.40.0-255,66,186414,64,287392
7154,0.0319,104.244.42.0-255,66,186480,64,287392
7155,0.031923,104.244.42.0-255,66,186546,64,287392
7156,0.032014,104.244.42.0-255,66,186612,64,287392
7157,0.032017,104.244.42.0-255,66,186678,64,287392
7158,0.032537,216.58.203.0-255,2902,189580,64,287392
7159,0.032541,172.31.40.0-255,66,189646,64,287392
7160,0.032632,216.58.203.0-255,2902,192548,64,287392
7161,0.03265,172.31.40.0-255,66,192614,64,287392
7162,0.034209,216.58.203.0-255,2902,195516,64,287392
7163,0.034216,172.31.40.0-255,66,195582,64,287392
7164,0.034308,216.58.203.0-255,2902,198484,64,287392
7165,0.03432,172.31.40.0-255,66,198550,64,287392
7166,0.035897,216.58.203.0-255,2902,201452,64,287392
7167,0.035906,172.31.40.0-255,66,201518,64,287392
7168,0.035976,216.58.203.0-255,2902,204420,64,287392
7169,0.036014,172.31.40.0-255,66,204486,64,287392
7170,0.037573,216.58.203.0-255,2902,207388,64,287392
7171,0.03758,172.31.40.0-255,66,207454,64,287392
7172,0.037672,216.58.203.0-255,2902,210356,64,287392
7173,0.037677,172.31.40.0-255,66,210422,64,287392
7174,0.039293,216.58.203.0-255,2902,213324,64,287392
7175,0.039301,172.31.40.0-255,66,213390,64,287392
7176,0.039344,216.58.203.0-255,2902,216292,64,287392
7177,0.039383,172.31.40.0-255,66,216358,64,287392
7178,0.040964,216.58.203.0-255,2902,219260,64,287392
7179,0.04097,172.31.40.0-255,66,219326,64,287392
7180,0.041043,216.58.203.0-255,2902,222228,64,287392
7181,0.041058,172.31.40.0-255,66,222294,64,287392
7182,0.042657,216.58.203.0-255,2902,225196,64,287392
7183,0.042664,172.31.40.0-255,66,225262,64,287392
7184,0.042746,216.58.203.0-255,1484,226746,64,287392
7185,0.04276,216.58.203.0-255,1484,228230,64,287392
7186,0.042768,172.31.40.0-255,66,228296,64,287392
7187,0.044497,216.58.203.0-255,5738,234034,64,287392
7188,0.044536,172.31.40.0-255,66,234100,64,287392
7189,0.046205,216.58.203.0-255,5738,239838,64,287392
7190,0.04621,172.31.40.0-255,66,239904,64,287392
7191,0.047895,216.58.203.0-255,2902,242806,64,287392
7192,0.047902,172.31.40.0-255,66,242872,64,287392
7193,0.047924,216.58.203.0-255,2902,245774,64,287392
7194,0.047943,172.31.40.0-255,66,245840,64,287392
7195,0.049558,216.58.203.0-255,2902,248742,64,287392
7196,0.049564,172.31.40.0-255,66,248808,64,287392
7197,0.049591,216.58.203.0-255,2902,251710,64,287392
7198,0.049605,172.31.40.0-255,66,251776,64,287392
7199,0.05123,216.58.203.0-255,2902,254678,64,287392
7200,0.051236,172.31.40.0-255,66,254744,64,287392
7201,0.051274,216.58.203.0-255,2902,257646,64,287392
7202,0.051303,172.31.40.0-255,66,257712,64,287392
7203,0.052931,216.58.203.0-255,2902,260614,64,287392
7204,0.052941,172.31.40.0-255,66,260680,64,287392
7205,0.052966,216.58.203.0-255,2902,263582,64,287392
7206,0.053006,172.31.40.0-255,66,263648,64,287392
7207,0.05465,216.58.203.0-255,2902,266550,64,287392
7208,0.054656,172.31.40.0-255,66,266616,64,287392
7209,0.054681,216.58.203.0-255,2902,269518,64,287392
7210,0.0547,172.31.40.0-255,66,269584,64,287392
7211,0.056339,216.58.203.0-255,2902,272486,64,287392
7212,0.056346,172.31.40.0-255,66,272552,64,287392
7213,0.056376,216.58.203.0-255,2902,275454,64,287392
7214,0.056388,172.31.40.0-255,66,275520,64,287392
7215,0.058027,216.58.203.0-255,2902,278422,64,287392
7216,0.058034,172.31.40.0-255,66,278488,64,287392
7217,0.058056,216.58.203.0-255,2902,281390,64,287392
7218,0.058076,172.31.40.0-255,66,281456,64,287392
7219,0.059698,216.58.203.0-255,2902,284358,64,287392
7220,0.059704,172.31.40.0-255,66,284424,64,287392
7221,0.059735,216.58.203.0-255,2902,287326,64,287392
7222,0.05976,172.31.40.0-255,66,287392,64,287392
7223,0.0,74.125.24.0-255,156,156,64,243063
7224,2.1e-05,172.31.40.0-255,66,222,64,243063
7225,5.6e-05,74.125.24.0-255,1484,1706,64,243063
7226,6.1e-05,172.31.40.0-255,66,1772,64,243063
7227,9.2e-05,74.125.24.0-255,2902,4674,64,243063
7228,9.5e-05,172.31.40.0-255,66,4740,64,243063
7229,0.000125,74.125.24.0-255,5738,10478,64,243063
7230,0.000128,172.31.40.0-255,66,10544,64,243063
7231,0.000164,74.125.24.0-255,6275,16819,64,243063
7232,0.000167,172.31.40.0-255,66,16885,64,243063
7233,0.000174,74.125.24.0-255,5738,22623,64,243063
7234,0.000176,172.31.40.0-255,66,22689,64,243063
7235,0.000199,74.125.24.0-255,1484,24173,64,243063
7236,0.000206,172.31.40.0-255,66,24239,64,243063
7237,0.000213,74.125.24.0-255,6797,31036,64,243063
7238,0.000216,172.31.40.0-255,66,31102,64,243063
7239,0.000364,74.125.24.0-255,1484,32586,64,243063
7240,0.000368,172.31.40.0-255,66,32652,64,243063
7241,0.000374,74.125.24.0-255,2902,35554,64,243063
7242,0.000377,172.31.40.0-255,66,35620,64,243063
7243,0.000388,74.125.24.0-255,4320,39940,64,243063
7244,0.000392,172.31.40.0-255,66,40006,64,243063
7245,0.000401,74.125.24.0-255,1484,41490,64,243063
7246,0.000404,172.31.40.0-255,66,41556,64,243063
7247,0.000409,74.125.24.0-255,2902,44458,64,243063
7248,0.000411,172.31.40.0-255,66,44524,64,243063
7249,0.000436,74.125.24.0-255,3961,48485,64,243063
7250,0.000439,172.31.40.0-255,66,48551,64,243063
7251,0.000447,74.125.24.0-255,7156,55707,64,243063
7252,0.00045,172.31.40.0-255,66,55773,64,243063
7253,0.000455,74.125.24.0-255,4320,60093,64,243063
7254,0.000457,172.31.40.0-255,66,60159,64,243063
7255,0.000512,74.125.24.0-255,4320,64479,64,243063
7256,0.000515,172.31.40.0-255,66,64545,64,243063
7257,0.00054,74.125.24.0-255,1400,65945,64,243063
7258,0.000543,74.125.24.0-255,380,66325,64,243063
7259,0.000546,172.31.40.0-255,66,66391,64,243063
7260,0.000641,74.125.24.0-255,1484,67875,64,243063
7261,0.000646,74.125.24.0-255,1484,69359,64,243063
7262,0.000649,172.31.40.0-255,66,69425,64,243063
7263,0.000667,74.125.24.0-255,1484,70909,64,243063
7264,0.000674,74.125.24.0-255,5738,76647,64,243063
7265,0.000676,172.31.40.0-255,66,76713,64,243063
7266,0.000712,74.125.24.0-255,4320,81033,64,243063
7267,0.000716,172.31.40.0-255,66,81099,64,243063
7268,0.000744,74.125.24.0-255,2543,83642,64,243063
7269,0.000747,172.31.40.0-255,66,83708,64,243063
7270,0.000827,74.125.24.0-255,1484,85192,64,243063
7271,0.000833,74.125.24.0-255,2902,88094,64,243063
7272,0.000836,172.31.40.0-255,66,88160,64,243063
7273,0.000864,74.125.24.0-255,5738,93898,64,243063
7274,0.000867,172.31.40.0-255,66,93964,64,243063
7275,0.000917,74.125.24.0-255,5738,99702,64,243063
7276,0.00092,172.31.40.0-255,66,99768,64,243063
7277,0.000942,74.125.24.0-255,1125,100893,64,243063
7278,0.003262,74.125.24.0-255,4320,105213,64,243063
7279,0.003268,172.31.40.0-255,66,105279,64,243063
7280,0.005637,74.125.24.0-255,5738,111017,64,243063
7281,0.005641,172.31.40.0-255,66,111083,64,243063
7282,0.008013,74.125.24.0-255,5738,116821,64,243063
7283,0.00802,172.31.40.0-255,66,116887,64,243063
7284,0.010378,74.125.24.0-255,5738,122625,64,243063
7285,0.010385,172.31.40.0-255,66,122691,64,243063
7286,0.012753,74.125.24.0-255,5738,128429,64,243063
7287,0.01277,172.31.40.0-255,66,128495,64,243063
7288,0.01512,74.125.24.0-255,5738,134233,64,243063
7289,0.015134,172.31.40.0-255,66,134299,64,243063
7290,0.017525,74.125.24.0-255,5738,140037,64,243063
7291,0.017537,172.31.40.0-255,66,140103,64,243063
7292,0.019914,74.125.24.0-255,5738,145841,64,243063
7293,0.019924,172.31.40.0-255,66,145907,64,243063
7294,0.0223,74.125.24.0-255,5738,151645,64,243063
7295,0.022313,172.31.40.0-255,66,151711,64,243063
7296,0.024688,74.125.24.0-255,5738,157449,64,243063
7297,0.024695,172.31.40.0-255,66,157515,64,243063
7298,0.027097,74.125.24.0-255,5738,163253,64,243063
7299,0.027104,172.31.40.0-255,66,163319,64,243063
7300,0.029451,74.125.24.0-255,5738,169057,64,243063
7301,0.029458,172.31.40.0-255,66,169123,64,243063
7302,0.031807,74.125.24.0-255,5738,174861,64,243063
7303,0.031814,172.31.40.0-255,66,174927,64,243063
7304,0.034157,74.125.24.0-255,5738,180665,64,243063
7305,0.034165,172.31.40.0-255,66,180731,64,243063
7306,0.036499,74.125.24.0-255,5738,186469,64,243063
7307,0.036506,172.31.40.0-255,66,186535,64,243063
7308,0.038066,172.31.40.0-255,172,186707,64,243063
7309,0.038099,172.31.40.0-255,1112,187819,64,243063
7310,0.038157,172.31.40.0-255,1514,189333,64,243063
7311,0.038159,172.31.40.0-255,1296,190629,64,243063
7312,0.038846,74.125.24.0-255,5738,196367,64,243063
7313,0.038853,172.31.40.0-255,66,196433,64,243063
7314,0.039626,104.244.42.0-255,66,196499,64,243063
7315,0.039666,104.244.42.0-255,66,196565,64,243063
7316,0.039712,104.244.42.0-255,66,196631,64,243063
7317,0.041266,74.125.24.0-255,5738,202369,64,243063
7318,0.041272,172.31.40.0-255,66,202435,64,243063
7319,0.043648,74.125.24.0-255,5738,208173,64,243063
7320,0.043659,172.31.40.0-255,66,208239,64,243063
7321,0.046023,74.125.24.0-255,5738,213977,64,243063
7322,0.046035,172.31.40.0-255,66,214043,64,243063
7323,0.048389,74.125.24.0-255,5738,219781,64,243063
7324,0.048404,172.31.40.0-255,66,219847,64,243063
7325,0.050767,74.125.24.0-255,5738,225585,64,243063
7326,0.050781,172.31.40.0-255,66,225651,64,243063
7327,0.053156,74.125.24.0-255,5738,231389,64,243063
7328,0.053163,172.31.40.0-255,66,231455,64,243063
7329,0.055541,74.125.24.0-255,5738,237193,64,243063
7330,0.055549,172.31.40.0-255,66,237259,64,243063
7331,0.057898,74.125.24.0-255,5738,242997,64,243063
7332,0.057911,172.31.40.0-255,66,243063,64,243063
7333,0.0,172.217.194.0-255,143,143,64,203447
7334,3.3e-05,172.31.40.0-255,66,209,64,203447
7335,4e-05,172.217.194.0-255,1484,1693,64,203447
7336,4.5e-05,172.31.40.0-255,66,1759,64,203447
7337,4.9e-05,172.217.194.0-255,2902,4661,64,203447
7338,5.2e-05,172.31.40.0-255,66,4727,64,203447
7339,6.7e-05,172.217.194.0-255,7156,11883,64,203447
7340,7e-05,172.31.40.0-255,66,11949,64,203447
7341,7.4e-05,172.217.194.0-255,1911,13860,64,203447
7342,7.7e-05,172.31.40.0-255,66,13926,64,203447
7343,0.00031,172.217.194.0-255,1484,15410,64,203447
7344,0.000315,172.31.40.0-255,66,15476,64,203447
7345,0.000321,172.217.194.0-255,2902,18378,64,203447
7346,0.000324,172.31.40.0-255,66,18444,64,203447
7347,0.000337,172.217.194.0-255,5738,24182,64,203447
7348,0.00034,172.31.40.0-255,66,24248,64,203447
7349,0.000381,172.217.194.0-255,6797,31045,64,203447
7350,0.000385,172.31.40.0-255,66,31111,64,203447
7351,0.00046,172.217.194.0-255,1484,32595,64,203447
7352,0.000464,172.31.40.0-255,66,32661,64,203447
7353,0.000469,172.217.194.0-255,2902,35563,64,203447
7354,0.000473,172.31.40.0-255,66,35629,64,203447
7355,0.000495,172.217.194.0-255,5738,41367,64,203447
7356,0.000503,172.31.40.0-255,66,41433,64,203447
7357,0.000506,172.217.194.0-255,1484,42917,64,203447
7358,0.000508,172.31.40.0-255,66,42983,64,203447
7359,0.000552,172.31.40.0-255,66,43049,64,203447
7360,0.000588,172.31.40.0-255,66,43115,64,203447
7361,0.000626,172.217.194.0-255,1484,44599,64,203447
7362,0.00063,172.31.40.0-255,66,44665,64,203447
7363,0.000635,172.217.194.0-255,2902,47567,64,203447
7364,0.000639,172.31.40.0-255,66,47633,64,203447
7365,0.000662,172.217.194.0-255,5738,53371,64,203447
7366,0.000665,172.31.40.0-255,66,53437,64,203447
7367,0.000673,172.217.194.0-255,6797,60234,64,203447
7368,0.000676,172.31.40.0-255,66,60300,64,203447
7369,0.000689,172.217.194.0-255,4320,64620,64,203447
7370,0.000692,172.31.40.0-255,66,64686,64,203447
7371,0.000732,172.31.40.0-255,66,64752,64,203447
7372,0.000736,172.217.194.0-255,2819,67571,64,203447
7373,0.000738,172.31.40.0-255,66,67637,64,203447
7374,0.000811,172.217.194.0-255,1484,69121,64,203447
7375,0.000828,172.217.194.0-255,2902,72023,64,203447
7376,0.000832,172.31.40.0-255,66,72089,64,203447
7377,0.000838,172.217.194.0-255,5738,77827,64,203447
7378,0.000841,172.31.40.0-255,66,77893,64,203447
7379,0.000843,172.217.194.0-255,1484,79377,64,203447
7380,0.000883,172.31.40.0-255,66,79443,64,203447
7381,0.000888,172.31.40.0-255,66,79509,64,203447
7382,0.000941,172.217.194.0-255,1484,80993,64,203447
7383,0.000964,172.217.194.0-255,2902,83895,64,203447
7384,0.000968,172.31.40.0-255,66,83961,64,203447
7385,0.000973,172.217.194.0-255,5738,89699,64,203447
7386,0.000976,172.31.40.0-255,66,89765,64,203447
7387,0.000988,172.217.194.0-255,5738,95503,64,203447
7388,0.000991,172.31.40.0-255,66,95569,64,203447
7389,0.001029,172.217.194.0-255,5738,101307,64,203447
7390,0.001032,172.31.40.0-255,66,101373,64,203447
7391,0.001059,172.217.194.0-255,7156,108529,64,203447
7392,0.001062,172.31.40.0-255,66,108595,64,203447
7393,0.001068,172.217.194.0-255,5020,113615,64,203447
7394,0.00107,172.31.40.0-255,66,113681,64,203447
7395,0.001076,172.217.194.0-255,4320,118001,64,203447
7396,0.001078,172.31.40.0-255,66,118067,64,203447
7397,0.001083,172.217.194.0-255,5738,123805,64,203447
7398,0.001085,172.31.40.0-255,66,123871,64,203447
7399,0.001127,172.31.40.0-255,66,123937,64,203447
7400,0.001148,172.31.40.0-255,66,124003,64,203447
7401,0.00143,172.217.194.0-255,1484,125487,64,203447
7402,0.001436,172.217.194.0-255,2902,128389,64,203447
7403,0.00144,172.31.40.0-255,66,128455,64,203447
7404,0.001446,172.217.194.0-255,5738,134193,64,203447
7405,0.001448,172.31.40.0-255,66,134259,64,203447
7406,0.001467,172.217.194.0-255,4320,138579,64,203447
7407,0.00147,172.31.40.0-255,66,138645,64,203447
7408,0.001499,172.31.40.0-255,66,138711,64,203447
7409,0.00151,172.31.40.0-255,66,138777,64,203447
7410,0.001534,172.217.194.0-255,4320,143097,64,203447
7411,0.001537,172.31.40.0-255,66,143163,64,203447
7412,0.00157,172.217.194.0-255,5020,148183,64,203447
7413,0.001573,172.31.40.0-255,66,148249,64,203447
7414,0.001588,172.31.40.0-255,66,148315,64,203447
7415,0.001608,172.31.40.0-255,66,148381,64,203447
7416,0.001642,172.217.194.0-255,1484,149865,64,203447
7417,0.001648,172.217.194.0-255,2902,152767,64,203447
7418,0.001653,172.217.194.0-255,5738,158505,64,203447
7419,0.001653,172.31.40.0-255,66,158571,64,203447
7420,0.001658,172.31.40.0-255,66,158637,64,203447
7421,0.00168,172.217.194.0-255,4320,162957,64,203447
7422,0.001685,172.31.40.0-255,66,163023,64,203447
7423,0.001712,172.31.40.0-255,66,163089,64,203447
7424,0.001714,172.217.194.0-255,7156,170245,64,203447
7425,0.001736,172.31.40.0-255,66,170311,64,203447
7426,0.001746,172.217.194.0-255,3602,173913,64,203447
7427,0.00175,172.31.40.0-255,66,173979,64,203447
7428,0.001824,172.217.194.0-255,1484,175463,64,203447
7429,0.001829,172.217.194.0-255,2902,178365,64,203447
7430,0.001832,172.31.40.0-255,66,178431,64,203447
7431,0.00186,172.217.194.0-255,5738,184169,64,203447
7432,0.001872,172.31.40.0-255,66,184235,64,203447
7433,0.001894,172.217.194.0-255,1484,185719,64,203447
7434,0.001898,172.31.40.0-255,66,185785,64,203447
7435,0.001942,172.31.40.0-255,66,185851,64,203447
7436,0.00199,172.217.194.0-255,1484,187335,64,203447
7437,0.001996,172.217.194.0-255,2902,190237,64,203447
7438,0.002001,172.217.194.0-255,5738,195975,64,203447
7439,0.002016,172.31.40.0-255,66,196041,64,203447
7440,0.002022,172.31.40.0-255,66,196107,64,203447
7441,0.002049,172.31.40.0-255,66,196173,64,203447
7442,0.002067,172.31.40.0-255,66,196239,64,203447
7443,0.002113,172.31.40.0-255,66,196305,64,203447
7444,0.002121,172.217.194.0-255,1467,197772,64,203447
7445,0.002126,172.31.40.0-255,66,197838,64,203447
7446,0.002162,172.217.194.0-255,105,197943,64,203447
7447,0.003616,172.31.40.0-255,66,198009,64,203447
7448,0.003643,172.31.40.0-255,105,198114,64,203447
7449,0.005984,172.217.194.0-255,66,198180,64,203447
7450,0.049226,172.31.40.0-255,167,198347,64,203447
7451,0.049256,172.31.40.0-255,1111,199458,64,203447
7452,0.049298,172.31.40.0-255,1514,200972,64,203447
7453,0.0493,172.31.40.0-255,1514,202486,64,203447
7454,0.049301,172.31.40.0-255,697,203183,64,203447
7455,0.050776,104.244.42.0-255,66,203249,64,203447
7456,0.050789,104.244.42.0-255,66,203315,64,203447
7457,0.050853,104.244.42.0-255,66,203381,64,203447
7458,0.050859,104.244.42.0-255,66,203447,64,203447
7459,0.0,74.125.24.0-255,147,147,64,185118
7460,3.3e-05,172.31.40.0-255,66,213,64,185118
7461,4.2e-05,74.125.24.0-255,1484,1697,64,185118
7462,4.7e-05,172.31.40.0-255,66,1763,64,185118
7463,5.3e-05,74.125.24.0-255,2902,4665,64,185118
7464,5.6e-05,172.31.40.0-255,66,4731,64,185118
7465,6.6e-05,74.125.24.0-255,7156,11887,64,185118
7466,6.9e-05,172.31.40.0-255,66,11953,64,185118
7467,7.2e-05,74.125.24.0-255,2031,13984,64,185118
7468,7.5e-05,172.31.40.0-255,66,14050,64,185118
7469,0.000755,74.125.24.0-255,1484,15534,64,185118
7470,0.00076,172.31.40.0-255,66,15600,64,185118
7471,0.000779,74.125.24.0-255,2902,18502,64,185118
7472,0.000782,172.31.40.0-255,66,18568,64,185118
7473,0.000788,74.125.24.0-255,5738,24306,64,185118
7474,0.00079,172.31.40.0-255,66,24372,64,185118
7475,0.000811,74.125.24.0-255,4320,28692,64,185118
7476,0.000814,172.31.40.0-255,66,28758,64,185118
7477,0.000833,74.125.24.0-255,2543,31301,64,185118
7478,0.000837,172.31.40.0-255,66,31367,64,185118
7479,0.000872,74.125.24.0-255,1484,32851,64,185118
7480,0.000876,74.125.24.0-255,2902,35753,64,185118
7481,0.000877,172.31.40.0-255,66,35819,64,185118
7482,0.000879,74.125.24.0-255,1484,37303,64,185118
7483,0.000883,172.31.40.0-255,66,37369,64,185118
7484,0.000886,172.31.40.0-255,66,37435,64,185118
7485,0.000909,74.125.24.0-255,4320,41755,64,185118
7486,0.000913,172.31.40.0-255,66,41821,64,185118
7487,0.00092,74.125.24.0-255,6797,48618,64,185118
7488,0.000922,172.31.40.0-255,66,48684,64,185118
7489,0.003449,74.125.24.0-255,5738,54422,64,185118
7490,0.003455,172.31.40.0-255,66,54488,64,185118
7491,0.00602,74.125.24.0-255,5738,60226,64,185118
7492,0.006026,172.31.40.0-255,66,60292,64,185118
7493,0.008569,74.125.24.0-255,5738,66030,64,185118
7494,0.008575,172.31.40.0-255,66,66096,64,185118
7495,0.011114,74.125.24.0-255,5738,71834,64,185118
7496,0.011121,172.31.40.0-255,66,71900,64,185118
7497,0.013682,74.125.24.0-255,5738,77638,64,185118
7498,0.013693,172.31.40.0-255,66,77704,64,185118
7499,0.016237,74.125.24.0-255,5738,83442,64,185118
7500,0.016246,172.31.40.0-255,66,83508,64,185118
7501,0.018785,74.125.24.0-255,5738,89246,64,185118
7502,0.018792,172.31.40.0-255,66,89312,64,185118
7503,0.021323,74.125.24.0-255,5738,95050,64,185118
7504,0.021331,172.31.40.0-255,66,95116,64,185118
7505,0.021669,172.31.40.0-255,172,95288,64,185118
7506,0.02171,172.31.40.0-255,1112,96400,64,185118
7507,0.021781,172.31.40.0-255,1514,97914,64,185118
7508,0.021783,172.31.40.0-255,1298,99212,64,185118
7509,0.023218,104.244.42.0-255,66,99278,64,185118
7510,0.023237,104.244.42.0-255,66,99344,64,185118
7511,0.023303,104.244.42.0-255,66,99410,64,185118
7512,0.023865,74.125.24.0-255,4320,103730,64,185118
7513,0.023869,172.31.40.0-255,66,103796,64,185118
7514,0.023885,74.125.24.0-255,1484,105280,64,185118
7515,0.026409,74.125.24.0-255,4320,109600,64,185118
7516,0.026415,172.31.40.0-255,66,109666,64,185118
7517,0.02895,74.125.24.0-255,5738,115404,64,185118
7518,0.028957,172.31.40.0-255,66,115470,64,185118
7519,0.031491,74.125.24.0-255,5738,121208,64,185118
7520,0.031499,172.31.40.0-255,66,121274,64,185118
7521,0.03403,74.125.24.0-255,5738,127012,64,185118
7522,0.034034,172.31.40.0-255,66,127078,64,185118
7523,0.036573,74.125.24.0-255,5738,132816,64,185118
7524,0.03658,172.31.40.0-255,66,132882,64,185118
7525,0.039097,74.125.24.0-255,5738,138620,64,185118
7526,0.039102,172.31.40.0-255,66,138686,64,185118
7527,0.041632,74.125.24.0-255,5738,144424,64,185118
7528,0.041637,172.31.40.0-255,66,144490,64,185118
7529,0.044186,74.125.24.0-255,5738,150228,64,185118
7530,0.044192,172.31.40.0-255,66,150294,64,185118
7531,0.046714,74.125.24.0-255,5738,156032,64,185118
7532,0.046722,172.31.40.0-255,66,156098,64,185118
7533,0.049252,74.125.24.0-255,5738,161836,64,185118
7534,0.049257,172.31.40.0-255,66,161902,64,185118
7535,0.051814,74.125.24.0-255,5738,167640,64,185118
7536,0.051819,172.31.40.0-255,66,167706,64,185118
7537,0.054362,74.125.24.0-255,5738,173444,64,185118
7538,0.054368,172.31.40.0-255,66,173510,64,185118
7539,0.056874,74.125.24.0-255,5738,179248,64,185118
7540,0.056878,172.31.40.0-255,66,179314,64,185118
7541,0.059403,74.125.24.0-255,5738,185052,64,185118
7542,0.059408,172.31.40.0-255,66,185118,64,185118
7543,0.0,74.125.24.0-255,153,153,64,303233
7544,2.7e-05,172.31.40.0-255,66,219,64,303233
7545,3.6e-05,74.125.24.0-255,1484,1703,64,303233
7546,4.1e-05,172.31.40.0-255,66,1769,64,303233
7547,4.7e-05,74.125.24.0-255,2902,4671,64,303233
7548,5.1e-05,172.31.40.0-255,66,4737,64,303233
7549,6e-05,74.125.24.0-255,7156,11893,64,303233
7550,6.4e-05,172.31.40.0-255,66,11959,64,303233
7551,9.4e-05,74.125.24.0-255,1949,13908,64,303233
7552,9.7e-05,172.31.40.0-255,66,13974,64,303233
7553,0.000125,74.125.24.0-255,1484,15458,64,303233
7554,0.000128,172.31.40.0-255,66,15524,64,303233
7555,0.000133,74.125.24.0-255,2902,18426,64,303233
7556,0.000135,172.31.40.0-255,66,18492,64,303233
7557,0.000151,74.125.24.0-255,5738,24230,64,303233
7558,0.000154,172.31.40.0-255,66,24296,64,303233
7559,0.000176,74.125.24.0-255,2902,27198,64,303233
7560,0.000179,172.31.40.0-255,66,27264,64,303233
7561,0.000199,74.125.24.0-255,3961,31225,64,303233
7562,0.000202,172.31.40.0-255,66,31291,64,303233
7563,0.000451,74.125.24.0-255,1484,32775,64,303233
7564,0.000456,172.31.40.0-255,66,32841,64,303233
7565,0.000463,74.125.24.0-255,2902,35743,64,303233
7566,0.000465,172.31.40.0-255,66,35809,64,303233
7567,0.00047,74.125.24.0-255,2902,38711,64,303233
7568,0.000472,172.31.40.0-255,66,38777,64,303233
7569,0.000494,74.125.24.0-255,2902,41679,64,303233
7570,0.000496,172.31.40.0-255,66,41745,64,303233
7571,0.000499,74.125.24.0-255,1484,43229,64,303233
7572,0.000501,172.31.40.0-255,66,43295,64,303233
7573,0.000533,74.125.24.0-255,5379,48674,64,303233
7574,0.000535,172.31.40.0-255,66,48740,64,303233
7575,0.000555,74.125.24.0-255,5738,54478,64,303233
7576,0.000571,74.125.24.0-255,1484,55962,64,303233
7577,0.000607,74.125.24.0-255,426,56388,64,303233
7578,0.000632,172.31.40.0-255,66,56454,64,303233
7579,0.000684,74.125.24.0-255,348,56802,64,303233
7580,0.001003,74.125.24.0-255,1484,58286,64,303233
7581,0.001007,74.125.24.0-255,1484,59770,64,303233
7582,0.001021,74.125.24.0-255,1484,61254,64,303233
7583,0.001025,74.125.24.0-255,2902,64156,64,303233
7584,0.001028,172.31.40.0-255,66,64222,64,303233
7585,0.001034,172.31.40.0-255,66,64288,64,303233
7586,0.00105,74.125.24.0-255,2902,67190,64,303233
7587,0.00109,172.31.40.0-255,66,67256,64,303233
7588,0.001106,74.125.24.0-255,6797,74053,64,303233
7589,0.001134,74.125.24.0-255,2902,76955,64,303233
7590,0.001145,172.31.40.0-255,66,77021,64,303233
7591,0.001152,74.125.24.0-255,4320,81341,64,303233
7592,0.001161,172.31.40.0-255,66,81407,64,303233
7593,0.001195,74.125.24.0-255,1125,82532,64,303233
7594,0.001212,172.31.40.0-255,66,82598,64,303233
7595,0.001515,74.125.24.0-255,1484,84082,64,303233
7596,0.001522,74.125.24.0-255,2902,86984,64,303233
7597,0.001525,172.31.40.0-255,66,87050,64,303233
7598,0.001532,74.125.24.0-255,4320,91370,64,303233
7599,0.001547,74.125.24.0-255,1484,92854,64,303233
7600,0.001552,74.125.24.0-255,2902,95756,64,303233
7601,0.001558,172.31.40.0-255,66,95822,64,303233
7602,0.001596,172.31.40.0-255,66,95888,64,303233
7603,0.001611,172.31.40.0-255,66,95954,64,303233
7604,0.001626,74.125.24.0-255,2184,98138,64,303233
7605,0.001635,172.31.40.0-255,66,98204,64,303233
7606,0.00167,74.125.24.0-255,1484,99688,64,303233
7607,0.001689,74.125.24.0-255,2902,102590,64,303233
7608,0.001702,74.125.24.0-255,4320,106910,64,303233
7609,0.001706,172.31.40.0-255,66,106976,64,303233
7610,0.001714,74.125.24.0-255,1484,108460,64,303233
7611,0.00172,74.125.24.0-255,5738,114198,64,303233
7612,0.001734,74.125.24.0-255,5738,119936,64,303233
7613,0.001749,74.125.24.0-255,1484,121420,64,303233
7614,0.001754,74.125.24.0-255,2902,124322,64,303233
7615,0.001763,172.31.40.0-255,66,124388,64,303233
7616,0.001799,74.125.24.0-255,4320,128708,64,303233
7617,0.001805,172.31.40.0-255,66,128774,64,303233
7618,0.001845,74.125.24.0-255,5738,134512,64,303233
7619,0.00185,172.31.40.0-255,66,134578,64,303233
7620,0.001862,74.125.24.0-255,2184,136762,64,303233
7621,0.001883,172.31.40.0-255,66,136828,64,303233
7622,0.001902,74.125.24.0-255,1484,138312,64,303233
7623,0.00192,74.125.24.0-255,2902,141214,64,303233
7624,0.001925,74.125.24.0-255,2902,144116,64,303233
7625,0.001933,172.31.40.0-255,66,144182,64,303233
7626,0.001951,74.125.24.0-255,2902,147084,64,303233
7627,0.001975,172.31.40.0-255,66,147150,64,303233
7628,0.002,74.125.24.0-255,7156,154306,64,303233
7629,0.002007,172.31.40.0-255,66,154372,64,303233
7630,0.002041,74.125.24.0-255,5738,160110,64,303233
7631,0.002046,172.31.40.0-255,66,160176,64,303233
7632,0.002077,74.125.24.0-255,7156,167332,64,303233
7633,0.009155,172.31.40.0-255,66,167398,64,303233
7634,0.01116,74.125.24.0-255,1484,168882,64,303233
7635,0.011196,74.125.24.0-255,4320,173202,64,303233
7636,0.011206,172.31.40.0-255,66,173268,64,303233
7637,0.013292,74.125.24.0-255,5738,179006,64,303233
7638,0.016408,172.31.40.0-255,66,179072,64,303233
7639,0.018441,74.125.24.0-255,5738,184810,64,303233
7640,0.018458,172.31.40.0-255,66,184876,64,303233
7641,0.020477,74.125.24.0-255,5738,190614,64,303233
7642,0.020492,172.31.40.0-255,66,190680,64,303233
7643,0.022527,74.125.24.0-255,5738,196418,64,303233
7644,0.023921,172.31.40.0-255,66,196484,64,303233
7645,0.025956,74.125.24.0-255,5738,202222,64,303233
7646,0.025973,172.31.40.0-255,66,202288,64,303233
7647,0.027987,74.125.24.0-255,5738,208026,64,303233
7648,0.027999,172.31.40.0-255,66,208092,64,303233
7649,0.030035,74.125.24.0-255,5738,213830,64,303233
7650,0.030047,172.31.40.0-255,66,213896,64,303233
7651,0.032062,74.125.24.0-255,5738,219634,64,303233
7652,0.032073,172.31.40.0-255,66,219700,64,303233
7653,0.034137,74.125.24.0-255,5738,225438,64,303233
7654,0.034156,172.31.40.0-255,66,225504,64,303233
7655,0.036198,74.125.24.0-255,5738,231242,64,303233
7656,0.036214,172.31.40.0-255,66,231308,64,303233
7657,0.038253,74.125.24.0-255,5738,237046,64,303233
7658,0.038267,172.31.40.0-255,66,237112,64,303233
7659,0.040357,74.125.24.0-255,5738,242850,64,303233
7660,0.040377,172.31.40.0-255,66,242916,64,303233
7661,0.042412,74.125.24.0-255,5738,248654,64,303233
7662,0.042431,172.31.40.0-255,66,248720,64,303233
7663,0.044481,74.125.24.0-255,5738,254458,64,303233
7664,0.044499,172.31.40.0-255,66,254524,64,303233
7665,0.046565,74.125.24.0-255,5738,260262,64,303233
7666,0.046583,172.31.40.0-255,66,260328,64,303233
7667,0.048606,74.125.24.0-255,5738,266066,64,303233
7668,0.048618,172.31.40.0-255,66,266132,64,303233
7669,0.05065,74.125.24.0-255,5738,271870,64,303233
7670,0.050664,172.31.40.0-255,66,271936,64,303233
7671,0.052684,74.125.24.0-255,5738,277674,64,303233
7672,0.052703,172.31.40.0-255,66,277740,64,303233
7673,0.053129,172.31.40.0-255,172,277912,64,303233
7674,0.053163,172.31.40.0-255,1111,279023,64,303233
7675,0.053236,172.31.40.0-255,1514,280537,64,303233
7676,0.053238,172.31.40.0-255,1514,282051,64,303233
7677,0.05324,172.31.40.0-255,1514,283565,64,303233
7678,0.053241,172.31.40.0-255,1514,285079,64,303233
7679,0.053268,172.31.40.0-255,478,285557,64,303233
7680,0.054705,104.244.42.0-255,66,285623,64,303233
7681,0.054726,104.244.42.0-255,66,285689,64,303233
7682,0.054757,74.125.24.0-255,5738,291427,64,303233
7683,0.05477,172.31.40.0-255,66,291493,64,303233
7684,0.054807,104.244.42.0-255,66,291559,64,303233
7685,0.054812,104.244.42.0-255,66,291625,64,303233
7686,0.056813,74.125.24.0-255,5738,297363,64,303233
7687,0.05683,172.31.40.0-255,66,297429,64,303233
7688,0.058878,74.125.24.0-255,5738,303167,64,303233
7689,0.058901,172.31.40.0-255,66,303233,64,303233
7690,0.0,74.125.24.0-255,156,156,64,261902
7691,2.4e-05,172.31.40.0-255,66,222,64,261902
7692,3.2e-05,74.125.24.0-255,1484,1706,64,261902
7693,3.7e-05,172.31.40.0-255,66,1772,64,261902
7694,5e-05,74.125.24.0-255,2902,4674,64,261902
7695,5.4e-05,172.31.40.0-255,66,4740,64,261902
7696,6.1e-05,74.125.24.0-255,5738,10478,64,261902
7697,6.4e-05,172.31.40.0-255,66,10544,64,261902
7698,6.9e-05,74.125.24.0-255,2902,13446,64,261902
7699,7.2e-05,172.31.40.0-255,66,13512,64,261902
7700,9.1e-05,74.125.24.0-255,511,14023,64,261902
7701,9.4e-05,172.31.40.0-255,66,14089,64,261902
7702,0.000428,74.125.24.0-255,1484,15573,64,261902
7703,0.000434,172.31.40.0-255,66,15639,64,261902
7704,0.00044,74.125.24.0-255,2902,18541,64,261902
7705,0.000443,172.31.40.0-255,66,18607,64,261902
7706,0.000454,74.125.24.0-255,5738,24345,64,261902
7707,0.000457,172.31.40.0-255,66,24411,64,261902
7708,0.000499,74.125.24.0-255,6797,31208,64,261902
7709,0.000503,172.31.40.0-255,66,31274,64,261902
7710,0.000692,74.125.24.0-255,1484,32758,64,261902
7711,0.000696,172.31.40.0-255,66,32824,64,261902
7712,0.000701,74.125.24.0-255,2902,35726,64,261902
7713,0.000704,172.31.40.0-255,66,35792,64,261902
7714,0.000707,74.125.24.0-255,1484,37276,64,261902
7715,0.000713,172.31.40.0-255,66,37342,64,261902
7716,0.000745,74.125.24.0-255,4320,41662,64,261902
7717,0.000748,172.31.40.0-255,66,41728,64,261902
7718,0.000756,74.125.24.0-255,2902,44630,64,261902
7719,0.000759,172.31.40.0-255,66,44696,64,261902
7720,0.000783,74.125.24.0-255,3961,48657,64,261902
7721,0.000785,172.31.40.0-255,66,48723,64,261902
7722,0.001099,74.125.24.0-255,1484,50207,64,261902
7723,0.00111,74.125.24.0-255,2902,53109,64,261902
7724,0.001115,172.31.40.0-255,66,53175,64,261902
7725,0.001124,74.125.24.0-255,5738,58913,64,261902
7726,0.001126,172.31.40.0-255,66,58979,64,261902
7727,0.001159,74.125.24.0-255,5738,64717,64,261902
7728,0.001162,172.31.40.0-255,66,64783,64,261902
7729,0.00119,74.125.24.0-255,1474,66257,64,261902
7730,0.001429,74.125.24.0-255,1484,67741,64,261902
7731,0.001434,172.31.40.0-255,66,67807,64,261902
7732,0.001441,74.125.24.0-255,2902,70709,64,261902
7733,0.001443,172.31.40.0-255,66,70775,64,261902
7734,0.001455,74.125.24.0-255,5738,76513,64,261902
7735,0.001457,172.31.40.0-255,66,76579,64,261902
7736,0.001499,74.125.24.0-255,6797,83376,64,261902
7737,0.001502,172.31.40.0-255,66,83442,64,261902
7738,0.001839,74.125.24.0-255,1484,84926,64,261902
7739,0.001848,74.125.24.0-255,2902,87828,64,261902
7740,0.001853,172.31.40.0-255,66,87894,64,261902
7741,0.001861,74.125.24.0-255,5738,93632,64,261902
7742,0.001864,172.31.40.0-255,66,93698,64,261902
7743,0.001892,74.125.24.0-255,7059,100757,64,261902
7744,0.001895,172.31.40.0-255,66,100823,64,261902
7745,0.002087,74.125.24.0-255,1484,102307,64,261902
7746,0.002101,74.125.24.0-255,2902,105209,64,261902
7747,0.002104,172.31.40.0-255,66,105275,64,261902
7748,0.00211,74.125.24.0-255,4320,109595,64,261902
7749,0.002112,172.31.40.0-255,66,109661,64,261902
7750,0.002138,74.125.24.0-255,1484,111145,64,261902
7751,0.002167,74.125.24.0-255,6128,117273,64,261902
7752,0.00217,172.31.40.0-255,66,117339,64,261902
7753,0.004542,74.125.24.0-255,5738,123077,64,261902
7754,0.004548,172.31.40.0-255,66,123143,64,261902
7755,0.0069,74.125.24.0-255,5738,128881,64,261902
7756,0.006908,172.31.40.0-255,66,128947,64,261902
7757,0.00927,74.125.24.0-255,5738,134685,64,261902
7758,0.009281,172.31.40.0-255,66,134751,64,261902
7759,0.01163,74.125.24.0-255,5738,140489,64,261902
7760,0.011647,172.31.40.0-255,66,140555,64,261902
7761,0.014011,74.125.24.0-255,5738,146293,64,261902
7762,0.01402,172.31.40.0-255,66,146359,64,261902
7763,0.016371,74.125.24.0-255,5738,152097,64,261902
7764,0.016381,172.31.40.0-255,66,152163,64,261902
7765,0.018772,74.125.24.0-255,5738,157901,64,261902
7766,0.018784,172.31.40.0-255,66,157967,64,261902
7767,0.021126,74.125.24.0-255,5738,163705,64,261902
7768,0.021138,172.31.40.0-255,66,163771,64,261902
7769,0.023484,74.125.24.0-255,5738,169509,64,261902
7770,0.023494,172.31.40.0-255,66,169575,64,261902
7771,0.025843,74.125.24.0-255,5738,175313,64,261902
7772,0.025853,172.31.40.0-255,66,175379,64,261902
7773,0.028221,74.125.24.0-255,5738,181117,64,261902
7774,0.028232,172.31.40.0-255,66,181183,64,261902
7775,0.028867,172.31.40.0-255,167,181350,64,261902
7776,0.028897,172.31.40.0-255,1111,182461,64,261902
7777,0.028967,172.31.40.0-255,1514,183975,64,261902
7778,0.028969,172.31.40.0-255,1514,185489,64,261902
7779,0.02897,172.31.40.0-255,697,186186,64,261902
7780,0.030415,104.244.42.0-255,66,186252,64,261902
7781,0.030463,104.244.42.0-255,66,186318,64,261902
7782,0.030523,104.244.42.0-255,66,186384,64,261902
7783,0.030528,104.244.42.0-255,66,186450,64,261902
7784,0.030579,74.125.24.0-255,5738,192188,64,261902
7785,0.030585,172.31.40.0-255,66,192254,64,261902
7786,0.032945,74.125.24.0-255,5738,197992,64,261902
7787,0.032952,172.31.40.0-255,66,198058,64,261902
7788,0.035328,74.125.24.0-255,5738,203796,64,261902
7789,0.035335,172.31.40.0-255,66,203862,64,261902
7790,0.037681,74.125.24.0-255,5738,209600,64,261902
7791,0.03769,172.31.40.0-255,66,209666,64,261902
7792,0.040058,74.125.24.0-255,5738,215404,64,261902
7793,0.040073,172.31.40.0-255,66,215470,64,261902
7794,0.04241,74.125.24.0-255,5738,221208,64,261902
7795,0.042416,172.31.40.0-255,66,221274,64,261902
7796,0.044759,74.125.24.0-255,5738,227012,64,261902
7797,0.044766,172.31.40.0-255,66,227078,64,261902
7798,0.047151,74.125.24.0-255,5738,232816,64,261902
7799,0.047159,172.31.40.0-255,66,232882,64,261902
7800,0.049489,74.125.24.0-255,5738,238620,64,261902
7801,0.049495,172.31.40.0-255,66,238686,64,261902
7802,0.051857,74.125.24.0-255,5738,244424,64,261902
7803,0.051863,172.31.40.0-255,66,244490,64,261902
7804,0.054221,74.125.24.0-255,5738,250228,64,261902
7805,0.054228,172.31.40.0-255,66,250294,64,261902
7806,0.056593,74.125.24.0-255,5738,256032,64,261902
7807,0.056599,172.31.40.0-255,66,256098,64,261902
7808,0.058983,74.125.24.0-255,5738,261836,64,261902
7809,0.059006,172.31.40.0-255,66,261902,64,261902
7810,0.0,74.125.68.0-255,156,156,64,284633
7811,1.4e-05,172.31.40.0-255,66,222,64,284633
7812,2.1e-05,74.125.68.0-255,1484,1706,64,284633
7813,2.5e-05,172.31.40.0-255,66,1772,64,284633
7814,3e-05,74.125.68.0-255,2902,4674,64,284633
7815,3.3e-05,172.31.40.0-255,66,4740,64,284633
7816,5.4e-05,74.125.68.0-255,4320,9060,64,284633
7817,5.7e-05,172.31.40.0-255,66,9126,64,284633
7818,6.4e-05,74.125.68.0-255,4866,13992,64,284633
7819,6.6e-05,172.31.40.0-255,66,14058,64,284633
7820,9e-05,74.125.68.0-255,2902,16960,64,284633
7821,9.2e-05,172.31.40.0-255,66,17026,64,284633
7822,0.000121,172.31.40.0-255,66,17092,64,284633
7823,0.000148,74.125.68.0-255,5379,22471,64,284633
7824,0.000151,172.31.40.0-255,66,22537,64,284633
7825,0.00023,74.125.68.0-255,1484,24021,64,284633
7826,0.000233,172.31.40.0-255,66,24087,64,284633
7827,0.000254,74.125.68.0-255,2902,26989,64,284633
7828,0.000257,172.31.40.0-255,66,27055,64,284633
7829,0.000262,74.125.68.0-255,4320,31375,64,284633
7830,0.000265,172.31.40.0-255,66,31441,64,284633
7831,0.000294,74.125.68.0-255,1484,32925,64,284633
7832,0.000296,172.31.40.0-255,66,32991,64,284633
7833,0.000323,172.31.40.0-255,66,33057,64,284633
7834,0.00033,74.125.68.0-255,7156,40213,64,284633
7835,0.000332,172.31.40.0-255,66,40279,64,284633
7836,0.000358,74.125.68.0-255,2902,43181,64,284633
7837,0.00036,172.31.40.0-255,66,43247,64,284633
7838,0.000367,74.125.68.0-255,5652,48899,64,284633
7839,0.00037,172.31.40.0-255,66,48965,64,284633
7840,0.000373,74.125.68.0-255,131,49096,64,284633
7841,0.000456,74.125.68.0-255,348,49444,64,284633
7842,0.000792,74.125.68.0-255,1484,50928,64,284633
7843,0.000806,172.31.40.0-255,66,50994,64,284633
7844,0.000812,74.125.68.0-255,2902,53896,64,284633
7845,0.000814,172.31.40.0-255,66,53962,64,284633
7846,0.00082,74.125.68.0-255,5738,59700,64,284633
7847,0.000822,172.31.40.0-255,66,59766,64,284633
7848,0.000834,74.125.68.0-255,1484,61250,64,284633
7849,0.000858,172.31.40.0-255,66,61316,64,284633
7850,0.000872,74.125.68.0-255,4320,65636,64,284633
7851,0.000875,172.31.40.0-255,66,65702,64,284633
7852,0.000887,74.125.68.0-255,7156,72858,64,284633
7853,0.000889,172.31.40.0-255,66,72924,64,284633
7854,0.000893,74.125.68.0-255,2184,75108,64,284633
7855,0.000895,172.31.40.0-255,66,75174,64,284633
7856,0.001106,74.125.68.0-255,1484,76658,64,284633
7857,0.001112,74.125.68.0-255,2902,79560,64,284633
7858,0.001115,172.31.40.0-255,66,79626,64,284633
7859,0.001129,74.125.68.0-255,1484,81110,64,284633
7860,0.001143,74.125.68.0-255,2902,84012,64,284633
7861,0.001145,172.31.40.0-255,66,84078,64,284633
7862,0.001168,74.125.68.0-255,5738,89816,64,284633
7863,0.00117,172.31.40.0-255,66,89882,64,284633
7864,0.00121,172.31.40.0-255,66,89948,64,284633
7865,0.001245,74.125.68.0-255,5738,95686,64,284633
7866,0.001248,172.31.40.0-255,66,95752,64,284633
7867,0.001262,74.125.68.0-255,3602,99354,64,284633
7868,0.001265,172.31.40.0-255,66,99420,64,284633
7869,0.001355,74.125.68.0-255,1484,100904,64,284633
7870,0.001369,74.125.68.0-255,1484,102388,64,284633
7871,0.001373,172.31.40.0-255,66,102454,64,284633
7872,0.001387,74.125.68.0-255,1484,103938,64,284633
7873,0.001394,74.125.68.0-255,5738,109676,64,284633
7874,0.001397,172.31.40.0-255,66,109742,64,284633
7875,0.001422,74.125.68.0-255,7156,116898,64,284633
7876,0.001425,172.31.40.0-255,66,116964,64,284633
7877,0.001463,172.31.40.0-255,66,117030,64,284633
7878,0.001516,74.125.68.0-255,3602,120632,64,284633
7879,0.001518,172.31.40.0-255,66,120698,64,284633
7880,0.001656,74.125.68.0-255,1484,122182,64,284633
7881,0.00167,74.125.68.0-255,2902,125084,64,284633
7882,0.001673,172.31.40.0-255,66,125150,64,284633
7883,0.001697,74.125.68.0-255,5738,130888,64,284633
7884,0.001701,74.125.68.0-255,2902,133790,64,284633
7885,0.001705,74.125.68.0-255,4320,138110,64,284633
7886,0.001709,172.31.40.0-255,66,138176,64,284633
7887,0.001717,172.31.40.0-255,66,138242,64,284633
7888,0.00172,172.31.40.0-255,66,138308,64,284633
7889,0.001723,74.125.68.0-255,1484,139792,64,284633
7890,0.001747,74.125.68.0-255,7156,146948,64,284633
7891,0.001751,172.31.40.0-255,66,147014,64,284633
7892,0.001756,74.125.68.0-255,4320,151334,64,284633
7893,0.001758,172.31.40.0-255,66,151400,64,284633
7894,0.001778,74.125.68.0-255,2902,154302,64,284633
7895,0.001781,172.31.40.0-255,66,154368,64,284633
7896,0.001784,74.125.68.0-255,766,155134,64,284633
7897,0.001851,74.125.68.0-255,1484,156618,64,284633
7898,0.001854,172.31.40.0-255,66,156684,64,284633
7899,0.001859,74.125.68.0-255,2902,159586,64,284633
7900,0.001861,172.31.40.0-255,66,159652,64,284633
7901,0.001874,74.125.68.0-255,1484,161136,64,284633
7902,0.001887,74.125.68.0-255,4320,165456,64,284633
7903,0.001889,172.31.40.0-255,66,165522,64,284633
7904,0.001896,74.125.68.0-255,5738,171260,64,284633
7905,0.001898,172.31.40.0-255,66,171326,64,284633
7906,0.001909,74.125.68.0-255,1484,172810,64,284633
7907,0.001936,74.125.68.0-255,5738,178548,64,284633
7908,0.001939,172.31.40.0-255,66,178614,64,284633
7909,0.001942,74.125.68.0-255,1484,180098,64,284633
7910,0.001975,172.31.40.0-255,66,180164,64,284633
7911,0.002018,74.125.68.0-255,4320,184484,64,284633
7912,0.002024,172.31.40.0-255,66,184550,64,284633
7913,0.002044,74.125.68.0-255,1484,186034,64,284633
7914,0.002078,74.125.68.0-255,4320,190354,64,284633
7915,0.002081,74.125.68.0-255,766,191120,64,284633
7916,0.002122,74.125.68.0-255,4320,195440,64,284633
7917,0.002156,74.125.68.0-255,5738,201178,64,284633
7918,0.002195,74.125.68.0-255,4320,205498,64,284633
7919,0.002221,74.125.68.0-255,1484,206982,64,284633
7920,0.002284,74.125.68.0-255,1484,208466,64,284633
7921,0.002288,74.125.68.0-255,4320,212786,64,284633
7922,0.002338,74.125.68.0-255,5738,218524,64,284633
7923,0.002347,74.125.68.0-255,766,219290,64,284633
7924,0.002398,74.125.68.0-255,5738,225028,64,284633
7925,0.002411,74.125.68.0-255,1484,226512,64,284633
7926,0.002418,74.125.68.0-255,5738,232250,64,284633
7927,0.002424,74.125.68.0-255,7156,239406,64,284633
7928,0.002431,74.125.68.0-255,7156,246562,64,284633
7929,0.002443,74.125.68.0-255,3602,250164,64,284633
7930,0.00247,74.125.68.0-255,5738,255902,64,284633
7931,0.002494,74.125.68.0-255,5738,261640,64,284633
7932,0.002499,74.125.68.0-255,4320,265960,64,284633
7933,0.002526,74.125.68.0-255,4320,270280,64,284633
7934,0.002557,74.125.68.0-255,766,271046,64,284633
7935,0.007352,172.31.40.0-255,66,271112,64,284633
7936,0.007357,172.31.40.0-255,66,271178,64,284633
7937,0.00736,172.31.40.0-255,66,271244,64,284633
7938,0.007362,172.31.40.0-255,66,271310,64,284633
7939,0.007365,172.31.40.0-255,66,271376,64,284633
7940,0.007374,172.31.40.0-255,66,271442,64,284633
7941,0.007377,172.31.40.0-255,66,271508,64,284633
7942,0.00738,172.31.40.0-255,66,271574,64,284633
7943,0.007383,172.31.40.0-255,66,271640,64,284633
7944,0.007385,172.31.40.0-255,66,271706,64,284633
7945,0.007388,172.31.40.0-255,66,271772,64,284633
7946,0.007391,172.31.40.0-255,66,271838,64,284633
7947,0.007394,172.31.40.0-255,66,271904,64,284633
7948,0.007398,172.31.40.0-255,66,271970,64,284633
7949,0.0074,172.31.40.0-255,66,272036,64,284633
7950,0.007402,172.31.40.0-255,66,272102,64,284633
7951,0.007405,172.31.40.0-255,66,272168,64,284633
7952,0.007407,172.31.40.0-255,66,272234,64,284633
7953,0.00741,172.31.40.0-255,66,272300,64,284633
7954,0.007412,172.31.40.0-255,66,272366,64,284633
7955,0.007414,172.31.40.0-255,66,272432,64,284633
7956,0.007416,172.31.40.0-255,66,272498,64,284633
7957,0.009274,172.31.40.0-255,66,272564,64,284633
7958,0.009968,74.125.68.0-255,4320,276884,64,284633
7959,0.009975,172.31.40.0-255,66,276950,64,284633
7960,0.011811,74.125.68.0-255,1484,278434,64,284633
7961,0.0125,74.125.68.0-255,1143,279577,64,284633
7962,0.012507,172.31.40.0-255,66,279643,64,284633
7963,0.019602,172.31.40.0-255,105,279748,64,284633
7964,0.019652,172.31.40.0-255,105,279853,64,284633
7965,0.019885,172.31.40.0-255,90,279943,64,284633
7966,0.019896,172.31.40.0-255,66,280009,64,284633
7967,0.022107,74.125.68.0-255,66,280075,64,284633
7968,0.022141,74.125.68.0-255,66,280141,64,284633
7969,0.022377,74.125.68.0-255,66,280207,64,284633
7970,0.022396,74.125.68.0-255,66,280273,64,284633
7971,0.022404,172.31.40.0-255,66,280339,64,284633
7972,0.031306,172.31.40.0-255,172,280511,64,284633
7973,0.03148,172.31.40.0-255,1112,281623,64,284633
7974,0.031549,172.31.40.0-255,1514,283137,64,284633
7975,0.031551,172.31.40.0-255,1298,284435,64,284633
7976,0.032844,104.244.42.0-255,66,284501,64,284633
7977,0.033022,104.244.42.0-255,66,284567,64,284633
7978,0.033111,104.244.42.0-255,66,284633,64,284633
7979,0.0,172.217.194.0-255,153,153,64,270476
7980,3.4e-05,172.31.40.0-255,66,219,64,270476
7981,4e-05,172.217.194.0-255,1484,1703,64,270476
7982,4.5e-05,172.31.40.0-255,66,1769,64,270476
7983,5.8e-05,172.217.194.0-255,2902,4671,64,270476
7984,6.2e-05,172.31.40.0-255,66,4737,64,270476
7985,7e-05,172.217.194.0-255,7156,11893,64,270476
7986,7.5e-05,172.31.40.0-255,66,11959,64,270476
7987,8.7e-05,172.31.40.0-255,66,12025,64,270476
7988,0.0001,172.31.40.0-255,66,12091,64,270476
7989,0.000168,172.217.194.0-255,1484,13575,64,270476
7990,0.000172,172.31.40.0-255,66,13641,64,270476
7991,0.000177,172.217.194.0-255,2902,16543,64,270476
7992,0.000179,172.31.40.0-255,66,16609,64,270476
7993,0.000201,172.217.194.0-255,5738,22347,64,270476
7994,0.000204,172.31.40.0-255,66,22413,64,270476
7995,0.000238,172.217.194.0-255,4320,26733,64,270476
7996,0.00024,172.31.40.0-255,66,26799,64,270476
7997,0.000277,172.217.194.0-255,2902,29701,64,270476
7998,0.000281,172.31.40.0-255,66,29767,64,270476
7999,0.000299,172.31.40.0-255,66,29833,64,270476
8000,0.000303,172.217.194.0-255,2184,32017,64,270476
8001,0.000305,172.31.40.0-255,66,32083,64,270476
8002,0.000308,172.217.194.0-255,413,32496,64,270476
8003,0.00031,172.31.40.0-255,66,32562,64,270476
8004,0.00038,172.217.194.0-255,1484,34046,64,270476
8005,0.000383,172.31.40.0-255,66,34112,64,270476
8006,0.000411,172.217.194.0-255,2902,37014,64,270476
8007,0.000414,172.31.40.0-255,66,37080,64,270476
8008,0.00042,172.217.194.0-255,5738,42818,64,270476
8009,0.000467,172.217.194.0-255,7156,49974,64,270476
8010,0.000503,172.217.194.0-255,3602,53576,64,270476
8011,0.000591,172.31.40.0-255,66,53642,64,270476
8012,0.001075,172.217.194.0-255,1484,55126,64,270476
8013,0.001082,172.217.194.0-255,2902,58028,64,270476
8014,0.001085,172.31.40.0-255,66,58094,64,270476
8015,0.001092,172.217.194.0-255,5738,63832,64,270476
8016,0.001132,172.217.194.0-255,4320,68152,64,270476
8017,0.001134,172.217.194.0-255,1484,69636,64,270476
8018,0.001136,172.31.40.0-255,66,69702,64,270476
8019,0.001142,172.31.40.0-255,66,69768,64,270476
8020,0.001193,172.31.40.0-255,66,69834,64,270476
8021,0.001206,172.217.194.0-255,2902,72736,64,270476
8022,0.001227,172.31.40.0-255,66,72802,64,270476
8023,0.001238,172.217.194.0-255,4320,77122,64,270476
8024,0.001256,172.217.194.0-255,5738,82860,64,270476
8025,0.001263,172.31.40.0-255,66,82926,64,270476
8026,0.001285,172.217.194.0-255,766,83692,64,270476
8027,0.001311,172.217.194.0-255,1484,85176,64,270476
8028,0.001314,172.31.40.0-255,66,85242,64,270476
8029,0.001345,172.217.194.0-255,2902,88144,64,270476
8030,0.001352,172.217.194.0-255,5738,93882,64,270476
8031,0.001358,172.217.194.0-255,5738,99620,64,270476
8032,0.001369,172.31.40.0-255,66,99686,64,270476
8033,0.001385,172.217.194.0-255,7156,106842,64,270476
8034,0.001416,172.217.194.0-255,2184,109026,64,270476
8035,0.00143,172.31.40.0-255,66,109092,64,270476
8036,0.001516,172.217.194.0-255,1484,110576,64,270476
8037,0.001538,172.217.194.0-255,2902,113478,64,270476
8038,0.001542,172.217.194.0-255,1484,114962,64,270476
8039,0.001548,172.31.40.0-255,66,115028,64,270476
8040,0.00156,172.217.194.0-255,4320,119348,64,270476
8041,0.001573,172.217.194.0-255,2902,122250,64,270476
8042,0.001578,172.31.40.0-255,66,122316,64,270476
8043,0.001595,172.217.194.0-255,7156,129472,64,270476
8044,0.001615,172.217.194.0-255,2184,131656,64,270476
8045,0.001668,172.31.40.0-255,66,131722,64,270476
8046,0.001941,172.217.194.0-255,1484,133206,64,270476
8047,0.001948,172.217.194.0-255,2902,136108,64,270476
8048,0.001951,172.31.40.0-255,66,136174,64,270476
8049,0.001985,172.217.194.0-255,5738,141912,64,270476
8050,0.001989,172.217.194.0-255,1484,143396,64,270476
8051,0.001995,172.31.40.0-255,66,143462,64,270476
8052,0.00208,172.31.40.0-255,66,143528,64,270476
8053,0.002394,172.217.194.0-255,1484,145012,64,270476
8054,0.002398,172.217.194.0-255,1484,146496,64,270476
8055,0.002401,172.31.40.0-255,66,146562,64,270476
8056,0.00244,172.217.194.0-255,1484,148046,64,270476
8057,0.002446,172.217.194.0-255,5738,153784,64,270476
8058,0.002453,172.217.194.0-255,7156,160940,64,270476
8059,0.002476,172.217.194.0-255,2902,163842,64,270476
8060,0.002482,172.217.194.0-255,5738,169580,64,270476
8061,0.002487,172.31.40.0-255,66,169646,64,270476
8062,0.00251,172.217.194.0-255,5020,174666,64,270476
8063,0.002524,172.217.194.0-255,1484,176150,64,270476
8064,0.002536,172.31.40.0-255,66,176216,64,270476
8065,0.002557,172.217.194.0-255,7156,183372,64,270476
8066,0.002573,172.217.194.0-255,4320,187692,64,270476
8067,0.002577,172.31.40.0-255,66,187758,64,270476
8068,0.002582,172.31.40.0-255,66,187824,64,270476
8069,0.002596,172.217.194.0-255,2184,190008,64,270476
8070,0.002609,172.31.40.0-255,66,190074,64,270476
8071,0.00516,172.217.194.0-255,5738,195812,64,270476
8072,0.005166,172.31.40.0-255,66,195878,64,270476
8073,0.007701,172.217.194.0-255,5738,201616,64,270476
8074,0.008972,172.31.40.0-255,66,201682,64,270476
8075,0.011554,172.217.194.0-255,5738,207420,64,270476
8076,0.011563,172.31.40.0-255,66,207486,64,270476
8077,0.014098,172.217.194.0-255,5738,213224,64,270476
8078,0.014117,172.31.40.0-255,66,213290,64,270476
8079,0.016644,172.217.194.0-255,5738,219028,64,270476
8080,0.016653,172.31.40.0-255,66,219094,64,270476
8081,0.019201,172.217.194.0-255,5738,224832,64,270476
8082,0.019208,172.31.40.0-255,66,224898,64,270476
8083,0.021748,172.217.194.0-255,5738,230636,64,270476
8084,0.021755,172.31.40.0-255,66,230702,64,270476
8085,0.024302,172.217.194.0-255,5738,236440,64,270476
8086,0.024311,172.31.40.0-255,66,236506,64,270476
8087,0.026877,172.217.194.0-255,5738,242244,64,270476
8088,0.026885,172.31.40.0-255,66,242310,64,270476
8089,0.029431,172.217.194.0-255,5738,248048,64,270476
8090,0.029441,172.31.40.0-255,66,248114,64,270476
8091,0.032005,172.217.194.0-255,4320,252434,64,270476
8092,0.032013,172.31.40.0-255,66,252500,64,270476
8093,0.032043,172.217.194.0-255,1484,253984,64,270476
8094,0.034545,172.217.194.0-255,2902,256886,64,270476
8095,0.034552,172.31.40.0-255,66,256952,64,270476
8096,0.035071,172.31.40.0-255,172,257124,64,270476
8097,0.035102,172.31.40.0-255,1111,258235,64,270476
8098,0.035159,172.31.40.0-255,1514,259749,64,270476
8099,0.035161,172.31.40.0-255,1298,261047,64,270476
8100,0.036601,104.244.42.0-255,66,261113,64,270476
8101,0.036627,104.244.42.0-255,66,261179,64,270476
8102,0.036663,104.244.42.0-255,66,261245,64,270476
8103,0.037107,172.217.194.0-255,5738,266983,64,270476
8104,0.037148,172.31.40.0-255,66,267049,64,270476
8105,0.039677,172.217.194.0-255,3190,270239,64,270476
8106,0.039684,172.31.40.0-255,66,270305,64,270476
8107,0.039892,172.31.40.0-255,105,270410,64,270476
8108,0.042423,172.217.194.0-255,66,270476,64,270476
8109,0.0,74.125.24.0-255,150,150,64,255940
8110,2.3e-05,172.31.40.0-255,66,216,64,255940
8111,3e-05,74.125.24.0-255,1484,1700,64,255940
8112,3.5e-05,172.31.40.0-255,66,1766,64,255940
8113,4.9e-05,74.125.24.0-255,2902,4668,64,255940
8114,5.4e-05,172.31.40.0-255,66,4734,64,255940
8115,5.9e-05,74.125.24.0-255,2902,7636,64,255940
8116,6.2e-05,172.31.40.0-255,66,7702,64,255940
8117,7e-05,74.125.24.0-255,7156,14858,64,255940
8118,7.3e-05,172.31.40.0-255,66,14924,64,255940
8119,9.3e-05,74.125.24.0-255,3557,18481,64,255940
8120,0.000101,172.31.40.0-255,66,18547,64,255940
8121,0.000114,172.31.40.0-255,66,18613,64,255940
8122,0.000145,74.125.24.0-255,2543,21156,64,255940
8123,0.000148,172.31.40.0-255,66,21222,64,255940
8124,0.000191,74.125.24.0-255,1484,22706,64,255940
8125,0.000194,172.31.40.0-255,66,22772,64,255940
8126,0.000198,74.125.24.0-255,2902,25674,64,255940
8127,0.000201,172.31.40.0-255,66,25740,64,255940
8128,0.000204,74.125.24.0-255,1484,27224,64,255940
8129,0.000205,172.31.40.0-255,66,27290,64,255940
8130,0.000243,74.125.24.0-255,4320,31610,64,255940
8131,0.000246,172.31.40.0-255,66,31676,64,255940
8132,0.000253,74.125.24.0-255,6797,38473,64,255940
8133,0.000255,172.31.40.0-255,66,38539,64,255940
8134,0.000262,74.125.24.0-255,7156,45695,64,255940
8135,0.000265,172.31.40.0-255,66,45761,64,255940
8136,0.000303,74.125.24.0-255,7156,52917,64,255940
8137,0.000306,172.31.40.0-255,66,52983,64,255940
8138,0.00031,74.125.24.0-255,2815,55798,64,255940
8139,0.000313,172.31.40.0-255,66,55864,64,255940
8140,0.001367,74.125.24.0-255,130,55994,64,255940
8141,0.001413,74.125.24.0-255,1484,57478,64,255940
8142,0.001418,172.31.40.0-255,66,57544,64,255940
8143,0.001423,74.125.24.0-255,1484,59028,64,255940
8144,0.001446,74.125.24.0-255,1484,60512,64,255940
8145,0.001449,172.31.40.0-255,66,60578,64,255940
8146,0.001456,74.125.24.0-255,4320,64898,64,255940
8147,0.001458,172.31.40.0-255,66,64964,64,255940
8148,0.001482,74.125.24.0-255,2902,67866,64,255940
8149,0.001488,172.31.40.0-255,66,67932,64,255940
8150,0.001499,172.31.40.0-255,66,67998,64,255940
8151,0.001504,74.125.24.0-255,2902,70900,64,255940
8152,0.001506,172.31.40.0-255,66,70966,64,255940
8153,0.001548,172.31.40.0-255,66,71032,64,255940
8154,0.001552,74.125.24.0-255,766,71798,64,255940
8155,0.001945,74.125.24.0-255,1484,73282,64,255940
8156,0.001952,172.31.40.0-255,66,73348,64,255940
8157,0.001957,74.125.24.0-255,2902,76250,64,255940
8158,0.00196,172.31.40.0-255,66,76316,64,255940
8159,0.001966,74.125.24.0-255,5738,82054,64,255940
8160,0.001973,172.31.40.0-255,66,82120,64,255940
8161,0.001979,74.125.24.0-255,5738,87858,64,255940
8162,0.001981,172.31.40.0-255,66,87924,64,255940
8163,0.002025,74.125.24.0-255,7156,95080,64,255940
8164,0.002028,172.31.40.0-255,66,95146,64,255940
8165,0.00204,172.31.40.0-255,66,95212,64,255940
8166,0.002052,172.31.40.0-255,66,95278,64,255940
8167,0.002086,74.125.24.0-255,2902,98180,64,255940
8168,0.002088,172.31.40.0-255,66,98246,64,255940
8169,0.002101,172.31.40.0-255,66,98312,64,255940
8170,0.002132,74.125.24.0-255,1484,99796,64,255940
8171,0.002174,172.31.40.0-255,66,99862,64,255940
8172,0.002187,172.31.40.0-255,66,99928,64,255940
8173,0.002197,172.31.40.0-255,66,99994,64,255940
8174,0.002223,74.125.24.0-255,1484,101478,64,255940
8175,0.002257,172.31.40.0-255,66,101544,64,255940
8176,0.002287,74.125.24.0-255,2184,103728,64,255940
8177,0.002289,172.31.40.0-255,66,103794,64,255940
8178,0.002309,172.31.40.0-255,66,103860,64,255940
8179,0.002314,74.125.24.0-255,3602,107462,64,255940
8180,0.002316,172.31.40.0-255,66,107528,64,255940
8181,0.002322,74.125.24.0-255,4320,111848,64,255940
8182,0.002324,172.31.40.0-255,66,111914,64,255940
8183,0.002368,172.31.40.0-255,66,111980,64,255940
8184,0.002384,172.31.40.0-255,66,112046,64,255940
8185,0.004666,74.125.24.0-255,2902,114948,64,255940
8186,0.00467,172.31.40.0-255,66,115014,64,255940
8187,0.004691,74.125.24.0-255,2902,117916,64,255940
8188,0.004694,172.31.40.0-255,66,117982,64,255940
8189,0.007005,74.125.24.0-255,5738,123720,64,255940
8190,0.007014,172.31.40.0-255,66,123786,64,255940
8191,0.009322,74.125.24.0-255,5738,129524,64,255940
8192,0.009343,172.31.40.0-255,66,129590,64,255940
8193,0.011641,74.125.24.0-255,5738,135328,64,255940
8194,0.011658,172.31.40.0-255,66,135394,64,255940
8195,0.013956,74.125.24.0-255,5738,141132,64,255940
8196,0.013964,172.31.40.0-255,66,141198,64,255940
8197,0.016279,74.125.24.0-255,5738,146936,64,255940
8198,0.016293,172.31.40.0-255,66,147002,64,255940
8199,0.018602,74.125.24.0-255,5738,152740,64,255940
8200,0.018617,172.31.40.0-255,66,152806,64,255940
8201,0.020899,74.125.24.0-255,5738,158544,64,255940
8202,0.02091,172.31.40.0-255,66,158610,64,255940
8203,0.023219,74.125.24.0-255,5738,164348,64,255940
8204,0.023227,172.31.40.0-255,66,164414,64,255940
8205,0.025583,74.125.24.0-255,5738,170152,64,255940
8206,0.025592,172.31.40.0-255,66,170218,64,255940
8207,0.02788,74.125.24.0-255,5738,175956,64,255940
8208,0.02789,172.31.40.0-255,66,176022,64,255940
8209,0.030178,74.125.24.0-255,5738,181760,64,255940
8210,0.030184,172.31.40.0-255,66,181826,64,255940
8211,0.032501,74.125.24.0-255,5738,187564,64,255940
8212,0.032507,172.31.40.0-255,66,187630,64,255940
8213,0.034786,74.125.24.0-255,5738,193368,64,255940
8214,0.034794,172.31.40.0-255,66,193434,64,255940
8215,0.03708,74.125.24.0-255,5738,199172,64,255940
8216,0.037087,172.31.40.0-255,66,199238,64,255940
8217,0.039378,74.125.24.0-255,5738,204976,64,255940
8218,0.039386,172.31.40.0-255,66,205042,64,255940
8219,0.041686,74.125.24.0-255,5738,210780,64,255940
8220,0.041701,172.31.40.0-255,66,210846,64,255940
8221,0.044031,74.125.24.0-255,5738,216584,64,255940
8222,0.044045,172.31.40.0-255,66,216650,64,255940
8223,0.046341,74.125.24.0-255,5738,222388,64,255940
8224,0.046348,172.31.40.0-255,66,222454,64,255940
8225,0.048658,74.125.24.0-255,5738,228192,64,255940
8226,0.048675,172.31.40.0-255,66,228258,64,255940
8227,0.050096,172.31.40.0-255,172,228430,64,255940
8228,0.050129,172.31.40.0-255,1113,229543,64,255940
8229,0.05019,172.31.40.0-255,1514,231057,64,255940
8230,0.050192,172.31.40.0-255,1295,232352,64,255940
8231,0.050956,74.125.24.0-255,5738,238090,64,255940
8232,0.050962,172.31.40.0-255,66,238156,64,255940
8233,0.051624,104.244.42.0-255,66,238222,64,255940
8234,0.051718,104.244.42.0-255,66,238288,64,255940
8235,0.05178,104.244.42.0-255,66,238354,64,255940
8236,0.05251,104.244.42.0-255,108,238462,64,255940
8237,0.052518,172.31.40.0-255,66,238528,64,255940
8238,0.053272,74.125.24.0-255,5738,244266,64,255940
8239,0.053278,172.31.40.0-255,66,244332,64,255940
8240,0.055611,74.125.24.0-255,5738,250070,64,255940
8241,0.055625,172.31.40.0-255,66,250136,64,255940
8242,0.057964,74.125.24.0-255,5738,255874,64,255940
8243,0.05798,172.31.40.0-255,66,255940,64,255940
8244,0.0,74.125.200.0-255,153,153,64,260767
8245,1.8e-05,172.31.40.0-255,66,219,64,260767
8246,2.5e-05,74.125.200.0-255,1484,1703,64,260767
8247,2.9e-05,172.31.40.0-255,66,1769,64,260767
8248,3.5e-05,74.125.200.0-255,2902,4671,64,260767
8249,3.8e-05,172.31.40.0-255,66,4737,64,260767
8250,4.6e-05,74.125.200.0-255,7156,11893,64,260767
8251,4.8e-05,172.31.40.0-255,66,11959,64,260767
8252,0.000115,74.125.200.0-255,2040,13999,64,260767
8253,0.000119,172.31.40.0-255,66,14065,64,260767
8254,0.000783,74.125.200.0-255,1484,15549,64,260767
8255,0.000791,172.31.40.0-255,66,15615,64,260767
8256,0.000828,74.125.200.0-255,2902,18517,64,260767
8257,0.000831,172.31.40.0-255,66,18583,64,260767
8258,0.000838,74.125.200.0-255,4320,22903,64,260767
8259,0.00084,172.31.40.0-255,66,22969,64,260767
8260,0.000873,74.125.200.0-255,7156,30125,64,260767
8261,0.000875,172.31.40.0-255,66,30191,64,260767
8262,0.000893,74.125.200.0-255,1125,31316,64,260767
8263,0.000896,172.31.40.0-255,66,31382,64,260767
8264,0.00094,74.125.200.0-255,2902,34284,64,260767
8265,0.000943,172.31.40.0-255,66,34350,64,260767
8266,0.000966,74.125.200.0-255,5738,40088,64,260767
8267,0.000969,172.31.40.0-255,66,40154,64,260767
8268,0.001027,74.125.200.0-255,2902,43056,64,260767
8269,0.00103,172.31.40.0-255,66,43122,64,260767
8270,0.001063,74.125.200.0-255,2902,46024,64,260767
8271,0.001067,172.31.40.0-255,66,46090,64,260767
8272,0.001085,74.125.200.0-255,2543,48633,64,260767
8273,0.001088,172.31.40.0-255,66,48699,64,260767
8274,0.001491,74.125.200.0-255,1484,50183,64,260767
8275,0.001497,172.31.40.0-255,66,50249,64,260767
8276,0.001502,74.125.200.0-255,1484,51733,64,260767
8277,0.001516,74.125.200.0-255,1484,53217,64,260767
8278,0.001519,172.31.40.0-255,66,53283,64,260767
8279,0.001524,74.125.200.0-255,2902,56185,64,260767
8280,0.001526,172.31.40.0-255,66,56251,64,260767
8281,0.001555,74.125.200.0-255,4320,60571,64,260767
8282,0.001558,172.31.40.0-255,66,60637,64,260767
8283,0.0016,74.125.200.0-255,5379,66016,64,260767
8284,0.001603,172.31.40.0-255,66,66082,64,260767
8285,0.001664,74.125.200.0-255,1484,67566,64,260767
8286,0.001678,74.125.200.0-255,2902,70468,64,260767
8287,0.001681,172.31.40.0-255,66,70534,64,260767
8288,0.0017,74.125.200.0-255,1484,72018,64,260767
8289,0.001715,74.125.200.0-255,4320,76338,64,260767
8290,0.001717,172.31.40.0-255,66,76404,64,260767
8291,0.00175,74.125.200.0-255,2902,79306,64,260767
8292,0.001753,172.31.40.0-255,66,79372,64,260767
8293,0.001771,74.125.200.0-255,2902,82274,64,260767
8294,0.001773,172.31.40.0-255,66,82340,64,260767
8295,0.001811,74.125.200.0-255,2902,85242,64,260767
8296,0.001814,172.31.40.0-255,66,85308,64,260767
8297,0.001837,74.125.200.0-255,3961,89269,64,260767
8298,0.001839,172.31.40.0-255,66,89335,64,260767
8299,0.001883,74.125.200.0-255,1484,90819,64,260767
8300,0.001901,74.125.200.0-255,4320,95139,64,260767
8301,0.001903,172.31.40.0-255,66,95205,64,260767
8302,0.001925,74.125.200.0-255,5379,100584,64,260767
8303,0.001928,172.31.40.0-255,66,100650,64,260767
8304,0.001992,74.125.200.0-255,1484,102134,64,260767
8305,0.002013,74.125.200.0-255,2902,105036,64,260767
8306,0.002015,172.31.40.0-255,66,105102,64,260767
8307,0.002046,74.125.200.0-255,5738,110840,64,260767
8308,0.002049,172.31.40.0-255,66,110906,64,260767
8309,0.002101,74.125.200.0-255,6683,117589,64,260767
8310,0.002104,172.31.40.0-255,66,117655,64,260767
8311,0.002495,74.125.200.0-255,1484,119139,64,260767
8312,0.002523,74.125.200.0-255,2902,122041,64,260767
8313,0.002525,74.125.200.0-255,1484,123525,64,260767
8314,0.002552,74.125.200.0-255,2902,126427,64,260767
8315,0.002584,74.125.200.0-255,5738,132165,64,260767
8316,0.002624,74.125.200.0-255,1484,133649,64,260767
8317,0.002637,74.125.200.0-255,1248,134897,64,260767
8318,0.003777,172.31.40.0-255,66,134963,64,260767
8319,0.006366,74.125.200.0-255,5738,140701,64,260767
8320,0.006372,172.31.40.0-255,66,140767,64,260767
8321,0.008963,74.125.200.0-255,5738,146505,64,260767
8322,0.008972,172.31.40.0-255,66,146571,64,260767
8323,0.011591,74.125.200.0-255,5738,152309,64,260767
8324,0.0116,172.31.40.0-255,66,152375,64,260767
8325,0.014193,74.125.200.0-255,5738,158113,64,260767
8326,0.014202,172.31.40.0-255,66,158179,64,260767
8327,0.016789,74.125.200.0-255,5738,163917,64,260767
8328,0.016796,172.31.40.0-255,66,163983,64,260767
8329,0.01938,74.125.200.0-255,5738,169721,64,260767
8330,0.019387,172.31.40.0-255,66,169787,64,260767
8331,0.021971,74.125.200.0-255,5738,175525,64,260767
8332,0.02198,172.31.40.0-255,66,175591,64,260767
8333,0.024565,74.125.200.0-255,5738,181329,64,260767
8334,0.024572,172.31.40.0-255,66,181395,64,260767
8335,0.025019,172.31.40.0-255,172,181567,64,260767
8336,0.025049,172.31.40.0-255,1112,182679,64,260767
8337,0.0251,172.31.40.0-255,1514,184193,64,260767
8338,0.025102,172.31.40.0-255,1514,185707,64,260767
8339,0.025125,172.31.40.0-255,696,186403,64,260767
8340,0.026571,104.244.42.0-255,66,186469,64,260767
8341,0.026608,104.244.42.0-255,66,186535,64,260767
8342,0.026657,104.244.42.0-255,66,186601,64,260767
8343,0.026662,104.244.42.0-255,66,186667,64,260767
8344,0.027171,74.125.200.0-255,5738,192405,64,260767
8345,0.027178,172.31.40.0-255,66,192471,64,260767
8346,0.029769,74.125.200.0-255,5738,198209,64,260767
8347,0.029776,172.31.40.0-255,66,198275,64,260767
8348,0.03239,74.125.200.0-255,5738,204013,64,260767
8349,0.032396,172.31.40.0-255,66,204079,64,260767
8350,0.034999,74.125.200.0-255,5738,209817,64,260767
8351,0.035004,172.31.40.0-255,66,209883,64,260767
8352,0.037603,74.125.200.0-255,5738,215621,64,260767
8353,0.037609,172.31.40.0-255,66,215687,64,260767
8354,0.040204,74.125.200.0-255,5738,221425,64,260767
8355,0.04021,172.31.40.0-255,66,221491,64,260767
8356,0.042826,74.125.200.0-255,5738,227229,64,260767
8357,0.042833,172.31.40.0-255,66,227295,64,260767
8358,0.045423,74.125.200.0-255,5738,233033,64,260767
8359,0.045429,172.31.40.0-255,66,233099,64,260767
8360,0.04801,74.125.200.0-255,4320,237419,64,260767
8361,0.048019,172.31.40.0-255,66,237485,64,260767
8362,0.048039,74.125.200.0-255,1484,238969,64,260767
8363,0.050615,74.125.200.0-255,4320,243289,64,260767
8364,0.050624,172.31.40.0-255,66,243355,64,260767
8365,0.0532,74.125.200.0-255,5738,249093,64,260767
8366,0.053208,172.31.40.0-255,66,249159,64,260767
8367,0.055819,74.125.200.0-255,5738,254897,64,260767
8368,0.055826,172.31.40.0-255,66,254963,64,260767
8369,0.058415,74.125.200.0-255,5738,260701,64,260767
8370,0.05843,172.31.40.0-255,66,260767,64,260767
8371,0.0,172.217.194.0-255,153,153,64,249989
8372,3.1e-05,172.31.40.0-255,66,219,64,249989
8373,3.9e-05,172.217.194.0-255,1484,1703,64,249989
8374,4.4e-05,172.31.40.0-255,66,1769,64,249989
8375,5e-05,172.217.194.0-255,2902,4671,64,249989
8376,5.4e-05,172.31.40.0-255,66,4737,64,249989
8377,6.1e-05,172.217.194.0-255,7156,11893,64,249989
8378,6.4e-05,172.31.40.0-255,66,11959,64,249989
8379,6.8e-05,172.217.194.0-255,1992,13951,64,249989
8380,7.1e-05,172.31.40.0-255,66,14017,64,249989
8381,0.000108,172.31.40.0-255,66,14083,64,249989
8382,0.000114,172.217.194.0-255,5379,19462,64,249989
8383,0.000117,172.31.40.0-255,66,19528,64,249989
8384,0.000223,172.217.194.0-255,1484,21012,64,249989
8385,0.000226,172.31.40.0-255,66,21078,64,249989
8386,0.00023,172.217.194.0-255,2902,23980,64,249989
8387,0.000232,172.31.40.0-255,66,24046,64,249989
8388,0.000245,172.217.194.0-255,2902,26948,64,249989
8389,0.000248,172.31.40.0-255,66,27014,64,249989
8390,0.000267,172.217.194.0-255,2902,29916,64,249989
8391,0.000269,172.31.40.0-255,66,29982,64,249989
8392,0.000274,172.217.194.0-255,4320,34302,64,249989
8393,0.000276,172.31.40.0-255,66,34368,64,249989
8394,0.000303,172.217.194.0-255,1484,35852,64,249989
8395,0.000304,172.31.40.0-255,66,35918,64,249989
8396,0.000325,172.217.194.0-255,5738,41656,64,249989
8397,0.000327,172.31.40.0-255,66,41722,64,249989
8398,0.000355,172.217.194.0-255,5379,47101,64,249989
8399,0.000357,172.31.40.0-255,66,47167,64,249989
8400,0.000364,172.217.194.0-255,7086,54253,64,249989
8401,0.000366,172.31.40.0-255,66,54319,64,249989
8402,0.000394,172.217.194.0-255,366,54685,64,249989
8403,0.000588,172.217.194.0-255,1484,56169,64,249989
8404,0.000594,172.217.194.0-255,2902,59071,64,249989
8405,0.000627,172.217.194.0-255,5738,64809,64,249989
8406,0.000634,172.217.194.0-255,7156,71965,64,249989
8407,0.000665,172.217.194.0-255,2902,74867,64,249989
8408,0.000676,172.31.40.0-255,66,74933,64,249989
8409,0.000689,172.217.194.0-255,5738,80671,64,249989
8410,0.00072,172.31.40.0-255,66,80737,64,249989
8411,0.001802,172.217.194.0-255,1484,82221,64,249989
8412,0.001811,172.217.194.0-255,2902,85123,64,249989
8413,0.001815,172.31.40.0-255,66,85189,64,249989
8414,0.001821,172.217.194.0-255,2902,88091,64,249989
8415,0.001839,172.217.194.0-255,2902,90993,64,249989
8416,0.001884,172.217.194.0-255,1484,92477,64,249989
8417,0.0019,172.217.194.0-255,3602,96079,64,249989
8418,0.004546,172.31.40.0-255,66,96145,64,249989
8419,0.006553,172.217.194.0-255,5738,101883,64,249989
8420,0.00656,172.31.40.0-255,66,101949,64,249989
8421,0.008654,172.217.194.0-255,4320,106269,64,249989
8422,0.00866,172.31.40.0-255,66,106335,64,249989
8423,0.008675,172.217.194.0-255,1484,107819,64,249989
8424,0.010666,172.217.194.0-255,4320,112139,64,249989
8425,0.012037,172.31.40.0-255,66,112205,64,249989
8426,0.014054,172.217.194.0-255,5738,117943,64,249989
8427,0.014063,172.31.40.0-255,66,118009,64,249989
8428,0.016099,172.217.194.0-255,5738,123747,64,249989
8429,0.016107,172.31.40.0-255,66,123813,64,249989
8430,0.018118,172.217.194.0-255,5738,129551,64,249989
8431,0.018132,172.31.40.0-255,66,129617,64,249989
8432,0.020123,172.217.194.0-255,5738,135355,64,249989
8433,0.020129,172.31.40.0-255,66,135421,64,249989
8434,0.022152,172.217.194.0-255,5738,141159,64,249989
8435,0.022168,172.31.40.0-255,66,141225,64,249989
8436,0.024141,172.217.194.0-255,5738,146963,64,249989
8437,0.024148,172.31.40.0-255,66,147029,64,249989
8438,0.026156,172.217.194.0-255,5738,152767,64,249989
8439,0.026164,172.31.40.0-255,66,152833,64,249989
8440,0.028202,172.217.194.0-255,5738,158571,64,249989
8441,0.028217,172.31.40.0-255,66,158637,64,249989
8442,0.030208,172.217.194.0-255,5738,164375,64,249989
8443,0.030217,172.31.40.0-255,66,164441,64,249989
8444,0.032213,172.217.194.0-255,5738,170179,64,249989
8445,0.032219,172.31.40.0-255,66,170245,64,249989
8446,0.033338,172.31.40.0-255,172,170417,64,249989
8447,0.033365,172.31.40.0-255,1112,171529,64,249989
8448,0.033412,172.31.40.0-255,1514,173043,64,249989
8449,0.033414,172.31.40.0-255,1296,174339,64,249989
8450,0.034232,172.217.194.0-255,5738,180077,64,249989
8451,0.034239,172.31.40.0-255,66,180143,64,249989
8452,0.034896,104.244.42.0-255,66,180209,64,249989
8453,0.034935,104.244.42.0-255,66,180275,64,249989
8454,0.034979,104.244.42.0-255,66,180341,64,249989
8455,0.036255,172.217.194.0-255,5738,186079,64,249989
8456,0.036266,172.31.40.0-255,66,186145,64,249989
8457,0.038307,172.217.194.0-255,5738,191883,64,249989
8458,0.038322,172.31.40.0-255,66,191949,64,249989
8459,0.040336,172.217.194.0-255,5738,197687,64,249989
8460,0.040352,172.31.40.0-255,66,197753,64,249989
8461,0.042405,172.217.194.0-255,5738,203491,64,249989
8462,0.04242,172.31.40.0-255,66,203557,64,249989
8463,0.044426,172.217.194.0-255,5738,209295,64,249989
8464,0.044441,172.31.40.0-255,66,209361,64,249989
8465,0.046457,172.217.194.0-255,5738,215099,64,249989
8466,0.046472,172.31.40.0-255,66,215165,64,249989
8467,0.0485,172.217.194.0-255,5738,220903,64,249989
8468,0.048517,172.31.40.0-255,66,220969,64,249989
8469,0.050509,172.217.194.0-255,5738,226707,64,249989
8470,0.050522,172.31.40.0-255,66,226773,64,249989
8471,0.052546,172.217.194.0-255,5738,232511,64,249989
8472,0.052557,172.31.40.0-255,66,232577,64,249989
8473,0.054585,172.217.194.0-255,5738,238315,64,249989
8474,0.054601,172.31.40.0-255,66,238381,64,249989
8475,0.056632,172.217.194.0-255,5738,244119,64,249989
8476,0.056651,172.31.40.0-255,66,244185,64,249989
8477,0.059008,172.217.194.0-255,5738,249923,64,249989
8478,0.059026,172.31.40.0-255,66,249989,64,249989
8479,0.0,172.31.40.0-255,105,105,64,459
8480,0.000264,172.31.40.0-255,90,195,64,459
8481,0.000275,172.31.40.0-255,66,261,64,459
8482,0.003365,172.217.194.0-255,66,327,64,459
8483,0.003393,172.217.194.0-255,66,393,64,459
8484,0.003418,172.31.40.0-255,66,459,64,459
8485,0.0,74.125.24.0-255,150,150,64,363231
8486,2.1e-05,172.31.40.0-255,66,216,64,363231
8487,4.5e-05,74.125.24.0-255,1484,1700,64,363231
8488,4.9e-05,172.31.40.0-255,66,1766,64,363231
8489,5.5e-05,74.125.24.0-255,2902,4668,64,363231
8490,5.9e-05,172.31.40.0-255,66,4734,64,363231
8491,6.2e-05,74.125.24.0-255,1484,6218,64,363231
8492,6.4e-05,172.31.40.0-255,66,6284,64,363231
8493,8.4e-05,74.125.24.0-255,4320,10604,64,363231
8494,8.7e-05,172.31.40.0-255,66,10670,64,363231
8495,9.4e-05,74.125.24.0-255,6275,16945,64,363231
8496,9.7e-05,172.31.40.0-255,66,17011,64,363231
8497,0.000104,74.125.24.0-255,7156,24167,64,363231
8498,0.000107,172.31.40.0-255,66,24233,64,363231
8499,0.000133,74.125.24.0-255,6797,31030,64,363231
8500,0.000135,172.31.40.0-255,66,31096,64,363231
8501,0.000191,74.125.24.0-255,1484,32580,64,363231
8502,0.000194,172.31.40.0-255,66,32646,64,363231
8503,0.00021,74.125.24.0-255,2902,35548,64,363231
8504,0.000212,172.31.40.0-255,66,35614,64,363231
8505,0.000217,74.125.24.0-255,2902,38516,64,363231
8506,0.000219,172.31.40.0-255,66,38582,64,363231
8507,0.000239,74.125.24.0-255,2902,41484,64,363231
8508,0.000242,172.31.40.0-255,66,41550,64,363231
8509,0.000244,74.125.24.0-255,1484,43034,64,363231
8510,0.000246,172.31.40.0-255,66,43100,64,363231
8511,0.000251,74.125.24.0-255,2902,46002,64,363231
8512,0.000253,172.31.40.0-255,66,46068,64,363231
8513,0.000256,74.125.24.0-255,1484,47552,64,363231
8514,0.000258,172.31.40.0-255,66,47618,64,363231
8515,0.00029,74.125.24.0-255,5379,52997,64,363231
8516,0.000292,172.31.40.0-255,66,53063,64,363231
8517,0.000297,74.125.24.0-255,4320,57383,64,363231
8518,0.0003,172.31.40.0-255,66,57449,64,363231
8519,0.000335,74.125.24.0-255,4320,61769,64,363231
8520,0.000339,172.31.40.0-255,66,61835,64,363231
8521,0.000356,74.125.24.0-255,4232,66067,64,363231
8522,0.000359,172.31.40.0-255,66,66133,64,363231
8523,0.000362,74.125.24.0-255,132,66265,64,363231
8524,0.000472,74.125.24.0-255,1484,67749,64,363231
8525,0.000477,172.31.40.0-255,66,67815,64,363231
8526,0.000482,74.125.24.0-255,2902,70717,64,363231
8527,0.000484,172.31.40.0-255,66,70783,64,363231
8528,0.000491,74.125.24.0-255,5738,76521,64,363231
8529,0.000493,172.31.40.0-255,66,76587,64,363231
8530,0.000532,74.125.24.0-255,4320,80907,64,363231
8531,0.000535,172.31.40.0-255,66,80973,64,363231
8532,0.000554,74.125.24.0-255,4320,85293,64,363231
8533,0.000557,172.31.40.0-255,66,85359,64,363231
8534,0.000586,74.125.24.0-255,5379,90738,64,363231
8535,0.000589,172.31.40.0-255,66,90804,64,363231
8536,0.000596,74.125.24.0-255,7156,97960,64,363231
8537,0.000598,172.31.40.0-255,66,98026,64,363231
8538,0.000613,74.125.24.0-255,2543,100569,64,363231
8539,0.000615,172.31.40.0-255,66,100635,64,363231
8540,0.000839,74.125.24.0-255,1484,102119,64,363231
8541,0.000859,74.125.24.0-255,2902,105021,64,363231
8542,0.000864,172.31.40.0-255,66,105087,64,363231
8543,0.000882,74.125.24.0-255,4320,109407,64,363231
8544,0.000885,172.31.40.0-255,66,109473,64,363231
8545,0.000906,74.125.24.0-255,1484,110957,64,363231
8546,0.000912,74.125.24.0-255,4320,115277,64,363231
8547,0.000914,172.31.40.0-255,66,115343,64,363231
8548,0.000932,74.125.24.0-255,7156,122499,64,363231
8549,0.000934,172.31.40.0-255,66,122565,64,363231
8550,0.000966,74.125.24.0-255,4320,126885,64,363231
8551,0.00097,172.31.40.0-255,66,126951,64,363231
8552,0.00098,172.31.40.0-255,66,127017,64,363231
8553,0.001059,74.125.24.0-255,1484,128501,64,363231
8554,0.001063,74.125.24.0-255,1484,129985,64,363231
8555,0.001066,172.31.40.0-255,66,130051,64,363231
8556,0.001084,74.125.24.0-255,1484,131535,64,363231
8557,0.001102,74.125.24.0-255,4320,135855,64,363231
8558,0.001105,172.31.40.0-255,66,135921,64,363231
8559,0.001142,74.125.24.0-255,5738,141659,64,363231
8560,0.001146,172.31.40.0-255,66,141725,64,363231
8561,0.001162,74.125.24.0-255,2902,144627,64,363231
8562,0.001164,172.31.40.0-255,66,144693,64,363231
8563,0.001188,74.125.24.0-255,1484,146177,64,363231
8564,0.001195,74.125.24.0-255,5738,151915,64,363231
8565,0.001198,172.31.40.0-255,66,151981,64,363231
8566,0.001214,74.125.24.0-255,1484,153465,64,363231
8567,0.001233,74.125.24.0-255,5738,159203,64,363231
8568,0.001236,172.31.40.0-255,66,159269,64,363231
8569,0.001259,74.125.24.0-255,2184,161453,64,363231
8570,0.001262,172.31.40.0-255,66,161519,64,363231
8571,0.001441,74.125.24.0-255,1484,163003,64,363231
8572,0.001446,74.125.24.0-255,1484,164487,64,363231
8573,0.001449,172.31.40.0-255,66,164553,64,363231
8574,0.001468,74.125.24.0-255,1484,166037,64,363231
8575,0.001475,74.125.24.0-255,5738,171775,64,363231
8576,0.001478,172.31.40.0-255,66,171841,64,363231
8577,0.001544,172.31.40.0-255,66,171907,64,363231
8578,0.00155,74.125.24.0-255,5738,177645,64,363231
8579,0.001553,172.31.40.0-255,66,177711,64,363231
8580,0.001575,74.125.24.0-255,2902,180613,64,363231
8581,0.001578,172.31.40.0-255,66,180679,64,363231
8582,0.001601,74.125.24.0-255,2184,182863,64,363231
8583,0.001604,172.31.40.0-255,66,182929,64,363231
8584,0.001715,74.125.24.0-255,1484,184413,64,363231
8585,0.001739,74.125.24.0-255,2902,187315,64,363231
8586,0.001742,172.31.40.0-255,66,187381,64,363231
8587,0.001748,74.125.24.0-255,4320,191701,64,363231
8588,0.001751,172.31.40.0-255,66,191767,64,363231
8589,0.001775,74.125.24.0-255,1484,193251,64,363231
8590,0.001788,172.31.40.0-255,66,193317,64,363231
8591,0.001837,74.125.24.0-255,5738,199055,64,363231
8592,0.00184,172.31.40.0-255,66,199121,64,363231
8593,0.001867,172.31.40.0-255,66,199187,64,363231
8594,0.00187,74.125.24.0-255,1484,200671,64,363231
8595,0.001896,74.125.24.0-255,2902,203573,64,363231
8596,0.001902,74.125.24.0-255,5738,209311,64,363231
8597,0.001905,172.31.40.0-255,66,209377,64,363231
8598,0.001908,172.31.40.0-255,66,209443,64,363231
8599,0.001928,74.125.24.0-255,4320,213763,64,363231
8600,0.001931,172.31.40.0-255,66,213829,64,363231
8601,0.001949,74.125.24.0-255,5738,219567,64,363231
8602,0.001951,172.31.40.0-255,66,219633,64,363231
8603,0.001964,172.31.40.0-255,66,219699,64,363231
8604,0.001968,74.125.24.0-255,2184,221883,64,363231
8605,0.001971,172.31.40.0-255,66,221949,64,363231
8606,0.002012,74.125.24.0-255,5738,227687,64,363231
8607,0.002017,172.31.40.0-255,66,227753,64,363231
8608,0.002045,172.31.40.0-255,66,227819,64,363231
8609,0.002051,74.125.24.0-255,5738,233557,64,363231
8610,0.002054,172.31.40.0-255,66,233623,64,363231
8611,0.002057,74.125.24.0-255,1484,235107,64,363231
8612,0.004085,74.125.24.0-255,4320,239427,64,363231
8613,0.004092,172.31.40.0-255,66,239493,64,363231
8614,0.00611,74.125.24.0-255,5738,245231,64,363231
8615,0.006117,172.31.40.0-255,66,245297,64,363231
8616,0.008122,74.125.24.0-255,5738,251035,64,363231
8617,0.008126,172.31.40.0-255,66,251101,64,363231
8618,0.01013,74.125.24.0-255,5738,256839,64,363231
8619,0.010136,172.31.40.0-255,66,256905,64,363231
8620,0.012151,74.125.24.0-255,5738,262643,64,363231
8621,0.01216,172.31.40.0-255,66,262709,64,363231
8622,0.014157,74.125.24.0-255,5738,268447,64,363231
8623,0.014165,172.31.40.0-255,66,268513,64,363231
8624,0.016189,74.125.24.0-255,5738,274251,64,363231
8625,0.016198,172.31.40.0-255,66,274317,64,363231
8626,0.018183,74.125.24.0-255,4320,278637,64,363231
8627,0.018189,172.31.40.0-255,66,278703,64,363231
8628,0.018208,74.125.24.0-255,1484,280187,64,363231
8629,0.020214,74.125.24.0-255,4320,284507,64,363231
8630,0.020221,172.31.40.0-255,66,284573,64,363231
8631,0.022225,74.125.24.0-255,5738,290311,64,363231
8632,0.022229,172.31.40.0-255,66,290377,64,363231
8633,0.024226,74.125.24.0-255,5738,296115,64,363231
8634,0.024233,172.31.40.0-255,66,296181,64,363231
8635,0.026237,74.125.24.0-255,5738,301919,64,363231
8636,0.026245,172.31.40.0-255,66,301985,64,363231
8637,0.028299,74.125.24.0-255,5738,307723,64,363231
8638,0.028306,172.31.40.0-255,66,307789,64,363231
8639,0.030323,74.125.24.0-255,5738,313527,64,363231
8640,0.03033,172.31.40.0-255,66,313593,64,363231
8641,0.032337,74.125.24.0-255,2902,316495,64,363231
8642,0.032345,172.31.40.0-255,66,316561,64,363231
8643,0.032367,74.125.24.0-255,2902,319463,64,363231
8644,0.03237,172.31.40.0-255,66,319529,64,363231
8645,0.034358,74.125.24.0-255,5738,325267,64,363231
8646,0.034365,172.31.40.0-255,66,325333,64,363231
8647,0.03499,172.31.40.0-255,182,325515,64,363231
8648,0.035024,172.31.40.0-255,1111,326626,64,363231
8649,0.035082,172.31.40.0-255,1514,328140,64,363231
8650,0.035084,172.31.40.0-255,1514,329654,64,363231
8651,0.035109,172.31.40.0-255,694,330348,64,363231
8652,0.0364,74.125.24.0-255,5738,336086,64,363231
8653,0.036406,172.31.40.0-255,66,336152,64,363231
8654,0.036485,104.244.42.0-255,66,336218,64,363231
8655,0.036547,104.244.42.0-255,66,336284,64,363231
8656,0.036646,104.244.42.0-255,66,336350,64,363231
8657,0.036652,104.244.42.0-255,66,336416,64,363231
8658,0.038388,104.244.42.0-255,108,336524,64,363231
8659,0.038396,172.31.40.0-255,66,336590,64,363231
8660,0.038453,74.125.24.0-255,5738,342328,64,363231
8661,0.038457,172.31.40.0-255,66,342394,64,363231
8662,0.040471,74.125.24.0-255,5738,348132,64,363231
8663,0.040477,172.31.40.0-255,66,348198,64,363231
8664,0.0425,74.125.24.0-255,5738,353936,64,363231
8665,0.042508,172.31.40.0-255,66,354002,64,363231
8666,0.044527,74.125.24.0-255,5738,359740,64,363231
8667,0.044534,172.31.40.0-255,66,359806,64,363231
8668,0.046549,74.125.24.0-255,3188,362994,64,363231
8669,0.046555,172.31.40.0-255,66,363060,64,363231
8670,0.046709,172.31.40.0-255,105,363165,64,363231
8671,0.048686,74.125.24.0-255,66,363231,64,363231
8672,0.0,172.31.40.0-255,105,105,64,459
8673,0.000148,172.31.40.0-255,90,195,64,459
8674,0.00016,172.31.40.0-255,66,261,64,459
8675,0.002495,172.217.194.0-255,66,327,64,459
8676,0.002523,172.217.194.0-255,66,393,64,459
8677,0.002545,172.31.40.0-255,66,459,64,459
8678,0.0,74.125.24.0-255,150,150,64,229109
8679,2.3e-05,172.31.40.0-255,66,216,64,229109
8680,3.1e-05,74.125.24.0-255,1484,1700,64,229109
8681,3.7e-05,172.31.40.0-255,66,1766,64,229109
8682,5e-05,74.125.24.0-255,2902,4668,64,229109
8683,5.3e-05,172.31.40.0-255,66,4734,64,229109
8684,6.1e-05,74.125.24.0-255,7156,11890,64,229109
8685,6.4e-05,172.31.40.0-255,66,11956,64,229109
8686,6.9e-05,74.125.24.0-255,3517,15473,64,229109
8687,7.1e-05,172.31.40.0-255,66,15539,64,229109
8688,8.2e-05,172.31.40.0-255,66,15605,64,229109
8689,0.000115,74.125.24.0-255,4320,19925,64,229109
8690,0.000118,172.31.40.0-255,66,19991,64,229109
8691,0.000121,74.125.24.0-255,2543,22534,64,229109
8692,0.000123,172.31.40.0-255,66,22600,64,229109
8693,0.000528,74.125.24.0-255,1484,24084,64,229109
8694,0.000536,172.31.40.0-255,66,24150,64,229109
8695,0.000542,74.125.24.0-255,2902,27052,64,229109
8696,0.000544,172.31.40.0-255,66,27118,64,229109
8697,0.00058,74.125.24.0-255,5738,32856,64,229109
8698,0.000583,172.31.40.0-255,66,32922,64,229109
8699,0.000589,74.125.24.0-255,2902,35824,64,229109
8700,0.000591,172.31.40.0-255,66,35890,64,229109
8701,0.000636,172.31.40.0-255,66,35956,64,229109
8702,0.000647,172.31.40.0-255,66,36022,64,229109
8703,0.000655,74.125.24.0-255,2868,38890,64,229109
8704,0.000657,172.31.40.0-255,66,38956,64,229109
8705,0.000706,74.125.24.0-255,1484,40440,64,229109
8706,0.000709,172.31.40.0-255,66,40506,64,229109
8707,0.000754,74.125.24.0-255,2902,43408,64,229109
8708,0.000757,172.31.40.0-255,66,43474,64,229109
8709,0.000763,74.125.24.0-255,5738,49212,64,229109
8710,0.000766,172.31.40.0-255,66,49278,64,229109
8711,0.000778,74.125.24.0-255,6797,56075,64,229109
8712,0.00078,172.31.40.0-255,66,56141,64,229109
8713,0.000784,74.125.24.0-255,2902,59043,64,229109
8714,0.000786,172.31.40.0-255,66,59109,64,229109
8715,0.000818,74.125.24.0-255,4320,63429,64,229109
8716,0.000821,172.31.40.0-255,66,63495,64,229109
8717,0.000833,172.31.40.0-255,66,63561,64,229109
8718,0.001736,74.125.24.0-255,1484,65045,64,229109
8719,0.001743,74.125.24.0-255,2902,67947,64,229109
8720,0.001747,172.31.40.0-255,66,68013,64,229109
8721,0.001753,74.125.24.0-255,4320,72333,64,229109
8722,0.001754,172.31.40.0-255,66,72399,64,229109
8723,0.001773,74.125.24.0-255,1484,73883,64,229109
8724,0.001778,74.125.24.0-255,4320,78203,64,229109
8725,0.00178,172.31.40.0-255,66,78269,64,229109
8726,0.001819,172.31.40.0-255,66,78335,64,229109
8727,0.001879,74.125.24.0-255,2902,81237,64,229109
8728,0.001882,172.31.40.0-255,66,81303,64,229109
8729,0.001913,172.31.40.0-255,66,81369,64,229109
8730,0.002125,74.125.24.0-255,1484,82853,64,229109
8731,0.002129,74.125.24.0-255,1484,84337,64,229109
8732,0.002131,172.31.40.0-255,66,84403,64,229109
8733,0.002154,74.125.24.0-255,1484,85887,64,229109
8734,0.00216,74.125.24.0-255,5738,91625,64,229109
8735,0.002162,172.31.40.0-255,66,91691,64,229109
8736,0.002171,172.31.40.0-255,66,91757,64,229109
8737,0.002193,74.125.24.0-255,4320,96077,64,229109
8738,0.002195,172.31.40.0-255,66,96143,64,229109
8739,0.002207,172.31.40.0-255,66,96209,64,229109
8740,0.002233,74.125.24.0-255,2902,99111,64,229109
8741,0.002236,172.31.40.0-255,66,99177,64,229109
8742,0.002267,172.31.40.0-255,66,99243,64,229109
8743,0.002291,172.31.40.0-255,66,99309,64,229109
8744,0.002296,74.125.24.0-255,5738,105047,64,229109
8745,0.002298,172.31.40.0-255,66,105113,64,229109
8746,0.002327,74.125.24.0-255,2184,107297,64,229109
8747,0.002329,172.31.40.0-255,66,107363,64,229109
8748,0.002331,74.125.24.0-255,1484,108847,64,229109
8749,0.002335,74.125.24.0-255,2902,111749,64,229109
8750,0.002337,172.31.40.0-255,66,111815,64,229109
8751,0.002372,74.125.24.0-255,5738,117553,64,229109
8752,0.002374,172.31.40.0-255,66,117619,64,229109
8753,0.002384,172.31.40.0-255,66,117685,64,229109
8754,0.002406,74.125.24.0-255,1484,119169,64,229109
8755,0.002411,74.125.24.0-255,5738,124907,64,229109
8756,0.002413,172.31.40.0-255,66,124973,64,229109
8757,0.002441,172.31.40.0-255,66,125039,64,229109
8758,0.00245,172.31.40.0-255,66,125105,64,229109
8759,0.002505,172.31.40.0-255,66,125171,64,229109
8760,0.002511,74.125.24.0-255,5020,130191,64,229109
8761,0.002513,172.31.40.0-255,66,130257,64,229109
8762,0.002547,74.125.24.0-255,4320,134577,64,229109
8763,0.00255,172.31.40.0-255,66,134643,64,229109
8764,0.002606,172.31.40.0-255,66,134709,64,229109
8765,0.002613,74.125.24.0-255,6438,141147,64,229109
8766,0.002615,172.31.40.0-255,66,141213,64,229109
8767,0.002627,172.31.40.0-255,66,141279,64,229109
8768,0.002647,74.125.24.0-255,4320,145599,64,229109
8769,0.002649,172.31.40.0-255,66,145665,64,229109
8770,0.002655,74.125.24.0-255,5738,151403,64,229109
8771,0.002657,172.31.40.0-255,66,151469,64,229109
8772,0.002699,172.31.40.0-255,66,151535,64,229109
8773,0.005352,74.125.24.0-255,5738,157273,64,229109
8774,0.005363,172.31.40.0-255,66,157339,64,229109
8775,0.008047,74.125.24.0-255,5738,163077,64,229109
8776,0.008063,172.31.40.0-255,66,163143,64,229109
8777,0.010713,74.125.24.0-255,5738,168881,64,229109
8778,0.010724,172.31.40.0-255,66,168947,64,229109
8779,0.013346,74.125.24.0-255,5738,174685,64,229109
8780,0.013355,172.31.40.0-255,66,174751,64,229109
8781,0.016014,74.125.24.0-255,5738,180489,64,229109
8782,0.016022,172.31.40.0-255,66,180555,64,229109
8783,0.01868,74.125.24.0-255,5738,186293,64,229109
8784,0.018699,172.31.40.0-255,66,186359,64,229109
8785,0.021335,74.125.24.0-255,5738,192097,64,229109
8786,0.021344,172.31.40.0-255,66,192163,64,229109
8787,0.024003,74.125.24.0-255,5738,197901,64,229109
8788,0.024013,172.31.40.0-255,66,197967,64,229109
8789,0.026692,74.125.24.0-255,5738,203705,64,229109
8790,0.026706,172.31.40.0-255,66,203771,64,229109
8791,0.029353,74.125.24.0-255,5738,209509,64,229109
8792,0.029361,172.31.40.0-255,66,209575,64,229109
8793,0.031994,74.125.24.0-255,5738,215313,64,229109
8794,0.032003,172.31.40.0-255,66,215379,64,229109
8795,0.034683,74.125.24.0-255,5738,221117,64,229109
8796,0.034699,172.31.40.0-255,66,221183,64,229109
8797,0.037333,74.125.24.0-255,3591,224774,64,229109
8798,0.037357,172.31.40.0-255,66,224840,64,229109
8799,0.037643,172.31.40.0-255,105,224945,64,229109
8800,0.04025,74.125.24.0-255,66,225011,64,229109
8801,0.059071,172.31.40.0-255,176,225187,64,229109
8802,0.059106,172.31.40.0-255,1113,226300,64,229109
8803,0.059168,172.31.40.0-255,1514,227814,64,229109
8804,0.05917,172.31.40.0-255,1295,229109,64,229109
8805,0.0,172.217.194.0-255,147,147,64,241592
8806,3.3e-05,172.31.40.0-255,66,213,64,241592
8807,4e-05,172.217.194.0-255,1484,1697,64,241592
8808,4.4e-05,172.31.40.0-255,66,1763,64,241592
8809,4.9e-05,172.217.194.0-255,2902,4665,64,241592
8810,5.2e-05,172.31.40.0-255,66,4731,64,241592
8811,6e-05,172.217.194.0-255,7156,11887,64,241592
8812,6.4e-05,172.31.40.0-255,66,11953,64,241592
8813,6.8e-05,172.217.194.0-255,2902,14855,64,241592
8814,7e-05,172.31.40.0-255,66,14921,64,241592
8815,0.000106,172.217.194.0-255,6266,21187,64,241592
8816,0.000109,172.31.40.0-255,66,21253,64,241592
8817,0.00012,172.31.40.0-255,66,21319,64,241592
8818,0.000332,172.217.194.0-255,1484,22803,64,241592
8819,0.000337,172.31.40.0-255,66,22869,64,241592
8820,0.000341,172.217.194.0-255,1484,24353,64,241592
8821,0.000343,172.31.40.0-255,66,24419,64,241592
8822,0.000358,172.217.194.0-255,1484,25903,64,241592
8823,0.000361,172.31.40.0-255,66,25969,64,241592
8824,0.000368,172.217.194.0-255,5738,31707,64,241592
8825,0.000371,172.31.40.0-255,66,31773,64,241592
8826,0.000374,172.217.194.0-255,1484,33257,64,241592
8827,0.000378,172.31.40.0-255,66,33323,64,241592
8828,0.00039,172.217.194.0-255,2902,36225,64,241592
8829,0.000393,172.31.40.0-255,66,36291,64,241592
8830,0.000413,172.217.194.0-255,2902,39193,64,241592
8831,0.000416,172.31.40.0-255,66,39259,64,241592
8832,0.000462,172.217.194.0-255,7156,46415,64,241592
8833,0.000465,172.31.40.0-255,66,46481,64,241592
8834,0.000488,172.217.194.0-255,2543,49024,64,241592
8835,0.000491,172.31.40.0-255,66,49090,64,241592
8836,0.000497,172.217.194.0-255,5738,54828,64,241592
8837,0.0005,172.217.194.0-255,1415,56243,64,241592
8838,0.000504,172.31.40.0-255,66,56309,64,241592
8839,0.000519,172.217.194.0-255,1484,57793,64,241592
8840,0.000525,172.217.194.0-255,4320,62113,64,241592
8841,0.000531,172.31.40.0-255,66,62179,64,241592
8842,0.000543,172.217.194.0-255,2902,65081,64,241592
8843,0.000563,172.31.40.0-255,66,65147,64,241592
8844,0.000582,172.217.194.0-255,1484,66631,64,241592
8845,0.000599,172.217.194.0-255,6797,73428,64,241592
8846,0.000608,172.31.40.0-255,66,73494,64,241592
8847,0.000711,172.217.194.0-255,1484,74978,64,241592
8848,0.000724,172.217.194.0-255,2902,77880,64,241592
8849,0.000728,172.31.40.0-255,66,77946,64,241592
8850,0.000751,172.217.194.0-255,5738,83684,64,241592
8851,0.000755,172.31.40.0-255,66,83750,64,241592
8852,0.000771,172.217.194.0-255,2902,86652,64,241592
8853,0.000781,172.31.40.0-255,66,86718,64,241592
8854,0.000788,172.217.194.0-255,5738,92456,64,241592
8855,0.000795,172.31.40.0-255,66,92522,64,241592
8856,0.000806,172.217.194.0-255,4320,96842,64,241592
8857,0.000811,172.31.40.0-255,66,96908,64,241592
8858,0.000826,172.31.40.0-255,66,96974,64,241592
8859,0.000914,172.217.194.0-255,1484,98458,64,241592
8860,0.000919,172.217.194.0-255,2902,101360,64,241592
8861,0.000922,172.31.40.0-255,66,101426,64,241592
8862,0.000945,172.217.194.0-255,5738,107164,64,241592
8863,0.000956,172.31.40.0-255,66,107230,64,241592
8864,0.000975,172.217.194.0-255,2902,110132,64,241592
8865,0.000982,172.31.40.0-255,66,110198,64,241592
8866,0.001015,172.217.194.0-255,5738,115936,64,241592
8867,0.00102,172.31.40.0-255,66,116002,64,241592
8868,0.001034,172.217.194.0-255,2902,118904,64,241592
8869,0.001037,172.31.40.0-255,66,118970,64,241592
8870,0.001072,172.31.40.0-255,66,119036,64,241592
8871,0.001097,172.217.194.0-255,1484,120520,64,241592
8872,0.0011,172.31.40.0-255,66,120586,64,241592
8873,0.001126,172.31.40.0-255,66,120652,64,241592
8874,0.001144,172.217.194.0-255,6438,127090,64,241592
8875,0.001152,172.31.40.0-255,66,127156,64,241592
8876,0.001184,172.217.194.0-255,4320,131476,64,241592
8877,0.001201,172.31.40.0-255,66,131542,64,241592
8878,0.001216,172.31.40.0-255,66,131608,64,241592
8879,0.001301,172.217.194.0-255,1484,133092,64,241592
8880,0.001321,172.217.194.0-255,2902,135994,64,241592
8881,0.001327,172.217.194.0-255,5738,141732,64,241592
8882,0.001328,172.31.40.0-255,66,141798,64,241592
8883,0.001332,172.31.40.0-255,66,141864,64,241592
8884,0.00138,172.31.40.0-255,66,141930,64,241592
8885,0.001386,172.217.194.0-255,1484,143414,64,241592
8886,0.001417,172.31.40.0-255,66,143480,64,241592
8887,0.001433,172.217.194.0-255,766,144246,64,241592
8888,0.001571,172.217.194.0-255,1484,145730,64,241592
8889,0.001575,172.31.40.0-255,66,145796,64,241592
8890,0.00158,172.217.194.0-255,2902,148698,64,241592
8891,0.00159,172.31.40.0-255,66,148764,64,241592
8892,0.001639,172.217.194.0-255,5738,154502,64,241592
8893,0.001645,172.31.40.0-255,66,154568,64,241592
8894,0.001659,172.31.40.0-255,66,154634,64,241592
8895,0.00167,172.31.40.0-255,66,154700,64,241592
8896,0.001726,172.31.40.0-255,66,154766,64,241592
8897,0.001728,172.217.194.0-255,5738,160504,64,241592
8898,0.001731,172.31.40.0-255,66,160570,64,241592
8899,0.001744,172.31.40.0-255,66,160636,64,241592
8900,0.002126,172.217.194.0-255,1484,162120,64,241592
8901,0.002133,172.217.194.0-255,2902,165022,64,241592
8902,0.002138,172.31.40.0-255,66,165088,64,241592
8903,0.002144,172.217.194.0-255,5738,170826,64,241592
8904,0.002149,172.217.194.0-255,4320,175146,64,241592
8905,0.002153,172.31.40.0-255,66,175212,64,241592
8906,0.002162,172.217.194.0-255,1484,176696,64,241592
8907,0.002177,172.217.194.0-255,4320,181016,64,241592
8908,0.002184,172.31.40.0-255,66,181082,64,241592
8909,0.002205,172.217.194.0-255,5020,186102,64,241592
8910,0.002207,172.31.40.0-255,66,186168,64,241592
8911,0.002211,172.31.40.0-255,66,186234,64,241592
8912,0.002252,172.217.194.0-255,1484,187718,64,241592
8913,0.002288,172.217.194.0-255,2902,190620,64,241592
8914,0.002299,172.217.194.0-255,5738,196358,64,241592
8915,0.002342,172.217.194.0-255,5020,201378,64,241592
8916,0.01162,172.31.40.0-255,66,201444,64,241592
8917,0.011674,172.217.194.0-255,1484,202928,64,241592
8918,0.013922,172.217.194.0-255,4320,207248,64,241592
8919,0.013929,172.31.40.0-255,66,207314,64,241592
8920,0.016229,172.217.194.0-255,5738,213052,64,241592
8921,0.016337,172.31.40.0-255,66,213118,64,241592
8922,0.018669,172.217.194.0-255,5738,218856,64,241592
8923,0.018679,172.31.40.0-255,66,218922,64,241592
8924,0.021004,172.217.194.0-255,5738,224660,64,241592
8925,0.021014,172.31.40.0-255,66,224726,64,241592
8926,0.02332,172.217.194.0-255,5738,230464,64,241592
8927,0.023327,172.31.40.0-255,66,230530,64,241592
8928,0.025628,172.217.194.0-255,5738,236268,64,241592
8929,0.025649,172.31.40.0-255,66,236334,64,241592
8930,0.027945,172.217.194.0-255,1523,237857,64,241592
8931,0.027959,172.31.40.0-255,66,237923,64,241592
8932,0.028204,172.31.40.0-255,105,238028,64,241592
8933,0.030512,172.217.194.0-255,66,238094,64,241592
8934,0.041488,172.31.40.0-255,167,238261,64,241592
8935,0.041531,172.31.40.0-255,1108,239369,64,241592
8936,0.041577,172.31.40.0-255,1514,240883,64,241592
8937,0.041579,172.31.40.0-255,337,241220,64,241592
8938,0.04309,104.244.42.0-255,66,241286,64,241592
8939,0.04312,104.244.42.0-255,66,241352,64,241592
8940,0.04319,104.244.42.0-255,66,241418,64,241592
8941,0.044022,104.244.42.0-255,108,241526,64,241592
8942,0.044045,172.31.40.0-255,66,241592,64,241592
8943,0.0,74.125.24.0-255,152,152,64,229863
8944,2e-05,172.31.40.0-255,66,218,64,229863
8945,2.7e-05,74.125.24.0-255,1484,1702,64,229863
8946,3.2e-05,172.31.40.0-255,66,1768,64,229863
8947,3.8e-05,74.125.24.0-255,2902,4670,64,229863
8948,4.8e-05,172.31.40.0-255,66,4736,64,229863
8949,5.2e-05,74.125.24.0-255,1484,6220,64,229863
8950,5.4e-05,172.31.40.0-255,66,6286,64,229863
8951,9.7e-05,172.31.40.0-255,66,6352,64,229863
8952,0.00014,172.31.40.0-255,66,6418,64,229863
8953,0.000148,74.125.24.0-255,7156,13574,64,229863
8954,0.00015,172.31.40.0-255,66,13640,64,229863
8955,0.000179,74.125.24.0-255,1125,14765,64,229863
8956,0.000181,172.31.40.0-255,66,14831,64,229863
8957,0.000282,74.125.24.0-255,1484,16315,64,229863
8958,0.000286,172.31.40.0-255,66,16381,64,229863
8959,0.000291,74.125.24.0-255,2902,19283,64,229863
8960,0.000293,172.31.40.0-255,66,19349,64,229863
8961,0.000296,74.125.24.0-255,1484,20833,64,229863
8962,0.0003,172.31.40.0-255,66,20899,64,229863
8963,0.00032,74.125.24.0-255,4320,25219,64,229863
8964,0.000323,172.31.40.0-255,66,25285,64,229863
8965,0.000334,74.125.24.0-255,6797,32082,64,229863
8966,0.000337,172.31.40.0-255,66,32148,64,229863
8967,0.000342,74.125.24.0-255,2902,35050,64,229863
8968,0.000344,172.31.40.0-255,66,35116,64,229863
8969,0.000369,74.125.24.0-255,4320,39436,64,229863
8970,0.000372,172.31.40.0-255,66,39502,64,229863
8971,0.000413,172.31.40.0-255,66,39568,64,229863
8972,0.000416,74.125.24.0-255,393,39961,64,229863
8973,0.000469,74.125.24.0-255,383,40344,64,229863
8974,0.000748,74.125.24.0-255,1484,41828,64,229863
8975,0.000752,172.31.40.0-255,66,41894,64,229863
8976,0.000757,74.125.24.0-255,2902,44796,64,229863
8977,0.000759,172.31.40.0-255,66,44862,64,229863
8978,0.000761,74.125.24.0-255,1484,46346,64,229863
8979,0.000795,74.125.24.0-255,4320,50666,64,229863
8980,0.000797,172.31.40.0-255,66,50732,64,229863
8981,0.0008,74.125.24.0-255,1484,52216,64,229863
8982,0.000811,172.31.40.0-255,66,52282,64,229863
8983,0.000833,74.125.24.0-255,1484,53766,64,229863
8984,0.000845,172.31.40.0-255,66,53832,64,229863
8985,0.00134,74.125.24.0-255,1484,55316,64,229863
8986,0.001347,74.125.24.0-255,2902,58218,64,229863
8987,0.001351,172.31.40.0-255,66,58284,64,229863
8988,0.001356,74.125.24.0-255,4320,62604,64,229863
8989,0.001359,172.31.40.0-255,66,62670,64,229863
8990,0.00138,74.125.24.0-255,1484,64154,64,229863
8991,0.001416,74.125.24.0-255,5738,69892,64,229863
8992,0.001421,172.31.40.0-255,66,69958,64,229863
8993,0.001437,74.125.24.0-255,5738,75696,64,229863
8994,0.001444,172.31.40.0-255,66,75762,64,229863
8995,0.001454,172.31.40.0-255,66,75828,64,229863
8996,0.001479,74.125.24.0-255,3602,79430,64,229863
8997,0.001482,172.31.40.0-255,66,79496,64,229863
8998,0.003734,74.125.24.0-255,5738,85234,64,229863
8999,0.003741,172.31.40.0-255,66,85300,64,229863
9000,0.005999,74.125.24.0-255,5738,91038,64,229863
9001,0.006004,172.31.40.0-255,66,91104,64,229863
9002,0.008269,74.125.24.0-255,5738,96842,64,229863
9003,0.00828,172.31.40.0-255,66,96908,64,229863
9004,0.010556,74.125.24.0-255,5738,102646,64,229863
9005,0.010571,172.31.40.0-255,66,102712,64,229863
9006,0.012848,74.125.24.0-255,5738,108450,64,229863
9007,0.012858,172.31.40.0-255,66,108516,64,229863
9008,0.01513,74.125.24.0-255,5738,114254,64,229863
9009,0.015137,172.31.40.0-255,66,114320,64,229863
9010,0.017429,74.125.24.0-255,5738,120058,64,229863
9011,0.017438,172.31.40.0-255,66,120124,64,229863
9012,0.019698,74.125.24.0-255,5738,125862,64,229863
9013,0.019706,172.31.40.0-255,66,125928,64,229863
9014,0.021978,74.125.24.0-255,5738,131666,64,229863
9015,0.021986,172.31.40.0-255,66,131732,64,229863
9016,0.024253,74.125.24.0-255,5738,137470,64,229863
9017,0.024259,172.31.40.0-255,66,137536,64,229863
9018,0.025118,172.31.40.0-255,167,137703,64,229863
9019,0.025147,172.31.40.0-255,1111,138814,64,229863
9020,0.025205,172.31.40.0-255,1514,140328,64,229863
9021,0.025207,172.31.40.0-255,1514,141842,64,229863
9022,0.02523,172.31.40.0-255,697,142539,64,229863
9023,0.026546,74.125.24.0-255,5738,148277,64,229863
9024,0.026552,172.31.40.0-255,66,148343,64,229863
9025,0.026671,104.244.42.0-255,66,148409,64,229863
9026,0.026677,104.244.42.0-255,66,148475,64,229863
9027,0.026778,104.244.42.0-255,66,148541,64,229863
9028,0.026783,104.244.42.0-255,66,148607,64,229863
9029,0.028836,74.125.24.0-255,5738,154345,64,229863
9030,0.028843,172.31.40.0-255,66,154411,64,229863
9031,0.031101,74.125.24.0-255,5738,160149,64,229863
9032,0.031107,172.31.40.0-255,66,160215,64,229863
9033,0.033443,74.125.24.0-255,5738,165953,64,229863
9034,0.033448,172.31.40.0-255,66,166019,64,229863
9035,0.035724,74.125.24.0-255,5738,171757,64,229863
9036,0.03573,172.31.40.0-255,66,171823,64,229863
9037,0.037997,74.125.24.0-255,5738,177561,64,229863
9038,0.038003,172.31.40.0-255,66,177627,64,229863
9039,0.040253,74.125.24.0-255,5738,183365,64,229863
9040,0.040259,172.31.40.0-255,66,183431,64,229863
9041,0.042547,74.125.24.0-255,5738,189169,64,229863
9042,0.042557,172.31.40.0-255,66,189235,64,229863
9043,0.04483,74.125.24.0-255,5738,194973,64,229863
9044,0.044836,172.31.40.0-255,66,195039,64,229863
9045,0.047134,74.125.24.0-255,5738,200777,64,229863
9046,0.04714,172.31.40.0-255,66,200843,64,229863
9047,0.049403,74.125.24.0-255,5738,206581,64,229863
9048,0.04942,172.31.40.0-255,66,206647,64,229863
9049,0.051677,74.125.24.0-255,5738,212385,64,229863
9050,0.051695,172.31.40.0-255,66,212451,64,229863
9051,0.053983,74.125.24.0-255,5738,218189,64,229863
9052,0.053997,172.31.40.0-255,66,218255,64,229863
9053,0.056303,74.125.24.0-255,5738,223993,64,229863
9054,0.056321,172.31.40.0-255,66,224059,64,229863
9055,0.058598,74.125.24.0-255,5738,229797,64,229863
9056,0.058615,172.31.40.0-255,66,229863,64,229863
9057,0.0,74.125.200.0-255,153,153,64,343250
9058,1.5e-05,172.31.40.0-255,66,219,64,343250
9059,2.3e-05,74.125.200.0-255,1484,1703,64,343250
9060,2.7e-05,172.31.40.0-255,66,1769,64,343250
9061,3e-05,74.125.200.0-255,1484,3253,64,343250
9062,3.3e-05,172.31.40.0-255,66,3319,64,343250
9063,5.8e-05,74.125.200.0-255,1484,4803,64,343250
9064,6.1e-05,172.31.40.0-255,66,4869,64,343250
9065,6.9e-05,74.125.200.0-255,1484,6353,64,343250
9066,7.1e-05,172.31.40.0-255,66,6419,64,343250
9067,7.6e-05,74.125.200.0-255,2902,9321,64,343250
9068,7.9e-05,172.31.40.0-255,66,9387,64,343250
9069,0.00012,74.125.200.0-255,4984,14371,64,343250
9070,0.000124,172.31.40.0-255,66,14437,64,343250
9071,0.000198,74.125.200.0-255,1484,15921,64,343250
9072,0.000201,172.31.40.0-255,66,15987,64,343250
9073,0.000206,74.125.200.0-255,2902,18889,64,343250
9074,0.000209,172.31.40.0-255,66,18955,64,343250
9075,0.000245,74.125.200.0-255,5738,24693,64,343250
9076,0.000248,172.31.40.0-255,66,24759,64,343250
9077,0.000254,74.125.200.0-255,5738,30497,64,343250
9078,0.000257,172.31.40.0-255,66,30563,64,343250
9079,0.000282,74.125.200.0-255,6797,37360,64,343250
9080,0.000288,172.31.40.0-255,66,37426,64,343250
9081,0.000296,74.125.200.0-255,5738,43164,64,343250
9082,0.000298,172.31.40.0-255,66,43230,64,343250
9083,0.000336,74.125.200.0-255,2902,46132,64,343250
9084,0.000339,172.31.40.0-255,66,46198,64,343250
9085,0.000352,172.31.40.0-255,66,46264,64,343250
9086,0.000364,172.31.40.0-255,66,46330,64,343250
9087,0.000394,74.125.200.0-255,361,46691,64,343250
9088,0.000408,74.125.200.0-255,132,46823,64,343250
9089,0.000519,74.125.200.0-255,1484,48307,64,343250
9090,0.000525,172.31.40.0-255,66,48373,64,343250
9091,0.00053,74.125.200.0-255,2902,51275,64,343250
9092,0.000533,172.31.40.0-255,66,51341,64,343250
9093,0.000538,74.125.200.0-255,2902,54243,64,343250
9094,0.00054,172.31.40.0-255,66,54309,64,343250
9095,0.000543,74.125.200.0-255,1484,55793,64,343250
9096,0.00057,74.125.200.0-255,2902,58695,64,343250
9097,0.000573,172.31.40.0-255,66,58761,64,343250
9098,0.000584,172.31.40.0-255,66,58827,64,343250
9099,0.000587,74.125.200.0-255,1484,60311,64,343250
9100,0.000622,74.125.200.0-255,7156,67467,64,343250
9101,0.000625,172.31.40.0-255,66,67533,64,343250
9102,0.000656,74.125.200.0-255,5302,72835,64,343250
9103,0.000659,172.31.40.0-255,66,72901,64,343250
9104,0.000878,74.125.200.0-255,1484,74385,64,343250
9105,0.000884,74.125.200.0-255,2902,77287,64,343250
9106,0.000887,172.31.40.0-255,66,77353,64,343250
9107,0.000891,74.125.200.0-255,1484,78837,64,343250
9108,0.000915,74.125.200.0-255,2902,81739,64,343250
9109,0.000918,172.31.40.0-255,66,81805,64,343250
9110,0.000925,74.125.200.0-255,5738,87543,64,343250
9111,0.000928,172.31.40.0-255,66,87609,64,343250
9112,0.000954,74.125.200.0-255,2902,90511,64,343250
9113,0.000957,172.31.40.0-255,66,90577,64,343250
9114,0.000987,172.31.40.0-255,66,90643,64,343250
9115,0.001014,74.125.200.0-255,6438,97081,64,343250
9116,0.001017,172.31.40.0-255,66,97147,64,343250
9117,0.001241,74.125.200.0-255,1484,98631,64,343250
9118,0.001262,74.125.200.0-255,2902,101533,64,343250
9119,0.001266,172.31.40.0-255,66,101599,64,343250
9120,0.001273,74.125.200.0-255,5738,107337,64,343250
9121,0.001275,172.31.40.0-255,66,107403,64,343250
9122,0.001304,74.125.200.0-255,4320,111723,64,343250
9123,0.001306,172.31.40.0-255,66,111789,64,343250
9124,0.001335,74.125.200.0-255,7156,118945,64,343250
9125,0.001337,172.31.40.0-255,66,119011,64,343250
9126,0.001352,172.31.40.0-255,66,119077,64,343250
9127,0.001394,74.125.200.0-255,1484,120561,64,343250
9128,0.001399,74.125.200.0-255,2902,123463,64,343250
9129,0.001402,172.31.40.0-255,66,123529,64,343250
9130,0.001432,74.125.200.0-255,4320,127849,64,343250
9131,0.001435,172.31.40.0-255,66,127915,64,343250
9132,0.001441,74.125.200.0-255,4320,132235,64,343250
9133,0.001443,172.31.40.0-255,66,132301,64,343250
9134,0.001471,74.125.200.0-255,4320,136621,64,343250
9135,0.001474,172.31.40.0-255,66,136687,64,343250
9136,0.001485,172.31.40.0-255,66,136753,64,343250
9137,0.001548,172.31.40.0-255,66,136819,64,343250
9138,0.001563,74.125.200.0-255,2902,139721,64,343250
9139,0.001571,172.31.40.0-255,66,139787,64,343250
9140,0.001577,74.125.200.0-255,4320,144107,64,343250
9141,0.001579,172.31.40.0-255,66,144173,64,343250
9142,0.001586,74.125.200.0-255,5738,149911,64,343250
9143,0.001589,172.31.40.0-255,66,149977,64,343250
9144,0.001629,74.125.200.0-255,2902,152879,64,343250
9145,0.001632,172.31.40.0-255,66,152945,64,343250
9146,0.001639,74.125.200.0-255,7156,160101,64,343250
9147,0.001642,172.31.40.0-255,66,160167,64,343250
9148,0.001652,172.31.40.0-255,66,160233,64,343250
9149,0.001656,74.125.200.0-255,2184,162417,64,343250
9150,0.001659,172.31.40.0-255,66,162483,64,343250
9151,0.001719,74.125.200.0-255,1484,163967,64,343250
9152,0.001739,74.125.200.0-255,2902,166869,64,343250
9153,0.001743,172.31.40.0-255,66,166935,64,343250
9154,0.001746,74.125.200.0-255,1484,168419,64,343250
9155,0.001773,74.125.200.0-255,2902,171321,64,343250
9156,0.001776,172.31.40.0-255,66,171387,64,343250
9157,0.001808,74.125.200.0-255,5738,177125,64,343250
9158,0.001812,172.31.40.0-255,66,177191,64,343250
9159,0.001818,74.125.200.0-255,1484,178675,64,343250
9160,0.001823,74.125.200.0-255,2902,181577,64,343250
9161,0.001825,172.31.40.0-255,66,181643,64,343250
9162,0.001855,74.125.200.0-255,5738,187381,64,343250
9163,0.001858,172.31.40.0-255,66,187447,64,343250
9164,0.001862,74.125.200.0-255,2902,190349,64,343250
9165,0.001864,172.31.40.0-255,66,190415,64,343250
9166,0.001867,74.125.200.0-255,1484,191899,64,343250
9167,0.001896,74.125.200.0-255,2902,194801,64,343250
9168,0.001898,172.31.40.0-255,66,194867,64,343250
9169,0.001917,74.125.200.0-255,2184,197051,64,343250
9170,0.00192,172.31.40.0-255,66,197117,64,343250
9171,0.002077,74.125.200.0-255,1484,198601,64,343250
9172,0.002082,74.125.200.0-255,1484,200085,64,343250
9173,0.002085,172.31.40.0-255,66,200151,64,343250
9174,0.002112,74.125.200.0-255,1484,201635,64,343250
9175,0.002117,74.125.200.0-255,2902,204537,64,343250
9176,0.00212,172.31.40.0-255,66,204603,64,343250
9177,0.002125,74.125.200.0-255,4320,208923,64,343250
9178,0.002128,172.31.40.0-255,66,208989,64,343250
9179,0.002133,74.125.200.0-255,2902,211891,64,343250
9180,0.002135,172.31.40.0-255,66,211957,64,343250
9181,0.002163,74.125.200.0-255,5738,217695,64,343250
9182,0.002167,172.31.40.0-255,66,217761,64,343250
9183,0.002172,74.125.200.0-255,4320,222081,64,343250
9184,0.002175,172.31.40.0-255,66,222147,64,343250
9185,0.002181,74.125.200.0-255,5738,227885,64,343250
9186,0.002185,172.31.40.0-255,66,227951,64,343250
9187,0.002216,74.125.200.0-255,3602,231553,64,343250
9188,0.002219,172.31.40.0-255,66,231619,64,343250
9189,0.004437,74.125.200.0-255,1484,233103,64,343250
9190,0.004459,74.125.200.0-255,2902,236005,64,343250
9191,0.004463,172.31.40.0-255,66,236071,64,343250
9192,0.004489,74.125.200.0-255,1484,237555,64,343250
9193,0.006735,74.125.200.0-255,4320,241875,64,343250
9194,0.006746,172.31.40.0-255,66,241941,64,343250
9195,0.009071,74.125.200.0-255,5738,247679,64,343250
9196,0.009087,172.31.40.0-255,66,247745,64,343250
9197,0.011371,74.125.200.0-255,5738,253483,64,343250
9198,0.01138,172.31.40.0-255,66,253549,64,343250
9199,0.013645,74.125.200.0-255,5738,259287,64,343250
9200,0.013663,172.31.40.0-255,66,259353,64,343250
9201,0.015955,74.125.200.0-255,5738,265091,64,343250
9202,0.01597,172.31.40.0-255,66,265157,64,343250
9203,0.01825,74.125.200.0-255,5738,270895,64,343250
9204,0.018267,172.31.40.0-255,66,270961,64,343250
9205,0.020532,74.125.200.0-255,5738,276699,64,343250
9206,0.02054,172.31.40.0-255,66,276765,64,343250
9207,0.022812,74.125.200.0-255,5738,282503,64,343250
9208,0.02282,172.31.40.0-255,66,282569,64,343250
9209,0.025092,74.125.200.0-255,5738,288307,64,343250
9210,0.0251,172.31.40.0-255,66,288373,64,343250
9211,0.027359,74.125.200.0-255,5738,294111,64,343250
9212,0.027367,172.31.40.0-255,66,294177,64,343250
9213,0.029643,74.125.200.0-255,5738,299915,64,343250
9214,0.02965,172.31.40.0-255,66,299981,64,343250
9215,0.031926,74.125.200.0-255,5738,305719,64,343250
9216,0.031944,172.31.40.0-255,66,305785,64,343250
9217,0.034224,74.125.200.0-255,5738,311523,64,343250
9218,0.034241,172.31.40.0-255,66,311589,64,343250
9219,0.036522,74.125.200.0-255,5738,317327,64,343250
9220,0.036532,172.31.40.0-255,66,317393,64,343250
9221,0.038805,74.125.200.0-255,5738,323131,64,343250
9222,0.038821,172.31.40.0-255,66,323197,64,343250
9223,0.041084,74.125.200.0-255,5738,328935,64,343250
9224,0.041093,172.31.40.0-255,66,329001,64,343250
9225,0.043361,74.125.200.0-255,5738,334739,64,343250
9226,0.04337,172.31.40.0-255,66,334805,64,343250
9227,0.045793,74.125.200.0-255,4114,338919,64,343250
9228,0.045811,172.31.40.0-255,66,338985,64,343250
9229,0.046103,172.31.40.0-255,105,339090,64,343250
9230,0.048316,74.125.200.0-255,66,339156,64,343250
9231,0.059417,172.31.40.0-255,172,339328,64,343250
9232,0.059456,172.31.40.0-255,1112,340440,64,343250
9233,0.059519,172.31.40.0-255,1514,341954,64,343250
9234,0.059521,172.31.40.0-255,1296,343250,64,343250
9235,0.0,172.217.194.0-255,150,150,64,171903
9236,1.4e-05,172.31.40.0-255,66,216,64,171903
9237,2.1e-05,172.217.194.0-255,1484,1700,64,171903
9238,2.6e-05,172.31.40.0-255,66,1766,64,171903
9239,3.2e-05,172.217.194.0-255,2902,4668,64,171903
9240,3.5e-05,172.31.40.0-255,66,4734,64,171903
9241,6.2e-05,172.217.194.0-255,7156,11890,64,171903
9242,6.5e-05,172.31.40.0-255,66,11956,64,171903
9243,8.1e-05,172.217.194.0-255,4320,16276,64,171903
9244,8.3e-05,172.31.40.0-255,66,16342,64,171903
9245,0.000119,172.31.40.0-255,66,16408,64,171903
9246,0.000123,172.217.194.0-255,2543,18951,64,171903
9247,0.000126,172.31.40.0-255,66,19017,64,171903
9248,0.000153,172.217.194.0-255,1484,20501,64,171903
9249,0.000156,172.31.40.0-255,66,20567,64,171903
9250,0.000159,172.217.194.0-255,1484,22051,64,171903
9251,0.000161,172.31.40.0-255,66,22117,64,171903
9252,0.000179,172.217.194.0-255,1484,23601,64,171903
9253,0.000181,172.31.40.0-255,66,23667,64,171903
9254,0.000188,172.217.194.0-255,5738,29405,64,171903
9255,0.00019,172.31.40.0-255,66,29471,64,171903
9256,0.000221,172.217.194.0-255,5738,35209,64,171903
9257,0.000224,172.31.40.0-255,66,35275,64,171903
9258,0.000227,172.217.194.0-255,1484,36759,64,171903
9259,0.000229,172.31.40.0-255,66,36825,64,171903
9260,0.000249,172.217.194.0-255,5738,42563,64,171903
9261,0.000252,172.31.40.0-255,66,42629,64,171903
9262,0.000257,172.217.194.0-255,4320,46949,64,171903
9263,0.000259,172.31.40.0-255,66,47015,64,171903
9264,0.000293,172.217.194.0-255,2902,49917,64,171903
9265,0.000296,172.31.40.0-255,66,49983,64,171903
9266,0.000318,172.217.194.0-255,3602,53585,64,171903
9267,0.000321,172.31.40.0-255,66,53651,64,171903
9268,0.000324,172.217.194.0-255,410,54061,64,171903
9269,0.000345,172.217.194.0-255,1484,55545,64,171903
9270,0.000347,172.31.40.0-255,66,55611,64,171903
9271,0.00035,172.217.194.0-255,1484,57095,64,171903
9272,0.000369,172.217.194.0-255,2902,59997,64,171903
9273,0.000371,172.31.40.0-255,66,60063,64,171903
9274,0.000374,172.217.194.0-255,1484,61547,64,171903
9275,0.000401,172.31.40.0-255,66,61613,64,171903
9276,0.000404,172.217.194.0-255,1484,63097,64,171903
9277,0.000418,172.217.194.0-255,1484,64581,64,171903
9278,0.000421,172.31.40.0-255,66,64647,64,171903
9279,0.000449,172.217.194.0-255,7156,71803,64,171903
9280,0.000452,172.31.40.0-255,66,71869,64,171903
9281,0.000455,172.217.194.0-255,1484,73353,64,171903
9282,0.00048,172.217.194.0-255,6156,79509,64,171903
9283,0.000483,172.31.40.0-255,66,79575,64,171903
9284,0.000584,172.217.194.0-255,1484,81059,64,171903
9285,0.000589,172.217.194.0-255,2902,83961,64,171903
9286,0.000593,172.31.40.0-255,66,84027,64,171903
9287,0.000599,172.217.194.0-255,4320,88347,64,171903
9288,0.000601,172.31.40.0-255,66,88413,64,171903
9289,0.000613,172.217.194.0-255,1484,89897,64,171903
9290,0.000645,172.31.40.0-255,66,89963,64,171903
9291,0.00068,172.31.40.0-255,66,90029,64,171903
9292,0.000757,172.217.194.0-255,1484,91513,64,171903
9293,0.000763,172.217.194.0-255,2902,94415,64,171903
9294,0.000765,172.31.40.0-255,66,94481,64,171903
9295,0.000769,172.217.194.0-255,1484,95965,64,171903
9296,0.000791,172.217.194.0-255,4320,100285,64,171903
9297,0.000794,172.31.40.0-255,66,100351,64,171903
9298,0.000797,172.217.194.0-255,1484,101835,64,171903
9299,0.000836,172.31.40.0-255,66,101901,64,171903
9300,0.000847,172.31.40.0-255,66,101967,64,171903
9301,0.000902,172.217.194.0-255,2184,104151,64,171903
9302,0.000906,172.31.40.0-255,66,104217,64,171903
9303,0.001093,172.217.194.0-255,1484,105701,64,171903
9304,0.001117,172.217.194.0-255,2902,108603,64,171903
9305,0.00112,172.31.40.0-255,66,108669,64,171903
9306,0.001142,172.217.194.0-255,4320,112989,64,171903
9307,0.001144,172.31.40.0-255,66,113055,64,171903
9308,0.001182,172.31.40.0-255,66,113121,64,171903
9309,0.001187,172.217.194.0-255,4320,117441,64,171903
9310,0.00119,172.31.40.0-255,66,117507,64,171903
9311,0.001223,172.217.194.0-255,1484,118991,64,171903
9312,0.001237,172.217.194.0-255,4320,123311,64,171903
9313,0.00124,172.31.40.0-255,66,123377,64,171903
9314,0.001255,172.217.194.0-255,4320,127697,64,171903
9315,0.001258,172.31.40.0-255,66,127763,64,171903
9316,0.001279,172.217.194.0-255,2184,129947,64,171903
9317,0.001281,172.31.40.0-255,66,130013,64,171903
9318,0.001295,172.31.40.0-255,66,130079,64,171903
9319,0.001305,172.31.40.0-255,66,130145,64,171903
9320,0.001339,172.217.194.0-255,2902,133047,64,171903
9321,0.001342,172.31.40.0-255,66,133113,64,171903
9322,0.001378,172.31.40.0-255,66,133179,64,171903
9323,0.001817,172.217.194.0-255,1484,134663,64,171903
9324,0.001823,172.217.194.0-255,2902,137565,64,171903
9325,0.001829,172.31.40.0-255,66,137631,64,171903
9326,0.001846,172.217.194.0-255,5738,143369,64,171903
9327,0.001848,172.31.40.0-255,66,143435,64,171903
9328,0.001853,172.217.194.0-255,2902,146337,64,171903
9329,0.001855,172.31.40.0-255,66,146403,64,171903
9330,0.001892,172.31.40.0-255,66,146469,64,171903
9331,0.001903,172.31.40.0-255,66,146535,64,171903
9332,0.001918,172.217.194.0-255,766,147301,64,171903
9333,0.001925,172.217.194.0-255,7156,154457,64,171903
9334,0.001928,172.31.40.0-255,66,154523,64,171903
9335,0.001949,172.217.194.0-255,4320,158843,64,171903
9336,0.001952,172.31.40.0-255,66,158909,64,171903
9337,0.001992,172.31.40.0-255,66,158975,64,171903
9338,0.001997,172.217.194.0-255,2902,161877,64,171903
9339,0.001999,172.31.40.0-255,66,161943,64,171903
9340,0.002054,172.217.194.0-255,5020,166963,64,171903
9341,0.002078,172.31.40.0-255,66,167029,64,171903
9342,0.00215,172.31.40.0-255,66,167095,64,171903
9343,0.002217,172.217.194.0-255,105,167200,64,171903
9344,0.002232,172.31.40.0-255,66,167266,64,171903
9345,0.004546,172.31.40.0-255,105,167371,64,171903
9346,0.006824,172.217.194.0-255,66,167437,64,171903
9347,0.035477,172.31.40.0-255,172,167609,64,171903
9348,0.035508,172.31.40.0-255,1111,168720,64,171903
9349,0.035573,172.31.40.0-255,1514,170234,64,171903
9350,0.035575,172.31.40.0-255,1297,171531,64,171903
9351,0.037075,104.244.42.0-255,66,171597,64,171903
9352,0.037115,104.244.42.0-255,66,171663,64,171903
9353,0.037166,104.244.42.0-255,66,171729,64,171903
9354,0.038239,104.244.42.0-255,108,171837,64,171903
9355,0.038245,172.31.40.0-255,66,171903,64,171903
9356,0.0,172.217.27.0-255,160,160,64,276840
9357,1.5e-05,172.31.40.0-255,66,226,64,276840
9358,2.2e-05,172.217.27.0-255,1484,1710,64,276840
9359,2.5e-05,172.31.40.0-255,66,1776,64,276840
9360,2.9e-05,172.217.27.0-255,1484,3260,64,276840
9361,3.2e-05,172.31.40.0-255,66,3326,64,276840
9362,4.8e-05,172.217.27.0-255,1484,4810,64,276840
9363,5e-05,172.31.40.0-255,66,4876,64,276840
9364,5.8e-05,172.217.27.0-255,4320,9196,64,276840
9365,6e-05,172.31.40.0-255,66,9262,64,276840
9366,8e-05,172.217.27.0-255,2902,12164,64,276840
9367,8.3e-05,172.31.40.0-255,66,12230,64,276840
9368,8.6e-05,172.217.27.0-255,1484,13714,64,276840
9369,8.8e-05,172.31.40.0-255,66,13780,64,276840
9370,9.3e-05,172.217.27.0-255,2034,15814,64,276840
9371,9.5e-05,172.31.40.0-255,66,15880,64,276840
9372,0.000102,172.217.27.0-255,5738,21618,64,276840
9373,0.000105,172.31.40.0-255,66,21684,64,276840
9374,0.000127,172.217.27.0-255,1484,23168,64,276840
9375,0.000129,172.31.40.0-255,66,23234,64,276840
9376,0.000158,172.31.40.0-255,66,23300,64,276840
9377,0.000223,172.217.27.0-255,1484,24784,64,276840
9378,0.000225,172.31.40.0-255,66,24850,64,276840
9379,0.000229,172.217.27.0-255,1484,26334,64,276840
9380,0.000231,172.31.40.0-255,66,26400,64,276840
9381,0.000243,172.217.27.0-255,1484,27884,64,276840
9382,0.000245,172.31.40.0-255,66,27950,64,276840
9383,0.000252,172.217.27.0-255,5738,33688,64,276840
9384,0.000255,172.31.40.0-255,66,33754,64,276840
9385,0.000261,172.217.27.0-255,4320,38074,64,276840
9386,0.000263,172.31.40.0-255,66,38140,64,276840
9387,0.000301,172.31.40.0-255,66,38206,64,276840
9388,0.000307,172.217.27.0-255,5738,43944,64,276840
9389,0.00031,172.31.40.0-255,66,44010,64,276840
9390,0.000327,172.217.27.0-255,5315,49325,64,276840
9391,0.00033,172.31.40.0-255,66,49391,64,276840
9392,0.000738,172.217.27.0-255,132,49523,64,276840
9393,0.001004,172.217.27.0-255,1484,51007,64,276840
9394,0.00101,172.31.40.0-255,66,51073,64,276840
9395,0.001016,172.217.27.0-255,2902,53975,64,276840
9396,0.001018,172.31.40.0-255,66,54041,64,276840
9397,0.001024,172.217.27.0-255,5738,59779,64,276840
9398,0.001027,172.31.40.0-255,66,59845,64,276840
9399,0.001041,172.31.40.0-255,66,59911,64,276840
9400,0.001069,172.217.27.0-255,2902,62813,64,276840
9401,0.001071,172.31.40.0-255,66,62879,64,276840
9402,0.001096,172.31.40.0-255,66,62945,64,276840
9403,0.002722,172.217.27.0-255,5738,68683,64,276840
9404,0.002729,172.31.40.0-255,66,68749,64,276840
9405,0.004344,172.217.27.0-255,2902,71651,64,276840
9406,0.004349,172.31.40.0-255,66,71717,64,276840
9407,0.004368,172.217.27.0-255,2902,74619,64,276840
9408,0.00437,172.31.40.0-255,66,74685,64,276840
9409,0.005973,172.217.27.0-255,2902,77587,64,276840
9410,0.005978,172.31.40.0-255,66,77653,64,276840
9411,0.005997,172.217.27.0-255,2902,80555,64,276840
9412,0.005999,172.31.40.0-255,66,80621,64,276840
9413,0.00759,172.217.27.0-255,2902,83523,64,276840
9414,0.007594,172.31.40.0-255,66,83589,64,276840
9415,0.007614,172.217.27.0-255,2902,86491,64,276840
9416,0.007616,172.31.40.0-255,66,86557,64,276840
9417,0.009205,172.217.27.0-255,2902,89459,64,276840
9418,0.009212,172.31.40.0-255,66,89525,64,276840
9419,0.009233,172.217.27.0-255,2902,92427,64,276840
9420,0.009236,172.31.40.0-255,66,92493,64,276840
9421,0.010836,172.217.27.0-255,5738,98231,64,276840
9422,0.010842,172.31.40.0-255,66,98297,64,276840
9423,0.01246,172.217.27.0-255,5738,104035,64,276840
9424,0.012469,172.31.40.0-255,66,104101,64,276840
9425,0.014083,172.217.27.0-255,5738,109839,64,276840
9426,0.01409,172.31.40.0-255,66,109905,64,276840
9427,0.015711,172.217.27.0-255,5738,115643,64,276840
9428,0.015719,172.31.40.0-255,66,115709,64,276840
9429,0.017332,172.217.27.0-255,5738,121447,64,276840
9430,0.017339,172.31.40.0-255,66,121513,64,276840
9431,0.018963,172.217.27.0-255,5738,127251,64,276840
9432,0.018971,172.31.40.0-255,66,127317,64,276840
9433,0.02059,172.217.27.0-255,5738,133055,64,276840
9434,0.020597,172.31.40.0-255,66,133121,64,276840
9435,0.022211,172.217.27.0-255,2902,136023,64,276840
9436,0.022218,172.31.40.0-255,66,136089,64,276840
9437,0.022238,172.217.27.0-255,2902,138991,64,276840
9438,0.022241,172.31.40.0-255,66,139057,64,276840
9439,0.023897,172.217.27.0-255,5738,144795,64,276840
9440,0.023904,172.31.40.0-255,66,144861,64,276840
9441,0.025521,172.217.27.0-255,5738,150599,64,276840
9442,0.025527,172.31.40.0-255,66,150665,64,276840
9443,0.027218,172.217.27.0-255,5738,156403,64,276840
9444,0.027226,172.31.40.0-255,66,156469,64,276840
9445,0.028478,172.31.40.0-255,171,156640,64,276840
9446,0.028505,172.31.40.0-255,1135,157775,64,276840
9447,0.028555,172.31.40.0-255,1514,159289,64,276840
9448,0.028556,172.31.40.0-255,1273,160562,64,276840
9449,0.028837,172.217.27.0-255,5738,166300,64,276840
9450,0.028844,172.31.40.0-255,66,166366,64,276840
9451,0.030025,104.244.42.0-255,66,166432,64,276840
9452,0.030056,104.244.42.0-255,66,166498,64,276840
9453,0.030107,104.244.42.0-255,66,166564,64,276840
9454,0.030464,172.217.27.0-255,5738,172302,64,276840
9455,0.030469,172.31.40.0-255,66,172368,64,276840
9456,0.032116,172.217.27.0-255,5738,178106,64,276840
9457,0.032122,172.31.40.0-255,66,178172,64,276840
9458,0.033761,172.217.27.0-255,5738,183910,64,276840
9459,0.033767,172.31.40.0-255,66,183976,64,276840
9460,0.035415,172.217.27.0-255,5738,189714,64,276840
9461,0.035423,172.31.40.0-255,66,189780,64,276840
9462,0.037033,172.217.27.0-255,5738,195518,64,276840
9463,0.037042,172.31.40.0-255,66,195584,64,276840
9464,0.038734,172.217.27.0-255,5738,201322,64,276840
9465,0.038741,172.31.40.0-255,66,201388,64,276840
9466,0.040359,172.217.27.0-255,5738,207126,64,276840
9467,0.040365,172.31.40.0-255,66,207192,64,276840
9468,0.041985,172.217.27.0-255,5738,212930,64,276840
9469,0.041991,172.31.40.0-255,66,212996,64,276840
9470,0.043622,172.217.27.0-255,5738,218734,64,276840
9471,0.043628,172.31.40.0-255,66,218800,64,276840
9472,0.045257,172.217.27.0-255,5738,224538,64,276840
9473,0.045263,172.31.40.0-255,66,224604,64,276840
9474,0.04689,172.217.27.0-255,5738,230342,64,276840
9475,0.046897,172.31.40.0-255,66,230408,64,276840
9476,0.048514,172.217.27.0-255,5738,236146,64,276840
9477,0.048521,172.31.40.0-255,66,236212,64,276840
9478,0.050148,172.217.27.0-255,5738,241950,64,276840
9479,0.050154,172.31.40.0-255,66,242016,64,276840
9480,0.051835,172.217.27.0-255,5738,247754,64,276840
9481,0.051842,172.31.40.0-255,66,247820,64,276840
9482,0.053461,172.217.27.0-255,5738,253558,64,276840
9483,0.053467,172.31.40.0-255,66,253624,64,276840
9484,0.05509,172.217.27.0-255,5738,259362,64,276840
9485,0.055097,172.31.40.0-255,66,259428,64,276840
9486,0.056721,172.217.27.0-255,5738,265166,64,276840
9487,0.056727,172.31.40.0-255,66,265232,64,276840
9488,0.058354,172.217.27.0-255,5738,270970,64,276840
9489,0.05836,172.31.40.0-255,66,271036,64,276840
9490,0.059985,172.217.27.0-255,5738,276774,64,276840
9491,0.059991,172.31.40.0-255,66,276840,64,276840
9492,0.0,172.31.40.0-255,233,233,64,299
9493,0.007379,74.125.24.0-255,66,299,64,299
9494,0.0,74.125.24.0-255,306,306,64,334603
9495,1.6e-05,172.31.40.0-255,66,372,64,334603
9496,2.2e-05,74.125.24.0-255,1484,1856,64,334603
9497,2.6e-05,172.31.40.0-255,66,1922,64,334603
9498,3.2e-05,74.125.24.0-255,2902,4824,64,334603
9499,3.5e-05,172.31.40.0-255,66,4890,64,334603
9500,5.9e-05,74.125.24.0-255,1484,6374,64,334603
9501,6.1e-05,172.31.40.0-255,66,6440,64,334603
9502,7.5e-05,172.31.40.0-255,66,6506,64,334603
9503,9.9e-05,172.31.40.0-255,66,6572,64,334603
9504,0.000124,74.125.24.0-255,5379,11951,64,334603
9505,0.000127,172.31.40.0-255,66,12017,64,334603
9506,0.000231,74.125.24.0-255,1484,13501,64,334603
9507,0.000235,172.31.40.0-255,66,13567,64,334603
9508,0.000241,74.125.24.0-255,2902,16469,64,334603
9509,0.000243,172.31.40.0-255,66,16535,64,334603
9510,0.000247,74.125.24.0-255,2902,19437,64,334603
9511,0.00025,172.31.40.0-255,66,19503,64,334603
9512,0.00027,74.125.24.0-255,2902,22405,64,334603
9513,0.000272,172.31.40.0-255,66,22471,64,334603
9514,0.000275,74.125.24.0-255,1484,23955,64,334603
9515,0.000278,172.31.40.0-255,66,24021,64,334603
9516,0.0003,74.125.24.0-255,5379,29400,64,334603
9517,0.000304,172.31.40.0-255,66,29466,64,334603
9518,0.000623,74.125.24.0-255,1484,30950,64,334603
9519,0.00063,172.31.40.0-255,66,31016,64,334603
9520,0.000636,74.125.24.0-255,2902,33918,64,334603
9521,0.000639,172.31.40.0-255,66,33984,64,334603
9522,0.000646,74.125.24.0-255,5738,39722,64,334603
9523,0.000649,172.31.40.0-255,66,39788,64,334603
9524,0.000702,172.31.40.0-255,66,39854,64,334603
9525,0.000713,172.31.40.0-255,66,39920,64,334603
9526,0.000737,74.125.24.0-255,1484,41404,64,334603
9527,0.000766,74.125.24.0-255,5379,46783,64,334603
9528,0.00077,172.31.40.0-255,66,46849,64,334603
9529,0.000777,74.125.24.0-255,7156,54005,64,334603
9530,0.00078,172.31.40.0-255,66,54071,64,334603
9531,0.000784,74.125.24.0-255,2902,56973,64,334603
9532,0.000786,172.31.40.0-255,66,57039,64,334603
9533,0.000832,172.31.40.0-255,66,57105,64,334603
9534,0.000838,74.125.24.0-255,4906,62011,64,334603
9535,0.00084,172.31.40.0-255,66,62077,64,334603
9536,0.000885,74.125.24.0-255,1484,63561,64,334603
9537,0.000891,74.125.24.0-255,2902,66463,64,334603
9538,0.000893,172.31.40.0-255,66,66529,64,334603
9539,0.0009,74.125.24.0-255,5738,72267,64,334603
9540,0.000902,172.31.40.0-255,66,72333,64,334603
9541,0.000916,172.31.40.0-255,66,72399,64,334603
9542,0.000922,74.125.24.0-255,5738,78137,64,334603
9543,0.000925,172.31.40.0-255,66,78203,64,334603
9544,0.000957,74.125.24.0-255,5165,83368,64,334603
9545,0.00096,172.31.40.0-255,66,83434,64,334603
9546,0.001259,74.125.24.0-255,1484,84918,64,334603
9547,0.001265,74.125.24.0-255,1484,86402,64,334603
9548,0.001269,172.31.40.0-255,66,86468,64,334603
9549,0.001289,74.125.24.0-255,1484,87952,64,334603
9550,0.001296,74.125.24.0-255,5738,93690,64,334603
9551,0.001298,172.31.40.0-255,66,93756,64,334603
9552,0.001304,74.125.24.0-255,5738,99494,64,334603
9553,0.001306,172.31.40.0-255,66,99560,64,334603
9554,0.001335,74.125.24.0-255,5738,105298,64,334603
9555,0.001337,172.31.40.0-255,66,105364,64,334603
9556,0.001355,74.125.24.0-255,7156,112520,64,334603
9557,0.001358,172.31.40.0-255,66,112586,64,334603
9558,0.001363,74.125.24.0-255,5020,117606,64,334603
9559,0.001364,172.31.40.0-255,66,117672,64,334603
9560,0.001486,74.125.24.0-255,1484,119156,64,334603
9561,0.001505,74.125.24.0-255,2902,122058,64,334603
9562,0.001507,172.31.40.0-255,66,122124,64,334603
9563,0.001514,74.125.24.0-255,5738,127862,64,334603
9564,0.001516,172.31.40.0-255,66,127928,64,334603
9565,0.001559,74.125.24.0-255,4320,132248,64,334603
9566,0.001562,172.31.40.0-255,66,132314,64,334603
9567,0.001582,172.31.40.0-255,66,132380,64,334603
9568,0.001618,74.125.24.0-255,4320,136700,64,334603
9569,0.00162,172.31.40.0-255,66,136766,64,334603
9570,0.001641,74.125.24.0-255,6438,143204,64,334603
9571,0.001644,172.31.40.0-255,66,143270,64,334603
9572,0.001689,74.125.24.0-255,1484,144754,64,334603
9573,0.001693,74.125.24.0-255,1484,146238,64,334603
9574,0.001695,172.31.40.0-255,66,146304,64,334603
9575,0.001712,74.125.24.0-255,1484,147788,64,334603
9576,0.001716,74.125.24.0-255,2902,150690,64,334603
9577,0.001718,172.31.40.0-255,66,150756,64,334603
9578,0.001724,74.125.24.0-255,5738,156494,64,334603
9579,0.001728,172.31.40.0-255,66,156560,64,334603
9580,0.001747,74.125.24.0-255,1484,158044,64,334603
9581,0.001754,74.125.24.0-255,7156,165200,64,334603
9582,0.001786,74.125.24.0-255,3602,168802,64,334603
9583,0.00179,172.31.40.0-255,66,168868,64,334603
9584,0.001795,172.31.40.0-255,66,168934,64,334603
9585,0.001817,74.125.24.0-255,1484,170418,64,334603
9586,0.001821,74.125.24.0-255,2902,173320,64,334603
9587,0.001824,74.125.24.0-255,1484,174804,64,334603
9588,0.001835,172.31.40.0-255,66,174870,64,334603
9589,0.001841,74.125.24.0-255,4320,179190,64,334603
9590,0.00185,172.31.40.0-255,66,179256,64,334603
9591,0.001853,74.125.24.0-255,1484,180740,64,334603
9592,0.00187,74.125.24.0-255,5738,186478,64,334603
9593,0.001877,172.31.40.0-255,66,186544,64,334603
9594,0.00189,74.125.24.0-255,5738,192282,64,334603
9595,0.001895,74.125.24.0-255,4320,196602,64,334603
9596,0.001907,74.125.24.0-255,2902,199504,64,334603
9597,0.001917,172.31.40.0-255,66,199570,64,334603
9598,0.001932,74.125.24.0-255,3602,203172,64,334603
9599,0.001939,172.31.40.0-255,66,203238,64,334603
9600,0.004301,74.125.24.0-255,1484,204722,64,334603
9601,0.004376,74.125.24.0-255,4320,209042,64,334603
9602,0.004381,172.31.40.0-255,66,209108,64,334603
9603,0.006873,74.125.24.0-255,5738,214846,64,334603
9604,0.006881,172.31.40.0-255,66,214912,64,334603
9605,0.009346,74.125.24.0-255,5738,220650,64,334603
9606,0.009356,172.31.40.0-255,66,220716,64,334603
9607,0.011772,74.125.24.0-255,5738,226454,64,334603
9608,0.011785,172.31.40.0-255,66,226520,64,334603
9609,0.014238,74.125.24.0-255,5738,232258,64,334603
9610,0.014245,172.31.40.0-255,66,232324,64,334603
9611,0.016749,74.125.24.0-255,5738,238062,64,334603
9612,0.016767,172.31.40.0-255,66,238128,64,334603
9613,0.019189,74.125.24.0-255,5738,243866,64,334603
9614,0.019197,172.31.40.0-255,66,243932,64,334603
9615,0.0216,74.125.24.0-255,5738,249670,64,334603
9616,0.021609,172.31.40.0-255,66,249736,64,334603
9617,0.024052,74.125.24.0-255,5738,255474,64,334603
9618,0.024059,172.31.40.0-255,66,255540,64,334603
9619,0.02649,74.125.24.0-255,5738,261278,64,334603
9620,0.0265,172.31.40.0-255,66,261344,64,334603
9621,0.028964,74.125.24.0-255,5738,267082,64,334603
9622,0.028973,172.31.40.0-255,66,267148,64,334603
9623,0.03144,74.125.24.0-255,5738,272886,64,334603
9624,0.031457,172.31.40.0-255,66,272952,64,334603
9625,0.033878,74.125.24.0-255,5738,278690,64,334603
9626,0.033885,172.31.40.0-255,66,278756,64,334603
9627,0.036261,74.125.24.0-255,5738,284494,64,334603
9628,0.036269,172.31.40.0-255,66,284560,64,334603
9629,0.038688,74.125.24.0-255,5738,290298,64,334603
9630,0.038696,172.31.40.0-255,66,290364,64,334603
9631,0.041087,74.125.24.0-255,5738,296102,64,334603
9632,0.041106,172.31.40.0-255,66,296168,64,334603
9633,0.043486,74.125.24.0-255,5738,301906,64,334603
9634,0.043492,172.31.40.0-255,66,301972,64,334603
9635,0.045966,74.125.24.0-255,5738,307710,64,334603
9636,0.045985,172.31.40.0-255,66,307776,64,334603
9637,0.048435,74.125.24.0-255,5738,313514,64,334603
9638,0.048443,172.31.40.0-255,66,313580,64,334603
9639,0.050832,74.125.24.0-255,5738,319318,64,334603
9640,0.050846,172.31.40.0-255,66,319384,64,334603
9641,0.053088,172.31.40.0-255,175,319559,64,334603
9642,0.053118,172.31.40.0-255,1137,320696,64,334603
9643,0.053177,172.31.40.0-255,1514,322210,64,334603
9644,0.053179,172.31.40.0-255,1271,323481,64,334603
9645,0.053292,74.125.24.0-255,5738,329219,64,334603
9646,0.053298,172.31.40.0-255,66,329285,64,334603
9647,0.05466,104.244.42.0-255,66,329351,64,334603
9648,0.054696,104.244.42.0-255,66,329417,64,334603
9649,0.054753,104.244.42.0-255,66,329483,64,334603
9650,0.055742,74.125.24.0-255,4883,334366,64,334603
9651,0.055754,172.31.40.0-255,66,334432,64,334603
9652,0.056031,172.31.40.0-255,105,334537,64,334603
9653,0.0584,74.125.24.0-255,66,334603,64,334603
9654,0.0,74.125.68.0-255,153,153,64,309403
9655,2.1e-05,172.31.40.0-255,66,219,64,309403
9656,2.8e-05,74.125.68.0-255,1484,1703,64,309403
9657,3.3e-05,172.31.40.0-255,66,1769,64,309403
9658,3.6e-05,74.125.68.0-255,1484,3253,64,309403
9659,3.9e-05,172.31.40.0-255,66,3319,64,309403
9660,4.5e-05,74.125.68.0-255,2902,6221,64,309403
9661,4.8e-05,172.31.40.0-255,66,6287,64,309403
9662,7.8e-05,74.125.68.0-255,5738,12025,64,309403
9663,8.2e-05,172.31.40.0-255,66,12091,64,309403
9664,8.7e-05,74.125.68.0-255,2099,14190,64,309403
9665,8.9e-05,172.31.40.0-255,66,14256,64,309403
9666,0.000165,74.125.68.0-255,1484,15740,64,309403
9667,0.000168,172.31.40.0-255,66,15806,64,309403
9668,0.000173,74.125.68.0-255,2902,18708,64,309403
9669,0.000175,172.31.40.0-255,66,18774,64,309403
9670,0.00019,74.125.68.0-255,1484,20258,64,309403
9671,0.000192,172.31.40.0-255,66,20324,64,309403
9672,0.000213,74.125.68.0-255,2902,23226,64,309403
9673,0.000216,172.31.40.0-255,66,23292,64,309403
9674,0.000253,74.125.68.0-255,7156,30448,64,309403
9675,0.000256,172.31.40.0-255,66,30514,64,309403
9676,0.000276,74.125.68.0-255,1125,31639,64,309403
9677,0.000278,172.31.40.0-255,66,31705,64,309403
9678,0.00029,172.31.40.0-255,66,31771,64,309403
9679,0.000296,74.125.68.0-255,5738,37509,64,309403
9680,0.000298,172.31.40.0-255,66,37575,64,309403
9681,0.000345,74.125.68.0-255,2543,40118,64,309403
9682,0.000348,172.31.40.0-255,66,40184,64,309403
9683,0.000363,74.125.68.0-255,1484,41668,64,309403
9684,0.000365,172.31.40.0-255,66,41734,64,309403
9685,0.000377,74.125.68.0-255,1484,43218,64,309403
9686,0.000402,74.125.68.0-255,4320,47538,64,309403
9687,0.000405,172.31.40.0-255,66,47604,64,309403
9688,0.000412,74.125.68.0-255,5738,53342,64,309403
9689,0.000414,172.31.40.0-255,66,53408,64,309403
9690,0.00044,74.125.68.0-255,3961,57369,64,309403
9691,0.000443,172.31.40.0-255,66,57435,64,309403
9692,0.00048,74.125.68.0-255,678,58113,64,309403
9693,0.000562,74.125.68.0-255,1484,59597,64,309403
9694,0.000566,172.31.40.0-255,66,59663,64,309403
9695,0.00057,74.125.68.0-255,1484,61147,64,309403
9696,0.000582,74.125.68.0-255,1484,62631,64,309403
9697,0.000585,172.31.40.0-255,66,62697,64,309403
9698,0.000588,74.125.68.0-255,1484,64181,64,309403
9699,0.000593,74.125.68.0-255,2902,67083,64,309403
9700,0.000596,172.31.40.0-255,66,67149,64,309403
9701,0.000625,74.125.68.0-255,5738,72887,64,309403
9702,0.000628,172.31.40.0-255,66,72953,64,309403
9703,0.000631,74.125.68.0-255,1484,74437,64,309403
9704,0.000652,74.125.68.0-255,3961,78398,64,309403
9705,0.000655,172.31.40.0-255,66,78464,64,309403
9706,0.000659,74.125.68.0-255,4320,82784,64,309403
9707,0.000661,172.31.40.0-255,66,82850,64,309403
9708,0.000672,74.125.68.0-255,1484,84334,64,309403
9709,0.000686,74.125.68.0-255,1484,85818,64,309403
9710,0.000688,172.31.40.0-255,66,85884,64,309403
9711,0.000713,74.125.68.0-255,6797,92681,64,309403
9712,0.000716,172.31.40.0-255,66,92747,64,309403
9713,0.001044,74.125.68.0-255,1484,94231,64,309403
9714,0.001048,74.125.68.0-255,1484,95715,64,309403
9715,0.001054,172.31.40.0-255,66,95781,64,309403
9716,0.001063,74.125.68.0-255,1484,97265,64,309403
9717,0.001066,74.125.68.0-255,1484,98749,64,309403
9718,0.001068,172.31.40.0-255,66,98815,64,309403
9719,0.001089,74.125.68.0-255,4320,103135,64,309403
9720,0.001092,172.31.40.0-255,66,103201,64,309403
9721,0.001106,74.125.68.0-255,2902,106103,64,309403
9722,0.001109,172.31.40.0-255,66,106169,64,309403
9723,0.001142,74.125.68.0-255,5738,111907,64,309403
9724,0.001155,74.125.68.0-255,5020,116927,64,309403
9725,0.001159,172.31.40.0-255,66,116993,64,309403
9726,0.001167,172.31.40.0-255,66,117059,64,309403
9727,0.001171,172.31.40.0-255,66,117125,64,309403
9728,0.001368,74.125.68.0-255,1484,118609,64,309403
9729,0.001375,74.125.68.0-255,2902,121511,64,309403
9730,0.001379,172.31.40.0-255,66,121577,64,309403
9731,0.001405,74.125.68.0-255,5738,127315,64,309403
9732,0.001408,172.31.40.0-255,66,127381,64,309403
9733,0.001413,74.125.68.0-255,2902,130283,64,309403
9734,0.001415,172.31.40.0-255,66,130349,64,309403
9735,0.00142,74.125.68.0-255,4320,134669,64,309403
9736,0.001422,172.31.40.0-255,66,134735,64,309403
9737,0.00146,74.125.68.0-255,4320,139055,64,309403
9738,0.001498,172.31.40.0-255,66,139121,64,309403
9739,0.001506,172.31.40.0-255,66,139187,64,309403
9740,0.001511,74.125.68.0-255,3602,142789,64,309403
9741,0.001513,172.31.40.0-255,66,142855,64,309403
9742,0.001841,74.125.68.0-255,1484,144339,64,309403
9743,0.001848,74.125.68.0-255,2902,147241,64,309403
9744,0.001851,172.31.40.0-255,66,147307,64,309403
9745,0.001873,74.125.68.0-255,5738,153045,64,309403
9746,0.001876,172.31.40.0-255,66,153111,64,309403
9747,0.001898,74.125.68.0-255,2902,156013,64,309403
9748,0.001902,172.31.40.0-255,66,156079,64,309403
9749,0.001907,74.125.68.0-255,4320,160399,64,309403
9750,0.001909,172.31.40.0-255,66,160465,64,309403
9751,0.001931,74.125.68.0-255,7156,167621,64,309403
9752,0.001934,172.31.40.0-255,66,167687,64,309403
9753,0.001957,74.125.68.0-255,1484,169171,64,309403
9754,0.001963,74.125.68.0-255,4320,173491,64,309403
9755,0.001965,172.31.40.0-255,66,173557,64,309403
9756,0.001987,74.125.68.0-255,3602,177159,64,309403
9757,0.001989,172.31.40.0-255,66,177225,64,309403
9758,0.004486,74.125.68.0-255,1484,178709,64,309403
9759,0.004508,74.125.68.0-255,4320,183029,64,309403
9760,0.004513,172.31.40.0-255,66,183095,64,309403
9761,0.00702,74.125.68.0-255,2902,185997,64,309403
9762,0.007023,172.31.40.0-255,66,186063,64,309403
9763,0.007037,74.125.68.0-255,2902,188965,64,309403
9764,0.00704,172.31.40.0-255,66,189031,64,309403
9765,0.009543,74.125.68.0-255,5738,194769,64,309403
9766,0.009551,172.31.40.0-255,66,194835,64,309403
9767,0.012068,74.125.68.0-255,5738,200573,64,309403
9768,0.012078,172.31.40.0-255,66,200639,64,309403
9769,0.014606,74.125.68.0-255,5738,206377,64,309403
9770,0.014618,172.31.40.0-255,66,206443,64,309403
9771,0.017135,74.125.68.0-255,5738,212181,64,309403
9772,0.017145,172.31.40.0-255,66,212247,64,309403
9773,0.019666,74.125.68.0-255,5738,217985,64,309403
9774,0.019675,172.31.40.0-255,66,218051,64,309403
9775,0.022189,74.125.68.0-255,5738,223789,64,309403
9776,0.022197,172.31.40.0-255,66,223855,64,309403
9777,0.024711,74.125.68.0-255,5738,229593,64,309403
9778,0.024719,172.31.40.0-255,66,229659,64,309403
9779,0.027252,74.125.68.0-255,5738,235397,64,309403
9780,0.027271,172.31.40.0-255,66,235463,64,309403
9781,0.029828,74.125.68.0-255,5738,241201,64,309403
9782,0.02984,172.31.40.0-255,66,241267,64,309403
9783,0.032374,74.125.68.0-255,5738,247005,64,309403
9784,0.032392,172.31.40.0-255,66,247071,64,309403
9785,0.034905,74.125.68.0-255,5738,252809,64,309403
9786,0.034912,172.31.40.0-255,66,252875,64,309403
9787,0.037214,172.31.40.0-255,172,253047,64,309403
9788,0.037249,172.31.40.0-255,1113,254160,64,309403
9789,0.037311,172.31.40.0-255,1514,255674,64,309403
9790,0.037313,172.31.40.0-255,1295,256969,64,309403
9791,0.03742,74.125.68.0-255,5738,262707,64,309403
9792,0.037427,172.31.40.0-255,66,262773,64,309403
9793,0.038786,104.244.42.0-255,66,262839,64,309403
9794,0.038794,104.244.42.0-255,66,262905,64,309403
9795,0.038867,104.244.42.0-255,66,262971,64,309403
9796,0.039955,74.125.68.0-255,5738,268709,64,309403
9797,0.039966,172.31.40.0-255,66,268775,64,309403
9798,0.042498,74.125.68.0-255,5738,274513,64,309403
9799,0.042512,172.31.40.0-255,66,274579,64,309403
9800,0.045037,74.125.68.0-255,5738,280317,64,309403
9801,0.045066,172.31.40.0-255,66,280383,64,309403
9802,0.047611,74.125.68.0-255,5738,286121,64,309403
9803,0.04763,172.31.40.0-255,66,286187,64,309403
9804,0.05016,74.125.68.0-255,5738,291925,64,309403
9805,0.050179,172.31.40.0-255,66,291991,64,309403
9806,0.052705,74.125.68.0-255,5738,297729,64,309403
9807,0.052722,172.31.40.0-255,66,297795,64,309403
9808,0.055263,74.125.68.0-255,5738,303533,64,309403
9809,0.05528,172.31.40.0-255,66,303599,64,309403
9810,0.057826,74.125.68.0-255,5738,309337,64,309403
9811,0.057843,172.31.40.0-255,66,309403,64,309403
9812,0.0,172.217.194.0-255,153,153,64,211454
9813,2.3e-05,172.31.40.0-255,66,219,64,211454
9814,3e-05,172.217.194.0-255,1484,1703,64,211454
9815,3.5e-05,172.31.40.0-255,66,1769,64,211454
9816,4.6e-05,172.217.194.0-255,2902,4671,64,211454
9817,5e-05,172.31.40.0-255,66,4737,64,211454
9818,5.5e-05,172.217.194.0-255,4320,9057,64,211454
9819,5.8e-05,172.31.40.0-255,66,9123,64,211454
9820,6.4e-05,172.217.194.0-255,5738,14861,64,211454
9821,6.7e-05,172.31.40.0-255,66,14927,64,211454
9822,0.000105,172.217.194.0-255,3579,18506,64,211454
9823,0.000108,172.31.40.0-255,66,18572,64,211454
9824,0.000119,172.31.40.0-255,66,18638,64,211454
9825,0.000136,172.31.40.0-255,66,18704,64,211454
9826,0.000167,172.217.194.0-255,1484,20188,64,211454
9827,0.000169,172.31.40.0-255,66,20254,64,211454
9828,0.00018,172.31.40.0-255,66,20320,64,211454
9829,0.000185,172.217.194.0-255,2902,23222,64,211454
9830,0.000187,172.31.40.0-255,66,23288,64,211454
9831,0.000205,172.217.194.0-255,7052,30340,64,211454
9832,0.000208,172.31.40.0-255,66,30406,64,211454
9833,0.000264,172.217.194.0-255,119,30525,64,211454
9834,0.000267,172.31.40.0-255,66,30591,64,211454
9835,0.000371,172.217.194.0-255,1484,32075,64,211454
9836,0.000375,172.31.40.0-255,66,32141,64,211454
9837,0.000379,172.217.194.0-255,1484,33625,64,211454
9838,0.000382,172.31.40.0-255,66,33691,64,211454
9839,0.000404,172.217.194.0-255,1484,35175,64,211454
9840,0.000407,172.31.40.0-255,66,35241,64,211454
9841,0.000413,172.217.194.0-255,5738,40979,64,211454
9842,0.000416,172.31.40.0-255,66,41045,64,211454
9843,0.000424,172.217.194.0-255,1484,42529,64,211454
9844,0.000496,172.31.40.0-255,66,42595,64,211454
9845,0.000513,172.31.40.0-255,66,42661,64,211454
9846,0.000515,172.217.194.0-255,766,43427,64,211454
9847,0.000805,172.217.194.0-255,1484,44911,64,211454
9848,0.000811,172.31.40.0-255,66,44977,64,211454
9849,0.000817,172.217.194.0-255,2902,47879,64,211454
9850,0.00082,172.31.40.0-255,66,47945,64,211454
9851,0.000831,172.217.194.0-255,5738,53683,64,211454
9852,0.000833,172.31.40.0-255,66,53749,64,211454
9853,0.000878,172.31.40.0-255,66,53815,64,211454
9854,0.000894,172.217.194.0-255,2902,56717,64,211454
9855,0.000896,172.31.40.0-255,66,56783,64,211454
9856,0.00093,172.31.40.0-255,66,56849,64,211454
9857,0.001081,172.217.194.0-255,1484,58333,64,211454
9858,0.001087,172.217.194.0-255,2902,61235,64,211454
9859,0.001089,172.31.40.0-255,66,61301,64,211454
9860,0.001119,172.217.194.0-255,5738,67039,64,211454
9861,0.001136,172.31.40.0-255,66,67105,64,211454
9862,0.001148,172.31.40.0-255,66,67171,64,211454
9863,0.001176,172.217.194.0-255,4320,71491,64,211454
9864,0.001179,172.31.40.0-255,66,71557,64,211454
9865,0.001192,172.31.40.0-255,66,71623,64,211454
9866,0.001683,172.217.194.0-255,1484,73107,64,211454
9867,0.001689,172.217.194.0-255,2902,76009,64,211454
9868,0.001692,172.31.40.0-255,66,76075,64,211454
9869,0.001697,172.217.194.0-255,2902,78977,64,211454
9870,0.001699,172.31.40.0-255,66,79043,64,211454
9871,0.001735,172.217.194.0-255,2902,81945,64,211454
9872,0.001738,172.31.40.0-255,66,82011,64,211454
9873,0.001742,172.217.194.0-255,1484,83495,64,211454
9874,0.001758,172.31.40.0-255,66,83561,64,211454
9875,0.001764,172.217.194.0-255,5738,89299,64,211454
9876,0.001766,172.31.40.0-255,66,89365,64,211454
9877,0.001813,172.217.194.0-255,3602,92967,64,211454
9878,0.001816,172.31.40.0-255,66,93033,64,211454
9879,0.001827,172.31.40.0-255,66,93099,64,211454
9880,0.001842,172.31.40.0-255,66,93165,64,211454
9881,0.001849,172.217.194.0-255,7156,100321,64,211454
9882,0.001851,172.31.40.0-255,66,100387,64,211454
9883,0.001877,172.217.194.0-255,4320,104707,64,211454
9884,0.001883,172.31.40.0-255,66,104773,64,211454
9885,0.001887,172.217.194.0-255,2184,106957,64,211454
9886,0.001889,172.31.40.0-255,66,107023,64,211454
9887,0.002217,172.217.194.0-255,1484,108507,64,211454
9888,0.002222,172.217.194.0-255,1484,109991,64,211454
9889,0.002225,172.31.40.0-255,66,110057,64,211454
9890,0.002256,172.217.194.0-255,1484,111541,64,211454
9891,0.002263,172.217.194.0-255,5738,117279,64,211454
9892,0.002266,172.31.40.0-255,66,117345,64,211454
9893,0.002288,172.217.194.0-255,5738,123083,64,211454
9894,0.002323,172.217.194.0-255,1484,124567,64,211454
9895,0.002334,172.31.40.0-255,66,124633,64,211454
9896,0.002363,172.217.194.0-255,5738,130371,64,211454
9897,0.002368,172.217.194.0-255,5738,136109,64,211454
9898,0.002373,172.217.194.0-255,5020,141129,64,211454
9899,0.002399,172.217.194.0-255,5738,146867,64,211454
9900,0.00241,172.217.194.0-255,1484,148351,64,211454
9901,0.002424,172.217.194.0-255,4320,152671,64,211454
9902,0.002447,172.217.194.0-255,1484,154155,64,211454
9903,0.002469,172.217.194.0-255,2902,157057,64,211454
9904,0.002527,172.217.194.0-255,5738,162795,64,211454
9905,0.002553,172.217.194.0-255,1484,164279,64,211454
9906,0.002564,172.217.194.0-255,1484,165763,64,211454
9907,0.002604,172.217.194.0-255,1484,167247,64,211454
9908,0.002619,172.217.194.0-255,2902,170149,64,211454
9909,0.002622,172.217.194.0-255,1484,171633,64,211454
9910,0.002624,172.217.194.0-255,1484,173117,64,211454
9911,0.002627,172.217.194.0-255,2184,175301,64,211454
9912,0.002629,172.217.194.0-255,1484,176785,64,211454
9913,0.002653,172.217.194.0-255,2902,179687,64,211454
9914,0.002671,172.217.194.0-255,7156,186843,64,211454
9915,0.0027,172.217.194.0-255,4320,191163,64,211454
9916,0.002702,172.217.194.0-255,1484,192647,64,211454
9917,0.002704,172.217.194.0-255,1484,194131,64,211454
9918,0.002709,172.217.194.0-255,5020,199151,64,211454
9919,0.002711,172.217.194.0-255,1484,200635,64,211454
9920,0.002727,172.217.194.0-255,5285,205920,64,211454
9921,0.002761,172.217.194.0-255,105,206025,64,211454
9922,0.012753,172.217.194.0-255,105,206130,64,211454
9923,0.013265,172.31.40.0-255,66,206196,64,211454
9924,0.013271,172.31.40.0-255,66,206262,64,211454
9925,0.013275,172.31.40.0-255,66,206328,64,211454
9926,0.013278,172.31.40.0-255,66,206394,64,211454
9927,0.013293,172.31.40.0-255,66,206460,64,211454
9928,0.013299,172.31.40.0-255,66,206526,64,211454
9929,0.013302,172.31.40.0-255,66,206592,64,211454
9930,0.013306,172.31.40.0-255,66,206658,64,211454
9931,0.013309,172.31.40.0-255,66,206724,64,211454
9932,0.013312,172.31.40.0-255,66,206790,64,211454
9933,0.013315,172.31.40.0-255,66,206856,64,211454
9934,0.013319,172.31.40.0-255,66,206922,64,211454
9935,0.013322,172.31.40.0-255,66,206988,64,211454
9936,0.013325,172.31.40.0-255,66,207054,64,211454
9937,0.013329,172.31.40.0-255,66,207120,64,211454
9938,0.013333,172.31.40.0-255,66,207186,64,211454
9939,0.013337,172.31.40.0-255,66,207252,64,211454
9940,0.01334,172.31.40.0-255,66,207318,64,211454
9941,0.013343,172.31.40.0-255,66,207384,64,211454
9942,0.013345,172.31.40.0-255,66,207450,64,211454
9943,0.013349,172.31.40.0-255,66,207516,64,211454
9944,0.013353,172.31.40.0-255,66,207582,64,211454
9945,0.013356,172.31.40.0-255,66,207648,64,211454
9946,0.013359,172.31.40.0-255,66,207714,64,211454
9947,0.013363,172.31.40.0-255,78,207792,64,211454
9948,0.014745,172.31.40.0-255,101,207893,64,211454
9949,0.015676,172.31.40.0-255,105,207998,64,211454
9950,0.017258,172.217.194.0-255,66,208064,64,211454
9951,0.018171,172.217.194.0-255,66,208130,64,211454
9952,0.036853,172.31.40.0-255,167,208297,64,211454
9953,0.036885,172.31.40.0-255,1107,209404,64,211454
9954,0.036945,172.31.40.0-255,1514,210918,64,211454
9955,0.036947,172.31.40.0-255,338,211256,64,211454
9956,0.038427,104.244.42.0-255,66,211322,64,211454
9957,0.038457,104.244.42.0-255,66,211388,64,211454
9958,0.038497,104.244.42.0-255,66,211454,64,211454
9959,0.0,74.125.24.0-255,152,152,64,179993
9960,1.3e-05,172.31.40.0-255,66,218,64,179993
9961,1.9e-05,74.125.24.0-255,1484,1702,64,179993
9962,2.3e-05,172.31.40.0-255,66,1768,64,179993
9963,2.8e-05,74.125.24.0-255,2902,4670,64,179993
9964,3.1e-05,172.31.40.0-255,66,4736,64,179993
9965,8.2e-05,74.125.24.0-255,4320,9056,64,179993
9966,8.6e-05,172.31.40.0-255,66,9122,64,179993
9967,0.000123,74.125.24.0-255,2902,12024,64,179993
9968,0.000126,172.31.40.0-255,66,12090,64,179993
9969,0.000129,74.125.24.0-255,1976,14066,64,179993
9970,0.000131,172.31.40.0-255,66,14132,64,179993
9971,0.000143,172.31.40.0-255,66,14198,64,179993
9972,0.000156,172.31.40.0-255,66,14264,64,179993
9973,0.000165,172.31.40.0-255,66,14330,64,179993
9974,0.000185,74.125.24.0-255,5020,19350,64,179993
9975,0.000187,172.31.40.0-255,66,19416,64,179993
9976,0.000219,172.31.40.0-255,66,19482,64,179993
9977,0.000244,74.125.24.0-255,298,19780,64,179993
9978,0.000246,172.31.40.0-255,66,19846,64,179993
9979,0.000271,74.125.24.0-255,1484,21330,64,179993
9980,0.000273,172.31.40.0-255,66,21396,64,179993
9981,0.000277,74.125.24.0-255,2902,24298,64,179993
9982,0.000279,172.31.40.0-255,66,24364,64,179993
9983,0.000312,74.125.24.0-255,5738,30102,64,179993
9984,0.000314,172.31.40.0-255,66,30168,64,179993
9985,0.000324,172.31.40.0-255,66,30234,64,179993
9986,0.000348,74.125.24.0-255,1484,31718,64,179993
9987,0.000352,74.125.24.0-255,1484,33202,64,179993
9988,0.000354,172.31.40.0-255,66,33268,64,179993
9989,0.000395,172.31.40.0-255,66,33334,64,179993
9990,0.000441,74.125.24.0-255,1484,34818,64,179993
9991,0.000444,74.125.24.0-255,1484,36302,64,179993
9992,0.000446,172.31.40.0-255,66,36368,64,179993
9993,0.000469,74.125.24.0-255,1484,37852,64,179993
9994,0.000474,74.125.24.0-255,5738,43590,64,179993
9995,0.000477,172.31.40.0-255,66,43656,64,179993
9996,0.000507,172.31.40.0-255,66,43722,64,179993
9997,0.000527,74.125.24.0-255,1484,45206,64,179993
9998,0.000531,74.125.24.0-255,2902,48108,64,179993
9999,0.000533,172.31.40.0-255,66,48174,64,179993
10000,0.000544,74.125.24.0-255,1484,49658,64,179993
10001,0.000552,74.125.24.0-255,5738,55396,64,179993
10002,0.000554,172.31.40.0-255,66,55462,64,179993
10003,0.000557,74.125.24.0-255,766,56228,64,179993
10004,0.000584,74.125.24.0-255,1484,57712,64,179993
10005,0.000586,172.31.40.0-255,66,57778,64,179993
10006,0.000589,74.125.24.0-255,1484,59262,64,179993
10007,0.000607,74.125.24.0-255,2902,62164,64,179993
10008,0.00061,172.31.40.0-255,66,62230,64,179993
10009,0.000615,74.125.24.0-255,5738,67968,64,179993
10010,0.000617,172.31.40.0-255,66,68034,64,179993
10011,0.000622,74.125.24.0-255,5738,73772,64,179993
10012,0.000624,172.31.40.0-255,66,73838,64,179993
10013,0.000645,74.125.24.0-255,1484,75322,64,179993
10014,0.000658,172.31.40.0-255,66,75388,64,179993
10015,0.000681,74.125.24.0-255,1484,76872,64,179993
10016,0.000684,74.125.24.0-255,766,77638,64,179993
10017,0.000686,172.31.40.0-255,66,77704,64,179993
10018,0.000786,74.125.24.0-255,1484,79188,64,179993
10019,0.000791,74.125.24.0-255,2902,82090,64,179993
10020,0.000794,172.31.40.0-255,66,82156,64,179993
10021,0.000799,74.125.24.0-255,4320,86476,64,179993
10022,0.000801,172.31.40.0-255,66,86542,64,179993
10023,0.000825,74.125.24.0-255,1484,88026,64,179993
10024,0.000831,74.125.24.0-255,4320,92346,64,179993
10025,0.000834,172.31.40.0-255,66,92412,64,179993
10026,0.000846,172.31.40.0-255,66,92478,64,179993
10027,0.000907,172.31.40.0-255,66,92544,64,179993
10028,0.00092,74.125.24.0-255,1484,94028,64,179993
10029,0.000928,74.125.24.0-255,2902,96930,64,179993
10030,0.00093,172.31.40.0-255,66,96996,64,179993
10031,0.000958,74.125.24.0-255,5738,102734,64,179993
10032,0.000961,172.31.40.0-255,66,102800,64,179993
10033,0.000971,172.31.40.0-255,66,102866,64,179993
10034,0.000995,74.125.24.0-255,4320,107186,64,179993
10035,0.000998,172.31.40.0-255,66,107252,64,179993
10036,0.001003,74.125.24.0-255,5738,112990,64,179993
10037,0.001004,172.31.40.0-255,66,113056,64,179993
10038,0.001047,172.31.40.0-255,66,113122,64,179993
10039,0.001074,74.125.24.0-255,2184,115306,64,179993
10040,0.001076,172.31.40.0-255,66,115372,64,179993
10041,0.001092,172.31.40.0-255,66,115438,64,179993
10042,0.001101,172.31.40.0-255,66,115504,64,179993
10043,0.001122,74.125.24.0-255,1484,116988,64,179993
10044,0.001145,74.125.24.0-255,2902,119890,64,179993
10045,0.001147,172.31.40.0-255,66,119956,64,179993
10046,0.001152,74.125.24.0-255,5738,125694,64,179993
10047,0.001154,172.31.40.0-255,66,125760,64,179993
10048,0.001202,172.31.40.0-255,66,125826,64,179993
10049,0.001207,74.125.24.0-255,5738,131564,64,179993
10050,0.00121,172.31.40.0-255,66,131630,64,179993
10051,0.001243,74.125.24.0-255,5020,136650,64,179993
10052,0.001245,172.31.40.0-255,66,136716,64,179993
10053,0.001281,74.125.24.0-255,2902,139618,64,179993
10054,0.001283,172.31.40.0-255,66,139684,64,179993
10055,0.001289,74.125.24.0-255,4320,144004,64,179993
10056,0.00129,172.31.40.0-255,66,144070,64,179993
10057,0.001331,172.31.40.0-255,66,144136,64,179993
10058,0.001336,74.125.24.0-255,4320,148456,64,179993
10059,0.001338,172.31.40.0-255,66,148522,64,179993
10060,0.001389,172.31.40.0-255,66,148588,64,179993
10061,0.001404,172.31.40.0-255,66,148654,64,179993
10062,0.001423,74.125.24.0-255,1484,150138,64,179993
10063,0.001436,172.31.40.0-255,66,150204,64,179993
10064,0.001442,74.125.24.0-255,6438,156642,64,179993
10065,0.001444,172.31.40.0-255,66,156708,64,179993
10066,0.001465,74.125.24.0-255,1484,158192,64,179993
10067,0.001492,74.125.24.0-255,5738,163930,64,179993
10068,0.001494,172.31.40.0-255,66,163996,64,179993
10069,0.001499,74.125.24.0-255,4320,168316,64,179993
10070,0.001501,172.31.40.0-255,66,168382,64,179993
10071,0.001561,172.31.40.0-255,66,168448,64,179993
10072,0.001565,74.125.24.0-255,4320,172768,64,179993
10073,0.001567,172.31.40.0-255,66,172834,64,179993
10074,0.001616,172.31.40.0-255,66,172900,64,179993
10075,0.001628,74.125.24.0-255,1194,174094,64,179993
10076,0.001664,74.125.24.0-255,105,174199,64,179993
10077,0.010858,74.125.24.0-255,105,174304,64,179993
10078,0.010878,172.31.40.0-255,78,174382,64,179993
10079,0.013201,172.31.40.0-255,105,174487,64,179993
10080,0.015185,74.125.24.0-255,66,174553,64,179993
10081,0.046395,172.31.40.0-255,166,174719,64,179993
10082,0.046428,172.31.40.0-255,1135,175854,64,179993
10083,0.046493,172.31.40.0-255,1514,177368,64,179993
10084,0.046495,172.31.40.0-255,1514,178882,64,179993
10085,0.046496,172.31.40.0-255,673,179555,64,179993
10086,0.047919,104.244.42.0-255,66,179621,64,179993
10087,0.047949,104.244.42.0-255,66,179687,64,179993
10088,0.048028,104.244.42.0-255,66,179753,64,179993
10089,0.048031,104.244.42.0-255,66,179819,64,179993
10090,0.048934,104.244.42.0-255,108,179927,64,179993
10091,0.048946,172.31.40.0-255,66,179993,64,179993
10092,0.0,74.125.24.0-255,154,154,64,179968
10093,2.1e-05,172.31.40.0-255,66,220,64,179968
10094,2.8e-05,74.125.24.0-255,1484,1704,64,179968
10095,3.3e-05,172.31.40.0-255,66,1770,64,179968
10096,3.8e-05,74.125.24.0-255,2902,4672,64,179968
10097,4.1e-05,172.31.40.0-255,66,4738,64,179968
10098,5.8e-05,74.125.24.0-255,7156,11894,64,179968
10099,6.1e-05,172.31.40.0-255,66,11960,64,179968
10100,8.2e-05,74.125.24.0-255,2129,14089,64,179968
10101,8.4e-05,172.31.40.0-255,66,14155,64,179968
10102,0.000108,74.125.24.0-255,2902,17057,64,179968
10103,0.000111,172.31.40.0-255,66,17123,64,179968
10104,0.000118,74.125.24.0-255,7156,24279,64,179968
10105,0.00012,172.31.40.0-255,66,24345,64,179968
10106,0.000131,74.125.24.0-255,5738,30083,64,179968
10107,0.000134,172.31.40.0-255,66,30149,64,179968
10108,0.00016,74.125.24.0-255,1125,31274,64,179968
10109,0.000163,172.31.40.0-255,66,31340,64,179968
10110,0.000362,74.125.24.0-255,1484,32824,64,179968
10111,0.000367,172.31.40.0-255,66,32890,64,179968
10112,0.000373,74.125.24.0-255,2902,35792,64,179968
10113,0.000375,172.31.40.0-255,66,35858,64,179968
10114,0.000381,74.125.24.0-255,4320,40178,64,179968
10115,0.000389,172.31.40.0-255,66,40244,64,179968
10116,0.000416,74.125.24.0-255,1484,41728,64,179968
10117,0.000418,172.31.40.0-255,66,41794,64,179968
10118,0.000433,172.31.40.0-255,66,41860,64,179968
10119,0.000452,172.31.40.0-255,66,41926,64,179968
10120,0.000454,74.125.24.0-255,362,42288,64,179968
10121,0.000456,172.31.40.0-255,66,42354,64,179968
10122,0.000715,74.125.24.0-255,127,42481,64,179968
10123,0.00074,74.125.24.0-255,352,42833,64,179968
10124,0.000965,74.125.24.0-255,1484,44317,64,179968
10125,0.000969,172.31.40.0-255,66,44383,64,179968
10126,0.000975,74.125.24.0-255,2902,47285,64,179968
10127,0.000977,172.31.40.0-255,66,47351,64,179968
10128,0.000989,74.125.24.0-255,5738,53089,64,179968
10129,0.000992,172.31.40.0-255,66,53155,64,179968
10130,0.001032,172.31.40.0-255,66,53221,64,179968
10131,0.001041,74.125.24.0-255,7156,60377,64,179968
10132,0.001043,172.31.40.0-255,66,60443,64,179968
10133,0.001062,74.125.24.0-255,3602,64045,64,179968
10134,0.001069,172.31.40.0-255,66,64111,64,179968
10135,0.001195,74.125.24.0-255,1484,65595,64,179968
10136,0.001201,74.125.24.0-255,2902,68497,64,179968
10137,0.001205,172.31.40.0-255,66,68563,64,179968
10138,0.001237,74.125.24.0-255,5738,74301,64,179968
10139,0.00124,172.31.40.0-255,66,74367,64,179968
10140,0.001251,172.31.40.0-255,66,74433,64,179968
10141,0.001313,74.125.24.0-255,4320,78753,64,179968
10142,0.001316,172.31.40.0-255,66,78819,64,179968
10143,0.001351,172.31.40.0-255,66,78885,64,179968
10144,0.001414,74.125.24.0-255,1484,80369,64,179968
10145,0.00142,74.125.24.0-255,2902,83271,64,179968
10146,0.001422,172.31.40.0-255,66,83337,64,179968
10147,0.001446,74.125.24.0-255,5738,89075,64,179968
10148,0.00145,172.31.40.0-255,66,89141,64,179968
10149,0.001453,74.125.24.0-255,1484,90625,64,179968
10150,0.001459,74.125.24.0-255,5738,96363,64,179968
10151,0.001461,172.31.40.0-255,66,96429,64,179968
10152,0.001491,74.125.24.0-255,2902,99331,64,179968
10153,0.001497,74.125.24.0-255,5738,105069,64,179968
10154,0.001502,172.31.40.0-255,66,105135,64,179968
10155,0.001505,172.31.40.0-255,66,105201,64,179968
10156,0.001543,172.31.40.0-255,66,105267,64,179968
10157,0.001576,74.125.24.0-255,1484,106751,64,179968
10158,0.001593,74.125.24.0-255,2902,109653,64,179968
10159,0.001596,172.31.40.0-255,66,109719,64,179968
10160,0.001603,74.125.24.0-255,5738,115457,64,179968
10161,0.001605,172.31.40.0-255,66,115523,64,179968
10162,0.001628,74.125.24.0-255,7156,122679,64,179968
10163,0.001649,172.31.40.0-255,66,122745,64,179968
10164,0.001678,74.125.24.0-255,5738,128483,64,179968
10165,0.001681,172.31.40.0-255,66,128549,64,179968
10166,0.001691,172.31.40.0-255,66,128615,64,179968
10167,0.001701,74.125.24.0-255,2184,130799,64,179968
10168,0.001704,172.31.40.0-255,66,130865,64,179968
10169,0.00174,74.125.24.0-255,1484,132349,64,179968
10170,0.001756,74.125.24.0-255,2902,135251,64,179968
10171,0.001759,172.31.40.0-255,66,135317,64,179968
10172,0.001765,74.125.24.0-255,4320,139637,64,179968
10173,0.001767,172.31.40.0-255,66,139703,64,179968
10174,0.001783,74.125.24.0-255,1484,141187,64,179968
10175,0.001788,74.125.24.0-255,2902,144089,64,179968
10176,0.001794,172.31.40.0-255,66,144155,64,179968
10177,0.001819,74.125.24.0-255,5738,149893,64,179968
10178,0.001822,172.31.40.0-255,66,149959,64,179968
10179,0.001834,172.31.40.0-255,66,150025,64,179968
10180,0.00187,74.125.24.0-255,5020,155045,64,179968
10181,0.001877,172.31.40.0-255,66,155111,64,179968
10182,0.00214,74.125.24.0-255,1484,156595,64,179968
10183,0.002147,74.125.24.0-255,2902,159497,64,179968
10184,0.002151,172.31.40.0-255,66,159563,64,179968
10185,0.002158,74.125.24.0-255,5738,165301,64,179968
10186,0.002161,172.31.40.0-255,66,165367,64,179968
10187,0.002243,172.31.40.0-255,66,165433,64,179968
10188,0.00225,74.125.24.0-255,7156,172589,64,179968
10189,0.002253,172.31.40.0-255,66,172655,64,179968
10190,0.002268,172.31.40.0-255,66,172721,64,179968
10191,0.002312,172.31.40.0-255,66,172787,64,179968
10192,0.002337,172.31.40.0-255,66,172853,64,179968
10193,0.002349,172.31.40.0-255,66,172919,64,179968
10194,0.002389,172.31.40.0-255,66,172985,64,179968
10195,0.002421,172.31.40.0-255,66,173051,64,179968
10196,0.002439,172.31.40.0-255,66,173117,64,179968
10197,0.002471,172.31.40.0-255,66,173183,64,179968
10198,0.002488,172.31.40.0-255,66,173249,64,179968
10199,0.002529,172.31.40.0-255,66,173315,64,179968
10200,0.002531,74.125.24.0-255,1484,174799,64,179968
10201,0.002535,74.125.24.0-255,467,175266,64,179968
10202,0.002538,172.31.40.0-255,66,175332,64,179968
10203,0.002547,74.125.24.0-255,105,175437,64,179968
10204,0.012941,172.31.40.0-255,66,175503,64,179968
10205,0.012992,172.31.40.0-255,105,175608,64,179968
10206,0.015496,74.125.24.0-255,66,175674,64,179968
10207,0.045879,172.31.40.0-255,172,175846,64,179968
10208,0.045912,172.31.40.0-255,1112,176958,64,179968
10209,0.045972,172.31.40.0-255,1514,178472,64,179968
10210,0.045974,172.31.40.0-255,1298,179770,64,179968
10211,0.047419,104.244.42.0-255,66,179836,64,179968
10212,0.047448,104.244.42.0-255,66,179902,64,179968
10213,0.047501,104.244.42.0-255,66,179968,64,179968
10214,0.0,172.217.194.0-255,161,161,64,221669
10215,2.1e-05,172.31.40.0-255,66,227,64,221669
10216,2.9e-05,172.217.194.0-255,1484,1711,64,221669
10217,3.3e-05,172.31.40.0-255,66,1777,64,221669
10218,3.9e-05,172.217.194.0-255,2902,4679,64,221669
10219,4.1e-05,172.31.40.0-255,66,4745,64,221669
10220,4.9e-05,172.217.194.0-255,7156,11901,64,221669
10221,5.2e-05,172.31.40.0-255,66,11967,64,221669
10222,5.6e-05,172.217.194.0-255,1984,13951,64,221669
10223,5.9e-05,172.31.40.0-255,66,14017,64,221669
10224,0.000192,172.217.194.0-255,1484,15501,64,221669
10225,0.000197,172.31.40.0-255,66,15567,64,221669
10226,0.000203,172.217.194.0-255,2902,18469,64,221669
10227,0.000206,172.31.40.0-255,66,18535,64,221669
10228,0.000213,172.217.194.0-255,5738,24273,64,221669
10229,0.000216,172.31.40.0-255,66,24339,64,221669
10230,0.000232,172.217.194.0-255,1484,25823,64,221669
10231,0.000234,172.31.40.0-255,66,25889,64,221669
10232,0.000252,172.217.194.0-255,5379,31268,64,221669
10233,0.000254,172.31.40.0-255,66,31334,64,221669
10234,0.000291,172.217.194.0-255,1484,32818,64,221669
10235,0.000293,172.31.40.0-255,66,32884,64,221669
10236,0.000308,172.217.194.0-255,2902,35786,64,221669
10237,0.00031,172.31.40.0-255,66,35852,64,221669
10238,0.000317,172.217.194.0-255,5738,41590,64,221669
10239,0.000319,172.31.40.0-255,66,41656,64,221669
10240,0.000344,172.217.194.0-255,4320,45976,64,221669
10241,0.000346,172.31.40.0-255,66,46042,64,221669
10242,0.000366,172.217.194.0-255,2543,48585,64,221669
10243,0.000369,172.31.40.0-255,66,48651,64,221669
10244,0.000384,172.217.194.0-255,1484,50135,64,221669
10245,0.000386,172.31.40.0-255,66,50201,64,221669
10246,0.000392,172.217.194.0-255,2902,53103,64,221669
10247,0.000395,172.31.40.0-255,66,53169,64,221669
10248,0.000398,172.217.194.0-255,1484,54653,64,221669
10249,0.000414,172.217.194.0-255,4320,58973,64,221669
10250,0.000417,172.31.40.0-255,66,59039,64,221669
10251,0.000453,172.31.40.0-255,66,59105,64,221669
10252,0.000635,172.217.194.0-255,1484,60589,64,221669
10253,0.000642,172.217.194.0-255,2902,63491,64,221669
10254,0.000645,172.31.40.0-255,66,63557,64,221669
10255,0.000648,172.217.194.0-255,1484,65041,64,221669
10256,0.000668,172.217.194.0-255,4320,69361,64,221669
10257,0.000671,172.31.40.0-255,66,69427,64,221669
10258,0.000677,172.217.194.0-255,5738,75165,64,221669
10259,0.00068,172.31.40.0-255,66,75231,64,221669
10260,0.000695,172.217.194.0-255,7156,82387,64,221669
10261,0.000698,172.31.40.0-255,66,82453,64,221669
10262,0.000736,172.217.194.0-255,7156,89609,64,221669
10263,0.000739,172.31.40.0-255,66,89675,64,221669
10264,0.000762,172.217.194.0-255,3602,93277,64,221669
10265,0.000765,172.31.40.0-255,66,93343,64,221669
10266,0.000932,172.217.194.0-255,1484,94827,64,221669
10267,0.000939,172.217.194.0-255,2902,97729,64,221669
10268,0.000942,172.31.40.0-255,66,97795,64,221669
10269,0.000966,172.217.194.0-255,5738,103533,64,221669
10270,0.000968,172.31.40.0-255,66,103599,64,221669
10271,0.00098,172.31.40.0-255,66,103665,64,221669
10272,0.000997,172.217.194.0-255,2902,106567,64,221669
10273,0.000999,172.31.40.0-255,66,106633,64,221669
10274,0.001012,172.31.40.0-255,66,106699,64,221669
10275,0.001031,172.217.194.0-255,1484,108183,64,221669
10276,0.001055,172.31.40.0-255,66,108249,64,221669
10277,0.001068,172.31.40.0-255,66,108315,64,221669
10278,0.001107,172.217.194.0-255,5738,114053,64,221669
10279,0.00111,172.31.40.0-255,66,114119,64,221669
10280,0.001132,172.217.194.0-255,5020,119139,64,221669
10281,0.001135,172.31.40.0-255,66,119205,64,221669
10282,0.00117,172.217.194.0-255,1484,120689,64,221669
10283,0.001174,172.217.194.0-255,1484,122173,64,221669
10284,0.001177,172.31.40.0-255,66,122239,64,221669
10285,0.001188,172.217.194.0-255,1484,123723,64,221669
10286,0.001195,172.217.194.0-255,5738,129461,64,221669
10287,0.0012,172.31.40.0-255,66,129527,64,221669
10288,0.001224,172.217.194.0-255,7156,136683,64,221669
10289,0.001227,172.31.40.0-255,66,136749,64,221669
10290,0.001231,172.217.194.0-255,2902,139651,64,221669
10291,0.001233,172.31.40.0-255,66,139717,64,221669
10292,0.001274,172.31.40.0-255,66,139783,64,221669
10293,0.001278,172.217.194.0-255,2184,141967,64,221669
10294,0.00128,172.31.40.0-255,66,142033,64,221669
10295,0.001356,172.217.194.0-255,1484,143517,64,221669
10296,0.001361,172.217.194.0-255,2902,146419,64,221669
10297,0.001364,172.31.40.0-255,66,146485,64,221669
10298,0.001368,172.217.194.0-255,2902,149387,64,221669
10299,0.001371,172.31.40.0-255,66,149453,64,221669
10300,0.001387,172.217.194.0-255,2902,152355,64,221669
10301,0.001389,172.31.40.0-255,66,152421,64,221669
10302,0.001396,172.217.194.0-255,7156,159577,64,221669
10303,0.001398,172.31.40.0-255,66,159643,64,221669
10304,0.001419,172.217.194.0-255,5738,165381,64,221669
10305,0.001421,172.31.40.0-255,66,165447,64,221669
10306,0.001433,172.31.40.0-255,66,165513,64,221669
10307,0.00145,172.217.194.0-255,1484,166997,64,221669
10308,0.001485,172.31.40.0-255,66,167063,64,221669
10309,0.001506,172.217.194.0-255,7156,174219,64,221669
10310,0.001525,172.31.40.0-255,66,174285,64,221669
10311,0.001602,172.217.194.0-255,1484,175769,64,221669
10312,0.001606,172.217.194.0-255,1484,177253,64,221669
10313,0.001617,172.31.40.0-255,66,177319,64,221669
10314,0.001629,172.217.194.0-255,1484,178803,64,221669
10315,0.001635,172.217.194.0-255,5738,184541,64,221669
10316,0.001669,172.217.194.0-255,1484,186025,64,221669
10317,0.001716,172.31.40.0-255,66,186091,64,221669
10318,0.001722,172.31.40.0-255,66,186157,64,221669
10319,0.001735,172.217.194.0-255,1484,187641,64,221669
10320,0.001739,172.217.194.0-255,2902,190543,64,221669
10321,0.001744,172.217.194.0-255,4320,194863,64,221669
10322,0.001753,172.31.40.0-255,66,194929,64,221669
10323,0.001761,172.217.194.0-255,1484,196413,64,221669
10324,0.001785,172.217.194.0-255,2902,199315,64,221669
10325,0.001801,172.217.194.0-255,7156,206471,64,221669
10326,0.001828,172.31.40.0-255,66,206537,64,221669
10327,0.001838,172.217.194.0-255,4320,210857,64,221669
10328,0.001845,172.31.40.0-255,66,210923,64,221669
10329,0.001875,172.31.40.0-255,66,210989,64,221669
10330,0.001909,172.217.194.0-255,5738,216727,64,221669
10331,0.001923,172.31.40.0-255,66,216793,64,221669
10332,0.001973,172.31.40.0-255,66,216859,64,221669
10333,0.003928,172.217.194.0-255,105,216964,64,221669
10334,0.010835,172.31.40.0-255,66,217030,64,221669
10335,0.010875,172.31.40.0-255,105,217135,64,221669
10336,0.012811,172.217.194.0-255,66,217201,64,221669
10337,0.030256,172.31.40.0-255,172,217373,64,221669
10338,0.030284,172.31.40.0-255,1112,218485,64,221669
10339,0.030334,172.31.40.0-255,1514,219999,64,221669
10340,0.030335,172.31.40.0-255,1298,221297,64,221669
10341,0.031804,104.244.42.0-255,66,221363,64,221669
10342,0.031969,104.244.42.0-255,66,221429,64,221669
10343,0.031986,104.244.42.0-255,66,221495,64,221669
10344,0.03253,104.244.42.0-255,108,221603,64,221669
10345,0.03254,172.31.40.0-255,66,221669,64,221669
10346,0.0,172.217.194.0-255,146,146,64,187570
10347,2.2e-05,172.31.40.0-255,66,212,64,187570
10348,2.9e-05,172.217.194.0-255,1484,1696,64,187570
10349,3.4e-05,172.31.40.0-255,66,1762,64,187570
10350,4e-05,172.217.194.0-255,2902,4664,64,187570
10351,4.5e-05,172.31.40.0-255,66,4730,64,187570
10352,5.2e-05,172.217.194.0-255,5738,10468,64,187570
10353,5.5e-05,172.31.40.0-255,66,10534,64,187570
10354,6.1e-05,172.217.194.0-255,4320,14854,64,187570
10355,6.4e-05,172.31.40.0-255,66,14920,64,187570
10356,0.000103,172.31.40.0-255,66,14986,64,187570
10357,0.00011,172.217.194.0-255,6797,21783,64,187570
10358,0.000113,172.31.40.0-255,66,21849,64,187570
10359,0.000186,172.217.194.0-255,1484,23333,64,187570
10360,0.000189,172.31.40.0-255,66,23399,64,187570
10361,0.000194,172.217.194.0-255,2902,26301,64,187570
10362,0.000196,172.31.40.0-255,66,26367,64,187570
10363,0.000213,172.217.194.0-255,5738,32105,64,187570
10364,0.000216,172.31.40.0-255,66,32171,64,187570
10365,0.000219,172.217.194.0-255,1484,33655,64,187570
10366,0.000221,172.31.40.0-255,66,33721,64,187570
10367,0.000274,172.217.194.0-255,2902,36623,64,187570
10368,0.000277,172.31.40.0-255,66,36689,64,187570
10369,0.000298,172.217.194.0-255,2543,39232,64,187570
10370,0.000301,172.31.40.0-255,66,39298,64,187570
10371,0.000319,172.217.194.0-255,1484,40782,64,187570
10372,0.000321,172.31.40.0-255,66,40848,64,187570
10373,0.000324,172.217.194.0-255,1484,42332,64,187570
10374,0.000326,172.31.40.0-255,66,42398,64,187570
10375,0.000337,172.217.194.0-255,1484,43882,64,187570
10376,0.00034,172.31.40.0-255,66,43948,64,187570
10377,0.000343,172.217.194.0-255,1484,45432,64,187570
10378,0.000345,172.31.40.0-255,66,45498,64,187570
10379,0.000376,172.217.194.0-255,4320,49818,64,187570
10380,0.000379,172.31.40.0-255,66,49884,64,187570
10381,0.000386,172.217.194.0-255,7101,56985,64,187570
10382,0.000388,172.31.40.0-255,66,57051,64,187570
10383,0.000403,172.217.194.0-255,373,57424,64,187570
10384,0.000405,172.31.40.0-255,66,57490,64,187570
10385,0.000528,172.217.194.0-255,1484,58974,64,187570
10386,0.000533,172.217.194.0-255,2902,61876,64,187570
10387,0.000538,172.31.40.0-255,66,61942,64,187570
10388,0.000553,172.217.194.0-255,5738,67680,64,187570
10389,0.00059,172.217.194.0-255,2902,70582,64,187570
10390,0.0006,172.31.40.0-255,66,70648,64,187570
10391,0.000607,172.217.194.0-255,5738,76386,64,187570
10392,0.000616,172.31.40.0-255,66,76452,64,187570
10393,0.000634,172.217.194.0-255,2184,78636,64,187570
10394,0.000652,172.31.40.0-255,66,78702,64,187570
10395,0.000979,172.217.194.0-255,1484,80186,64,187570
10396,0.000986,172.217.194.0-255,2902,83088,64,187570
10397,0.000989,172.217.194.0-255,1484,84572,64,187570
10398,0.000994,172.31.40.0-255,66,84638,64,187570
10399,0.001013,172.217.194.0-255,4320,88958,64,187570
10400,0.001038,172.217.194.0-255,4320,93278,64,187570
10401,0.001043,172.217.194.0-255,4320,97598,64,187570
10402,0.001048,172.31.40.0-255,66,97664,64,187570
10403,0.001063,172.217.194.0-255,5738,103402,64,187570
10404,0.001066,172.217.194.0-255,766,104168,64,187570
10405,0.001118,172.31.40.0-255,66,104234,64,187570
10406,0.001263,172.217.194.0-255,1484,105718,64,187570
10407,0.001269,172.217.194.0-255,2902,108620,64,187570
10408,0.001273,172.31.40.0-255,66,108686,64,187570
10409,0.001278,172.217.194.0-255,2902,111588,64,187570
10410,0.001296,172.217.194.0-255,2902,114490,64,187570
10411,0.001302,172.217.194.0-255,5738,120228,64,187570
10412,0.001305,172.217.194.0-255,1484,121712,64,187570
10413,0.001315,172.31.40.0-255,66,121778,64,187570
10414,0.001342,172.217.194.0-255,5020,126798,64,187570
10415,0.00136,172.217.194.0-255,1484,128282,64,187570
10416,0.001368,172.31.40.0-255,66,128348,64,187570
10417,0.001374,172.217.194.0-255,4320,132668,64,187570
10418,0.001379,172.31.40.0-255,66,132734,64,187570
10419,0.001389,172.217.194.0-255,4320,137054,64,187570
10420,0.001436,172.31.40.0-255,66,137120,64,187570
10421,0.001465,172.217.194.0-255,1484,138604,64,187570
10422,0.001491,172.217.194.0-255,5020,143624,64,187570
10423,0.001496,172.217.194.0-255,2902,146526,64,187570
10424,0.001517,172.217.194.0-255,4320,150846,64,187570
10425,0.001522,172.31.40.0-255,66,150912,64,187570
10426,0.001543,172.217.194.0-255,5738,156650,64,187570
10427,0.001575,172.31.40.0-255,66,156716,64,187570
10428,0.001588,172.217.194.0-255,1484,158200,64,187570
10429,0.001617,172.31.40.0-255,66,158266,64,187570
10430,0.00163,172.217.194.0-255,2184,160450,64,187570
10431,0.001645,172.217.194.0-255,2902,163352,64,187570
10432,0.001652,172.217.194.0-255,7156,170508,64,187570
10433,0.001679,172.31.40.0-255,66,170574,64,187570
10434,0.001691,172.217.194.0-255,2902,173476,64,187570
10435,0.001778,172.217.194.0-255,3602,177078,64,187570
10436,0.001832,172.31.40.0-255,66,177144,64,187570
10437,0.001843,172.31.40.0-255,66,177210,64,187570
10438,0.001878,172.217.194.0-255,2902,180112,64,187570
10439,0.001894,172.31.40.0-255,66,180178,64,187570
10440,0.001953,172.31.40.0-255,66,180244,64,187570
10441,0.001982,172.217.194.0-255,1484,181728,64,187570
10442,0.002014,172.217.194.0-255,97,181825,64,187570
10443,0.002017,172.31.40.0-255,66,181891,64,187570
10444,0.002022,172.31.40.0-255,66,181957,64,187570
10445,0.002028,172.217.194.0-255,105,182062,64,187570
10446,0.004225,172.31.40.0-255,66,182128,64,187570
10447,0.004257,172.31.40.0-255,105,182233,64,187570
10448,0.006299,172.217.194.0-255,66,182299,64,187570
10449,0.035742,172.31.40.0-255,172,182471,64,187570
10450,0.035775,172.31.40.0-255,1111,183582,64,187570
10451,0.035844,172.31.40.0-255,1514,185096,64,187570
10452,0.035846,172.31.40.0-255,1514,186610,64,187570
10453,0.035871,172.31.40.0-255,696,187306,64,187570
10454,0.037263,104.244.42.0-255,66,187372,64,187570
10455,0.037294,104.244.42.0-255,66,187438,64,187570
10456,0.037392,104.244.42.0-255,66,187504,64,187570
10457,0.037406,104.244.42.0-255,66,187570,64,187570
10458,0.0,74.125.24.0-255,296,296,64,268341
10459,2.3e-05,172.31.40.0-255,66,362,64,268341
10460,3e-05,74.125.24.0-255,1484,1846,64,268341
10461,3.4e-05,172.31.40.0-255,66,1912,64,268341
10462,4.1e-05,74.125.24.0-255,4320,6232,64,268341
10463,4.5e-05,172.31.40.0-255,66,6298,64,268341
10464,5.8e-05,74.125.24.0-255,4320,10618,64,268341
10465,6.2e-05,172.31.40.0-255,66,10684,64,268341
10466,6.9e-05,74.125.24.0-255,4673,15357,64,268341
10467,7.2e-05,172.31.40.0-255,66,15423,64,268341
10468,7.5e-05,74.125.24.0-255,1484,16907,64,268341
10469,7.7e-05,172.31.40.0-255,66,16973,64,268341
10470,0.00012,172.31.40.0-255,66,17039,64,268341
10471,0.000125,74.125.24.0-255,3961,21000,64,268341
10472,0.000128,172.31.40.0-255,66,21066,64,268341
10473,0.000189,74.125.24.0-255,1484,22550,64,268341
10474,0.000191,172.31.40.0-255,66,22616,64,268341
10475,0.000211,74.125.24.0-255,2902,25518,64,268341
10476,0.000214,172.31.40.0-255,66,25584,64,268341
10477,0.000219,74.125.24.0-255,4320,29904,64,268341
10478,0.000222,172.31.40.0-255,66,29970,64,268341
10479,0.000251,74.125.24.0-255,1484,31454,64,268341
10480,0.000253,172.31.40.0-255,66,31520,64,268341
10481,0.00026,74.125.24.0-255,6797,38317,64,268341
10482,0.000262,172.31.40.0-255,66,38383,64,268341
10483,0.000771,74.125.24.0-255,1484,39867,64,268341
10484,0.000776,172.31.40.0-255,66,39933,64,268341
10485,0.000782,74.125.24.0-255,2902,42835,64,268341
10486,0.000783,172.31.40.0-255,66,42901,64,268341
10487,0.000786,74.125.24.0-255,1484,44385,64,268341
10488,0.000788,172.31.40.0-255,66,44451,64,268341
10489,0.000812,74.125.24.0-255,4320,48771,64,268341
10490,0.000814,172.31.40.0-255,66,48837,64,268341
10491,0.00082,74.125.24.0-255,5738,54575,64,268341
10492,0.000822,172.31.40.0-255,66,54641,64,268341
10493,0.000858,74.125.24.0-255,1705,56346,64,268341
10494,0.000861,172.31.40.0-255,66,56412,64,268341
10495,0.001451,74.125.24.0-255,1484,57896,64,268341
10496,0.001463,74.125.24.0-255,2902,60798,64,268341
10497,0.001467,172.31.40.0-255,66,60864,64,268341
10498,0.001473,74.125.24.0-255,1484,62348,64,268341
10499,0.001521,74.125.24.0-255,4320,66668,64,268341
10500,0.001524,172.31.40.0-255,66,66734,64,268341
10501,0.001532,74.125.24.0-255,6797,73531,64,268341
10502,0.001534,172.31.40.0-255,66,73597,64,268341
10503,0.001665,74.125.24.0-255,1484,75081,64,268341
10504,0.001688,74.125.24.0-255,2902,77983,64,268341
10505,0.001692,172.31.40.0-255,66,78049,64,268341
10506,0.001699,74.125.24.0-255,5738,83787,64,268341
10507,0.001701,172.31.40.0-255,66,83853,64,268341
10508,0.001704,74.125.24.0-255,1484,85337,64,268341
10509,0.00175,172.31.40.0-255,66,85403,64,268341
10510,0.001764,172.31.40.0-255,66,85469,64,268341
10511,0.001871,74.125.24.0-255,1484,86953,64,268341
10512,0.001888,74.125.24.0-255,1484,88437,64,268341
10513,0.001893,172.31.40.0-255,66,88503,64,268341
10514,0.001923,74.125.24.0-255,1484,89987,64,268341
10515,0.00193,74.125.24.0-255,5738,95725,64,268341
10516,0.001933,172.31.40.0-255,66,95791,64,268341
10517,0.001946,172.31.40.0-255,66,95857,64,268341
10518,0.001971,74.125.24.0-255,4320,100177,64,268341
10519,0.001974,172.31.40.0-255,66,100243,64,268341
10520,0.002011,172.31.40.0-255,66,100309,64,268341
10521,0.002041,74.125.24.0-255,1484,101793,64,268341
10522,0.002046,74.125.24.0-255,2902,104695,64,268341
10523,0.002049,172.31.40.0-255,66,104761,64,268341
10524,0.002068,74.125.24.0-255,2902,107663,64,268341
10525,0.002071,172.31.40.0-255,66,107729,64,268341
10526,0.0021,74.125.24.0-255,2902,110631,64,268341
10527,0.002103,172.31.40.0-255,66,110697,64,268341
10528,0.00211,74.125.24.0-255,5738,116435,64,268341
10529,0.002113,172.31.40.0-255,66,116501,64,268341
10530,0.002127,172.31.40.0-255,66,116567,64,268341
10531,0.002133,74.125.24.0-255,5020,121587,64,268341
10532,0.002136,172.31.40.0-255,66,121653,64,268341
10533,0.004441,74.125.24.0-255,5738,127391,64,268341
10534,0.004453,172.31.40.0-255,66,127457,64,268341
10535,0.006716,74.125.24.0-255,5738,133195,64,268341
10536,0.006723,172.31.40.0-255,66,133261,64,268341
10537,0.008976,74.125.24.0-255,4320,137581,64,268341
10538,0.00898,172.31.40.0-255,66,137647,64,268341
10539,0.008997,74.125.24.0-255,1484,139131,64,268341
10540,0.011263,74.125.24.0-255,4320,143451,64,268341
10541,0.011275,172.31.40.0-255,66,143517,64,268341
10542,0.013545,74.125.24.0-255,5738,149255,64,268341
10543,0.013556,172.31.40.0-255,66,149321,64,268341
10544,0.015852,74.125.24.0-255,5738,155059,64,268341
10545,0.01586,172.31.40.0-255,66,155125,64,268341
10546,0.01816,74.125.24.0-255,5738,160863,64,268341
10547,0.018177,172.31.40.0-255,66,160929,64,268341
10548,0.020442,74.125.24.0-255,5738,166667,64,268341
10549,0.02045,172.31.40.0-255,66,166733,64,268341
10550,0.02273,74.125.24.0-255,5738,172471,64,268341
10551,0.022738,172.31.40.0-255,66,172537,64,268341
10552,0.025026,74.125.24.0-255,5738,178275,64,268341
10553,0.025034,172.31.40.0-255,66,178341,64,268341
10554,0.027322,74.125.24.0-255,5738,184079,64,268341
10555,0.027332,172.31.40.0-255,66,184145,64,268341
10556,0.029637,74.125.24.0-255,5738,189883,64,268341
10557,0.029644,172.31.40.0-255,66,189949,64,268341
10558,0.031946,74.125.24.0-255,5738,195687,64,268341
10559,0.031954,172.31.40.0-255,66,195753,64,268341
10560,0.034243,74.125.24.0-255,5738,201491,64,268341
10561,0.034251,172.31.40.0-255,66,201557,64,268341
10562,0.03662,74.125.24.0-255,4320,205877,64,268341
10563,0.036627,172.31.40.0-255,66,205943,64,268341
10564,0.036654,74.125.24.0-255,1484,207427,64,268341
10565,0.038779,172.31.40.0-255,171,207598,64,268341
10566,0.038805,172.31.40.0-255,1135,208733,64,268341
10567,0.038853,172.31.40.0-255,1514,210247,64,268341
10568,0.038855,172.31.40.0-255,1274,211521,64,268341
10569,0.038925,74.125.24.0-255,4320,215841,64,268341
10570,0.03893,172.31.40.0-255,66,215907,64,268341
10571,0.04038,104.244.42.0-255,66,215973,64,268341
10572,0.040417,104.244.42.0-255,66,216039,64,268341
10573,0.040453,104.244.42.0-255,66,216105,64,268341
10574,0.041249,74.125.24.0-255,5738,221843,64,268341
10575,0.041255,172.31.40.0-255,66,221909,64,268341
10576,0.043613,74.125.24.0-255,5738,227647,64,268341
10577,0.043622,172.31.40.0-255,66,227713,64,268341
10578,0.045915,74.125.24.0-255,5738,233451,64,268341
10579,0.045923,172.31.40.0-255,66,233517,64,268341
10580,0.048197,74.125.24.0-255,5738,239255,64,268341
10581,0.048204,172.31.40.0-255,66,239321,64,268341
10582,0.050539,74.125.24.0-255,5738,245059,64,268341
10583,0.050545,172.31.40.0-255,66,245125,64,268341
10584,0.052838,74.125.24.0-255,5738,250863,64,268341
10585,0.052845,172.31.40.0-255,66,250929,64,268341
10586,0.055162,74.125.24.0-255,5738,256667,64,268341
10587,0.055169,172.31.40.0-255,66,256733,64,268341
10588,0.057472,74.125.24.0-255,5738,262471,64,268341
10589,0.05748,172.31.40.0-255,66,262537,64,268341
10590,0.059812,74.125.24.0-255,5738,268275,64,268341
10591,0.059819,172.31.40.0-255,66,268341,64,268341
10592,0.0,172.217.194.0-255,153,153,64,266192
10593,1.7e-05,172.31.40.0-255,66,219,64,266192
10594,2.4e-05,172.217.194.0-255,1484,1703,64,266192
10595,2.9e-05,172.31.40.0-255,66,1769,64,266192
10596,4.3e-05,172.217.194.0-255,2902,4671,64,266192
10597,4.6e-05,172.31.40.0-255,66,4737,64,266192
10598,5.4e-05,172.217.194.0-255,7156,11893,64,266192
10599,5.8e-05,172.31.40.0-255,66,11959,64,266192
10600,6.2e-05,172.217.194.0-255,2109,14068,64,266192
10601,6.5e-05,172.31.40.0-255,66,14134,64,266192
10602,9.7e-05,172.217.194.0-255,2902,17036,64,266192
10603,0.0001,172.31.40.0-255,66,17102,64,266192
10604,0.000108,172.217.194.0-255,7156,24258,64,266192
10605,0.00011,172.31.40.0-255,66,24324,64,266192
10606,0.000113,172.217.194.0-255,1484,25808,64,266192
10607,0.000115,172.31.40.0-255,66,25874,64,266192
10608,0.000162,172.217.194.0-255,5738,31612,64,266192
10609,0.000165,172.31.40.0-255,66,31678,64,266192
10610,0.000203,172.31.40.0-255,66,31744,64,266192
10611,0.000211,172.217.194.0-255,6797,38541,64,266192
10612,0.000213,172.31.40.0-255,66,38607,64,266192
10613,0.000269,172.31.40.0-255,66,38673,64,266192
10614,0.000271,172.217.194.0-255,376,39049,64,266192
10615,0.000273,172.31.40.0-255,66,39115,64,266192
10616,0.000295,172.217.194.0-255,98,39213,64,266192
10617,0.000297,172.31.40.0-255,66,39279,64,266192
10618,0.000325,172.217.194.0-255,366,39645,64,266192
10619,0.000327,172.31.40.0-255,66,39711,64,266192
10620,0.000471,172.217.194.0-255,1484,41195,64,266192
10621,0.000476,172.31.40.0-255,66,41261,64,266192
10622,0.000486,172.217.194.0-255,2902,44163,64,266192
10623,0.000488,172.31.40.0-255,66,44229,64,266192
10624,0.000501,172.217.194.0-255,5738,49967,64,266192
10625,0.000504,172.31.40.0-255,66,50033,64,266192
10626,0.000538,172.217.194.0-255,6797,56830,64,266192
10627,0.000542,172.31.40.0-255,66,56896,64,266192
10628,0.000549,172.217.194.0-255,7156,64052,64,266192
10629,0.000552,172.31.40.0-255,66,64118,64,266192
10630,0.000589,172.31.40.0-255,66,64184,64,266192
10631,0.001641,172.217.194.0-255,1484,65668,64,266192
10632,0.001653,172.217.194.0-255,2902,68570,64,266192
10633,0.001657,172.31.40.0-255,66,68636,64,266192
10634,0.001666,172.217.194.0-255,5738,74374,64,266192
10635,0.001668,172.31.40.0-255,66,74440,64,266192
10636,0.001712,172.31.40.0-255,66,74506,64,266192
10637,0.001724,172.31.40.0-255,66,74572,64,266192
10638,0.001763,172.217.194.0-255,1484,76056,64,266192
10639,0.001783,172.217.194.0-255,2902,78958,64,266192
10640,0.001786,172.31.40.0-255,66,79024,64,266192
10641,0.001792,172.217.194.0-255,4320,83344,64,266192
10642,0.001794,172.31.40.0-255,66,83410,64,266192
10643,0.001824,172.217.194.0-255,1484,84894,64,266192
10644,0.001838,172.31.40.0-255,66,84960,64,266192
10645,0.001878,172.31.40.0-255,66,85026,64,266192
10646,0.001884,172.217.194.0-255,4320,89346,64,266192
10647,0.001886,172.31.40.0-255,66,89412,64,266192
10648,0.001913,172.217.194.0-255,7156,96568,64,266192
10649,0.001916,172.31.40.0-255,66,96634,64,266192
10650,0.001924,172.217.194.0-255,7156,103790,64,266192
10651,0.001926,172.31.40.0-255,66,103856,64,266192
10652,0.001966,172.217.194.0-255,2902,106758,64,266192
10653,0.001969,172.31.40.0-255,66,106824,64,266192
10654,0.002015,172.31.40.0-255,66,106890,64,266192
10655,0.002031,172.31.40.0-255,66,106956,64,266192
10656,0.002052,172.31.40.0-255,66,107022,64,266192
10657,0.002085,172.217.194.0-255,766,107788,64,266192
10658,0.004153,172.217.194.0-255,4320,112108,64,266192
10659,0.004161,172.31.40.0-255,66,112174,64,266192
10660,0.006294,172.217.194.0-255,4320,116494,64,266192
10661,0.006299,172.31.40.0-255,66,116560,64,266192
10662,0.006317,172.217.194.0-255,1484,118044,64,266192
10663,0.008394,172.217.194.0-255,4320,122364,64,266192
10664,0.008402,172.31.40.0-255,66,122430,64,266192
10665,0.010545,172.217.194.0-255,5738,128168,64,266192
10666,0.010553,172.31.40.0-255,66,128234,64,266192
10667,0.012671,172.217.194.0-255,5738,133972,64,266192
10668,0.012688,172.31.40.0-255,66,134038,64,266192
10669,0.01479,172.217.194.0-255,5738,139776,64,266192
10670,0.014803,172.31.40.0-255,66,139842,64,266192
10671,0.01693,172.217.194.0-255,5738,145580,64,266192
10672,0.016945,172.31.40.0-255,66,145646,64,266192
10673,0.019049,172.217.194.0-255,5738,151384,64,266192
10674,0.019061,172.31.40.0-255,66,151450,64,266192
10675,0.021225,172.217.194.0-255,5738,157188,64,266192
10676,0.021243,172.31.40.0-255,66,157254,64,266192
10677,0.023345,172.217.194.0-255,5738,162992,64,266192
10678,0.023353,172.31.40.0-255,66,163058,64,266192
10679,0.02546,172.217.194.0-255,5738,168796,64,266192
10680,0.025469,172.31.40.0-255,66,168862,64,266192
10681,0.02761,172.217.194.0-255,5738,174600,64,266192
10682,0.027627,172.31.40.0-255,66,174666,64,266192
10683,0.029727,172.217.194.0-255,5738,180404,64,266192
10684,0.029736,172.31.40.0-255,66,180470,64,266192
10685,0.031857,172.217.194.0-255,5738,186208,64,266192
10686,0.031869,172.31.40.0-255,66,186274,64,266192
10687,0.034008,172.217.194.0-255,5738,192012,64,266192
10688,0.034027,172.31.40.0-255,66,192078,64,266192
10689,0.036116,172.217.194.0-255,5738,197816,64,266192
10690,0.036125,172.31.40.0-255,66,197882,64,266192
10691,0.038233,172.217.194.0-255,5738,203620,64,266192
10692,0.038242,172.31.40.0-255,66,203686,64,266192
10693,0.040356,172.217.194.0-255,5738,209424,64,266192
10694,0.040374,172.31.40.0-255,66,209490,64,266192
10695,0.042498,172.217.194.0-255,5738,215228,64,266192
10696,0.042511,172.31.40.0-255,66,215294,64,266192
10697,0.044593,172.217.194.0-255,5738,221032,64,266192
10698,0.044604,172.31.40.0-255,66,221098,64,266192
10699,0.046658,172.31.40.0-255,172,221270,64,266192
10700,0.04669,172.31.40.0-255,1112,222382,64,266192
10701,0.046709,172.217.194.0-255,5738,228120,64,266192
10702,0.046715,172.31.40.0-255,66,228186,64,266192
10703,0.046828,172.31.40.0-255,1514,229700,64,266192
10704,0.04683,172.31.40.0-255,1296,230996,64,266192
10705,0.048229,104.244.42.0-255,66,231062,64,266192
10706,0.048243,104.244.42.0-255,66,231128,64,266192
10707,0.048379,104.244.42.0-255,66,231194,64,266192
10708,0.048816,172.217.194.0-255,5738,236932,64,266192
10709,0.048828,172.31.40.0-255,66,236998,64,266192
10710,0.048968,104.244.42.0-255,108,237106,64,266192
10711,0.048972,172.31.40.0-255,66,237172,64,266192
10712,0.050937,172.217.194.0-255,5738,242910,64,266192
10713,0.050944,172.31.40.0-255,66,242976,64,266192
10714,0.05303,172.217.194.0-255,5738,248714,64,266192
10715,0.053047,172.31.40.0-255,66,248780,64,266192
10716,0.055194,172.217.194.0-255,5738,254518,64,266192
10717,0.055212,172.31.40.0-255,66,254584,64,266192
10718,0.057332,172.217.194.0-255,5738,260322,64,266192
10719,0.057352,172.31.40.0-255,66,260388,64,266192
10720,0.059509,172.217.194.0-255,5738,266126,64,266192
10721,0.059525,172.31.40.0-255,66,266192,64,266192
10722,0.0,74.125.130.0-255,154,154,64,259600
10723,1.7e-05,172.31.40.0-255,66,220,64,259600
10724,2.3e-05,74.125.130.0-255,1484,1704,64,259600
10725,2.8e-05,172.31.40.0-255,66,1770,64,259600
10726,4.6e-05,74.125.130.0-255,2902,4672,64,259600
10727,4.9e-05,172.31.40.0-255,66,4738,64,259600
10728,8.2e-05,74.125.130.0-255,7156,11894,64,259600
10729,8.6e-05,172.31.40.0-255,66,11960,64,259600
10730,9e-05,74.125.130.0-255,2039,13999,64,259600
10731,9.3e-05,172.31.40.0-255,66,14065,64,259600
10732,0.000148,74.125.130.0-255,1484,15549,64,259600
10733,0.000151,172.31.40.0-255,66,15615,64,259600
10734,0.000163,74.125.130.0-255,2902,18517,64,259600
10735,0.000166,172.31.40.0-255,66,18583,64,259600
10736,0.000186,74.125.130.0-255,1484,20067,64,259600
10737,0.000188,172.31.40.0-255,66,20133,64,259600
10738,0.000193,74.125.130.0-255,2902,23035,64,259600
10739,0.000195,172.31.40.0-255,66,23101,64,259600
10740,0.000225,74.125.130.0-255,1484,24585,64,259600
10741,0.000228,172.31.40.0-255,66,24651,64,259600
10742,0.000253,74.125.130.0-255,4320,28971,64,259600
10743,0.000256,172.31.40.0-255,66,29037,64,259600
10744,0.000261,74.125.130.0-255,2543,31580,64,259600
10745,0.000263,172.31.40.0-255,66,31646,64,259600
10746,0.000423,74.125.130.0-255,1484,33130,64,259600
10747,0.000428,172.31.40.0-255,66,33196,64,259600
10748,0.000432,74.125.130.0-255,1484,34680,64,259600
10749,0.000434,172.31.40.0-255,66,34746,64,259600
10750,0.000439,74.125.130.0-255,2902,37648,64,259600
10751,0.000444,172.31.40.0-255,66,37714,64,259600
10752,0.000468,74.125.130.0-255,5738,43452,64,259600
10753,0.00047,172.31.40.0-255,66,43518,64,259600
10754,0.000496,74.125.130.0-255,5379,48897,64,259600
10755,0.000541,172.31.40.0-255,66,48963,64,259600
10756,0.000549,74.125.130.0-255,4320,53283,64,259600
10757,0.000562,74.125.130.0-255,1484,54767,64,259600
10758,0.000569,172.31.40.0-255,66,54833,64,259600
10759,0.000583,74.125.130.0-255,1411,56244,64,259600
10760,0.000588,172.31.40.0-255,66,56310,64,259600
10761,0.000714,74.125.130.0-255,99,56409,64,259600
10762,0.000923,74.125.130.0-255,1484,57893,64,259600
10763,0.000927,172.31.40.0-255,66,57959,64,259600
10764,0.000933,74.125.130.0-255,2902,60861,64,259600
10765,0.000937,74.125.130.0-255,2902,63763,64,259600
10766,0.000943,172.31.40.0-255,66,63829,64,259600
10767,0.000967,74.125.130.0-255,4320,68149,64,259600
10768,0.00097,172.31.40.0-255,66,68215,64,259600
10769,0.000987,74.125.130.0-255,4320,72535,64,259600
10770,0.001003,172.31.40.0-255,66,72601,64,259600
10771,0.001006,74.125.130.0-255,5379,77980,64,259600
10772,0.001018,172.31.40.0-255,66,78046,64,259600
10773,0.001048,74.125.130.0-255,2902,80948,64,259600
10774,0.001052,172.31.40.0-255,66,81014,64,259600
10775,0.001068,74.125.130.0-255,1484,82498,64,259600
10776,0.001097,172.31.40.0-255,66,82564,64,259600
10777,0.001432,74.125.130.0-255,1484,84048,64,259600
10778,0.001442,74.125.130.0-255,2902,86950,64,259600
10779,0.001445,172.31.40.0-255,66,87016,64,259600
10780,0.00145,74.125.130.0-255,1484,88500,64,259600
10781,0.001466,74.125.130.0-255,2902,91402,64,259600
10782,0.001468,172.31.40.0-255,66,91468,64,259600
10783,0.001474,74.125.130.0-255,4320,95788,64,259600
10784,0.001476,172.31.40.0-255,66,95854,64,259600
10785,0.001487,74.125.130.0-255,1484,97338,64,259600
10786,0.001521,74.125.130.0-255,5738,103076,64,259600
10787,0.001539,74.125.130.0-255,2902,105978,64,259600
10788,0.001576,74.125.130.0-255,2902,108880,64,259600
10789,0.001601,74.125.130.0-255,7156,116036,64,259600
10790,0.001623,74.125.130.0-255,766,116802,64,259600
10791,0.003584,172.31.40.0-255,66,116868,64,259600
10792,0.005914,74.125.130.0-255,5738,122606,64,259600
10793,0.00592,172.31.40.0-255,66,122672,64,259600
10794,0.008234,74.125.130.0-255,1484,124156,64,259600
10795,0.008272,74.125.130.0-255,4320,128476,64,259600
10796,0.008277,172.31.40.0-255,66,128542,64,259600
10797,0.010605,74.125.130.0-255,5738,134280,64,259600
10798,0.010612,172.31.40.0-255,66,134346,64,259600
10799,0.012965,74.125.130.0-255,5738,140084,64,259600
10800,0.012971,172.31.40.0-255,66,140150,64,259600
10801,0.015293,74.125.130.0-255,5738,145888,64,259600
10802,0.015299,172.31.40.0-255,66,145954,64,259600
10803,0.017647,74.125.130.0-255,5738,151692,64,259600
10804,0.017659,172.31.40.0-255,66,151758,64,259600
10805,0.019989,74.125.130.0-255,5738,157496,64,259600
10806,0.019998,172.31.40.0-255,66,157562,64,259600
10807,0.022328,74.125.130.0-255,5738,163300,64,259600
10808,0.022335,172.31.40.0-255,66,163366,64,259600
10809,0.024656,74.125.130.0-255,4320,167686,64,259600
10810,0.024663,172.31.40.0-255,66,167752,64,259600
10811,0.024684,74.125.130.0-255,1484,169236,64,259600
10812,0.026987,74.125.130.0-255,4320,173556,64,259600
10813,0.026994,172.31.40.0-255,66,173622,64,259600
10814,0.029326,74.125.130.0-255,4320,177942,64,259600
10815,0.029332,172.31.40.0-255,66,178008,64,259600
10816,0.029354,74.125.130.0-255,1484,179492,64,259600
10817,0.029692,172.31.40.0-255,172,179664,64,259600
10818,0.029735,172.31.40.0-255,1112,180776,64,259600
10819,0.029945,172.31.40.0-255,1514,182290,64,259600
10820,0.029948,172.31.40.0-255,1296,183586,64,259600
10821,0.031247,104.244.42.0-255,66,183652,64,259600
10822,0.031387,104.244.42.0-255,66,183718,64,259600
10823,0.031491,104.244.42.0-255,66,183784,64,259600
10824,0.031647,74.125.130.0-255,1484,185268,64,259600
10825,0.031651,172.31.40.0-255,66,185334,64,259600
10826,0.031713,74.125.130.0-255,2902,188236,64,259600
10827,0.031718,172.31.40.0-255,66,188302,64,259600
10828,0.033986,74.125.130.0-255,2902,191204,64,259600
10829,0.033992,172.31.40.0-255,66,191270,64,259600
10830,0.03404,74.125.130.0-255,2902,194172,64,259600
10831,0.034043,172.31.40.0-255,66,194238,64,259600
10832,0.036317,74.125.130.0-255,2902,197140,64,259600
10833,0.036322,172.31.40.0-255,66,197206,64,259600
10834,0.036375,74.125.130.0-255,2902,200108,64,259600
10835,0.036378,172.31.40.0-255,66,200174,64,259600
10836,0.038658,74.125.130.0-255,2902,203076,64,259600
10837,0.038663,172.31.40.0-255,66,203142,64,259600
10838,0.038698,74.125.130.0-255,2902,206044,64,259600
10839,0.038701,172.31.40.0-255,66,206110,64,259600
10840,0.040988,74.125.130.0-255,2902,209012,64,259600
10841,0.040994,172.31.40.0-255,66,209078,64,259600
10842,0.041031,74.125.130.0-255,2902,211980,64,259600
10843,0.041035,172.31.40.0-255,66,212046,64,259600
10844,0.043321,74.125.130.0-255,2902,214948,64,259600
10845,0.043326,172.31.40.0-255,66,215014,64,259600
10846,0.043354,74.125.130.0-255,1484,216498,64,259600
10847,0.043371,74.125.130.0-255,1484,217982,64,259600
10848,0.043374,172.31.40.0-255,66,218048,64,259600
10849,0.045651,74.125.130.0-255,2902,220950,64,259600
10850,0.045656,172.31.40.0-255,66,221016,64,259600
10851,0.04569,74.125.130.0-255,2902,223918,64,259600
10852,0.045693,172.31.40.0-255,66,223984,64,259600
10853,0.047984,74.125.130.0-255,2902,226886,64,259600
10854,0.047989,172.31.40.0-255,66,226952,64,259600
10855,0.048019,74.125.130.0-255,2902,229854,64,259600
10856,0.048022,172.31.40.0-255,66,229920,64,259600
10857,0.050315,74.125.130.0-255,2902,232822,64,259600
10858,0.050321,172.31.40.0-255,66,232888,64,259600
10859,0.050338,74.125.130.0-255,2902,235790,64,259600
10860,0.050341,172.31.40.0-255,66,235856,64,259600
10861,0.052637,74.125.130.0-255,2902,238758,64,259600
10862,0.052643,172.31.40.0-255,66,238824,64,259600
10863,0.052671,74.125.130.0-255,2902,241726,64,259600
10864,0.052675,172.31.40.0-255,66,241792,64,259600
10865,0.054959,74.125.130.0-255,2902,244694,64,259600
10866,0.054965,172.31.40.0-255,66,244760,64,259600
10867,0.055,74.125.130.0-255,2902,247662,64,259600
10868,0.055003,172.31.40.0-255,66,247728,64,259600
10869,0.057287,74.125.130.0-255,2902,250630,64,259600
10870,0.057292,172.31.40.0-255,66,250696,64,259600
10871,0.057323,74.125.130.0-255,2902,253598,64,259600
10872,0.057326,172.31.40.0-255,66,253664,64,259600
10873,0.059621,74.125.130.0-255,2902,256566,64,259600
10874,0.059625,172.31.40.0-255,66,256632,64,259600
10875,0.059653,74.125.130.0-255,2902,259534,64,259600
10876,0.059655,172.31.40.0-255,66,259600,64,259600
10877,0.0,74.125.68.0-255,301,301,64,360421
10878,2.4e-05,172.31.40.0-255,66,367,64,360421
10879,3.2e-05,74.125.68.0-255,1484,1851,64,360421
10880,3.7e-05,172.31.40.0-255,66,1917,64,360421
10881,4.4e-05,74.125.68.0-255,4320,6237,64,360421
10882,4.7e-05,172.31.40.0-255,66,6303,64,360421
10883,5.5e-05,74.125.68.0-255,5738,12041,64,360421
10884,5.9e-05,172.31.40.0-255,66,12107,64,360421
10885,8.4e-05,74.125.68.0-255,1894,14001,64,360421
10886,8.7e-05,172.31.40.0-255,66,14067,64,360421
10887,9.9e-05,172.31.40.0-255,66,14133,64,360421
10888,0.000103,74.125.68.0-255,2902,17035,64,360421
10889,0.000105,172.31.40.0-255,66,17101,64,360421
10890,0.000133,74.125.68.0-255,4320,21421,64,360421
10891,0.000136,172.31.40.0-255,66,21487,64,360421
10892,0.000139,74.125.68.0-255,1125,22612,64,360421
10893,0.000141,172.31.40.0-255,66,22678,64,360421
10894,0.000273,74.125.68.0-255,1484,24162,64,360421
10895,0.000278,172.31.40.0-255,66,24228,64,360421
10896,0.000283,74.125.68.0-255,2902,27130,64,360421
10897,0.000286,172.31.40.0-255,66,27196,64,360421
10898,0.000299,74.125.68.0-255,2902,30098,64,360421
10899,0.000301,172.31.40.0-255,66,30164,64,360421
10900,0.000316,74.125.68.0-255,2902,33066,64,360421
10901,0.000319,172.31.40.0-255,66,33132,64,360421
10902,0.000337,74.125.68.0-255,1484,34616,64,360421
10903,0.00034,172.31.40.0-255,66,34682,64,360421
10904,0.000355,74.125.68.0-255,5379,40061,64,360421
10905,0.000358,172.31.40.0-255,66,40127,64,360421
10906,0.000391,74.125.68.0-255,5738,45865,64,360421
10907,0.000394,172.31.40.0-255,66,45931,64,360421
10908,0.000397,74.125.68.0-255,1484,47415,64,360421
10909,0.000414,74.125.68.0-255,2902,50317,64,360421
10910,0.000417,172.31.40.0-255,66,50383,64,360421
10911,0.00042,74.125.68.0-255,1484,51867,64,360421
10912,0.00044,74.125.68.0-255,4320,56187,64,360421
10913,0.000443,172.31.40.0-255,66,56253,64,360421
10914,0.000456,74.125.68.0-255,1437,57690,64,360421
10915,0.000515,74.125.68.0-255,111,57801,64,360421
10916,0.000624,74.125.68.0-255,331,58132,64,360421
10917,0.000629,172.31.40.0-255,66,58198,64,360421
10918,0.000762,74.125.68.0-255,1484,59682,64,360421
10919,0.000788,74.125.68.0-255,2902,62584,64,360421
10920,0.000791,172.31.40.0-255,66,62650,64,360421
10921,0.000795,74.125.68.0-255,1484,64134,64,360421
10922,0.000811,74.125.68.0-255,2902,67036,64,360421
10923,0.000813,172.31.40.0-255,66,67102,64,360421
10924,0.000818,74.125.68.0-255,2902,70004,64,360421
10925,0.00082,172.31.40.0-255,66,70070,64,360421
10926,0.000845,74.125.68.0-255,2902,72972,64,360421
10927,0.000847,172.31.40.0-255,66,73038,64,360421
10928,0.000851,74.125.68.0-255,1484,74522,64,360421
10929,0.000872,74.125.68.0-255,7156,81678,64,360421
10930,0.000876,172.31.40.0-255,66,81744,64,360421
10931,0.000889,74.125.68.0-255,5738,87482,64,360421
10932,0.000892,172.31.40.0-255,66,87548,64,360421
10933,0.000913,74.125.68.0-255,4320,91868,64,360421
10934,0.000916,172.31.40.0-255,66,91934,64,360421
10935,0.000919,74.125.68.0-255,766,92700,64,360421
10936,0.00106,74.125.68.0-255,1484,94184,64,360421
10937,0.001064,172.31.40.0-255,66,94250,64,360421
10938,0.001069,74.125.68.0-255,2902,97152,64,360421
10939,0.001071,172.31.40.0-255,66,97218,64,360421
10940,0.001103,74.125.68.0-255,1484,98702,64,360421
10941,0.00112,74.125.68.0-255,2902,101604,64,360421
10942,0.001124,172.31.40.0-255,66,101670,64,360421
10943,0.001145,74.125.68.0-255,5738,107408,64,360421
10944,0.001148,172.31.40.0-255,66,107474,64,360421
10945,0.001166,74.125.68.0-255,7156,114630,64,360421
10946,0.001169,172.31.40.0-255,66,114696,64,360421
10947,0.001202,172.31.40.0-255,66,114762,64,360421
10948,0.001206,74.125.68.0-255,2902,117664,64,360421
10949,0.001209,172.31.40.0-255,66,117730,64,360421
10950,0.001221,74.125.68.0-255,766,118496,64,360421
10951,0.001295,74.125.68.0-255,1484,119980,64,360421
10952,0.001298,172.31.40.0-255,66,120046,64,360421
10953,0.001303,74.125.68.0-255,1484,121530,64,360421
10954,0.001315,74.125.68.0-255,1484,123014,64,360421
10955,0.001318,172.31.40.0-255,66,123080,64,360421
10956,0.001323,74.125.68.0-255,2902,125982,64,360421
10957,0.001325,172.31.40.0-255,66,126048,64,360421
10958,0.001342,74.125.68.0-255,1484,127532,64,360421
10959,0.001346,74.125.68.0-255,2902,130434,64,360421
10960,0.001349,172.31.40.0-255,66,130500,64,360421
10961,0.001373,74.125.68.0-255,5738,136238,64,360421
10962,0.001376,172.31.40.0-255,66,136304,64,360421
10963,0.00138,74.125.68.0-255,2902,139206,64,360421
10964,0.001383,172.31.40.0-255,66,139272,64,360421
10965,0.001388,74.125.68.0-255,4320,143592,64,360421
10966,0.00139,172.31.40.0-255,66,143658,64,360421
10967,0.001445,172.31.40.0-255,66,143724,64,360421
10968,0.001459,74.125.68.0-255,766,144490,64,360421
10969,0.001668,74.125.68.0-255,1484,145974,64,360421
10970,0.001672,172.31.40.0-255,66,146040,64,360421
10971,0.001676,74.125.68.0-255,1484,147524,64,360421
10972,0.001691,74.125.68.0-255,1484,149008,64,360421
10973,0.001693,172.31.40.0-255,66,149074,64,360421
10974,0.0017,74.125.68.0-255,5738,154812,64,360421
10975,0.001702,172.31.40.0-255,66,154878,64,360421
10976,0.001705,74.125.68.0-255,1484,156362,64,360421
10977,0.001723,74.125.68.0-255,4320,160682,64,360421
10978,0.001725,172.31.40.0-255,66,160748,64,360421
10979,0.001751,74.125.68.0-255,7156,167904,64,360421
10980,0.001754,172.31.40.0-255,66,167970,64,360421
10981,0.001776,74.125.68.0-255,7156,175126,64,360421
10982,0.001779,172.31.40.0-255,66,175192,64,360421
10983,0.001801,74.125.68.0-255,3602,178794,64,360421
10984,0.001803,172.31.40.0-255,66,178860,64,360421
10985,0.001822,74.125.68.0-255,7156,186016,64,360421
10986,0.001825,172.31.40.0-255,66,186082,64,360421
10987,0.001847,74.125.68.0-255,4320,190402,64,360421
10988,0.00185,172.31.40.0-255,66,190468,64,360421
10989,0.001858,74.125.68.0-255,7156,197624,64,360421
10990,0.001861,172.31.40.0-255,66,197690,64,360421
10991,0.001884,74.125.68.0-255,5738,203428,64,360421
10992,0.001887,172.31.40.0-255,66,203494,64,360421
10993,0.001894,74.125.68.0-255,7156,210650,64,360421
10994,0.001897,172.31.40.0-255,66,210716,64,360421
10995,0.001921,74.125.68.0-255,2184,212900,64,360421
10996,0.001923,172.31.40.0-255,66,212966,64,360421
10997,0.001986,74.125.68.0-255,1484,214450,64,360421
10998,0.001999,74.125.68.0-255,2902,217352,64,360421
10999,0.002002,172.31.40.0-255,66,217418,64,360421
11000,0.002035,74.125.68.0-255,5738,223156,64,360421
11001,0.002039,172.31.40.0-255,66,223222,64,360421
11002,0.002052,74.125.68.0-255,7156,230378,64,360421
11003,0.002055,172.31.40.0-255,66,230444,64,360421
11004,0.002096,172.31.40.0-255,66,230510,64,360421
11005,0.002134,74.125.68.0-255,5020,235530,64,360421
11006,0.002137,172.31.40.0-255,66,235596,64,360421
11007,0.002153,74.125.68.0-255,2902,238498,64,360421
11008,0.002155,172.31.40.0-255,66,238564,64,360421
11009,0.002168,74.125.68.0-255,2902,241466,64,360421
11010,0.002171,172.31.40.0-255,66,241532,64,360421
11011,0.002176,74.125.68.0-255,4320,245852,64,360421
11012,0.002179,172.31.40.0-255,66,245918,64,360421
11013,0.002185,74.125.68.0-255,5738,251656,64,360421
11014,0.002188,172.31.40.0-255,66,251722,64,360421
11015,0.002208,74.125.68.0-255,1484,253206,64,360421
11016,0.002241,172.31.40.0-255,66,253272,64,360421
11017,0.002245,74.125.68.0-255,2902,256174,64,360421
11018,0.002247,172.31.40.0-255,66,256240,64,360421
11019,0.002292,74.125.68.0-255,3602,259842,64,360421
11020,0.002295,172.31.40.0-255,66,259908,64,360421
11021,0.002337,74.125.68.0-255,1484,261392,64,360421
11022,0.002355,74.125.68.0-255,2902,264294,64,360421
11023,0.002358,172.31.40.0-255,66,264360,64,360421
11024,0.002365,74.125.68.0-255,4320,268680,64,360421
11025,0.002367,172.31.40.0-255,66,268746,64,360421
11026,0.002381,74.125.68.0-255,1484,270230,64,360421
11027,0.002387,74.125.68.0-255,4320,274550,64,360421
11028,0.00239,172.31.40.0-255,66,274616,64,360421
11029,0.002395,74.125.68.0-255,2902,277518,64,360421
11030,0.002398,172.31.40.0-255,66,277584,64,360421
11031,0.002425,74.125.68.0-255,2902,280486,64,360421
11032,0.002428,172.31.40.0-255,66,280552,64,360421
11033,0.002441,172.31.40.0-255,66,280618,64,360421
11034,0.002445,74.125.68.0-255,2184,282802,64,360421
11035,0.002447,172.31.40.0-255,66,282868,64,360421
11036,0.002553,74.125.68.0-255,1484,284352,64,360421
11037,0.002574,74.125.68.0-255,2902,287254,64,360421
11038,0.002578,172.31.40.0-255,66,287320,64,360421
11039,0.002583,74.125.68.0-255,2902,290222,64,360421
11040,0.002585,172.31.40.0-255,66,290288,64,360421
11041,0.005142,74.125.68.0-255,5738,296026,64,360421
11042,0.00515,172.31.40.0-255,66,296092,64,360421
11043,0.007725,74.125.68.0-255,5738,301830,64,360421
11044,0.007748,172.31.40.0-255,66,301896,64,360421
11045,0.010323,74.125.68.0-255,5738,307634,64,360421
11046,0.010338,172.31.40.0-255,66,307700,64,360421
11047,0.012905,74.125.68.0-255,5738,313438,64,360421
11048,0.012919,172.31.40.0-255,66,313504,64,360421
11049,0.015471,74.125.68.0-255,5738,319242,64,360421
11050,0.015476,172.31.40.0-255,66,319308,64,360421
11051,0.018027,74.125.68.0-255,5738,325046,64,360421
11052,0.018034,172.31.40.0-255,66,325112,64,360421
11053,0.020595,74.125.68.0-255,5738,330850,64,360421
11054,0.020606,172.31.40.0-255,66,330916,64,360421
11055,0.02317,74.125.68.0-255,5738,336654,64,360421
11056,0.023179,172.31.40.0-255,66,336720,64,360421
11057,0.025738,74.125.68.0-255,5738,342458,64,360421
11058,0.025749,172.31.40.0-255,66,342524,64,360421
11059,0.028316,74.125.68.0-255,5738,348262,64,360421
11060,0.028326,172.31.40.0-255,66,348328,64,360421
11061,0.030883,74.125.68.0-255,5738,354066,64,360421
11062,0.030891,172.31.40.0-255,66,354132,64,360421
11063,0.033451,74.125.68.0-255,1760,355892,64,360421
11064,0.033462,172.31.40.0-255,66,355958,64,360421
11065,0.03368,172.31.40.0-255,105,356063,64,360421
11066,0.036227,74.125.68.0-255,66,356129,64,360421
11067,0.050425,172.31.40.0-255,172,356301,64,360421
11068,0.050459,172.31.40.0-255,1112,357413,64,360421
11069,0.050522,172.31.40.0-255,1514,358927,64,360421
11070,0.050524,172.31.40.0-255,1296,360223,64,360421
11071,0.051981,104.244.42.0-255,66,360289,64,360421
11072,0.052016,104.244.42.0-255,66,360355,64,360421
11073,0.052059,104.244.42.0-255,66,360421,64,360421
11074,0.0,172.217.194.0-255,146,146,64,241309
11075,1.7e-05,172.31.40.0-255,66,212,64,241309
11076,2.4e-05,172.217.194.0-255,1484,1696,64,241309
11077,2.8e-05,172.31.40.0-255,66,1762,64,241309
11078,3.4e-05,172.217.194.0-255,2902,4664,64,241309
11079,4.6e-05,172.31.40.0-255,66,4730,64,241309
11080,5.2e-05,172.217.194.0-255,4320,9050,64,241309
11081,5.5e-05,172.31.40.0-255,66,9116,64,241309
11082,6.7e-05,172.31.40.0-255,66,9182,64,241309
11083,8.1e-05,172.31.40.0-255,66,9248,64,241309
11084,0.0002,172.217.194.0-255,1484,10732,64,241309
11085,0.000204,172.31.40.0-255,66,10798,64,241309
11086,0.00021,172.217.194.0-255,2902,13700,64,241309
11087,0.000213,172.31.40.0-255,66,13766,64,241309
11088,0.000225,172.217.194.0-255,5738,19504,64,241309
11089,0.000227,172.31.40.0-255,66,19570,64,241309
11090,0.000254,172.217.194.0-255,6797,26367,64,241309
11091,0.000257,172.31.40.0-255,66,26433,64,241309
11092,0.000291,172.217.194.0-255,7156,33589,64,241309
11093,0.000294,172.31.40.0-255,66,33655,64,241309
11094,0.000306,172.31.40.0-255,66,33721,64,241309
11095,0.000329,172.217.194.0-255,378,34099,64,241309
11096,0.000331,172.31.40.0-255,66,34165,64,241309
11097,0.000415,172.217.194.0-255,365,34530,64,241309
11098,0.000419,172.31.40.0-255,66,34596,64,241309
11099,0.000763,172.217.194.0-255,1484,36080,64,241309
11100,0.000768,172.31.40.0-255,66,36146,64,241309
11101,0.000773,172.217.194.0-255,2902,39048,64,241309
11102,0.000776,172.31.40.0-255,66,39114,64,241309
11103,0.000787,172.217.194.0-255,5738,44852,64,241309
11104,0.000789,172.31.40.0-255,66,44918,64,241309
11105,0.000837,172.31.40.0-255,66,44984,64,241309
11106,0.000841,172.217.194.0-255,1484,46468,64,241309
11107,0.000878,172.31.40.0-255,66,46534,64,241309
11108,0.001182,172.217.194.0-255,1484,48018,64,241309
11109,0.001188,172.217.194.0-255,2902,50920,64,241309
11110,0.001192,172.31.40.0-255,66,50986,64,241309
11111,0.001196,172.217.194.0-255,1484,52470,64,241309
11112,0.00122,172.217.194.0-255,4320,56790,64,241309
11113,0.001223,172.31.40.0-255,66,56856,64,241309
11114,0.00123,172.217.194.0-255,7156,64012,64,241309
11115,0.001232,172.31.40.0-255,66,64078,64,241309
11116,0.001262,172.217.194.0-255,5738,69816,64,241309
11117,0.001265,172.31.40.0-255,66,69882,64,241309
11118,0.001276,172.31.40.0-255,66,69948,64,241309
11119,0.00164,172.217.194.0-255,1484,71432,64,241309
11120,0.001645,172.217.194.0-255,1484,72916,64,241309
11121,0.001648,172.31.40.0-255,66,72982,64,241309
11122,0.001678,172.217.194.0-255,1484,74466,64,241309
11123,0.001684,172.217.194.0-255,5738,80204,64,241309
11124,0.001687,172.31.40.0-255,66,80270,64,241309
11125,0.001705,172.31.40.0-255,66,80336,64,241309
11126,0.00171,172.217.194.0-255,4320,84656,64,241309
11127,0.001713,172.31.40.0-255,66,84722,64,241309
11128,0.001745,172.217.194.0-255,6438,91160,64,241309
11129,0.001747,172.31.40.0-255,66,91226,64,241309
11130,0.001822,172.217.194.0-255,1484,92710,64,241309
11131,0.001827,172.217.194.0-255,2902,95612,64,241309
11132,0.00183,172.31.40.0-255,66,95678,64,241309
11133,0.001834,172.217.194.0-255,1484,97162,64,241309
11134,0.001862,172.217.194.0-255,4320,101482,64,241309
11135,0.001865,172.31.40.0-255,66,101548,64,241309
11136,0.001876,172.31.40.0-255,66,101614,64,241309
11137,0.0019,172.217.194.0-255,1484,103098,64,241309
11138,0.001917,172.217.194.0-255,5738,108836,64,241309
11139,0.00192,172.31.40.0-255,66,108902,64,241309
11140,0.001957,172.31.40.0-255,66,108968,64,241309
11141,0.002007,172.217.194.0-255,1484,110452,64,241309
11142,0.002011,172.217.194.0-255,1484,111936,64,241309
11143,0.002014,172.31.40.0-255,66,112002,64,241309
11144,0.002044,172.217.194.0-255,1484,113486,64,241309
11145,0.002051,172.217.194.0-255,5738,119224,64,241309
11146,0.002054,172.31.40.0-255,66,119290,64,241309
11147,0.002069,172.31.40.0-255,66,119356,64,241309
11148,0.002087,172.31.40.0-255,66,119422,64,241309
11149,0.002118,172.217.194.0-255,7156,126578,64,241309
11150,0.002121,172.31.40.0-255,66,126644,64,241309
11151,0.002132,172.31.40.0-255,66,126710,64,241309
11152,0.002176,172.31.40.0-255,66,126776,64,241309
11153,0.002201,172.217.194.0-255,1484,128260,64,241309
11154,0.00221,172.217.194.0-255,6438,134698,64,241309
11155,0.002212,172.31.40.0-255,66,134764,64,241309
11156,0.002225,172.31.40.0-255,66,134830,64,241309
11157,0.002271,172.31.40.0-255,66,134896,64,241309
11158,0.002291,172.31.40.0-255,66,134962,64,241309
11159,0.002293,172.217.194.0-255,1484,136446,64,241309
11160,0.004564,172.217.194.0-255,4320,140766,64,241309
11161,0.004582,172.31.40.0-255,66,140832,64,241309
11162,0.006783,172.217.194.0-255,5738,146570,64,241309
11163,0.0068,172.31.40.0-255,66,146636,64,241309
11164,0.009018,172.217.194.0-255,5738,152374,64,241309
11165,0.009034,172.31.40.0-255,66,152440,64,241309
11166,0.011255,172.217.194.0-255,5738,158178,64,241309
11167,0.011797,172.31.40.0-255,66,158244,64,241309
11168,0.014006,172.217.194.0-255,5738,163982,64,241309
11169,0.014013,172.31.40.0-255,66,164048,64,241309
11170,0.016223,172.217.194.0-255,5738,169786,64,241309
11171,0.016228,172.31.40.0-255,66,169852,64,241309
11172,0.018425,172.217.194.0-255,5738,175590,64,241309
11173,0.018433,172.31.40.0-255,66,175656,64,241309
11174,0.020622,172.217.194.0-255,5738,181394,64,241309
11175,0.020631,172.31.40.0-255,66,181460,64,241309
11176,0.02284,172.217.194.0-255,5738,187198,64,241309
11177,0.022849,172.31.40.0-255,66,187264,64,241309
11178,0.025035,172.217.194.0-255,5738,193002,64,241309
11179,0.025042,172.31.40.0-255,66,193068,64,241309
11180,0.027251,172.217.194.0-255,5738,198806,64,241309
11181,0.027258,172.31.40.0-255,66,198872,64,241309
11182,0.029462,172.217.194.0-255,5738,204610,64,241309
11183,0.029472,172.31.40.0-255,66,204676,64,241309
11184,0.031703,172.217.194.0-255,5738,210414,64,241309
11185,0.031719,172.31.40.0-255,66,210480,64,241309
11186,0.033909,172.217.194.0-255,5738,216218,64,241309
11187,0.033917,172.31.40.0-255,66,216284,64,241309
11188,0.036123,172.217.194.0-255,5738,222022,64,241309
11189,0.036131,172.31.40.0-255,66,222088,64,241309
11190,0.038348,172.217.194.0-255,5738,227826,64,241309
11191,0.038363,172.31.40.0-255,66,227892,64,241309
11192,0.040575,172.217.194.0-255,5738,233630,64,241309
11193,0.040586,172.31.40.0-255,66,233696,64,241309
11194,0.042776,172.217.194.0-255,3012,236708,64,241309
11195,0.042784,172.31.40.0-255,66,236774,64,241309
11196,0.042982,172.31.40.0-255,105,236879,64,241309
11197,0.045136,172.217.194.0-255,66,236945,64,241309
11198,0.046322,172.31.40.0-255,242,237187,64,241309
11199,0.046359,172.31.40.0-255,1112,238299,64,241309
11200,0.046426,172.31.40.0-255,1514,239813,64,241309
11201,0.046428,172.31.40.0-255,1298,241111,64,241309
11202,0.047856,104.244.42.0-255,66,241177,64,241309
11203,0.047887,104.244.42.0-255,66,241243,64,241309
11204,0.047985,104.244.42.0-255,66,241309,64,241309
11205,0.0,74.125.24.0-255,153,153,64,197720
11206,1.9e-05,172.31.40.0-255,66,219,64,197720
11207,2.7e-05,74.125.24.0-255,1484,1703,64,197720
11208,3.2e-05,172.31.40.0-255,66,1769,64,197720
11209,4.6e-05,74.125.24.0-255,2902,4671,64,197720
11210,5e-05,172.31.40.0-255,66,4737,64,197720
11211,5.5e-05,74.125.24.0-255,2902,7639,64,197720
11212,5.8e-05,172.31.40.0-255,66,7705,64,197720
11213,6.4e-05,74.125.24.0-255,4320,12025,64,197720
11214,6.7e-05,172.31.40.0-255,66,12091,64,197720
11215,7.2e-05,74.125.24.0-255,2902,14993,64,197720
11216,7.4e-05,172.31.40.0-255,66,15059,64,197720
11217,0.000104,74.125.24.0-255,6410,21469,64,197720
11218,0.000108,172.31.40.0-255,66,21535,64,197720
11219,0.00012,172.31.40.0-255,66,21601,64,197720
11220,0.000585,74.125.24.0-255,1484,23085,64,197720
11221,0.000591,172.31.40.0-255,66,23151,64,197720
11222,0.000597,74.125.24.0-255,2902,26053,64,197720
11223,0.000599,172.31.40.0-255,66,26119,64,197720
11224,0.000606,74.125.24.0-255,5738,31857,64,197720
11225,0.000613,172.31.40.0-255,66,31923,64,197720
11226,0.000656,74.125.24.0-255,6797,38720,64,197720
11227,0.000659,172.31.40.0-255,66,38786,64,197720
11228,0.000717,74.125.24.0-255,1484,40270,64,197720
11229,0.00072,172.31.40.0-255,66,40336,64,197720
11230,0.000724,74.125.24.0-255,1484,41820,64,197720
11231,0.000726,172.31.40.0-255,66,41886,64,197720
11232,0.000753,74.125.24.0-255,1484,43370,64,197720
11233,0.000755,172.31.40.0-255,66,43436,64,197720
11234,0.000763,74.125.24.0-255,5738,49174,64,197720
11235,0.000765,172.31.40.0-255,66,49240,64,197720
11236,0.000785,74.125.24.0-255,1484,50724,64,197720
11237,0.000808,74.125.24.0-255,5379,56103,64,197720
11238,0.000812,172.31.40.0-255,66,56169,64,197720
11239,0.001033,74.125.24.0-255,646,56815,64,197720
11240,0.001083,172.31.40.0-255,66,56881,64,197720
11241,0.00158,74.125.24.0-255,1484,58365,64,197720
11242,0.001592,74.125.24.0-255,2902,61267,64,197720
11243,0.001597,172.31.40.0-255,66,61333,64,197720
11244,0.001606,74.125.24.0-255,5738,67071,64,197720
11245,0.001609,172.31.40.0-255,66,67137,64,197720
11246,0.00162,74.125.24.0-255,4320,71457,64,197720
11247,0.001623,172.31.40.0-255,66,71523,64,197720
11248,0.001656,74.125.24.0-255,2902,74425,64,197720
11249,0.001659,172.31.40.0-255,66,74491,64,197720
11250,0.001678,172.31.40.0-255,66,74557,64,197720
11251,0.001682,74.125.24.0-255,2184,76741,64,197720
11252,0.001684,172.31.40.0-255,66,76807,64,197720
11253,0.002686,74.125.24.0-255,1484,78291,64,197720
11254,0.002718,74.125.24.0-255,2902,81193,64,197720
11255,0.002723,172.31.40.0-255,66,81259,64,197720
11256,0.002731,74.125.24.0-255,5738,86997,64,197720
11257,0.002733,172.31.40.0-255,66,87063,64,197720
11258,0.002752,172.31.40.0-255,66,87129,64,197720
11259,0.002763,172.31.40.0-255,66,87195,64,197720
11260,0.002786,74.125.24.0-255,1484,88679,64,197720
11261,0.002793,74.125.24.0-255,766,89445,64,197720
11262,0.002796,172.31.40.0-255,66,89511,64,197720
11263,0.00292,74.125.24.0-255,1484,90995,64,197720
11264,0.002926,74.125.24.0-255,2902,93897,64,197720
11265,0.002929,172.31.40.0-255,66,93963,64,197720
11266,0.002933,74.125.24.0-255,1484,95447,64,197720
11267,0.002955,74.125.24.0-255,1484,96931,64,197720
11268,0.002958,172.31.40.0-255,66,96997,64,197720
11269,0.002962,74.125.24.0-255,2902,99899,64,197720
11270,0.002964,172.31.40.0-255,66,99965,64,197720
11271,0.002975,74.125.24.0-255,4320,104285,64,197720
11272,0.002978,172.31.40.0-255,66,104351,64,197720
11273,0.003012,74.125.24.0-255,7156,111507,64,197720
11274,0.003014,74.125.24.0-255,1484,112991,64,197720
11275,0.003018,172.31.40.0-255,66,113057,64,197720
11276,0.003049,172.31.40.0-255,66,113123,64,197720
11277,0.003509,74.125.24.0-255,1484,114607,64,197720
11278,0.003532,74.125.24.0-255,2902,117509,64,197720
11279,0.003538,74.125.24.0-255,5738,123247,64,197720
11280,0.003546,172.31.40.0-255,66,123313,64,197720
11281,0.003554,172.31.40.0-255,66,123379,64,197720
11282,0.00357,172.31.40.0-255,66,123445,64,197720
11283,0.003612,74.125.24.0-255,5738,129183,64,197720
11284,0.003615,172.31.40.0-255,66,129249,64,197720
11285,0.003644,172.31.40.0-255,66,129315,64,197720
11286,0.00372,74.125.24.0-255,1484,130799,64,197720
11287,0.003739,74.125.24.0-255,2902,133701,64,197720
11288,0.003742,172.31.40.0-255,66,133767,64,197720
11289,0.003747,74.125.24.0-255,2902,136669,64,197720
11290,0.003749,172.31.40.0-255,66,136735,64,197720
11291,0.00379,74.125.24.0-255,7156,143891,64,197720
11292,0.003793,172.31.40.0-255,66,143957,64,197720
11293,0.003798,74.125.24.0-255,2902,146859,64,197720
11294,0.0038,172.31.40.0-255,66,146925,64,197720
11295,0.003845,172.31.40.0-255,66,146991,64,197720
11296,0.003852,74.125.24.0-255,5020,152011,64,197720
11297,0.003854,172.31.40.0-255,66,152077,64,197720
11298,0.004011,74.125.24.0-255,1484,153561,64,197720
11299,0.004017,74.125.24.0-255,2902,156463,64,197720
11300,0.00402,172.31.40.0-255,66,156529,64,197720
11301,0.004057,74.125.24.0-255,5738,162267,64,197720
11302,0.00406,172.31.40.0-255,66,162333,64,197720
11303,0.004066,74.125.24.0-255,4320,166653,64,197720
11304,0.004068,172.31.40.0-255,66,166719,64,197720
11305,0.004077,74.125.24.0-255,1484,168203,64,197720
11306,0.004117,172.31.40.0-255,66,168269,64,197720
11307,0.004132,172.31.40.0-255,66,168335,64,197720
11308,0.004336,74.125.24.0-255,1484,169819,64,197720
11309,0.004341,74.125.24.0-255,1484,171303,64,197720
11310,0.004344,172.31.40.0-255,66,171369,64,197720
11311,0.004375,74.125.24.0-255,2902,174271,64,197720
11312,0.004378,172.31.40.0-255,66,174337,64,197720
11313,0.004384,74.125.24.0-255,5738,180075,64,197720
11314,0.004387,172.31.40.0-255,66,180141,64,197720
11315,0.004391,74.125.24.0-255,2902,183043,64,197720
11316,0.004393,172.31.40.0-255,66,183109,64,197720
11317,0.004439,172.31.40.0-255,66,183175,64,197720
11318,0.004455,172.31.40.0-255,66,183241,64,197720
11319,0.00446,74.125.24.0-255,4320,187561,64,197720
11320,0.004463,172.31.40.0-255,66,187627,64,197720
11321,0.004508,172.31.40.0-255,66,187693,64,197720
11322,0.004528,172.31.40.0-255,66,187759,64,197720
11323,0.00454,172.31.40.0-255,66,187825,64,197720
11324,0.004589,172.31.40.0-255,66,187891,64,197720
11325,0.004601,172.31.40.0-255,66,187957,64,197720
11326,0.004697,172.31.40.0-255,66,188023,64,197720
11327,0.004704,74.125.24.0-255,5965,193988,64,197720
11328,0.004707,172.31.40.0-255,66,194054,64,197720
11329,0.004743,74.125.24.0-255,105,194159,64,197720
11330,0.013349,172.31.40.0-255,66,194225,64,197720
11331,0.013397,172.31.40.0-255,105,194330,64,197720
11332,0.015689,74.125.24.0-255,66,194396,64,197720
11333,0.034315,172.31.40.0-255,167,194563,64,197720
11334,0.034346,172.31.40.0-255,1107,195670,64,197720
11335,0.034507,172.31.40.0-255,1514,197184,64,197720
11336,0.034509,172.31.40.0-255,338,197522,64,197720
11337,0.035863,104.244.42.0-255,66,197588,64,197720
11338,0.035886,104.244.42.0-255,66,197654,64,197720
11339,0.036032,104.244.42.0-255,66,197720,64,197720
11340,0.0,172.217.194.0-255,153,153,64,298720
11341,2.3e-05,172.31.40.0-255,66,219,64,298720
11342,3e-05,172.217.194.0-255,1484,1703,64,298720
11343,3.4e-05,172.31.40.0-255,66,1769,64,298720
11344,3.9e-05,172.217.194.0-255,2902,4671,64,298720
11345,4.2e-05,172.31.40.0-255,66,4737,64,298720
11346,5e-05,172.217.194.0-255,7156,11893,64,298720
11347,5.4e-05,172.31.40.0-255,66,11959,64,298720
11348,8.1e-05,172.217.194.0-255,1978,13937,64,298720
11349,8.5e-05,172.31.40.0-255,66,14003,64,298720
11350,0.000183,172.217.194.0-255,1484,15487,64,298720
11351,0.000186,172.31.40.0-255,66,15553,64,298720
11352,0.000206,172.217.194.0-255,2902,18455,64,298720
11353,0.000209,172.31.40.0-255,66,18521,64,298720
11354,0.000213,172.217.194.0-255,2902,21423,64,298720
11355,0.000216,172.31.40.0-255,66,21489,64,298720
11356,0.000239,172.217.194.0-255,2902,24391,64,298720
11357,0.000242,172.31.40.0-255,66,24457,64,298720
11358,0.000246,172.217.194.0-255,2902,27359,64,298720
11359,0.000248,172.31.40.0-255,66,27425,64,298720
11360,0.00028,172.217.194.0-255,3961,31386,64,298720
11361,0.000283,172.31.40.0-255,66,31452,64,298720
11362,0.000828,172.217.194.0-255,1484,32936,64,298720
11363,0.000835,172.31.40.0-255,66,33002,64,298720
11364,0.000842,172.217.194.0-255,2902,35904,64,298720
11365,0.000845,172.31.40.0-255,66,35970,64,298720
11366,0.000852,172.217.194.0-255,5738,41708,64,298720
11367,0.000854,172.31.40.0-255,66,41774,64,298720
11368,0.000879,172.217.194.0-255,4320,46094,64,298720
11369,0.000882,172.31.40.0-255,66,46160,64,298720
11370,0.000918,172.31.40.0-255,66,46226,64,298720
11371,0.00093,172.31.40.0-255,66,46292,64,298720
11372,0.000932,172.217.194.0-255,1125,47417,64,298720
11373,0.001102,172.217.194.0-255,360,47777,64,298720
11374,0.001287,172.217.194.0-255,383,48160,64,298720
11375,0.00131,172.31.40.0-255,66,48226,64,298720
11376,0.001511,172.217.194.0-255,1484,49710,64,298720
11377,0.001519,172.217.194.0-255,2902,52612,64,298720
11378,0.001522,172.31.40.0-255,66,52678,64,298720
11379,0.001545,172.217.194.0-255,5738,58416,64,298720
11380,0.001548,172.31.40.0-255,66,58482,64,298720
11381,0.001554,172.217.194.0-255,4320,62802,64,298720
11382,0.001556,172.31.40.0-255,66,62868,64,298720
11383,0.001589,172.31.40.0-255,66,62934,64,298720
11384,0.001619,172.31.40.0-255,66,63000,64,298720
11385,0.001904,172.217.194.0-255,1484,64484,64,298720
11386,0.001922,172.217.194.0-255,2902,67386,64,298720
11387,0.001925,172.31.40.0-255,66,67452,64,298720
11388,0.001932,172.217.194.0-255,5738,73190,64,298720
11389,0.001934,172.31.40.0-255,66,73256,64,298720
11390,0.001939,172.217.194.0-255,2902,76158,64,298720
11391,0.001941,172.31.40.0-255,66,76224,64,298720
11392,0.001969,172.31.40.0-255,66,76290,64,298720
11393,0.00198,172.31.40.0-255,66,76356,64,298720
11394,0.002008,172.217.194.0-255,2184,78540,64,298720
11395,0.00201,172.31.40.0-255,66,78606,64,298720
11396,0.002238,172.217.194.0-255,1484,80090,64,298720
11397,0.002244,172.217.194.0-255,2902,82992,64,298720
11398,0.002248,172.31.40.0-255,66,83058,64,298720
11399,0.002275,172.217.194.0-255,5738,88796,64,298720
11400,0.002278,172.31.40.0-255,66,88862,64,298720
11401,0.002286,172.217.194.0-255,7156,96018,64,298720
11402,0.002287,172.31.40.0-255,66,96084,64,298720
11403,0.002312,172.217.194.0-255,5738,101822,64,298720
11404,0.002315,172.31.40.0-255,66,101888,64,298720
11405,0.002321,172.217.194.0-255,5738,107626,64,298720
11406,0.002323,172.31.40.0-255,66,107692,64,298720
11407,0.002341,172.217.194.0-255,5020,112712,64,298720
11408,0.002343,172.31.40.0-255,66,112778,64,298720
11409,0.002517,172.217.194.0-255,1484,114262,64,298720
11410,0.002521,172.217.194.0-255,1484,115746,64,298720
11411,0.002524,172.31.40.0-255,66,115812,64,298720
11412,0.002546,172.217.194.0-255,1484,117296,64,298720
11413,0.002551,172.217.194.0-255,5738,123034,64,298720
11414,0.002553,172.31.40.0-255,66,123100,64,298720
11415,0.002556,172.217.194.0-255,1484,124584,64,298720
11416,0.002584,172.31.40.0-255,66,124650,64,298720
11417,0.002588,172.217.194.0-255,4320,128970,64,298720
11418,0.00259,172.31.40.0-255,66,129036,64,298720
11419,0.002612,172.217.194.0-255,5738,134774,64,298720
11420,0.002614,172.31.40.0-255,66,134840,64,298720
11421,0.002617,172.217.194.0-255,766,135606,64,298720
11422,0.002719,172.217.194.0-255,1484,137090,64,298720
11423,0.002722,172.31.40.0-255,66,137156,64,298720
11424,0.002726,172.217.194.0-255,1484,138640,64,298720
11425,0.002742,172.217.194.0-255,1484,140124,64,298720
11426,0.002744,172.31.40.0-255,66,140190,64,298720
11427,0.002751,172.217.194.0-255,5738,145928,64,298720
11428,0.002753,172.31.40.0-255,66,145994,64,298720
11429,0.002779,172.217.194.0-255,7156,153150,64,298720
11430,0.002782,172.31.40.0-255,66,153216,64,298720
11431,0.002806,172.217.194.0-255,1484,154700,64,298720
11432,0.002835,172.217.194.0-255,4320,159020,64,298720
11433,0.002839,172.31.40.0-255,66,159086,64,298720
11434,0.002863,172.217.194.0-255,7156,166242,64,298720
11435,0.002866,172.31.40.0-255,66,166308,64,298720
11436,0.00287,172.217.194.0-255,2902,169210,64,298720
11437,0.002873,172.31.40.0-255,66,169276,64,298720
11438,0.0029,172.31.40.0-255,66,169342,64,298720
11439,0.002907,172.217.194.0-255,5738,175080,64,298720
11440,0.00291,172.31.40.0-255,66,175146,64,298720
11441,0.002943,172.217.194.0-255,7156,182302,64,298720
11442,0.002946,172.31.40.0-255,66,182368,64,298720
11443,0.002954,172.217.194.0-255,7156,189524,64,298720
11444,0.002956,172.31.40.0-255,66,189590,64,298720
11445,0.002982,172.217.194.0-255,5020,194610,64,298720
11446,0.002984,172.31.40.0-255,66,194676,64,298720
11447,0.003024,172.217.194.0-255,5738,200414,64,298720
11448,0.003027,172.31.40.0-255,66,200480,64,298720
11449,0.003064,172.217.194.0-255,7156,207636,64,298720
11450,0.003067,172.31.40.0-255,66,207702,64,298720
11451,0.003125,172.31.40.0-255,66,207768,64,298720
11452,0.003131,172.217.194.0-255,5738,213506,64,298720
11453,0.003133,172.31.40.0-255,66,213572,64,298720
11454,0.003136,172.217.194.0-255,766,214338,64,298720
11455,0.003152,172.217.194.0-255,1484,215822,64,298720
11456,0.003154,172.31.40.0-255,66,215888,64,298720
11457,0.00316,172.217.194.0-255,4320,220208,64,298720
11458,0.003162,172.31.40.0-255,66,220274,64,298720
11459,0.003181,172.217.194.0-255,2902,223176,64,298720
11460,0.003184,172.31.40.0-255,66,223242,64,298720
11461,0.003212,172.217.194.0-255,7156,230398,64,298720
11462,0.003215,172.31.40.0-255,66,230464,64,298720
11463,0.003225,172.31.40.0-255,66,230530,64,298720
11464,0.003249,172.217.194.0-255,5738,236268,64,298720
11465,0.003252,172.31.40.0-255,66,236334,64,298720
11466,0.003284,172.217.194.0-255,3602,239936,64,298720
11467,0.003287,172.31.40.0-255,66,240002,64,298720
11468,0.003405,172.217.194.0-255,1484,241486,64,298720
11469,0.00342,172.217.194.0-255,2902,244388,64,298720
11470,0.003423,172.31.40.0-255,66,244454,64,298720
11471,0.003448,172.217.194.0-255,5738,250192,64,298720
11472,0.003451,172.31.40.0-255,66,250258,64,298720
11473,0.003456,172.217.194.0-255,2902,253160,64,298720
11474,0.003458,172.31.40.0-255,66,253226,64,298720
11475,0.00349,172.217.194.0-255,4320,257546,64,298720
11476,0.003493,172.31.40.0-255,66,257612,64,298720
11477,0.003504,172.31.40.0-255,66,257678,64,298720
11478,0.003532,172.217.194.0-255,5738,263416,64,298720
11479,0.003536,172.31.40.0-255,66,263482,64,298720
11480,0.00354,172.217.194.0-255,2184,265666,64,298720
11481,0.003542,172.31.40.0-255,66,265732,64,298720
11482,0.003584,172.217.194.0-255,2902,268634,64,298720
11483,0.003588,172.31.40.0-255,66,268700,64,298720
11484,0.003593,172.217.194.0-255,2902,271602,64,298720
11485,0.003595,172.31.40.0-255,66,271668,64,298720
11486,0.003628,172.217.194.0-255,7156,278824,64,298720
11487,0.003632,172.31.40.0-255,66,278890,64,298720
11488,0.003642,172.217.194.0-255,1484,280374,64,298720
11489,0.003674,172.31.40.0-255,66,280440,64,298720
11490,0.003679,172.217.194.0-255,2902,283342,64,298720
11491,0.003681,172.31.40.0-255,66,283408,64,298720
11492,0.003685,172.217.194.0-255,1484,284892,64,298720
11493,0.003709,172.217.194.0-255,2184,287076,64,298720
11494,0.003713,172.31.40.0-255,66,287142,64,298720
11495,0.003779,172.217.194.0-255,1484,288626,64,298720
11496,0.003814,172.217.194.0-255,1484,290110,64,298720
11497,0.003818,172.31.40.0-255,66,290176,64,298720
11498,0.003823,172.217.194.0-255,2488,292664,64,298720
11499,0.003825,172.31.40.0-255,66,292730,64,298720
11500,0.003829,172.217.194.0-255,97,292827,64,298720
11501,0.003928,172.217.194.0-255,105,292932,64,298720
11502,0.013626,172.31.40.0-255,101,293033,64,298720
11503,0.013665,172.217.194.0-255,105,293138,64,298720
11504,0.013685,172.31.40.0-255,78,293216,64,298720
11505,0.014086,172.31.40.0-255,105,293321,64,298720
11506,0.015959,172.217.194.0-255,66,293387,64,298720
11507,0.016376,172.217.194.0-255,66,293453,64,298720
11508,0.050733,172.31.40.0-255,167,293620,64,298720
11509,0.050771,172.31.40.0-255,1111,294731,64,298720
11510,0.050834,172.31.40.0-255,1514,296245,64,298720
11511,0.050836,172.31.40.0-255,1514,297759,64,298720
11512,0.050861,172.31.40.0-255,697,298456,64,298720
11513,0.052292,104.244.42.0-255,66,298522,64,298720
11514,0.052343,104.244.42.0-255,66,298588,64,298720
11515,0.052403,104.244.42.0-255,66,298654,64,298720
11516,0.052408,104.244.42.0-255,66,298720,64,298720
11517,0.0,74.125.130.0-255,143,143,64,218892
11518,1.7e-05,172.31.40.0-255,66,209,64,218892
11519,2.5e-05,74.125.130.0-255,1484,1693,64,218892
11520,2.9e-05,172.31.40.0-255,66,1759,64,218892
11521,3.5e-05,74.125.130.0-255,2902,4661,64,218892
11522,3.8e-05,172.31.40.0-255,66,4727,64,218892
11523,4.7e-05,74.125.130.0-255,7156,11883,64,218892
11524,5.1e-05,172.31.40.0-255,66,11949,64,218892
11525,5.5e-05,74.125.130.0-255,2062,14011,64,218892
11526,5.8e-05,172.31.40.0-255,66,14077,64,218892
11527,0.00064,74.125.130.0-255,1484,15561,64,218892
11528,0.000647,172.31.40.0-255,66,15627,64,218892
11529,0.000655,74.125.130.0-255,2902,18529,64,218892
11530,0.000658,172.31.40.0-255,66,18595,64,218892
11531,0.000692,74.125.130.0-255,5738,24333,64,218892
11532,0.000695,172.31.40.0-255,66,24399,64,218892
11533,0.000703,74.125.130.0-255,6797,31196,64,218892
11534,0.000706,172.31.40.0-255,66,31262,64,218892
11535,0.000719,74.125.130.0-255,1484,32746,64,218892
11536,0.000721,172.31.40.0-255,66,32812,64,218892
11537,0.000726,74.125.130.0-255,2902,35714,64,218892
11538,0.000728,172.31.40.0-255,66,35780,64,218892
11539,0.000758,74.125.130.0-255,5738,41518,64,218892
11540,0.000761,172.31.40.0-255,66,41584,64,218892
11541,0.000765,74.125.130.0-255,1484,43068,64,218892
11542,0.000767,172.31.40.0-255,66,43134,64,218892
11543,0.000784,74.125.130.0-255,5379,48513,64,218892
11544,0.000787,172.31.40.0-255,66,48579,64,218892
11545,0.003455,74.125.130.0-255,1484,50063,64,218892
11546,0.003463,172.31.40.0-255,66,50129,64,218892
11547,0.00347,74.125.130.0-255,2902,53031,64,218892
11548,0.003473,172.31.40.0-255,66,53097,64,218892
11549,0.003476,74.125.130.0-255,1484,54581,64,218892
11550,0.005395,74.125.130.0-255,4320,58901,64,218892
11551,0.005402,172.31.40.0-255,66,58967,64,218892
11552,0.007349,74.125.130.0-255,5738,64705,64,218892
11553,0.007357,172.31.40.0-255,66,64771,64,218892
11554,0.009325,74.125.130.0-255,5738,70509,64,218892
11555,0.009332,172.31.40.0-255,66,70575,64,218892
11556,0.011281,74.125.130.0-255,5738,76313,64,218892
11557,0.01129,172.31.40.0-255,66,76379,64,218892
11558,0.01324,74.125.130.0-255,5738,82117,64,218892
11559,0.013249,172.31.40.0-255,66,82183,64,218892
11560,0.015184,74.125.130.0-255,5738,87921,64,218892
11561,0.015191,172.31.40.0-255,66,87987,64,218892
11562,0.017139,74.125.130.0-255,5738,93725,64,218892
11563,0.017147,172.31.40.0-255,66,93791,64,218892
11564,0.019092,74.125.130.0-255,4320,98111,64,218892
11565,0.019099,172.31.40.0-255,66,98177,64,218892
11566,0.01912,74.125.130.0-255,1484,99661,64,218892
11567,0.021033,74.125.130.0-255,4320,103981,64,218892
11568,0.021041,172.31.40.0-255,66,104047,64,218892
11569,0.022987,74.125.130.0-255,5738,109785,64,218892
11570,0.022994,172.31.40.0-255,66,109851,64,218892
11571,0.023167,172.31.40.0-255,172,110023,64,218892
11572,0.023196,172.31.40.0-255,1112,111135,64,218892
11573,0.023327,172.31.40.0-255,1514,112649,64,218892
11574,0.023329,172.31.40.0-255,1297,113946,64,218892
11575,0.024695,104.244.42.0-255,66,114012,64,218892
11576,0.024731,104.244.42.0-255,66,114078,64,218892
11577,0.02488,104.244.42.0-255,66,114144,64,218892
11578,0.024932,74.125.130.0-255,5738,119882,64,218892
11579,0.024938,172.31.40.0-255,66,119948,64,218892
11580,0.0269,74.125.130.0-255,5738,125686,64,218892
11581,0.026906,172.31.40.0-255,66,125752,64,218892
11582,0.028843,74.125.130.0-255,5738,131490,64,218892
11583,0.02885,172.31.40.0-255,66,131556,64,218892
11584,0.030804,74.125.130.0-255,5738,137294,64,218892
11585,0.03081,172.31.40.0-255,66,137360,64,218892
11586,0.032759,74.125.130.0-255,5738,143098,64,218892
11587,0.032766,172.31.40.0-255,66,143164,64,218892
11588,0.033907,172.31.40.0-255,105,143269,64,218892
11589,0.034716,74.125.130.0-255,5738,149007,64,218892
11590,0.034722,172.31.40.0-255,66,149073,64,218892
11591,0.035671,157.240.7.0-255,105,149178,64,218892
11592,0.03568,172.31.40.0-255,66,149244,64,218892
11593,0.036666,74.125.130.0-255,5738,154982,64,218892
11594,0.036671,172.31.40.0-255,66,155048,64,218892
11595,0.038624,74.125.130.0-255,5738,160786,64,218892
11596,0.038631,172.31.40.0-255,66,160852,64,218892
11597,0.040584,74.125.130.0-255,5738,166590,64,218892
11598,0.04059,172.31.40.0-255,66,166656,64,218892
11599,0.042544,74.125.130.0-255,5738,172394,64,218892
11600,0.04255,172.31.40.0-255,66,172460,64,218892
11601,0.0445,74.125.130.0-255,5738,178198,64,218892
11602,0.044507,172.31.40.0-255,66,178264,64,218892
11603,0.046446,74.125.130.0-255,5738,184002,64,218892
11604,0.046453,172.31.40.0-255,66,184068,64,218892
11605,0.048392,74.125.130.0-255,5738,189806,64,218892
11606,0.048398,172.31.40.0-255,66,189872,64,218892
11607,0.05034,74.125.130.0-255,5738,195610,64,218892
11608,0.050348,172.31.40.0-255,66,195676,64,218892
11609,0.052294,74.125.130.0-255,5738,201414,64,218892
11610,0.052301,172.31.40.0-255,66,201480,64,218892
11611,0.054258,74.125.130.0-255,5738,207218,64,218892
11612,0.054267,172.31.40.0-255,66,207284,64,218892
11613,0.056269,74.125.130.0-255,5738,213022,64,218892
11614,0.056275,172.31.40.0-255,66,213088,64,218892
11615,0.058224,74.125.130.0-255,5738,218826,64,218892
11616,0.058234,172.31.40.0-255,66,218892,64,218892
11617,0.0,172.217.194.0-255,152,152,64,218881
11618,2.3e-05,172.31.40.0-255,66,218,64,218881
11619,3.1e-05,172.217.194.0-255,1484,1702,64,218881
11620,3.5e-05,172.31.40.0-255,66,1768,64,218881
11621,4.1e-05,172.217.194.0-255,2902,4670,64,218881
11622,4.4e-05,172.31.40.0-255,66,4736,64,218881
11623,7e-05,172.217.194.0-255,2902,7638,64,218881
11624,7.2e-05,172.31.40.0-255,66,7704,64,218881
11625,9e-05,172.217.194.0-255,2902,10606,64,218881
11626,9.3e-05,172.31.40.0-255,66,10672,64,218881
11627,0.000196,172.217.194.0-255,3456,14128,64,218881
11628,0.000201,172.31.40.0-255,66,14194,64,218881
11629,0.000406,172.217.194.0-255,1484,15678,64,218881
11630,0.00041,172.31.40.0-255,66,15744,64,218881
11631,0.000416,172.217.194.0-255,2902,18646,64,218881
11632,0.000419,172.31.40.0-255,66,18712,64,218881
11633,0.000482,172.217.194.0-255,5738,24450,64,218881
11634,0.000486,172.31.40.0-255,66,24516,64,218881
11635,0.000599,172.217.194.0-255,4320,28836,64,218881
11636,0.000603,172.31.40.0-255,66,28902,64,218881
11637,0.000621,172.217.194.0-255,2543,31445,64,218881
11638,0.000624,172.31.40.0-255,66,31511,64,218881
11639,0.00093,172.217.194.0-255,1484,32995,64,218881
11640,0.000936,172.31.40.0-255,66,33061,64,218881
11641,0.000945,172.217.194.0-255,2902,35963,64,218881
11642,0.000947,172.31.40.0-255,66,36029,64,218881
11643,0.00099,172.217.194.0-255,5738,41767,64,218881
11644,0.000993,172.31.40.0-255,66,41833,64,218881
11645,0.001115,172.217.194.0-255,4320,46153,64,218881
11646,0.00112,172.31.40.0-255,66,46219,64,218881
11647,0.001206,172.217.194.0-255,7156,53375,64,218881
11648,0.00121,172.31.40.0-255,66,53441,64,218881
11649,0.001225,172.217.194.0-255,5379,58820,64,218881
11650,0.001478,172.217.194.0-255,6797,65617,64,218881
11651,0.001654,172.217.194.0-255,647,66264,64,218881
11652,0.001778,172.217.194.0-255,1484,67748,64,218881
11653,0.001792,172.217.194.0-255,2902,70650,64,218881
11654,0.001842,172.217.194.0-255,1484,72134,64,218881
11655,0.001861,172.217.194.0-255,4320,76454,64,218881
11656,0.001973,172.217.194.0-255,4320,80774,64,218881
11657,0.001986,172.217.194.0-255,2902,83676,64,218881
11658,0.002132,172.217.194.0-255,7156,90832,64,218881
11659,0.002156,172.217.194.0-255,7156,97988,64,218881
11660,0.002435,172.217.194.0-255,2184,100172,64,218881
11661,0.006104,172.31.40.0-255,66,100238,64,218881
11662,0.008706,172.217.194.0-255,5738,105976,64,218881
11663,0.008714,172.31.40.0-255,66,106042,64,218881
11664,0.011321,172.217.194.0-255,5738,111780,64,218881
11665,0.011332,172.31.40.0-255,66,111846,64,218881
11666,0.013865,172.217.194.0-255,5738,117584,64,218881
11667,0.013876,172.31.40.0-255,66,117650,64,218881
11668,0.016443,172.217.194.0-255,5738,123388,64,218881
11669,0.016453,172.31.40.0-255,66,123454,64,218881
11670,0.019001,172.217.194.0-255,5738,129192,64,218881
11671,0.019009,172.31.40.0-255,66,129258,64,218881
11672,0.021563,172.217.194.0-255,5738,134996,64,218881
11673,0.021571,172.31.40.0-255,66,135062,64,218881
11674,0.02415,172.217.194.0-255,5738,140800,64,218881
11675,0.024158,172.31.40.0-255,66,140866,64,218881
11676,0.024294,172.31.40.0-255,167,141033,64,218881
11677,0.024321,172.31.40.0-255,1112,142145,64,218881
11678,0.024461,172.31.40.0-255,1514,143659,64,218881
11679,0.024463,172.31.40.0-255,1514,145173,64,218881
11680,0.024464,172.31.40.0-255,696,145869,64,218881
11681,0.025849,104.244.42.0-255,66,145935,64,218881
11682,0.02587,104.244.42.0-255,66,146001,64,218881
11683,0.026053,104.244.42.0-255,66,146067,64,218881
11684,0.026058,104.244.42.0-255,66,146133,64,218881
11685,0.026723,172.217.194.0-255,4320,150453,64,218881
11686,0.02673,172.31.40.0-255,66,150519,64,218881
11687,0.026752,172.217.194.0-255,1484,152003,64,218881
11688,0.02933,172.217.194.0-255,4320,156323,64,218881
11689,0.029336,172.31.40.0-255,66,156389,64,218881
11690,0.03191,172.217.194.0-255,5738,162127,64,218881
11691,0.031961,172.31.40.0-255,66,162193,64,218881
11692,0.034526,172.217.194.0-255,5738,167931,64,218881
11693,0.034533,172.31.40.0-255,66,167997,64,218881
11694,0.037099,172.217.194.0-255,4320,172317,64,218881
11695,0.037105,172.31.40.0-255,66,172383,64,218881
11696,0.037124,172.217.194.0-255,1484,173867,64,218881
11697,0.039674,172.217.194.0-255,4320,178187,64,218881
11698,0.03968,172.31.40.0-255,66,178253,64,218881
11699,0.042226,172.217.194.0-255,5738,183991,64,218881
11700,0.042275,172.31.40.0-255,66,184057,64,218881
11701,0.044833,172.217.194.0-255,5738,189795,64,218881
11702,0.044839,172.31.40.0-255,66,189861,64,218881
11703,0.047358,172.217.194.0-255,5738,195599,64,218881
11704,0.047364,172.31.40.0-255,66,195665,64,218881
11705,0.049921,172.217.194.0-255,5738,201403,64,218881
11706,0.04993,172.31.40.0-255,66,201469,64,218881
11707,0.052487,172.217.194.0-255,5738,207207,64,218881
11708,0.052493,172.31.40.0-255,66,207273,64,218881
11709,0.055071,172.217.194.0-255,5738,213011,64,218881
11710,0.055078,172.31.40.0-255,66,213077,64,218881
11711,0.057648,172.217.194.0-255,5738,218815,64,218881
11712,0.057655,172.31.40.0-255,66,218881,64,218881
11713,0.0,172.217.194.0-255,153,153,64,283713
11714,1.8e-05,172.31.40.0-255,66,219,64,283713
11715,2.5e-05,172.217.194.0-255,1484,1703,64,283713
11716,2.9e-05,172.31.40.0-255,66,1769,64,283713
11717,3.4e-05,172.217.194.0-255,2902,4671,64,283713
11718,3.8e-05,172.31.40.0-255,66,4737,64,283713
11719,4.5e-05,172.217.194.0-255,4320,9057,64,283713
11720,4.9e-05,172.31.40.0-255,66,9123,64,283713
11721,7.7e-05,172.217.194.0-255,4876,13999,64,283713
11722,8.1e-05,172.31.40.0-255,66,14065,64,283713
11723,0.000323,172.217.194.0-255,1484,15549,64,283713
11724,0.000329,172.31.40.0-255,66,15615,64,283713
11725,0.000335,172.217.194.0-255,2902,18517,64,283713
11726,0.000337,172.31.40.0-255,66,18583,64,283713
11727,0.000344,172.217.194.0-255,5738,24321,64,283713
11728,0.000348,172.31.40.0-255,66,24387,64,283713
11729,0.000395,172.217.194.0-255,6797,31184,64,283713
11730,0.000398,172.31.40.0-255,66,31250,64,283713
11731,0.000451,172.217.194.0-255,1484,32734,64,283713
11732,0.000454,172.31.40.0-255,66,32800,64,283713
11733,0.000459,172.217.194.0-255,2902,35702,64,283713
11734,0.000462,172.31.40.0-255,66,35768,64,283713
11735,0.000465,172.217.194.0-255,1484,37252,64,283713
11736,0.000467,172.31.40.0-255,66,37318,64,283713
11737,0.000487,172.217.194.0-255,4320,41638,64,283713
11738,0.00049,172.31.40.0-255,66,41704,64,283713
11739,0.000493,172.217.194.0-255,1484,43188,64,283713
11740,0.000495,172.31.40.0-255,66,43254,64,283713
11741,0.000502,172.217.194.0-255,5738,48992,64,283713
11742,0.000504,172.31.40.0-255,66,49058,64,283713
11743,0.000526,172.217.194.0-255,3961,53019,64,283713
11744,0.000529,172.31.40.0-255,66,53085,64,283713
11745,0.000547,172.217.194.0-255,5738,58823,64,283713
11746,0.00055,172.31.40.0-255,66,58889,64,283713
11747,0.000577,172.217.194.0-255,7050,65939,64,283713
11748,0.00058,172.31.40.0-255,66,66005,64,283713
11749,0.000583,172.217.194.0-255,118,66123,64,283713
11750,0.000624,172.217.194.0-255,382,66505,64,283713
11751,0.001104,172.217.194.0-255,1484,67989,64,283713
11752,0.001109,172.31.40.0-255,66,68055,64,283713
11753,0.001113,172.217.194.0-255,1484,69539,64,283713
11754,0.001126,172.217.194.0-255,1484,71023,64,283713
11755,0.001128,172.31.40.0-255,66,71089,64,283713
11756,0.001135,172.217.194.0-255,5738,76827,64,283713
11757,0.001138,172.31.40.0-255,66,76893,64,283713
11758,0.00117,172.217.194.0-255,7156,84049,64,283713
11759,0.001173,172.31.40.0-255,66,84115,64,283713
11760,0.001184,172.31.40.0-255,66,84181,64,283713
11761,0.001211,172.217.194.0-255,5738,89919,64,283713
11762,0.001214,172.31.40.0-255,66,89985,64,283713
11763,0.001218,172.217.194.0-255,2184,92169,64,283713
11764,0.00122,172.31.40.0-255,66,92235,64,283713
11765,0.001319,172.217.194.0-255,1484,93719,64,283713
11766,0.001323,172.217.194.0-255,1484,95203,64,283713
11767,0.001327,172.31.40.0-255,66,95269,64,283713
11768,0.001338,172.217.194.0-255,1484,96753,64,283713
11769,0.001344,172.217.194.0-255,5738,102491,64,283713
11770,0.001346,172.31.40.0-255,66,102557,64,283713
11771,0.00137,172.217.194.0-255,2902,105459,64,283713
11772,0.001372,172.31.40.0-255,66,105525,64,283713
11773,0.001388,172.217.194.0-255,7156,112681,64,283713
11774,0.00139,172.31.40.0-255,66,112747,64,283713
11775,0.001395,172.217.194.0-255,4320,117067,64,283713
11776,0.001397,172.31.40.0-255,66,117133,64,283713
11777,0.001421,172.217.194.0-255,4320,121453,64,283713
11778,0.001424,172.31.40.0-255,66,121519,64,283713
11779,0.001444,172.217.194.0-255,5020,126539,64,283713
11780,0.001447,172.31.40.0-255,66,126605,64,283713
11781,0.00154,172.217.194.0-255,1484,128089,64,283713
11782,0.001557,172.217.194.0-255,2902,130991,64,283713
11783,0.001562,172.217.194.0-255,4320,135311,64,283713
11784,0.001571,172.31.40.0-255,66,135377,64,283713
11785,0.001575,172.31.40.0-255,66,135443,64,283713
11786,0.001579,172.217.194.0-255,1484,136927,64,283713
11787,0.001585,172.217.194.0-255,5738,142665,64,283713
11788,0.001587,172.31.40.0-255,66,142731,64,283713
11789,0.001618,172.217.194.0-255,7156,149887,64,283713
11790,0.00162,172.31.40.0-255,66,149953,64,283713
11791,0.001634,172.31.40.0-255,66,150019,64,283713
11792,0.002001,172.217.194.0-255,1484,151503,64,283713
11793,0.002009,172.217.194.0-255,2902,154405,64,283713
11794,0.002013,172.31.40.0-255,66,154471,64,283713
11795,0.002018,172.217.194.0-255,2902,157373,64,283713
11796,0.00202,172.31.40.0-255,66,157439,64,283713
11797,0.002033,172.217.194.0-255,2902,160341,64,283713
11798,0.002036,172.31.40.0-255,66,160407,64,283713
11799,0.002039,172.217.194.0-255,1484,161891,64,283713
11800,0.002073,172.31.40.0-255,66,161957,64,283713
11801,0.002086,172.31.40.0-255,66,162023,64,283713
11802,0.002176,172.217.194.0-255,1484,163507,64,283713
11803,0.002182,172.217.194.0-255,2902,166409,64,283713
11804,0.002186,172.31.40.0-255,66,166475,64,283713
11805,0.002238,172.217.194.0-255,5738,172213,64,283713
11806,0.002242,172.31.40.0-255,66,172279,64,283713
11807,0.00225,172.217.194.0-255,7156,179435,64,283713
11808,0.002253,172.31.40.0-255,66,179501,64,283713
11809,0.002267,172.31.40.0-255,66,179567,64,283713
11810,0.00227,172.217.194.0-255,2184,181751,64,283713
11811,0.002273,172.31.40.0-255,66,181817,64,283713
11812,0.002371,172.217.194.0-255,1484,183301,64,283713
11813,0.002393,172.217.194.0-255,2902,186203,64,283713
11814,0.002397,172.31.40.0-255,66,186269,64,283713
11815,0.002401,172.217.194.0-255,1484,187753,64,283713
11816,0.002418,172.217.194.0-255,4320,192073,64,283713
11817,0.002421,172.31.40.0-255,66,192139,64,283713
11818,0.002424,172.217.194.0-255,1484,193623,64,283713
11819,0.002434,172.217.194.0-255,4320,197943,64,283713
11820,0.002436,172.31.40.0-255,66,198009,64,283713
11821,0.002455,172.217.194.0-255,4320,202329,64,283713
11822,0.002458,172.31.40.0-255,66,202395,64,283713
11823,0.002479,172.217.194.0-255,1484,203879,64,283713
11824,0.002514,172.31.40.0-255,66,203945,64,283713
11825,0.002517,172.217.194.0-255,1484,205429,64,283713
11826,0.002523,172.217.194.0-255,4320,209749,64,283713
11827,0.002525,172.31.40.0-255,66,209815,64,283713
11828,0.002527,172.217.194.0-255,1484,211299,64,283713
11829,0.00253,172.31.40.0-255,78,211377,64,283713
11830,0.002537,172.217.194.0-255,7156,218533,64,283713
11831,0.00254,172.31.40.0-255,66,218599,64,283713
11832,0.002555,172.31.40.0-255,66,218665,64,283713
11833,0.003093,172.217.194.0-255,1484,220149,64,283713
11834,0.003101,172.217.194.0-255,2902,223051,64,283713
11835,0.003106,172.31.40.0-255,66,223117,64,283713
11836,0.003113,172.217.194.0-255,5738,228855,64,283713
11837,0.003116,172.31.40.0-255,66,228921,64,283713
11838,0.003119,172.217.194.0-255,1484,230405,64,283713
11839,0.003148,172.31.40.0-255,66,230471,64,283713
11840,0.003171,172.217.194.0-255,1484,231955,64,283713
11841,0.003194,172.31.40.0-255,66,232021,64,283713
11842,0.003213,172.217.194.0-255,3602,235623,64,283713
11843,0.003216,172.31.40.0-255,66,235689,64,283713
11844,0.003226,172.217.194.0-255,1484,237173,64,283713
11845,0.003229,172.217.194.0-255,1484,238657,64,283713
11846,0.003231,172.31.40.0-255,66,238723,64,283713
11847,0.003242,172.217.194.0-255,1484,240207,64,283713
11848,0.003261,172.217.194.0-255,5738,245945,64,283713
11849,0.003264,172.31.40.0-255,66,246011,64,283713
11850,0.003267,172.217.194.0-255,1484,247495,64,283713
11851,0.003294,172.31.40.0-255,66,247561,64,283713
11852,0.003306,172.31.40.0-255,66,247627,64,283713
11853,0.003324,172.217.194.0-255,766,248393,64,283713
11854,0.003374,172.217.194.0-255,1484,249877,64,283713
11855,0.003376,172.31.40.0-255,66,249943,64,283713
11856,0.003394,172.217.194.0-255,2902,252845,64,283713
11857,0.003396,172.31.40.0-255,66,252911,64,283713
11858,0.003399,172.217.194.0-255,1484,254395,64,283713
11859,0.003422,172.217.194.0-255,4320,258715,64,283713
11860,0.003425,172.31.40.0-255,66,258781,64,283713
11861,0.003431,172.217.194.0-255,5738,264519,64,283713
11862,0.003433,172.31.40.0-255,66,264585,64,283713
11863,0.003452,172.217.194.0-255,7156,271741,64,283713
11864,0.003454,172.31.40.0-255,66,271807,64,283713
11865,0.003464,172.31.40.0-255,66,271873,64,283713
11866,0.003523,172.217.194.0-255,2184,274057,64,283713
11867,0.003525,172.31.40.0-255,66,274123,64,283713
11868,0.00434,172.217.194.0-255,1484,275607,64,283713
11869,0.004357,172.217.194.0-255,2902,278509,64,283713
11870,0.004359,172.31.40.0-255,66,278575,64,283713
11871,0.004363,172.217.194.0-255,1538,280113,64,283713
11872,0.004365,172.31.40.0-255,66,280179,64,283713
11873,0.004421,172.217.194.0-255,105,280284,64,283713
11874,0.012354,172.31.40.0-255,66,280350,64,283713
11875,0.012407,172.31.40.0-255,105,280455,64,283713
11876,0.01478,172.217.194.0-255,66,280521,64,283713
11877,0.056818,172.31.40.0-255,167,280688,64,283713
11878,0.056855,172.31.40.0-255,1108,281796,64,283713
11879,0.056918,172.31.40.0-255,1514,283310,64,283713
11880,0.05692,172.31.40.0-255,337,283647,64,283713
11881,0.058552,104.244.42.0-255,66,283713,64,283713
11882,0.0,172.217.194.0-255,297,297,64,169736
11883,1.6e-05,172.31.40.0-255,66,363,64,169736
11884,2.3e-05,172.217.194.0-255,1484,1847,64,169736
11885,2.8e-05,172.31.40.0-255,66,1913,64,169736
11886,3.5e-05,172.217.194.0-255,4320,6233,64,169736
11887,4.5e-05,172.31.40.0-255,66,6299,64,169736
11888,6.2e-05,172.217.194.0-255,1484,7783,64,169736
11889,6.4e-05,172.31.40.0-255,66,7849,64,169736
11890,9.3e-05,172.31.40.0-255,66,7915,64,169736
11891,0.000104,172.31.40.0-255,66,7981,64,169736
11892,0.000143,172.217.194.0-255,5738,13719,64,169736
11893,0.000146,172.31.40.0-255,66,13785,64,169736
11894,0.000149,172.217.194.0-255,1125,14910,64,169736
11895,0.00015,172.31.40.0-255,66,14976,64,169736
11896,0.000462,172.217.194.0-255,1484,16460,64,169736
11897,0.000467,172.31.40.0-255,66,16526,64,169736
11898,0.000474,172.217.194.0-255,2902,19428,64,169736
11899,0.000477,172.31.40.0-255,66,19494,64,169736
11900,0.000488,172.217.194.0-255,4320,23814,64,169736
11901,0.00049,172.31.40.0-255,66,23880,64,169736
11902,0.000516,172.217.194.0-255,1484,25364,64,169736
11903,0.000519,172.31.40.0-255,66,25430,64,169736
11904,0.000535,172.31.40.0-255,66,25496,64,169736
11905,0.000548,172.31.40.0-255,66,25562,64,169736
11906,0.000582,172.217.194.0-255,7049,32611,64,169736
11907,0.000591,172.31.40.0-255,66,32677,64,169736
11908,0.000594,172.217.194.0-255,119,32796,64,169736
11909,0.000596,172.31.40.0-255,66,32862,64,169736
11910,0.000684,172.217.194.0-255,1484,34346,64,169736
11911,0.000689,172.217.194.0-255,1484,35830,64,169736
11912,0.000692,172.31.40.0-255,66,35896,64,169736
11913,0.000711,172.217.194.0-255,1484,37380,64,169736
11914,0.000718,172.217.194.0-255,5738,43118,64,169736
11915,0.00072,172.31.40.0-255,66,43184,64,169736
11916,0.000749,172.217.194.0-255,1484,44668,64,169736
11917,0.000782,172.31.40.0-255,66,44734,64,169736
11918,0.000799,172.31.40.0-255,66,44800,64,169736
11919,0.000802,172.217.194.0-255,381,45181,64,169736
11920,0.001033,172.217.194.0-255,1484,46665,64,169736
11921,0.001037,172.31.40.0-255,66,46731,64,169736
11922,0.001042,172.217.194.0-255,2902,49633,64,169736
11923,0.001045,172.31.40.0-255,66,49699,64,169736
11924,0.001051,172.217.194.0-255,5738,55437,64,169736
11925,0.001061,172.31.40.0-255,66,55503,64,169736
11926,0.001066,172.217.194.0-255,2902,58405,64,169736
11927,0.001068,172.31.40.0-255,66,58471,64,169736
11928,0.001103,172.217.194.0-255,5738,64209,64,169736
11929,0.001106,172.31.40.0-255,66,64275,64,169736
11930,0.001151,172.31.40.0-255,66,64341,64,169736
11931,0.001578,172.217.194.0-255,1484,65825,64,169736
11932,0.001582,172.217.194.0-255,1484,67309,64,169736
11933,0.001585,172.31.40.0-255,66,67375,64,169736
11934,0.001618,172.217.194.0-255,1484,68859,64,169736
11935,0.001625,172.217.194.0-255,5738,74597,64,169736
11936,0.001627,172.31.40.0-255,66,74663,64,169736
11937,0.001638,172.31.40.0-255,66,74729,64,169736
11938,0.001675,172.217.194.0-255,5738,80467,64,169736
11939,0.001678,172.31.40.0-255,66,80533,64,169736
11940,0.001717,172.31.40.0-255,66,80599,64,169736
11941,0.001756,172.31.40.0-255,66,80665,64,169736
11942,0.001799,172.31.40.0-255,66,80731,64,169736
11943,0.001825,172.217.194.0-255,7156,87887,64,169736
11944,0.001828,172.31.40.0-255,66,87953,64,169736
11945,0.001834,172.217.194.0-255,5020,92973,64,169736
11946,0.001836,172.31.40.0-255,66,93039,64,169736
11947,0.001863,172.31.40.0-255,66,93105,64,169736
11948,0.001869,172.217.194.0-255,5020,98125,64,169736
11949,0.001871,172.31.40.0-255,66,98191,64,169736
11950,0.00191,172.31.40.0-255,66,98257,64,169736
11951,0.001954,172.31.40.0-255,66,98323,64,169736
11952,0.001968,172.31.40.0-255,66,98389,64,169736
11953,0.002023,172.217.194.0-255,1484,99873,64,169736
11954,0.002029,172.217.194.0-255,2902,102775,64,169736
11955,0.002032,172.31.40.0-255,66,102841,64,169736
11956,0.002053,172.217.194.0-255,5738,108579,64,169736
11957,0.002056,172.31.40.0-255,66,108645,64,169736
11958,0.002068,172.217.194.0-255,1484,110129,64,169736
11959,0.002098,172.31.40.0-255,66,110195,64,169736
11960,0.002104,172.217.194.0-255,5738,115933,64,169736
11961,0.002107,172.31.40.0-255,66,115999,64,169736
11962,0.002144,172.217.194.0-255,5020,121019,64,169736
11963,0.002149,172.31.40.0-255,66,121085,64,169736
11964,0.002244,172.217.194.0-255,1484,122569,64,169736
11965,0.00226,172.217.194.0-255,2902,125471,64,169736
11966,0.002264,172.31.40.0-255,66,125537,64,169736
11967,0.002297,172.217.194.0-255,5738,131275,64,169736
11968,0.002301,172.31.40.0-255,66,131341,64,169736
11969,0.002307,172.217.194.0-255,5738,137079,64,169736
11970,0.00231,172.31.40.0-255,66,137145,64,169736
11971,0.00233,172.217.194.0-255,7156,144301,64,169736
11972,0.002334,172.31.40.0-255,66,144367,64,169736
11973,0.002345,172.31.40.0-255,66,144433,64,169736
11974,0.00237,172.217.194.0-255,2184,146617,64,169736
11975,0.002372,172.31.40.0-255,66,146683,64,169736
11976,0.002375,172.217.194.0-255,1484,148167,64,169736
11977,0.002385,172.217.194.0-255,2902,151069,64,169736
11978,0.002387,172.31.40.0-255,66,151135,64,169736
11979,0.002393,172.217.194.0-255,5738,156873,64,169736
11980,0.002396,172.31.40.0-255,66,156939,64,169736
11981,0.002425,172.217.194.0-255,4320,161259,64,169736
11982,0.002429,172.31.40.0-255,66,161325,64,169736
11983,0.002469,172.31.40.0-255,66,161391,64,169736
11984,0.002482,172.31.40.0-255,66,161457,64,169736
11985,0.002532,172.31.40.0-255,66,161523,64,169736
11986,0.002571,172.31.40.0-255,66,161589,64,169736
11987,0.002589,172.31.40.0-255,66,161655,64,169736
11988,0.002594,172.217.194.0-255,3315,164970,64,169736
11989,0.002597,172.31.40.0-255,66,165036,64,169736
11990,0.002599,172.217.194.0-255,105,165141,64,169736
11991,0.021995,172.31.40.0-255,66,165207,64,169736
11992,0.022069,172.31.40.0-255,105,165312,64,169736
11993,0.024614,172.217.194.0-255,66,165378,64,169736
11994,0.050606,172.31.40.0-255,172,165550,64,169736
11995,0.050643,172.31.40.0-255,1112,166662,64,169736
11996,0.050706,172.31.40.0-255,1514,168176,64,169736
11997,0.05073,172.31.40.0-255,1296,169472,64,169736
11998,0.052112,104.244.42.0-255,66,169538,64,169736
11999,0.052195,104.244.42.0-255,66,169604,64,169736
12000,0.05229,104.244.42.0-255,66,169670,64,169736
12001,0.052332,104.244.42.0-255,66,169736,64,169736
12002,0.0,74.125.68.0-255,152,152,64,258520
12003,2.3e-05,172.31.40.0-255,66,218,64,258520
12004,3.1e-05,74.125.68.0-255,1484,1702,64,258520
12005,3.5e-05,172.31.40.0-255,66,1768,64,258520
12006,4.1e-05,74.125.68.0-255,2902,4670,64,258520
12007,4.5e-05,172.31.40.0-255,66,4736,64,258520
12008,5.3e-05,74.125.68.0-255,5738,10474,64,258520
12009,5.6e-05,172.31.40.0-255,66,10540,64,258520
12010,6.2e-05,74.125.68.0-255,3528,14068,64,258520
12011,6.5e-05,172.31.40.0-255,66,14134,64,258520
12012,0.000234,74.125.68.0-255,1484,15618,64,258520
12013,0.000241,172.31.40.0-255,66,15684,64,258520
12014,0.000247,74.125.68.0-255,2902,18586,64,258520
12015,0.000249,172.31.40.0-255,66,18652,64,258520
12016,0.000264,74.125.68.0-255,2902,21554,64,258520
12017,0.000266,172.31.40.0-255,66,21620,64,258520
12018,0.000288,74.125.68.0-255,2902,24522,64,258520
12019,0.000291,172.31.40.0-255,66,24588,64,258520
12020,0.000297,74.125.68.0-255,4320,28908,64,258520
12021,0.0003,172.31.40.0-255,66,28974,64,258520
12022,0.000327,74.125.68.0-255,2543,31517,64,258520
12023,0.00033,172.31.40.0-255,66,31583,64,258520
12024,0.000449,74.125.68.0-255,1484,33067,64,258520
12025,0.000454,172.31.40.0-255,66,33133,64,258520
12026,0.000483,74.125.68.0-255,2902,36035,64,258520
12027,0.000486,172.31.40.0-255,66,36101,64,258520
12028,0.000491,74.125.68.0-255,2902,39003,64,258520
12029,0.000493,172.31.40.0-255,66,39069,64,258520
12030,0.000499,74.125.68.0-255,4320,43389,64,258520
12031,0.000502,172.31.40.0-255,66,43455,64,258520
12032,0.000545,74.125.68.0-255,4320,47775,64,258520
12033,0.000549,172.31.40.0-255,66,47841,64,258520
12034,0.000571,74.125.68.0-255,5379,53220,64,258520
12035,0.000575,172.31.40.0-255,66,53286,64,258520
12036,0.000599,74.125.68.0-255,1484,54770,64,258520
12037,0.000627,172.31.40.0-255,66,54836,64,258520
12038,0.000646,74.125.68.0-255,2855,57691,64,258520
12039,0.000649,172.31.40.0-255,66,57757,64,258520
12040,0.000667,74.125.68.0-255,109,57866,64,258520
12041,0.000697,74.125.68.0-255,331,58197,64,258520
12042,0.000913,74.125.68.0-255,1484,59681,64,258520
12043,0.000919,172.31.40.0-255,66,59747,64,258520
12044,0.000926,74.125.68.0-255,2902,62649,64,258520
12045,0.000928,172.31.40.0-255,66,62715,64,258520
12046,0.000957,74.125.68.0-255,4320,67035,64,258520
12047,0.000959,172.31.40.0-255,66,67101,64,258520
12048,0.000964,74.125.68.0-255,2902,70003,64,258520
12049,0.000967,172.31.40.0-255,66,70069,64,258520
12050,0.001002,74.125.68.0-255,2902,72971,64,258520
12051,0.001005,172.31.40.0-255,66,73037,64,258520
12052,0.001018,172.31.40.0-255,66,73103,64,258520
12053,0.001077,172.31.40.0-255,66,73169,64,258520
12054,0.001188,74.125.68.0-255,1484,74653,64,258520
12055,0.001206,74.125.68.0-255,2902,77555,64,258520
12056,0.00121,172.31.40.0-255,66,77621,64,258520
12057,0.001234,74.125.68.0-255,5738,83359,64,258520
12058,0.001236,172.31.40.0-255,66,83425,64,258520
12059,0.00126,74.125.68.0-255,4320,87745,64,258520
12060,0.001262,172.31.40.0-255,66,87811,64,258520
12061,0.001281,74.125.68.0-255,4320,92131,64,258520
12062,0.001283,172.31.40.0-255,66,92197,64,258520
12063,0.001313,74.125.68.0-255,7156,99353,64,258520
12064,0.001317,172.31.40.0-255,66,99419,64,258520
12065,0.001321,74.125.68.0-255,2902,102321,64,258520
12066,0.001324,172.31.40.0-255,66,102387,64,258520
12067,0.001337,74.125.68.0-255,4320,106707,64,258520
12068,0.00134,172.31.40.0-255,66,106773,64,258520
12069,0.001363,74.125.68.0-255,766,107539,64,258520
12070,0.001884,172.31.40.0-255,66,107605,64,258520
12071,0.003644,74.125.68.0-255,4320,111925,64,258520
12072,0.003652,172.31.40.0-255,66,111991,64,258520
12073,0.004182,74.125.68.0-255,1484,113475,64,258520
12074,0.005969,74.125.68.0-255,4320,117795,64,258520
12075,0.005974,172.31.40.0-255,66,117861,64,258520
12076,0.008287,74.125.68.0-255,5738,123599,64,258520
12077,0.008295,172.31.40.0-255,66,123665,64,258520
12078,0.010621,74.125.68.0-255,5738,129403,64,258520
12079,0.010631,172.31.40.0-255,66,129469,64,258520
12080,0.012966,74.125.68.0-255,5738,135207,64,258520
12081,0.01298,172.31.40.0-255,66,135273,64,258520
12082,0.015323,74.125.68.0-255,5738,141011,64,258520
12083,0.015336,172.31.40.0-255,66,141077,64,258520
12084,0.017665,74.125.68.0-255,5738,146815,64,258520
12085,0.017674,172.31.40.0-255,66,146881,64,258520
12086,0.019994,74.125.68.0-255,5738,152619,64,258520
12087,0.020004,172.31.40.0-255,66,152685,64,258520
12088,0.02234,74.125.68.0-255,5738,158423,64,258520
12089,0.02235,172.31.40.0-255,66,158489,64,258520
12090,0.024679,74.125.68.0-255,5738,164227,64,258520
12091,0.024687,172.31.40.0-255,66,164293,64,258520
12092,0.027009,74.125.68.0-255,5738,170031,64,258520
12093,0.02702,172.31.40.0-255,66,170097,64,258520
12094,0.02934,74.125.68.0-255,5738,175835,64,258520
12095,0.029347,172.31.40.0-255,66,175901,64,258520
12096,0.030589,172.31.40.0-255,172,176073,64,258520
12097,0.030628,172.31.40.0-255,1112,177185,64,258520
12098,0.030686,172.31.40.0-255,1514,178699,64,258520
12099,0.030688,172.31.40.0-255,1514,180213,64,258520
12100,0.030689,172.31.40.0-255,1514,181727,64,258520
12101,0.03069,172.31.40.0-255,1077,182804,64,258520
12102,0.031667,74.125.68.0-255,5738,188542,64,258520
12103,0.031677,172.31.40.0-255,66,188608,64,258520
12104,0.032143,104.244.42.0-255,66,188674,64,258520
12105,0.032186,104.244.42.0-255,66,188740,64,258520
12106,0.03228,104.244.42.0-255,66,188806,64,258520
12107,0.032284,104.244.42.0-255,66,188872,64,258520
12108,0.033995,74.125.68.0-255,5738,194610,64,258520
12109,0.034001,172.31.40.0-255,66,194676,64,258520
12110,0.036318,74.125.68.0-255,5738,200414,64,258520
12111,0.036325,172.31.40.0-255,66,200480,64,258520
12112,0.038642,74.125.68.0-255,5738,206218,64,258520
12113,0.038655,172.31.40.0-255,66,206284,64,258520
12114,0.040973,74.125.68.0-255,5738,212022,64,258520
12115,0.04098,172.31.40.0-255,66,212088,64,258520
12116,0.043289,74.125.68.0-255,5738,217826,64,258520
12117,0.0433,172.31.40.0-255,66,217892,64,258520
12118,0.045616,74.125.68.0-255,5738,223630,64,258520
12119,0.04563,172.31.40.0-255,66,223696,64,258520
12120,0.048002,74.125.68.0-255,5738,229434,64,258520
12121,0.048025,172.31.40.0-255,66,229500,64,258520
12122,0.050357,74.125.68.0-255,5738,235238,64,258520
12123,0.050374,172.31.40.0-255,66,235304,64,258520
12124,0.052712,74.125.68.0-255,5738,241042,64,258520
12125,0.052728,172.31.40.0-255,66,241108,64,258520
12126,0.055073,74.125.68.0-255,5738,246846,64,258520
12127,0.055093,172.31.40.0-255,66,246912,64,258520
12128,0.057484,74.125.68.0-255,5738,252650,64,258520
12129,0.057503,172.31.40.0-255,66,252716,64,258520
12130,0.059845,74.125.68.0-255,5738,258454,64,258520
12131,0.059864,172.31.40.0-255,66,258520,64,258520
12132,0.0,172.31.40.0-255,105,105,64,459
12133,0.000334,172.31.40.0-255,90,195,64,459
12134,0.000345,172.31.40.0-255,66,261,64,459
12135,0.002332,74.125.24.0-255,66,327,64,459
12136,0.002352,74.125.24.0-255,66,393,64,459
12137,0.002367,172.31.40.0-255,66,459,64,459
12138,0.0,74.125.24.0-255,153,153,64,294756
12139,2.5e-05,172.31.40.0-255,66,219,64,294756
12140,3.2e-05,74.125.24.0-255,1484,1703,64,294756
12141,3.6e-05,172.31.40.0-255,66,1769,64,294756
12142,4.2e-05,74.125.24.0-255,2902,4671,64,294756
12143,4.5e-05,172.31.40.0-255,66,4737,64,294756
12144,6.1e-05,74.125.24.0-255,7156,11893,64,294756
12145,6.5e-05,172.31.40.0-255,66,11959,64,294756
12146,8.8e-05,74.125.24.0-255,7156,19115,64,294756
12147,9.1e-05,172.31.40.0-255,66,19181,64,294756
12148,0.000107,74.125.24.0-255,582,19763,64,294756
12149,0.000115,172.31.40.0-255,66,19829,64,294756
12150,0.000121,74.125.24.0-255,4320,24149,64,294756
12151,0.000123,172.31.40.0-255,66,24215,64,294756
12152,0.000174,74.125.24.0-255,6797,31012,64,294756
12153,0.000178,172.31.40.0-255,66,31078,64,294756
12154,0.000204,74.125.24.0-255,1484,32562,64,294756
12155,0.000206,172.31.40.0-255,66,32628,64,294756
12156,0.000211,74.125.24.0-255,2902,35530,64,294756
12157,0.000214,172.31.40.0-255,66,35596,64,294756
12158,0.00025,74.125.24.0-255,5738,41334,64,294756
12159,0.000253,172.31.40.0-255,66,41400,64,294756
12160,0.000256,74.125.24.0-255,1484,42884,64,294756
12161,0.000258,172.31.40.0-255,66,42950,64,294756
12162,0.000301,172.31.40.0-255,66,43016,64,294756
12163,0.000314,172.31.40.0-255,66,43082,64,294756
12164,0.000343,74.125.24.0-255,4275,47357,64,294756
12165,0.000345,172.31.40.0-255,66,47423,64,294756
12166,0.000349,74.125.24.0-255,108,47531,64,294756
12167,0.000351,172.31.40.0-255,66,47597,64,294756
12168,0.00082,74.125.24.0-255,330,47927,64,294756
12169,0.00106,172.31.40.0-255,66,47993,64,294756
12170,0.00115,74.125.24.0-255,1484,49477,64,294756
12171,0.001157,74.125.24.0-255,1484,50961,64,294756
12172,0.00116,172.31.40.0-255,66,51027,64,294756
12173,0.001193,74.125.24.0-255,1484,52511,64,294756
12174,0.0012,74.125.24.0-255,5738,58249,64,294756
12175,0.001202,172.31.40.0-255,66,58315,64,294756
12176,0.001222,172.31.40.0-255,66,58381,64,294756
12177,0.001228,74.125.24.0-255,5738,64119,64,294756
12178,0.00123,172.31.40.0-255,66,64185,64,294756
12179,0.001264,74.125.24.0-255,5020,69205,64,294756
12180,0.001266,172.31.40.0-255,66,69271,64,294756
12181,0.001467,74.125.24.0-255,1484,70755,64,294756
12182,0.001472,74.125.24.0-255,1484,72239,64,294756
12183,0.001475,172.31.40.0-255,66,72305,64,294756
12184,0.001501,74.125.24.0-255,1484,73789,64,294756
12185,0.001508,74.125.24.0-255,5738,79527,64,294756
12186,0.001511,172.31.40.0-255,66,79593,64,294756
12187,0.001515,74.125.24.0-255,2902,82495,64,294756
12188,0.001517,172.31.40.0-255,66,82561,64,294756
12189,0.001561,172.31.40.0-255,66,82627,64,294756
12190,0.001568,74.125.24.0-255,5738,88365,64,294756
12191,0.00157,172.31.40.0-255,66,88431,64,294756
12192,0.001595,74.125.24.0-255,5020,93451,64,294756
12193,0.001599,172.31.40.0-255,66,93517,64,294756
12194,0.001635,74.125.24.0-255,1484,95001,64,294756
12195,0.001651,74.125.24.0-255,2902,97903,64,294756
12196,0.001653,172.31.40.0-255,66,97969,64,294756
12197,0.001659,74.125.24.0-255,4320,102289,64,294756
12198,0.001661,172.31.40.0-255,66,102355,64,294756
12199,0.001683,74.125.24.0-255,1484,103839,64,294756
12200,0.001712,74.125.24.0-255,7156,110995,64,294756
12201,0.001714,172.31.40.0-255,66,111061,64,294756
12202,0.001722,74.125.24.0-255,7156,118217,64,294756
12203,0.001725,172.31.40.0-255,66,118283,64,294756
12204,0.001746,74.125.24.0-255,1484,119767,64,294756
12205,0.001765,74.125.24.0-255,2902,122669,64,294756
12206,0.001767,172.31.40.0-255,66,122735,64,294756
12207,0.001793,74.125.24.0-255,5020,127755,64,294756
12208,0.001796,172.31.40.0-255,66,127821,64,294756
12209,0.002254,74.125.24.0-255,1484,129305,64,294756
12210,0.002263,74.125.24.0-255,2902,132207,64,294756
12211,0.002268,172.31.40.0-255,66,132273,64,294756
12212,0.002276,74.125.24.0-255,5738,138011,64,294756
12213,0.002279,172.31.40.0-255,66,138077,64,294756
12214,0.002293,74.125.24.0-255,7156,145233,64,294756
12215,0.002296,172.31.40.0-255,66,145299,64,294756
12216,0.002324,74.125.24.0-255,5738,151037,64,294756
12217,0.002327,172.31.40.0-255,66,151103,64,294756
12218,0.002341,172.31.40.0-255,66,151169,64,294756
12219,0.004641,74.125.24.0-255,5738,156907,64,294756
12220,0.004647,172.31.40.0-255,66,156973,64,294756
12221,0.007013,74.125.24.0-255,5738,162711,64,294756
12222,0.007019,172.31.40.0-255,66,162777,64,294756
12223,0.009345,74.125.24.0-255,5738,168515,64,294756
12224,0.009353,172.31.40.0-255,66,168581,64,294756
12225,0.011691,74.125.24.0-255,5738,174319,64,294756
12226,0.011705,172.31.40.0-255,66,174385,64,294756
12227,0.014031,74.125.24.0-255,5738,180123,64,294756
12228,0.014043,172.31.40.0-255,66,180189,64,294756
12229,0.016384,74.125.24.0-255,5738,185927,64,294756
12230,0.016393,172.31.40.0-255,66,185993,64,294756
12231,0.018723,74.125.24.0-255,5738,191731,64,294756
12232,0.018736,172.31.40.0-255,66,191797,64,294756
12233,0.021099,74.125.24.0-255,5738,197535,64,294756
12234,0.021112,172.31.40.0-255,66,197601,64,294756
12235,0.023427,74.125.24.0-255,5738,203339,64,294756
12236,0.023435,172.31.40.0-255,66,203405,64,294756
12237,0.02579,74.125.24.0-255,5738,209143,64,294756
12238,0.025811,172.31.40.0-255,66,209209,64,294756
12239,0.02815,74.125.24.0-255,5738,214947,64,294756
12240,0.028192,172.31.40.0-255,66,215013,64,294756
12241,0.030515,74.125.24.0-255,5738,220751,64,294756
12242,0.030533,172.31.40.0-255,66,220817,64,294756
12243,0.032871,74.125.24.0-255,5738,226555,64,294756
12244,0.03289,172.31.40.0-255,66,226621,64,294756
12245,0.035247,74.125.24.0-255,5738,232359,64,294756
12246,0.035262,172.31.40.0-255,66,232425,64,294756
12247,0.037594,74.125.24.0-255,5738,238163,64,294756
12248,0.037612,172.31.40.0-255,66,238229,64,294756
12249,0.039949,74.125.24.0-255,5738,243967,64,294756
12250,0.039967,172.31.40.0-255,66,244033,64,294756
12251,0.042284,74.125.24.0-255,5738,249771,64,294756
12252,0.042296,172.31.40.0-255,66,249837,64,294756
12253,0.043076,172.31.40.0-255,171,250008,64,294756
12254,0.043112,172.31.40.0-255,1132,251140,64,294756
12255,0.043173,172.31.40.0-255,1514,252654,64,294756
12256,0.043176,172.31.40.0-255,1276,253930,64,294756
12257,0.044644,74.125.24.0-255,5738,259668,64,294756
12258,0.044654,172.31.40.0-255,66,259734,64,294756
12259,0.044663,104.244.42.0-255,66,259800,64,294756
12260,0.044668,104.244.42.0-255,66,259866,64,294756
12261,0.044714,104.244.42.0-255,66,259932,64,294756
12262,0.047,74.125.24.0-255,5738,265670,64,294756
12263,0.047016,172.31.40.0-255,66,265736,64,294756
12264,0.04936,74.125.24.0-255,5738,271474,64,294756
12265,0.049374,172.31.40.0-255,66,271540,64,294756
12266,0.051721,74.125.24.0-255,5738,277278,64,294756
12267,0.051737,172.31.40.0-255,66,277344,64,294756
12268,0.054111,74.125.24.0-255,5738,283082,64,294756
12269,0.05413,172.31.40.0-255,66,283148,64,294756
12270,0.056442,74.125.24.0-255,5738,288886,64,294756
12271,0.056453,172.31.40.0-255,66,288952,64,294756
12272,0.058801,74.125.24.0-255,5738,294690,64,294756
12273,0.058808,172.31.40.0-255,66,294756,64,294756
12274,0.0,172.217.194.0-255,153,153,64,111809
12275,1.5e-05,172.31.40.0-255,66,219,64,111809
12276,2.2e-05,172.217.194.0-255,1484,1703,64,111809
12277,2.6e-05,172.31.40.0-255,66,1769,64,111809
12278,3.2e-05,172.217.194.0-255,2902,4671,64,111809
12279,4.6e-05,172.31.40.0-255,66,4737,64,111809
12280,9.5e-05,172.217.194.0-255,4320,9057,64,111809
12281,9.8e-05,172.31.40.0-255,66,9123,64,111809
12282,0.000127,172.217.194.0-255,2902,12025,64,111809
12283,0.000129,172.31.40.0-255,66,12091,64,111809
12284,0.000298,172.31.40.0-255,66,12157,64,111809
12285,0.000553,172.31.40.0-255,66,12223,64,111809
12286,0.001006,172.217.194.0-255,5379,17602,64,111809
12287,0.001013,172.31.40.0-255,66,17668,64,111809
12288,0.001133,172.217.194.0-255,5738,23406,64,111809
12289,0.001137,172.31.40.0-255,66,23472,64,111809
12290,0.001269,172.217.194.0-255,7156,30628,64,111809
12291,0.001273,172.31.40.0-255,66,30694,64,111809
12292,0.001302,172.217.194.0-255,5379,36073,64,111809
12293,0.001304,172.31.40.0-255,66,36139,64,111809
12294,0.001585,172.217.194.0-255,5738,41877,64,111809
12295,0.001591,172.31.40.0-255,66,41943,64,111809
12296,0.001639,172.31.40.0-255,66,42009,64,111809
12297,0.002277,172.31.40.0-255,66,42075,64,111809
12298,0.002334,172.31.40.0-255,66,42141,64,111809
12299,0.003218,172.217.194.0-255,7156,49297,64,111809
12300,0.003221,172.31.40.0-255,66,49363,64,111809
12301,0.003285,172.217.194.0-255,5738,55101,64,111809
12302,0.004145,172.217.194.0-255,1484,56585,64,111809
12303,0.004197,172.217.194.0-255,4320,60905,64,111809
12304,0.004852,172.217.194.0-255,5738,66643,64,111809
12305,0.00558,172.217.194.0-255,2902,69545,64,111809
12306,0.005593,172.217.194.0-255,2902,72447,64,111809
12307,0.005603,172.217.194.0-255,1484,73931,64,111809
12308,0.005733,172.31.40.0-255,66,73997,64,111809
12309,0.005755,172.217.194.0-255,7156,81153,64,111809
12310,0.005817,172.31.40.0-255,66,81219,64,111809
12311,0.005826,172.217.194.0-255,1484,82703,64,111809
12312,0.006728,172.217.194.0-255,7156,89859,64,111809
12313,0.006733,172.31.40.0-255,66,89925,64,111809
12314,0.006795,172.31.40.0-255,66,89991,64,111809
12315,0.007358,172.217.194.0-255,7156,97147,64,111809
12316,0.007364,172.31.40.0-255,66,97213,64,111809
12317,0.007424,172.31.40.0-255,66,97279,64,111809
12318,0.008375,172.217.194.0-255,7156,104435,64,111809
12319,0.010045,172.217.194.0-255,3813,108248,64,111809
12320,0.013813,172.31.40.0-255,66,108314,64,111809
12321,0.014818,172.31.40.0-255,105,108419,64,111809
12322,0.01683,172.217.194.0-255,66,108485,64,111809
12323,0.043943,172.31.40.0-255,167,108652,64,111809
12324,0.043977,172.31.40.0-255,1108,109760,64,111809
12325,0.04404,172.31.40.0-255,1514,111274,64,111809
12326,0.044042,172.31.40.0-255,337,111611,64,111809
12327,0.045501,104.244.42.0-255,66,111677,64,111809
12328,0.045635,104.244.42.0-255,66,111743,64,111809
12329,0.045638,104.244.42.0-255,66,111809,64,111809
12330,0.0,172.217.26.0-255,147,147,64,274312
12331,2e-05,172.31.40.0-255,66,213,64,274312
12332,2.7e-05,172.217.26.0-255,1484,1697,64,274312
12333,3.2e-05,172.31.40.0-255,66,1763,64,274312
12334,3.8e-05,172.217.26.0-255,2902,4665,64,274312
12335,4.2e-05,172.31.40.0-255,66,4731,64,274312
12336,4.9e-05,172.217.26.0-255,7156,11887,64,274312
12337,5.3e-05,172.31.40.0-255,66,11953,64,274312
12338,5.8e-05,172.217.26.0-255,3402,15355,64,274312
12339,6e-05,172.31.40.0-255,66,15421,64,274312
12340,6.6e-05,172.217.26.0-255,4320,19741,64,274312
12341,6.9e-05,172.31.40.0-255,66,19807,64,274312
12342,8.2e-05,172.31.40.0-255,66,19873,64,274312
12343,8.5e-05,172.217.26.0-255,1125,20998,64,274312
12344,8.7e-05,172.31.40.0-255,66,21064,64,274312
12345,0.000143,172.217.26.0-255,1484,22548,64,274312
12346,0.000146,172.31.40.0-255,66,22614,64,274312
12347,0.000151,172.217.26.0-255,2902,25516,64,274312
12348,0.000153,172.31.40.0-255,66,25582,64,274312
12349,0.000174,172.217.26.0-255,5738,31320,64,274312
12350,0.000177,172.31.40.0-255,66,31386,64,274312
12351,0.000195,172.217.26.0-255,6797,38183,64,274312
12352,0.000197,172.31.40.0-255,66,38249,64,274312
12353,0.000284,172.217.26.0-255,1484,39733,64,274312
12354,0.000287,172.31.40.0-255,66,39799,64,274312
12355,0.000291,172.217.26.0-255,1484,41283,64,274312
12356,0.000293,172.31.40.0-255,66,41349,64,274312
12357,0.000312,172.217.26.0-255,1484,42833,64,274312
12358,0.000314,172.31.40.0-255,66,42899,64,274312
12359,0.00032,172.217.26.0-255,5738,48637,64,274312
12360,0.000323,172.31.40.0-255,66,48703,64,274312
12361,0.000363,172.217.26.0-255,7123,55826,64,274312
12362,0.000366,172.31.40.0-255,66,55892,64,274312
12363,0.000527,172.31.40.0-255,101,55993,64,274312
12364,0.000805,172.217.26.0-255,120,56113,64,274312
12365,0.001082,172.217.26.0-255,1484,57597,64,274312
12366,0.001087,172.31.40.0-255,66,57663,64,274312
12367,0.001092,172.217.26.0-255,2902,60565,64,274312
12368,0.001094,172.31.40.0-255,66,60631,64,274312
12369,0.001115,172.217.26.0-255,5738,66369,64,274312
12370,0.001117,172.31.40.0-255,66,66435,64,274312
12371,0.001134,172.217.26.0-255,2902,69337,64,274312
12372,0.001137,172.31.40.0-255,66,69403,64,274312
12373,0.001163,172.31.40.0-255,66,69469,64,274312
12374,0.001176,172.31.40.0-255,66,69535,64,274312
12375,0.001211,172.217.26.0-255,1484,71019,64,274312
12376,0.001215,172.217.26.0-255,1484,72503,64,274312
12377,0.001217,172.31.40.0-255,66,72569,64,274312
12378,0.001237,172.217.26.0-255,1484,74053,64,274312
12379,0.001244,172.217.26.0-255,5738,79791,64,274312
12380,0.001246,172.31.40.0-255,66,79857,64,274312
12381,0.001253,172.217.26.0-255,5738,85595,64,274312
12382,0.001255,172.31.40.0-255,66,85661,64,274312
12383,0.00127,172.217.26.0-255,807,86468,64,274312
12384,0.001491,172.217.26.0-255,1484,87952,64,274312
12385,0.001494,172.31.40.0-255,66,88018,64,274312
12386,0.001499,172.217.26.0-255,2902,90920,64,274312
12387,0.001501,172.31.40.0-255,66,90986,64,274312
12388,0.001505,172.217.26.0-255,2902,93888,64,274312
12389,0.001507,172.31.40.0-255,66,93954,64,274312
12390,0.001511,172.217.26.0-255,2902,96856,64,274312
12391,0.001512,172.31.40.0-255,66,96922,64,274312
12392,0.001547,172.217.26.0-255,1484,98406,64,274312
12393,0.001558,172.31.40.0-255,66,98472,64,274312
12394,0.001563,172.217.26.0-255,5738,104210,64,274312
12395,0.001565,172.31.40.0-255,66,104276,64,274312
12396,0.00159,172.31.40.0-255,66,104342,64,274312
12397,0.002472,172.217.26.0-255,66,104408,64,274312
12398,0.00363,172.217.26.0-255,5738,110146,64,274312
12399,0.003634,172.31.40.0-255,66,110212,64,274312
12400,0.005627,172.217.26.0-255,5738,115950,64,274312
12401,0.005634,172.31.40.0-255,66,116016,64,274312
12402,0.007624,172.217.26.0-255,5738,121754,64,274312
12403,0.00763,172.31.40.0-255,66,121820,64,274312
12404,0.009617,172.217.26.0-255,5738,127558,64,274312
12405,0.009624,172.31.40.0-255,66,127624,64,274312
12406,0.011622,172.217.26.0-255,5738,133362,64,274312
12407,0.01163,172.31.40.0-255,66,133428,64,274312
12408,0.013623,172.217.26.0-255,4320,137748,64,274312
12409,0.013629,172.31.40.0-255,66,137814,64,274312
12410,0.013649,172.217.26.0-255,1484,139298,64,274312
12411,0.015622,172.217.26.0-255,4320,143618,64,274312
12412,0.01563,172.31.40.0-255,66,143684,64,274312
12413,0.017633,172.217.26.0-255,5738,149422,64,274312
12414,0.017641,172.31.40.0-255,66,149488,64,274312
12415,0.01963,172.217.26.0-255,5738,155226,64,274312
12416,0.019638,172.31.40.0-255,66,155292,64,274312
12417,0.021626,172.217.26.0-255,4320,159612,64,274312
12418,0.021632,172.31.40.0-255,66,159678,64,274312
12419,0.02165,172.217.26.0-255,1484,161162,64,274312
12420,0.02362,172.217.26.0-255,4320,165482,64,274312
12421,0.023627,172.31.40.0-255,66,165548,64,274312
12422,0.025608,172.217.26.0-255,5738,171286,64,274312
12423,0.025614,172.31.40.0-255,66,171352,64,274312
12424,0.026664,172.31.40.0-255,172,171524,64,274312
12425,0.026688,172.31.40.0-255,1111,172635,64,274312
12426,0.026736,172.31.40.0-255,1514,174149,64,274312
12427,0.026737,172.31.40.0-255,1297,175446,64,274312
12428,0.027609,172.217.26.0-255,5738,181184,64,274312
12429,0.027616,172.31.40.0-255,66,181250,64,274312
12430,0.028183,104.244.42.0-255,66,181316,64,274312
12431,0.028219,104.244.42.0-255,66,181382,64,274312
12432,0.02828,104.244.42.0-255,66,181448,64,274312
12433,0.029602,172.217.26.0-255,5738,187186,64,274312
12434,0.029607,172.31.40.0-255,66,187252,64,274312
12435,0.031599,172.217.26.0-255,5738,192990,64,274312
12436,0.031606,172.31.40.0-255,66,193056,64,274312
12437,0.033637,172.217.26.0-255,5738,198794,64,274312
12438,0.033644,172.31.40.0-255,66,198860,64,274312
12439,0.035646,172.217.26.0-255,5738,204598,64,274312
12440,0.035653,172.31.40.0-255,66,204664,64,274312
12441,0.037658,172.217.26.0-255,5738,210402,64,274312
12442,0.037664,172.31.40.0-255,66,210468,64,274312
12443,0.039648,172.217.26.0-255,5738,216206,64,274312
12444,0.039656,172.31.40.0-255,66,216272,64,274312
12445,0.04167,172.217.26.0-255,5738,222010,64,274312
12446,0.041677,172.31.40.0-255,66,222076,64,274312
12447,0.043691,172.217.26.0-255,5738,227814,64,274312
12448,0.043697,172.31.40.0-255,66,227880,64,274312
12449,0.045681,172.217.26.0-255,5738,233618,64,274312
12450,0.045687,172.31.40.0-255,66,233684,64,274312
12451,0.047679,172.217.26.0-255,5738,239422,64,274312
12452,0.047685,172.31.40.0-255,66,239488,64,274312
12453,0.049671,172.217.26.0-255,5738,245226,64,274312
12454,0.049678,172.31.40.0-255,66,245292,64,274312
12455,0.051667,172.217.26.0-255,5738,251030,64,274312
12456,0.051672,172.31.40.0-255,66,251096,64,274312
12457,0.053659,172.217.26.0-255,5738,256834,64,274312
12458,0.053665,172.31.40.0-255,66,256900,64,274312
12459,0.055658,172.217.26.0-255,5738,262638,64,274312
12460,0.055665,172.31.40.0-255,66,262704,64,274312
12461,0.057659,172.217.26.0-255,5738,268442,64,274312
12462,0.057666,172.31.40.0-255,66,268508,64,274312
12463,0.05965,172.217.26.0-255,5738,274246,64,274312
12464,0.05966,172.31.40.0-255,66,274312,64,274312
12465,0.0,172.217.194.0-255,146,146,64,238576
12466,2.1e-05,172.31.40.0-255,66,212,64,238576
12467,2.8e-05,172.217.194.0-255,1484,1696,64,238576
12468,3.2e-05,172.31.40.0-255,66,1762,64,238576
12469,3.7e-05,172.217.194.0-255,2902,4664,64,238576
12470,4.7e-05,172.31.40.0-255,66,4730,64,238576
12471,5.1e-05,172.217.194.0-255,2902,7632,64,238576
12472,5.4e-05,172.31.40.0-255,66,7698,64,238576
12473,5.9e-05,172.217.194.0-255,4320,12018,64,238576
12474,6.1e-05,172.31.40.0-255,66,12084,64,238576
12475,8.6e-05,172.217.194.0-255,2902,14986,64,238576
12476,8.9e-05,172.31.40.0-255,66,15052,64,238576
12477,0.000115,172.217.194.0-255,6256,21308,64,238576
12478,0.000117,172.31.40.0-255,66,21374,64,238576
12479,0.000123,172.217.194.0-255,7156,28530,64,238576
12480,0.000125,172.31.40.0-255,66,28596,64,238576
12481,0.000154,172.217.194.0-255,1484,30080,64,238576
12482,0.000156,172.31.40.0-255,66,30146,64,238576
12483,0.000177,172.217.194.0-255,1125,31271,64,238576
12484,0.000179,172.31.40.0-255,66,31337,64,238576
12485,0.000315,172.217.194.0-255,1484,32821,64,238576
12486,0.000319,172.31.40.0-255,66,32887,64,238576
12487,0.000323,172.217.194.0-255,1484,34371,64,238576
12488,0.000325,172.31.40.0-255,66,34437,64,238576
12489,0.000345,172.217.194.0-255,1484,35921,64,238576
12490,0.000348,172.31.40.0-255,66,35987,64,238576
12491,0.000358,172.217.194.0-255,5738,41725,64,238576
12492,0.00036,172.31.40.0-255,66,41791,64,238576
12493,0.000365,172.217.194.0-255,5738,47529,64,238576
12494,0.000367,172.31.40.0-255,66,47595,64,238576
12495,0.000419,172.31.40.0-255,66,47661,64,238576
12496,0.000454,172.217.194.0-255,2902,50563,64,238576
12497,0.000457,172.31.40.0-255,66,50629,64,238576
12498,0.000466,172.217.194.0-255,1415,52044,64,238576
12499,0.000468,172.31.40.0-255,66,52110,64,238576
12500,0.000651,172.217.194.0-255,364,52474,64,238576
12501,0.000655,172.31.40.0-255,66,52540,64,238576
12502,0.000693,172.217.194.0-255,1484,54024,64,238576
12503,0.000696,172.31.40.0-255,66,54090,64,238576
12504,0.000719,172.217.194.0-255,2902,56992,64,238576
12505,0.000729,172.217.194.0-255,1484,58476,64,238576
12506,0.000745,172.217.194.0-255,4320,62796,64,238576
12507,0.000757,172.31.40.0-255,66,62862,64,238576
12508,0.000782,172.217.194.0-255,6797,69659,64,238576
12509,0.000789,172.31.40.0-255,66,69725,64,238576
12510,0.000845,172.217.194.0-255,1484,71209,64,238576
12511,0.000862,172.217.194.0-255,2902,74111,64,238576
12512,0.000867,172.217.194.0-255,4320,78431,64,238576
12513,0.000872,172.31.40.0-255,66,78497,64,238576
12514,0.000881,172.217.194.0-255,1484,79981,64,238576
12515,0.000909,172.217.194.0-255,2902,82883,64,238576
12516,0.000928,172.217.194.0-255,3961,86844,64,238576
12517,0.000933,172.31.40.0-255,66,86910,64,238576
12518,0.001959,172.217.194.0-255,1484,88394,64,238576
12519,0.001966,172.31.40.0-255,66,88460,64,238576
12520,0.001976,172.217.194.0-255,2902,91362,64,238576
12521,0.001979,172.31.40.0-255,66,91428,64,238576
12522,0.001988,172.217.194.0-255,2902,94330,64,238576
12523,0.00199,172.31.40.0-255,66,94396,64,238576
12524,0.002014,172.217.194.0-255,2902,97298,64,238576
12525,0.002017,172.217.194.0-255,1484,98782,64,238576
12526,0.002078,172.217.194.0-255,2902,101684,64,238576
12527,0.002118,172.217.194.0-255,4320,106004,64,238576
12528,0.002136,172.217.194.0-255,3602,109606,64,238576
12529,0.002139,172.217.194.0-255,1484,111090,64,238576
12530,0.002143,172.217.194.0-255,2902,113992,64,238576
12531,0.002163,172.217.194.0-255,5738,119730,64,238576
12532,0.002187,172.217.194.0-255,7156,126886,64,238576
12533,0.002213,172.217.194.0-255,5738,132624,64,238576
12534,0.002333,172.217.194.0-255,2184,134808,64,238576
12535,0.002407,172.217.194.0-255,2184,136992,64,238576
12536,0.002411,172.217.194.0-255,2902,139894,64,238576
12537,0.002414,172.217.194.0-255,1484,141378,64,238576
12538,0.002438,172.217.194.0-255,5738,147116,64,238576
12539,0.002452,172.217.194.0-255,5738,152854,64,238576
12540,0.002489,172.217.194.0-255,4320,157174,64,238576
12541,0.002521,172.217.194.0-255,4320,161494,64,238576
12542,0.002587,172.217.194.0-255,5738,167232,64,238576
12543,0.003475,172.31.40.0-255,66,167298,64,238576
12544,0.006108,172.217.194.0-255,5738,173036,64,238576
12545,0.006115,172.31.40.0-255,66,173102,64,238576
12546,0.008734,172.217.194.0-255,5738,178840,64,238576
12547,0.008741,172.31.40.0-255,66,178906,64,238576
12548,0.011361,172.217.194.0-255,5738,184644,64,238576
12549,0.011367,172.31.40.0-255,66,184710,64,238576
12550,0.013974,172.217.194.0-255,5738,190448,64,238576
12551,0.013986,172.31.40.0-255,66,190514,64,238576
12552,0.016626,172.217.194.0-255,5738,196252,64,238576
12553,0.016643,172.31.40.0-255,66,196318,64,238576
12554,0.019286,172.217.194.0-255,5738,202056,64,238576
12555,0.019305,172.31.40.0-255,66,202122,64,238576
12556,0.021912,172.217.194.0-255,5738,207860,64,238576
12557,0.02192,172.31.40.0-255,66,207926,64,238576
12558,0.024511,172.217.194.0-255,5738,213664,64,238576
12559,0.024521,172.31.40.0-255,66,213730,64,238576
12560,0.027127,172.217.194.0-255,5738,219468,64,238576
12561,0.027135,172.31.40.0-255,66,219534,64,238576
12562,0.029756,172.217.194.0-255,5738,225272,64,238576
12563,0.029764,172.31.40.0-255,66,225338,64,238576
12564,0.032401,172.217.194.0-255,5738,231076,64,238576
12565,0.032417,172.31.40.0-255,66,231142,64,238576
12566,0.035063,172.217.194.0-255,2905,234047,64,238576
12567,0.035082,172.31.40.0-255,66,234113,64,238576
12568,0.03532,172.31.40.0-255,105,234218,64,238576
12569,0.037909,172.217.194.0-255,66,234284,64,238576
12570,0.038549,172.31.40.0-255,172,234456,64,238576
12571,0.038581,172.31.40.0-255,1111,235567,64,238576
12572,0.038642,172.31.40.0-255,1514,237081,64,238576
12573,0.038644,172.31.40.0-255,1297,238378,64,238576
12574,0.040129,104.244.42.0-255,66,238444,64,238576
12575,0.040137,104.244.42.0-255,66,238510,64,238576
12576,0.040224,104.244.42.0-255,66,238576,64,238576
12577,0.0,172.217.194.0-255,152,152,64,180177
12578,2.4e-05,172.31.40.0-255,66,218,64,180177
12579,3.1e-05,172.217.194.0-255,1484,1702,64,180177
12580,3.6e-05,172.31.40.0-255,66,1768,64,180177
12581,5.3e-05,172.217.194.0-255,2902,4670,64,180177
12582,5.7e-05,172.31.40.0-255,66,4736,64,180177
12583,6.5e-05,172.217.194.0-255,7156,11892,64,180177
12584,6.8e-05,172.31.40.0-255,66,11958,64,180177
12585,8.6e-05,172.31.40.0-255,66,12024,64,180177
12586,0.000109,172.217.194.0-255,3961,15985,64,180177
12587,0.000112,172.31.40.0-255,66,16051,64,180177
12588,0.000154,172.217.194.0-255,1484,17535,64,180177
12589,0.000157,172.31.40.0-255,66,17601,64,180177
12590,0.000184,172.217.194.0-255,1484,19085,64,180177
12591,0.000187,172.31.40.0-255,66,19151,64,180177
12592,0.000192,172.217.194.0-255,4320,23471,64,180177
12593,0.000194,172.31.40.0-255,66,23537,64,180177
12594,0.000206,172.31.40.0-255,66,23603,64,180177
12595,0.000244,172.31.40.0-255,66,23669,64,180177
12596,0.000247,172.217.194.0-255,378,24047,64,180177
12597,0.000249,172.31.40.0-255,66,24113,64,180177
12598,0.000287,172.217.194.0-255,99,24212,64,180177
12599,0.00029,172.31.40.0-255,66,24278,64,180177
12600,0.000431,172.217.194.0-255,1484,25762,64,180177
12601,0.000435,172.31.40.0-255,66,25828,64,180177
12602,0.000441,172.217.194.0-255,2902,28730,64,180177
12603,0.000444,172.31.40.0-255,66,28796,64,180177
12604,0.000454,172.217.194.0-255,4320,33116,64,180177
12605,0.000457,172.31.40.0-255,66,33182,64,180177
12606,0.000491,172.217.194.0-255,1484,34666,64,180177
12607,0.000499,172.217.194.0-255,5738,40404,64,180177
12608,0.000501,172.31.40.0-255,66,40470,64,180177
12609,0.000515,172.31.40.0-255,66,40536,64,180177
12610,0.000518,172.217.194.0-255,1484,42020,64,180177
12611,0.000549,172.217.194.0-255,3602,45622,64,180177
12612,0.000551,172.31.40.0-255,66,45688,64,180177
12613,0.000555,172.217.194.0-255,1484,47172,64,180177
12614,0.000579,172.217.194.0-255,2902,50074,64,180177
12615,0.000581,172.31.40.0-255,66,50140,64,180177
12616,0.000585,172.217.194.0-255,1484,51624,64,180177
12617,0.000615,172.217.194.0-255,4320,55944,64,180177
12618,0.000618,172.31.40.0-255,66,56010,64,180177
12619,0.000632,172.31.40.0-255,66,56076,64,180177
12620,0.000648,172.31.40.0-255,66,56142,64,180177
12621,0.000704,172.217.194.0-255,2184,58326,64,180177
12622,0.000706,172.31.40.0-255,66,58392,64,180177
12623,0.000711,172.217.194.0-255,2902,61294,64,180177
12624,0.000714,172.31.40.0-255,66,61360,64,180177
12625,0.000746,172.217.194.0-255,4320,65680,64,180177
12626,0.000749,172.31.40.0-255,66,65746,64,180177
12627,0.000761,172.31.40.0-255,66,65812,64,180177
12628,0.000773,172.217.194.0-255,2902,68714,64,180177
12629,0.000776,172.31.40.0-255,66,68780,64,180177
12630,0.000817,172.31.40.0-255,66,68846,64,180177
12631,0.000822,172.217.194.0-255,2902,71748,64,180177
12632,0.000824,172.31.40.0-255,66,71814,64,180177
12633,0.000855,172.217.194.0-255,3602,75416,64,180177
12634,0.000858,172.31.40.0-255,66,75482,64,180177
12635,0.000866,172.217.194.0-255,7156,82638,64,180177
12636,0.000868,172.31.40.0-255,66,82704,64,180177
12637,0.000888,172.31.40.0-255,66,82770,64,180177
12638,0.000894,172.217.194.0-255,6438,89208,64,180177
12639,0.0009,172.31.40.0-255,66,89274,64,180177
12640,0.000935,172.217.194.0-255,1484,90758,64,180177
12641,0.00094,172.217.194.0-255,2902,93660,64,180177
12642,0.000942,172.31.40.0-255,66,93726,64,180177
12643,0.000949,172.217.194.0-255,5738,99464,64,180177
12644,0.000952,172.31.40.0-255,66,99530,64,180177
12645,0.00098,172.31.40.0-255,66,99596,64,180177
12646,0.001013,172.217.194.0-255,4320,103916,64,180177
12647,0.001016,172.31.40.0-255,66,103982,64,180177
12648,0.001027,172.31.40.0-255,66,104048,64,180177
12649,0.001031,172.217.194.0-255,2902,106950,64,180177
12650,0.001034,172.31.40.0-255,66,107016,64,180177
12651,0.001104,172.31.40.0-255,66,107082,64,180177
12652,0.001115,172.31.40.0-255,66,107148,64,180177
12653,0.001253,172.217.194.0-255,1484,108632,64,180177
12654,0.001258,172.217.194.0-255,2902,111534,64,180177
12655,0.001262,172.31.40.0-255,66,111600,64,180177
12656,0.001269,172.217.194.0-255,5738,117338,64,180177
12657,0.001271,172.31.40.0-255,66,117404,64,180177
12658,0.00131,172.31.40.0-255,66,117470,64,180177
12659,0.001322,172.31.40.0-255,66,117536,64,180177
12660,0.001346,172.217.194.0-255,766,118302,64,180177
12661,0.001453,172.217.194.0-255,1484,119786,64,180177
12662,0.001457,172.31.40.0-255,66,119852,64,180177
12663,0.00146,172.217.194.0-255,1484,121336,64,180177
12664,0.001482,172.217.194.0-255,1484,122820,64,180177
12665,0.001488,172.217.194.0-255,5738,128558,64,180177
12666,0.001524,172.217.194.0-255,1484,130042,64,180177
12667,0.001528,172.31.40.0-255,66,130108,64,180177
12668,0.001531,172.31.40.0-255,66,130174,64,180177
12669,0.001561,172.217.194.0-255,4320,134494,64,180177
12670,0.001563,172.31.40.0-255,66,134560,64,180177
12671,0.001577,172.31.40.0-255,66,134626,64,180177
12672,0.001583,172.217.194.0-255,5020,139646,64,180177
12673,0.001587,172.31.40.0-255,66,139712,64,180177
12674,0.001591,172.217.194.0-255,2902,142614,64,180177
12675,0.001594,172.31.40.0-255,66,142680,64,180177
12676,0.001628,172.217.194.0-255,4320,147000,64,180177
12677,0.001631,172.31.40.0-255,66,147066,64,180177
12678,0.001643,172.31.40.0-255,66,147132,64,180177
12679,0.001648,172.217.194.0-255,4320,151452,64,180177
12680,0.001651,172.31.40.0-255,66,151518,64,180177
12681,0.001691,172.217.194.0-255,5738,157256,64,180177
12682,0.001695,172.31.40.0-255,66,157322,64,180177
12683,0.001698,172.217.194.0-255,1484,158806,64,180177
12684,0.001738,172.31.40.0-255,66,158872,64,180177
12685,0.001745,172.217.194.0-255,5738,164610,64,180177
12686,0.001747,172.31.40.0-255,66,164676,64,180177
12687,0.001792,172.31.40.0-255,66,164742,64,180177
12688,0.001797,172.217.194.0-255,3602,168344,64,180177
12689,0.001799,172.31.40.0-255,66,168410,64,180177
12690,0.001803,172.217.194.0-255,2158,170568,64,180177
12691,0.001805,172.31.40.0-255,66,170634,64,180177
12692,0.00184,172.217.194.0-255,105,170739,64,180177
12693,0.004613,172.31.40.0-255,66,170805,64,180177
12694,0.004652,172.31.40.0-255,105,170910,64,180177
12695,0.00694,172.217.194.0-255,66,170976,64,180177
12696,0.050528,172.31.40.0-255,172,171148,64,180177
12697,0.050564,172.31.40.0-255,1112,172260,64,180177
12698,0.050632,172.31.40.0-255,1514,173774,64,180177
12699,0.050634,172.31.40.0-255,1514,175288,64,180177
12700,0.05064,172.31.40.0-255,1514,176802,64,180177
12701,0.050642,172.31.40.0-255,1514,178316,64,180177
12702,0.05066,172.31.40.0-255,1514,179830,64,180177
12703,0.050662,172.31.40.0-255,83,179913,64,180177
12704,0.052102,104.244.42.0-255,66,179979,64,180177
12705,0.052114,104.244.42.0-255,66,180045,64,180177
12706,0.052239,104.244.42.0-255,66,180111,64,180177
12707,0.052296,104.244.42.0-255,66,180177,64,180177
12708,0.0,172.217.194.0-255,288,288,64,232721
12709,2.5e-05,172.31.40.0-255,66,354,64,232721
12710,3.2e-05,172.217.194.0-255,1484,1838,64,232721
12711,3.6e-05,172.31.40.0-255,66,1904,64,232721
12712,4.3e-05,172.217.194.0-255,4320,6224,64,232721
12713,4.7e-05,172.31.40.0-255,66,6290,64,232721
12714,6.7e-05,172.31.40.0-255,66,6356,64,232721
12715,7.2e-05,172.217.194.0-255,2902,9258,64,232721
12716,7.4e-05,172.31.40.0-255,66,9324,64,232721
12717,0.000121,172.31.40.0-255,66,9390,64,232721
12718,0.000124,172.217.194.0-255,1484,10874,64,232721
12719,0.000126,172.31.40.0-255,66,10940,64,232721
12720,0.000131,172.217.194.0-255,2902,13842,64,232721
12721,0.000134,172.31.40.0-255,66,13908,64,232721
12722,0.000141,172.217.194.0-255,5738,19646,64,232721
12723,0.000143,172.31.40.0-255,66,19712,64,232721
12724,0.000196,172.217.194.0-255,6797,26509,64,232721
12725,0.000199,172.31.40.0-255,66,26575,64,232721
12726,0.000835,172.217.194.0-255,1484,28059,64,232721
12727,0.000841,172.31.40.0-255,66,28125,64,232721
12728,0.000848,172.217.194.0-255,2902,31027,64,232721
12729,0.00085,172.31.40.0-255,66,31093,64,232721
12730,0.000862,172.217.194.0-255,5738,36831,64,232721
12731,0.000864,172.31.40.0-255,66,36897,64,232721
12732,0.000903,172.31.40.0-255,66,36963,64,232721
12733,0.000936,172.217.194.0-255,3961,40924,64,232721
12734,0.000939,172.31.40.0-255,66,40990,64,232721
12735,0.000953,172.31.40.0-255,66,41056,64,232721
12736,0.000995,172.31.40.0-255,66,41122,64,232721
12737,0.001028,172.217.194.0-255,1484,42606,64,232721
12738,0.001046,172.217.194.0-255,2902,45508,64,232721
12739,0.001063,172.31.40.0-255,66,45574,64,232721
12740,0.00107,172.217.194.0-255,5738,51312,64,232721
12741,0.001076,172.31.40.0-255,66,51378,64,232721
12742,0.001107,172.217.194.0-255,6133,57511,64,232721
12743,0.001116,172.31.40.0-255,66,57577,64,232721
12744,0.00179,172.217.194.0-255,1484,59061,64,232721
12745,0.001801,172.217.194.0-255,2902,61963,64,232721
12746,0.001806,172.31.40.0-255,66,62029,64,232721
12747,0.001814,172.217.194.0-255,5738,67767,64,232721
12748,0.001816,172.31.40.0-255,66,67833,64,232721
12749,0.001848,172.217.194.0-255,1484,69317,64,232721
12750,0.001865,172.217.194.0-255,6074,75391,64,232721
12751,0.001867,172.31.40.0-255,66,75457,64,232721
12752,0.001896,172.217.194.0-255,7156,82613,64,232721
12753,0.001898,172.31.40.0-255,66,82679,64,232721
12754,0.001925,172.217.194.0-255,1484,84163,64,232721
12755,0.001932,172.217.194.0-255,4320,88483,64,232721
12756,0.001935,172.31.40.0-255,66,88549,64,232721
12757,0.001981,172.217.194.0-255,6438,94987,64,232721
12758,0.004863,172.31.40.0-255,66,95053,64,232721
12759,0.007238,172.217.194.0-255,5738,100791,64,232721
12760,0.007246,172.31.40.0-255,66,100857,64,232721
12761,0.009631,172.217.194.0-255,5738,106595,64,232721
12762,0.009638,172.31.40.0-255,66,106661,64,232721
12763,0.011998,172.217.194.0-255,5738,112399,64,232721
12764,0.012007,172.31.40.0-255,66,112465,64,232721
12765,0.014415,172.217.194.0-255,5738,118203,64,232721
12766,0.014424,172.31.40.0-255,66,118269,64,232721
12767,0.016799,172.217.194.0-255,5738,124007,64,232721
12768,0.016808,172.31.40.0-255,66,124073,64,232721
12769,0.019206,172.217.194.0-255,5738,129811,64,232721
12770,0.019218,172.31.40.0-255,66,129877,64,232721
12771,0.021592,172.217.194.0-255,5738,135615,64,232721
12772,0.021602,172.31.40.0-255,66,135681,64,232721
12773,0.024,172.217.194.0-255,5738,141419,64,232721
12774,0.024009,172.31.40.0-255,66,141485,64,232721
12775,0.026387,172.217.194.0-255,5738,147223,64,232721
12776,0.026395,172.31.40.0-255,66,147289,64,232721
12777,0.028233,172.31.40.0-255,172,147461,64,232721
12778,0.028265,172.31.40.0-255,1112,148573,64,232721
12779,0.028325,172.31.40.0-255,1514,150087,64,232721
12780,0.028327,172.31.40.0-255,1180,151267,64,232721
12781,0.028802,172.217.194.0-255,5738,157005,64,232721
12782,0.028809,172.31.40.0-255,66,157071,64,232721
12783,0.029796,104.244.42.0-255,66,157137,64,232721
12784,0.029804,104.244.42.0-255,66,157203,64,232721
12785,0.029909,104.244.42.0-255,66,157269,64,232721
12786,0.031164,172.217.194.0-255,5738,163007,64,232721
12787,0.03117,172.31.40.0-255,66,163073,64,232721
12788,0.033551,172.217.194.0-255,5738,168811,64,232721
12789,0.033558,172.31.40.0-255,66,168877,64,232721
12790,0.035923,172.217.194.0-255,5738,174615,64,232721
12791,0.035932,172.31.40.0-255,66,174681,64,232721
12792,0.038306,172.217.194.0-255,5738,180419,64,232721
12793,0.038313,172.31.40.0-255,66,180485,64,232721
12794,0.040711,172.217.194.0-255,5738,186223,64,232721
12795,0.040725,172.31.40.0-255,66,186289,64,232721
12796,0.043129,172.217.194.0-255,5738,192027,64,232721
12797,0.04314,172.31.40.0-255,66,192093,64,232721
12798,0.045529,172.217.194.0-255,5738,197831,64,232721
12799,0.045536,172.31.40.0-255,66,197897,64,232721
12800,0.047926,172.217.194.0-255,5738,203635,64,232721
12801,0.047932,172.31.40.0-255,66,203701,64,232721
12802,0.050292,172.217.194.0-255,5738,209439,64,232721
12803,0.0503,172.31.40.0-255,66,209505,64,232721
12804,0.052686,172.217.194.0-255,5738,215243,64,232721
12805,0.052693,172.31.40.0-255,66,215309,64,232721
12806,0.05506,172.217.194.0-255,5738,221047,64,232721
12807,0.055067,172.31.40.0-255,66,221113,64,232721
12808,0.057475,172.217.194.0-255,5738,226851,64,232721
12809,0.057482,172.31.40.0-255,66,226917,64,232721
12810,0.059886,172.217.194.0-255,5738,232655,64,232721
12811,0.059892,172.31.40.0-255,66,232721,64,232721
12812,0.0,172.217.194.0-255,152,152,64,178750
12813,1.4e-05,172.31.40.0-255,66,218,64,178750
12814,2.1e-05,172.217.194.0-255,1484,1702,64,178750
12815,2.5e-05,172.31.40.0-255,66,1768,64,178750
12816,3.8e-05,172.217.194.0-255,2902,4670,64,178750
12817,4.1e-05,172.31.40.0-255,66,4736,64,178750
12818,4.7e-05,172.217.194.0-255,2902,7638,64,178750
12819,5e-05,172.31.40.0-255,66,7704,64,178750
12820,7.7e-05,172.217.194.0-255,4320,12024,64,178750
12821,8.1e-05,172.31.40.0-255,66,12090,64,178750
12822,0.000127,172.217.194.0-255,2134,14224,64,178750
12823,0.00013,172.31.40.0-255,66,14290,64,178750
12824,0.000158,172.217.194.0-255,2902,17192,64,178750
12825,0.00016,172.31.40.0-255,66,17258,64,178750
12826,0.000204,172.217.194.0-255,7156,24414,64,178750
12827,0.000207,172.31.40.0-255,66,24480,64,178750
12828,0.000279,172.217.194.0-255,4320,28800,64,178750
12829,0.000284,172.31.40.0-255,66,28866,64,178750
12830,0.000316,172.217.194.0-255,6797,35663,64,178750
12831,0.000319,172.31.40.0-255,66,35729,64,178750
12832,0.00042,172.217.194.0-255,5738,41467,64,178750
12833,0.000424,172.31.40.0-255,66,41533,64,178750
12834,0.000467,172.31.40.0-255,66,41599,64,178750
12835,0.000672,172.217.194.0-255,7156,48755,64,178750
12836,0.000677,172.31.40.0-255,66,48821,64,178750
12837,0.000704,172.217.194.0-255,2184,51005,64,178750
12838,0.000709,172.31.40.0-255,66,51071,64,178750
12839,0.000751,172.217.194.0-255,709,51780,64,178750
12840,0.000755,172.31.40.0-255,66,51846,64,178750
12841,0.000793,172.31.40.0-255,66,51912,64,178750
12842,0.000921,172.217.194.0-255,7156,59068,64,178750
12843,0.000925,172.31.40.0-255,66,59134,64,178750
12844,0.000966,172.31.40.0-255,66,59200,64,178750
12845,0.001184,172.217.194.0-255,1484,60684,64,178750
12846,0.0012,172.217.194.0-255,1484,62168,64,178750
12847,0.001204,172.31.40.0-255,66,62234,64,178750
12848,0.001227,172.217.194.0-255,1484,63718,64,178750
12849,0.001246,172.217.194.0-255,4320,68038,64,178750
12850,0.001249,172.31.40.0-255,66,68104,64,178750
12851,0.001272,172.217.194.0-255,1484,69588,64,178750
12852,0.001321,172.31.40.0-255,66,69654,64,178750
12853,0.001468,172.217.194.0-255,7156,76810,64,178750
12854,0.001474,172.31.40.0-255,66,76876,64,178750
12855,0.001483,172.217.194.0-255,3602,80478,64,178750
12856,0.001489,172.31.40.0-255,66,80544,64,178750
12857,0.001609,172.31.40.0-255,66,80610,64,178750
12858,0.001734,172.217.194.0-255,2902,83512,64,178750
12859,0.001738,172.31.40.0-255,66,83578,64,178750
12860,0.001765,172.217.194.0-255,4320,87898,64,178750
12861,0.001768,172.31.40.0-255,66,87964,64,178750
12862,0.001831,172.217.194.0-255,5738,93702,64,178750
12863,0.001835,172.31.40.0-255,66,93768,64,178750
12864,0.001878,172.31.40.0-255,66,93834,64,178750
12865,0.002092,172.31.40.0-255,66,93900,64,178750
12866,0.002142,172.31.40.0-255,66,93966,64,178750
12867,0.002422,172.217.194.0-255,5738,99704,64,178750
12868,0.002427,172.31.40.0-255,66,99770,64,178750
12869,0.002477,172.31.40.0-255,66,99836,64,178750
12870,0.002858,172.31.40.0-255,66,99902,64,178750
12871,0.002908,172.31.40.0-255,66,99968,64,178750
12872,0.003252,172.31.40.0-255,66,100034,64,178750
12873,0.006701,172.31.40.0-255,66,100100,64,178750
12874,0.008974,172.217.194.0-255,5738,105838,64,178750
12875,0.008986,172.31.40.0-255,66,105904,64,178750
12876,0.011225,172.217.194.0-255,5738,111642,64,178750
12877,0.011232,172.31.40.0-255,66,111708,64,178750
12878,0.013489,172.217.194.0-255,5738,117446,64,178750
12879,0.013507,172.31.40.0-255,66,117512,64,178750
12880,0.015737,172.217.194.0-255,5738,123250,64,178750
12881,0.015754,172.31.40.0-255,66,123316,64,178750
12882,0.017991,172.217.194.0-255,5738,129054,64,178750
12883,0.018004,172.31.40.0-255,66,129120,64,178750
12884,0.020252,172.217.194.0-255,5738,134858,64,178750
12885,0.02026,172.31.40.0-255,66,134924,64,178750
12886,0.022505,172.217.194.0-255,5738,140662,64,178750
12887,0.022516,172.31.40.0-255,66,140728,64,178750
12888,0.024744,172.217.194.0-255,5738,146466,64,178750
12889,0.024753,172.31.40.0-255,66,146532,64,178750
12890,0.026981,172.217.194.0-255,5738,152270,64,178750
12891,0.026993,172.31.40.0-255,66,152336,64,178750
12892,0.029228,172.217.194.0-255,5738,158074,64,178750
12893,0.029236,172.31.40.0-255,66,158140,64,178750
12894,0.031458,172.217.194.0-255,5738,163878,64,178750
12895,0.031466,172.31.40.0-255,66,163944,64,178750
12896,0.033714,172.217.194.0-255,5738,169682,64,178750
12897,0.033731,172.31.40.0-255,66,169748,64,178750
12898,0.035978,172.217.194.0-255,4467,174215,64,178750
12899,0.035987,172.31.40.0-255,66,174281,64,178750
12900,0.036218,172.31.40.0-255,105,174386,64,178750
12901,0.038414,172.217.194.0-255,66,174452,64,178750
12902,0.051988,172.31.40.0-255,176,174628,64,178750
12903,0.052019,172.31.40.0-255,1113,175741,64,178750
12904,0.052077,172.31.40.0-255,1514,177255,64,178750
12905,0.052078,172.31.40.0-255,1297,178552,64,178750
12906,0.053537,104.244.42.0-255,66,178618,64,178750
12907,0.053548,104.244.42.0-255,66,178684,64,178750
12908,0.053629,104.244.42.0-255,66,178750,64,178750
12909,0.0,216.58.221.0-255,146,146,64,299378
12910,2.2e-05,172.31.40.0-255,66,212,64,299378
12911,2.9e-05,216.58.221.0-255,1484,1696,64,299378
12912,3.3e-05,172.31.40.0-255,66,1762,64,299378
12913,3.9e-05,216.58.221.0-255,2902,4664,64,299378
12914,4.2e-05,172.31.40.0-255,66,4730,64,299378
12915,5.1e-05,216.58.221.0-255,7156,11886,64,299378
12916,5.4e-05,172.31.40.0-255,66,11952,64,299378
12917,6.6e-05,172.31.40.0-255,66,12018,64,299378
12918,0.000103,172.31.40.0-255,66,12084,64,299378
12919,0.000119,216.58.221.0-255,2543,14627,64,299378
12920,0.000121,172.31.40.0-255,66,14693,64,299378
12921,0.000156,216.58.221.0-255,1484,16177,64,299378
12922,0.000159,172.31.40.0-255,66,16243,64,299378
12923,0.000162,216.58.221.0-255,1484,17727,64,299378
12924,0.000164,172.31.40.0-255,66,17793,64,299378
12925,0.000179,216.58.221.0-255,1484,19277,64,299378
12926,0.000181,172.31.40.0-255,66,19343,64,299378
12927,0.000188,216.58.221.0-255,5738,25081,64,299378
12928,0.000191,172.31.40.0-255,66,25147,64,299378
12929,0.000196,216.58.221.0-255,4320,29467,64,299378
12930,0.000198,172.31.40.0-255,66,29533,64,299378
12931,0.000237,216.58.221.0-255,2543,32076,64,299378
12932,0.00024,172.31.40.0-255,66,32142,64,299378
12933,0.000295,216.58.221.0-255,1484,33626,64,299378
12934,0.000299,172.31.40.0-255,66,33692,64,299378
12935,0.000304,216.58.221.0-255,2902,36594,64,299378
12936,0.000306,172.31.40.0-255,66,36660,64,299378
12937,0.000311,216.58.221.0-255,4320,40980,64,299378
12938,0.000314,172.31.40.0-255,66,41046,64,299378
12939,0.000331,216.58.221.0-255,1484,42530,64,299378
12940,0.000357,216.58.221.0-255,7094,49624,64,299378
12941,0.000501,172.31.40.0-255,66,49690,64,299378
12942,0.000861,216.58.221.0-255,137,49827,64,299378
12943,0.001005,216.58.221.0-255,1484,51311,64,299378
12944,0.00101,172.31.40.0-255,66,51377,64,299378
12945,0.001017,216.58.221.0-255,2902,54279,64,299378
12946,0.00102,216.58.221.0-255,1484,55763,64,299378
12947,0.001035,216.58.221.0-255,4320,60083,64,299378
12948,0.001045,172.31.40.0-255,66,60149,64,299378
12949,0.001055,216.58.221.0-255,2902,63051,64,299378
12950,0.001059,216.58.221.0-255,2902,65953,64,299378
12951,0.001078,172.31.40.0-255,66,66019,64,299378
12952,0.001108,216.58.221.0-255,3961,69980,64,299378
12953,0.001115,172.31.40.0-255,66,70046,64,299378
12954,0.001131,216.58.221.0-255,4320,74366,64,299378
12955,0.001143,172.31.40.0-255,66,74432,64,299378
12956,0.001173,172.31.40.0-255,66,74498,64,299378
12957,0.001565,216.58.221.0-255,1484,75982,64,299378
12958,0.001574,216.58.221.0-255,2902,78884,64,299378
12959,0.001578,172.31.40.0-255,66,78950,64,299378
12960,0.001583,216.58.221.0-255,1484,80434,64,299378
12961,0.001597,216.58.221.0-255,4320,84754,64,299378
12962,0.001626,216.58.221.0-255,5738,90492,64,299378
12963,0.00164,216.58.221.0-255,5738,96230,64,299378
12964,0.001645,216.58.221.0-255,2902,99132,64,299378
12965,0.001705,216.58.221.0-255,1484,100616,64,299378
12966,0.001725,216.58.221.0-255,2902,103518,64,299378
12967,0.001732,216.58.221.0-255,5738,109256,64,299378
12968,0.001755,216.58.221.0-255,2902,112158,64,299378
12969,0.001793,216.58.221.0-255,5738,117896,64,299378
12970,0.001827,216.58.221.0-255,5020,122916,64,299378
12971,0.001865,216.58.221.0-255,2902,125818,64,299378
12972,0.001878,216.58.221.0-255,2902,128720,64,299378
12973,0.001883,216.58.221.0-255,4320,133040,64,299378
12974,0.001899,216.58.221.0-255,2902,135942,64,299378
12975,0.001925,216.58.221.0-255,7156,143098,64,299378
12976,0.001952,216.58.221.0-255,7156,150254,64,299378
12977,0.00196,216.58.221.0-255,6438,156692,64,299378
12978,0.007244,172.31.40.0-255,66,156758,64,299378
12979,0.009194,216.58.221.0-255,5738,162496,64,299378
12980,0.009202,172.31.40.0-255,66,162562,64,299378
12981,0.01114,216.58.221.0-255,5738,168300,64,299378
12982,0.015544,172.31.40.0-255,66,168366,64,299378
12983,0.0175,216.58.221.0-255,5738,174104,64,299378
12984,0.017511,172.31.40.0-255,66,174170,64,299378
12985,0.01946,216.58.221.0-255,5738,179908,64,299378
12986,0.019467,172.31.40.0-255,66,179974,64,299378
12987,0.021409,216.58.221.0-255,5738,185712,64,299378
12988,0.021417,172.31.40.0-255,66,185778,64,299378
12989,0.023356,216.58.221.0-255,5738,191516,64,299378
12990,0.023362,172.31.40.0-255,66,191582,64,299378
12991,0.024004,172.31.40.0-255,167,191749,64,299378
12992,0.024037,172.31.40.0-255,1107,192856,64,299378
12993,0.024093,172.31.40.0-255,1514,194370,64,299378
12994,0.024094,172.31.40.0-255,338,194708,64,299378
12995,0.025321,216.58.221.0-255,5738,200446,64,299378
12996,0.025328,172.31.40.0-255,66,200512,64,299378
12997,0.025507,104.244.42.0-255,66,200578,64,299378
12998,0.025571,104.244.42.0-255,66,200644,64,299378
12999,0.025645,104.244.42.0-255,66,200710,64,299378
13000,0.027273,216.58.221.0-255,5738,206448,64,299378
13001,0.02728,172.31.40.0-255,66,206514,64,299378
13002,0.029235,216.58.221.0-255,5738,212252,64,299378
13003,0.029242,172.31.40.0-255,66,212318,64,299378
13004,0.031187,216.58.221.0-255,5738,218056,64,299378
13005,0.0312,172.31.40.0-255,66,218122,64,299378
13006,0.03315,216.58.221.0-255,5738,223860,64,299378
13007,0.033163,172.31.40.0-255,66,223926,64,299378
13008,0.035094,216.58.221.0-255,5738,229664,64,299378
13009,0.0351,172.31.40.0-255,66,229730,64,299378
13010,0.037037,216.58.221.0-255,5738,235468,64,299378
13011,0.037044,172.31.40.0-255,66,235534,64,299378
13012,0.038986,216.58.221.0-255,5738,241272,64,299378
13013,0.038992,172.31.40.0-255,66,241338,64,299378
13014,0.040934,216.58.221.0-255,5738,247076,64,299378
13015,0.04094,172.31.40.0-255,66,247142,64,299378
13016,0.042885,216.58.221.0-255,5738,252880,64,299378
13017,0.042893,172.31.40.0-255,66,252946,64,299378
13018,0.044837,216.58.221.0-255,5738,258684,64,299378
13019,0.044845,172.31.40.0-255,66,258750,64,299378
13020,0.046803,216.58.221.0-255,5738,264488,64,299378
13021,0.04681,172.31.40.0-255,66,264554,64,299378
13022,0.048744,216.58.221.0-255,5738,270292,64,299378
13023,0.048755,172.31.40.0-255,66,270358,64,299378
13024,0.050701,216.58.221.0-255,5738,276096,64,299378
13025,0.050707,172.31.40.0-255,66,276162,64,299378
13026,0.05265,216.58.221.0-255,5738,281900,64,299378
13027,0.052657,172.31.40.0-255,66,281966,64,299378
13028,0.054607,216.58.221.0-255,5738,287704,64,299378
13029,0.054613,172.31.40.0-255,66,287770,64,299378
13030,0.056572,216.58.221.0-255,5738,293508,64,299378
13031,0.056578,172.31.40.0-255,66,293574,64,299378
13032,0.058522,216.58.221.0-255,5738,299312,64,299378
13033,0.058529,172.31.40.0-255,66,299378,64,299378
13034,0.0,172.217.27.0-255,297,297,64,326624
13035,1.6e-05,172.31.40.0-255,66,363,64,326624
13036,2.3e-05,172.217.27.0-255,1484,1847,64,326624
13037,2.8e-05,172.31.40.0-255,66,1913,64,326624
13038,4.4e-05,172.217.27.0-255,4320,6233,64,326624
13039,4.6e-05,172.31.40.0-255,66,6299,64,326624
13040,5.3e-05,172.217.27.0-255,5738,12037,64,326624
13041,5.6e-05,172.31.40.0-255,66,12103,64,326624
13042,8.4e-05,172.217.27.0-255,1840,13943,64,326624
13043,8.6e-05,172.31.40.0-255,66,14009,64,326624
13044,0.000124,172.217.27.0-255,1484,15493,64,326624
13045,0.000127,172.31.40.0-255,66,15559,64,326624
13046,0.000146,172.217.27.0-255,2902,18461,64,326624
13047,0.000148,172.31.40.0-255,66,18527,64,326624
13048,0.000151,172.217.27.0-255,1484,20011,64,326624
13049,0.000153,172.31.40.0-255,66,20077,64,326624
13050,0.000177,172.217.27.0-255,4320,24397,64,326624
13051,0.000179,172.31.40.0-255,66,24463,64,326624
13052,0.000185,172.217.27.0-255,4320,28783,64,326624
13053,0.000187,172.31.40.0-255,66,28849,64,326624
13054,0.000226,172.217.27.0-255,2543,31392,64,326624
13055,0.000228,172.31.40.0-255,66,31458,64,326624
13056,0.000235,172.217.27.0-255,7156,38614,64,326624
13057,0.000238,172.31.40.0-255,66,38680,64,326624
13058,0.00025,172.31.40.0-255,66,38746,64,326624
13059,0.000379,172.217.27.0-255,1484,40230,64,326624
13060,0.000383,172.31.40.0-255,66,40296,64,326624
13061,0.000389,172.217.27.0-255,2902,43198,64,326624
13062,0.000392,172.31.40.0-255,66,43264,64,326624
13063,0.000441,172.217.27.0-255,4320,47584,64,326624
13064,0.000443,172.31.40.0-255,66,47650,64,326624
13065,0.000471,172.217.27.0-255,1484,49134,64,326624
13066,0.000479,172.217.27.0-255,7091,56225,64,326624
13067,0.000482,172.31.40.0-255,66,56291,64,326624
13068,0.000893,172.217.27.0-255,383,56674,64,326624
13069,0.001033,172.217.27.0-255,1484,58158,64,326624
13070,0.001038,172.31.40.0-255,66,58224,64,326624
13071,0.001076,172.217.27.0-255,2902,61126,64,326624
13072,0.001082,172.217.27.0-255,5738,66864,64,326624
13073,0.001084,172.217.27.0-255,1484,68348,64,326624
13074,0.001095,172.31.40.0-255,66,68414,64,326624
13075,0.001098,172.31.40.0-255,66,68480,64,326624
13076,0.001116,172.31.40.0-255,66,68546,64,326624
13077,0.001146,172.217.27.0-255,1125,69671,64,326624
13078,0.001158,172.31.40.0-255,66,69737,64,326624
13079,0.001161,172.217.27.0-255,1125,70862,64,326624
13080,0.001481,172.217.27.0-255,1484,72346,64,326624
13081,0.001486,172.31.40.0-255,66,72412,64,326624
13082,0.001492,172.217.27.0-255,2902,75314,64,326624
13083,0.001494,172.31.40.0-255,66,75380,64,326624
13084,0.0015,172.217.27.0-255,5738,81118,64,326624
13085,0.001507,172.31.40.0-255,66,81184,64,326624
13086,0.001513,172.217.27.0-255,4320,85504,64,326624
13087,0.001515,172.31.40.0-255,66,85570,64,326624
13088,0.001522,172.217.27.0-255,5738,91308,64,326624
13089,0.001524,172.31.40.0-255,66,91374,64,326624
13090,0.00157,172.31.40.0-255,66,91440,64,326624
13091,0.001579,172.217.27.0-255,5889,97329,64,326624
13092,0.001581,172.31.40.0-255,66,97395,64,326624
13093,0.001588,172.217.27.0-255,7156,104551,64,326624
13094,0.00159,172.31.40.0-255,66,104617,64,326624
13095,0.001601,172.31.40.0-255,66,104683,64,326624
13096,0.001634,172.217.27.0-255,7156,111839,64,326624
13097,0.001637,172.31.40.0-255,66,111905,64,326624
13098,0.001644,172.217.27.0-255,6438,118343,64,326624
13099,0.001646,172.31.40.0-255,66,118409,64,326624
13100,0.003291,172.217.27.0-255,5738,124147,64,326624
13101,0.003298,172.31.40.0-255,66,124213,64,326624
13102,0.00499,172.217.27.0-255,5738,129951,64,326624
13103,0.004997,172.31.40.0-255,66,130017,64,326624
13104,0.006623,172.217.27.0-255,2902,132919,64,326624
13105,0.006627,172.31.40.0-255,66,132985,64,326624
13106,0.006653,172.217.27.0-255,2902,135887,64,326624
13107,0.006655,172.31.40.0-255,66,135953,64,326624
13108,0.008256,172.217.27.0-255,2902,138855,64,326624
13109,0.008262,172.31.40.0-255,66,138921,64,326624
13110,0.008296,172.217.27.0-255,2902,141823,64,326624
13111,0.008299,172.31.40.0-255,66,141889,64,326624
13112,0.009902,172.217.27.0-255,2902,144791,64,326624
13113,0.009909,172.31.40.0-255,66,144857,64,326624
13114,0.009937,172.217.27.0-255,2902,147759,64,326624
13115,0.009939,172.31.40.0-255,66,147825,64,326624
13116,0.01155,172.217.27.0-255,2902,150727,64,326624
13117,0.011558,172.31.40.0-255,66,150793,64,326624
13118,0.011593,172.217.27.0-255,2902,153695,64,326624
13119,0.011596,172.31.40.0-255,66,153761,64,326624
13120,0.013198,172.217.27.0-255,2902,156663,64,326624
13121,0.013206,172.31.40.0-255,66,156729,64,326624
13122,0.013234,172.217.27.0-255,2902,159631,64,326624
13123,0.013238,172.31.40.0-255,66,159697,64,326624
13124,0.014857,172.217.27.0-255,2902,162599,64,326624
13125,0.014864,172.31.40.0-255,66,162665,64,326624
13126,0.014894,172.217.27.0-255,2902,165567,64,326624
13127,0.014897,172.31.40.0-255,66,165633,64,326624
13128,0.0165,172.217.27.0-255,2902,168535,64,326624
13129,0.016509,172.31.40.0-255,66,168601,64,326624
13130,0.016538,172.217.27.0-255,2902,171503,64,326624
13131,0.016541,172.31.40.0-255,66,171569,64,326624
13132,0.018152,172.217.27.0-255,2902,174471,64,326624
13133,0.018159,172.31.40.0-255,66,174537,64,326624
13134,0.01818,172.217.27.0-255,2902,177439,64,326624
13135,0.018183,172.31.40.0-255,66,177505,64,326624
13136,0.019827,172.217.27.0-255,5738,183243,64,326624
13137,0.019834,172.31.40.0-255,66,183309,64,326624
13138,0.021476,172.217.27.0-255,5738,189047,64,326624
13139,0.021484,172.31.40.0-255,66,189113,64,326624
13140,0.02318,172.217.27.0-255,5738,194851,64,326624
13141,0.023187,172.31.40.0-255,66,194917,64,326624
13142,0.024825,172.217.27.0-255,5738,200655,64,326624
13143,0.024833,172.31.40.0-255,66,200721,64,326624
13144,0.026486,172.217.27.0-255,5738,206459,64,326624
13145,0.026493,172.31.40.0-255,66,206525,64,326624
13146,0.02815,172.217.27.0-255,5738,212263,64,326624
13147,0.028163,172.31.40.0-255,66,212329,64,326624
13148,0.029805,172.217.27.0-255,5738,218067,64,326624
13149,0.029815,172.31.40.0-255,66,218133,64,326624
13150,0.031469,172.217.27.0-255,5738,223871,64,326624
13151,0.031479,172.31.40.0-255,66,223937,64,326624
13152,0.03313,172.217.27.0-255,5738,229675,64,326624
13153,0.033143,172.31.40.0-255,66,229741,64,326624
13154,0.034798,172.217.27.0-255,4320,234061,64,326624
13155,0.03481,172.31.40.0-255,66,234127,64,326624
13156,0.034842,172.217.27.0-255,1484,235611,64,326624
13157,0.036449,172.217.27.0-255,4320,239931,64,326624
13158,0.036457,172.31.40.0-255,66,239997,64,326624
13159,0.03812,172.217.27.0-255,5738,245735,64,326624
13160,0.038133,172.31.40.0-255,66,245801,64,326624
13161,0.039769,172.217.27.0-255,1484,247285,64,326624
13162,0.039798,172.217.27.0-255,4320,251605,64,326624
13163,0.039804,172.31.40.0-255,66,251671,64,326624
13164,0.041448,172.217.27.0-255,5738,257409,64,326624
13165,0.041456,172.31.40.0-255,66,257475,64,326624
13166,0.043108,172.217.27.0-255,5738,263213,64,326624
13167,0.043116,172.31.40.0-255,66,263279,64,326624
13168,0.043944,172.31.40.0-255,205,263484,64,326624
13169,0.043977,172.31.40.0-255,1112,264596,64,326624
13170,0.044036,172.31.40.0-255,1514,266110,64,326624
13171,0.044038,172.31.40.0-255,1514,267624,64,326624
13172,0.044039,172.31.40.0-255,696,268320,64,326624
13173,0.044781,172.217.27.0-255,5738,274058,64,326624
13174,0.044788,172.31.40.0-255,66,274124,64,326624
13175,0.045482,104.244.42.0-255,66,274190,64,326624
13176,0.045529,104.244.42.0-255,66,274256,64,326624
13177,0.045623,104.244.42.0-255,66,274322,64,326624
13178,0.045627,104.244.42.0-255,66,274388,64,326624
13179,0.046431,172.217.27.0-255,5738,280126,64,326624
13180,0.04644,172.31.40.0-255,66,280192,64,326624
13181,0.048094,172.217.27.0-255,5738,285930,64,326624
13182,0.048104,172.31.40.0-255,66,285996,64,326624
13183,0.049775,172.217.27.0-255,5738,291734,64,326624
13184,0.049789,172.31.40.0-255,66,291800,64,326624
13185,0.051466,172.217.27.0-255,5738,297538,64,326624
13186,0.051477,172.31.40.0-255,66,297604,64,326624
13187,0.053131,172.217.27.0-255,5738,303342,64,326624
13188,0.053143,172.31.40.0-255,66,303408,64,326624
13189,0.054789,172.217.27.0-255,5738,309146,64,326624
13190,0.054799,172.31.40.0-255,66,309212,64,326624
13191,0.05645,172.217.27.0-255,5738,314950,64,326624
13192,0.05646,172.31.40.0-255,66,315016,64,326624
13193,0.058114,172.217.27.0-255,5738,320754,64,326624
13194,0.058126,172.31.40.0-255,66,320820,64,326624
13195,0.059772,172.217.27.0-255,5738,326558,64,326624
13196,0.059786,172.31.40.0-255,66,326624,64,326624
13197,0.0,172.217.27.0-255,146,146,64,306978
13198,1.8e-05,172.31.40.0-255,66,212,64,306978
13199,2.5e-05,172.217.27.0-255,1484,1696,64,306978
13200,3e-05,172.31.40.0-255,66,1762,64,306978
13201,3.5e-05,172.217.27.0-255,2902,4664,64,306978
13202,3.9e-05,172.31.40.0-255,66,4730,64,306978
13203,6.5e-05,172.217.27.0-255,7156,11886,64,306978
13204,7e-05,172.31.40.0-255,66,11952,64,306978
13205,7.3e-05,172.217.27.0-255,2128,14080,64,306978
13206,7.6e-05,172.31.40.0-255,66,14146,64,306978
13207,8e-05,172.217.27.0-255,2902,17048,64,306978
13208,8.3e-05,172.31.40.0-255,66,17114,64,306978
13209,0.000142,172.217.27.0-255,7156,24270,64,306978
13210,0.000147,172.31.40.0-255,66,24336,64,306978
13211,0.000154,172.217.27.0-255,6797,31133,64,306978
13212,0.000157,172.31.40.0-255,66,31199,64,306978
13213,0.000197,172.217.27.0-255,1484,32683,64,306978
13214,0.000201,172.31.40.0-255,66,32749,64,306978
13215,0.000203,172.217.27.0-255,1484,34233,64,306978
13216,0.000205,172.31.40.0-255,66,34299,64,306978
13217,0.000218,172.217.27.0-255,2902,37201,64,306978
13218,0.00022,172.31.40.0-255,66,37267,64,306978
13219,0.000247,172.217.27.0-255,5738,43005,64,306978
13220,0.00025,172.31.40.0-255,66,43071,64,306978
13221,0.000271,172.217.27.0-255,5379,48450,64,306978
13222,0.000274,172.31.40.0-255,66,48516,64,306978
13223,0.000369,172.217.27.0-255,1484,50000,64,306978
13224,0.000373,172.31.40.0-255,66,50066,64,306978
13225,0.000378,172.217.27.0-255,2902,52968,64,306978
13226,0.000381,172.31.40.0-255,66,53034,64,306978
13227,0.00041,172.217.27.0-255,5738,58772,64,306978
13228,0.000413,172.31.40.0-255,66,58838,64,306978
13229,0.000417,172.217.27.0-255,4320,63158,64,306978
13230,0.00042,172.31.40.0-255,66,63224,64,306978
13231,0.000463,172.217.27.0-255,2872,66096,64,306978
13232,0.000467,172.31.40.0-255,66,66162,64,306978
13233,0.000825,172.217.27.0-255,114,66276,64,306978
13234,0.00099,172.217.27.0-255,1484,67760,64,306978
13235,0.000995,172.31.40.0-255,66,67826,64,306978
13236,0.001001,172.217.27.0-255,2902,70728,64,306978
13237,0.001004,172.217.27.0-255,1484,72212,64,306978
13238,0.001021,172.217.27.0-255,4320,76532,64,306978
13239,0.001025,172.217.27.0-255,2902,79434,64,306978
13240,0.00103,172.217.27.0-255,3961,83395,64,306978
13241,0.001045,172.31.40.0-255,66,83461,64,306978
13242,0.001064,172.217.27.0-255,1484,84945,64,306978
13243,0.001081,172.217.27.0-255,7156,92101,64,306978
13244,0.001086,172.217.27.0-255,2902,95003,64,306978
13245,0.001113,172.217.27.0-255,5379,100382,64,306978
13246,0.001118,172.31.40.0-255,66,100448,64,306978
13247,0.001128,172.31.40.0-255,66,100514,64,306978
13248,0.002747,172.217.27.0-255,5738,106252,64,306978
13249,0.002756,172.31.40.0-255,66,106318,64,306978
13250,0.004386,172.217.27.0-255,5738,112056,64,306978
13251,0.004687,172.31.40.0-255,66,112122,64,306978
13252,0.006311,172.217.27.0-255,5738,117860,64,306978
13253,0.006317,172.31.40.0-255,66,117926,64,306978
13254,0.00796,172.217.27.0-255,5738,123664,64,306978
13255,0.007968,172.31.40.0-255,66,123730,64,306978
13256,0.009598,172.217.27.0-255,5738,129468,64,306978
13257,0.009607,172.31.40.0-255,66,129534,64,306978
13258,0.011235,172.217.27.0-255,5738,135272,64,306978
13259,0.012213,172.31.40.0-255,66,135338,64,306978
13260,0.013841,172.217.27.0-255,5738,141076,64,306978
13261,0.013849,172.31.40.0-255,66,141142,64,306978
13262,0.01548,172.217.27.0-255,5738,146880,64,306978
13263,0.015489,172.31.40.0-255,66,146946,64,306978
13264,0.01712,172.217.27.0-255,5738,152684,64,306978
13265,0.017131,172.31.40.0-255,66,152750,64,306978
13266,0.018762,172.217.27.0-255,5738,158488,64,306978
13267,0.018771,172.31.40.0-255,66,158554,64,306978
13268,0.020443,172.217.27.0-255,5738,164292,64,306978
13269,0.020452,172.31.40.0-255,66,164358,64,306978
13270,0.022078,172.217.27.0-255,5738,170096,64,306978
13271,0.022087,172.31.40.0-255,66,170162,64,306978
13272,0.02375,172.217.27.0-255,5738,175900,64,306978
13273,0.023759,172.31.40.0-255,66,175966,64,306978
13274,0.025397,172.217.27.0-255,5738,181704,64,306978
13275,0.025405,172.31.40.0-255,66,181770,64,306978
13276,0.026431,172.31.40.0-255,167,181937,64,306978
13277,0.026462,172.31.40.0-255,1107,183044,64,306978
13278,0.026521,172.31.40.0-255,1514,184558,64,306978
13279,0.026523,172.31.40.0-255,338,184896,64,306978
13280,0.027031,172.217.27.0-255,5738,190634,64,306978
13281,0.027039,172.31.40.0-255,66,190700,64,306978
13282,0.028011,104.244.42.0-255,66,190766,64,306978
13283,0.028187,104.244.42.0-255,66,190832,64,306978
13284,0.028217,104.244.42.0-255,66,190898,64,306978
13285,0.028667,172.217.27.0-255,5738,196636,64,306978
13286,0.028673,172.31.40.0-255,66,196702,64,306978
13287,0.030315,172.217.27.0-255,5738,202440,64,306978
13288,0.030323,172.31.40.0-255,66,202506,64,306978
13289,0.031958,172.217.27.0-255,5738,208244,64,306978
13290,0.031966,172.31.40.0-255,66,208310,64,306978
13291,0.033599,172.217.27.0-255,5738,214048,64,306978
13292,0.033607,172.31.40.0-255,66,214114,64,306978
13293,0.035282,172.217.27.0-255,5738,219852,64,306978
13294,0.03529,172.31.40.0-255,66,219918,64,306978
13295,0.036923,172.217.27.0-255,5738,225656,64,306978
13296,0.036931,172.31.40.0-255,66,225722,64,306978
13297,0.038565,172.217.27.0-255,5738,231460,64,306978
13298,0.038573,172.31.40.0-255,66,231526,64,306978
13299,0.040204,172.217.27.0-255,5738,237264,64,306978
13300,0.040212,172.31.40.0-255,66,237330,64,306978
13301,0.041852,172.217.27.0-255,5738,243068,64,306978
13302,0.04186,172.31.40.0-255,66,243134,64,306978
13303,0.043493,172.217.27.0-255,5738,248872,64,306978
13304,0.043501,172.31.40.0-255,66,248938,64,306978
13305,0.045129,172.217.27.0-255,5738,254676,64,306978
13306,0.04514,172.31.40.0-255,66,254742,64,306978
13307,0.046774,172.217.27.0-255,5738,260480,64,306978
13308,0.046783,172.31.40.0-255,66,260546,64,306978
13309,0.048411,172.217.27.0-255,5738,266284,64,306978
13310,0.048422,172.31.40.0-255,66,266350,64,306978
13311,0.050087,172.217.27.0-255,5738,272088,64,306978
13312,0.050095,172.31.40.0-255,66,272154,64,306978
13313,0.051723,172.217.27.0-255,5738,277892,64,306978
13314,0.051731,172.31.40.0-255,66,277958,64,306978
13315,0.053361,172.217.27.0-255,5738,283696,64,306978
13316,0.05337,172.31.40.0-255,66,283762,64,306978
13317,0.055005,172.217.27.0-255,5738,289500,64,306978
13318,0.055015,172.31.40.0-255,66,289566,64,306978
13319,0.056635,172.217.27.0-255,5738,295304,64,306978
13320,0.056642,172.31.40.0-255,66,295370,64,306978
13321,0.058282,172.217.27.0-255,5738,301108,64,306978
13322,0.05829,172.31.40.0-255,66,301174,64,306978
13323,0.059939,172.217.27.0-255,5738,306912,64,306978
13324,0.059947,172.31.40.0-255,66,306978,64,306978
13325,0.0,172.31.40.0-255,105,105,64,459
13326,0.000145,172.31.40.0-255,90,195,64,459
13327,0.000154,172.31.40.0-255,66,261,64,459
13328,0.002465,74.125.68.0-255,66,327,64,459
13329,0.002483,74.125.68.0-255,66,393,64,459
13330,0.002495,172.31.40.0-255,66,459,64,459
13331,0.0,74.125.130.0-255,152,152,64,196532
13332,1.7e-05,172.31.40.0-255,66,218,64,196532
13333,2.4e-05,74.125.130.0-255,1484,1702,64,196532
13334,2.9e-05,172.31.40.0-255,66,1768,64,196532
13335,5.2e-05,74.125.130.0-255,2902,4670,64,196532
13336,5.5e-05,172.31.40.0-255,66,4736,64,196532
13337,9.1e-05,74.125.130.0-255,4320,9056,64,196532
13338,9.4e-05,172.31.40.0-255,66,9122,64,196532
13339,0.000166,74.125.130.0-255,4955,14077,64,196532
13340,0.00017,172.31.40.0-255,66,14143,64,196532
13341,0.000318,74.125.130.0-255,1484,15627,64,196532
13342,0.000322,172.31.40.0-255,66,15693,64,196532
13343,0.000327,74.125.130.0-255,2902,18595,64,196532
13344,0.00033,172.31.40.0-255,66,18661,64,196532
13345,0.000374,74.125.130.0-255,1484,20145,64,196532
13346,0.000378,172.31.40.0-255,66,20211,64,196532
13347,0.000397,74.125.130.0-255,4320,24531,64,196532
13348,0.0004,172.31.40.0-255,66,24597,64,196532
13349,0.000485,74.125.130.0-255,4320,28917,64,196532
13350,0.000488,172.31.40.0-255,66,28983,64,196532
13351,0.000506,74.125.130.0-255,2543,31526,64,196532
13352,0.000508,172.31.40.0-255,66,31592,64,196532
13353,0.000613,74.125.130.0-255,1484,33076,64,196532
13354,0.000616,172.31.40.0-255,66,33142,64,196532
13355,0.000656,172.31.40.0-255,66,33208,64,196532
13356,0.000902,74.125.130.0-255,5738,38946,64,196532
13357,0.000906,172.31.40.0-255,66,39012,64,196532
13358,0.000939,172.31.40.0-255,66,39078,64,196532
13359,0.001258,74.125.130.0-255,646,39724,64,196532
13360,0.001264,172.31.40.0-255,66,39790,64,196532
13361,0.001315,74.125.130.0-255,5738,45528,64,196532
13362,0.001347,172.31.40.0-255,66,45594,64,196532
13363,0.001696,74.125.130.0-255,5738,51332,64,196532
13364,0.001706,172.31.40.0-255,66,51398,64,196532
13365,0.001752,172.31.40.0-255,66,51464,64,196532
13366,0.002064,74.125.130.0-255,5738,57202,64,196532
13367,0.002068,172.31.40.0-255,66,57268,64,196532
13368,0.002128,172.31.40.0-255,66,57334,64,196532
13369,0.002144,172.31.40.0-255,66,57400,64,196532
13370,0.002944,172.31.40.0-255,66,57466,64,196532
13371,0.002963,74.125.130.0-255,2184,59650,64,196532
13372,0.008029,172.31.40.0-255,66,59716,64,196532
13373,0.010074,74.125.130.0-255,5738,65454,64,196532
13374,0.010083,172.31.40.0-255,66,65520,64,196532
13375,0.012127,74.125.130.0-255,5738,71258,64,196532
13376,0.012136,172.31.40.0-255,66,71324,64,196532
13377,0.01418,74.125.130.0-255,5738,77062,64,196532
13378,0.016099,172.31.40.0-255,66,77128,64,196532
13379,0.018146,74.125.130.0-255,5738,82866,64,196532
13380,0.018157,172.31.40.0-255,66,82932,64,196532
13381,0.020197,74.125.130.0-255,5738,88670,64,196532
13382,0.020204,172.31.40.0-255,66,88736,64,196532
13383,0.022254,74.125.130.0-255,5738,94474,64,196532
13384,0.022261,172.31.40.0-255,66,94540,64,196532
13385,0.024306,74.125.130.0-255,5738,100278,64,196532
13386,0.024314,172.31.40.0-255,66,100344,64,196532
13387,0.026375,74.125.130.0-255,5738,106082,64,196532
13388,0.026387,172.31.40.0-255,66,106148,64,196532
13389,0.028452,74.125.130.0-255,5738,111886,64,196532
13390,0.030064,172.31.40.0-255,66,111952,64,196532
13391,0.032158,74.125.130.0-255,5738,117690,64,196532
13392,0.032169,172.31.40.0-255,66,117756,64,196532
13393,0.033413,172.31.40.0-255,167,117923,64,196532
13394,0.033443,172.31.40.0-255,1107,119030,64,196532
13395,0.033497,172.31.40.0-255,1514,120544,64,196532
13396,0.033499,172.31.40.0-255,338,120882,64,196532
13397,0.034223,74.125.130.0-255,5738,126620,64,196532
13398,0.034229,172.31.40.0-255,66,126686,64,196532
13399,0.035041,104.244.42.0-255,66,126752,64,196532
13400,0.03628,74.125.130.0-255,5738,132490,64,196532
13401,0.036288,172.31.40.0-255,66,132556,64,196532
13402,0.03835,74.125.130.0-255,5738,138294,64,196532
13403,0.038356,172.31.40.0-255,66,138360,64,196532
13404,0.040407,74.125.130.0-255,5738,144098,64,196532
13405,0.040425,172.31.40.0-255,66,144164,64,196532
13406,0.042458,74.125.130.0-255,5738,149902,64,196532
13407,0.042464,172.31.40.0-255,66,149968,64,196532
13408,0.044505,74.125.130.0-255,5738,155706,64,196532
13409,0.044513,172.31.40.0-255,66,155772,64,196532
13410,0.046556,74.125.130.0-255,5738,161510,64,196532
13411,0.046565,172.31.40.0-255,66,161576,64,196532
13412,0.048621,74.125.130.0-255,5738,167314,64,196532
13413,0.048628,172.31.40.0-255,66,167380,64,196532
13414,0.05068,74.125.130.0-255,5738,173118,64,196532
13415,0.050687,172.31.40.0-255,66,173184,64,196532
13416,0.052739,74.125.130.0-255,5738,178922,64,196532
13417,0.052747,172.31.40.0-255,66,178988,64,196532
13418,0.054814,74.125.130.0-255,5738,184726,64,196532
13419,0.05482,172.31.40.0-255,66,184792,64,196532
13420,0.056866,74.125.130.0-255,5738,190530,64,196532
13421,0.056872,172.31.40.0-255,66,190596,64,196532
13422,0.058926,74.125.130.0-255,2902,193498,64,196532
13423,0.058932,172.31.40.0-255,66,193564,64,196532
13424,0.058952,74.125.130.0-255,2902,196466,64,196532
13425,0.058975,172.31.40.0-255,66,196532,64,196532
13426,0.0,172.217.194.0-255,153,153,64,215276
13427,2.2e-05,172.31.40.0-255,66,219,64,215276
13428,3e-05,172.217.194.0-255,1484,1703,64,215276
13429,3.3e-05,172.31.40.0-255,66,1769,64,215276
13430,3.9e-05,172.217.194.0-255,2902,4671,64,215276
13431,4.2e-05,172.31.40.0-255,66,4737,64,215276
13432,5.1e-05,172.217.194.0-255,7156,11893,64,215276
13433,5.4e-05,172.31.40.0-255,66,11959,64,215276
13434,7.3e-05,172.217.194.0-255,2067,14026,64,215276
13435,7.6e-05,172.31.40.0-255,66,14092,64,215276
13436,0.000116,172.217.194.0-255,1484,15576,64,215276
13437,0.000118,172.31.40.0-255,66,15642,64,215276
13438,0.000123,172.217.194.0-255,2902,18544,64,215276
13439,0.000125,172.31.40.0-255,66,18610,64,215276
13440,0.000128,172.217.194.0-255,1484,20094,64,215276
13441,0.00013,172.31.40.0-255,66,20160,64,215276
13442,0.000158,172.217.194.0-255,4320,24480,64,215276
13443,0.000161,172.31.40.0-255,66,24546,64,215276
13444,0.000169,172.217.194.0-255,6797,31343,64,215276
13445,0.000171,172.31.40.0-255,66,31409,64,215276
13446,0.000223,172.217.194.0-255,1484,32893,64,215276
13447,0.000226,172.31.40.0-255,66,32959,64,215276
13448,0.00023,172.217.194.0-255,2902,35861,64,215276
13449,0.000232,172.31.40.0-255,66,35927,64,215276
13450,0.000252,172.217.194.0-255,5738,41665,64,215276
13451,0.000255,172.31.40.0-255,66,41731,64,215276
13452,0.000283,172.31.40.0-255,66,41797,64,215276
13453,0.000303,172.217.194.0-255,2543,44340,64,215276
13454,0.000305,172.31.40.0-255,66,44406,64,215276
13455,0.000332,172.31.40.0-255,66,44472,64,215276
13456,0.000355,172.217.194.0-255,2796,47268,64,215276
13457,0.000357,172.31.40.0-255,66,47334,64,215276
13458,0.00036,172.217.194.0-255,122,47456,64,215276
13459,0.000364,172.217.194.0-255,379,47835,64,215276
13460,0.000547,172.217.194.0-255,1484,49319,64,215276
13461,0.000551,172.31.40.0-255,66,49385,64,215276
13462,0.000556,172.217.194.0-255,2902,52287,64,215276
13463,0.000559,172.31.40.0-255,66,52353,64,215276
13464,0.000563,172.217.194.0-255,2902,55255,64,215276
13465,0.000566,172.31.40.0-255,66,55321,64,215276
13466,0.00059,172.217.194.0-255,2902,58223,64,215276
13467,0.000593,172.31.40.0-255,66,58289,64,215276
13468,0.000605,172.31.40.0-255,66,58355,64,215276
13469,0.000655,172.31.40.0-255,66,58421,64,215276
13470,0.000789,172.217.194.0-255,1484,59905,64,215276
13471,0.000804,172.217.194.0-255,2902,62807,64,215276
13472,0.000807,172.31.40.0-255,66,62873,64,215276
13473,0.000813,172.217.194.0-255,4320,67193,64,215276
13474,0.000815,172.31.40.0-255,66,67259,64,215276
13475,0.000832,172.217.194.0-255,1484,68743,64,215276
13476,0.000839,172.217.194.0-255,6783,75526,64,215276
13477,0.000841,172.31.40.0-255,66,75592,64,215276
13478,0.001166,172.217.194.0-255,1484,77076,64,215276
13479,0.001172,172.217.194.0-255,2902,79978,64,215276
13480,0.001176,172.31.40.0-255,66,80044,64,215276
13481,0.001181,172.217.194.0-255,2902,82946,64,215276
13482,0.001183,172.31.40.0-255,66,83012,64,215276
13483,0.001204,172.217.194.0-255,2902,85914,64,215276
13484,0.001206,172.31.40.0-255,66,85980,64,215276
13485,0.001218,172.31.40.0-255,66,86046,64,215276
13486,0.001237,172.217.194.0-255,1484,87530,64,215276
13487,0.001249,172.31.40.0-255,66,87596,64,215276
13488,0.001655,172.217.194.0-255,1484,89080,64,215276
13489,0.001661,172.217.194.0-255,2902,91982,64,215276
13490,0.001664,172.31.40.0-255,66,92048,64,215276
13491,0.001671,172.217.194.0-255,5738,97786,64,215276
13492,0.001673,172.31.40.0-255,66,97852,64,215276
13493,0.001684,172.217.194.0-255,1484,99336,64,215276
13494,0.0017,172.217.194.0-255,4320,103656,64,215276
13495,0.001702,172.31.40.0-255,66,103722,64,215276
13496,0.001715,172.31.40.0-255,66,103788,64,215276
13497,0.001734,172.217.194.0-255,1484,105272,64,215276
13498,0.00174,172.217.194.0-255,5020,110292,64,215276
13499,0.001742,172.31.40.0-255,66,110358,64,215276
13500,0.00196,172.217.194.0-255,1484,111842,64,215276
13501,0.001966,172.217.194.0-255,2902,114744,64,215276
13502,0.001969,172.31.40.0-255,66,114810,64,215276
13503,0.00201,172.217.194.0-255,5738,120548,64,215276
13504,0.002013,172.31.40.0-255,66,120614,64,215276
13505,0.002019,172.217.194.0-255,5738,126352,64,215276
13506,0.002021,172.31.40.0-255,66,126418,64,215276
13507,0.002034,172.31.40.0-255,66,126484,64,215276
13508,0.002039,172.217.194.0-255,2902,129386,64,215276
13509,0.002042,172.31.40.0-255,66,129452,64,215276
13510,0.002064,172.217.194.0-255,2184,131636,64,215276
13511,0.002066,172.31.40.0-255,66,131702,64,215276
13512,0.002482,172.217.194.0-255,1484,133186,64,215276
13513,0.002489,172.217.194.0-255,2902,136088,64,215276
13514,0.002493,172.31.40.0-255,66,136154,64,215276
13515,0.002516,172.217.194.0-255,5738,141892,64,215276
13516,0.002518,172.31.40.0-255,66,141958,64,215276
13517,0.002535,172.217.194.0-255,2902,144860,64,215276
13518,0.002536,172.31.40.0-255,66,144926,64,215276
13519,0.002569,172.31.40.0-255,66,144992,64,215276
13520,0.002573,172.217.194.0-255,2902,147894,64,215276
13521,0.002575,172.31.40.0-255,66,147960,64,215276
13522,0.002597,172.217.194.0-255,7156,155116,64,215276
13523,0.002599,172.31.40.0-255,66,155182,64,215276
13524,0.002612,172.217.194.0-255,766,155948,64,215276
13525,0.002654,172.217.194.0-255,1484,157432,64,215276
13526,0.002658,172.31.40.0-255,66,157498,64,215276
13527,0.002663,172.217.194.0-255,2902,160400,64,215276
13528,0.002665,172.31.40.0-255,66,160466,64,215276
13529,0.00268,172.217.194.0-255,4320,164786,64,215276
13530,0.002683,172.31.40.0-255,66,164852,64,215276
13531,0.002697,172.217.194.0-255,1484,166336,64,215276
13532,0.002732,172.217.194.0-255,7156,173492,64,215276
13533,0.002735,172.31.40.0-255,66,173558,64,215276
13534,0.002753,172.217.194.0-255,2902,176460,64,215276
13535,0.002755,172.31.40.0-255,66,176526,64,215276
13536,0.00277,172.31.40.0-255,66,176592,64,215276
13537,0.00281,172.217.194.0-255,1484,178076,64,215276
13538,0.002814,172.217.194.0-255,1484,179560,64,215276
13539,0.002816,172.31.40.0-255,66,179626,64,215276
13540,0.002839,172.217.194.0-255,1484,181110,64,215276
13541,0.002847,172.217.194.0-255,5738,186848,64,215276
13542,0.002849,172.31.40.0-255,66,186914,64,215276
13543,0.002879,172.31.40.0-255,66,186980,64,215276
13544,0.002892,172.31.40.0-255,66,187046,64,215276
13545,0.00292,172.217.194.0-255,5020,192066,64,215276
13546,0.002923,172.31.40.0-255,66,192132,64,215276
13547,0.002929,172.217.194.0-255,5738,197870,64,215276
13548,0.002931,172.31.40.0-255,66,197936,64,215276
13549,0.002949,172.217.194.0-255,2902,200838,64,215276
13550,0.002952,172.31.40.0-255,66,200904,64,215276
13551,0.002979,172.31.40.0-255,66,200970,64,215276
13552,0.002993,172.31.40.0-255,66,201036,64,215276
13553,0.003014,172.217.194.0-255,2902,203938,64,215276
13554,0.003016,172.31.40.0-255,66,204004,64,215276
13555,0.003047,172.31.40.0-255,66,204070,64,215276
13556,0.003078,172.217.194.0-255,2184,206254,64,215276
13557,0.00308,172.31.40.0-255,66,206320,64,215276
13558,0.003093,172.31.40.0-255,66,206386,64,215276
13559,0.00311,172.31.40.0-255,66,206452,64,215276
13560,0.003113,172.217.194.0-255,1484,207936,64,215276
13561,0.003118,172.217.194.0-255,2440,210376,64,215276
13562,0.00312,172.31.40.0-255,66,210442,64,215276
13563,0.003124,172.217.194.0-255,97,210539,64,215276
13564,0.003126,172.217.194.0-255,105,210644,64,215276
13565,0.009907,172.31.40.0-255,101,210745,64,215276
13566,0.0104,172.31.40.0-255,105,210850,64,215276
13567,0.012387,172.217.194.0-255,66,210916,64,215276
13568,0.01286,172.217.194.0-255,66,210982,64,215276
13569,0.049657,172.31.40.0-255,172,211154,64,215276
13570,0.049695,172.31.40.0-255,1112,212266,64,215276
13571,0.04976,172.31.40.0-255,1514,213780,64,215276
13572,0.049762,172.31.40.0-255,1298,215078,64,215276
13573,0.051165,104.244.42.0-255,66,215144,64,215276
13574,0.051186,104.244.42.0-255,66,215210,64,215276
13575,0.051275,104.244.42.0-255,66,215276,64,215276
13576,0.0,172.217.194.0-255,146,146,64,278269
13577,2.3e-05,172.31.40.0-255,66,212,64,278269
13578,3e-05,172.217.194.0-255,1484,1696,64,278269
13579,3.4e-05,172.31.40.0-255,66,1762,64,278269
13580,4.1e-05,172.217.194.0-255,2902,4664,64,278269
13581,4.5e-05,172.31.40.0-255,66,4730,64,278269
13582,6.1e-05,172.217.194.0-255,7156,11886,64,278269
13583,6.4e-05,172.31.40.0-255,66,11952,64,278269
13584,7.7e-05,172.31.40.0-255,66,12018,64,278269
13585,0.000126,172.31.40.0-255,66,12084,64,278269
13586,0.000288,172.217.194.0-255,1484,13568,64,278269
13587,0.000293,172.31.40.0-255,66,13634,64,278269
13588,0.0003,172.217.194.0-255,2902,16536,64,278269
13589,0.000302,172.31.40.0-255,66,16602,64,278269
13590,0.000329,172.217.194.0-255,4320,20922,64,278269
13591,0.000332,172.31.40.0-255,66,20988,64,278269
13592,0.000372,172.217.194.0-255,5738,26726,64,278269
13593,0.000376,172.31.40.0-255,66,26792,64,278269
13594,0.000387,172.217.194.0-255,2543,29335,64,278269
13595,0.00039,172.31.40.0-255,66,29401,64,278269
13596,0.000405,172.31.40.0-255,66,29467,64,278269
13597,0.000408,172.217.194.0-255,1484,30951,64,278269
13598,0.00041,172.31.40.0-255,66,31017,64,278269
13599,0.00045,172.217.194.0-255,7086,38103,64,278269
13600,0.000454,172.31.40.0-255,66,38169,64,278269
13601,0.000772,172.217.194.0-255,367,38536,64,278269
13602,0.000777,172.31.40.0-255,66,38602,64,278269
13603,0.000836,172.217.194.0-255,1484,40086,64,278269
13604,0.00084,172.31.40.0-255,66,40152,64,278269
13605,0.000843,172.217.194.0-255,1484,41636,64,278269
13606,0.000869,172.217.194.0-255,2902,44538,64,278269
13607,0.000899,172.217.194.0-255,5738,50276,64,278269
13608,0.000907,172.31.40.0-255,66,50342,64,278269
13609,0.000939,172.217.194.0-255,4320,54662,64,278269
13610,0.000956,172.217.194.0-255,2184,56846,64,278269
13611,0.000966,172.31.40.0-255,66,56912,64,278269
13612,0.001421,172.217.194.0-255,1484,58396,64,278269
13613,0.001437,172.217.194.0-255,2902,61298,64,278269
13614,0.001441,172.31.40.0-255,66,61364,64,278269
13615,0.001446,172.217.194.0-255,4320,65684,64,278269
13616,0.00145,172.31.40.0-255,66,65750,64,278269
13617,0.001468,172.217.194.0-255,1484,67234,64,278269
13618,0.001473,172.217.194.0-255,4320,71554,64,278269
13619,0.001508,172.217.194.0-255,5738,77292,64,278269
13620,0.001522,172.31.40.0-255,66,77358,64,278269
13621,0.00154,172.217.194.0-255,5020,82378,64,278269
13622,0.001565,172.31.40.0-255,66,82444,64,278269
13623,0.001578,172.217.194.0-255,5738,88182,64,278269
13624,0.001589,172.217.194.0-255,4320,92502,64,278269
13625,0.001607,172.217.194.0-255,4320,96822,64,278269
13626,0.001615,172.31.40.0-255,66,96888,64,278269
13627,0.001631,172.217.194.0-255,7156,104044,64,278269
13628,0.001635,172.217.194.0-255,2902,106946,64,278269
13629,0.001642,172.31.40.0-255,66,107012,64,278269
13630,0.001665,172.217.194.0-255,1484,108496,64,278269
13631,0.001683,172.31.40.0-255,66,108562,64,278269
13632,0.001687,172.217.194.0-255,1484,110046,64,278269
13633,0.001737,172.217.194.0-255,4320,114366,64,278269
13634,0.001749,172.31.40.0-255,66,114432,64,278269
13635,0.001765,172.217.194.0-255,5020,119452,64,278269
13636,0.00177,172.31.40.0-255,66,119518,64,278269
13637,0.001982,172.217.194.0-255,1484,121002,64,278269
13638,0.001988,172.217.194.0-255,2902,123904,64,278269
13639,0.002009,172.217.194.0-255,2902,126806,64,278269
13640,0.002021,172.217.194.0-255,2902,129708,64,278269
13641,0.002024,172.31.40.0-255,66,129774,64,278269
13642,0.002029,172.31.40.0-255,66,129840,64,278269
13643,0.002075,172.217.194.0-255,7156,136996,64,278269
13644,0.002086,172.31.40.0-255,66,137062,64,278269
13645,0.002116,172.217.194.0-255,3602,140664,64,278269
13646,0.002126,172.31.40.0-255,66,140730,64,278269
13647,0.002286,172.217.194.0-255,1484,142214,64,278269
13648,0.002303,172.217.194.0-255,2902,145116,64,278269
13649,0.002306,172.217.194.0-255,1484,146600,64,278269
13650,0.002321,172.217.194.0-255,4320,150920,64,278269
13651,0.002328,172.31.40.0-255,66,150986,64,278269
13652,0.002341,172.217.194.0-255,4320,155306,64,278269
13653,0.002359,172.31.40.0-255,66,155372,64,278269
13654,0.002393,172.31.40.0-255,66,155438,64,278269
13655,0.0024,172.217.194.0-255,5738,161176,64,278269
13656,0.011932,172.217.194.0-255,1484,162660,64,278269
13657,0.012726,172.31.40.0-255,66,162726,64,278269
13658,0.015107,172.217.194.0-255,5738,168464,64,278269
13659,0.015123,172.31.40.0-255,66,168530,64,278269
13660,0.017492,172.217.194.0-255,5738,174268,64,278269
13661,0.017505,172.31.40.0-255,66,174334,64,278269
13662,0.019838,172.217.194.0-255,5738,180072,64,278269
13663,0.019845,172.31.40.0-255,66,180138,64,278269
13664,0.022183,172.217.194.0-255,5738,185876,64,278269
13665,0.024445,172.31.40.0-255,66,185942,64,278269
13666,0.026785,172.217.194.0-255,5738,191680,64,278269
13667,0.026803,172.31.40.0-255,66,191746,64,278269
13668,0.02917,172.217.194.0-255,5738,197484,64,278269
13669,0.029178,172.31.40.0-255,66,197550,64,278269
13670,0.031523,172.217.194.0-255,5738,203288,64,278269
13671,0.031532,172.31.40.0-255,66,203354,64,278269
13672,0.033847,172.217.194.0-255,5738,209092,64,278269
13673,0.033862,172.31.40.0-255,66,209158,64,278269
13674,0.036207,172.217.194.0-255,5738,214896,64,278269
13675,0.036215,172.31.40.0-255,66,214962,64,278269
13676,0.038562,172.217.194.0-255,5738,220700,64,278269
13677,0.038578,172.31.40.0-255,66,220766,64,278269
13678,0.040967,172.217.194.0-255,5738,226504,64,278269
13679,0.040985,172.31.40.0-255,66,226570,64,278269
13680,0.04335,172.217.194.0-255,5738,232308,64,278269
13681,0.043358,172.31.40.0-255,66,232374,64,278269
13682,0.045698,172.217.194.0-255,5738,238112,64,278269
13683,0.045716,172.31.40.0-255,66,238178,64,278269
13684,0.047592,172.31.40.0-255,167,238345,64,278269
13685,0.047623,172.31.40.0-255,1111,239456,64,278269
13686,0.047676,172.31.40.0-255,1514,240970,64,278269
13687,0.047678,172.31.40.0-255,1514,242484,64,278269
13688,0.047718,172.31.40.0-255,697,243181,64,278269
13689,0.048057,172.217.194.0-255,5738,248919,64,278269
13690,0.048065,172.31.40.0-255,66,248985,64,278269
13691,0.049118,104.244.42.0-255,66,249051,64,278269
13692,0.04919,104.244.42.0-255,66,249117,64,278269
13693,0.049417,104.244.42.0-255,66,249183,64,278269
13694,0.049422,104.244.42.0-255,66,249249,64,278269
13695,0.050398,172.217.194.0-255,5738,254987,64,278269
13696,0.050408,172.31.40.0-255,66,255053,64,278269
13697,0.052751,172.217.194.0-255,5738,260791,64,278269
13698,0.052782,172.31.40.0-255,66,260857,64,278269
13699,0.055116,172.217.194.0-255,5738,266595,64,278269
13700,0.055135,172.31.40.0-255,66,266661,64,278269
13701,0.057487,172.217.194.0-255,5738,272399,64,278269
13702,0.057502,172.31.40.0-255,66,272465,64,278269
13703,0.059867,172.217.194.0-255,5738,278203,64,278269
13704,0.059885,172.31.40.0-255,66,278269,64,278269
13705,0.0,74.125.24.0-255,156,156,64,272194
13706,3.4e-05,172.31.40.0-255,66,222,64,272194
13707,4.1e-05,74.125.24.0-255,1484,1706,64,272194
13708,4.5e-05,172.31.40.0-255,66,1772,64,272194
13709,4.9e-05,74.125.24.0-255,2902,4674,64,272194
13710,5.2e-05,172.31.40.0-255,66,4740,64,272194
13711,5.6e-05,74.125.24.0-255,2902,7642,64,272194
13712,5.8e-05,172.31.40.0-255,66,7708,64,272194
13713,9.4e-05,74.125.24.0-255,6354,14062,64,272194
13714,9.7e-05,172.31.40.0-255,66,14128,64,272194
13715,0.000201,74.125.24.0-255,1484,15612,64,272194
13716,0.000206,172.31.40.0-255,66,15678,64,272194
13717,0.000211,74.125.24.0-255,2902,18580,64,272194
13718,0.000213,172.31.40.0-255,66,18646,64,272194
13719,0.000218,74.125.24.0-255,2902,21548,64,272194
13720,0.00022,172.31.40.0-255,66,21614,64,272194
13721,0.000244,74.125.24.0-255,2902,24516,64,272194
13722,0.000247,172.31.40.0-255,66,24582,64,272194
13723,0.000253,74.125.24.0-255,5738,30320,64,272194
13724,0.000255,172.31.40.0-255,66,30386,64,272194
13725,0.000279,74.125.24.0-255,1125,31511,64,272194
13726,0.000282,172.31.40.0-255,66,31577,64,272194
13727,0.000414,74.125.24.0-255,1484,33061,64,272194
13728,0.000418,172.31.40.0-255,66,33127,64,272194
13729,0.000422,74.125.24.0-255,1484,34611,64,272194
13730,0.000425,172.31.40.0-255,66,34677,64,272194
13731,0.000437,74.125.24.0-255,1484,36161,64,272194
13732,0.00044,172.31.40.0-255,66,36227,64,272194
13733,0.000447,74.125.24.0-255,5738,41965,64,272194
13734,0.00045,172.31.40.0-255,66,42031,64,272194
13735,0.000496,172.31.40.0-255,66,42097,64,272194
13736,0.000509,172.31.40.0-255,66,42163,64,272194
13737,0.000512,74.125.24.0-255,111,42274,64,272194
13738,0.000679,74.125.24.0-255,333,42607,64,272194
13739,0.000841,172.31.40.0-255,66,42673,64,272194
13740,0.000974,74.125.24.0-255,1484,44157,64,272194
13741,0.000983,74.125.24.0-255,2902,47059,64,272194
13742,0.000987,172.31.40.0-255,66,47125,64,272194
13743,0.000995,74.125.24.0-255,5738,52863,64,272194
13744,0.000997,172.31.40.0-255,66,52929,64,272194
13745,0.001034,172.31.40.0-255,66,52995,64,272194
13746,0.001039,74.125.24.0-255,2902,55897,64,272194
13747,0.001041,172.31.40.0-255,66,55963,64,272194
13748,0.001059,74.125.24.0-255,7156,63119,64,272194
13749,0.001063,172.31.40.0-255,66,63185,64,272194
13750,0.001075,74.125.24.0-255,766,63951,64,272194
13751,0.001238,74.125.24.0-255,1484,65435,64,272194
13752,0.001243,172.31.40.0-255,66,65501,64,272194
13753,0.001249,74.125.24.0-255,2902,68403,64,272194
13754,0.001251,172.31.40.0-255,66,68469,64,272194
13755,0.001257,74.125.24.0-255,5738,74207,64,272194
13756,0.001259,172.31.40.0-255,66,74273,64,272194
13757,0.001282,172.31.40.0-255,66,74339,64,272194
13758,0.00131,74.125.24.0-255,4320,78659,64,272194
13759,0.001313,172.31.40.0-255,66,78725,64,272194
13760,0.001326,172.31.40.0-255,66,78791,64,272194
13761,0.001552,74.125.24.0-255,1484,80275,64,272194
13762,0.001557,74.125.24.0-255,1484,81759,64,272194
13763,0.00156,172.31.40.0-255,66,81825,64,272194
13764,0.001577,74.125.24.0-255,1484,83309,64,272194
13765,0.001584,74.125.24.0-255,5738,89047,64,272194
13766,0.001586,172.31.40.0-255,66,89113,64,272194
13767,0.001591,74.125.24.0-255,4320,93433,64,272194
13768,0.001593,172.31.40.0-255,66,93499,64,272194
13769,0.001618,172.31.40.0-255,66,93565,64,272194
13770,0.001627,172.31.40.0-255,66,93631,64,272194
13771,0.001643,74.125.24.0-255,766,94397,64,272194
13772,0.001733,74.125.24.0-255,1484,95881,64,272194
13773,0.001735,172.31.40.0-255,66,95947,64,272194
13774,0.00174,74.125.24.0-255,2902,98849,64,272194
13775,0.001741,172.31.40.0-255,66,98915,64,272194
13776,0.001753,74.125.24.0-255,1484,100399,64,272194
13777,0.001767,74.125.24.0-255,4320,104719,64,272194
13778,0.00177,172.31.40.0-255,66,104785,64,272194
13779,0.001777,74.125.24.0-255,7156,111941,64,272194
13780,0.001779,172.31.40.0-255,66,112007,64,272194
13781,0.001794,74.125.24.0-255,5738,117745,64,272194
13782,0.001796,172.31.40.0-255,66,117811,64,272194
13783,0.001807,74.125.24.0-255,2902,120713,64,272194
13784,0.001809,172.31.40.0-255,66,120779,64,272194
13785,0.001845,172.31.40.0-255,66,120845,64,272194
13786,0.001857,172.31.40.0-255,66,120911,64,272194
13787,0.001864,74.125.24.0-255,5738,126649,64,272194
13788,0.001866,172.31.40.0-255,66,126715,64,272194
13789,0.001886,172.31.40.0-255,66,126781,64,272194
13790,0.001951,74.125.24.0-255,1484,128265,64,272194
13791,0.001954,74.125.24.0-255,1484,129749,64,272194
13792,0.001956,172.31.40.0-255,66,129815,64,272194
13793,0.001973,74.125.24.0-255,1484,131299,64,272194
13794,0.001979,74.125.24.0-255,5738,137037,64,272194
13795,0.001981,172.31.40.0-255,66,137103,64,272194
13796,0.002015,172.31.40.0-255,66,137169,64,272194
13797,0.002025,172.31.40.0-255,66,137235,64,272194
13798,0.002078,74.125.24.0-255,2184,139419,64,272194
13799,0.00208,172.31.40.0-255,66,139485,64,272194
13800,0.002105,74.125.24.0-255,2902,142387,64,272194
13801,0.002107,172.31.40.0-255,66,142453,64,272194
13802,0.002112,74.125.24.0-255,4320,146773,64,272194
13803,0.002114,172.31.40.0-255,66,146839,64,272194
13804,0.002118,74.125.24.0-255,2902,149741,64,272194
13805,0.00212,172.31.40.0-255,66,149807,64,272194
13806,0.00214,74.125.24.0-255,5738,155545,64,272194
13807,0.002142,172.31.40.0-255,66,155611,64,272194
13808,0.002167,74.125.24.0-255,4320,159931,64,272194
13809,0.002169,172.31.40.0-255,66,159997,64,272194
13810,0.002202,172.31.40.0-255,66,160063,64,272194
13811,0.00446,74.125.24.0-255,4320,164383,64,272194
13812,0.004466,172.31.40.0-255,66,164449,64,272194
13813,0.004483,74.125.24.0-255,1484,165933,64,272194
13814,0.006743,74.125.24.0-255,4320,170253,64,272194
13815,0.006767,172.31.40.0-255,66,170319,64,272194
13816,0.009035,74.125.24.0-255,5738,176057,64,272194
13817,0.009044,172.31.40.0-255,66,176123,64,272194
13818,0.011299,74.125.24.0-255,5738,181861,64,272194
13819,0.011313,172.31.40.0-255,66,181927,64,272194
13820,0.013605,74.125.24.0-255,5738,187665,64,272194
13821,0.013621,172.31.40.0-255,66,187731,64,272194
13822,0.015892,74.125.24.0-255,5738,193469,64,272194
13823,0.015905,172.31.40.0-255,66,193535,64,272194
13824,0.01815,74.125.24.0-255,5738,199273,64,272194
13825,0.018157,172.31.40.0-255,66,199339,64,272194
13826,0.02042,74.125.24.0-255,5738,205077,64,272194
13827,0.020428,172.31.40.0-255,66,205143,64,272194
13828,0.022712,74.125.24.0-255,5738,210881,64,272194
13829,0.022721,172.31.40.0-255,66,210947,64,272194
13830,0.025021,74.125.24.0-255,5738,216685,64,272194
13831,0.025029,172.31.40.0-255,66,216751,64,272194
13832,0.0273,74.125.24.0-255,5738,222489,64,272194
13833,0.027309,172.31.40.0-255,66,222555,64,272194
13834,0.029561,74.125.24.0-255,5738,228293,64,272194
13835,0.029567,172.31.40.0-255,66,228359,64,272194
13836,0.031825,74.125.24.0-255,5738,234097,64,272194
13837,0.031832,172.31.40.0-255,66,234163,64,272194
13838,0.034081,74.125.24.0-255,5738,239901,64,272194
13839,0.034088,172.31.40.0-255,66,239967,64,272194
13840,0.036359,74.125.24.0-255,5738,245705,64,272194
13841,0.036378,172.31.40.0-255,66,245771,64,272194
13842,0.038653,74.125.24.0-255,5738,251509,64,272194
13843,0.038667,172.31.40.0-255,66,251575,64,272194
13844,0.039611,172.31.40.0-255,101,251676,64,272194
13845,0.040943,74.125.24.0-255,5738,257414,64,272194
13846,0.04095,172.31.40.0-255,66,257480,64,272194
13847,0.041839,74.125.24.0-255,66,257546,64,272194
13848,0.043232,74.125.24.0-255,5738,263284,64,272194
13849,0.043239,172.31.40.0-255,66,263350,64,272194
13850,0.045524,74.125.24.0-255,4315,267665,64,272194
13851,0.045531,172.31.40.0-255,66,267731,64,272194
13852,0.04571,172.31.40.0-255,105,267836,64,272194
13853,0.047742,172.31.40.0-255,172,268008,64,272194
13854,0.04778,172.31.40.0-255,1113,269121,64,272194
13855,0.047807,172.31.40.0-255,1514,270635,64,272194
13856,0.047809,172.31.40.0-255,1295,271930,64,272194
13857,0.049332,104.244.42.0-255,66,271996,64,272194
13858,0.049356,104.244.42.0-255,66,272062,64,272194
13859,0.049413,104.244.42.0-255,66,272128,64,272194
13860,0.051538,74.125.24.0-255,66,272194,64,272194
13861,0.0,74.125.24.0-255,150,150,64,302750
13862,1.1e-05,172.31.40.0-255,66,216,64,302750
13863,1.7e-05,74.125.24.0-255,1484,1700,64,302750
13864,2.1e-05,172.31.40.0-255,66,1766,64,302750
13865,2.6e-05,74.125.24.0-255,2902,4668,64,302750
13866,2.8e-05,172.31.40.0-255,66,4734,64,302750
13867,5.9e-05,74.125.24.0-255,7156,11890,64,302750
13868,6.1e-05,172.31.40.0-255,66,11956,64,302750
13869,6.4e-05,74.125.24.0-255,1484,13440,64,302750
13870,6.5e-05,172.31.40.0-255,66,13506,64,302750
13871,8.2e-05,74.125.24.0-255,5738,19244,64,302750
13872,8.4e-05,172.31.40.0-255,66,19310,64,302750
13873,0.000114,172.31.40.0-255,66,19376,64,302750
13874,0.000118,74.125.24.0-255,2543,21919,64,302750
13875,0.000119,172.31.40.0-255,66,21985,64,302750
13876,0.000173,172.31.40.0-255,66,22051,64,302750
13877,0.000188,74.125.24.0-255,6797,28848,64,302750
13878,0.00019,172.31.40.0-255,66,28914,64,302750
13879,0.000646,74.125.24.0-255,1484,30398,64,302750
13880,0.000651,172.31.40.0-255,66,30464,64,302750
13881,0.000666,74.125.24.0-255,2902,33366,64,302750
13882,0.000668,172.31.40.0-255,66,33432,64,302750
13883,0.000671,74.125.24.0-255,1484,34916,64,302750
13884,0.000672,172.31.40.0-255,66,34982,64,302750
13885,0.000698,74.125.24.0-255,4320,39302,64,302750
13886,0.0007,172.31.40.0-255,66,39368,64,302750
13887,0.000707,74.125.24.0-255,6797,46165,64,302750
13888,0.000708,172.31.40.0-255,66,46231,64,302750
13889,0.000746,172.31.40.0-255,66,46297,64,302750
13890,0.000752,74.125.24.0-255,1484,47781,64,302750
13891,0.000756,74.125.24.0-255,2543,50324,64,302750
13892,0.000758,172.31.40.0-255,66,50390,64,302750
13893,0.000798,74.125.24.0-255,5738,56128,64,302750
13894,0.000801,172.31.40.0-255,66,56194,64,302750
13895,0.000812,74.125.24.0-255,1484,57678,64,302750
13896,0.000814,74.125.24.0-255,1484,59162,64,302750
13897,0.000816,172.31.40.0-255,66,59228,64,302750
13898,0.000835,74.125.24.0-255,7156,66384,64,302750
13899,0.000838,172.31.40.0-255,66,66450,64,302750
13900,0.000894,74.125.24.0-255,1704,68154,64,302750
13901,0.000897,172.31.40.0-255,66,68220,64,302750
13902,0.001018,74.125.24.0-255,1484,69704,64,302750
13903,0.001033,74.125.24.0-255,2902,72606,64,302750
13904,0.001036,172.31.40.0-255,66,72672,64,302750
13905,0.001057,74.125.24.0-255,4320,76992,64,302750
13906,0.001059,172.31.40.0-255,66,77058,64,302750
13907,0.001071,74.125.24.0-255,4320,81378,64,302750
13908,0.001073,172.31.40.0-255,66,81444,64,302750
13909,0.001084,74.125.24.0-255,4320,85764,64,302750
13910,0.001086,172.31.40.0-255,66,85830,64,302750
13911,0.001118,74.125.24.0-255,2902,88732,64,302750
13912,0.001121,172.31.40.0-255,66,88798,64,302750
13913,0.001152,172.31.40.0-255,66,88864,64,302750
13914,0.001155,74.125.24.0-255,766,89630,64,302750
13915,0.001219,74.125.24.0-255,1484,91114,64,302750
13916,0.001222,172.31.40.0-255,66,91180,64,302750
13917,0.001226,74.125.24.0-255,2902,94082,64,302750
13918,0.001227,172.31.40.0-255,66,94148,64,302750
13919,0.001238,74.125.24.0-255,1484,95632,64,302750
13920,0.00126,74.125.24.0-255,4320,99952,64,302750
13921,0.001262,172.31.40.0-255,66,100018,64,302750
13922,0.001276,74.125.24.0-255,7156,107174,64,302750
13923,0.001278,172.31.40.0-255,66,107240,64,302750
13924,0.001298,74.125.24.0-255,4320,111560,64,302750
13925,0.0013,172.31.40.0-255,66,111626,64,302750
13926,0.00133,172.31.40.0-255,66,111692,64,302750
13927,0.001334,74.125.24.0-255,2184,113876,64,302750
13928,0.001336,172.31.40.0-255,66,113942,64,302750
13929,0.001368,74.125.24.0-255,1484,115426,64,302750
13930,0.001387,74.125.24.0-255,2902,118328,64,302750
13931,0.001389,172.31.40.0-255,66,118394,64,302750
13932,0.001395,74.125.24.0-255,5738,124132,64,302750
13933,0.001397,172.31.40.0-255,66,124198,64,302750
13934,0.001417,74.125.24.0-255,2902,127100,64,302750
13935,0.001419,172.31.40.0-255,66,127166,64,302750
13936,0.00144,74.125.24.0-255,5738,132904,64,302750
13937,0.001443,172.31.40.0-255,66,132970,64,302750
13938,0.001516,172.31.40.0-255,66,133036,64,302750
13939,0.001531,74.125.24.0-255,5020,138056,64,302750
13940,0.001534,172.31.40.0-255,66,138122,64,302750
13941,0.00199,74.125.24.0-255,1484,139606,64,302750
13942,0.002002,74.125.24.0-255,2902,142508,64,302750
13943,0.002006,172.31.40.0-255,66,142574,64,302750
13944,0.002025,74.125.24.0-255,5738,148312,64,302750
13945,0.002028,172.31.40.0-255,66,148378,64,302750
13946,0.002045,74.125.24.0-255,4320,152698,64,302750
13947,0.002047,172.31.40.0-255,66,152764,64,302750
13948,0.00207,172.31.40.0-255,66,152830,64,302750
13949,0.002073,74.125.24.0-255,1484,154314,64,302750
13950,0.002116,172.31.40.0-255,66,154380,64,302750
13951,0.002194,74.125.24.0-255,1484,155864,64,302750
13952,0.002206,74.125.24.0-255,1484,157348,64,302750
13953,0.002208,172.31.40.0-255,66,157414,64,302750
13954,0.002232,74.125.24.0-255,1484,158898,64,302750
13955,0.002237,74.125.24.0-255,5738,164636,64,302750
13956,0.002244,172.31.40.0-255,66,164702,64,302750
13957,0.002247,74.125.24.0-255,1484,166186,64,302750
13958,0.002277,172.31.40.0-255,66,166252,64,302750
13959,0.003957,172.31.40.0-255,66,166318,64,302750
13960,0.006331,74.125.24.0-255,5738,172056,64,302750
13961,0.006337,172.31.40.0-255,66,172122,64,302750
13962,0.008643,74.125.24.0-255,5738,177860,64,302750
13963,0.008648,172.31.40.0-255,66,177926,64,302750
13964,0.011036,74.125.24.0-255,5738,183664,64,302750
13965,0.011043,172.31.40.0-255,66,183730,64,302750
13966,0.013357,74.125.24.0-255,5738,189468,64,302750
13967,0.013365,172.31.40.0-255,66,189534,64,302750
13968,0.015696,74.125.24.0-255,5738,195272,64,302750
13969,0.015702,172.31.40.0-255,66,195338,64,302750
13970,0.018012,74.125.24.0-255,5738,201076,64,302750
13971,0.018019,172.31.40.0-255,66,201142,64,302750
13972,0.020367,74.125.24.0-255,5738,206880,64,302750
13973,0.020376,172.31.40.0-255,66,206946,64,302750
13974,0.022732,74.125.24.0-255,5738,212684,64,302750
13975,0.022739,172.31.40.0-255,66,212750,64,302750
13976,0.025104,74.125.24.0-255,5738,218488,64,302750
13977,0.025111,172.31.40.0-255,66,218554,64,302750
13978,0.027468,74.125.24.0-255,5738,224292,64,302750
13979,0.027475,172.31.40.0-255,66,224358,64,302750
13980,0.029828,74.125.24.0-255,5738,230096,64,302750
13981,0.029836,172.31.40.0-255,66,230162,64,302750
13982,0.031457,172.31.40.0-255,172,230334,64,302750
13983,0.03149,172.31.40.0-255,1111,231445,64,302750
13984,0.031547,172.31.40.0-255,1514,232959,64,302750
13985,0.031549,172.31.40.0-255,1297,234256,64,302750
13986,0.03217,74.125.24.0-255,4320,238576,64,302750
13987,0.032176,172.31.40.0-255,66,238642,64,302750
13988,0.032194,74.125.24.0-255,1484,240126,64,302750
13989,0.032983,104.244.42.0-255,66,240192,64,302750
13990,0.033043,104.244.42.0-255,66,240258,64,302750
13991,0.033082,104.244.42.0-255,66,240324,64,302750
13992,0.034481,74.125.24.0-255,4320,244644,64,302750
13993,0.034487,172.31.40.0-255,66,244710,64,302750
13994,0.036818,74.125.24.0-255,5738,250448,64,302750
13995,0.036825,172.31.40.0-255,66,250514,64,302750
13996,0.039142,74.125.24.0-255,5738,256252,64,302750
13997,0.039147,172.31.40.0-255,66,256318,64,302750
13998,0.041483,74.125.24.0-255,5738,262056,64,302750
13999,0.041489,172.31.40.0-255,66,262122,64,302750
14000,0.043839,74.125.24.0-255,5738,267860,64,302750
14001,0.043845,172.31.40.0-255,66,267926,64,302750
14002,0.046205,74.125.24.0-255,5738,273664,64,302750
14003,0.046211,172.31.40.0-255,66,273730,64,302750
14004,0.048504,74.125.24.0-255,5738,279468,64,302750
14005,0.048509,172.31.40.0-255,66,279534,64,302750
14006,0.05086,74.125.24.0-255,5738,285272,64,302750
14007,0.050865,172.31.40.0-255,66,285338,64,302750
14008,0.053187,74.125.24.0-255,5738,291076,64,302750
14009,0.053193,172.31.40.0-255,66,291142,64,302750
14010,0.055496,74.125.24.0-255,5738,296880,64,302750
14011,0.055501,172.31.40.0-255,66,296946,64,302750
14012,0.057908,74.125.24.0-255,5738,302684,64,302750
14013,0.057915,172.31.40.0-255,66,302750,64,302750
14014,0.0,172.217.194.0-255,153,153,64,299919
14015,1.7e-05,172.31.40.0-255,66,219,64,299919
14016,2.5e-05,172.217.194.0-255,1484,1703,64,299919
14017,2.9e-05,172.31.40.0-255,66,1769,64,299919
14018,3.6e-05,172.217.194.0-255,2902,4671,64,299919
14019,3.9e-05,172.31.40.0-255,66,4737,64,299919
14020,5.3e-05,172.217.194.0-255,5738,10475,64,299919
14021,5.7e-05,172.31.40.0-255,66,10541,64,299919
14022,7.6e-05,172.217.194.0-255,4320,14861,64,299919
14023,8.3e-05,172.31.40.0-255,66,14927,64,299919
14024,0.000126,172.31.40.0-255,66,14993,64,299919
14025,0.000133,172.217.194.0-255,6797,21790,64,299919
14026,0.000136,172.31.40.0-255,66,21856,64,299919
14027,0.000186,172.217.194.0-255,1484,23340,64,299919
14028,0.000188,172.31.40.0-255,66,23406,64,299919
14029,0.000192,172.217.194.0-255,1484,24890,64,299919
14030,0.000194,172.31.40.0-255,66,24956,64,299919
14031,0.00022,172.217.194.0-255,1484,26440,64,299919
14032,0.000224,172.31.40.0-255,66,26506,64,299919
14033,0.000231,172.217.194.0-255,5738,32244,64,299919
14034,0.000233,172.31.40.0-255,66,32310,64,299919
14035,0.00026,172.217.194.0-255,6797,39107,64,299919
14036,0.000262,172.31.40.0-255,66,39173,64,299919
14037,0.000269,172.217.194.0-255,7156,46329,64,299919
14038,0.000271,172.31.40.0-255,66,46395,64,299919
14039,0.000315,172.31.40.0-255,66,46461,64,299919
14040,0.000334,172.217.194.0-255,1414,47875,64,299919
14041,0.000337,172.31.40.0-255,66,47941,64,299919
14042,0.000429,172.217.194.0-255,366,48307,64,299919
14043,0.000433,172.31.40.0-255,66,48373,64,299919
14044,0.000553,172.217.194.0-255,1484,49857,64,299919
14045,0.000573,172.217.194.0-255,2902,52759,64,299919
14046,0.000576,172.31.40.0-255,66,52825,64,299919
14047,0.000596,172.217.194.0-255,5738,58563,64,299919
14048,0.000605,172.31.40.0-255,66,58629,64,299919
14049,0.00061,172.217.194.0-255,4320,62949,64,299919
14050,0.000613,172.31.40.0-255,66,63015,64,299919
14051,0.000667,172.31.40.0-255,66,63081,64,299919
14052,0.000674,172.31.40.0-255,66,63147,64,299919
14053,0.000741,172.217.194.0-255,1484,64631,64,299919
14054,0.000782,172.217.194.0-255,2902,67533,64,299919
14055,0.000786,172.31.40.0-255,66,67599,64,299919
14056,0.000793,172.217.194.0-255,5738,73337,64,299919
14057,0.000795,172.31.40.0-255,66,73403,64,299919
14058,0.00083,172.31.40.0-255,66,73469,64,299919
14059,0.000855,172.217.194.0-255,1484,74953,64,299919
14060,0.00087,172.31.40.0-255,66,75019,64,299919
14061,0.000931,172.217.194.0-255,7156,82175,64,299919
14062,0.000934,172.31.40.0-255,66,82241,64,299919
14063,0.000961,172.217.194.0-255,5738,87979,64,299919
14064,0.000964,172.31.40.0-255,66,88045,64,299919
14065,0.000975,172.31.40.0-255,66,88111,64,299919
14066,0.000992,172.31.40.0-255,66,88177,64,299919
14067,0.001014,172.217.194.0-255,2184,90361,64,299919
14068,0.001022,172.31.40.0-255,66,90427,64,299919
14069,0.001581,172.217.194.0-255,1484,91911,64,299919
14070,0.001589,172.217.194.0-255,2902,94813,64,299919
14071,0.001593,172.31.40.0-255,66,94879,64,299919
14072,0.0016,172.217.194.0-255,5738,100617,64,299919
14073,0.001602,172.31.40.0-255,66,100683,64,299919
14074,0.001606,172.217.194.0-255,1484,102167,64,299919
14075,0.001646,172.31.40.0-255,66,102233,64,299919
14076,0.001653,172.217.194.0-255,7156,109389,64,299919
14077,0.001655,172.31.40.0-255,66,109455,64,299919
14078,0.001682,172.217.194.0-255,3602,113057,64,299919
14079,0.001685,172.31.40.0-255,66,113123,64,299919
14080,0.001773,172.217.194.0-255,1484,114607,64,299919
14081,0.001786,172.217.194.0-255,2902,117509,64,299919
14082,0.00179,172.31.40.0-255,66,117575,64,299919
14083,0.001827,172.217.194.0-255,5738,123313,64,299919
14084,0.001829,172.31.40.0-255,66,123379,64,299919
14085,0.00184,172.31.40.0-255,66,123445,64,299919
14086,0.001884,172.31.40.0-255,66,123511,64,299919
14087,0.00189,172.217.194.0-255,5020,128531,64,299919
14088,0.001892,172.31.40.0-255,66,128597,64,299919
14089,0.00196,172.217.194.0-255,1484,130081,64,299919
14090,0.003836,172.217.194.0-255,4320,134401,64,299919
14091,0.003843,172.31.40.0-255,66,134467,64,299919
14092,0.005785,172.217.194.0-255,4320,138787,64,299919
14093,0.005791,172.31.40.0-255,66,138853,64,299919
14094,0.005823,172.217.194.0-255,1484,140337,64,299919
14095,0.007747,172.217.194.0-255,4320,144657,64,299919
14096,0.007754,172.31.40.0-255,66,144723,64,299919
14097,0.009705,172.217.194.0-255,5738,150461,64,299919
14098,0.009712,172.31.40.0-255,66,150527,64,299919
14099,0.011682,172.217.194.0-255,5738,156265,64,299919
14100,0.0117,172.31.40.0-255,66,156331,64,299919
14101,0.013624,172.217.194.0-255,5738,162069,64,299919
14102,0.013637,172.31.40.0-255,66,162135,64,299919
14103,0.015566,172.217.194.0-255,5738,167873,64,299919
14104,0.01558,172.31.40.0-255,66,167939,64,299919
14105,0.017527,172.217.194.0-255,5738,173677,64,299919
14106,0.017543,172.31.40.0-255,66,173743,64,299919
14107,0.019479,172.217.194.0-255,5738,179481,64,299919
14108,0.019488,172.31.40.0-255,66,179547,64,299919
14109,0.021415,172.217.194.0-255,5738,185285,64,299919
14110,0.021425,172.31.40.0-255,66,185351,64,299919
14111,0.023392,172.217.194.0-255,5738,191089,64,299919
14112,0.023404,172.31.40.0-255,66,191155,64,299919
14113,0.025408,172.217.194.0-255,5738,196893,64,299919
14114,0.025422,172.31.40.0-255,66,196959,64,299919
14115,0.027379,172.217.194.0-255,5738,202697,64,299919
14116,0.027388,172.31.40.0-255,66,202763,64,299919
14117,0.029334,172.217.194.0-255,5738,208501,64,299919
14118,0.029341,172.31.40.0-255,66,208567,64,299919
14119,0.03131,172.217.194.0-255,5738,214305,64,299919
14120,0.031327,172.31.40.0-255,66,214371,64,299919
14121,0.033309,172.217.194.0-255,5738,220109,64,299919
14122,0.03332,172.31.40.0-255,66,220175,64,299919
14123,0.035279,172.217.194.0-255,5738,225913,64,299919
14124,0.035289,172.31.40.0-255,66,225979,64,299919
14125,0.037246,172.217.194.0-255,5738,231717,64,299919
14126,0.037263,172.31.40.0-255,66,231783,64,299919
14127,0.039208,172.217.194.0-255,5738,237521,64,299919
14128,0.039217,172.31.40.0-255,66,237587,64,299919
14129,0.041168,172.217.194.0-255,5738,243325,64,299919
14130,0.04118,172.31.40.0-255,66,243391,64,299919
14131,0.043163,172.217.194.0-255,5738,249129,64,299919
14132,0.043174,172.31.40.0-255,66,249195,64,299919
14133,0.045158,172.217.194.0-255,5738,254933,64,299919
14134,0.045174,172.31.40.0-255,66,254999,64,299919
14135,0.047098,172.217.194.0-255,5738,260737,64,299919
14136,0.047105,172.31.40.0-255,66,260803,64,299919
14137,0.049079,172.217.194.0-255,5738,266541,64,299919
14138,0.049098,172.31.40.0-255,66,266607,64,299919
14139,0.051043,172.217.194.0-255,5738,272345,64,299919
14140,0.051051,172.31.40.0-255,66,272411,64,299919
14141,0.05111,172.31.40.0-255,172,272583,64,299919
14142,0.051139,172.31.40.0-255,1112,273695,64,299919
14143,0.051252,172.31.40.0-255,1514,275209,64,299919
14144,0.051276,172.31.40.0-255,1296,276505,64,299919
14145,0.052665,104.244.42.0-255,66,276571,64,299919
14146,0.052762,104.244.42.0-255,66,276637,64,299919
14147,0.052811,104.244.42.0-255,66,276703,64,299919
14148,0.052985,172.217.194.0-255,5738,282441,64,299919
14149,0.052992,172.31.40.0-255,66,282507,64,299919
14150,0.054968,172.217.194.0-255,5738,288245,64,299919
14151,0.054986,172.31.40.0-255,66,288311,64,299919
14152,0.056944,172.217.194.0-255,5738,294049,64,299919
14153,0.056959,172.31.40.0-255,66,294115,64,299919
14154,0.058925,172.217.194.0-255,5738,299853,64,299919
14155,0.058944,172.31.40.0-255,66,299919,64,299919
14156,0.0,172.217.24.0-255,153,153,64,240486
14157,1.7e-05,172.31.40.0-255,66,219,64,240486
14158,2.4e-05,172.217.24.0-255,1484,1703,64,240486
14159,2.9e-05,172.31.40.0-255,66,1769,64,240486
14160,3.4e-05,172.217.24.0-255,2902,4671,64,240486
14161,3.6e-05,172.31.40.0-255,66,4737,64,240486
14162,4.2e-05,172.217.24.0-255,4320,9057,64,240486
14163,4.5e-05,172.31.40.0-255,66,9123,64,240486
14164,7.9e-05,172.217.24.0-255,2902,12025,64,240486
14165,8.2e-05,172.31.40.0-255,66,12091,64,240486
14166,9.5e-05,172.217.24.0-255,2126,14217,64,240486
14167,9.8e-05,172.31.40.0-255,66,14283,64,240486
14168,0.000137,172.217.24.0-255,2902,17185,64,240486
14169,0.000139,172.31.40.0-255,66,17251,64,240486
14170,0.000145,172.217.24.0-255,4320,21571,64,240486
14171,0.000147,172.31.40.0-255,66,21637,64,240486
14172,0.000177,172.217.24.0-255,7156,28793,64,240486
14173,0.00018,172.31.40.0-255,66,28859,64,240486
14174,0.000242,172.217.24.0-255,2543,31402,64,240486
14175,0.000246,172.31.40.0-255,66,31468,64,240486
14176,0.000249,172.217.24.0-255,1484,32952,64,240486
14177,0.000252,172.31.40.0-255,66,33018,64,240486
14178,0.000265,172.217.24.0-255,1484,34502,64,240486
14179,0.000267,172.31.40.0-255,66,34568,64,240486
14180,0.000274,172.217.24.0-255,7156,41724,64,240486
14181,0.000277,172.31.40.0-255,66,41790,64,240486
14182,0.000292,172.217.24.0-255,6797,48587,64,240486
14183,0.000295,172.31.40.0-255,66,48653,64,240486
14184,0.000429,172.217.24.0-255,1484,50137,64,240486
14185,0.000434,172.31.40.0-255,66,50203,64,240486
14186,0.000439,172.217.24.0-255,2902,53105,64,240486
14187,0.000441,172.31.40.0-255,66,53171,64,240486
14188,0.000459,172.217.24.0-255,4320,57491,64,240486
14189,0.000462,172.31.40.0-255,66,57557,64,240486
14190,0.000487,172.217.24.0-255,4320,61877,64,240486
14191,0.00049,172.31.40.0-255,66,61943,64,240486
14192,0.00051,172.217.24.0-255,4291,66234,64,240486
14193,0.000513,172.31.40.0-255,66,66300,64,240486
14194,0.002436,172.217.24.0-255,1484,67784,64,240486
14195,0.002459,172.217.24.0-255,4320,72104,64,240486
14196,0.002465,172.31.40.0-255,66,72170,64,240486
14197,0.004411,172.217.24.0-255,5738,77908,64,240486
14198,0.004417,172.31.40.0-255,66,77974,64,240486
14199,0.006352,172.217.24.0-255,5738,83712,64,240486
14200,0.006357,172.31.40.0-255,66,83778,64,240486
14201,0.008296,172.217.24.0-255,5738,89516,64,240486
14202,0.008303,172.31.40.0-255,66,89582,64,240486
14203,0.010244,172.217.24.0-255,5738,95320,64,240486
14204,0.010251,172.31.40.0-255,66,95386,64,240486
14205,0.012196,172.217.24.0-255,5738,101124,64,240486
14206,0.012204,172.31.40.0-255,66,101190,64,240486
14207,0.014146,172.217.24.0-255,5738,106928,64,240486
14208,0.014154,172.31.40.0-255,66,106994,64,240486
14209,0.016095,172.217.24.0-255,5738,112732,64,240486
14210,0.016102,172.31.40.0-255,66,112798,64,240486
14211,0.01806,172.217.24.0-255,5738,118536,64,240486
14212,0.018068,172.31.40.0-255,66,118602,64,240486
14213,0.02004,172.217.24.0-255,5738,124340,64,240486
14214,0.020047,172.31.40.0-255,66,124406,64,240486
14215,0.022012,172.217.24.0-255,5738,130144,64,240486
14216,0.022028,172.31.40.0-255,66,130210,64,240486
14217,0.02402,172.217.24.0-255,5738,135948,64,240486
14218,0.024037,172.31.40.0-255,66,136014,64,240486
14219,0.026004,172.217.24.0-255,5738,141752,64,240486
14220,0.026021,172.31.40.0-255,66,141818,64,240486
14221,0.02802,172.217.24.0-255,5738,147556,64,240486
14222,0.028037,172.31.40.0-255,66,147622,64,240486
14223,0.029992,172.217.24.0-255,5738,153360,64,240486
14224,0.030007,172.31.40.0-255,66,153426,64,240486
14225,0.032014,172.217.24.0-255,5738,159164,64,240486
14226,0.032027,172.31.40.0-255,66,159230,64,240486
14227,0.033984,172.217.24.0-255,5738,164968,64,240486
14228,0.034,172.31.40.0-255,66,165034,64,240486
14229,0.035973,172.217.24.0-255,5738,170772,64,240486
14230,0.035983,172.31.40.0-255,66,170838,64,240486
14231,0.037934,172.217.24.0-255,5738,176576,64,240486
14232,0.037948,172.31.40.0-255,66,176642,64,240486
14233,0.03989,172.217.24.0-255,5738,182380,64,240486
14234,0.039898,172.31.40.0-255,66,182446,64,240486
14235,0.041835,172.217.24.0-255,5738,188184,64,240486
14236,0.041842,172.31.40.0-255,66,188250,64,240486
14237,0.043789,172.217.24.0-255,5738,193988,64,240486
14238,0.043797,172.31.40.0-255,66,194054,64,240486
14239,0.045746,172.217.24.0-255,5738,199792,64,240486
14240,0.045756,172.31.40.0-255,66,199858,64,240486
14241,0.04772,172.217.24.0-255,5738,205596,64,240486
14242,0.047735,172.31.40.0-255,66,205662,64,240486
14243,0.04969,172.217.24.0-255,5738,211400,64,240486
14244,0.049704,172.31.40.0-255,66,211466,64,240486
14245,0.051649,172.217.24.0-255,5738,217204,64,240486
14246,0.051657,172.31.40.0-255,66,217270,64,240486
14247,0.053608,172.217.24.0-255,5738,223008,64,240486
14248,0.053615,172.31.40.0-255,66,223074,64,240486
14249,0.055562,172.217.24.0-255,5738,228812,64,240486
14250,0.055569,172.31.40.0-255,66,228878,64,240486
14251,0.057513,172.217.24.0-255,5738,234616,64,240486
14252,0.05752,172.31.40.0-255,66,234682,64,240486
14253,0.059461,172.217.24.0-255,5738,240420,64,240486
14254,0.059468,172.31.40.0-255,66,240486,64,240486
14255,0.0,172.217.160.0-255,150,150,64,331875
14256,2.2e-05,172.31.40.0-255,66,216,64,331875
14257,2.9e-05,172.217.160.0-255,1484,1700,64,331875
14258,3.3e-05,172.31.40.0-255,66,1766,64,331875
14259,4e-05,172.217.160.0-255,2902,4668,64,331875
14260,4.3e-05,172.31.40.0-255,66,4734,64,331875
14261,5.1e-05,172.217.160.0-255,7156,11890,64,331875
14262,5.4e-05,172.31.40.0-255,66,11956,64,331875
14263,5.8e-05,172.217.160.0-255,1983,13939,64,331875
14264,6.1e-05,172.31.40.0-255,66,14005,64,331875
14265,8.9e-05,172.217.160.0-255,2902,16907,64,331875
14266,9.2e-05,172.31.40.0-255,66,16973,64,331875
14267,0.0001,172.217.160.0-255,7156,24129,64,331875
14268,0.000102,172.31.40.0-255,66,24195,64,331875
14269,0.000108,172.217.160.0-255,6797,30992,64,331875
14270,0.00011,172.31.40.0-255,66,31058,64,331875
14271,0.00033,172.217.160.0-255,1484,32542,64,331875
14272,0.000335,172.31.40.0-255,66,32608,64,331875
14273,0.000345,172.217.160.0-255,2902,35510,64,331875
14274,0.000347,172.31.40.0-255,66,35576,64,331875
14275,0.000352,172.217.160.0-255,4320,39896,64,331875
14276,0.000354,172.31.40.0-255,66,39962,64,331875
14277,0.000398,172.217.160.0-255,4320,44282,64,331875
14278,0.000402,172.31.40.0-255,66,44348,64,331875
14279,0.000418,172.217.160.0-255,3961,48309,64,331875
14280,0.00042,172.31.40.0-255,66,48375,64,331875
14281,0.000576,172.217.160.0-255,1484,49859,64,331875
14282,0.00058,172.217.160.0-255,2902,52761,64,331875
14283,0.000584,172.31.40.0-255,66,52827,64,331875
14284,0.000587,172.31.40.0-255,66,52893,64,331875
14285,0.000603,172.217.160.0-255,5738,58631,64,331875
14286,0.000605,172.31.40.0-255,66,58697,64,331875
14287,0.000612,172.217.160.0-255,6797,65494,64,331875
14288,0.000627,172.31.40.0-255,66,65560,64,331875
14289,0.000631,172.217.160.0-255,374,65934,64,331875
14290,0.000906,172.31.40.0-255,66,66000,64,331875
14291,0.001082,172.217.160.0-255,101,66101,64,331875
14292,0.001213,172.217.160.0-255,1484,67585,64,331875
14293,0.001219,172.31.40.0-255,66,67651,64,331875
14294,0.001226,172.217.160.0-255,2902,70553,64,331875
14295,0.001233,172.217.160.0-255,5738,76291,64,331875
14296,0.001237,172.217.160.0-255,2902,79193,64,331875
14297,0.00128,172.217.160.0-255,4320,83513,64,331875
14298,0.001301,172.217.160.0-255,6797,90310,64,331875
14299,0.001332,172.217.160.0-255,4320,94630,64,331875
14300,0.001353,172.217.160.0-255,5379,100009,64,331875
14301,0.001517,172.217.160.0-255,1484,101493,64,331875
14302,0.001525,172.217.160.0-255,2902,104395,64,331875
14303,0.001548,172.217.160.0-255,5738,110133,64,331875
14304,0.001577,172.217.160.0-255,1484,111617,64,331875
14305,0.001633,172.217.160.0-255,1484,113101,64,331875
14306,0.001649,172.217.160.0-255,2902,116003,64,331875
14307,0.001673,172.217.160.0-255,5738,121741,64,331875
14308,0.001678,172.217.160.0-255,2902,124643,64,331875
14309,0.001714,172.217.160.0-255,7156,131799,64,331875
14310,0.00174,172.217.160.0-255,3602,135401,64,331875
14311,0.001862,172.217.160.0-255,1484,136885,64,331875
14312,0.001869,172.217.160.0-255,2902,139787,64,331875
14313,0.001877,172.217.160.0-255,5738,145525,64,331875
14314,0.00188,172.217.160.0-255,1484,147009,64,331875
14315,0.001897,172.217.160.0-255,2902,149911,64,331875
14316,0.001901,172.217.160.0-255,1484,151395,64,331875
14317,0.00194,172.217.160.0-255,2902,154297,64,331875
14318,0.001963,172.217.160.0-255,5020,159317,64,331875
14319,0.003197,172.31.40.0-255,66,159383,64,331875
14320,0.005167,172.217.160.0-255,5738,165121,64,331875
14321,0.005173,172.31.40.0-255,66,165187,64,331875
14322,0.007103,172.217.160.0-255,5738,170925,64,331875
14323,0.007108,172.31.40.0-255,66,170991,64,331875
14324,0.009036,172.217.160.0-255,5738,176729,64,331875
14325,0.009042,172.31.40.0-255,66,176795,64,331875
14326,0.010967,172.217.160.0-255,5738,182533,64,331875
14327,0.010973,172.31.40.0-255,66,182599,64,331875
14328,0.012912,172.217.160.0-255,5738,188337,64,331875
14329,0.013263,172.31.40.0-255,66,188403,64,331875
14330,0.015195,172.217.160.0-255,5738,194141,64,331875
14331,0.015202,172.31.40.0-255,66,194207,64,331875
14332,0.017133,172.217.160.0-255,5738,199945,64,331875
14333,0.01714,172.31.40.0-255,66,200011,64,331875
14334,0.019078,172.217.160.0-255,5738,205749,64,331875
14335,0.019086,172.31.40.0-255,66,205815,64,331875
14336,0.021034,172.217.160.0-255,5738,211553,64,331875
14337,0.021041,172.31.40.0-255,66,211619,64,331875
14338,0.02298,172.217.160.0-255,5738,217357,64,331875
14339,0.022988,172.31.40.0-255,66,217423,64,331875
14340,0.024932,172.217.160.0-255,5738,223161,64,331875
14341,0.024939,172.31.40.0-255,66,223227,64,331875
14342,0.026862,172.217.160.0-255,5738,228965,64,331875
14343,0.026869,172.31.40.0-255,66,229031,64,331875
14344,0.028164,172.31.40.0-255,172,229203,64,331875
14345,0.02821,172.31.40.0-255,1112,230315,64,331875
14346,0.028273,172.31.40.0-255,1514,231829,64,331875
14347,0.028275,172.31.40.0-255,1180,233009,64,331875
14348,0.028805,172.217.160.0-255,5738,238747,64,331875
14349,0.028813,172.31.40.0-255,66,238813,64,331875
14350,0.0297,104.244.42.0-255,66,238879,64,331875
14351,0.029754,104.244.42.0-255,66,238945,64,331875
14352,0.02984,104.244.42.0-255,66,239011,64,331875
14353,0.030752,172.217.160.0-255,5738,244749,64,331875
14354,0.030758,172.31.40.0-255,66,244815,64,331875
14355,0.032692,172.217.160.0-255,5738,250553,64,331875
14356,0.032698,172.31.40.0-255,66,250619,64,331875
14357,0.034665,172.217.160.0-255,5738,256357,64,331875
14358,0.03467,172.31.40.0-255,66,256423,64,331875
14359,0.036601,172.217.160.0-255,5738,262161,64,331875
14360,0.036607,172.31.40.0-255,66,262227,64,331875
14361,0.038536,172.217.160.0-255,5738,267965,64,331875
14362,0.038543,172.31.40.0-255,66,268031,64,331875
14363,0.040478,172.217.160.0-255,5738,273769,64,331875
14364,0.040484,172.31.40.0-255,66,273835,64,331875
14365,0.042418,172.217.160.0-255,5738,279573,64,331875
14366,0.042425,172.31.40.0-255,66,279639,64,331875
14367,0.044364,172.217.160.0-255,5738,285377,64,331875
14368,0.04437,172.31.40.0-255,66,285443,64,331875
14369,0.046304,172.217.160.0-255,5738,291181,64,331875
14370,0.04631,172.31.40.0-255,66,291247,64,331875
14371,0.048294,172.217.160.0-255,5738,296985,64,331875
14372,0.0483,172.31.40.0-255,66,297051,64,331875
14373,0.05023,172.217.160.0-255,5738,302789,64,331875
14374,0.050239,172.31.40.0-255,66,302855,64,331875
14375,0.052176,172.217.160.0-255,5738,308593,64,331875
14376,0.052185,172.31.40.0-255,66,308659,64,331875
14377,0.054123,172.217.160.0-255,5738,314397,64,331875
14378,0.05413,172.31.40.0-255,66,314463,64,331875
14379,0.056072,172.217.160.0-255,5738,320201,64,331875
14380,0.056081,172.31.40.0-255,66,320267,64,331875
14381,0.05802,172.217.160.0-255,5738,326005,64,331875
14382,0.058026,172.31.40.0-255,66,326071,64,331875
14383,0.059971,172.217.160.0-255,5738,331809,64,331875
14384,0.059978,172.31.40.0-255,66,331875,64,331875
14385,0.0,74.125.130.0-255,150,150,64,323370
14386,2.5e-05,172.31.40.0-255,66,216,64,323370
14387,3.2e-05,74.125.130.0-255,1484,1700,64,323370
14388,3.6e-05,172.31.40.0-255,66,1766,64,323370
14389,4.2e-05,74.125.130.0-255,2902,4668,64,323370
14390,4.5e-05,172.31.40.0-255,66,4734,64,323370
14391,7.9e-05,74.125.130.0-255,5738,10472,64,323370
14392,8.3e-05,172.31.40.0-255,66,10538,64,323370
14393,8.6e-05,74.125.130.0-255,1484,12022,64,323370
14394,8.8e-05,172.31.40.0-255,66,12088,64,323370
14395,9.2e-05,74.125.130.0-255,2064,14152,64,323370
14396,9.5e-05,172.31.40.0-255,66,14218,64,323370
14397,0.000116,74.125.130.0-255,5738,19956,64,323370
14398,0.000119,172.31.40.0-255,66,20022,64,323370
14399,0.000152,74.125.130.0-255,7156,27178,64,323370
14400,0.000155,172.31.40.0-255,66,27244,64,323370
14401,0.000197,74.125.130.0-255,3961,31205,64,323370
14402,0.0002,172.31.40.0-255,66,31271,64,323370
14403,0.000285,74.125.130.0-255,1484,32755,64,323370
14404,0.000289,172.31.40.0-255,66,32821,64,323370
14405,0.000301,74.125.130.0-255,1484,34305,64,323370
14406,0.000303,172.31.40.0-255,66,34371,64,323370
14407,0.000315,74.125.130.0-255,1484,35855,64,323370
14408,0.000317,172.31.40.0-255,66,35921,64,323370
14409,0.00032,74.125.130.0-255,1484,37405,64,323370
14410,0.000322,172.31.40.0-255,66,37471,64,323370
14411,0.000328,74.125.130.0-255,2902,40373,64,323370
14412,0.000331,172.31.40.0-255,66,40439,64,323370
14413,0.000349,74.125.130.0-255,4320,44759,64,323370
14414,0.000352,172.31.40.0-255,66,44825,64,323370
14415,0.000375,74.125.130.0-255,1484,46309,64,323370
14416,0.000377,172.31.40.0-255,66,46375,64,323370
14417,0.000383,74.125.130.0-255,4320,50695,64,323370
14418,0.000385,172.31.40.0-255,66,50761,64,323370
14419,0.00039,74.125.130.0-255,4320,55081,64,323370
14420,0.000392,172.31.40.0-255,66,55147,64,323370
14421,0.000408,74.125.130.0-255,1484,56631,64,323370
14422,0.000426,74.125.130.0-255,7156,63787,64,323370
14423,0.000429,172.31.40.0-255,66,63853,64,323370
14424,0.000449,74.125.130.0-255,2184,66037,64,323370
14425,0.000452,172.31.40.0-255,66,66103,64,323370
14426,0.000455,74.125.130.0-255,343,66446,64,323370
14427,0.000797,74.125.130.0-255,120,66566,64,323370
14428,0.001095,74.125.130.0-255,1484,68050,64,323370
14429,0.001101,172.31.40.0-255,66,68116,64,323370
14430,0.001107,74.125.130.0-255,2902,71018,64,323370
14431,0.001111,172.31.40.0-255,66,71084,64,323370
14432,0.001118,74.125.130.0-255,5738,76822,64,323370
14433,0.001121,172.31.40.0-255,66,76888,64,323370
14434,0.001165,74.125.130.0-255,7156,84044,64,323370
14435,0.001169,172.31.40.0-255,66,84110,64,323370
14436,0.001175,74.125.130.0-255,5738,89848,64,323370
14437,0.001178,172.31.40.0-255,66,89914,64,323370
14438,0.001207,74.125.130.0-255,7156,97070,64,323370
14439,0.00121,172.31.40.0-255,66,97136,64,323370
14440,0.00123,74.125.130.0-255,3602,100738,64,323370
14441,0.001232,172.31.40.0-255,66,100804,64,323370
14442,0.002473,74.125.130.0-255,1484,102288,64,323370
14443,0.002483,74.125.130.0-255,2902,105190,64,323370
14444,0.002488,172.31.40.0-255,66,105256,64,323370
14445,0.002506,74.125.130.0-255,1484,106740,64,323370
14446,0.002529,74.125.130.0-255,4320,111060,64,323370
14447,0.002532,172.31.40.0-255,66,111126,64,323370
14448,0.002545,74.125.130.0-255,2902,114028,64,323370
14449,0.002547,172.31.40.0-255,66,114094,64,323370
14450,0.002564,74.125.130.0-255,4320,118414,64,323370
14451,0.002566,172.31.40.0-255,66,118480,64,323370
14452,0.002571,74.125.130.0-255,2902,121382,64,323370
14453,0.002572,172.31.40.0-255,66,121448,64,323370
14454,0.00259,74.125.130.0-255,4320,125768,64,323370
14455,0.002593,172.31.40.0-255,66,125834,64,323370
14456,0.002612,74.125.130.0-255,1484,127318,64,323370
14457,0.002638,74.125.130.0-255,4320,131638,64,323370
14458,0.002641,172.31.40.0-255,66,131704,64,323370
14459,0.002644,74.125.130.0-255,1484,133188,64,323370
14460,0.002666,74.125.130.0-255,2184,135372,64,323370
14461,0.002669,172.31.40.0-255,66,135438,64,323370
14462,0.003391,74.125.130.0-255,1484,136922,64,323370
14463,0.003407,74.125.130.0-255,2902,139824,64,323370
14464,0.003411,172.31.40.0-255,66,139890,64,323370
14465,0.00343,74.125.130.0-255,2902,142792,64,323370
14466,0.003432,172.31.40.0-255,66,142858,64,323370
14467,0.003437,74.125.130.0-255,2902,145760,64,323370
14468,0.003439,172.31.40.0-255,66,145826,64,323370
14469,0.003464,74.125.130.0-255,1484,147310,64,323370
14470,0.003475,172.31.40.0-255,66,147376,64,323370
14471,0.00348,74.125.130.0-255,2902,150278,64,323370
14472,0.003482,172.31.40.0-255,66,150344,64,323370
14473,0.003535,74.125.130.0-255,2902,153246,64,323370
14474,0.003537,172.31.40.0-255,66,153312,64,323370
14475,0.003565,172.31.40.0-255,66,153378,64,323370
14476,0.003576,172.31.40.0-255,66,153444,64,323370
14477,0.003592,74.125.130.0-255,2902,156346,64,323370
14478,0.003594,172.31.40.0-255,66,156412,64,323370
14479,0.003599,74.125.130.0-255,4320,160732,64,323370
14480,0.003601,172.31.40.0-255,66,160798,64,323370
14481,0.003625,74.125.130.0-255,1484,162282,64,323370
14482,0.003628,172.31.40.0-255,78,162360,64,323370
14483,0.003636,74.125.130.0-255,7156,169516,64,323370
14484,0.003639,172.31.40.0-255,78,169594,64,323370
14485,0.003656,74.125.130.0-255,7156,176750,64,323370
14486,0.00366,172.31.40.0-255,66,176816,64,323370
14487,0.003662,74.125.130.0-255,1484,178300,64,323370
14488,0.003665,74.125.130.0-255,766,179066,64,323370
14489,0.003667,172.31.40.0-255,66,179132,64,323370
14490,0.003829,74.125.130.0-255,1484,180616,64,323370
14491,0.003844,74.125.130.0-255,2902,183518,64,323370
14492,0.003847,172.31.40.0-255,66,183584,64,323370
14493,0.003873,74.125.130.0-255,5738,189322,64,323370
14494,0.003876,172.31.40.0-255,66,189388,64,323370
14495,0.003914,74.125.130.0-255,4320,193708,64,323370
14496,0.003916,172.31.40.0-255,66,193774,64,323370
14497,0.003932,74.125.130.0-255,1484,195258,64,323370
14498,0.00394,74.125.130.0-255,7156,202414,64,323370
14499,0.003943,172.31.40.0-255,66,202480,64,323370
14500,0.003954,172.31.40.0-255,66,202546,64,323370
14501,0.003967,74.125.130.0-255,766,203312,64,323370
14502,0.003994,74.125.130.0-255,1484,204796,64,323370
14503,0.003996,172.31.40.0-255,66,204862,64,323370
14504,0.004023,74.125.130.0-255,2902,207764,64,323370
14505,0.004025,172.31.40.0-255,66,207830,64,323370
14506,0.004044,74.125.130.0-255,1484,209314,64,323370
14507,0.004049,74.125.130.0-255,2902,212216,64,323370
14508,0.004051,172.31.40.0-255,66,212282,64,323370
14509,0.004063,74.125.130.0-255,1484,213766,64,323370
14510,0.00409,74.125.130.0-255,4320,218086,64,323370
14511,0.004093,172.31.40.0-255,66,218152,64,323370
14512,0.004099,74.125.130.0-255,5738,223890,64,323370
14513,0.004102,172.31.40.0-255,66,223956,64,323370
14514,0.004109,74.125.130.0-255,7156,231112,64,323370
14515,0.004111,172.31.40.0-255,66,231178,64,323370
14516,0.004129,74.125.130.0-255,1484,232662,64,323370
14517,0.004145,74.125.130.0-255,5020,237682,64,323370
14518,0.004148,172.31.40.0-255,66,237748,64,323370
14519,0.004151,74.125.130.0-255,1484,239232,64,323370
14520,0.004171,74.125.130.0-255,5738,244970,64,323370
14521,0.004174,172.31.40.0-255,66,245036,64,323370
14522,0.004187,74.125.130.0-255,1484,246520,64,323370
14523,0.004215,172.31.40.0-255,66,246586,64,323370
14524,0.004221,74.125.130.0-255,4320,250906,64,323370
14525,0.004223,172.31.40.0-255,66,250972,64,323370
14526,0.00425,172.31.40.0-255,66,251038,64,323370
14527,0.004254,74.125.130.0-255,2184,253222,64,323370
14528,0.004256,172.31.40.0-255,66,253288,64,323370
14529,0.00426,74.125.130.0-255,2902,256190,64,323370
14530,0.004262,172.31.40.0-255,66,256256,64,323370
14531,0.004288,74.125.130.0-255,5738,261994,64,323370
14532,0.00429,172.31.40.0-255,66,262060,64,323370
14533,0.004293,74.125.130.0-255,1484,263544,64,323370
14534,0.004315,74.125.130.0-255,5738,269282,64,323370
14535,0.004317,172.31.40.0-255,66,269348,64,323370
14536,0.004342,74.125.130.0-255,5738,275086,64,323370
14537,0.004344,172.31.40.0-255,66,275152,64,323370
14538,0.004371,172.31.40.0-255,66,275218,64,323370
14539,0.004399,74.125.130.0-255,6438,281656,64,323370
14540,0.004402,172.31.40.0-255,66,281722,64,323370
14541,0.004408,74.125.130.0-255,7156,288878,64,323370
14542,0.004411,172.31.40.0-255,66,288944,64,323370
14543,0.004439,74.125.130.0-255,4320,293264,64,323370
14544,0.004441,172.31.40.0-255,66,293330,64,323370
14545,0.004485,74.125.130.0-255,2902,296232,64,323370
14546,0.004513,74.125.130.0-255,3602,299834,64,323370
14547,0.004543,74.125.130.0-255,5738,305572,64,323370
14548,0.00459,74.125.130.0-255,2902,308474,64,323370
14549,0.004673,74.125.130.0-255,6438,314912,64,323370
14550,0.004684,74.125.130.0-255,1484,316396,64,323370
14551,0.004697,74.125.130.0-255,2340,318736,64,323370
14552,0.004749,74.125.130.0-255,105,318841,64,323370
14553,0.010587,172.31.40.0-255,66,318907,64,323370
14554,0.013006,172.31.40.0-255,105,319012,64,323370
14555,0.01551,74.125.130.0-255,66,319078,64,323370
14556,0.051496,172.31.40.0-255,172,319250,64,323370
14557,0.051529,172.31.40.0-255,1112,320362,64,323370
14558,0.051587,172.31.40.0-255,1514,321876,64,323370
14559,0.051589,172.31.40.0-255,1296,323172,64,323370
14560,0.053067,104.244.42.0-255,66,323238,64,323370
14561,0.053093,104.244.42.0-255,66,323304,64,323370
14562,0.053139,104.244.42.0-255,66,323370,64,323370
14563,0.0,74.125.130.0-255,151,151,64,336455
14564,2.3e-05,172.31.40.0-255,66,217,64,336455
14565,3.1e-05,74.125.130.0-255,1484,1701,64,336455
14566,3.6e-05,172.31.40.0-255,66,1767,64,336455
14567,4.1e-05,74.125.130.0-255,2902,4669,64,336455
14568,5.1e-05,172.31.40.0-255,66,4735,64,336455
14569,5.5e-05,74.125.130.0-255,1484,6219,64,336455
14570,5.7e-05,172.31.40.0-255,66,6285,64,336455
14571,6.3e-05,74.125.130.0-255,2902,9187,64,336455
14572,6.6e-05,172.31.40.0-255,66,9253,64,336455
14573,8.5e-05,74.125.130.0-255,4906,14159,64,336455
14574,9.2e-05,172.31.40.0-255,66,14225,64,336455
14575,0.000193,74.125.130.0-255,1484,15709,64,336455
14576,0.000196,172.31.40.0-255,66,15775,64,336455
14577,0.000204,74.125.130.0-255,2902,18677,64,336455
14578,0.000206,172.31.40.0-255,66,18743,64,336455
14579,0.000218,74.125.130.0-255,5738,24481,64,336455
14580,0.000221,172.31.40.0-255,66,24547,64,336455
14581,0.000255,74.125.130.0-255,4320,28867,64,336455
14582,0.000258,172.31.40.0-255,66,28933,64,336455
14583,0.000279,74.125.130.0-255,5379,34312,64,336455
14584,0.000282,172.31.40.0-255,66,34378,64,336455
14585,0.000286,74.125.130.0-255,2902,37280,64,336455
14586,0.000301,172.31.40.0-255,66,37346,64,336455
14587,0.000307,74.125.130.0-255,4320,41666,64,336455
14588,0.00031,172.31.40.0-255,66,41732,64,336455
14589,0.000357,74.125.130.0-255,6797,48529,64,336455
14590,0.00036,172.31.40.0-255,66,48595,64,336455
14591,0.000406,74.125.130.0-255,1484,50079,64,336455
14592,0.000409,172.31.40.0-255,66,50145,64,336455
14593,0.00044,74.125.130.0-255,2902,53047,64,336455
14594,0.000443,172.31.40.0-255,66,53113,64,336455
14595,0.000448,74.125.130.0-255,2902,56015,64,336455
14596,0.00045,172.31.40.0-255,66,56081,64,336455
14597,0.00046,74.125.130.0-255,4320,60401,64,336455
14598,0.000462,172.31.40.0-255,66,60467,64,336455
14599,0.000484,74.125.130.0-255,2902,63369,64,336455
14600,0.000486,172.31.40.0-255,66,63435,64,336455
14601,0.000508,74.125.130.0-255,2816,66251,64,336455
14602,0.000511,172.31.40.0-255,66,66317,64,336455
14603,0.000568,74.125.130.0-255,1484,67801,64,336455
14604,0.000584,74.125.130.0-255,2902,70703,64,336455
14605,0.000587,172.31.40.0-255,66,70769,64,336455
14606,0.000592,74.125.130.0-255,4320,75089,64,336455
14607,0.000595,172.31.40.0-255,66,75155,64,336455
14608,0.000642,74.125.130.0-255,5738,80893,64,336455
14609,0.000645,172.31.40.0-255,66,80959,64,336455
14610,0.000659,74.125.130.0-255,3961,84920,64,336455
14611,0.000665,172.31.40.0-255,66,84986,64,336455
14612,0.000677,172.31.40.0-255,66,85052,64,336455
14613,0.000714,74.125.130.0-255,5674,90726,64,336455
14614,0.000717,172.31.40.0-255,66,90792,64,336455
14615,0.000802,74.125.130.0-255,1484,92276,64,336455
14616,0.000823,74.125.130.0-255,2902,95178,64,336455
14617,0.000826,172.31.40.0-255,66,95244,64,336455
14618,0.000832,74.125.130.0-255,5738,100982,64,336455
14619,0.000835,172.31.40.0-255,66,101048,64,336455
14620,0.000844,74.125.130.0-255,2902,103950,64,336455
14621,0.000846,172.31.40.0-255,66,104016,64,336455
14622,0.000851,74.125.130.0-255,2902,106918,64,336455
14623,0.000853,172.31.40.0-255,66,106984,64,336455
14624,0.000878,74.125.130.0-255,1484,108468,64,336455
14625,0.000893,172.31.40.0-255,66,108534,64,336455
14626,0.0009,74.125.130.0-255,7156,115690,64,336455
14627,0.000902,172.31.40.0-255,66,115756,64,336455
14628,0.000953,74.125.130.0-255,766,116522,64,336455
14629,0.000977,74.125.130.0-255,1484,118006,64,336455
14630,0.00098,172.31.40.0-255,66,118072,64,336455
14631,0.000983,74.125.130.0-255,1484,119556,64,336455
14632,0.001007,74.125.130.0-255,2902,122458,64,336455
14633,0.00101,172.31.40.0-255,66,122524,64,336455
14634,0.001016,74.125.130.0-255,5738,128262,64,336455
14635,0.001019,172.31.40.0-255,66,128328,64,336455
14636,0.001047,74.125.130.0-255,4320,132648,64,336455
14637,0.00105,172.31.40.0-255,66,132714,64,336455
14638,0.001078,74.125.130.0-255,7156,139870,64,336455
14639,0.001081,172.31.40.0-255,66,139936,64,336455
14640,0.00111,172.31.40.0-255,66,140002,64,336455
14641,0.001144,74.125.130.0-255,1484,141486,64,336455
14642,0.001158,74.125.130.0-255,2902,144388,64,336455
14643,0.00116,172.31.40.0-255,66,144454,64,336455
14644,0.001192,74.125.130.0-255,5738,150192,64,336455
14645,0.001195,172.31.40.0-255,66,150258,64,336455
14646,0.0012,74.125.130.0-255,5738,155996,64,336455
14647,0.001202,172.31.40.0-255,66,156062,64,336455
14648,0.001236,74.125.130.0-255,7156,163218,64,336455
14649,0.001239,172.31.40.0-255,66,163284,64,336455
14650,0.001242,74.125.130.0-255,1484,164768,64,336455
14651,0.001275,172.31.40.0-255,66,164834,64,336455
14652,0.001641,74.125.130.0-255,1484,166318,64,336455
14653,0.001647,74.125.130.0-255,2902,169220,64,336455
14654,0.00165,172.31.40.0-255,66,169286,64,336455
14655,0.001678,74.125.130.0-255,5738,175024,64,336455
14656,0.001681,172.31.40.0-255,66,175090,64,336455
14657,0.001713,172.31.40.0-255,66,175156,64,336455
14658,0.001717,74.125.130.0-255,1484,176640,64,336455
14659,0.001748,172.31.40.0-255,66,176706,64,336455
14660,0.001752,74.125.130.0-255,2184,178890,64,336455
14661,0.001754,172.31.40.0-255,66,178956,64,336455
14662,0.001901,74.125.130.0-255,1484,180440,64,336455
14663,0.001915,74.125.130.0-255,2902,183342,64,336455
14664,0.001918,172.31.40.0-255,66,183408,64,336455
14665,0.001924,74.125.130.0-255,2902,186310,64,336455
14666,0.001926,172.31.40.0-255,66,186376,64,336455
14667,0.001949,74.125.130.0-255,2902,189278,64,336455
14668,0.001951,172.31.40.0-255,66,189344,64,336455
14669,0.001968,74.125.130.0-255,7156,196500,64,336455
14670,0.001971,172.31.40.0-255,66,196566,64,336455
14671,0.001979,74.125.130.0-255,7156,203722,64,336455
14672,0.001981,172.31.40.0-255,66,203788,64,336455
14673,0.002014,74.125.130.0-255,1484,205272,64,336455
14674,0.002026,172.31.40.0-255,66,205338,64,336455
14675,0.002098,74.125.130.0-255,1484,206822,64,336455
14676,0.002102,74.125.130.0-255,1484,208306,64,336455
14677,0.002105,172.31.40.0-255,66,208372,64,336455
14678,0.002128,74.125.130.0-255,1484,209856,64,336455
14679,0.002135,74.125.130.0-255,5738,215594,64,336455
14680,0.002137,172.31.40.0-255,66,215660,64,336455
14681,0.002172,172.31.40.0-255,66,215726,64,336455
14682,0.00219,74.125.130.0-255,4320,220046,64,336455
14683,0.002193,172.31.40.0-255,66,220112,64,336455
14684,0.002218,172.31.40.0-255,66,220178,64,336455
14685,0.00348,172.31.40.0-255,101,220279,64,336455
14686,0.004474,74.125.130.0-255,5738,226017,64,336455
14687,0.004496,172.31.40.0-255,66,226083,64,336455
14688,0.005705,74.125.130.0-255,66,226149,64,336455
14689,0.006778,74.125.130.0-255,5738,231887,64,336455
14690,0.006785,172.31.40.0-255,66,231953,64,336455
14691,0.009039,74.125.130.0-255,5738,237691,64,336455
14692,0.009046,172.31.40.0-255,66,237757,64,336455
14693,0.011296,74.125.130.0-255,5738,243495,64,336455
14694,0.011299,172.31.40.0-255,66,243561,64,336455
14695,0.013567,74.125.130.0-255,5738,249299,64,336455
14696,0.013582,172.31.40.0-255,66,249365,64,336455
14697,0.015849,74.125.130.0-255,5738,255103,64,336455
14698,0.015864,172.31.40.0-255,66,255169,64,336455
14699,0.018131,74.125.130.0-255,5738,260907,64,336455
14700,0.018138,172.31.40.0-255,66,260973,64,336455
14701,0.0204,74.125.130.0-255,5738,266711,64,336455
14702,0.020409,172.31.40.0-255,66,266777,64,336455
14703,0.022677,74.125.130.0-255,5738,272515,64,336455
14704,0.022685,172.31.40.0-255,66,272581,64,336455
14705,0.024952,74.125.130.0-255,5738,278319,64,336455
14706,0.02496,172.31.40.0-255,66,278385,64,336455
14707,0.027221,74.125.130.0-255,5738,284123,64,336455
14708,0.02723,172.31.40.0-255,66,284189,64,336455
14709,0.029491,74.125.130.0-255,5738,289927,64,336455
14710,0.029501,172.31.40.0-255,66,289993,64,336455
14711,0.031764,74.125.130.0-255,5738,295731,64,336455
14712,0.031777,172.31.40.0-255,66,295797,64,336455
14713,0.034036,74.125.130.0-255,5738,301535,64,336455
14714,0.034043,172.31.40.0-255,66,301601,64,336455
14715,0.036315,74.125.130.0-255,5738,307339,64,336455
14716,0.036323,172.31.40.0-255,66,307405,64,336455
14717,0.038598,74.125.130.0-255,5738,313143,64,336455
14718,0.038613,172.31.40.0-255,66,313209,64,336455
14719,0.040877,74.125.130.0-255,5738,318947,64,336455
14720,0.040889,172.31.40.0-255,66,319013,64,336455
14721,0.043165,74.125.130.0-255,5738,324751,64,336455
14722,0.043182,172.31.40.0-255,66,324817,64,336455
14723,0.045453,74.125.130.0-255,5738,330555,64,336455
14724,0.045461,172.31.40.0-255,66,330621,64,336455
14725,0.047725,74.125.130.0-255,1369,331990,64,336455
14726,0.048015,172.31.40.0-255,105,332095,64,336455
14727,0.051195,172.31.40.0-255,172,332267,64,336455
14728,0.051227,172.31.40.0-255,1112,333379,64,336455
14729,0.051285,172.31.40.0-255,1514,334893,64,336455
14730,0.051287,172.31.40.0-255,1298,336191,64,336455
14731,0.05268,104.244.42.0-255,66,336257,64,336455
14732,0.052729,104.244.42.0-255,66,336323,64,336455
14733,0.052794,104.244.42.0-255,66,336389,64,336455
14734,0.053983,74.125.130.0-255,66,336455,64,336455
14735,0.0,172.217.194.0-255,146,146,64,236106
14736,2.2e-05,172.31.40.0-255,66,212,64,236106
14737,2.9e-05,172.217.194.0-255,1484,1696,64,236106
14738,3.3e-05,172.31.40.0-255,66,1762,64,236106
14739,3.9e-05,172.217.194.0-255,2902,4664,64,236106
14740,4.2e-05,172.31.40.0-255,66,4730,64,236106
14741,5e-05,172.217.194.0-255,7156,11886,64,236106
14742,5.2e-05,172.31.40.0-255,66,11952,64,236106
14743,5.7e-05,172.217.194.0-255,2001,13953,64,236106
14744,5.9e-05,172.31.40.0-255,66,14019,64,236106
14745,6.3e-05,172.217.194.0-255,2902,16921,64,236106
14746,6.6e-05,172.31.40.0-255,66,16987,64,236106
14747,9.4e-05,172.217.194.0-255,7156,24143,64,236106
14748,9.7e-05,172.31.40.0-255,66,24209,64,236106
14749,0.000142,172.31.40.0-255,66,24275,64,236106
14750,0.000168,172.31.40.0-255,66,24341,64,236106
14751,0.000262,172.217.194.0-255,1484,25825,64,236106
14752,0.000266,172.31.40.0-255,66,25891,64,236106
14753,0.000279,172.217.194.0-255,2902,28793,64,236106
14754,0.000281,172.31.40.0-255,66,28859,64,236106
14755,0.000297,172.217.194.0-255,5738,34597,64,236106
14756,0.0003,172.31.40.0-255,66,34663,64,236106
14757,0.000303,172.217.194.0-255,1484,36147,64,236106
14758,0.000305,172.31.40.0-255,66,36213,64,236106
14759,0.000328,172.217.194.0-255,1484,37697,64,236106
14760,0.00033,172.31.40.0-255,66,37763,64,236106
14761,0.000367,172.217.194.0-255,4542,42305,64,236106
14762,0.00037,172.31.40.0-255,66,42371,64,236106
14763,0.000411,172.217.194.0-255,1484,43855,64,236106
14764,0.000413,172.31.40.0-255,66,43921,64,236106
14765,0.000426,172.217.194.0-255,2902,46823,64,236106
14766,0.000428,172.31.40.0-255,66,46889,64,236106
14767,0.000455,172.217.194.0-255,5738,52627,64,236106
14768,0.000458,172.31.40.0-255,66,52693,64,236106
14769,0.000461,172.217.194.0-255,1484,54177,64,236106
14770,0.000463,172.31.40.0-255,66,54243,64,236106
14771,0.00049,172.217.194.0-255,1484,55727,64,236106
14772,0.000492,172.31.40.0-255,66,55793,64,236106
14773,0.000514,172.31.40.0-255,66,55859,64,236106
14774,0.00052,172.217.194.0-255,5738,61597,64,236106
14775,0.000522,172.31.40.0-255,66,61663,64,236106
14776,0.00057,172.217.194.0-255,4320,65983,64,236106
14777,0.000579,172.31.40.0-255,66,66049,64,236106
14778,0.000583,172.217.194.0-255,2543,68592,64,236106
14779,0.000586,172.31.40.0-255,66,68658,64,236106
14780,0.000778,172.217.194.0-255,1484,70142,64,236106
14781,0.000786,172.217.194.0-255,2902,73044,64,236106
14782,0.00079,172.31.40.0-255,66,73110,64,236106
14783,0.000815,172.217.194.0-255,5738,78848,64,236106
14784,0.000819,172.31.40.0-255,66,78914,64,236106
14785,0.000823,172.217.194.0-255,2902,81816,64,236106
14786,0.000825,172.31.40.0-255,66,81882,64,236106
14787,0.000864,172.31.40.0-255,66,81948,64,236106
14788,0.000878,172.217.194.0-255,1484,83432,64,236106
14789,0.00089,172.217.194.0-255,2902,86334,64,236106
14790,0.000893,172.31.40.0-255,66,86400,64,236106
14791,0.000919,172.217.194.0-255,6438,92838,64,236106
14792,0.000922,172.31.40.0-255,66,92904,64,236106
14793,0.000964,172.217.194.0-255,1484,94388,64,236106
14794,0.000968,172.217.194.0-255,1484,95872,64,236106
14795,0.00097,172.31.40.0-255,66,95938,64,236106
14796,0.000985,172.217.194.0-255,1484,97422,64,236106
14797,0.000992,172.217.194.0-255,5738,103160,64,236106
14798,0.000995,172.31.40.0-255,66,103226,64,236106
14799,0.001025,172.217.194.0-255,7156,110382,64,236106
14800,0.001028,172.31.40.0-255,66,110448,64,236106
14801,0.001051,172.217.194.0-255,5738,116186,64,236106
14802,0.001054,172.31.40.0-255,66,116252,64,236106
14803,0.001104,172.31.40.0-255,66,116318,64,236106
14804,0.001164,172.217.194.0-255,1484,117802,64,236106
14805,0.001186,172.217.194.0-255,2902,120704,64,236106
14806,0.001188,172.31.40.0-255,66,120770,64,236106
14807,0.001196,172.217.194.0-255,5738,126508,64,236106
14808,0.001207,172.217.194.0-255,1484,127992,64,236106
14809,0.001222,172.217.194.0-255,5738,133730,64,236106
14810,0.001227,172.31.40.0-255,66,133796,64,236106
14811,0.001256,172.217.194.0-255,5738,139534,64,236106
14812,0.001268,172.217.194.0-255,766,140300,64,236106
14813,0.001286,172.31.40.0-255,66,140366,64,236106
14814,0.001332,172.217.194.0-255,1484,141850,64,236106
14815,0.001336,172.217.194.0-255,1484,143334,64,236106
14816,0.001348,172.217.194.0-255,1484,144818,64,236106
14817,0.001355,172.217.194.0-255,5738,150556,64,236106
14818,0.001358,172.31.40.0-255,66,150622,64,236106
14819,0.001371,172.217.194.0-255,4320,154942,64,236106
14820,0.001377,172.31.40.0-255,66,155008,64,236106
14821,0.001397,172.217.194.0-255,7156,162164,64,236106
14822,0.001416,172.217.194.0-255,2902,165066,64,236106
14823,0.001424,172.31.40.0-255,66,165132,64,236106
14824,0.001435,172.217.194.0-255,5738,170870,64,236106
14825,0.00144,172.31.40.0-255,66,170936,64,236106
14826,0.0015,172.31.40.0-255,66,171002,64,236106
14827,0.001549,172.217.194.0-255,5738,176740,64,236106
14828,0.001588,172.217.194.0-255,2184,178924,64,236106
14829,0.001592,172.31.40.0-255,66,178990,64,236106
14830,0.001602,172.217.194.0-255,2902,181892,64,236106
14831,0.001623,172.217.194.0-255,4320,186212,64,236106
14832,0.001628,172.217.194.0-255,2902,189114,64,236106
14833,0.001647,172.217.194.0-255,5738,194852,64,236106
14834,0.001652,172.31.40.0-255,66,194918,64,236106
14835,0.0017,172.217.194.0-255,6438,201356,64,236106
14836,0.001712,172.31.40.0-255,66,201422,64,236106
14837,0.001724,172.217.194.0-255,1484,202906,64,236106
14838,0.001729,172.217.194.0-255,2902,205808,64,236106
14839,0.001747,172.31.40.0-255,66,205874,64,236106
14840,0.001754,172.217.194.0-255,5738,211612,64,236106
14841,0.001759,172.217.194.0-255,4320,215932,64,236106
14842,0.001764,172.31.40.0-255,66,215998,64,236106
14843,0.001803,172.217.194.0-255,2902,218900,64,236106
14844,0.00181,172.31.40.0-255,66,218966,64,236106
14845,0.001832,172.217.194.0-255,2902,221868,64,236106
14846,0.001847,172.31.40.0-255,66,221934,64,236106
14847,0.001899,172.31.40.0-255,66,222000,64,236106
14848,0.001907,172.217.194.0-255,1484,223484,64,236106
14849,0.001921,172.217.194.0-255,4320,227804,64,236106
14850,0.001933,172.31.40.0-255,66,227870,64,236106
14851,0.001943,172.217.194.0-255,3541,231411,64,236106
14852,0.00195,172.31.40.0-255,66,231477,64,236106
14853,0.001961,172.217.194.0-255,105,231582,64,236106
14854,0.011073,172.31.40.0-255,66,231648,64,236106
14855,0.011112,172.31.40.0-255,105,231753,64,236106
14856,0.013056,172.217.194.0-255,66,231819,64,236106
14857,0.037255,172.31.40.0-255,167,231986,64,236106
14858,0.037289,172.31.40.0-255,1111,233097,64,236106
14859,0.037349,172.31.40.0-255,1514,234611,64,236106
14860,0.03735,172.31.40.0-255,1297,235908,64,236106
14861,0.038782,104.244.42.0-255,66,235974,64,236106
14862,0.038823,104.244.42.0-255,66,236040,64,236106
14863,0.038867,104.244.42.0-255,66,236106,64,236106
14864,0.0,172.217.194.0-255,153,153,64,314725
14865,1.1e-05,172.31.40.0-255,66,219,64,314725
14866,4.8e-05,172.217.194.0-255,1484,1703,64,314725
14867,5.3e-05,172.31.40.0-255,66,1769,64,314725
14868,5.9e-05,172.217.194.0-255,2902,4671,64,314725
14869,6.1e-05,172.31.40.0-255,66,4737,64,314725
14870,9.8e-05,172.217.194.0-255,5738,10475,64,314725
14871,0.000101,172.31.40.0-255,66,10541,64,314725
14872,0.000104,172.217.194.0-255,1484,12025,64,314725
14873,0.000106,172.31.40.0-255,66,12091,64,314725
14874,0.00014,172.217.194.0-255,2030,14121,64,314725
14875,0.000143,172.31.40.0-255,66,14187,64,314725
14876,0.000233,172.217.194.0-255,1484,15671,64,314725
14877,0.000238,172.31.40.0-255,66,15737,64,314725
14878,0.000264,172.217.194.0-255,2902,18639,64,314725
14879,0.000267,172.31.40.0-255,66,18705,64,314725
14880,0.00027,172.217.194.0-255,1484,20189,64,314725
14881,0.000272,172.31.40.0-255,66,20255,64,314725
14882,0.000311,172.217.194.0-255,4320,24575,64,314725
14883,0.000313,172.31.40.0-255,66,24641,64,314725
14884,0.00032,172.217.194.0-255,6797,31438,64,314725
14885,0.000323,172.31.40.0-255,66,31504,64,314725
14886,0.000329,172.217.194.0-255,7156,38660,64,314725
14887,0.000334,172.31.40.0-255,66,38726,64,314725
14888,0.000385,172.31.40.0-255,66,38792,64,314725
14889,0.000392,172.217.194.0-255,7156,45948,64,314725
14890,0.000396,172.31.40.0-255,66,46014,64,314725
14891,0.000415,172.217.194.0-255,3602,49616,64,314725
14892,0.000417,172.31.40.0-255,66,49682,64,314725
14893,0.000462,172.217.194.0-255,646,50328,64,314725
14894,0.000465,172.31.40.0-255,66,50394,64,314725
14895,0.000597,172.217.194.0-255,1484,51878,64,314725
14896,0.000603,172.217.194.0-255,2902,54780,64,314725
14897,0.000607,172.31.40.0-255,66,54846,64,314725
14898,0.00064,172.217.194.0-255,4320,59166,64,314725
14899,0.000643,172.31.40.0-255,66,59232,64,314725
14900,0.000689,172.217.194.0-255,2902,62134,64,314725
14901,0.000692,172.31.40.0-255,66,62200,64,314725
14902,0.000724,172.217.194.0-255,4320,66520,64,314725
14903,0.000727,172.31.40.0-255,66,66586,64,314725
14904,0.000741,172.31.40.0-255,66,66652,64,314725
14905,0.000747,172.217.194.0-255,5020,71672,64,314725
14906,0.000749,172.31.40.0-255,66,71738,64,314725
14907,0.00085,172.217.194.0-255,1484,73222,64,314725
14908,0.000855,172.217.194.0-255,1484,74706,64,314725
14909,0.000858,172.31.40.0-255,66,74772,64,314725
14910,0.000884,172.217.194.0-255,1484,76256,64,314725
14911,0.000889,172.217.194.0-255,2902,79158,64,314725
14912,0.000892,172.31.40.0-255,66,79224,64,314725
14913,0.00093,172.217.194.0-255,2902,82126,64,314725
14914,0.000934,172.31.40.0-255,66,82192,64,314725
14915,0.000947,172.31.40.0-255,66,82258,64,314725
14916,0.000958,172.31.40.0-255,66,82324,64,314725
14917,0.00098,172.217.194.0-255,2184,84508,64,314725
14918,0.000983,172.31.40.0-255,66,84574,64,314725
14919,0.001009,172.217.194.0-255,2902,87476,64,314725
14920,0.001011,172.31.40.0-255,66,87542,64,314725
14921,0.001017,172.217.194.0-255,4320,91862,64,314725
14922,0.001019,172.31.40.0-255,66,91928,64,314725
14923,0.001065,172.217.194.0-255,2902,94830,64,314725
14924,0.001068,172.31.40.0-255,66,94896,64,314725
14925,0.00108,172.31.40.0-255,66,94962,64,314725
14926,0.001092,172.31.40.0-255,66,95028,64,314725
14927,0.001098,172.217.194.0-255,5020,100048,64,314725
14928,0.001105,172.217.194.0-255,5738,105786,64,314725
14929,0.00111,172.31.40.0-255,66,105852,64,314725
14930,0.001112,172.31.40.0-255,66,105918,64,314725
14931,0.001139,172.31.40.0-255,66,105984,64,314725
14932,0.001172,172.217.194.0-255,4320,110304,64,314725
14933,0.001175,172.31.40.0-255,66,110370,64,314725
14934,0.001186,172.31.40.0-255,66,110436,64,314725
14935,0.001216,172.217.194.0-255,6438,116874,64,314725
14936,0.00122,172.31.40.0-255,66,116940,64,314725
14937,0.001585,172.217.194.0-255,1484,118424,64,314725
14938,0.0016,172.217.194.0-255,2902,121326,64,314725
14939,0.001604,172.31.40.0-255,66,121392,64,314725
14940,0.001608,172.217.194.0-255,1484,122876,64,314725
14941,0.001636,172.217.194.0-255,4320,127196,64,314725
14942,0.001638,172.31.40.0-255,66,127262,64,314725
14943,0.001645,172.217.194.0-255,5738,133000,64,314725
14944,0.001648,172.31.40.0-255,66,133066,64,314725
14945,0.001668,172.217.194.0-255,2902,135968,64,314725
14946,0.001675,172.31.40.0-255,66,136034,64,314725
14947,0.001686,172.31.40.0-255,66,136100,64,314725
14948,0.001718,172.217.194.0-255,5020,141120,64,314725
14949,0.001721,172.31.40.0-255,66,141186,64,314725
14950,0.001759,172.217.194.0-255,1484,142670,64,314725
14951,0.001772,172.217.194.0-255,2902,145572,64,314725
14952,0.001775,172.31.40.0-255,66,145638,64,314725
14953,0.001801,172.217.194.0-255,1484,147122,64,314725
14954,0.001808,172.217.194.0-255,5738,152860,64,314725
14955,0.001811,172.31.40.0-255,66,152926,64,314725
14956,0.001841,172.217.194.0-255,2902,155828,64,314725
14957,0.001844,172.31.40.0-255,66,155894,64,314725
14958,0.001878,172.31.40.0-255,66,155960,64,314725
14959,0.001885,172.217.194.0-255,5738,161698,64,314725
14960,0.001887,172.31.40.0-255,66,161764,64,314725
14961,0.001954,172.217.194.0-255,3602,165366,64,314725
14962,0.001957,172.31.40.0-255,66,165432,64,314725
14963,0.002189,172.217.194.0-255,1484,166916,64,314725
14964,0.002194,172.217.194.0-255,1484,168400,64,314725
14965,0.002197,172.31.40.0-255,66,168466,64,314725
14966,0.002224,172.217.194.0-255,1484,169950,64,314725
14967,0.002254,172.217.194.0-255,2902,172852,64,314725
14968,0.002257,172.31.40.0-255,66,172918,64,314725
14969,0.002287,172.217.194.0-255,2902,175820,64,314725
14970,0.002289,172.31.40.0-255,66,175886,64,314725
14971,0.002297,172.217.194.0-255,7156,183042,64,314725
14972,0.002299,172.31.40.0-255,66,183108,64,314725
14973,0.004567,172.217.194.0-255,5738,188846,64,314725
14974,0.004574,172.31.40.0-255,66,188912,64,314725
14975,0.006843,172.217.194.0-255,5738,194650,64,314725
14976,0.006857,172.31.40.0-255,66,194716,64,314725
14977,0.00912,172.217.194.0-255,5738,200454,64,314725
14978,0.009133,172.31.40.0-255,66,200520,64,314725
14979,0.01137,172.217.194.0-255,5738,206258,64,314725
14980,0.011377,172.31.40.0-255,66,206324,64,314725
14981,0.013626,172.217.194.0-255,2902,209226,64,314725
14982,0.013633,172.31.40.0-255,66,209292,64,314725
14983,0.013659,172.217.194.0-255,2902,212194,64,314725
14984,0.013662,172.31.40.0-255,66,212260,64,314725
14985,0.015877,172.217.194.0-255,2902,215162,64,314725
14986,0.015883,172.31.40.0-255,66,215228,64,314725
14987,0.015941,172.217.194.0-255,2902,218130,64,314725
14988,0.015944,172.31.40.0-255,66,218196,64,314725
14989,0.018159,172.217.194.0-255,2902,221098,64,314725
14990,0.018175,172.31.40.0-255,66,221164,64,314725
14991,0.018207,172.217.194.0-255,2902,224066,64,314725
14992,0.01821,172.31.40.0-255,66,224132,64,314725
14993,0.020452,172.217.194.0-255,2902,227034,64,314725
14994,0.020471,172.31.40.0-255,66,227100,64,314725
14995,0.020511,172.217.194.0-255,2902,230002,64,314725
14996,0.020515,172.31.40.0-255,66,230068,64,314725
14997,0.022717,172.217.194.0-255,2902,232970,64,314725
14998,0.022725,172.31.40.0-255,66,233036,64,314725
14999,0.022754,172.217.194.0-255,2902,235938,64,314725
15000,0.022757,172.31.40.0-255,66,236004,64,314725
15001,0.02498,172.217.194.0-255,2902,238906,64,314725
15002,0.024987,172.31.40.0-255,66,238972,64,314725
15003,0.025021,172.217.194.0-255,2902,241874,64,314725
15004,0.025025,172.31.40.0-255,66,241940,64,314725
15005,0.027223,172.217.194.0-255,2902,244842,64,314725
15006,0.02723,172.31.40.0-255,66,244908,64,314725
15007,0.027262,172.217.194.0-255,2902,247810,64,314725
15008,0.027266,172.31.40.0-255,66,247876,64,314725
15009,0.029463,172.217.194.0-255,2902,250778,64,314725
15010,0.02948,172.31.40.0-255,66,250844,64,314725
15011,0.029517,172.217.194.0-255,2902,253746,64,314725
15012,0.02952,172.31.40.0-255,66,253812,64,314725
15013,0.031754,172.217.194.0-255,2902,256714,64,314725
15014,0.031762,172.31.40.0-255,66,256780,64,314725
15015,0.031784,172.217.194.0-255,2902,259682,64,314725
15016,0.031787,172.31.40.0-255,66,259748,64,314725
15017,0.033985,172.217.194.0-255,2902,262650,64,314725
15018,0.033992,172.31.40.0-255,66,262716,64,314725
15019,0.034031,172.217.194.0-255,2902,265618,64,314725
15020,0.034033,172.31.40.0-255,66,265684,64,314725
15021,0.036276,172.217.194.0-255,5738,271422,64,314725
15022,0.036292,172.31.40.0-255,66,271488,64,314725
15023,0.038541,172.217.194.0-255,5738,277226,64,314725
15024,0.03855,172.31.40.0-255,66,277292,64,314725
15025,0.040797,172.217.194.0-255,5738,283030,64,314725
15026,0.040807,172.31.40.0-255,66,283096,64,314725
15027,0.04305,172.217.194.0-255,5738,288834,64,314725
15028,0.043072,172.31.40.0-255,66,288900,64,314725
15029,0.045338,172.217.194.0-255,5738,294638,64,314725
15030,0.045346,172.31.40.0-255,66,294704,64,314725
15031,0.047598,172.217.194.0-255,5738,300442,64,314725
15032,0.047613,172.31.40.0-255,66,300508,64,314725
15033,0.049885,172.217.194.0-255,5738,306246,64,314725
15034,0.049894,172.31.40.0-255,66,306312,64,314725
15035,0.052181,172.217.194.0-255,3885,310197,64,314725
15036,0.052207,172.31.40.0-255,66,310263,64,314725
15037,0.052539,172.31.40.0-255,105,310368,64,314725
15038,0.054742,172.217.194.0-255,66,310434,64,314725
15039,0.05537,172.31.40.0-255,171,310605,64,314725
15040,0.055399,172.31.40.0-255,1136,311741,64,314725
15041,0.05545,172.31.40.0-255,1514,313255,64,314725
15042,0.055453,172.31.40.0-255,1272,314527,64,314725
15043,0.056908,104.244.42.0-255,66,314593,64,314725
15044,0.056973,104.244.42.0-255,66,314659,64,314725
15045,0.057002,104.244.42.0-255,66,314725,64,314725
15046,0.0,172.31.40.0-255,105,105,64,459
15047,0.000264,172.31.40.0-255,90,195,64,459
15048,0.000275,172.31.40.0-255,66,261,64,459
15049,0.00248,74.125.68.0-255,66,327,64,459
15050,0.002501,74.125.68.0-255,66,393,64,459
15051,0.002516,172.31.40.0-255,66,459,64,459
15052,0.0,172.217.194.0-255,297,297,64,280061
15053,2.3e-05,172.31.40.0-255,66,363,64,280061
15054,3e-05,172.217.194.0-255,1484,1847,64,280061
15055,3.4e-05,172.31.40.0-255,66,1913,64,280061
15056,4.9e-05,172.217.194.0-255,4320,6233,64,280061
15057,5.2e-05,172.31.40.0-255,66,6299,64,280061
15058,9.8e-05,172.31.40.0-255,66,6365,64,280061
15059,0.000215,172.217.194.0-255,1484,7849,64,280061
15060,0.000218,172.31.40.0-255,66,7915,64,280061
15061,0.000242,172.217.194.0-255,2902,10817,64,280061
15062,0.000244,172.31.40.0-255,66,10883,64,280061
15063,0.000249,172.217.194.0-255,2902,13785,64,280061
15064,0.000252,172.31.40.0-255,66,13851,64,280061
15065,0.00028,172.217.194.0-255,2902,16753,64,280061
15066,0.000283,172.31.40.0-255,66,16819,64,280061
15067,0.000286,172.217.194.0-255,1484,18303,64,280061
15068,0.000288,172.31.40.0-255,66,18369,64,280061
15069,0.000293,172.217.194.0-255,2902,21271,64,280061
15070,0.000298,172.31.40.0-255,66,21337,64,280061
15071,0.000334,172.217.194.0-255,4320,25657,64,280061
15072,0.000341,172.31.40.0-255,66,25723,64,280061
15073,0.000342,172.31.40.0-255,66,25789,64,280061
15074,0.000361,172.217.194.0-255,3961,29750,64,280061
15075,0.000364,172.31.40.0-255,66,29816,64,280061
15076,0.00133,172.217.194.0-255,1484,31300,64,280061
15077,0.001336,172.31.40.0-255,66,31366,64,280061
15078,0.001345,172.217.194.0-255,2902,34268,64,280061
15079,0.001346,172.31.40.0-255,66,34334,64,280061
15080,0.001357,172.217.194.0-255,5738,40072,64,280061
15081,0.001358,172.31.40.0-255,66,40138,64,280061
15082,0.001403,172.31.40.0-255,66,40204,64,280061
15083,0.001443,172.217.194.0-255,2902,43106,64,280061
15084,0.001446,172.31.40.0-255,66,43172,64,280061
15085,0.001483,172.31.40.0-255,66,43238,64,280061
15086,0.001495,172.31.40.0-255,66,43304,64,280061
15087,0.001547,172.217.194.0-255,4540,47844,64,280061
15088,0.00155,172.31.40.0-255,66,47910,64,280061
15089,0.001556,172.217.194.0-255,5738,53648,64,280061
15090,0.001558,172.31.40.0-255,66,53714,64,280061
15091,0.001581,172.217.194.0-255,4320,58034,64,280061
15092,0.001583,172.31.40.0-255,66,58100,64,280061
15093,0.00161,172.217.194.0-255,4817,62917,64,280061
15094,0.001613,172.31.40.0-255,66,62983,64,280061
15095,0.001705,172.217.194.0-255,1484,64467,64,280061
15096,0.001723,172.217.194.0-255,2902,67369,64,280061
15097,0.001727,172.31.40.0-255,66,67435,64,280061
15098,0.001733,172.217.194.0-255,5738,73173,64,280061
15099,0.001735,172.31.40.0-255,66,73239,64,280061
15100,0.00174,172.217.194.0-255,4320,77559,64,280061
15101,0.001746,172.31.40.0-255,66,77625,64,280061
15102,0.00179,172.31.40.0-255,66,77691,64,280061
15103,0.001801,172.217.194.0-255,1484,79175,64,280061
15104,0.001821,172.217.194.0-255,3602,82777,64,280061
15105,0.001823,172.31.40.0-255,66,82843,64,280061
15106,0.00202,172.217.194.0-255,1484,84327,64,280061
15107,0.002027,172.217.194.0-255,2902,87229,64,280061
15108,0.002031,172.31.40.0-255,66,87295,64,280061
15109,0.002035,172.217.194.0-255,1484,88779,64,280061
15110,0.002067,172.217.194.0-255,4320,93099,64,280061
15111,0.00207,172.31.40.0-255,66,93165,64,280061
15112,0.002083,172.31.40.0-255,66,93231,64,280061
15113,0.002091,172.217.194.0-255,2902,96133,64,280061
15114,0.002093,172.31.40.0-255,66,96199,64,280061
15115,0.002128,172.31.40.0-255,66,96265,64,280061
15116,0.002164,172.217.194.0-255,1484,97749,64,280061
15117,0.002179,172.217.194.0-255,2902,100651,64,280061
15118,0.002182,172.31.40.0-255,66,100717,64,280061
15119,0.002187,172.217.194.0-255,4320,105037,64,280061
15120,0.002189,172.31.40.0-255,66,105103,64,280061
15121,0.002206,172.217.194.0-255,1484,106587,64,280061
15122,0.002211,172.217.194.0-255,4320,110907,64,280061
15123,0.002213,172.31.40.0-255,66,110973,64,280061
15124,0.002246,172.31.40.0-255,66,111039,64,280061
15125,0.002252,172.217.194.0-255,7156,118195,64,280061
15126,0.002254,172.31.40.0-255,66,118261,64,280061
15127,0.002283,172.217.194.0-255,3602,121863,64,280061
15128,0.002286,172.31.40.0-255,66,121929,64,280061
15129,0.002293,172.217.194.0-255,7156,129085,64,280061
15130,0.002295,172.31.40.0-255,66,129151,64,280061
15131,0.002307,172.217.194.0-255,4320,133471,64,280061
15132,0.002309,172.31.40.0-255,66,133537,64,280061
15133,0.002322,172.31.40.0-255,66,133603,64,280061
15134,0.002329,172.217.194.0-255,1484,135087,64,280061
15135,0.002365,172.31.40.0-255,66,135153,64,280061
15136,0.00475,172.217.194.0-255,5738,140891,64,280061
15137,0.004756,172.31.40.0-255,66,140957,64,280061
15138,0.007155,172.217.194.0-255,5738,146695,64,280061
15139,0.007161,172.31.40.0-255,66,146761,64,280061
15140,0.009533,172.217.194.0-255,5738,152499,64,280061
15141,0.00954,172.31.40.0-255,66,152565,64,280061
15142,0.011919,172.217.194.0-255,5738,158303,64,280061
15143,0.011926,172.31.40.0-255,66,158369,64,280061
15144,0.014319,172.217.194.0-255,5738,164107,64,280061
15145,0.014327,172.31.40.0-255,66,164173,64,280061
15146,0.016683,172.217.194.0-255,5738,169911,64,280061
15147,0.016693,172.31.40.0-255,66,169977,64,280061
15148,0.019092,172.217.194.0-255,5738,175715,64,280061
15149,0.0191,172.31.40.0-255,66,175781,64,280061
15150,0.021487,172.217.194.0-255,5738,181519,64,280061
15151,0.021495,172.31.40.0-255,66,181585,64,280061
15152,0.023885,172.217.194.0-255,5738,187323,64,280061
15153,0.023891,172.31.40.0-255,66,187389,64,280061
15154,0.026267,172.217.194.0-255,5738,193127,64,280061
15155,0.026274,172.31.40.0-255,66,193193,64,280061
15156,0.028622,172.217.194.0-255,5738,198931,64,280061
15157,0.02863,172.31.40.0-255,66,198997,64,280061
15158,0.031012,172.217.194.0-255,5738,204735,64,280061
15159,0.031021,172.31.40.0-255,66,204801,64,280061
15160,0.033417,172.217.194.0-255,5738,210539,64,280061
15161,0.033429,172.31.40.0-255,66,210605,64,280061
15162,0.035797,172.217.194.0-255,5738,216343,64,280061
15163,0.035803,172.31.40.0-255,66,216409,64,280061
15164,0.035951,172.31.40.0-255,172,216581,64,280061
15165,0.035976,172.31.40.0-255,1112,217693,64,280061
15166,0.036014,172.31.40.0-255,1514,219207,64,280061
15167,0.036015,172.31.40.0-255,1296,220503,64,280061
15168,0.037555,104.244.42.0-255,66,220569,64,280061
15169,0.037561,104.244.42.0-255,66,220635,64,280061
15170,0.037585,104.244.42.0-255,66,220701,64,280061
15171,0.038167,172.217.194.0-255,2902,223603,64,280061
15172,0.03817,172.31.40.0-255,66,223669,64,280061
15173,0.038208,172.217.194.0-255,2902,226571,64,280061
15174,0.038211,172.31.40.0-255,66,226637,64,280061
15175,0.040531,172.217.194.0-255,2902,229539,64,280061
15176,0.040552,172.31.40.0-255,66,229605,64,280061
15177,0.040587,172.217.194.0-255,2902,232507,64,280061
15178,0.040592,172.31.40.0-255,66,232573,64,280061
15179,0.042933,172.217.194.0-255,2902,235475,64,280061
15180,0.042939,172.31.40.0-255,66,235541,64,280061
15181,0.042968,172.217.194.0-255,2902,238443,64,280061
15182,0.042971,172.31.40.0-255,66,238509,64,280061
15183,0.045301,172.217.194.0-255,2902,241411,64,280061
15184,0.045307,172.31.40.0-255,66,241477,64,280061
15185,0.045348,172.217.194.0-255,2902,244379,64,280061
15186,0.045351,172.31.40.0-255,66,244445,64,280061
15187,0.047656,172.217.194.0-255,2902,247347,64,280061
15188,0.047664,172.31.40.0-255,66,247413,64,280061
15189,0.047722,172.217.194.0-255,2902,250315,64,280061
15190,0.047726,172.31.40.0-255,66,250381,64,280061
15191,0.050027,172.217.194.0-255,2902,253283,64,280061
15192,0.050031,172.31.40.0-255,66,253349,64,280061
15193,0.050084,172.217.194.0-255,2902,256251,64,280061
15194,0.050089,172.31.40.0-255,66,256317,64,280061
15195,0.052383,172.217.194.0-255,1484,257801,64,280061
15196,0.052415,172.217.194.0-255,1484,259285,64,280061
15197,0.052419,172.31.40.0-255,66,259351,64,280061
15198,0.052471,172.217.194.0-255,2902,262253,64,280061
15199,0.052474,172.31.40.0-255,66,262319,64,280061
15200,0.054815,172.217.194.0-255,2902,265221,64,280061
15201,0.054819,172.31.40.0-255,66,265287,64,280061
15202,0.054856,172.217.194.0-255,1484,266771,64,280061
15203,0.054869,172.217.194.0-255,1484,268255,64,280061
15204,0.054874,172.31.40.0-255,66,268321,64,280061
15205,0.057211,172.217.194.0-255,2902,271223,64,280061
15206,0.057217,172.31.40.0-255,66,271289,64,280061
15207,0.057249,172.217.194.0-255,2902,274191,64,280061
15208,0.057251,172.31.40.0-255,66,274257,64,280061
15209,0.059612,172.217.194.0-255,5738,279995,64,280061
15210,0.059621,172.31.40.0-255,66,280061,64,280061
15211,0.0,172.217.194.0-255,153,153,64,225336
15212,2.2e-05,172.31.40.0-255,66,219,64,225336
15213,3e-05,172.217.194.0-255,1484,1703,64,225336
15214,3.4e-05,172.31.40.0-255,66,1769,64,225336
15215,4e-05,172.217.194.0-255,2902,4671,64,225336
15216,5.1e-05,172.31.40.0-255,66,4737,64,225336
15217,5.8e-05,172.217.194.0-255,7156,11893,64,225336
15218,6.1e-05,172.31.40.0-255,66,11959,64,225336
15219,9.9e-05,172.217.194.0-255,2041,14000,64,225336
15220,0.000102,172.31.40.0-255,66,14066,64,225336
15221,0.000107,172.217.194.0-255,2902,16968,64,225336
15222,0.000109,172.31.40.0-255,66,17034,64,225336
15223,0.000135,172.217.194.0-255,7156,24190,64,225336
15224,0.000137,172.31.40.0-255,66,24256,64,225336
15225,0.000141,172.217.194.0-255,2902,27158,64,225336
15226,0.000143,172.31.40.0-255,66,27224,64,225336
15227,0.000167,172.217.194.0-255,3961,31185,64,225336
15228,0.000173,172.31.40.0-255,66,31251,64,225336
15229,0.000242,172.217.194.0-255,1484,32735,64,225336
15230,0.000244,172.31.40.0-255,66,32801,64,225336
15231,0.000264,172.217.194.0-255,2902,35703,64,225336
15232,0.000266,172.31.40.0-255,66,35769,64,225336
15233,0.000272,172.217.194.0-255,5738,41507,64,225336
15234,0.000274,172.31.40.0-255,66,41573,64,225336
15235,0.00029,172.217.194.0-255,1484,43057,64,225336
15236,0.000291,172.31.40.0-255,66,43123,64,225336
15237,0.00032,172.217.194.0-255,5379,48502,64,225336
15238,0.000322,172.31.40.0-255,66,48568,64,225336
15239,0.000369,172.31.40.0-255,66,48634,64,225336
15240,0.000373,172.217.194.0-255,2795,51429,64,225336
15241,0.000375,172.31.40.0-255,66,51495,64,225336
15242,0.000378,172.217.194.0-255,119,51614,64,225336
15243,0.000428,172.217.194.0-255,1484,53098,64,225336
15244,0.000431,172.31.40.0-255,66,53164,64,225336
15245,0.000436,172.217.194.0-255,2902,56066,64,225336
15246,0.000438,172.31.40.0-255,66,56132,64,225336
15247,0.000441,172.217.194.0-255,1484,57616,64,225336
15248,0.000454,172.217.194.0-255,1484,59100,64,225336
15249,0.000456,172.31.40.0-255,66,59166,64,225336
15250,0.000483,172.217.194.0-255,7156,66322,64,225336
15251,0.000486,172.31.40.0-255,66,66388,64,225336
15252,0.000488,172.217.194.0-255,1484,67872,64,225336
15253,0.000536,172.31.40.0-255,66,67938,64,225336
15254,0.000539,172.217.194.0-255,860,68798,64,225336
15255,0.000559,172.217.194.0-255,2902,71700,64,225336
15256,0.000565,172.31.40.0-255,66,71766,64,225336
15257,0.000611,172.31.40.0-255,66,71832,64,225336
15258,0.000614,172.217.194.0-255,1484,73316,64,225336
15259,0.000618,172.217.194.0-255,2902,76218,64,225336
15260,0.00062,172.31.40.0-255,66,76284,64,225336
15261,0.000625,172.217.194.0-255,2902,79186,64,225336
15262,0.000627,172.31.40.0-255,66,79252,64,225336
15263,0.000641,172.217.194.0-255,2902,82154,64,225336
15264,0.000647,172.31.40.0-255,66,82220,64,225336
15265,0.00068,172.217.194.0-255,1484,83704,64,225336
15266,0.000703,172.217.194.0-255,5379,89083,64,225336
15267,0.000706,172.31.40.0-255,66,89149,64,225336
15268,0.000712,172.217.194.0-255,5738,94887,64,225336
15269,0.000715,172.31.40.0-255,66,94953,64,225336
15270,0.000722,172.217.194.0-255,5738,100691,64,225336
15271,0.000724,172.31.40.0-255,66,100757,64,225336
15272,0.000751,172.217.194.0-255,1484,102241,64,225336
15273,0.000767,172.31.40.0-255,66,102307,64,225336
15274,0.000774,172.217.194.0-255,6438,108745,64,225336
15275,0.000777,172.31.40.0-255,66,108811,64,225336
15276,0.000828,172.217.194.0-255,1484,110295,64,225336
15277,0.000846,172.217.194.0-255,2902,113197,64,225336
15278,0.000849,172.31.40.0-255,66,113263,64,225336
15279,0.000884,172.217.194.0-255,5738,119001,64,225336
15280,0.000887,172.31.40.0-255,66,119067,64,225336
15281,0.000894,172.217.194.0-255,5738,124805,64,225336
15282,0.000896,172.31.40.0-255,66,124871,64,225336
15283,0.000934,172.217.194.0-255,3961,128832,64,225336
15284,0.000937,172.31.40.0-255,66,128898,64,225336
15285,0.000943,172.217.194.0-255,4320,133218,64,225336
15286,0.000945,172.31.40.0-255,66,133284,64,225336
15287,0.000958,172.31.40.0-255,66,133350,64,225336
15288,0.00101,172.31.40.0-255,66,133416,64,225336
15289,0.001066,172.217.194.0-255,1484,134900,64,225336
15290,0.001071,172.217.194.0-255,2902,137802,64,225336
15291,0.001074,172.31.40.0-255,66,137868,64,225336
15292,0.001077,172.217.194.0-255,1484,139352,64,225336
15293,0.001106,172.217.194.0-255,4320,143672,64,225336
15294,0.001109,172.31.40.0-255,66,143738,64,225336
15295,0.001133,172.217.194.0-255,1484,145222,64,225336
15296,0.001157,172.217.194.0-255,5379,150601,64,225336
15297,0.001161,172.31.40.0-255,66,150667,64,225336
15298,0.00121,172.217.194.0-255,1484,152151,64,225336
15299,0.001225,172.217.194.0-255,2902,155053,64,225336
15300,0.001228,172.31.40.0-255,66,155119,64,225336
15301,0.001231,172.217.194.0-255,1484,156603,64,225336
15302,0.001262,172.217.194.0-255,4320,160923,64,225336
15303,0.001265,172.31.40.0-255,66,160989,64,225336
15304,0.001283,172.31.40.0-255,66,161055,64,225336
15305,0.001312,172.217.194.0-255,1484,162539,64,225336
15306,0.001324,172.31.40.0-255,66,162605,64,225336
15307,0.001328,172.217.194.0-255,2184,164789,64,225336
15308,0.00133,172.31.40.0-255,66,164855,64,225336
15309,0.001334,172.217.194.0-255,2902,167757,64,225336
15310,0.001336,172.31.40.0-255,66,167823,64,225336
15311,0.001339,172.217.194.0-255,1484,169307,64,225336
15312,0.001362,172.217.194.0-255,5738,175045,64,225336
15313,0.001365,172.31.40.0-255,66,175111,64,225336
15314,0.001371,172.217.194.0-255,4320,179431,64,225336
15315,0.001374,172.31.40.0-255,66,179497,64,225336
15316,0.001419,172.31.40.0-255,66,179563,64,225336
15317,0.001429,172.31.40.0-255,66,179629,64,225336
15318,0.001434,172.217.194.0-255,4320,183949,64,225336
15319,0.001437,172.31.40.0-255,66,184015,64,225336
15320,0.001471,172.217.194.0-255,7156,191171,64,225336
15321,0.001474,172.31.40.0-255,66,191237,64,225336
15322,0.00149,172.31.40.0-255,66,191303,64,225336
15323,0.001501,172.31.40.0-255,66,191369,64,225336
15324,0.001564,172.31.40.0-255,66,191435,64,225336
15325,0.001572,172.217.194.0-255,7156,198591,64,225336
15326,0.001574,172.31.40.0-255,66,198657,64,225336
15327,0.001604,172.31.40.0-255,66,198723,64,225336
15328,0.001628,172.217.194.0-255,6438,205161,64,225336
15329,0.00163,172.31.40.0-255,66,205227,64,225336
15330,0.001634,172.217.194.0-255,1484,206711,64,225336
15331,0.001689,172.31.40.0-255,66,206777,64,225336
15332,0.0017,172.31.40.0-255,66,206843,64,225336
15333,0.001708,172.217.194.0-255,7156,213999,64,225336
15334,0.00171,172.31.40.0-255,66,214065,64,225336
15335,0.001742,172.217.194.0-255,6468,220533,64,225336
15336,0.001745,172.31.40.0-255,66,220599,64,225336
15337,0.001748,172.217.194.0-255,105,220704,64,225336
15338,0.004431,172.31.40.0-255,101,220805,64,225336
15339,0.006673,172.217.194.0-255,66,220871,64,225336
15340,0.016876,172.31.40.0-255,105,220976,64,225336
15341,0.019136,172.217.194.0-255,66,221042,64,225336
15342,0.048549,172.31.40.0-255,172,221214,64,225336
15343,0.048582,172.31.40.0-255,1112,222326,64,225336
15344,0.048759,172.31.40.0-255,1514,223840,64,225336
15345,0.048761,172.31.40.0-255,1298,225138,64,225336
15346,0.050048,104.244.42.0-255,66,225204,64,225336
15347,0.050068,104.244.42.0-255,66,225270,64,225336
15348,0.050279,104.244.42.0-255,66,225336,64,225336
15349,0.0,172.217.194.0-255,146,146,64,256224
15350,2.3e-05,172.31.40.0-255,66,212,64,256224
15351,3.1e-05,172.217.194.0-255,1484,1696,64,256224
15352,3.5e-05,172.31.40.0-255,66,1762,64,256224
15353,4.9e-05,172.217.194.0-255,2902,4664,64,256224
15354,5.3e-05,172.31.40.0-255,66,4730,64,256224
15355,6.1e-05,172.217.194.0-255,7156,11886,64,256224
15356,6.4e-05,172.31.40.0-255,66,11952,64,256224
15357,0.000146,172.217.194.0-255,2144,14096,64,256224
15358,0.00015,172.31.40.0-255,66,14162,64,256224
15359,0.000175,172.217.194.0-255,2902,17064,64,256224
15360,0.000178,172.31.40.0-255,66,17130,64,256224
15361,0.000216,172.217.194.0-255,4320,21450,64,256224
15362,0.000219,172.31.40.0-255,66,21516,64,256224
15363,0.000231,172.217.194.0-255,2902,24418,64,256224
15364,0.000238,172.31.40.0-255,66,24484,64,256224
15365,0.000324,172.217.194.0-255,4320,28804,64,256224
15366,0.000329,172.31.40.0-255,66,28870,64,256224
15367,0.000369,172.31.40.0-255,66,28936,64,256224
15368,0.000532,172.217.194.0-255,1484,30420,64,256224
15369,0.000536,172.31.40.0-255,66,30486,64,256224
15370,0.000566,172.217.194.0-255,6797,37283,64,256224
15371,0.00057,172.31.40.0-255,66,37349,64,256224
15372,0.00065,172.217.194.0-255,4320,41669,64,256224
15373,0.000654,172.31.40.0-255,66,41735,64,256224
15374,0.000684,172.217.194.0-255,5738,47473,64,256224
15375,0.000688,172.31.40.0-255,66,47539,64,256224
15376,0.000788,172.217.194.0-255,4320,51859,64,256224
15377,0.000791,172.31.40.0-255,66,51925,64,256224
15378,0.00082,172.217.194.0-255,2844,54769,64,256224
15379,0.000823,172.31.40.0-255,66,54835,64,256224
15380,0.000874,172.217.194.0-255,376,55211,64,256224
15381,0.000877,172.31.40.0-255,66,55277,64,256224
15382,0.00091,172.31.40.0-255,66,55343,64,256224
15383,0.001034,172.217.194.0-255,5738,61081,64,256224
15384,0.001038,172.31.40.0-255,66,61147,64,256224
15385,0.001085,172.31.40.0-255,66,61213,64,256224
15386,0.001334,172.217.194.0-255,2543,63756,64,256224
15387,0.00134,172.31.40.0-255,66,63822,64,256224
15388,0.001626,172.217.194.0-255,1484,65306,64,256224
15389,0.001637,172.217.194.0-255,2902,68208,64,256224
15390,0.001641,172.31.40.0-255,66,68274,64,256224
15391,0.001675,172.217.194.0-255,5738,74012,64,256224
15392,0.001678,172.31.40.0-255,66,74078,64,256224
15393,0.001751,172.31.40.0-255,66,74144,64,256224
15394,0.00177,172.217.194.0-255,4320,78464,64,256224
15395,0.001773,172.31.40.0-255,66,78530,64,256224
15396,0.001923,172.217.194.0-255,5738,84268,64,256224
15397,0.001928,172.31.40.0-255,66,84334,64,256224
15398,0.00196,172.217.194.0-255,5020,89354,64,256224
15399,0.001963,172.31.40.0-255,66,89420,64,256224
15400,0.003986,172.217.194.0-255,5738,95158,64,256224
15401,0.003994,172.31.40.0-255,66,95224,64,256224
15402,0.006028,172.217.194.0-255,5738,100962,64,256224
15403,0.006033,172.31.40.0-255,66,101028,64,256224
15404,0.00807,172.217.194.0-255,5738,106766,64,256224
15405,0.008076,172.31.40.0-255,66,106832,64,256224
15406,0.010102,172.217.194.0-255,5738,112570,64,256224
15407,0.010109,172.31.40.0-255,66,112636,64,256224
15408,0.012181,172.217.194.0-255,5738,118374,64,256224
15409,0.01219,172.31.40.0-255,66,118440,64,256224
15410,0.014211,172.217.194.0-255,5738,124178,64,256224
15411,0.014223,172.31.40.0-255,66,124244,64,256224
15412,0.016233,172.217.194.0-255,5738,129982,64,256224
15413,0.016241,172.31.40.0-255,66,130048,64,256224
15414,0.018296,172.217.194.0-255,5738,135786,64,256224
15415,0.018307,172.31.40.0-255,66,135852,64,256224
15416,0.02035,172.217.194.0-255,5738,141590,64,256224
15417,0.020359,172.31.40.0-255,66,141656,64,256224
15418,0.02237,172.217.194.0-255,5738,147394,64,256224
15419,0.022377,172.31.40.0-255,66,147460,64,256224
15420,0.024414,172.217.194.0-255,5738,153198,64,256224
15421,0.024421,172.31.40.0-255,66,153264,64,256224
15422,0.026459,172.217.194.0-255,5738,159002,64,256224
15423,0.026467,172.31.40.0-255,66,159068,64,256224
15424,0.028494,172.217.194.0-255,5738,164806,64,256224
15425,0.0285,172.31.40.0-255,66,164872,64,256224
15426,0.029388,172.31.40.0-255,172,165044,64,256224
15427,0.029421,172.31.40.0-255,1112,166156,64,256224
15428,0.029478,172.31.40.0-255,1514,167670,64,256224
15429,0.029479,172.31.40.0-255,1296,168966,64,256224
15430,0.030534,172.217.194.0-255,5738,174704,64,256224
15431,0.030542,172.31.40.0-255,66,174770,64,256224
15432,0.030956,104.244.42.0-255,66,174836,64,256224
15433,0.030993,104.244.42.0-255,66,174902,64,256224
15434,0.031067,104.244.42.0-255,66,174968,64,256224
15435,0.032596,172.217.194.0-255,5738,180706,64,256224
15436,0.032603,172.31.40.0-255,66,180772,64,256224
15437,0.034684,172.217.194.0-255,5738,186510,64,256224
15438,0.034691,172.31.40.0-255,66,186576,64,256224
15439,0.036755,172.217.194.0-255,5738,192314,64,256224
15440,0.036762,172.31.40.0-255,66,192380,64,256224
15441,0.038783,172.217.194.0-255,5738,198118,64,256224
15442,0.038792,172.31.40.0-255,66,198184,64,256224
15443,0.040818,172.217.194.0-255,5738,203922,64,256224
15444,0.040825,172.31.40.0-255,66,203988,64,256224
15445,0.042842,172.217.194.0-255,5738,209726,64,256224
15446,0.042849,172.31.40.0-255,66,209792,64,256224
15447,0.044892,172.217.194.0-255,5738,215530,64,256224
15448,0.044907,172.31.40.0-255,66,215596,64,256224
15449,0.046985,172.217.194.0-255,5738,221334,64,256224
15450,0.046998,172.31.40.0-255,66,221400,64,256224
15451,0.049039,172.217.194.0-255,5738,227138,64,256224
15452,0.049053,172.31.40.0-255,66,227204,64,256224
15453,0.051105,172.217.194.0-255,5738,232942,64,256224
15454,0.051121,172.31.40.0-255,66,233008,64,256224
15455,0.05315,172.217.194.0-255,5738,238746,64,256224
15456,0.053163,172.31.40.0-255,66,238812,64,256224
15457,0.055209,172.217.194.0-255,5738,244550,64,256224
15458,0.055224,172.31.40.0-255,66,244616,64,256224
15459,0.057277,172.217.194.0-255,5738,250354,64,256224
15460,0.057293,172.31.40.0-255,66,250420,64,256224
15461,0.059353,172.217.194.0-255,5738,256158,64,256224
15462,0.059367,172.31.40.0-255,66,256224,64,256224
15463,0.0,74.125.24.0-255,147,147,64,253548
15464,2.3e-05,172.31.40.0-255,66,213,64,253548
15465,3e-05,74.125.24.0-255,1484,1697,64,253548
15466,3.4e-05,172.31.40.0-255,66,1763,64,253548
15467,4e-05,74.125.24.0-255,2902,4665,64,253548
15468,4.3e-05,172.31.40.0-255,66,4731,64,253548
15469,5.8e-05,74.125.24.0-255,7156,11887,64,253548
15470,6.2e-05,172.31.40.0-255,66,11953,64,253548
15471,9.6e-05,74.125.24.0-255,2074,14027,64,253548
15472,9.9e-05,172.31.40.0-255,66,14093,64,253548
15473,0.000185,74.125.24.0-255,1484,15577,64,253548
15474,0.000188,172.31.40.0-255,66,15643,64,253548
15475,0.000193,74.125.24.0-255,2902,18545,64,253548
15476,0.000196,172.31.40.0-255,66,18611,64,253548
15477,0.000204,74.125.24.0-255,2902,21513,64,253548
15478,0.000207,172.31.40.0-255,66,21579,64,253548
15479,0.000219,74.125.24.0-255,2902,24481,64,253548
15480,0.000222,172.31.40.0-255,66,24547,64,253548
15481,0.000229,74.125.24.0-255,1484,26031,64,253548
15482,0.000232,172.31.40.0-255,66,26097,64,253548
15483,0.000265,74.125.24.0-255,5379,31476,64,253548
15484,0.000268,172.31.40.0-255,66,31542,64,253548
15485,0.00029,74.125.24.0-255,1484,33026,64,253548
15486,0.000293,172.31.40.0-255,66,33092,64,253548
15487,0.000319,74.125.24.0-255,2902,35994,64,253548
15488,0.000322,172.31.40.0-255,66,36060,64,253548
15489,0.000328,74.125.24.0-255,5738,41798,64,253548
15490,0.000331,172.31.40.0-255,66,41864,64,253548
15491,0.000341,74.125.24.0-255,4320,46184,64,253548
15492,0.000343,172.31.40.0-255,66,46250,64,253548
15493,0.000372,74.125.24.0-255,2543,48793,64,253548
15494,0.000375,172.31.40.0-255,66,48859,64,253548
15495,0.001455,74.125.24.0-255,1484,50343,64,253548
15496,0.001468,74.125.24.0-255,2902,53245,64,253548
15497,0.001473,172.31.40.0-255,66,53311,64,253548
15498,0.001481,74.125.24.0-255,5738,59049,64,253548
15499,0.001485,74.125.24.0-255,1484,60533,64,253548
15500,0.00151,74.125.24.0-255,6797,67330,64,253548
15501,0.001517,74.125.24.0-255,7156,74486,64,253548
15502,0.001528,74.125.24.0-255,1484,75970,64,253548
15503,0.001541,74.125.24.0-255,2902,78872,64,253548
15504,0.001557,74.125.24.0-255,3961,82833,64,253548
15505,0.001581,74.125.24.0-255,7156,89989,64,253548
15506,0.001601,74.125.24.0-255,4320,94309,64,253548
15507,0.001625,74.125.24.0-255,5960,100269,64,253548
15508,0.006231,172.31.40.0-255,66,100335,64,253548
15509,0.008317,74.125.24.0-255,5738,106073,64,253548
15510,0.008325,172.31.40.0-255,66,106139,64,253548
15511,0.010428,74.125.24.0-255,5738,111877,64,253548
15512,0.010436,172.31.40.0-255,66,111943,64,253548
15513,0.012504,74.125.24.0-255,5738,117681,64,253548
15514,0.012954,172.31.40.0-255,66,117747,64,253548
15515,0.014995,74.125.24.0-255,5738,123485,64,253548
15516,0.015007,172.31.40.0-255,66,123551,64,253548
15517,0.017049,74.125.24.0-255,5738,129289,64,253548
15518,0.017058,172.31.40.0-255,66,129355,64,253548
15519,0.019121,74.125.24.0-255,5738,135093,64,253548
15520,0.019129,172.31.40.0-255,66,135159,64,253548
15521,0.021193,74.125.24.0-255,5738,140897,64,253548
15522,0.021201,172.31.40.0-255,66,140963,64,253548
15523,0.023258,74.125.24.0-255,5738,146701,64,253548
15524,0.023266,172.31.40.0-255,66,146767,64,253548
15525,0.025308,74.125.24.0-255,5738,152505,64,253548
15526,0.025321,172.31.40.0-255,66,152571,64,253548
15527,0.027354,74.125.24.0-255,5738,158309,64,253548
15528,0.027362,172.31.40.0-255,66,158375,64,253548
15529,0.029425,74.125.24.0-255,5738,164113,64,253548
15530,0.029433,172.31.40.0-255,66,164179,64,253548
15531,0.031505,74.125.24.0-255,5738,169917,64,253548
15532,0.031515,172.31.40.0-255,66,169983,64,253548
15533,0.033238,172.31.40.0-255,172,170155,64,253548
15534,0.033268,172.31.40.0-255,1112,171267,64,253548
15535,0.033326,172.31.40.0-255,1514,172781,64,253548
15536,0.033328,172.31.40.0-255,1514,174295,64,253548
15537,0.033329,172.31.40.0-255,1514,175809,64,253548
15538,0.03333,172.31.40.0-255,1514,177323,64,253548
15539,0.033356,172.31.40.0-255,1514,178837,64,253548
15540,0.033357,172.31.40.0-255,83,178920,64,253548
15541,0.033532,74.125.24.0-255,4320,183240,64,253548
15542,0.033536,172.31.40.0-255,66,183306,64,253548
15543,0.033561,74.125.24.0-255,1484,184790,64,253548
15544,0.034751,104.244.42.0-255,66,184856,64,253548
15545,0.034854,104.244.42.0-255,66,184922,64,253548
15546,0.034913,104.244.42.0-255,66,184988,64,253548
15547,0.034919,104.244.42.0-255,66,185054,64,253548
15548,0.035596,74.125.24.0-255,4320,189374,64,253548
15549,0.035604,172.31.40.0-255,66,189440,64,253548
15550,0.037686,74.125.24.0-255,5738,195178,64,253548
15551,0.037969,172.31.40.0-255,66,195244,64,253548
15552,0.040001,74.125.24.0-255,5738,200982,64,253548
15553,0.040008,172.31.40.0-255,66,201048,64,253548
15554,0.042046,74.125.24.0-255,5738,206786,64,253548
15555,0.042054,172.31.40.0-255,66,206852,64,253548
15556,0.044105,74.125.24.0-255,5738,212590,64,253548
15557,0.044111,172.31.40.0-255,66,212656,64,253548
15558,0.046176,74.125.24.0-255,5738,218394,64,253548
15559,0.046182,172.31.40.0-255,66,218460,64,253548
15560,0.048238,74.125.24.0-255,5738,224198,64,253548
15561,0.048245,172.31.40.0-255,66,224264,64,253548
15562,0.050307,74.125.24.0-255,5738,230002,64,253548
15563,0.050314,172.31.40.0-255,66,230068,64,253548
15564,0.052403,74.125.24.0-255,5738,235806,64,253548
15565,0.052409,172.31.40.0-255,66,235872,64,253548
15566,0.054462,74.125.24.0-255,5738,241610,64,253548
15567,0.054471,172.31.40.0-255,66,241676,64,253548
15568,0.056513,74.125.24.0-255,2902,244578,64,253548
15569,0.05652,172.31.40.0-255,66,244644,64,253548
15570,0.056547,74.125.24.0-255,2902,247546,64,253548
15571,0.057168,172.31.40.0-255,66,247612,64,253548
15572,0.058549,74.125.24.0-255,2902,250514,64,253548
15573,0.058559,172.31.40.0-255,66,250580,64,253548
15574,0.05925,74.125.24.0-255,2902,253482,64,253548
15575,0.059257,172.31.40.0-255,66,253548,64,253548
15576,0.0,74.125.24.0-255,153,153,64,227150
15577,1.4e-05,172.31.40.0-255,66,219,64,227150
15578,2.1e-05,74.125.24.0-255,1484,1703,64,227150
15579,2.4e-05,172.31.40.0-255,66,1769,64,227150
15580,3e-05,74.125.24.0-255,2902,4671,64,227150
15581,4e-05,172.31.40.0-255,66,4737,64,227150
15582,6.3e-05,74.125.24.0-255,7156,11893,64,227150
15583,6.6e-05,172.31.40.0-255,66,11959,64,227150
15584,7.3e-05,74.125.24.0-255,2029,13988,64,227150
15585,7.5e-05,172.31.40.0-255,66,14054,64,227150
15586,8e-05,74.125.24.0-255,2902,16956,64,227150
15587,8.2e-05,172.31.40.0-255,66,17022,64,227150
15588,8.9e-05,74.125.24.0-255,7156,24178,64,227150
15589,9.1e-05,172.31.40.0-255,66,24244,64,227150
15590,0.000123,74.125.24.0-255,6797,31041,64,227150
15591,0.000126,172.31.40.0-255,66,31107,64,227150
15592,0.000208,74.125.24.0-255,1484,32591,64,227150
15593,0.000211,172.31.40.0-255,66,32657,64,227150
15594,0.000215,74.125.24.0-255,2902,35559,64,227150
15595,0.000217,172.31.40.0-255,66,35625,64,227150
15596,0.000244,74.125.24.0-255,5738,41363,64,227150
15597,0.000247,172.31.40.0-255,66,41429,64,227150
15598,0.000289,172.31.40.0-255,66,41495,64,227150
15599,0.0003,172.31.40.0-255,66,41561,64,227150
15600,0.000736,74.125.24.0-255,647,42208,64,227150
15601,0.000741,172.31.40.0-255,66,42274,64,227150
15602,0.000857,74.125.24.0-255,1484,43758,64,227150
15603,0.000862,172.31.40.0-255,66,43824,64,227150
15604,0.000874,74.125.24.0-255,2902,46726,64,227150
15605,0.000879,172.31.40.0-255,66,46792,64,227150
15606,0.000907,74.125.24.0-255,4320,51112,64,227150
15607,0.00091,172.31.40.0-255,66,51178,64,227150
15608,0.001072,172.31.40.0-255,66,51244,64,227150
15609,0.001963,74.125.24.0-255,1484,52728,64,227150
15610,0.001987,74.125.24.0-255,2902,55630,64,227150
15611,0.001991,172.31.40.0-255,66,55696,64,227150
15612,0.002,74.125.24.0-255,5738,61434,64,227150
15613,0.002002,172.31.40.0-255,66,61500,64,227150
15614,0.002021,172.31.40.0-255,66,61566,64,227150
15615,0.002077,172.31.40.0-255,66,61632,64,227150
15616,0.004097,74.125.24.0-255,4320,65952,64,227150
15617,0.0041,172.31.40.0-255,66,66018,64,227150
15618,0.004127,74.125.24.0-255,1484,67502,64,227150
15619,0.006144,74.125.24.0-255,4320,71822,64,227150
15620,0.006149,172.31.40.0-255,66,71888,64,227150
15621,0.008167,74.125.24.0-255,5738,77626,64,227150
15622,0.008174,172.31.40.0-255,66,77692,64,227150
15623,0.010239,74.125.24.0-255,5738,83430,64,227150
15624,0.010247,172.31.40.0-255,66,83496,64,227150
15625,0.012273,74.125.24.0-255,5738,89234,64,227150
15626,0.012282,172.31.40.0-255,66,89300,64,227150
15627,0.014305,74.125.24.0-255,5738,95038,64,227150
15628,0.014314,172.31.40.0-255,66,95104,64,227150
15629,0.016361,74.125.24.0-255,5738,100842,64,227150
15630,0.01637,172.31.40.0-255,66,100908,64,227150
15631,0.018422,74.125.24.0-255,5738,106646,64,227150
15632,0.018429,172.31.40.0-255,66,106712,64,227150
15633,0.020463,74.125.24.0-255,5738,112450,64,227150
15634,0.02047,172.31.40.0-255,66,112516,64,227150
15635,0.022488,74.125.24.0-255,5738,118254,64,227150
15636,0.022496,172.31.40.0-255,66,118320,64,227150
15637,0.024523,74.125.24.0-255,1484,119804,64,227150
15638,0.02456,74.125.24.0-255,4320,124124,64,227150
15639,0.024564,172.31.40.0-255,66,124190,64,227150
15640,0.02526,172.31.40.0-255,172,124362,64,227150
15641,0.025289,172.31.40.0-255,1112,125474,64,227150
15642,0.025339,172.31.40.0-255,1514,126988,64,227150
15643,0.02534,172.31.40.0-255,1296,128284,64,227150
15644,0.026612,74.125.24.0-255,5738,134022,64,227150
15645,0.026618,172.31.40.0-255,66,134088,64,227150
15646,0.026816,104.244.42.0-255,66,134154,64,227150
15647,0.026851,104.244.42.0-255,66,134220,64,227150
15648,0.026904,104.244.42.0-255,66,134286,64,227150
15649,0.028668,74.125.24.0-255,5738,140024,64,227150
15650,0.028676,172.31.40.0-255,66,140090,64,227150
15651,0.030722,74.125.24.0-255,5738,145828,64,227150
15652,0.03073,172.31.40.0-255,66,145894,64,227150
15653,0.032771,74.125.24.0-255,5738,151632,64,227150
15654,0.032779,172.31.40.0-255,66,151698,64,227150
15655,0.03479,74.125.24.0-255,5738,157436,64,227150
15656,0.034796,172.31.40.0-255,66,157502,64,227150
15657,0.036848,74.125.24.0-255,5738,163240,64,227150
15658,0.036854,172.31.40.0-255,66,163306,64,227150
15659,0.038913,74.125.24.0-255,5738,169044,64,227150
15660,0.038919,172.31.40.0-255,66,169110,64,227150
15661,0.04099,74.125.24.0-255,5738,174848,64,227150
15662,0.040996,172.31.40.0-255,66,174914,64,227150
15663,0.043016,74.125.24.0-255,5738,180652,64,227150
15664,0.043023,172.31.40.0-255,66,180718,64,227150
15665,0.045044,74.125.24.0-255,5738,186456,64,227150
15666,0.045053,172.31.40.0-255,66,186522,64,227150
15667,0.04709,74.125.24.0-255,5738,192260,64,227150
15668,0.047097,172.31.40.0-255,66,192326,64,227150
15669,0.049176,74.125.24.0-255,5738,198064,64,227150
15670,0.049184,172.31.40.0-255,66,198130,64,227150
15671,0.051241,74.125.24.0-255,5738,203868,64,227150
15672,0.05125,172.31.40.0-255,66,203934,64,227150
15673,0.053283,74.125.24.0-255,5738,209672,64,227150
15674,0.0533,172.31.40.0-255,66,209738,64,227150
15675,0.055336,74.125.24.0-255,5738,215476,64,227150
15676,0.055352,172.31.40.0-255,66,215542,64,227150
15677,0.057408,74.125.24.0-255,5738,221280,64,227150
15678,0.057421,172.31.40.0-255,66,221346,64,227150
15679,0.059481,74.125.24.0-255,5738,227084,64,227150
15680,0.059493,172.31.40.0-255,66,227150,64,227150
15681,0.0,172.217.194.0-255,152,152,64,221493
15682,2.1e-05,172.31.40.0-255,66,218,64,221493
15683,2.8e-05,172.217.194.0-255,1484,1702,64,221493
15684,3.2e-05,172.31.40.0-255,66,1768,64,221493
15685,3.7e-05,172.217.194.0-255,2902,4670,64,221493
15686,4e-05,172.31.40.0-255,66,4736,64,221493
15687,4.7e-05,172.217.194.0-255,7156,11892,64,221493
15688,5e-05,172.31.40.0-255,66,11958,64,221493
15689,7.5e-05,172.217.194.0-255,2020,13978,64,221493
15690,7.8e-05,172.31.40.0-255,66,14044,64,221493
15691,0.000336,172.217.194.0-255,1484,15528,64,221493
15692,0.000341,172.31.40.0-255,66,15594,64,221493
15693,0.000347,172.217.194.0-255,2902,18496,64,221493
15694,0.000349,172.31.40.0-255,66,18562,64,221493
15695,0.000354,172.217.194.0-255,4320,22882,64,221493
15696,0.000356,172.31.40.0-255,66,22948,64,221493
15697,0.000369,172.217.194.0-255,1484,24432,64,221493
15698,0.000371,172.31.40.0-255,66,24498,64,221493
15699,0.000376,172.217.194.0-255,4320,28818,64,221493
15700,0.000378,172.31.40.0-255,66,28884,64,221493
15701,0.000401,172.217.194.0-255,2543,31427,64,221493
15702,0.000403,172.31.40.0-255,66,31493,64,221493
15703,0.000524,172.217.194.0-255,1484,32977,64,221493
15704,0.000528,172.31.40.0-255,66,33043,64,221493
15705,0.000532,172.217.194.0-255,2902,35945,64,221493
15706,0.000534,172.31.40.0-255,66,36011,64,221493
15707,0.000552,172.217.194.0-255,5738,41749,64,221493
15708,0.000555,172.31.40.0-255,66,41815,64,221493
15709,0.000575,172.217.194.0-255,2902,44717,64,221493
15710,0.000577,172.31.40.0-255,66,44783,64,221493
15711,0.000609,172.31.40.0-255,66,44849,64,221493
15712,0.000627,172.217.194.0-255,1484,46333,64,221493
15713,0.000643,172.217.194.0-255,4320,50653,64,221493
15714,0.000646,172.31.40.0-255,66,50719,64,221493
15715,0.000669,172.217.194.0-255,4234,54953,64,221493
15716,0.000672,172.31.40.0-255,66,55019,64,221493
15717,0.000859,172.217.194.0-255,120,55139,64,221493
15718,0.000881,172.217.194.0-255,380,55519,64,221493
15719,0.001006,172.31.40.0-255,66,55585,64,221493
15720,0.001023,172.217.194.0-255,1484,57069,64,221493
15721,0.001028,172.217.194.0-255,2902,59971,64,221493
15722,0.00103,172.31.40.0-255,66,60037,64,221493
15723,0.001071,172.217.194.0-255,5738,65775,64,221493
15724,0.001074,172.31.40.0-255,66,65841,64,221493
15725,0.001079,172.217.194.0-255,4320,70161,64,221493
15726,0.001081,172.31.40.0-255,66,70227,64,221493
15727,0.001104,172.31.40.0-255,66,70293,64,221493
15728,0.001138,172.31.40.0-255,66,70359,64,221493
15729,0.001153,172.217.194.0-255,766,71125,64,221493
15730,0.001156,172.217.194.0-255,1484,72609,64,221493
15731,0.001158,172.31.40.0-255,66,72675,64,221493
15732,0.001163,172.217.194.0-255,2902,75577,64,221493
15733,0.001165,172.31.40.0-255,66,75643,64,221493
15734,0.001169,172.217.194.0-255,1484,77127,64,221493
15735,0.001185,172.217.194.0-255,4320,81447,64,221493
15736,0.001188,172.31.40.0-255,66,81513,64,221493
15737,0.001223,172.31.40.0-255,66,81579,64,221493
15738,0.001268,172.31.40.0-255,66,81645,64,221493
15739,0.001307,172.31.40.0-255,66,81711,64,221493
15740,0.001329,172.217.194.0-255,4320,86031,64,221493
15741,0.001332,172.31.40.0-255,66,86097,64,221493
15742,0.001337,172.217.194.0-255,4320,90417,64,221493
15743,0.001341,172.31.40.0-255,66,90483,64,221493
15744,0.001347,172.217.194.0-255,5738,96221,64,221493
15745,0.001349,172.31.40.0-255,66,96287,64,221493
15746,0.001387,172.217.194.0-255,5738,102025,64,221493
15747,0.00139,172.31.40.0-255,66,102091,64,221493
15748,0.001411,172.217.194.0-255,3602,105693,64,221493
15749,0.001414,172.31.40.0-255,66,105759,64,221493
15750,0.001435,172.217.194.0-255,1484,107243,64,221493
15751,0.00144,172.217.194.0-255,2902,110145,64,221493
15752,0.001442,172.31.40.0-255,66,110211,64,221493
15753,0.001449,172.217.194.0-255,5738,115949,64,221493
15754,0.001451,172.31.40.0-255,66,116015,64,221493
15755,0.001458,172.217.194.0-255,5738,121753,64,221493
15756,0.00146,172.31.40.0-255,66,121819,64,221493
15757,0.001487,172.217.194.0-255,5738,127557,64,221493
15758,0.00149,172.31.40.0-255,66,127623,64,221493
15759,0.001514,172.217.194.0-255,5738,133361,64,221493
15760,0.001517,172.31.40.0-255,66,133427,64,221493
15761,0.001551,172.31.40.0-255,66,133493,64,221493
15762,0.001562,172.31.40.0-255,66,133559,64,221493
15763,0.001583,172.217.194.0-255,7156,140715,64,221493
15764,0.001586,172.31.40.0-255,66,140781,64,221493
15765,0.001616,172.31.40.0-255,66,140847,64,221493
15766,0.001652,172.217.194.0-255,1484,142331,64,221493
15767,0.001666,172.217.194.0-255,2902,145233,64,221493
15768,0.001668,172.31.40.0-255,66,145299,64,221493
15769,0.001673,172.217.194.0-255,2902,148201,64,221493
15770,0.001675,172.31.40.0-255,66,148267,64,221493
15771,0.00169,172.217.194.0-255,2902,151169,64,221493
15772,0.001692,172.31.40.0-255,66,151235,64,221493
15773,0.001697,172.217.194.0-255,4320,155555,64,221493
15774,0.0017,172.31.40.0-255,66,155621,64,221493
15775,0.001747,172.31.40.0-255,66,155687,64,221493
15776,0.00176,172.31.40.0-255,66,155753,64,221493
15777,0.00178,172.217.194.0-255,7156,162909,64,221493
15778,0.001783,172.31.40.0-255,66,162975,64,221493
15779,0.001814,172.31.40.0-255,66,163041,64,221493
15780,0.001863,172.217.194.0-255,7156,170197,64,221493
15781,0.001866,172.31.40.0-255,66,170263,64,221493
15782,0.001892,172.217.194.0-255,766,171029,64,221493
15783,0.001905,172.31.40.0-255,66,171095,64,221493
15784,0.001923,172.31.40.0-255,66,171161,64,221493
15785,0.001929,172.217.194.0-255,6438,177599,64,221493
15786,0.001931,172.31.40.0-255,66,177665,64,221493
15787,0.001955,172.217.194.0-255,1484,179149,64,221493
15788,0.00197,172.217.194.0-255,5738,184887,64,221493
15789,0.001973,172.31.40.0-255,66,184953,64,221493
15790,0.001976,172.217.194.0-255,1484,186437,64,221493
15791,0.001996,172.217.194.0-255,7156,193593,64,221493
15792,0.001999,172.31.40.0-255,66,193659,64,221493
15793,0.002015,172.217.194.0-255,5738,199397,64,221493
15794,0.002017,172.31.40.0-255,66,199463,64,221493
15795,0.002046,172.217.194.0-255,766,200229,64,221493
15796,0.00207,172.217.194.0-255,4320,204549,64,221493
15797,0.002079,172.31.40.0-255,66,204615,64,221493
15798,0.002114,172.217.194.0-255,4320,208935,64,221493
15799,0.002148,172.217.194.0-255,6877,215812,64,221493
15800,0.002154,172.31.40.0-255,66,215878,64,221493
15801,0.002166,172.217.194.0-255,105,215983,64,221493
15802,0.010151,172.31.40.0-255,66,216049,64,221493
15803,0.010196,172.31.40.0-255,105,216154,64,221493
15804,0.012453,172.217.194.0-255,66,216220,64,221493
15805,0.033416,172.31.40.0-255,176,216396,64,221493
15806,0.033449,172.31.40.0-255,1111,217507,64,221493
15807,0.033514,172.31.40.0-255,1514,219021,64,221493
15808,0.033515,172.31.40.0-255,1514,220535,64,221493
15809,0.033539,172.31.40.0-255,694,221229,64,221493
15810,0.03495,104.244.42.0-255,66,221295,64,221493
15811,0.034981,104.244.42.0-255,66,221361,64,221493
15812,0.035093,104.244.42.0-255,66,221427,64,221493
15813,0.035106,104.244.42.0-255,66,221493,64,221493
15814,0.0,74.125.68.0-255,153,153,64,159928
15815,2.2e-05,172.31.40.0-255,66,219,64,159928
15816,3e-05,74.125.68.0-255,1484,1703,64,159928
15817,3.5e-05,172.31.40.0-255,66,1769,64,159928
15818,4.9e-05,74.125.68.0-255,2902,4671,64,159928
15819,5.1e-05,172.31.40.0-255,66,4737,64,159928
15820,0.000101,74.125.68.0-255,4320,9057,64,159928
15821,0.000104,172.31.40.0-255,66,9123,64,159928
15822,0.000224,74.125.68.0-255,5738,14861,64,159928
15823,0.000229,172.31.40.0-255,66,14927,64,159928
15824,0.000255,74.125.68.0-255,3556,18483,64,159928
15825,0.000259,172.31.40.0-255,66,18549,64,159928
15826,0.000509,172.31.40.0-255,66,18615,64,159928
15827,0.000842,172.31.40.0-255,66,18681,64,159928
15828,0.00087,74.125.68.0-255,2902,21583,64,159928
15829,0.000873,172.31.40.0-255,66,21649,64,159928
15830,0.001219,172.31.40.0-255,66,21715,64,159928
15831,0.001258,172.31.40.0-255,66,21781,64,159928
15832,0.001927,74.125.68.0-255,7156,28937,64,159928
15833,0.001935,172.31.40.0-255,66,29003,64,159928
15834,0.001994,172.31.40.0-255,66,29069,64,159928
15835,0.002739,74.125.68.0-255,4320,33389,64,159928
15836,0.002742,172.31.40.0-255,66,33455,64,159928
15837,0.002793,172.31.40.0-255,66,33521,64,159928
15838,0.003756,74.125.68.0-255,7156,40677,64,159928
15839,0.00376,172.31.40.0-255,66,40743,64,159928
15840,0.00638,172.31.40.0-255,66,40809,64,159928
15841,0.00889,74.125.68.0-255,5738,46547,64,159928
15842,0.008899,172.31.40.0-255,66,46613,64,159928
15843,0.011407,74.125.68.0-255,5738,52351,64,159928
15844,0.011859,172.31.40.0-255,66,52417,64,159928
15845,0.014373,74.125.68.0-255,2902,55319,64,159928
15846,0.014382,172.31.40.0-255,66,55385,64,159928
15847,0.014408,74.125.68.0-255,2902,58287,64,159928
15848,0.014436,172.31.40.0-255,66,58353,64,159928
15849,0.016894,74.125.68.0-255,2902,61255,64,159928
15850,0.016902,172.31.40.0-255,66,61321,64,159928
15851,0.016946,74.125.68.0-255,2902,64223,64,159928
15852,0.016972,172.31.40.0-255,66,64289,64,159928
15853,0.01942,74.125.68.0-255,2902,67191,64,159928
15854,0.019428,172.31.40.0-255,66,67257,64,159928
15855,0.019473,74.125.68.0-255,2902,70159,64,159928
15856,0.019497,172.31.40.0-255,66,70225,64,159928
15857,0.021923,74.125.68.0-255,2902,73127,64,159928
15858,0.021931,172.31.40.0-255,66,73193,64,159928
15859,0.021993,74.125.68.0-255,2902,76095,64,159928
15860,0.022036,172.31.40.0-255,66,76161,64,159928
15861,0.024459,74.125.68.0-255,2902,79063,64,159928
15862,0.024471,172.31.40.0-255,66,79129,64,159928
15863,0.024533,74.125.68.0-255,2902,82031,64,159928
15864,0.024541,172.31.40.0-255,66,82097,64,159928
15865,0.026983,74.125.68.0-255,2902,84999,64,159928
15866,0.026991,172.31.40.0-255,66,85065,64,159928
15867,0.027031,74.125.68.0-255,2902,87967,64,159928
15868,0.027058,172.31.40.0-255,66,88033,64,159928
15869,0.02766,172.31.40.0-255,171,88204,64,159928
15870,0.027687,172.31.40.0-255,1137,89341,64,159928
15871,0.027734,172.31.40.0-255,1514,90855,64,159928
15872,0.027735,172.31.40.0-255,1271,92126,64,159928
15873,0.029216,104.244.42.0-255,66,92192,64,159928
15874,0.029259,104.244.42.0-255,66,92258,64,159928
15875,0.029298,104.244.42.0-255,66,92324,64,159928
15876,0.029487,74.125.68.0-255,2902,95226,64,159928
15877,0.029492,172.31.40.0-255,66,95292,64,159928
15878,0.029533,74.125.68.0-255,1484,96776,64,159928
15879,0.029544,74.125.68.0-255,1484,98260,64,159928
15880,0.029569,172.31.40.0-255,66,98326,64,159928
15881,0.032005,74.125.68.0-255,2902,101228,64,159928
15882,0.032017,172.31.40.0-255,66,101294,64,159928
15883,0.032064,74.125.68.0-255,2902,104196,64,159928
15884,0.032096,172.31.40.0-255,66,104262,64,159928
15885,0.034534,74.125.68.0-255,2902,107164,64,159928
15886,0.034544,172.31.40.0-255,66,107230,64,159928
15887,0.034592,74.125.68.0-255,2902,110132,64,159928
15888,0.034618,172.31.40.0-255,66,110198,64,159928
15889,0.037058,74.125.68.0-255,2902,113100,64,159928
15890,0.037071,172.31.40.0-255,66,113166,64,159928
15891,0.03712,74.125.68.0-255,2902,116068,64,159928
15892,0.037151,172.31.40.0-255,66,116134,64,159928
15893,0.039606,74.125.68.0-255,2902,119036,64,159928
15894,0.039616,172.31.40.0-255,66,119102,64,159928
15895,0.039665,74.125.68.0-255,2902,122004,64,159928
15896,0.039688,172.31.40.0-255,66,122070,64,159928
15897,0.042132,74.125.68.0-255,2902,124972,64,159928
15898,0.042139,172.31.40.0-255,66,125038,64,159928
15899,0.042183,74.125.68.0-255,2902,127940,64,159928
15900,0.04466,74.125.68.0-255,2902,130842,64,159928
15901,0.04621,172.31.40.0-255,66,130908,64,159928
15902,0.048731,74.125.68.0-255,5738,136646,64,159928
15903,0.048748,172.31.40.0-255,66,136712,64,159928
15904,0.051274,74.125.68.0-255,5738,142450,64,159928
15905,0.05129,172.31.40.0-255,66,142516,64,159928
15906,0.053828,74.125.68.0-255,5738,148254,64,159928
15907,0.053842,172.31.40.0-255,66,148320,64,159928
15908,0.056372,74.125.68.0-255,5738,154058,64,159928
15909,0.05639,172.31.40.0-255,66,154124,64,159928
15910,0.058905,74.125.68.0-255,5738,159862,64,159928
15911,0.058922,172.31.40.0-255,66,159928,64,159928
15912,0.0,74.125.24.0-255,150,150,64,294157
15913,3.7e-05,172.31.40.0-255,66,216,64,294157
15914,4.4e-05,74.125.24.0-255,1484,1700,64,294157
15915,4.9e-05,172.31.40.0-255,66,1766,64,294157
15916,5.4e-05,74.125.24.0-255,2902,4668,64,294157
15917,5.8e-05,172.31.40.0-255,66,4734,64,294157
15918,6.2e-05,74.125.24.0-255,2902,7636,64,294157
15919,6.5e-05,172.31.40.0-255,66,7702,64,294157
15920,7.7e-05,172.31.40.0-255,66,7768,64,294157
15921,9.1e-05,172.31.40.0-255,66,7834,64,294157
15922,9.5e-05,74.125.24.0-255,2543,10377,64,294157
15923,9.7e-05,172.31.40.0-255,66,10443,64,294157
15924,0.000212,74.125.24.0-255,1484,11927,64,294157
15925,0.000217,172.31.40.0-255,66,11993,64,294157
15926,0.000235,74.125.24.0-255,1484,13477,64,294157
15927,0.000237,172.31.40.0-255,66,13543,64,294157
15928,0.000249,74.125.24.0-255,1484,15027,64,294157
15929,0.000252,172.31.40.0-255,66,15093,64,294157
15930,0.000263,74.125.24.0-255,1484,16577,64,294157
15931,0.000265,172.31.40.0-255,66,16643,64,294157
15932,0.000285,74.125.24.0-255,4320,20963,64,294157
15933,0.000288,172.31.40.0-255,66,21029,64,294157
15934,0.000292,74.125.24.0-255,2902,23931,64,294157
15935,0.000295,172.31.40.0-255,66,23997,64,294157
15936,0.000308,172.31.40.0-255,66,24063,64,294157
15937,0.000342,172.31.40.0-255,66,24129,64,294157
15938,0.000361,74.125.24.0-255,1431,25560,64,294157
15939,0.000363,172.31.40.0-255,66,25626,64,294157
15940,0.000366,74.125.24.0-255,115,25741,64,294157
15941,0.000474,74.125.24.0-255,1484,27225,64,294157
15942,0.000478,172.31.40.0-255,66,27291,64,294157
15943,0.000482,74.125.24.0-255,2902,30193,64,294157
15944,0.000485,172.31.40.0-255,66,30259,64,294157
15945,0.000503,74.125.24.0-255,4320,34579,64,294157
15946,0.000506,172.31.40.0-255,66,34645,64,294157
15947,0.000523,74.125.24.0-255,1484,36129,64,294157
15948,0.00053,74.125.24.0-255,6797,42926,64,294157
15949,0.000532,172.31.40.0-255,66,42992,64,294157
15950,0.000548,74.125.24.0-255,4320,47312,64,294157
15951,0.000551,172.31.40.0-255,66,47378,64,294157
15952,0.000567,74.125.24.0-255,2902,50280,64,294157
15953,0.00057,172.31.40.0-255,66,50346,64,294157
15954,0.000595,74.125.24.0-255,5738,56084,64,294157
15955,0.000598,172.31.40.0-255,66,56150,64,294157
15956,0.000612,74.125.24.0-255,1484,57634,64,294157
15957,0.000615,74.125.24.0-255,1484,59118,64,294157
15958,0.000617,172.31.40.0-255,66,59184,64,294157
15959,0.000634,74.125.24.0-255,1367,60551,64,294157
15960,0.000878,74.125.24.0-255,1484,62035,64,294157
15961,0.000883,172.31.40.0-255,66,62101,64,294157
15962,0.000888,74.125.24.0-255,2902,65003,64,294157
15963,0.00089,172.31.40.0-255,66,65069,64,294157
15964,0.000923,74.125.24.0-255,1484,66553,64,294157
15965,0.000945,74.125.24.0-255,4320,70873,64,294157
15966,0.000959,172.31.40.0-255,66,70939,64,294157
15967,0.000969,172.31.40.0-255,66,71005,64,294157
15968,0.000975,74.125.24.0-255,5738,76743,64,294157
15969,0.000977,172.31.40.0-255,66,76809,64,294157
15970,0.001007,74.125.24.0-255,5020,81829,64,294157
15971,0.00101,172.31.40.0-255,66,81895,64,294157
15972,0.001942,74.125.24.0-255,1484,83379,64,294157
15973,0.001953,74.125.24.0-255,2902,86281,64,294157
15974,0.001957,172.31.40.0-255,66,86347,64,294157
15975,0.001965,74.125.24.0-255,5738,92085,64,294157
15976,0.001968,172.31.40.0-255,66,92151,64,294157
15977,0.001973,74.125.24.0-255,2902,95053,64,294157
15978,0.001975,172.31.40.0-255,66,95119,64,294157
15979,0.002007,74.125.24.0-255,4320,99439,64,294157
15980,0.00201,172.31.40.0-255,66,99505,64,294157
15981,0.002022,172.31.40.0-255,66,99571,64,294157
15982,0.002037,74.125.24.0-255,5738,105309,64,294157
15983,0.00204,172.31.40.0-255,66,105375,64,294157
15984,0.002044,74.125.24.0-255,2184,107559,64,294157
15985,0.002045,172.31.40.0-255,66,107625,64,294157
15986,0.002077,74.125.24.0-255,4320,111945,64,294157
15987,0.00208,172.31.40.0-255,66,112011,64,294157
15988,0.002113,172.31.40.0-255,66,112077,64,294157
15989,0.002119,74.125.24.0-255,4320,116397,64,294157
15990,0.002121,172.31.40.0-255,66,116463,64,294157
15991,0.002143,74.125.24.0-255,7156,123619,64,294157
15992,0.002146,172.31.40.0-255,66,123685,64,294157
15993,0.002151,74.125.24.0-255,3602,127287,64,294157
15994,0.002153,172.31.40.0-255,66,127353,64,294157
15995,0.004195,74.125.24.0-255,5738,133091,64,294157
15996,0.004202,172.31.40.0-255,66,133157,64,294157
15997,0.00622,74.125.24.0-255,5738,138895,64,294157
15998,0.006223,172.31.40.0-255,66,138961,64,294157
15999,0.008273,74.125.24.0-255,5738,144699,64,294157
16000,0.00828,172.31.40.0-255,66,144765,64,294157
16001,0.010312,74.125.24.0-255,5738,150503,64,294157
16002,0.010319,172.31.40.0-255,66,150569,64,294157
16003,0.01237,74.125.24.0-255,5738,156307,64,294157
16004,0.012378,172.31.40.0-255,66,156373,64,294157
16005,0.014428,74.125.24.0-255,5738,162111,64,294157
16006,0.014439,172.31.40.0-255,66,162177,64,294157
16007,0.016479,74.125.24.0-255,5738,167915,64,294157
16008,0.016488,172.31.40.0-255,66,167981,64,294157
16009,0.018538,74.125.24.0-255,5738,173719,64,294157
16010,0.018546,172.31.40.0-255,66,173785,64,294157
16011,0.020604,74.125.24.0-255,5738,179523,64,294157
16012,0.020612,172.31.40.0-255,66,179589,64,294157
16013,0.022678,74.125.24.0-255,5738,185327,64,294157
16014,0.022694,172.31.40.0-255,66,185393,64,294157
16015,0.024751,74.125.24.0-255,5738,191131,64,294157
16016,0.024761,172.31.40.0-255,66,191197,64,294157
16017,0.026835,74.125.24.0-255,5738,196935,64,294157
16018,0.026849,172.31.40.0-255,66,197001,64,294157
16019,0.028892,74.125.24.0-255,5738,202739,64,294157
16020,0.02891,172.31.40.0-255,66,202805,64,294157
16021,0.030968,74.125.24.0-255,5738,208543,64,294157
16022,0.030983,172.31.40.0-255,66,208609,64,294157
16023,0.033039,74.125.24.0-255,5738,214347,64,294157
16024,0.033047,172.31.40.0-255,66,214413,64,294157
16025,0.035137,74.125.24.0-255,5738,220151,64,294157
16026,0.035149,172.31.40.0-255,66,220217,64,294157
16027,0.037167,74.125.24.0-255,5738,225955,64,294157
16028,0.037181,172.31.40.0-255,66,226021,64,294157
16029,0.039239,74.125.24.0-255,5738,231759,64,294157
16030,0.039246,172.31.40.0-255,66,231825,64,294157
16031,0.041275,74.125.24.0-255,5738,237563,64,294157
16032,0.041288,172.31.40.0-255,66,237629,64,294157
16033,0.043338,74.125.24.0-255,5738,243367,64,294157
16034,0.043347,172.31.40.0-255,66,243433,64,294157
16035,0.045389,74.125.24.0-255,5738,249171,64,294157
16036,0.045399,172.31.40.0-255,66,249237,64,294157
16037,0.047495,74.125.24.0-255,5738,254975,64,294157
16038,0.047511,172.31.40.0-255,66,255041,64,294157
16039,0.048792,172.31.40.0-255,172,255213,64,294157
16040,0.048823,172.31.40.0-255,1113,256326,64,294157
16041,0.048879,172.31.40.0-255,1514,257840,64,294157
16042,0.048881,172.31.40.0-255,1295,259135,64,294157
16043,0.04955,74.125.24.0-255,5738,264873,64,294157
16044,0.049557,172.31.40.0-255,66,264939,64,294157
16045,0.050303,104.244.42.0-255,66,265005,64,294157
16046,0.050352,104.244.42.0-255,66,265071,64,294157
16047,0.050418,104.244.42.0-255,66,265137,64,294157
16048,0.051603,74.125.24.0-255,5738,270875,64,294157
16049,0.051612,172.31.40.0-255,66,270941,64,294157
16050,0.053705,74.125.24.0-255,5738,276679,64,294157
16051,0.05372,172.31.40.0-255,66,276745,64,294157
16052,0.055769,74.125.24.0-255,5738,282483,64,294157
16053,0.055785,172.31.40.0-255,66,282549,64,294157
16054,0.057837,74.125.24.0-255,5738,288287,64,294157
16055,0.057843,172.31.40.0-255,66,288353,64,294157
16056,0.059887,74.125.24.0-255,5738,294091,64,294157
16057,0.059898,172.31.40.0-255,66,294157,64,294157
16058,0.0,172.217.160.0-255,152,152,64,237003
16059,2.1e-05,172.31.40.0-255,66,218,64,237003
16060,2.8e-05,172.217.160.0-255,1484,1702,64,237003
16061,3.3e-05,172.31.40.0-255,66,1768,64,237003
16062,4e-05,172.217.160.0-255,2902,4670,64,237003
16063,4.4e-05,172.31.40.0-255,66,4736,64,237003
16064,5.1e-05,172.217.160.0-255,7156,11892,64,237003
16065,5.4e-05,172.31.40.0-255,66,11958,64,237003
16066,5.8e-05,172.217.160.0-255,2023,13981,64,237003
16067,6.2e-05,172.31.40.0-255,66,14047,64,237003
16068,8.8e-05,172.31.40.0-255,66,14113,64,237003
16069,0.000106,172.217.160.0-255,2902,17015,64,237003
16070,0.000109,172.31.40.0-255,66,17081,64,237003
16071,0.000127,172.217.160.0-255,4320,21401,64,237003
16072,0.00013,172.31.40.0-255,66,21467,64,237003
16073,0.000144,172.217.160.0-255,1125,22592,64,237003
16074,0.000146,172.31.40.0-255,66,22658,64,237003
16075,0.000357,172.217.160.0-255,1484,24142,64,237003
16076,0.000362,172.31.40.0-255,66,24208,64,237003
16077,0.000367,172.217.160.0-255,2902,27110,64,237003
16078,0.000369,172.31.40.0-255,66,27176,64,237003
16079,0.000375,172.217.160.0-255,5738,32914,64,237003
16080,0.000377,172.31.40.0-255,66,32980,64,237003
16081,0.00038,172.217.160.0-255,1484,34464,64,237003
16082,0.000382,172.31.40.0-255,66,34530,64,237003
16083,0.000404,172.217.160.0-255,2902,37432,64,237003
16084,0.000406,172.31.40.0-255,66,37498,64,237003
16085,0.000426,172.217.160.0-255,1484,38982,64,237003
16086,0.000429,172.31.40.0-255,66,39048,64,237003
16087,0.000461,172.31.40.0-255,66,39114,64,237003
16088,0.000479,172.217.160.0-255,2902,42016,64,237003
16089,0.000498,172.217.160.0-255,6797,48813,64,237003
16090,0.000503,172.31.40.0-255,66,48879,64,237003
16091,0.000522,172.217.160.0-255,333,49212,64,237003
16092,0.00086,172.31.40.0-255,66,49278,64,237003
16093,0.001543,172.217.160.0-255,409,49687,64,237003
16094,0.001664,172.217.160.0-255,1484,51171,64,237003
16095,0.002497,172.217.160.0-255,2902,54073,64,237003
16096,0.006425,172.31.40.0-255,66,54139,64,237003
16097,0.008076,172.217.160.0-255,5738,59877,64,237003
16098,0.010013,172.31.40.0-255,66,59943,64,237003
16099,0.011667,172.217.160.0-255,5738,65681,64,237003
16100,0.011677,172.31.40.0-255,66,65747,64,237003
16101,0.013326,172.217.160.0-255,5738,71485,64,237003
16102,0.013337,172.31.40.0-255,66,71551,64,237003
16103,0.01499,172.217.160.0-255,5738,77289,64,237003
16104,0.014998,172.31.40.0-255,66,77355,64,237003
16105,0.016653,172.217.160.0-255,5738,83093,64,237003
16106,0.016659,172.31.40.0-255,66,83159,64,237003
16107,0.018304,172.217.160.0-255,5738,88897,64,237003
16108,0.018311,172.31.40.0-255,66,88963,64,237003
16109,0.01996,172.217.160.0-255,5738,94701,64,237003
16110,0.019967,172.31.40.0-255,66,94767,64,237003
16111,0.021615,172.217.160.0-255,5738,100505,64,237003
16112,0.021621,172.31.40.0-255,66,100571,64,237003
16113,0.023267,172.217.160.0-255,5738,106309,64,237003
16114,0.023272,172.31.40.0-255,66,106375,64,237003
16115,0.02406,172.31.40.0-255,172,106547,64,237003
16116,0.024086,172.31.40.0-255,1112,107659,64,237003
16117,0.024139,172.31.40.0-255,1514,109173,64,237003
16118,0.02414,172.31.40.0-255,1296,110469,64,237003
16119,0.024928,172.217.160.0-255,5738,116207,64,237003
16120,0.024935,172.31.40.0-255,66,116273,64,237003
16121,0.025622,104.244.42.0-255,66,116339,64,237003
16122,0.025661,104.244.42.0-255,66,116405,64,237003
16123,0.025699,104.244.42.0-255,66,116471,64,237003
16124,0.02658,172.217.160.0-255,5738,122209,64,237003
16125,0.026587,172.31.40.0-255,66,122275,64,237003
16126,0.028229,172.217.160.0-255,5738,128013,64,237003
16127,0.028236,172.31.40.0-255,66,128079,64,237003
16128,0.029885,172.217.160.0-255,5738,133817,64,237003
16129,0.029892,172.31.40.0-255,66,133883,64,237003
16130,0.031533,172.217.160.0-255,4320,138203,64,237003
16131,0.031539,172.31.40.0-255,66,138269,64,237003
16132,0.031563,172.217.160.0-255,1484,139753,64,237003
16133,0.033201,172.217.160.0-255,4320,144073,64,237003
16134,0.033207,172.31.40.0-255,66,144139,64,237003
16135,0.03486,172.217.160.0-255,5738,149877,64,237003
16136,0.034907,172.31.40.0-255,66,149943,64,237003
16137,0.036589,172.217.160.0-255,5738,155681,64,237003
16138,0.036594,172.31.40.0-255,66,155747,64,237003
16139,0.038264,172.217.160.0-255,5738,161485,64,237003
16140,0.03827,172.31.40.0-255,66,161551,64,237003
16141,0.039932,172.217.160.0-255,5738,167289,64,237003
16142,0.039939,172.31.40.0-255,66,167355,64,237003
16143,0.041595,172.217.160.0-255,5738,173093,64,237003
16144,0.041601,172.31.40.0-255,66,173159,64,237003
16145,0.043245,172.217.160.0-255,5738,178897,64,237003
16146,0.043251,172.31.40.0-255,66,178963,64,237003
16147,0.044899,172.217.160.0-255,5738,184701,64,237003
16148,0.044905,172.31.40.0-255,66,184767,64,237003
16149,0.046553,172.217.160.0-255,5738,190505,64,237003
16150,0.046559,172.31.40.0-255,66,190571,64,237003
16151,0.048196,172.217.160.0-255,5738,196309,64,237003
16152,0.048202,172.31.40.0-255,66,196375,64,237003
16153,0.049854,172.217.160.0-255,5738,202113,64,237003
16154,0.04986,172.31.40.0-255,66,202179,64,237003
16155,0.051517,172.217.160.0-255,5738,207917,64,237003
16156,0.051522,172.31.40.0-255,66,207983,64,237003
16157,0.053179,172.217.160.0-255,5738,213721,64,237003
16158,0.053183,172.31.40.0-255,66,213787,64,237003
16159,0.054845,172.217.160.0-255,5738,219525,64,237003
16160,0.054851,172.31.40.0-255,66,219591,64,237003
16161,0.056501,172.217.160.0-255,5738,225329,64,237003
16162,0.056507,172.31.40.0-255,66,225395,64,237003
16163,0.058158,172.217.160.0-255,5738,231133,64,237003
16164,0.058164,172.31.40.0-255,66,231199,64,237003
16165,0.059823,172.217.160.0-255,5738,236937,64,237003
16166,0.059829,172.31.40.0-255,66,237003,64,237003
16167,0.0,172.217.194.0-255,143,143,64,179863
16168,2.4e-05,172.31.40.0-255,66,209,64,179863
16169,3.2e-05,172.217.194.0-255,1484,1693,64,179863
16170,3.7e-05,172.31.40.0-255,66,1759,64,179863
16171,4.2e-05,172.217.194.0-255,2902,4661,64,179863
16172,5.4e-05,172.31.40.0-255,66,4727,64,179863
16173,6.2e-05,172.217.194.0-255,7156,11883,64,179863
16174,6.6e-05,172.31.40.0-255,66,11949,64,179863
16175,7e-05,172.217.194.0-255,2137,14086,64,179863
16176,7.3e-05,172.31.40.0-255,66,14152,64,179863
16177,0.000113,172.217.194.0-255,1484,15636,64,179863
16178,0.000117,172.31.40.0-255,66,15702,64,179863
16179,0.000122,172.217.194.0-255,2902,18604,64,179863
16180,0.000125,172.31.40.0-255,66,18670,64,179863
16181,0.000132,172.217.194.0-255,5738,24408,64,179863
16182,0.000135,172.31.40.0-255,66,24474,64,179863
16183,0.000165,172.217.194.0-255,7156,31630,64,179863
16184,0.000169,172.31.40.0-255,66,31696,64,179863
16185,0.000191,172.217.194.0-255,2543,34239,64,179863
16186,0.000194,172.31.40.0-255,66,34305,64,179863
16187,0.000207,172.31.40.0-255,66,34371,64,179863
16188,0.000212,172.217.194.0-255,3961,38332,64,179863
16189,0.000215,172.31.40.0-255,66,38398,64,179863
16190,0.00022,172.217.194.0-255,4320,42718,64,179863
16191,0.000222,172.31.40.0-255,66,42784,64,179863
16192,0.000225,172.217.194.0-255,1484,44268,64,179863
16193,0.000227,172.31.40.0-255,66,44334,64,179863
16194,0.000272,172.31.40.0-255,66,44400,64,179863
16195,0.000277,172.217.194.0-255,2853,47253,64,179863
16196,0.000279,172.31.40.0-255,66,47319,64,179863
16197,0.000396,172.217.194.0-255,367,47686,64,179863
16198,0.00049,172.217.194.0-255,1484,49170,64,179863
16199,0.000493,172.31.40.0-255,66,49236,64,179863
16200,0.000499,172.217.194.0-255,2902,52138,64,179863
16201,0.000501,172.31.40.0-255,66,52204,64,179863
16202,0.000507,172.217.194.0-255,5738,57942,64,179863
16203,0.00051,172.31.40.0-255,66,58008,64,179863
16204,0.000555,172.217.194.0-255,5738,63746,64,179863
16205,0.000558,172.31.40.0-255,66,63812,64,179863
16206,0.000607,172.31.40.0-255,66,63878,64,179863
16207,0.000623,172.31.40.0-255,66,63944,64,179863
16208,0.000995,172.217.194.0-255,1484,65428,64,179863
16209,0.001002,172.217.194.0-255,2902,68330,64,179863
16210,0.001004,172.31.40.0-255,66,68396,64,179863
16211,0.001011,172.217.194.0-255,4320,72716,64,179863
16212,0.001014,172.31.40.0-255,66,72782,64,179863
16213,0.001029,172.217.194.0-255,1484,74266,64,179863
16214,0.001046,172.31.40.0-255,66,74332,64,179863
16215,0.001087,172.217.194.0-255,5738,80070,64,179863
16216,0.00109,172.31.40.0-255,66,80136,64,179863
16217,0.001124,172.31.40.0-255,66,80202,64,179863
16218,0.001139,172.31.40.0-255,66,80268,64,179863
16219,0.001147,172.217.194.0-255,7156,87424,64,179863
16220,0.00115,172.31.40.0-255,66,87490,64,179863
16221,0.001178,172.217.194.0-255,2902,90392,64,179863
16222,0.001181,172.31.40.0-255,66,90458,64,179863
16223,0.001193,172.31.40.0-255,66,90524,64,179863
16224,0.001267,172.217.194.0-255,1484,92008,64,179863
16225,0.00131,172.217.194.0-255,1484,93492,64,179863
16226,0.001313,172.31.40.0-255,66,93558,64,179863
16227,0.00134,172.217.194.0-255,1484,95042,64,179863
16228,0.001347,172.217.194.0-255,5738,100780,64,179863
16229,0.001349,172.31.40.0-255,66,100846,64,179863
16230,0.001364,172.31.40.0-255,66,100912,64,179863
16231,0.001378,172.217.194.0-255,1484,102396,64,179863
16232,0.001382,172.31.40.0-255,66,102462,64,179863
16233,0.001412,172.217.194.0-255,7156,109618,64,179863
16234,0.001416,172.31.40.0-255,66,109684,64,179863
16235,0.001428,172.31.40.0-255,66,109750,64,179863
16236,0.001485,172.31.40.0-255,66,109816,64,179863
16237,0.001488,172.217.194.0-255,1484,111300,64,179863
16238,0.001513,172.217.194.0-255,2902,114202,64,179863
16239,0.001516,172.31.40.0-255,66,114268,64,179863
16240,0.001522,172.217.194.0-255,5738,120006,64,179863
16241,0.001526,172.31.40.0-255,66,120072,64,179863
16242,0.001532,172.217.194.0-255,5738,125810,64,179863
16243,0.001534,172.31.40.0-255,66,125876,64,179863
16244,0.001574,172.217.194.0-255,7156,133032,64,179863
16245,0.001578,172.31.40.0-255,66,133098,64,179863
16246,0.001584,172.217.194.0-255,5738,138836,64,179863
16247,0.001586,172.31.40.0-255,66,138902,64,179863
16248,0.001619,172.217.194.0-255,5020,143922,64,179863
16249,0.001622,172.31.40.0-255,66,143988,64,179863
16250,0.001652,172.217.194.0-255,5738,149726,64,179863
16251,0.001655,172.31.40.0-255,66,149792,64,179863
16252,0.001661,172.217.194.0-255,5738,155530,64,179863
16253,0.001663,172.31.40.0-255,66,155596,64,179863
16254,0.00171,172.31.40.0-255,66,155662,64,179863
16255,0.001722,172.31.40.0-255,66,155728,64,179863
16256,0.001727,172.217.194.0-255,4320,160048,64,179863
16257,0.00173,172.31.40.0-255,66,160114,64,179863
16258,0.001761,172.217.194.0-255,5738,165852,64,179863
16259,0.001765,172.31.40.0-255,66,165918,64,179863
16260,0.001777,172.31.40.0-255,66,165984,64,179863
16261,0.001814,172.31.40.0-255,66,166050,64,179863
16262,0.00183,172.31.40.0-255,66,166116,64,179863
16263,0.001864,172.217.194.0-255,6438,172554,64,179863
16264,0.001867,172.31.40.0-255,66,172620,64,179863
16265,0.001882,172.31.40.0-255,66,172686,64,179863
16266,0.001931,172.31.40.0-255,66,172752,64,179863
16267,0.001973,172.31.40.0-255,66,172818,64,179863
16268,0.001978,172.217.194.0-255,3306,176124,64,179863
16269,0.001981,172.31.40.0-255,66,176190,64,179863
16270,0.001984,172.217.194.0-255,105,176295,64,179863
16271,0.005068,172.31.40.0-255,66,176361,64,179863
16272,0.005112,172.31.40.0-255,105,176466,64,179863
16273,0.007611,172.217.194.0-255,66,176532,64,179863
16274,0.048746,172.31.40.0-255,172,176704,64,179863
16275,0.048784,172.31.40.0-255,1113,177817,64,179863
16276,0.048846,172.31.40.0-255,1514,179331,64,179863
16277,0.048848,172.31.40.0-255,334,179665,64,179863
16278,0.050281,104.244.42.0-255,66,179731,64,179863
16279,0.050303,104.244.42.0-255,66,179797,64,179863
16280,0.050397,104.244.42.0-255,66,179863,64,179863
16281,0.0,74.125.24.0-255,297,297,64,115656
16282,2.2e-05,172.31.40.0-255,66,363,64,115656
16283,2.9e-05,74.125.24.0-255,1484,1847,64,115656
16284,3.3e-05,172.31.40.0-255,66,1913,64,115656
16285,3.9e-05,74.125.24.0-255,2902,4815,64,115656
16286,4.3e-05,172.31.40.0-255,66,4881,64,115656
16287,4.9e-05,74.125.24.0-255,5738,10619,64,115656
16288,5.2e-05,172.31.40.0-255,66,10685,64,115656
16289,8.5e-05,74.125.24.0-255,1484,12169,64,115656
16290,8.8e-05,172.31.40.0-255,66,12235,64,115656
16291,0.000122,172.31.40.0-255,66,12301,64,115656
16292,0.000223,74.125.24.0-255,2902,15203,64,115656
16293,0.000227,172.31.40.0-255,66,15269,64,115656
16294,0.000261,172.31.40.0-255,66,15335,64,115656
16295,0.000359,74.125.24.0-255,2902,18237,64,115656
16296,0.000363,172.31.40.0-255,66,18303,64,115656
16297,0.000392,172.31.40.0-255,66,18369,64,115656
16298,0.00051,74.125.24.0-255,5738,24107,64,115656
16299,0.000515,172.31.40.0-255,66,24173,64,115656
16300,0.000547,172.31.40.0-255,66,24239,64,115656
16301,0.000698,74.125.24.0-255,2902,27141,64,115656
16302,0.000702,172.31.40.0-255,66,27207,64,115656
16303,0.000754,74.125.24.0-255,7156,34363,64,115656
16304,0.000757,172.31.40.0-255,66,34429,64,115656
16305,0.000786,172.31.40.0-255,66,34495,64,115656
16306,0.000996,74.125.24.0-255,4320,38815,64,115656
16307,0.001,172.31.40.0-255,66,38881,64,115656
16308,0.001029,172.31.40.0-255,66,38947,64,115656
16309,0.00122,172.31.40.0-255,66,39013,64,115656
16310,0.001247,172.31.40.0-255,66,39079,64,115656
16311,0.0015,74.125.24.0-255,5738,44817,64,115656
16312,0.001506,172.31.40.0-255,66,44883,64,115656
16313,0.001546,172.31.40.0-255,66,44949,64,115656
16314,0.001568,74.125.24.0-255,3602,48551,64,115656
16315,0.00157,172.31.40.0-255,66,48617,64,115656
16316,0.001837,172.31.40.0-255,66,48683,64,115656
16317,0.001905,172.31.40.0-255,66,48749,64,115656
16318,0.001922,74.125.24.0-255,4320,53069,64,115656
16319,0.001924,172.31.40.0-255,66,53135,64,115656
16320,0.00259,172.31.40.0-255,66,53201,64,115656
16321,0.002652,172.31.40.0-255,66,53267,64,115656
16322,0.002676,74.125.24.0-255,5738,59005,64,115656
16323,0.00268,172.31.40.0-255,66,59071,64,115656
16324,0.003337,74.125.24.0-255,5738,64809,64,115656
16325,0.003345,172.31.40.0-255,66,64875,64,115656
16326,0.014077,172.31.40.0-255,66,64941,64,115656
16327,0.015053,74.125.24.0-255,1484,66425,64,115656
16328,0.016438,74.125.24.0-255,4320,70745,64,115656
16329,0.016445,172.31.40.0-255,66,70811,64,115656
16330,0.01876,74.125.24.0-255,5738,76549,64,115656
16331,0.018766,172.31.40.0-255,66,76615,64,115656
16332,0.021144,74.125.24.0-255,5738,82353,64,115656
16333,0.021161,172.31.40.0-255,66,82419,64,115656
16334,0.023498,74.125.24.0-255,5738,88157,64,115656
16335,0.023505,172.31.40.0-255,66,88223,64,115656
16336,0.025667,172.31.40.0-255,101,88324,64,115656
16337,0.025884,74.125.24.0-255,5738,94062,64,115656
16338,0.025891,172.31.40.0-255,66,94128,64,115656
16339,0.027973,74.125.24.0-255,66,94194,64,115656
16340,0.028243,74.125.24.0-255,4320,98514,64,115656
16341,0.02825,172.31.40.0-255,66,98580,64,115656
16342,0.028268,74.125.24.0-255,1484,100064,64,115656
16343,0.030617,74.125.24.0-255,4320,104384,64,115656
16344,0.030626,172.31.40.0-255,66,104450,64,115656
16345,0.033011,74.125.24.0-255,5738,110188,64,115656
16346,0.033019,172.31.40.0-255,66,110254,64,115656
16347,0.035398,74.125.24.0-255,939,111193,64,115656
16348,0.035619,172.31.40.0-255,105,111298,64,115656
16349,0.043026,74.125.24.0-255,66,111364,64,115656
16350,0.053114,172.31.40.0-255,172,111536,64,115656
16351,0.05315,172.31.40.0-255,1112,112648,64,115656
16352,0.053212,172.31.40.0-255,1514,114162,64,115656
16353,0.053214,172.31.40.0-255,1296,115458,64,115656
16354,0.054665,104.244.42.0-255,66,115524,64,115656
16355,0.054727,104.244.42.0-255,66,115590,64,115656
16356,0.054778,104.244.42.0-255,66,115656,64,115656
16357,0.0,74.125.24.0-255,153,153,64,234052
16358,1.5e-05,172.31.40.0-255,66,219,64,234052
16359,2.1e-05,74.125.24.0-255,1484,1703,64,234052
16360,2.6e-05,172.31.40.0-255,66,1769,64,234052
16361,3.1e-05,74.125.24.0-255,2902,4671,64,234052
16362,3.5e-05,172.31.40.0-255,66,4737,64,234052
16363,4e-05,74.125.24.0-255,2902,7639,64,234052
16364,4.3e-05,172.31.40.0-255,66,7705,64,234052
16365,7.7e-05,74.125.24.0-255,2902,10607,64,234052
16366,8e-05,172.31.40.0-255,66,10673,64,234052
16367,8.7e-05,74.125.24.0-255,6157,16830,64,234052
16368,8.9e-05,172.31.40.0-255,66,16896,64,234052
16369,0.000104,172.31.40.0-255,66,16962,64,234052
16370,0.000142,74.125.24.0-255,4320,21282,64,234052
16371,0.000144,172.31.40.0-255,66,21348,64,234052
16372,0.00018,74.125.24.0-255,2543,23891,64,234052
16373,0.000184,172.31.40.0-255,66,23957,64,234052
16374,0.000187,172.31.40.0-255,66,24023,64,234052
16375,0.000682,74.125.24.0-255,1484,25507,64,234052
16376,0.000689,172.31.40.0-255,66,25573,64,234052
16377,0.000695,74.125.24.0-255,2902,28475,64,234052
16378,0.000697,172.31.40.0-255,66,28541,64,234052
16379,0.000703,74.125.24.0-255,4320,32861,64,234052
16380,0.000705,172.31.40.0-255,66,32927,64,234052
16381,0.000727,74.125.24.0-255,1484,34411,64,234052
16382,0.00073,172.31.40.0-255,66,34477,64,234052
16383,0.000735,74.125.24.0-255,4320,38797,64,234052
16384,0.000737,172.31.40.0-255,66,38863,64,234052
16385,0.000756,74.125.24.0-255,3123,41986,64,234052
16386,0.000759,172.31.40.0-255,66,42052,64,234052
16387,0.00079,74.125.24.0-255,4320,46372,64,234052
16388,0.000802,172.31.40.0-255,66,46438,64,234052
16389,0.000814,74.125.24.0-255,7156,53594,64,234052
16390,0.000824,74.125.24.0-255,1484,55078,64,234052
16391,0.000826,172.31.40.0-255,66,55144,64,234052
16392,0.000847,74.125.24.0-255,5738,60882,64,234052
16393,0.000857,172.31.40.0-255,66,60948,64,234052
16394,0.000868,74.125.24.0-255,3961,64909,64,234052
16395,0.000873,74.125.24.0-255,5738,70647,64,234052
16396,0.000879,172.31.40.0-255,66,70713,64,234052
16397,0.000917,74.125.24.0-255,5379,76092,64,234052
16398,0.000943,172.31.40.0-255,66,76158,64,234052
16399,0.00214,74.125.24.0-255,1484,77642,64,234052
16400,0.002152,74.125.24.0-255,2902,80544,64,234052
16401,0.002156,172.31.40.0-255,66,80610,64,234052
16402,0.002163,74.125.24.0-255,2902,83512,64,234052
16403,0.002182,74.125.24.0-255,2902,86414,64,234052
16404,0.002215,74.125.24.0-255,7156,93570,64,234052
16405,0.002236,74.125.24.0-255,5738,99308,64,234052
16406,0.00224,74.125.24.0-255,2902,102210,64,234052
16407,0.003876,172.31.40.0-255,66,102276,64,234052
16408,0.006217,74.125.24.0-255,5738,108014,64,234052
16409,0.006223,172.31.40.0-255,66,108080,64,234052
16410,0.008551,74.125.24.0-255,5738,113818,64,234052
16411,0.008559,172.31.40.0-255,66,113884,64,234052
16412,0.010921,74.125.24.0-255,5738,119622,64,234052
16413,0.012317,172.31.40.0-255,66,119688,64,234052
16414,0.014653,74.125.24.0-255,5738,125426,64,234052
16415,0.014667,172.31.40.0-255,66,125492,64,234052
16416,0.017002,74.125.24.0-255,5738,131230,64,234052
16417,0.017018,172.31.40.0-255,66,131296,64,234052
16418,0.0194,74.125.24.0-255,5738,137034,64,234052
16419,0.019414,172.31.40.0-255,66,137100,64,234052
16420,0.021828,74.125.24.0-255,5738,142838,64,234052
16421,0.021844,172.31.40.0-255,66,142904,64,234052
16422,0.024229,74.125.24.0-255,5738,148642,64,234052
16423,0.024249,172.31.40.0-255,66,148708,64,234052
16424,0.026615,74.125.24.0-255,5738,154446,64,234052
16425,0.026631,172.31.40.0-255,66,154512,64,234052
16426,0.028674,172.31.40.0-255,166,154678,64,234052
16427,0.02871,172.31.40.0-255,1135,155813,64,234052
16428,0.028776,172.31.40.0-255,1514,157327,64,234052
16429,0.028777,172.31.40.0-255,1514,158841,64,234052
16430,0.028779,172.31.40.0-255,673,159514,64,234052
16431,0.028979,74.125.24.0-255,5738,165252,64,234052
16432,0.028989,172.31.40.0-255,66,165318,64,234052
16433,0.030232,104.244.42.0-255,66,165384,64,234052
16434,0.030274,104.244.42.0-255,66,165450,64,234052
16435,0.030359,104.244.42.0-255,66,165516,64,234052
16436,0.030364,104.244.42.0-255,66,165582,64,234052
16437,0.031348,74.125.24.0-255,5738,171320,64,234052
16438,0.031358,172.31.40.0-255,66,171386,64,234052
16439,0.031791,104.244.42.0-255,108,171494,64,234052
16440,0.031796,172.31.40.0-255,66,171560,64,234052
16441,0.033736,74.125.24.0-255,5738,177298,64,234052
16442,0.033748,172.31.40.0-255,66,177364,64,234052
16443,0.036105,74.125.24.0-255,5738,183102,64,234052
16444,0.036116,172.31.40.0-255,66,183168,64,234052
16445,0.038585,74.125.24.0-255,4320,187488,64,234052
16446,0.038593,172.31.40.0-255,66,187554,64,234052
16447,0.038613,74.125.24.0-255,1484,189038,64,234052
16448,0.040975,74.125.24.0-255,4320,193358,64,234052
16449,0.040996,172.31.40.0-255,66,193424,64,234052
16450,0.043394,74.125.24.0-255,5738,199162,64,234052
16451,0.043864,172.31.40.0-255,66,199228,64,234052
16452,0.046227,74.125.24.0-255,5738,204966,64,234052
16453,0.046248,172.31.40.0-255,66,205032,64,234052
16454,0.048608,74.125.24.0-255,5738,210770,64,234052
16455,0.048625,172.31.40.0-255,66,210836,64,234052
16456,0.050989,74.125.24.0-255,5738,216574,64,234052
16457,0.051009,172.31.40.0-255,66,216640,64,234052
16458,0.053411,74.125.24.0-255,5738,222378,64,234052
16459,0.053428,172.31.40.0-255,66,222444,64,234052
16460,0.055817,74.125.24.0-255,5738,228182,64,234052
16461,0.055863,172.31.40.0-255,66,228248,64,234052
16462,0.058238,74.125.24.0-255,5738,233986,64,234052
16463,0.058256,172.31.40.0-255,66,234052,64,234052
16464,0.0,172.217.194.0-255,298,298,64,205148
16465,1.9e-05,172.31.40.0-255,66,364,64,205148
16466,2.6e-05,172.217.194.0-255,1484,1848,64,205148
16467,3e-05,172.31.40.0-255,66,1914,64,205148
16468,3.4e-05,172.217.194.0-255,1484,3398,64,205148
16469,3.7e-05,172.31.40.0-255,66,3464,64,205148
16470,6.2e-05,172.217.194.0-255,2902,6366,64,205148
16471,6.5e-05,172.31.40.0-255,66,6432,64,205148
16472,8.2e-05,172.31.40.0-255,66,6498,64,205148
16473,0.000111,172.217.194.0-255,1484,7982,64,205148
16474,0.000114,172.31.40.0-255,66,8048,64,205148
16475,0.000119,172.217.194.0-255,2902,10950,64,205148
16476,0.000122,172.31.40.0-255,66,11016,64,205148
16477,0.000162,172.217.194.0-255,5738,16754,64,205148
16478,0.000165,172.31.40.0-255,66,16820,64,205148
16479,0.000172,172.217.194.0-255,6797,23617,64,205148
16480,0.000175,172.31.40.0-255,66,23683,64,205148
16481,0.000646,172.217.194.0-255,1484,25167,64,205148
16482,0.000653,172.31.40.0-255,66,25233,64,205148
16483,0.000659,172.217.194.0-255,2902,28135,64,205148
16484,0.000662,172.31.40.0-255,66,28201,64,205148
16485,0.000687,172.217.194.0-255,5738,33939,64,205148
16486,0.00069,172.31.40.0-255,66,34005,64,205148
16487,0.000701,172.217.194.0-255,6797,40802,64,205148
16488,0.000703,172.31.40.0-255,66,40868,64,205148
16489,0.000754,172.31.40.0-255,66,40934,64,205148
16490,0.000758,172.217.194.0-255,2543,43477,64,205148
16491,0.00076,172.31.40.0-255,66,43543,64,205148
16492,0.001928,172.217.194.0-255,647,44190,64,205148
16493,0.001936,172.31.40.0-255,66,44256,64,205148
16494,0.002019,172.217.194.0-255,1484,45740,64,205148
16495,0.002036,172.217.194.0-255,2902,48642,64,205148
16496,0.002039,172.31.40.0-255,66,48708,64,205148
16497,0.002045,172.217.194.0-255,4320,53028,64,205148
16498,0.002048,172.31.40.0-255,66,53094,64,205148
16499,0.002065,172.217.194.0-255,1484,54578,64,205148
16500,0.00209,172.217.194.0-255,4320,58898,64,205148
16501,0.002093,172.31.40.0-255,66,58964,64,205148
16502,0.00213,172.31.40.0-255,66,59030,64,205148
16503,0.002133,172.217.194.0-255,1484,60514,64,205148
16504,0.002145,172.31.40.0-255,66,60580,64,205148
16505,0.004458,172.217.194.0-255,5738,66318,64,205148
16506,0.004466,172.31.40.0-255,66,66384,64,205148
16507,0.006874,172.217.194.0-255,5738,72122,64,205148
16508,0.006885,172.31.40.0-255,66,72188,64,205148
16509,0.00918,172.217.194.0-255,5738,77926,64,205148
16510,0.009191,172.31.40.0-255,66,77992,64,205148
16511,0.011513,172.217.194.0-255,5738,83730,64,205148
16512,0.011522,172.31.40.0-255,66,83796,64,205148
16513,0.013861,172.217.194.0-255,5738,89534,64,205148
16514,0.013868,172.31.40.0-255,66,89600,64,205148
16515,0.016179,172.217.194.0-255,5738,95338,64,205148
16516,0.016187,172.31.40.0-255,66,95404,64,205148
16517,0.01852,172.217.194.0-255,5738,101142,64,205148
16518,0.018526,172.31.40.0-255,66,101208,64,205148
16519,0.020884,172.217.194.0-255,5738,106946,64,205148
16520,0.020892,172.31.40.0-255,66,107012,64,205148
16521,0.023212,172.217.194.0-255,5738,112750,64,205148
16522,0.02322,172.31.40.0-255,66,112816,64,205148
16523,0.025534,172.217.194.0-255,5738,118554,64,205148
16524,0.025541,172.31.40.0-255,66,118620,64,205148
16525,0.027864,172.217.194.0-255,5738,124358,64,205148
16526,0.02787,172.31.40.0-255,66,124424,64,205148
16527,0.030162,172.217.194.0-255,5738,130162,64,205148
16528,0.03017,172.31.40.0-255,66,130228,64,205148
16529,0.032212,172.31.40.0-255,172,130400,64,205148
16530,0.03224,172.31.40.0-255,1111,131511,64,205148
16531,0.032293,172.31.40.0-255,1514,133025,64,205148
16532,0.032295,172.31.40.0-255,1514,134539,64,205148
16533,0.032296,172.31.40.0-255,697,135236,64,205148
16534,0.032472,172.217.194.0-255,5738,140974,64,205148
16535,0.032478,172.31.40.0-255,66,141040,64,205148
16536,0.033765,104.244.42.0-255,66,141106,64,205148
16537,0.033772,104.244.42.0-255,66,141172,64,205148
16538,0.033847,104.244.42.0-255,66,141238,64,205148
16539,0.033851,104.244.42.0-255,66,141304,64,205148
16540,0.034778,172.217.194.0-255,5738,147042,64,205148
16541,0.034785,172.31.40.0-255,66,147108,64,205148
16542,0.037111,172.217.194.0-255,5738,152846,64,205148
16543,0.037117,172.31.40.0-255,66,152912,64,205148
16544,0.039445,172.217.194.0-255,5738,158650,64,205148
16545,0.039451,172.31.40.0-255,66,158716,64,205148
16546,0.041769,172.217.194.0-255,5738,164454,64,205148
16547,0.041779,172.31.40.0-255,66,164520,64,205148
16548,0.044146,172.217.194.0-255,5738,170258,64,205148
16549,0.044153,172.31.40.0-255,66,170324,64,205148
16550,0.046455,172.217.194.0-255,5738,176062,64,205148
16551,0.046462,172.31.40.0-255,66,176128,64,205148
16552,0.048783,172.217.194.0-255,5738,181866,64,205148
16553,0.048789,172.31.40.0-255,66,181932,64,205148
16554,0.051097,172.217.194.0-255,5738,187670,64,205148
16555,0.051104,172.31.40.0-255,66,187736,64,205148
16556,0.053441,172.217.194.0-255,5738,193474,64,205148
16557,0.053447,172.31.40.0-255,66,193540,64,205148
16558,0.055763,172.217.194.0-255,5738,199278,64,205148
16559,0.055769,172.31.40.0-255,66,199344,64,205148
16560,0.058097,172.217.194.0-255,5738,205082,64,205148
16561,0.058104,172.31.40.0-255,66,205148,64,205148
16562,0.0,74.125.24.0-255,152,152,64,236990
16563,2.3e-05,172.31.40.0-255,66,218,64,236990
16564,3e-05,74.125.24.0-255,1484,1702,64,236990
16565,3.4e-05,172.31.40.0-255,66,1768,64,236990
16566,4.1e-05,74.125.24.0-255,2902,4670,64,236990
16567,4.5e-05,172.31.40.0-255,66,4736,64,236990
16568,4.8e-05,74.125.24.0-255,1484,6220,64,236990
16569,5e-05,172.31.40.0-255,66,6286,64,236990
16570,5.6e-05,74.125.24.0-255,2902,9188,64,236990
16571,5.8e-05,172.31.40.0-255,66,9254,64,236990
16572,9.8e-05,74.125.24.0-255,4776,14030,64,236990
16573,0.000101,172.31.40.0-255,66,14096,64,236990
16574,0.000134,74.125.24.0-255,1484,15580,64,236990
16575,0.000137,172.31.40.0-255,66,15646,64,236990
16576,0.000155,74.125.24.0-255,2902,18548,64,236990
16577,0.000157,172.31.40.0-255,66,18614,64,236990
16578,0.000163,74.125.24.0-255,4320,22934,64,236990
16579,0.000165,172.31.40.0-255,66,23000,64,236990
16580,0.000189,74.125.24.0-255,1484,24484,64,236990
16581,0.000191,172.31.40.0-255,66,24550,64,236990
16582,0.000199,74.125.24.0-255,6797,31347,64,236990
16583,0.000201,172.31.40.0-255,66,31413,64,236990
16584,0.000306,74.125.24.0-255,1484,32897,64,236990
16585,0.00031,172.31.40.0-255,66,32963,64,236990
16586,0.000315,74.125.24.0-255,2902,35865,64,236990
16587,0.000318,172.31.40.0-255,66,35931,64,236990
16588,0.000324,74.125.24.0-255,5738,41669,64,236990
16589,0.000327,172.31.40.0-255,66,41735,64,236990
16590,0.000332,74.125.24.0-255,4320,46055,64,236990
16591,0.000335,172.31.40.0-255,66,46121,64,236990
16592,0.000357,74.125.24.0-255,1484,47605,64,236990
16593,0.000359,172.31.40.0-255,66,47671,64,236990
16594,0.000372,172.31.40.0-255,66,47737,64,236990
16595,0.000386,74.125.24.0-255,2543,50280,64,236990
16596,0.000388,172.31.40.0-255,66,50346,64,236990
16597,0.000394,74.125.24.0-255,4296,54642,64,236990
16598,0.000488,172.31.40.0-255,66,54708,64,236990
16599,0.001371,74.125.24.0-255,110,54818,64,236990
16600,0.001404,74.125.24.0-255,1484,56302,64,236990
16601,0.001408,172.31.40.0-255,66,56368,64,236990
16602,0.001415,74.125.24.0-255,2902,59270,64,236990
16603,0.001417,172.31.40.0-255,66,59336,64,236990
16604,0.001443,74.125.24.0-255,7156,66492,64,236990
16605,0.001446,172.31.40.0-255,66,66558,64,236990
16606,0.001453,74.125.24.0-255,5379,71937,64,236990
16607,0.001455,172.31.40.0-255,66,72003,64,236990
16608,0.001484,74.125.24.0-255,5738,77741,64,236990
16609,0.001487,172.31.40.0-255,66,77807,64,236990
16610,0.00152,172.31.40.0-255,66,77873,64,236990
16611,0.00154,74.125.24.0-255,2543,80416,64,236990
16612,0.001543,172.31.40.0-255,66,80482,64,236990
16613,0.002184,74.125.24.0-255,1484,81966,64,236990
16614,0.002191,74.125.24.0-255,2902,84868,64,236990
16615,0.002196,172.31.40.0-255,66,84934,64,236990
16616,0.002218,74.125.24.0-255,4320,89254,64,236990
16617,0.002221,172.31.40.0-255,66,89320,64,236990
16618,0.002228,74.125.24.0-255,5738,95058,64,236990
16619,0.00223,172.31.40.0-255,66,95124,64,236990
16620,0.002251,74.125.24.0-255,1484,96608,64,236990
16621,0.002273,172.31.40.0-255,66,96674,64,236990
16622,0.002295,74.125.24.0-255,1484,98158,64,236990
16623,0.006644,172.31.40.0-255,66,98224,64,236990
16624,0.008926,74.125.24.0-255,5738,103962,64,236990
16625,0.008934,172.31.40.0-255,66,104028,64,236990
16626,0.011222,74.125.24.0-255,5738,109766,64,236990
16627,0.011229,172.31.40.0-255,66,109832,64,236990
16628,0.013494,74.125.24.0-255,5738,115570,64,236990
16629,0.013507,172.31.40.0-255,66,115636,64,236990
16630,0.015829,74.125.24.0-255,5738,121374,64,236990
16631,0.015838,172.31.40.0-255,66,121440,64,236990
16632,0.018131,74.125.24.0-255,5738,127178,64,236990
16633,0.018143,172.31.40.0-255,66,127244,64,236990
16634,0.020456,74.125.24.0-255,5738,132982,64,236990
16635,0.020465,172.31.40.0-255,66,133048,64,236990
16636,0.022782,74.125.24.0-255,5738,138786,64,236990
16637,0.022792,172.31.40.0-255,66,138852,64,236990
16638,0.025102,74.125.24.0-255,5738,144590,64,236990
16639,0.025109,172.31.40.0-255,66,144656,64,236990
16640,0.0266,172.31.40.0-255,172,144828,64,236990
16641,0.026627,172.31.40.0-255,1111,145939,64,236990
16642,0.026679,172.31.40.0-255,1514,147453,64,236990
16643,0.02668,172.31.40.0-255,1514,148967,64,236990
16644,0.026702,172.31.40.0-255,699,149666,64,236990
16645,0.027406,74.125.24.0-255,5738,155404,64,236990
16646,0.027412,172.31.40.0-255,66,155470,64,236990
16647,0.028153,104.244.42.0-255,66,155536,64,236990
16648,0.02816,104.244.42.0-255,66,155602,64,236990
16649,0.028202,104.244.42.0-255,66,155668,64,236990
16650,0.028206,104.244.42.0-255,66,155734,64,236990
16651,0.029708,74.125.24.0-255,5738,161472,64,236990
16652,0.029714,172.31.40.0-255,66,161538,64,236990
16653,0.031992,74.125.24.0-255,5738,167276,64,236990
16654,0.031998,172.31.40.0-255,66,167342,64,236990
16655,0.034298,74.125.24.0-255,5738,173080,64,236990
16656,0.034305,172.31.40.0-255,66,173146,64,236990
16657,0.036585,74.125.24.0-255,5738,178884,64,236990
16658,0.03659,172.31.40.0-255,66,178950,64,236990
16659,0.038901,74.125.24.0-255,5738,184688,64,236990
16660,0.03891,172.31.40.0-255,66,184754,64,236990
16661,0.041224,74.125.24.0-255,5738,190492,64,236990
16662,0.04123,172.31.40.0-255,66,190558,64,236990
16663,0.043524,74.125.24.0-255,5738,196296,64,236990
16664,0.04353,172.31.40.0-255,66,196362,64,236990
16665,0.045793,74.125.24.0-255,5738,202100,64,236990
16666,0.0458,172.31.40.0-255,66,202166,64,236990
16667,0.048083,74.125.24.0-255,5738,207904,64,236990
16668,0.048089,172.31.40.0-255,66,207970,64,236990
16669,0.050381,74.125.24.0-255,5738,213708,64,236990
16670,0.050388,172.31.40.0-255,66,213774,64,236990
16671,0.052678,74.125.24.0-255,5738,219512,64,236990
16672,0.052687,172.31.40.0-255,66,219578,64,236990
16673,0.054992,74.125.24.0-255,5738,225316,64,236990
16674,0.055008,172.31.40.0-255,66,225382,64,236990
16675,0.057311,74.125.24.0-255,5738,231120,64,236990
16676,0.057329,172.31.40.0-255,66,231186,64,236990
16677,0.059658,74.125.24.0-255,5738,236924,64,236990
16678,0.059673,172.31.40.0-255,66,236990,64,236990
16679,0.0,74.125.24.0-255,150,150,64,159805
16680,2.1e-05,172.31.40.0-255,66,216,64,159805
16681,2.8e-05,74.125.24.0-255,1484,1700,64,159805
16682,3.2e-05,172.31.40.0-255,66,1766,64,159805
16683,3.8e-05,74.125.24.0-255,2902,4668,64,159805
16684,4.9e-05,172.31.40.0-255,66,4734,64,159805
16685,5.7e-05,74.125.24.0-255,7156,11890,64,159805
16686,6e-05,172.31.40.0-255,66,11956,64,159805
16687,8.1e-05,74.125.24.0-255,1484,13440,64,159805
16688,8.3e-05,172.31.40.0-255,66,13506,64,159805
16689,0.000108,74.125.24.0-255,567,14073,64,159805
16690,0.000111,172.31.40.0-255,66,14139,64,159805
16691,0.000152,74.125.24.0-255,1484,15623,64,159805
16692,0.000155,172.31.40.0-255,66,15689,64,159805
16693,0.000158,74.125.24.0-255,1484,17173,64,159805
16694,0.000161,172.31.40.0-255,66,17239,64,159805
16695,0.000186,74.125.24.0-255,1484,18723,64,159805
16696,0.000188,172.31.40.0-255,66,18789,64,159805
16697,0.000199,74.125.24.0-255,5738,24527,64,159805
16698,0.000202,172.31.40.0-255,66,24593,64,159805
16699,0.000207,74.125.24.0-255,4320,28913,64,159805
16700,0.000209,172.31.40.0-255,66,28979,64,159805
16701,0.000246,74.125.24.0-255,2543,31522,64,159805
16702,0.000252,74.125.24.0-255,7156,38678,64,159805
16703,0.000265,172.31.40.0-255,66,38744,64,159805
16704,0.000268,172.31.40.0-255,66,38810,64,159805
16705,0.000276,172.31.40.0-255,66,38876,64,159805
16706,0.000312,172.31.40.0-255,66,38942,64,159805
16707,0.000316,74.125.24.0-255,2902,41844,64,159805
16708,0.000319,172.31.40.0-255,66,41910,64,159805
16709,0.000359,74.125.24.0-255,4296,46206,64,159805
16710,0.000362,172.31.40.0-255,66,46272,64,159805
16711,0.000387,74.125.24.0-255,110,46382,64,159805
16712,0.000499,74.125.24.0-255,1484,47866,64,159805
16713,0.000504,172.31.40.0-255,66,47932,64,159805
16714,0.00051,74.125.24.0-255,2902,50834,64,159805
16715,0.000513,172.31.40.0-255,66,50900,64,159805
16716,0.000516,74.125.24.0-255,1484,52384,64,159805
16717,0.000546,74.125.24.0-255,4320,56704,64,159805
16718,0.000549,172.31.40.0-255,66,56770,64,159805
16719,0.000559,172.31.40.0-255,66,56836,64,159805
16720,0.000589,74.125.24.0-255,5379,62215,64,159805
16721,0.000592,172.31.40.0-255,66,62281,64,159805
16722,0.000609,172.31.40.0-255,66,62347,64,159805
16723,0.000611,74.125.24.0-255,330,62677,64,159805
16724,0.000746,74.125.24.0-255,1484,64161,64,159805
16725,0.000751,172.31.40.0-255,66,64227,64,159805
16726,0.000755,74.125.24.0-255,1484,65711,64,159805
16727,0.000781,74.125.24.0-255,1484,67195,64,159805
16728,0.000787,74.125.24.0-255,5738,72933,64,159805
16729,0.00079,74.125.24.0-255,2902,75835,64,159805
16730,0.000794,172.31.40.0-255,66,75901,64,159805
16731,0.000802,172.31.40.0-255,66,75967,64,159805
16732,0.000805,172.31.40.0-255,66,76033,64,159805
16733,0.000816,172.31.40.0-255,66,76099,64,159805
16734,0.000864,172.31.40.0-255,66,76165,64,159805
16735,0.00126,74.125.24.0-255,1484,77649,64,159805
16736,0.001275,74.125.24.0-255,2902,80551,64,159805
16737,0.001278,172.31.40.0-255,66,80617,64,159805
16738,0.001307,74.125.24.0-255,5738,86355,64,159805
16739,0.00131,172.31.40.0-255,66,86421,64,159805
16740,0.001318,74.125.24.0-255,7156,93577,64,159805
16741,0.00132,172.31.40.0-255,66,93643,64,159805
16742,0.001342,74.125.24.0-255,5738,99381,64,159805
16743,0.001345,172.31.40.0-255,66,99447,64,159805
16744,0.001356,172.31.40.0-255,66,99513,64,159805
16745,0.001387,74.125.24.0-255,766,100279,64,159805
16746,0.001505,74.125.24.0-255,1484,101763,64,159805
16747,0.001508,74.125.24.0-255,1484,103247,64,159805
16748,0.001515,172.31.40.0-255,66,103313,64,159805
16749,0.001526,74.125.24.0-255,1484,104797,64,159805
16750,0.001532,172.31.40.0-255,66,104863,64,159805
16751,0.00154,74.125.24.0-255,5738,110601,64,159805
16752,0.001542,172.31.40.0-255,66,110667,64,159805
16753,0.001581,74.125.24.0-255,7156,117823,64,159805
16754,0.001584,172.31.40.0-255,66,117889,64,159805
16755,0.00159,74.125.24.0-255,5738,123627,64,159805
16756,0.001593,172.31.40.0-255,66,123693,64,159805
16757,0.001631,172.31.40.0-255,66,123759,64,159805
16758,0.001635,74.125.24.0-255,2184,125943,64,159805
16759,0.001637,172.31.40.0-255,66,126009,64,159805
16760,0.001748,74.125.24.0-255,1484,127493,64,159805
16761,0.001754,74.125.24.0-255,2902,130395,64,159805
16762,0.001758,172.31.40.0-255,66,130461,64,159805
16763,0.001786,74.125.24.0-255,5738,136199,64,159805
16764,0.001789,172.31.40.0-255,66,136265,64,159805
16765,0.001792,74.125.24.0-255,1484,137749,64,159805
16766,0.001826,172.31.40.0-255,66,137815,64,159805
16767,0.001858,74.125.24.0-255,5738,143553,64,159805
16768,0.001861,172.31.40.0-255,66,143619,64,159805
16769,0.001898,172.31.40.0-255,66,143685,64,159805
16770,0.001917,172.31.40.0-255,66,143751,64,159805
16771,0.001934,172.31.40.0-255,66,143817,64,159805
16772,0.001972,74.125.24.0-255,7156,150973,64,159805
16773,0.001975,172.31.40.0-255,66,151039,64,159805
16774,0.001997,172.31.40.0-255,66,151105,64,159805
16775,0.002014,172.31.40.0-255,66,151171,64,159805
16776,0.002026,172.31.40.0-255,66,151237,64,159805
16777,0.002131,172.31.40.0-255,66,151303,64,159805
16778,0.002164,74.125.24.0-255,3602,154905,64,159805
16779,0.002219,74.125.24.0-255,105,155010,64,159805
16780,0.002224,172.31.40.0-255,66,155076,64,159805
16781,0.002227,172.31.40.0-255,66,155142,64,159805
16782,0.00223,172.31.40.0-255,66,155208,64,159805
16783,0.002245,172.31.40.0-255,66,155274,64,159805
16784,0.011027,172.31.40.0-255,66,155340,64,159805
16785,0.011067,172.31.40.0-255,105,155445,64,159805
16786,0.013532,74.125.24.0-255,66,155511,64,159805
16787,0.031574,172.31.40.0-255,172,155683,64,159805
16788,0.03161,172.31.40.0-255,1111,156794,64,159805
16789,0.031673,172.31.40.0-255,1514,158308,64,159805
16790,0.031675,172.31.40.0-255,1299,159607,64,159805
16791,0.033102,104.244.42.0-255,66,159673,64,159805
16792,0.03314,104.244.42.0-255,66,159739,64,159805
16793,0.033224,104.244.42.0-255,66,159805,64,159805
16794,0.0,172.217.194.0-255,146,146,64,255303
16795,2.1e-05,172.31.40.0-255,66,212,64,255303
16796,2.8e-05,172.217.194.0-255,1484,1696,64,255303
16797,3.3e-05,172.31.40.0-255,66,1762,64,255303
16798,3.9e-05,172.217.194.0-255,2902,4664,64,255303
16799,5e-05,172.31.40.0-255,66,4730,64,255303
16800,5.8e-05,172.217.194.0-255,7156,11886,64,255303
16801,6.2e-05,172.31.40.0-255,66,11952,64,255303
16802,6.6e-05,172.217.194.0-255,2065,14017,64,255303
16803,6.9e-05,172.31.40.0-255,66,14083,64,255303
16804,0.00011,172.217.194.0-255,1484,15567,64,255303
16805,0.000113,172.31.40.0-255,66,15633,64,255303
16806,0.000118,172.217.194.0-255,2902,18535,64,255303
16807,0.00012,172.31.40.0-255,66,18601,64,255303
16808,0.000131,172.217.194.0-255,5738,24339,64,255303
16809,0.000134,172.31.40.0-255,66,24405,64,255303
16810,0.000198,172.217.194.0-255,6797,31202,64,255303
16811,0.000201,172.31.40.0-255,66,31268,64,255303
16812,0.000209,172.217.194.0-255,7156,38424,64,255303
16813,0.000216,172.31.40.0-255,66,38490,64,255303
16814,0.000227,172.31.40.0-255,66,38556,64,255303
16815,0.000383,172.217.194.0-255,1484,40040,64,255303
16816,0.000387,172.31.40.0-255,66,40106,64,255303
16817,0.000393,172.217.194.0-255,2902,43008,64,255303
16818,0.000396,172.31.40.0-255,66,43074,64,255303
16819,0.000408,172.217.194.0-255,5738,48812,64,255303
16820,0.000411,172.31.40.0-255,66,48878,64,255303
16821,0.00046,172.217.194.0-255,7072,55950,64,255303
16822,0.000463,172.31.40.0-255,66,56016,64,255303
16823,0.000547,172.217.194.0-255,403,56419,64,255303
16824,0.00055,172.31.40.0-255,66,56485,64,255303
16825,0.00064,172.217.194.0-255,1484,57969,64,255303
16826,0.000656,172.217.194.0-255,2902,60871,64,255303
16827,0.000659,172.31.40.0-255,66,60937,64,255303
16828,0.000663,172.217.194.0-255,1484,62421,64,255303
16829,0.00069,172.217.194.0-255,4320,66741,64,255303
16830,0.000694,172.31.40.0-255,66,66807,64,255303
16831,0.000724,172.31.40.0-255,66,66873,64,255303
16832,0.000761,172.217.194.0-255,1484,68357,64,255303
16833,0.000793,172.31.40.0-255,66,68423,64,255303
16834,0.000979,172.217.194.0-255,1484,69907,64,255303
16835,0.000986,172.217.194.0-255,2902,72809,64,255303
16836,0.000989,172.31.40.0-255,66,72875,64,255303
16837,0.000992,172.217.194.0-255,1484,74359,64,255303
16838,0.00102,172.217.194.0-255,4320,78679,64,255303
16839,0.001023,172.31.40.0-255,66,78745,64,255303
16840,0.001038,172.31.40.0-255,66,78811,64,255303
16841,0.001063,172.217.194.0-255,2902,81713,64,255303
16842,0.001066,172.31.40.0-255,66,81779,64,255303
16843,0.001107,172.31.40.0-255,66,81845,64,255303
16844,0.002003,172.217.194.0-255,1484,83329,64,255303
16845,0.002012,172.217.194.0-255,2902,86231,64,255303
16846,0.002016,172.31.40.0-255,66,86297,64,255303
16847,0.002022,172.217.194.0-255,4320,90617,64,255303
16848,0.002024,172.31.40.0-255,66,90683,64,255303
16849,0.002048,172.217.194.0-255,1484,92167,64,255303
16850,0.002067,172.31.40.0-255,66,92233,64,255303
16851,0.002071,172.217.194.0-255,2902,95135,64,255303
16852,0.002073,172.31.40.0-255,66,95201,64,255303
16853,0.002118,172.31.40.0-255,66,95267,64,255303
16854,0.00422,172.217.194.0-255,5738,101005,64,255303
16855,0.004227,172.31.40.0-255,66,101071,64,255303
16856,0.006292,172.217.194.0-255,5738,106809,64,255303
16857,0.006296,172.31.40.0-255,66,106875,64,255303
16858,0.008368,172.217.194.0-255,5738,112613,64,255303
16859,0.008375,172.31.40.0-255,66,112679,64,255303
16860,0.010457,172.217.194.0-255,5738,118417,64,255303
16861,0.010464,172.31.40.0-255,66,118483,64,255303
16862,0.012573,172.217.194.0-255,5738,124221,64,255303
16863,0.012582,172.31.40.0-255,66,124287,64,255303
16864,0.01468,172.217.194.0-255,5738,130025,64,255303
16865,0.014688,172.31.40.0-255,66,130091,64,255303
16866,0.016806,172.217.194.0-255,5738,135829,64,255303
16867,0.016815,172.31.40.0-255,66,135895,64,255303
16868,0.018937,172.217.194.0-255,5738,141633,64,255303
16869,0.018946,172.31.40.0-255,66,141699,64,255303
16870,0.021037,172.217.194.0-255,5738,147437,64,255303
16871,0.021045,172.31.40.0-255,66,147503,64,255303
16872,0.023156,172.217.194.0-255,5738,153241,64,255303
16873,0.023164,172.31.40.0-255,66,153307,64,255303
16874,0.025258,172.217.194.0-255,5738,159045,64,255303
16875,0.025266,172.31.40.0-255,66,159111,64,255303
16876,0.026926,172.31.40.0-255,171,159282,64,255303
16877,0.026959,172.31.40.0-255,1132,160414,64,255303
16878,0.027019,172.31.40.0-255,1514,161928,64,255303
16879,0.027021,172.31.40.0-255,313,162241,64,255303
16880,0.027364,172.217.194.0-255,5738,167979,64,255303
16881,0.027371,172.31.40.0-255,66,168045,64,255303
16882,0.02849,104.244.42.0-255,66,168111,64,255303
16883,0.028526,104.244.42.0-255,66,168177,64,255303
16884,0.028573,104.244.42.0-255,66,168243,64,255303
16885,0.029466,172.217.194.0-255,5738,173981,64,255303
16886,0.029472,172.31.40.0-255,66,174047,64,255303
16887,0.031568,172.217.194.0-255,5738,179785,64,255303
16888,0.031575,172.31.40.0-255,66,179851,64,255303
16889,0.033687,172.217.194.0-255,5738,185589,64,255303
16890,0.033694,172.31.40.0-255,66,185655,64,255303
16891,0.035769,172.217.194.0-255,5738,191393,64,255303
16892,0.035786,172.31.40.0-255,66,191459,64,255303
16893,0.037893,172.217.194.0-255,5738,197197,64,255303
16894,0.037908,172.31.40.0-255,66,197263,64,255303
16895,0.03999,172.217.194.0-255,5738,203001,64,255303
16896,0.040005,172.31.40.0-255,66,203067,64,255303
16897,0.042114,172.217.194.0-255,5738,208805,64,255303
16898,0.04213,172.31.40.0-255,66,208871,64,255303
16899,0.044244,172.217.194.0-255,5738,214609,64,255303
16900,0.044257,172.31.40.0-255,66,214675,64,255303
16901,0.046365,172.217.194.0-255,5738,220413,64,255303
16902,0.046381,172.31.40.0-255,66,220479,64,255303
16903,0.048467,172.217.194.0-255,5738,226217,64,255303
16904,0.048478,172.31.40.0-255,66,226283,64,255303
16905,0.050562,172.217.194.0-255,5738,232021,64,255303
16906,0.050577,172.31.40.0-255,66,232087,64,255303
16907,0.052691,172.217.194.0-255,5738,237825,64,255303
16908,0.052706,172.31.40.0-255,66,237891,64,255303
16909,0.054819,172.217.194.0-255,5738,243629,64,255303
16910,0.054835,172.31.40.0-255,66,243695,64,255303
16911,0.056935,172.217.194.0-255,5738,249433,64,255303
16912,0.056952,172.31.40.0-255,66,249499,64,255303
16913,0.059075,172.217.194.0-255,5738,255237,64,255303
16914,0.059087,172.31.40.0-255,66,255303,64,255303
16915,0.0,74.125.24.0-255,153,153,64,275612
16916,1.9e-05,172.31.40.0-255,66,219,64,275612
16917,2.7e-05,74.125.24.0-255,1484,1703,64,275612
16918,3.2e-05,172.31.40.0-255,66,1769,64,275612
16919,3.8e-05,74.125.24.0-255,2902,4671,64,275612
16920,4.2e-05,172.31.40.0-255,66,4737,64,275612
16921,5.5e-05,74.125.24.0-255,4320,9057,64,275612
16922,5.9e-05,172.31.40.0-255,66,9123,64,275612
16923,7.6e-05,74.125.24.0-255,2902,12025,64,275612
16924,7.9e-05,172.31.40.0-255,66,12091,64,275612
16925,9.5e-05,172.31.40.0-255,66,12157,64,275612
16926,0.000142,172.31.40.0-255,66,12223,64,275612
16927,0.000185,74.125.24.0-255,1484,13707,64,275612
16928,0.000187,172.31.40.0-255,66,13773,64,275612
16929,0.000192,74.125.24.0-255,2902,16675,64,275612
16930,0.000194,172.31.40.0-255,66,16741,64,275612
16931,0.000205,74.125.24.0-255,5738,22479,64,275612
16932,0.000207,172.31.40.0-255,66,22545,64,275612
16933,0.000229,74.125.24.0-255,5738,28283,64,275612
16934,0.000232,172.31.40.0-255,66,28349,64,275612
16935,0.000265,74.125.24.0-255,1125,29474,64,275612
16936,0.000268,172.31.40.0-255,66,29540,64,275612
16937,0.000287,172.31.40.0-255,66,29606,64,275612
16938,0.00029,74.125.24.0-255,1484,31090,64,275612
16939,0.000292,172.31.40.0-255,66,31156,64,275612
16940,0.000323,74.125.24.0-255,1430,32586,64,275612
16941,0.000326,172.31.40.0-255,66,32652,64,275612
16942,0.000681,74.125.24.0-255,116,32768,64,275612
16943,0.000686,172.31.40.0-255,66,32834,64,275612
16944,0.000722,74.125.24.0-255,1484,34318,64,275612
16945,0.000728,74.125.24.0-255,2902,37220,64,275612
16946,0.000731,172.31.40.0-255,66,37286,64,275612
16947,0.000736,74.125.24.0-255,2902,40188,64,275612
16948,0.000738,172.31.40.0-255,66,40254,64,275612
16949,0.000773,74.125.24.0-255,4320,44574,64,275612
16950,0.000775,172.31.40.0-255,66,44640,64,275612
16951,0.000782,74.125.24.0-255,5379,50019,64,275612
16952,0.000784,172.31.40.0-255,66,50085,64,275612
16953,0.00087,74.125.24.0-255,1484,51569,64,275612
16954,0.000876,74.125.24.0-255,2902,54471,64,275612
16955,0.00088,172.31.40.0-255,66,54537,64,275612
16956,0.000885,74.125.24.0-255,2902,57439,64,275612
16957,0.000886,172.31.40.0-255,66,57505,64,275612
16958,0.000907,74.125.24.0-255,2902,60407,64,275612
16959,0.000914,172.31.40.0-255,66,60473,64,275612
16960,0.000947,74.125.24.0-255,6797,67270,64,275612
16961,0.00095,172.31.40.0-255,66,67336,64,275612
16962,0.001586,74.125.24.0-255,1484,68820,64,275612
16963,0.001594,74.125.24.0-255,2902,71722,64,275612
16964,0.001598,172.31.40.0-255,66,71788,64,275612
16965,0.001627,74.125.24.0-255,5738,77526,64,275612
16966,0.00163,172.31.40.0-255,66,77592,64,275612
16967,0.00166,74.125.24.0-255,7156,84748,64,275612
16968,0.001662,172.31.40.0-255,66,84814,64,275612
16969,0.001687,74.125.24.0-255,1484,86298,64,275612
16970,0.001699,172.31.40.0-255,66,86364,64,275612
16971,0.001705,74.125.24.0-255,4320,90684,64,275612
16972,0.001707,172.31.40.0-255,66,90750,64,275612
16973,0.001736,74.125.24.0-255,766,91516,64,275612
16974,0.001777,74.125.24.0-255,1484,93000,64,275612
16975,0.00178,172.31.40.0-255,66,93066,64,275612
16976,0.001784,74.125.24.0-255,2902,95968,64,275612
16977,0.001786,172.31.40.0-255,66,96034,64,275612
16978,0.001821,74.125.24.0-255,5738,101772,64,275612
16979,0.001824,172.31.40.0-255,66,101838,64,275612
16980,0.00183,74.125.24.0-255,5738,107576,64,275612
16981,0.001832,172.31.40.0-255,66,107642,64,275612
16982,0.00185,172.31.40.0-255,66,107708,64,275612
16983,0.001856,74.125.24.0-255,5020,112728,64,275612
16984,0.001861,172.31.40.0-255,66,112794,64,275612
16985,0.001883,74.125.24.0-255,2902,115696,64,275612
16986,0.001885,172.31.40.0-255,66,115762,64,275612
16987,0.001911,74.125.24.0-255,2902,118664,64,275612
16988,0.001914,172.31.40.0-255,66,118730,64,275612
16989,0.001927,172.31.40.0-255,66,118796,64,275612
16990,0.001951,74.125.24.0-255,5738,124534,64,275612
16991,0.001953,172.31.40.0-255,66,124600,64,275612
16992,0.002006,172.31.40.0-255,66,124666,64,275612
16993,0.002024,172.31.40.0-255,66,124732,64,275612
16994,0.002032,74.125.24.0-255,7156,131888,64,275612
16995,0.002035,172.31.40.0-255,66,131954,64,275612
16996,0.002078,172.31.40.0-255,66,132020,64,275612
16997,0.004421,74.125.24.0-255,5738,137758,64,275612
16998,0.004434,172.31.40.0-255,66,137824,64,275612
16999,0.006755,74.125.24.0-255,5738,143562,64,275612
17000,0.006764,172.31.40.0-255,66,143628,64,275612
17001,0.009134,74.125.24.0-255,5738,149366,64,275612
17002,0.009149,172.31.40.0-255,66,149432,64,275612
17003,0.011493,74.125.24.0-255,5738,155170,64,275612
17004,0.011512,172.31.40.0-255,66,155236,64,275612
17005,0.013868,74.125.24.0-255,5738,160974,64,275612
17006,0.013882,172.31.40.0-255,66,161040,64,275612
17007,0.016231,74.125.24.0-255,5738,166778,64,275612
17008,0.016244,172.31.40.0-255,66,166844,64,275612
17009,0.018615,74.125.24.0-255,5738,172582,64,275612
17010,0.018635,172.31.40.0-255,66,172648,64,275612
17011,0.020962,74.125.24.0-255,5738,178386,64,275612
17012,0.020977,172.31.40.0-255,66,178452,64,275612
17013,0.023326,74.125.24.0-255,5738,184190,64,275612
17014,0.023339,172.31.40.0-255,66,184256,64,275612
17015,0.025677,74.125.24.0-255,5738,189994,64,275612
17016,0.025695,172.31.40.0-255,66,190060,64,275612
17017,0.028032,74.125.24.0-255,5738,195798,64,275612
17018,0.028046,172.31.40.0-255,66,195864,64,275612
17019,0.030378,74.125.24.0-255,5738,201602,64,275612
17020,0.03039,172.31.40.0-255,66,201668,64,275612
17021,0.032701,74.125.24.0-255,5738,207406,64,275612
17022,0.032718,172.31.40.0-255,66,207472,64,275612
17023,0.035096,74.125.24.0-255,5738,213210,64,275612
17024,0.035114,172.31.40.0-255,66,213276,64,275612
17025,0.037469,74.125.24.0-255,5738,219014,64,275612
17026,0.037479,172.31.40.0-255,66,219080,64,275612
17027,0.039822,74.125.24.0-255,5738,224818,64,275612
17028,0.039846,172.31.40.0-255,66,224884,64,275612
17029,0.042208,74.125.24.0-255,5738,230622,64,275612
17030,0.042226,172.31.40.0-255,66,230688,64,275612
17031,0.044605,74.125.24.0-255,5738,236426,64,275612
17032,0.044622,172.31.40.0-255,66,236492,64,275612
17033,0.046953,74.125.24.0-255,5738,242230,64,275612
17034,0.046967,172.31.40.0-255,66,242296,64,275612
17035,0.049287,74.125.24.0-255,5738,248034,64,275612
17036,0.049301,172.31.40.0-255,66,248100,64,275612
17037,0.051644,74.125.24.0-255,5738,253838,64,275612
17038,0.051661,172.31.40.0-255,66,253904,64,275612
17039,0.052141,172.31.40.0-255,176,254080,64,275612
17040,0.052175,172.31.40.0-255,1112,255192,64,275612
17041,0.052238,172.31.40.0-255,1514,256706,64,275612
17042,0.052259,172.31.40.0-255,1296,258002,64,275612
17043,0.053671,104.244.42.0-255,66,258068,64,275612
17044,0.053707,104.244.42.0-255,66,258134,64,275612
17045,0.053803,104.244.42.0-255,66,258200,64,275612
17046,0.053981,74.125.24.0-255,5738,263938,64,275612
17047,0.053988,172.31.40.0-255,66,264004,64,275612
17048,0.056334,74.125.24.0-255,5738,269742,64,275612
17049,0.056346,172.31.40.0-255,66,269808,64,275612
17050,0.058687,74.125.24.0-255,5738,275546,64,275612
17051,0.058705,172.31.40.0-255,66,275612,64,275612
17052,0.0,74.125.130.0-255,156,156,64,263262
17053,2.7e-05,172.31.40.0-255,66,222,64,263262
17054,3.4e-05,74.125.130.0-255,1484,1706,64,263262
17055,4e-05,172.31.40.0-255,66,1772,64,263262
17056,4.4e-05,74.125.130.0-255,2902,4674,64,263262
17057,4.7e-05,172.31.40.0-255,66,4740,64,263262
17058,5.9e-05,74.125.130.0-255,5738,10478,64,263262
17059,6.2e-05,172.31.40.0-255,66,10544,64,263262
17060,9.4e-05,74.125.130.0-255,3484,14028,64,263262
17061,9.7e-05,172.31.40.0-255,66,14094,64,263262
17062,0.000336,74.125.130.0-255,1484,15578,64,263262
17063,0.000343,172.31.40.0-255,66,15644,64,263262
17064,0.000348,74.125.130.0-255,2902,18546,64,263262
17065,0.00035,172.31.40.0-255,66,18612,64,263262
17066,0.000381,74.125.130.0-255,4320,22932,64,263262
17067,0.000385,172.31.40.0-255,66,22998,64,263262
17068,0.000398,74.125.130.0-255,1484,24482,64,263262
17069,0.000405,172.31.40.0-255,66,24548,64,263262
17070,0.000412,74.125.130.0-255,6797,31345,64,263262
17071,0.000415,172.31.40.0-255,66,31411,64,263262
17072,0.000438,74.125.130.0-255,4320,35731,64,263262
17073,0.000442,172.31.40.0-255,66,35797,64,263262
17074,0.000445,74.125.130.0-255,1484,37281,64,263262
17075,0.000448,172.31.40.0-255,66,37347,64,263262
17076,0.000479,74.125.130.0-255,4320,41667,64,263262
17077,0.000483,172.31.40.0-255,66,41733,64,263262
17078,0.000495,172.31.40.0-255,66,41799,64,263262
17079,0.000539,74.125.130.0-255,2902,44701,64,263262
17080,0.000544,172.31.40.0-255,66,44767,64,263262
17081,0.000575,74.125.130.0-255,5738,50505,64,263262
17082,0.000578,172.31.40.0-255,66,50571,64,263262
17083,0.000584,74.125.130.0-255,3602,54173,64,263262
17084,0.000587,172.31.40.0-255,66,54239,64,263262
17085,0.000623,74.125.130.0-255,339,54578,64,263262
17086,0.000649,74.125.130.0-255,118,54696,64,263262
17087,0.000806,74.125.130.0-255,1484,56180,64,263262
17088,0.000809,172.31.40.0-255,66,56246,64,263262
17089,0.000815,74.125.130.0-255,2902,59148,64,263262
17090,0.000817,172.31.40.0-255,66,59214,64,263262
17091,0.000822,74.125.130.0-255,2902,62116,64,263262
17092,0.000824,172.31.40.0-255,66,62182,64,263262
17093,0.000862,74.125.130.0-255,2902,65084,64,263262
17094,0.000865,172.31.40.0-255,66,65150,64,263262
17095,0.000875,172.31.40.0-255,66,65216,64,263262
17096,0.000886,172.31.40.0-255,66,65282,64,263262
17097,0.00089,74.125.130.0-255,2902,68184,64,263262
17098,0.000893,172.31.40.0-255,66,68250,64,263262
17099,0.00092,74.125.130.0-255,2184,70434,64,263262
17100,0.000923,172.31.40.0-255,66,70500,64,263262
17101,0.000925,74.125.130.0-255,384,70884,64,263262
17102,0.001039,74.125.130.0-255,1484,72368,64,263262
17103,0.001043,172.31.40.0-255,66,72434,64,263262
17104,0.001065,74.125.130.0-255,2902,75336,64,263262
17105,0.001069,172.31.40.0-255,66,75402,64,263262
17106,0.001076,74.125.130.0-255,4320,79722,64,263262
17107,0.001079,172.31.40.0-255,66,79788,64,263262
17108,0.001102,74.125.130.0-255,1484,81272,64,263262
17109,0.001109,74.125.130.0-255,7156,88428,64,263262
17110,0.001112,172.31.40.0-255,66,88494,64,263262
17111,0.001122,172.31.40.0-255,66,88560,64,263262
17112,0.001156,172.31.40.0-255,66,88626,64,263262
17113,0.001361,74.125.130.0-255,1484,90110,64,263262
17114,0.001366,74.125.130.0-255,2902,93012,64,263262
17115,0.001369,172.31.40.0-255,66,93078,64,263262
17116,0.001373,74.125.130.0-255,1484,94562,64,263262
17117,0.001392,74.125.130.0-255,4320,98882,64,263262
17118,0.001395,172.31.40.0-255,66,98948,64,263262
17119,0.0014,74.125.130.0-255,4320,103268,64,263262
17120,0.001402,172.31.40.0-255,66,103334,64,263262
17121,0.00143,74.125.130.0-255,5738,109072,64,263262
17122,0.001434,172.31.40.0-255,66,109138,64,263262
17123,0.001474,74.125.130.0-255,5738,114876,64,263262
17124,0.001477,172.31.40.0-255,66,114942,64,263262
17125,0.001506,74.125.130.0-255,5738,120680,64,263262
17126,0.001509,172.31.40.0-255,66,120746,64,263262
17127,0.001513,74.125.130.0-255,2184,122930,64,263262
17128,0.001515,172.31.40.0-255,66,122996,64,263262
17129,0.001839,74.125.130.0-255,1484,124480,64,263262
17130,0.001849,74.125.130.0-255,2902,127382,64,263262
17131,0.001853,172.31.40.0-255,66,127448,64,263262
17132,0.001859,74.125.130.0-255,2902,130350,64,263262
17133,0.001861,172.31.40.0-255,66,130416,64,263262
17134,0.001892,74.125.130.0-255,2902,133318,64,263262
17135,0.001896,172.31.40.0-255,66,133384,64,263262
17136,0.00191,172.31.40.0-255,66,133450,64,263262
17137,0.00192,172.31.40.0-255,66,133516,64,263262
17138,0.001942,74.125.130.0-255,2184,135700,64,263262
17139,0.001945,172.31.40.0-255,66,135766,64,263262
17140,0.004525,74.125.130.0-255,2902,138668,64,263262
17141,0.004532,172.31.40.0-255,66,138734,64,263262
17142,0.004557,74.125.130.0-255,2902,141636,64,263262
17143,0.004559,172.31.40.0-255,66,141702,64,263262
17144,0.007156,74.125.130.0-255,2902,144604,64,263262
17145,0.007162,172.31.40.0-255,66,144670,64,263262
17146,0.0072,74.125.130.0-255,2902,147572,64,263262
17147,0.007203,172.31.40.0-255,66,147638,64,263262
17148,0.009782,74.125.130.0-255,2902,150540,64,263262
17149,0.009789,172.31.40.0-255,66,150606,64,263262
17150,0.009818,74.125.130.0-255,2902,153508,64,263262
17151,0.009821,172.31.40.0-255,66,153574,64,263262
17152,0.012395,74.125.130.0-255,2902,156476,64,263262
17153,0.012402,172.31.40.0-255,66,156542,64,263262
17154,0.012442,74.125.130.0-255,2902,159444,64,263262
17155,0.012445,172.31.40.0-255,66,159510,64,263262
17156,0.01502,74.125.130.0-255,2902,162412,64,263262
17157,0.015027,172.31.40.0-255,66,162478,64,263262
17158,0.015063,74.125.130.0-255,2902,165380,64,263262
17159,0.015067,172.31.40.0-255,66,165446,64,263262
17160,0.017647,74.125.130.0-255,2902,168348,64,263262
17161,0.017656,172.31.40.0-255,66,168414,64,263262
17162,0.017692,74.125.130.0-255,2902,171316,64,263262
17163,0.017696,172.31.40.0-255,66,171382,64,263262
17164,0.020269,74.125.130.0-255,2902,174284,64,263262
17165,0.020279,172.31.40.0-255,66,174350,64,263262
17166,0.020316,74.125.130.0-255,2902,177252,64,263262
17167,0.02032,172.31.40.0-255,66,177318,64,263262
17168,0.022904,74.125.130.0-255,2902,180220,64,263262
17169,0.022911,172.31.40.0-255,66,180286,64,263262
17170,0.022943,74.125.130.0-255,2902,183188,64,263262
17171,0.022951,172.31.40.0-255,66,183254,64,263262
17172,0.025343,172.31.40.0-255,172,183426,64,263262
17173,0.025376,172.31.40.0-255,1112,184538,64,263262
17174,0.025415,172.31.40.0-255,1514,186052,64,263262
17175,0.025416,172.31.40.0-255,1296,187348,64,263262
17176,0.025535,74.125.130.0-255,2902,190250,64,263262
17177,0.025545,172.31.40.0-255,66,190316,64,263262
17178,0.025578,74.125.130.0-255,2902,193218,64,263262
17179,0.025582,172.31.40.0-255,66,193284,64,263262
17180,0.026926,104.244.42.0-255,66,193350,64,263262
17181,0.02695,104.244.42.0-255,66,193416,64,263262
17182,0.026993,104.244.42.0-255,66,193482,64,263262
17183,0.028164,74.125.130.0-255,2902,196384,64,263262
17184,0.028179,172.31.40.0-255,66,196450,64,263262
17185,0.02821,74.125.130.0-255,2902,199352,64,263262
17186,0.028215,172.31.40.0-255,66,199418,64,263262
17187,0.030822,74.125.130.0-255,5738,205156,64,263262
17188,0.03084,172.31.40.0-255,66,205222,64,263262
17189,0.033493,74.125.130.0-255,5738,210960,64,263262
17190,0.033512,172.31.40.0-255,66,211026,64,263262
17191,0.036158,74.125.130.0-255,5738,216764,64,263262
17192,0.036177,172.31.40.0-255,66,216830,64,263262
17193,0.038859,74.125.130.0-255,5738,222568,64,263262
17194,0.038877,172.31.40.0-255,66,222634,64,263262
17195,0.041525,74.125.130.0-255,5738,228372,64,263262
17196,0.041549,172.31.40.0-255,66,228438,64,263262
17197,0.044191,74.125.130.0-255,5738,234176,64,263262
17198,0.044211,172.31.40.0-255,66,234242,64,263262
17199,0.046867,74.125.130.0-255,5738,239980,64,263262
17200,0.046889,172.31.40.0-255,66,240046,64,263262
17201,0.049545,74.125.130.0-255,5738,245784,64,263262
17202,0.049556,172.31.40.0-255,66,245850,64,263262
17203,0.052201,74.125.130.0-255,5738,251588,64,263262
17204,0.05222,172.31.40.0-255,66,251654,64,263262
17205,0.054851,74.125.130.0-255,5738,257392,64,263262
17206,0.05487,172.31.40.0-255,66,257458,64,263262
17207,0.057509,74.125.130.0-255,5738,263196,64,263262
17208,0.057529,172.31.40.0-255,66,263262,64,263262
17209,0.0,172.253.118.0-255,146,146,64,229143
17210,2.3e-05,172.31.40.0-255,66,212,64,229143
17211,3e-05,172.253.118.0-255,1484,1696,64,229143
17212,3.5e-05,172.31.40.0-255,66,1762,64,229143
17213,4.1e-05,172.253.118.0-255,2902,4664,64,229143
17214,4.5e-05,172.31.40.0-255,66,4730,64,229143
17215,5.2e-05,172.253.118.0-255,5738,10468,64,229143
17216,5.5e-05,172.31.40.0-255,66,10534,64,229143
17217,8e-05,172.253.118.0-255,3494,14028,64,229143
17218,8.2e-05,172.31.40.0-255,66,14094,64,229143
17219,8.9e-05,172.253.118.0-255,4320,18414,64,229143
17220,9.1e-05,172.31.40.0-255,66,18480,64,229143
17221,0.000121,172.31.40.0-255,66,18546,64,229143
17222,0.000128,172.253.118.0-255,7156,25702,64,229143
17223,0.000131,172.31.40.0-255,66,25768,64,229143
17224,0.000188,172.31.40.0-255,66,25834,64,229143
17225,0.000208,172.253.118.0-255,3602,29436,64,229143
17226,0.00021,172.31.40.0-255,66,29502,64,229143
17227,0.000236,172.31.40.0-255,66,29568,64,229143
17228,0.000296,172.253.118.0-255,2902,32470,64,229143
17229,0.000299,172.31.40.0-255,66,32536,64,229143
17230,0.000321,172.253.118.0-255,5686,38222,64,229143
17231,0.000324,172.31.40.0-255,66,38288,64,229143
17232,0.000333,172.31.40.0-255,66,38354,64,229143
17233,0.000357,172.253.118.0-255,7156,45510,64,229143
17234,0.00036,172.31.40.0-255,66,45576,64,229143
17235,0.000375,172.253.118.0-255,827,46403,64,229143
17236,0.000377,172.31.40.0-255,66,46469,64,229143
17237,0.000424,172.253.118.0-255,1484,47953,64,229143
17238,0.000429,172.253.118.0-255,2902,50855,64,229143
17239,0.000432,172.31.40.0-255,66,50921,64,229143
17240,0.000453,172.253.118.0-255,4320,55241,64,229143
17241,0.000456,172.31.40.0-255,66,55307,64,229143
17242,0.000473,172.253.118.0-255,1484,56791,64,229143
17243,0.000478,172.253.118.0-255,4320,61111,64,229143
17244,0.000481,172.31.40.0-255,66,61177,64,229143
17245,0.000504,172.253.118.0-255,6797,67974,64,229143
17246,0.000506,172.31.40.0-255,66,68040,64,229143
17247,0.000519,172.31.40.0-255,66,68106,64,229143
17248,0.000521,172.253.118.0-255,1125,69231,64,229143
17249,0.001271,172.31.40.0-255,66,69297,64,229143
17250,0.002239,172.253.118.0-255,1484,70781,64,229143
17251,0.002249,172.253.118.0-255,2902,73683,64,229143
17252,0.002253,172.31.40.0-255,66,73749,64,229143
17253,0.00226,172.253.118.0-255,5738,79487,64,229143
17254,0.002262,172.31.40.0-255,66,79553,64,229143
17255,0.002281,172.253.118.0-255,1484,81037,64,229143
17256,0.002305,172.31.40.0-255,66,81103,64,229143
17257,0.004561,172.253.118.0-255,5738,86841,64,229143
17258,0.004565,172.31.40.0-255,66,86907,64,229143
17259,0.006795,172.253.118.0-255,5738,92645,64,229143
17260,0.006802,172.31.40.0-255,66,92711,64,229143
17261,0.009033,172.253.118.0-255,5738,98449,64,229143
17262,0.009042,172.31.40.0-255,66,98515,64,229143
17263,0.011301,172.253.118.0-255,5738,104253,64,229143
17264,0.01131,172.31.40.0-255,66,104319,64,229143
17265,0.013571,172.253.118.0-255,5738,110057,64,229143
17266,0.013583,172.31.40.0-255,66,110123,64,229143
17267,0.015833,172.253.118.0-255,5738,115861,64,229143
17268,0.015841,172.31.40.0-255,66,115927,64,229143
17269,0.018104,172.253.118.0-255,5738,121665,64,229143
17270,0.018111,172.31.40.0-255,66,121731,64,229143
17271,0.020349,172.253.118.0-255,4320,126051,64,229143
17272,0.020357,172.31.40.0-255,66,126117,64,229143
17273,0.020377,172.253.118.0-255,1484,127601,64,229143
17274,0.022617,172.253.118.0-255,4320,131921,64,229143
17275,0.022625,172.31.40.0-255,66,131987,64,229143
17276,0.024867,172.253.118.0-255,5738,137725,64,229143
17277,0.024873,172.31.40.0-255,66,137791,64,229143
17278,0.026032,172.31.40.0-255,172,137963,64,229143
17279,0.026065,172.31.40.0-255,1112,139075,64,229143
17280,0.026125,172.31.40.0-255,1514,140589,64,229143
17281,0.026127,172.31.40.0-255,1296,141885,64,229143
17282,0.027125,172.253.118.0-255,5738,147623,64,229143
17283,0.027132,172.31.40.0-255,66,147689,64,229143
17284,0.027558,104.244.42.0-255,66,147755,64,229143
17285,0.027603,104.244.42.0-255,66,147821,64,229143
17286,0.02771,104.244.42.0-255,66,147887,64,229143
17287,0.029396,172.253.118.0-255,5738,153625,64,229143
17288,0.029403,172.31.40.0-255,66,153691,64,229143
17289,0.031659,172.253.118.0-255,5738,159429,64,229143
17290,0.031666,172.31.40.0-255,66,159495,64,229143
17291,0.033911,172.253.118.0-255,5738,165233,64,229143
17292,0.033916,172.31.40.0-255,66,165299,64,229143
17293,0.03618,172.253.118.0-255,5738,171037,64,229143
17294,0.036186,172.31.40.0-255,66,171103,64,229143
17295,0.038441,172.253.118.0-255,5738,176841,64,229143
17296,0.038448,172.31.40.0-255,66,176907,64,229143
17297,0.04071,172.253.118.0-255,5738,182645,64,229143
17298,0.040717,172.31.40.0-255,66,182711,64,229143
17299,0.042968,172.253.118.0-255,5738,188449,64,229143
17300,0.042975,172.31.40.0-255,66,188515,64,229143
17301,0.045259,172.253.118.0-255,5738,194253,64,229143
17302,0.045265,172.31.40.0-255,66,194319,64,229143
17303,0.047536,172.253.118.0-255,5738,200057,64,229143
17304,0.047543,172.31.40.0-255,66,200123,64,229143
17305,0.049794,172.253.118.0-255,5738,205861,64,229143
17306,0.049801,172.31.40.0-255,66,205927,64,229143
17307,0.052065,172.253.118.0-255,5738,211665,64,229143
17308,0.052071,172.31.40.0-255,66,211731,64,229143
17309,0.054321,172.253.118.0-255,5738,217469,64,229143
17310,0.054327,172.31.40.0-255,66,217535,64,229143
17311,0.056591,172.253.118.0-255,5738,223273,64,229143
17312,0.056597,172.31.40.0-255,66,223339,64,229143
17313,0.058837,172.253.118.0-255,5738,229077,64,229143
17314,0.058844,172.31.40.0-255,66,229143,64,229143
17315,0.0,74.125.24.0-255,152,152,64,255572
17316,2.5e-05,172.31.40.0-255,66,218,64,255572
17317,3.3e-05,74.125.24.0-255,1484,1702,64,255572
17318,3.7e-05,172.31.40.0-255,66,1768,64,255572
17319,4.2e-05,74.125.24.0-255,2902,4670,64,255572
17320,4.4e-05,172.31.40.0-255,66,4736,64,255572
17321,5.8e-05,74.125.24.0-255,7156,11892,64,255572
17322,6e-05,172.31.40.0-255,66,11958,64,255572
17323,7.1e-05,172.31.40.0-255,66,12024,64,255572
17324,8.9e-05,74.125.24.0-255,610,12634,64,255572
17325,9.2e-05,172.31.40.0-255,66,12700,64,255572
17326,0.000107,172.31.40.0-255,66,12766,64,255572
17327,0.000192,74.125.24.0-255,1484,14250,64,255572
17328,0.000195,172.31.40.0-255,66,14316,64,255572
17329,0.000222,74.125.24.0-255,2902,17218,64,255572
17330,0.000224,172.31.40.0-255,66,17284,64,255572
17331,0.000229,74.125.24.0-255,5738,23022,64,255572
17332,0.000232,172.31.40.0-255,66,23088,64,255572
17333,0.000266,74.125.24.0-255,1484,24572,64,255572
17334,0.000268,172.31.40.0-255,66,24638,64,255572
17335,0.000301,172.31.40.0-255,66,24704,64,255572
17336,0.000312,172.31.40.0-255,66,24770,64,255572
17337,0.00032,74.125.24.0-255,4275,29045,64,255572
17338,0.000322,172.31.40.0-255,66,29111,64,255572
17339,0.000345,74.125.24.0-255,109,29220,64,255572
17340,0.000347,172.31.40.0-255,66,29286,64,255572
17341,0.000552,74.125.24.0-255,330,29616,64,255572
17342,0.000557,172.31.40.0-255,66,29682,64,255572
17343,0.000728,74.125.24.0-255,1484,31166,64,255572
17344,0.000733,74.125.24.0-255,1484,32650,64,255572
17345,0.000735,172.31.40.0-255,66,32716,64,255572
17346,0.000757,74.125.24.0-255,1484,34200,64,255572
17347,0.000764,74.125.24.0-255,5738,39938,64,255572
17348,0.000766,172.31.40.0-255,66,40004,64,255572
17349,0.000793,74.125.24.0-255,2902,42906,64,255572
17350,0.000795,172.31.40.0-255,66,42972,64,255572
17351,0.000818,74.125.24.0-255,4320,47292,64,255572
17352,0.000852,172.31.40.0-255,66,47358,64,255572
17353,0.000859,172.31.40.0-255,66,47424,64,255572
17354,0.000867,74.125.24.0-255,4320,51744,64,255572
17355,0.00087,172.31.40.0-255,66,51810,64,255572
17356,0.000874,74.125.24.0-255,2184,53994,64,255572
17357,0.000876,172.31.40.0-255,66,54060,64,255572
17358,0.000906,74.125.24.0-255,1484,55544,64,255572
17359,0.00091,74.125.24.0-255,2902,58446,64,255572
17360,0.000913,172.31.40.0-255,66,58512,64,255572
17361,0.000916,74.125.24.0-255,1484,59996,64,255572
17362,0.000942,74.125.24.0-255,2902,62898,64,255572
17363,0.000945,172.31.40.0-255,66,62964,64,255572
17364,0.000953,172.31.40.0-255,66,63030,64,255572
17365,0.000988,74.125.24.0-255,5738,68768,64,255572
17366,0.000991,172.31.40.0-255,66,68834,64,255572
17367,0.001011,74.125.24.0-255,7156,75990,64,255572
17368,0.001014,172.31.40.0-255,66,76056,64,255572
17369,0.00104,74.125.24.0-255,3602,79658,64,255572
17370,0.001042,172.31.40.0-255,66,79724,64,255572
17371,0.001045,74.125.24.0-255,1484,81208,64,255572
17372,0.001049,74.125.24.0-255,2902,84110,64,255572
17373,0.001051,172.31.40.0-255,66,84176,64,255572
17374,0.001055,74.125.24.0-255,2902,87078,64,255572
17375,0.001061,172.31.40.0-255,66,87144,64,255572
17376,0.001092,74.125.24.0-255,2902,90046,64,255572
17377,0.001095,172.31.40.0-255,66,90112,64,255572
17378,0.001107,172.31.40.0-255,66,90178,64,255572
17379,0.00113,74.125.24.0-255,5738,95916,64,255572
17380,0.001134,172.31.40.0-255,66,95982,64,255572
17381,0.001163,172.31.40.0-255,66,96048,64,255572
17382,0.001185,74.125.24.0-255,1484,97532,64,255572
17383,0.001187,74.125.24.0-255,1484,99016,64,255572
17384,0.001189,172.31.40.0-255,66,99082,64,255572
17385,0.001214,74.125.24.0-255,1484,100566,64,255572
17386,0.00122,74.125.24.0-255,5738,106304,64,255572
17387,0.001222,74.125.24.0-255,1484,107788,64,255572
17388,0.001225,172.31.40.0-255,66,107854,64,255572
17389,0.001252,172.31.40.0-255,66,107920,64,255572
17390,0.001255,74.125.24.0-255,1484,109404,64,255572
17391,0.001291,172.31.40.0-255,66,109470,64,255572
17392,0.001322,74.125.24.0-255,5020,114490,64,255572
17393,0.001337,172.31.40.0-255,66,114556,64,255572
17394,0.00134,172.31.40.0-255,66,114622,64,255572
17395,0.001367,74.125.24.0-255,5738,120360,64,255572
17396,0.00137,172.31.40.0-255,66,120426,64,255572
17397,0.001413,172.31.40.0-255,66,120492,64,255572
17398,0.001432,172.31.40.0-255,66,120558,64,255572
17399,0.001456,74.125.24.0-255,2902,123460,64,255572
17400,0.00147,172.31.40.0-255,66,123526,64,255572
17401,0.001473,172.31.40.0-255,66,123592,64,255572
17402,0.004067,74.125.24.0-255,5738,129330,64,255572
17403,0.004074,172.31.40.0-255,66,129396,64,255572
17404,0.006653,74.125.24.0-255,5738,135134,64,255572
17405,0.006656,172.31.40.0-255,66,135200,64,255572
17406,0.009251,74.125.24.0-255,5738,140938,64,255572
17407,0.009259,172.31.40.0-255,66,141004,64,255572
17408,0.01184,74.125.24.0-255,5738,146742,64,255572
17409,0.011849,172.31.40.0-255,66,146808,64,255572
17410,0.014436,74.125.24.0-255,5738,152546,64,255572
17411,0.014445,172.31.40.0-255,66,152612,64,255572
17412,0.017059,74.125.24.0-255,5738,158350,64,255572
17413,0.017073,172.31.40.0-255,66,158416,64,255572
17414,0.019662,74.125.24.0-255,5738,164154,64,255572
17415,0.01968,172.31.40.0-255,66,164220,64,255572
17416,0.022262,74.125.24.0-255,5738,169958,64,255572
17417,0.02227,172.31.40.0-255,66,170024,64,255572
17418,0.024853,74.125.24.0-255,5738,175762,64,255572
17419,0.02486,172.31.40.0-255,66,175828,64,255572
17420,0.027444,74.125.24.0-255,5738,181566,64,255572
17421,0.027459,172.31.40.0-255,66,181632,64,255572
17422,0.030048,74.125.24.0-255,5738,187370,64,255572
17423,0.030056,172.31.40.0-255,66,187436,64,255572
17424,0.032649,74.125.24.0-255,5738,193174,64,255572
17425,0.032665,172.31.40.0-255,66,193240,64,255572
17426,0.035265,74.125.24.0-255,5738,198978,64,255572
17427,0.035282,172.31.40.0-255,66,199044,64,255572
17428,0.037862,74.125.24.0-255,5738,204782,64,255572
17429,0.037871,172.31.40.0-255,66,204848,64,255572
17430,0.03844,172.31.40.0-255,172,205020,64,255572
17431,0.038472,172.31.40.0-255,1112,206132,64,255572
17432,0.038531,172.31.40.0-255,1514,207646,64,255572
17433,0.038553,172.31.40.0-255,1296,208942,64,255572
17434,0.040008,104.244.42.0-255,66,209008,64,255572
17435,0.04008,104.244.42.0-255,66,209074,64,255572
17436,0.040116,104.244.42.0-255,66,209140,64,255572
17437,0.040431,74.125.24.0-255,5738,214878,64,255572
17438,0.040446,172.31.40.0-255,66,214944,64,255572
17439,0.043022,74.125.24.0-255,5738,220682,64,255572
17440,0.043036,172.31.40.0-255,66,220748,64,255572
17441,0.04563,74.125.24.0-255,5738,226486,64,255572
17442,0.045647,172.31.40.0-255,66,226552,64,255572
17443,0.048234,74.125.24.0-255,5738,232290,64,255572
17444,0.048252,172.31.40.0-255,66,232356,64,255572
17445,0.050837,74.125.24.0-255,5738,238094,64,255572
17446,0.050855,172.31.40.0-255,66,238160,64,255572
17447,0.053459,74.125.24.0-255,5738,243898,64,255572
17448,0.053471,172.31.40.0-255,66,243964,64,255572
17449,0.056053,74.125.24.0-255,5738,249702,64,255572
17450,0.056071,172.31.40.0-255,66,249768,64,255572
17451,0.058668,74.125.24.0-255,5738,255506,64,255572
17452,0.058686,172.31.40.0-255,66,255572,64,255572
17453,0.0,172.217.194.0-255,152,152,64,200137
17454,2.3e-05,172.31.40.0-255,66,218,64,200137
17455,3e-05,172.217.194.0-255,1484,1702,64,200137
17456,3.5e-05,172.31.40.0-255,66,1768,64,200137
17457,4e-05,172.217.194.0-255,2902,4670,64,200137
17458,4.4e-05,172.31.40.0-255,66,4736,64,200137
17459,5.2e-05,172.217.194.0-255,7156,11892,64,200137
17460,5.4e-05,172.31.40.0-255,66,11958,64,200137
17461,5.8e-05,172.217.194.0-255,2071,14029,64,200137
17462,6.2e-05,172.31.40.0-255,66,14095,64,200137
17463,8.3e-05,172.217.194.0-255,4320,18415,64,200137
17464,8.7e-05,172.31.40.0-255,66,18481,64,200137
17465,0.000116,172.217.194.0-255,7156,25637,64,200137
17466,0.000119,172.31.40.0-255,66,25703,64,200137
17467,0.000125,172.217.194.0-255,5379,31082,64,200137
17468,0.000127,172.31.40.0-255,66,31148,64,200137
17469,0.000277,172.217.194.0-255,1484,32632,64,200137
17470,0.000282,172.31.40.0-255,66,32698,64,200137
17471,0.000287,172.217.194.0-255,2902,35600,64,200137
17472,0.000289,172.31.40.0-255,66,35666,64,200137
17473,0.000293,172.217.194.0-255,1484,37150,64,200137
17474,0.000294,172.31.40.0-255,66,37216,64,200137
17475,0.000319,172.217.194.0-255,4320,41536,64,200137
17476,0.000322,172.31.40.0-255,66,41602,64,200137
17477,0.000325,172.217.194.0-255,1484,43086,64,200137
17478,0.000327,172.31.40.0-255,66,43152,64,200137
17479,0.000338,172.31.40.0-255,66,43218,64,200137
17480,0.000351,172.217.194.0-255,1125,44343,64,200137
17481,0.000353,172.31.40.0-255,66,44409,64,200137
17482,0.000356,172.217.194.0-255,1484,45893,64,200137
17483,0.000359,172.31.40.0-255,66,45959,64,200137
17484,0.000394,172.31.40.0-255,66,46025,64,200137
17485,0.000397,172.217.194.0-255,120,46145,64,200137
17486,0.000445,172.217.194.0-255,1484,47629,64,200137
17487,0.000447,172.31.40.0-255,66,47695,64,200137
17488,0.000453,172.217.194.0-255,2902,50597,64,200137
17489,0.000456,172.31.40.0-255,66,50663,64,200137
17490,0.000463,172.217.194.0-255,7156,57819,64,200137
17491,0.000466,172.31.40.0-255,66,57885,64,200137
17492,0.000469,172.217.194.0-255,1484,59369,64,200137
17493,0.000472,172.217.194.0-255,1484,60853,64,200137
17494,0.000474,172.31.40.0-255,66,60919,64,200137
17495,0.000505,172.31.40.0-255,66,60985,64,200137
17496,0.00051,172.217.194.0-255,2902,63887,64,200137
17497,0.000512,172.31.40.0-255,66,63953,64,200137
17498,0.000547,172.31.40.0-255,66,64019,64,200137
17499,0.000587,172.217.194.0-255,1484,65503,64,200137
17500,0.00059,172.217.194.0-255,1484,66987,64,200137
17501,0.000592,172.31.40.0-255,66,67053,64,200137
17502,0.000611,172.217.194.0-255,1484,68537,64,200137
17503,0.000614,172.217.194.0-255,2902,71439,64,200137
17504,0.000616,172.31.40.0-255,66,71505,64,200137
17505,0.00062,172.217.194.0-255,2902,74407,64,200137
17506,0.000622,172.31.40.0-255,66,74473,64,200137
17507,0.000636,172.217.194.0-255,1484,75957,64,200137
17508,0.000643,172.217.194.0-255,5738,81695,64,200137
17509,0.000645,172.31.40.0-255,66,81761,64,200137
17510,0.00066,172.217.194.0-255,2902,84663,64,200137
17511,0.000662,172.31.40.0-255,66,84729,64,200137
17512,0.000708,172.31.40.0-255,66,84795,64,200137
17513,0.000737,172.217.194.0-255,3602,88397,64,200137
17514,0.000739,172.31.40.0-255,66,88463,64,200137
17515,0.000752,172.31.40.0-255,66,88529,64,200137
17516,0.000763,172.31.40.0-255,66,88595,64,200137
17517,0.0008,172.31.40.0-255,66,88661,64,200137
17518,0.000831,172.217.194.0-255,4320,92981,64,200137
17519,0.000861,172.217.194.0-255,6438,99419,64,200137
17520,0.000908,172.217.194.0-255,2902,102321,64,200137
17521,0.000912,172.217.194.0-255,4320,106641,64,200137
17522,0.000936,172.217.194.0-255,5738,112379,64,200137
17523,0.000957,172.217.194.0-255,766,113145,64,200137
17524,0.001049,172.217.194.0-255,1484,114629,64,200137
17525,0.001055,172.217.194.0-255,2902,117531,64,200137
17526,0.001075,172.217.194.0-255,1484,119015,64,200137
17527,0.001094,172.217.194.0-255,4320,123335,64,200137
17528,0.001114,172.217.194.0-255,5738,129073,64,200137
17529,0.001154,172.217.194.0-255,3602,132675,64,200137
17530,0.001188,172.217.194.0-255,4320,136995,64,200137
17531,0.001277,172.217.194.0-255,1484,138479,64,200137
17532,0.001297,172.217.194.0-255,2902,141381,64,200137
17533,0.001301,172.217.194.0-255,2902,144283,64,200137
17534,0.001318,172.217.194.0-255,2902,147185,64,200137
17535,0.001338,172.217.194.0-255,2902,150087,64,200137
17536,0.001386,172.217.194.0-255,5738,155825,64,200137
17537,0.0014,172.217.194.0-255,5020,160845,64,200137
17538,0.001629,172.217.194.0-255,1484,162329,64,200137
17539,0.001634,172.31.40.0-255,66,162395,64,200137
17540,0.001651,172.217.194.0-255,2902,165297,64,200137
17541,0.001654,172.217.194.0-255,1484,166781,64,200137
17542,0.001666,172.217.194.0-255,4320,171101,64,200137
17543,0.001681,172.217.194.0-255,1484,172585,64,200137
17544,0.001695,172.217.194.0-255,4320,176905,64,200137
17545,0.001711,172.217.194.0-255,4320,181225,64,200137
17546,0.001741,172.217.194.0-255,4320,185545,64,200137
17547,0.00177,172.217.194.0-255,2902,188447,64,200137
17548,0.001874,172.217.194.0-255,7054,195501,64,200137
17549,0.001876,172.217.194.0-255,105,195606,64,200137
17550,0.001982,172.31.40.0-255,66,195672,64,200137
17551,0.004784,172.31.40.0-255,105,195777,64,200137
17552,0.007019,172.217.194.0-255,66,195843,64,200137
17553,0.031673,172.31.40.0-255,172,196015,64,200137
17554,0.031706,172.31.40.0-255,1112,197127,64,200137
17555,0.031756,172.31.40.0-255,1514,198641,64,200137
17556,0.031757,172.31.40.0-255,1298,199939,64,200137
17557,0.033233,104.244.42.0-255,66,200005,64,200137
17558,0.033259,104.244.42.0-255,66,200071,64,200137
17559,0.033306,104.244.42.0-255,66,200137,64,200137
17560,0.0,74.125.68.0-255,153,153,64,362975
17561,1.9e-05,172.31.40.0-255,66,219,64,362975
17562,2.6e-05,74.125.68.0-255,1484,1703,64,362975
17563,3e-05,172.31.40.0-255,66,1769,64,362975
17564,3.5e-05,74.125.68.0-255,2902,4671,64,362975
17565,3.8e-05,172.31.40.0-255,66,4737,64,362975
17566,4.1e-05,74.125.68.0-255,1484,6221,64,362975
17567,4.3e-05,172.31.40.0-255,66,6287,64,362975
17568,7.3e-05,74.125.68.0-255,5738,12025,64,362975
17569,7.6e-05,172.31.40.0-255,66,12091,64,362975
17570,9.4e-05,74.125.68.0-255,5738,17829,64,362975
17571,9.6e-05,172.31.40.0-255,66,17895,64,362975
17572,0.000116,74.125.68.0-255,3531,21426,64,362975
17573,0.000118,172.31.40.0-255,66,21492,64,362975
17574,0.000128,172.31.40.0-255,66,21558,64,362975
17575,0.000232,74.125.68.0-255,1484,23042,64,362975
17576,0.000236,172.31.40.0-255,66,23108,64,362975
17577,0.00024,74.125.68.0-255,1484,24592,64,362975
17578,0.000242,172.31.40.0-255,66,24658,64,362975
17579,0.000246,74.125.68.0-255,2902,27560,64,362975
17580,0.000248,172.31.40.0-255,66,27626,64,362975
17581,0.000266,74.125.68.0-255,2902,30528,64,362975
17582,0.000268,172.31.40.0-255,66,30594,64,362975
17583,0.000279,74.125.68.0-255,2902,33496,64,362975
17584,0.000281,172.31.40.0-255,66,33562,64,362975
17585,0.000293,74.125.68.0-255,2902,36464,64,362975
17586,0.000295,172.31.40.0-255,66,36530,64,362975
17587,0.000312,74.125.68.0-255,3961,40491,64,362975
17588,0.000314,172.31.40.0-255,66,40557,64,362975
17589,0.000321,74.125.68.0-255,7156,47713,64,362975
17590,0.000323,172.31.40.0-255,66,47779,64,362975
17591,0.000345,74.125.68.0-255,2902,50681,64,362975
17592,0.000347,172.31.40.0-255,66,50747,64,362975
17593,0.000367,74.125.68.0-255,5646,56393,64,362975
17594,0.000369,172.31.40.0-255,66,56459,64,362975
17595,0.000371,74.125.68.0-255,134,56593,64,362975
17596,0.000455,74.125.68.0-255,1484,58077,64,362975
17597,0.000459,74.125.68.0-255,2902,60979,64,362975
17598,0.000463,172.31.40.0-255,66,61045,64,362975
17599,0.000471,172.31.40.0-255,66,61111,64,362975
17600,0.000475,74.125.68.0-255,2902,64013,64,362975
17601,0.000477,172.31.40.0-255,66,64079,64,362975
17602,0.000493,74.125.68.0-255,2902,66981,64,362975
17603,0.000496,172.31.40.0-255,66,67047,64,362975
17604,0.000501,74.125.68.0-255,5738,72785,64,362975
17605,0.000503,172.31.40.0-255,66,72851,64,362975
17606,0.000526,74.125.68.0-255,5738,78589,64,362975
17607,0.000529,172.31.40.0-255,66,78655,64,362975
17608,0.000543,74.125.68.0-255,1484,80139,64,362975
17609,0.000549,74.125.68.0-255,4320,84459,64,362975
17610,0.000551,172.31.40.0-255,66,84525,64,362975
17611,0.000572,74.125.68.0-255,2902,87427,64,362975
17612,0.000574,172.31.40.0-255,66,87493,64,362975
17613,0.000608,74.125.68.0-255,3602,91095,64,362975
17614,0.000611,172.31.40.0-255,66,91161,64,362975
17615,0.000693,74.125.68.0-255,1484,92645,64,362975
17616,0.000708,74.125.68.0-255,2902,95547,64,362975
17617,0.000711,172.31.40.0-255,66,95613,64,362975
17618,0.000735,74.125.68.0-255,5738,101351,64,362975
17619,0.000737,172.31.40.0-255,66,101417,64,362975
17620,0.000751,74.125.68.0-255,2902,104319,64,362975
17621,0.000753,172.31.40.0-255,66,104385,64,362975
17622,0.000771,74.125.68.0-255,4320,108705,64,362975
17623,0.000773,172.31.40.0-255,66,108771,64,362975
17624,0.000777,74.125.68.0-255,4320,113091,64,362975
17625,0.000779,172.31.40.0-255,66,113157,64,362975
17626,0.000808,74.125.68.0-255,4320,117477,64,362975
17627,0.000811,172.31.40.0-255,66,117543,64,362975
17628,0.000817,74.125.68.0-255,7156,124699,64,362975
17629,0.000819,172.31.40.0-255,66,124765,64,362975
17630,0.000836,74.125.68.0-255,766,125531,64,362975
17631,0.000884,74.125.68.0-255,1484,127015,64,362975
17632,0.000886,172.31.40.0-255,66,127081,64,362975
17633,0.000891,74.125.68.0-255,4320,131401,64,362975
17634,0.000893,172.31.40.0-255,66,131467,64,362975
17635,0.000897,74.125.68.0-255,2902,134369,64,362975
17636,0.000899,172.31.40.0-255,66,134435,64,362975
17637,0.000925,74.125.68.0-255,4320,138755,64,362975
17638,0.000928,172.31.40.0-255,66,138821,64,362975
17639,0.000942,74.125.68.0-255,2902,141723,64,362975
17640,0.000944,172.31.40.0-255,66,141789,64,362975
17641,0.000976,74.125.68.0-255,5738,147527,64,362975
17642,0.000978,74.125.68.0-255,1484,149011,64,362975
17643,0.000982,172.31.40.0-255,66,149077,64,362975
17644,0.001021,172.31.40.0-255,66,149143,64,362975
17645,0.001038,74.125.68.0-255,2184,151327,64,362975
17646,0.001041,172.31.40.0-255,66,151393,64,362975
17647,0.001081,74.125.68.0-255,352,151745,64,362975
17648,0.001175,74.125.68.0-255,1484,153229,64,362975
17649,0.001178,172.31.40.0-255,66,153295,64,362975
17650,0.001183,74.125.68.0-255,2902,156197,64,362975
17651,0.001185,172.31.40.0-255,66,156263,64,362975
17652,0.001207,74.125.68.0-255,5738,162001,64,362975
17653,0.001209,172.31.40.0-255,66,162067,64,362975
17654,0.00123,74.125.68.0-255,7156,169223,64,362975
17655,0.001233,172.31.40.0-255,66,169289,64,362975
17656,0.00126,74.125.68.0-255,4320,173609,64,362975
17657,0.001262,172.31.40.0-255,66,173675,64,362975
17658,0.001292,172.31.40.0-255,66,173741,64,362975
17659,0.001307,74.125.68.0-255,2184,175925,64,362975
17660,0.00131,172.31.40.0-255,66,175991,64,362975
17661,0.002027,74.125.68.0-255,1484,177475,64,362975
17662,0.002032,74.125.68.0-255,1484,178959,64,362975
17663,0.002036,172.31.40.0-255,66,179025,64,362975
17664,0.002042,74.125.68.0-255,2902,181927,64,362975
17665,0.002044,172.31.40.0-255,66,181993,64,362975
17666,0.002051,74.125.68.0-255,5738,187731,64,362975
17667,0.002053,172.31.40.0-255,66,187797,64,362975
17668,0.002079,74.125.68.0-255,7156,194953,64,362975
17669,0.002082,172.31.40.0-255,66,195019,64,362975
17670,0.002103,74.125.68.0-255,2902,197921,64,362975
17671,0.002106,172.31.40.0-255,66,197987,64,362975
17672,0.00413,74.125.68.0-255,2902,200889,64,362975
17673,0.004137,172.31.40.0-255,66,200955,64,362975
17674,0.00416,74.125.68.0-255,2902,203857,64,362975
17675,0.004163,172.31.40.0-255,66,203923,64,362975
17676,0.006206,74.125.68.0-255,2902,206825,64,362975
17677,0.006211,172.31.40.0-255,66,206891,64,362975
17678,0.00623,74.125.68.0-255,2902,209793,64,362975
17679,0.006232,172.31.40.0-255,66,209859,64,362975
17680,0.00827,74.125.68.0-255,5738,215597,64,362975
17681,0.008273,172.31.40.0-255,66,215663,64,362975
17682,0.010332,74.125.68.0-255,4320,219983,64,362975
17683,0.010339,172.31.40.0-255,66,220049,64,362975
17684,0.010357,74.125.68.0-255,1484,221533,64,362975
17685,0.012418,74.125.68.0-255,4320,225853,64,362975
17686,0.012426,172.31.40.0-255,66,225919,64,362975
17687,0.014489,74.125.68.0-255,5738,231657,64,362975
17688,0.014498,172.31.40.0-255,66,231723,64,362975
17689,0.016568,74.125.68.0-255,5738,237461,64,362975
17690,0.016582,172.31.40.0-255,66,237527,64,362975
17691,0.018653,74.125.68.0-255,5738,243265,64,362975
17692,0.018669,172.31.40.0-255,66,243331,64,362975
17693,0.020773,74.125.68.0-255,5738,249069,64,362975
17694,0.020787,172.31.40.0-255,66,249135,64,362975
17695,0.02288,74.125.68.0-255,5738,254873,64,362975
17696,0.022895,172.31.40.0-255,66,254939,64,362975
17697,0.024975,74.125.68.0-255,5738,260677,64,362975
17698,0.024988,172.31.40.0-255,66,260743,64,362975
17699,0.027073,74.125.68.0-255,5738,266481,64,362975
17700,0.027087,172.31.40.0-255,66,266547,64,362975
17701,0.027214,172.31.40.0-255,101,266648,64,362975
17702,0.029161,74.125.68.0-255,5738,272386,64,362975
17703,0.029172,172.31.40.0-255,66,272452,64,362975
17704,0.029233,74.125.68.0-255,66,272518,64,362975
17705,0.031251,74.125.68.0-255,5738,278256,64,362975
17706,0.031268,172.31.40.0-255,66,278322,64,362975
17707,0.033335,74.125.68.0-255,5738,284060,64,362975
17708,0.033342,172.31.40.0-255,66,284126,64,362975
17709,0.03541,74.125.68.0-255,5738,289864,64,362975
17710,0.035418,172.31.40.0-255,66,289930,64,362975
17711,0.037528,74.125.68.0-255,5738,295668,64,362975
17712,0.037539,172.31.40.0-255,66,295734,64,362975
17713,0.039618,74.125.68.0-255,5738,301472,64,362975
17714,0.039628,172.31.40.0-255,66,301538,64,362975
17715,0.041709,74.125.68.0-255,5738,307276,64,362975
17716,0.041726,172.31.40.0-255,66,307342,64,362975
17717,0.043804,74.125.68.0-255,5738,313080,64,362975
17718,0.043818,172.31.40.0-255,66,313146,64,362975
17719,0.045897,74.125.68.0-255,5738,318884,64,362975
17720,0.045905,172.31.40.0-255,66,318950,64,362975
17721,0.047981,74.125.68.0-255,5738,324688,64,362975
17722,0.04799,172.31.40.0-255,66,324754,64,362975
17723,0.050061,74.125.68.0-255,5738,330492,64,362975
17724,0.050069,172.31.40.0-255,66,330558,64,362975
17725,0.051694,172.31.40.0-255,172,330730,64,362975
17726,0.051729,172.31.40.0-255,1112,331842,64,362975
17727,0.051795,172.31.40.0-255,1514,333356,64,362975
17728,0.051797,172.31.40.0-255,1514,334870,64,362975
17729,0.051802,172.31.40.0-255,1514,336384,64,362975
17730,0.051803,172.31.40.0-255,1514,337898,64,362975
17731,0.051821,172.31.40.0-255,1514,339412,64,362975
17732,0.051822,172.31.40.0-255,83,339495,64,362975
17733,0.052134,74.125.68.0-255,5738,345233,64,362975
17734,0.052141,172.31.40.0-255,66,345299,64,362975
17735,0.053294,104.244.42.0-255,66,345365,64,362975
17736,0.053303,104.244.42.0-255,66,345431,64,362975
17737,0.053377,104.244.42.0-255,66,345497,64,362975
17738,0.053383,104.244.42.0-255,66,345563,64,362975
17739,0.054196,74.125.68.0-255,5738,351301,64,362975
17740,0.054204,172.31.40.0-255,66,351367,64,362975
17741,0.056271,74.125.68.0-255,5738,357105,64,362975
17742,0.056278,172.31.40.0-255,66,357171,64,362975
17743,0.058358,74.125.68.0-255,5738,362909,64,362975
17744,0.058365,172.31.40.0-255,66,362975,64,362975
17745,0.0,74.125.24.0-255,290,290,64,127771
17746,2.4e-05,172.31.40.0-255,66,356,64,127771
17747,3.1e-05,74.125.24.0-255,1484,1840,64,127771
17748,3.6e-05,172.31.40.0-255,66,1906,64,127771
17749,5e-05,74.125.24.0-255,4320,6226,64,127771
17750,5.4e-05,172.31.40.0-255,66,6292,64,127771
17751,6.7e-05,172.31.40.0-255,66,6358,64,127771
17752,7.2e-05,74.125.24.0-255,4320,10678,64,127771
17753,7.5e-05,172.31.40.0-255,66,10744,64,127771
17754,0.000129,172.31.40.0-255,66,10810,64,127771
17755,0.000218,74.125.24.0-255,1484,12294,64,127771
17756,0.000221,172.31.40.0-255,66,12360,64,127771
17757,0.000239,74.125.24.0-255,2902,15262,64,127771
17758,0.000242,172.31.40.0-255,66,15328,64,127771
17759,0.000271,74.125.24.0-255,5738,21066,64,127771
17760,0.000274,172.31.40.0-255,66,21132,64,127771
17761,0.000278,74.125.24.0-255,2902,24034,64,127771
17762,0.00028,172.31.40.0-255,66,24100,64,127771
17763,0.000314,172.31.40.0-255,66,24166,64,127771
17764,0.000322,74.125.24.0-255,7156,31322,64,127771
17765,0.000324,172.31.40.0-255,66,31388,64,127771
17766,0.000366,74.125.24.0-255,2854,34242,64,127771
17767,0.000368,172.31.40.0-255,66,34308,64,127771
17768,0.000393,74.125.24.0-255,110,34418,64,127771
17769,0.000395,172.31.40.0-255,66,34484,64,127771
17770,0.000492,74.125.24.0-255,1484,35968,64,127771
17771,0.000497,172.31.40.0-255,66,36034,64,127771
17772,0.000502,74.125.24.0-255,2902,38936,64,127771
17773,0.000505,172.31.40.0-255,66,39002,64,127771
17774,0.000515,74.125.24.0-255,5738,44740,64,127771
17775,0.000518,172.31.40.0-255,66,44806,64,127771
17776,0.000561,172.31.40.0-255,66,44872,64,127771
17777,0.000598,172.31.40.0-255,66,44938,64,127771
17778,0.000725,74.125.24.0-255,1484,46422,64,127771
17779,0.00073,172.31.40.0-255,66,46488,64,127771
17780,0.000736,74.125.24.0-255,2902,49390,64,127771
17781,0.000738,172.31.40.0-255,66,49456,64,127771
17782,0.000746,74.125.24.0-255,1484,50940,64,127771
17783,0.000748,172.31.40.0-255,66,51006,64,127771
17784,0.000781,74.125.24.0-255,4320,55326,64,127771
17785,0.000785,172.31.40.0-255,66,55392,64,127771
17786,0.000803,172.31.40.0-255,66,55458,64,127771
17787,0.00084,172.31.40.0-255,66,55524,64,127771
17788,0.000879,172.31.40.0-255,66,55590,64,127771
17789,0.000895,172.31.40.0-255,66,55656,64,127771
17790,0.000931,172.31.40.0-255,66,55722,64,127771
17791,0.000987,74.125.24.0-255,1484,57206,64,127771
17792,0.00099,172.31.40.0-255,66,57272,64,127771
17793,0.000994,74.125.24.0-255,2902,60174,64,127771
17794,0.000997,172.31.40.0-255,66,60240,64,127771
17795,0.001009,74.125.24.0-255,5738,65978,64,127771
17796,0.001012,172.31.40.0-255,66,66044,64,127771
17797,0.001017,74.125.24.0-255,4320,70364,64,127771
17798,0.001019,172.31.40.0-255,66,70430,64,127771
17799,0.001063,172.31.40.0-255,66,70496,64,127771
17800,0.001102,172.31.40.0-255,66,70562,64,127771
17801,0.001136,74.125.24.0-255,1484,72046,64,127771
17802,0.001151,74.125.24.0-255,2902,74948,64,127771
17803,0.001154,172.31.40.0-255,66,75014,64,127771
17804,0.00116,74.125.24.0-255,4320,79334,64,127771
17805,0.001162,172.31.40.0-255,66,79400,64,127771
17806,0.001194,74.125.24.0-255,1484,80884,64,127771
17807,0.001202,74.125.24.0-255,7156,88040,64,127771
17808,0.001205,172.31.40.0-255,66,88106,64,127771
17809,0.001226,74.125.24.0-255,2184,90290,64,127771
17810,0.001251,172.31.40.0-255,66,90356,64,127771
17811,0.00171,74.125.24.0-255,1484,91840,64,127771
17812,0.001717,74.125.24.0-255,2902,94742,64,127771
17813,0.001721,172.31.40.0-255,66,94808,64,127771
17814,0.001726,74.125.24.0-255,2902,97710,64,127771
17815,0.001728,172.31.40.0-255,66,97776,64,127771
17816,0.001756,74.125.24.0-255,2902,100678,64,127771
17817,0.001759,172.31.40.0-255,66,100744,64,127771
17818,0.001782,172.31.40.0-255,66,100810,64,127771
17819,0.001809,172.31.40.0-255,66,100876,64,127771
17820,0.001843,74.125.24.0-255,1484,102360,64,127771
17821,0.001848,74.125.24.0-255,2902,105262,64,127771
17822,0.001851,172.31.40.0-255,66,105328,64,127771
17823,0.001857,74.125.24.0-255,5738,111066,64,127771
17824,0.001859,172.31.40.0-255,66,111132,64,127771
17825,0.001878,172.31.40.0-255,66,111198,64,127771
17826,0.001913,172.31.40.0-255,66,111264,64,127771
17827,0.001952,172.31.40.0-255,66,111330,64,127771
17828,0.002001,74.125.24.0-255,4320,115650,64,127771
17829,0.002011,172.31.40.0-255,66,115716,64,127771
17830,0.002126,74.125.24.0-255,4320,120036,64,127771
17831,0.002134,172.31.40.0-255,66,120102,64,127771
17832,0.002146,74.125.24.0-255,1484,121586,64,127771
17833,0.002162,74.125.24.0-255,1484,123070,64,127771
17834,0.002175,172.31.40.0-255,66,123136,64,127771
17835,0.002198,74.125.24.0-255,105,123241,64,127771
17836,0.002203,172.31.40.0-255,66,123307,64,127771
17837,0.00467,172.31.40.0-255,105,123412,64,127771
17838,0.006662,74.125.24.0-255,66,123478,64,127771
17839,0.054036,172.31.40.0-255,171,123649,64,127771
17840,0.054069,172.31.40.0-255,1137,124786,64,127771
17841,0.054128,172.31.40.0-255,1514,126300,64,127771
17842,0.054129,172.31.40.0-255,1273,127573,64,127771
17843,0.055536,104.244.42.0-255,66,127639,64,127771
17844,0.055564,104.244.42.0-255,66,127705,64,127771
17845,0.055629,104.244.42.0-255,66,127771,64,127771
17846,0.0,74.125.68.0-255,153,153,64,330876
17847,2.3e-05,172.31.40.0-255,66,219,64,330876
17848,2.9e-05,74.125.68.0-255,1484,1703,64,330876
17849,3.4e-05,172.31.40.0-255,66,1769,64,330876
17850,4e-05,74.125.68.0-255,2902,4671,64,330876
17851,4.4e-05,172.31.40.0-255,66,4737,64,330876
17852,5.2e-05,74.125.68.0-255,7156,11893,64,330876
17853,5.5e-05,172.31.40.0-255,66,11959,64,330876
17854,5.9e-05,74.125.68.0-255,2151,14110,64,330876
17855,6.2e-05,172.31.40.0-255,66,14176,64,330876
17856,0.000109,74.125.68.0-255,1484,15660,64,330876
17857,0.000112,172.31.40.0-255,66,15726,64,330876
17858,0.000118,74.125.68.0-255,2902,18628,64,330876
17859,0.000121,172.31.40.0-255,66,18694,64,330876
17860,0.000158,74.125.68.0-255,5738,24432,64,330876
17861,0.000161,172.31.40.0-255,66,24498,64,330876
17862,0.000183,74.125.68.0-255,6797,31295,64,330876
17863,0.000185,172.31.40.0-255,66,31361,64,330876
17864,0.000271,74.125.68.0-255,1484,32845,64,330876
17865,0.000275,172.31.40.0-255,66,32911,64,330876
17866,0.000281,74.125.68.0-255,2902,35813,64,330876
17867,0.000283,172.31.40.0-255,66,35879,64,330876
17868,0.000308,74.125.68.0-255,5738,41617,64,330876
17869,0.000312,172.31.40.0-255,66,41683,64,330876
17870,0.000316,74.125.68.0-255,2902,44585,64,330876
17871,0.000318,172.31.40.0-255,66,44651,64,330876
17872,0.00034,74.125.68.0-255,3961,48612,64,330876
17873,0.000343,172.31.40.0-255,66,48678,64,330876
17874,0.000358,74.125.68.0-255,2902,51580,64,330876
17875,0.00036,172.31.40.0-255,66,51646,64,330876
17876,0.000381,74.125.68.0-255,2902,54548,64,330876
17877,0.000384,172.31.40.0-255,66,54614,64,330876
17878,0.000391,74.125.68.0-255,5738,60352,64,330876
17879,0.000394,172.31.40.0-255,66,60418,64,330876
17880,0.000419,74.125.68.0-255,1484,61902,64,330876
17881,0.000426,74.125.68.0-255,3961,65863,64,330876
17882,0.000429,172.31.40.0-255,66,65929,64,330876
17883,0.000431,74.125.68.0-255,366,66295,64,330876
17884,0.000463,74.125.68.0-255,378,66673,64,330876
17885,0.000589,74.125.68.0-255,1484,68157,64,330876
17886,0.000593,172.31.40.0-255,66,68223,64,330876
17887,0.000598,74.125.68.0-255,1484,69707,64,330876
17888,0.000611,74.125.68.0-255,1484,71191,64,330876
17889,0.000613,172.31.40.0-255,66,71257,64,330876
17890,0.000618,74.125.68.0-255,2902,74159,64,330876
17891,0.000621,172.31.40.0-255,66,74225,64,330876
17892,0.000626,74.125.68.0-255,4320,78545,64,330876
17893,0.000628,172.31.40.0-255,66,78611,64,330876
17894,0.000669,172.31.40.0-255,66,78677,64,330876
17895,0.000673,74.125.68.0-255,2902,81579,64,330876
17896,0.000675,172.31.40.0-255,66,81645,64,330876
17897,0.00072,74.125.68.0-255,7156,88801,64,330876
17898,0.000724,172.31.40.0-255,66,88867,64,330876
17899,0.000743,74.125.68.0-255,2543,91410,64,330876
17900,0.000745,172.31.40.0-255,66,91476,64,330876
17901,0.000898,74.125.68.0-255,1484,92960,64,330876
17902,0.000918,74.125.68.0-255,2902,95862,64,330876
17903,0.000921,172.31.40.0-255,66,95928,64,330876
17904,0.000929,74.125.68.0-255,4320,100248,64,330876
17905,0.000931,172.31.40.0-255,66,100314,64,330876
17906,0.00098,172.31.40.0-255,66,100380,64,330876
17907,0.000987,74.125.68.0-255,5738,106118,64,330876
17908,0.000989,172.31.40.0-255,66,106184,64,330876
17909,0.000996,74.125.68.0-255,7156,113340,64,330876
17910,0.000999,172.31.40.0-255,66,113406,64,330876
17911,0.001021,74.125.68.0-255,3602,117008,64,330876
17912,0.001023,172.31.40.0-255,66,117074,64,330876
17913,0.001574,74.125.68.0-255,1484,118558,64,330876
17914,0.00159,74.125.68.0-255,2902,121460,64,330876
17915,0.001595,172.31.40.0-255,66,121526,64,330876
17916,0.001614,74.125.68.0-255,1484,123010,64,330876
17917,0.001631,74.125.68.0-255,4320,127330,64,330876
17918,0.001634,172.31.40.0-255,66,127396,64,330876
17919,0.001637,74.125.68.0-255,1484,128880,64,330876
17920,0.001642,74.125.68.0-255,2902,131782,64,330876
17921,0.001644,172.31.40.0-255,66,131848,64,330876
17922,0.001677,74.125.68.0-255,5738,137586,64,330876
17923,0.00168,172.31.40.0-255,66,137652,64,330876
17924,0.001692,172.31.40.0-255,66,137718,64,330876
17925,0.001727,74.125.68.0-255,1484,139202,64,330876
17926,0.001744,74.125.68.0-255,2902,142104,64,330876
17927,0.001747,172.31.40.0-255,66,142170,64,330876
17928,0.001763,74.125.68.0-255,766,142936,64,330876
17929,0.002061,74.125.68.0-255,1484,144420,64,330876
17930,0.002067,172.31.40.0-255,66,144486,64,330876
17931,0.002074,74.125.68.0-255,2902,147388,64,330876
17932,0.002077,172.31.40.0-255,66,147454,64,330876
17933,0.002083,74.125.68.0-255,4320,151774,64,330876
17934,0.002086,172.31.40.0-255,66,151840,64,330876
17935,0.002113,74.125.68.0-255,5738,157578,64,330876
17936,0.002115,172.31.40.0-255,66,157644,64,330876
17937,0.002148,74.125.68.0-255,5738,163382,64,330876
17938,0.002151,172.31.40.0-255,66,163448,64,330876
17939,0.00217,74.125.68.0-255,4320,167768,64,330876
17940,0.002172,172.31.40.0-255,66,167834,64,330876
17941,0.002187,74.125.68.0-255,1484,169318,64,330876
17942,0.002208,172.31.40.0-255,66,169384,64,330876
17943,0.002262,74.125.68.0-255,7156,176540,64,330876
17944,0.002265,172.31.40.0-255,66,176606,64,330876
17945,0.004466,74.125.68.0-255,5738,182344,64,330876
17946,0.004475,172.31.40.0-255,66,182410,64,330876
17947,0.006661,74.125.68.0-255,5738,188148,64,330876
17948,0.006665,172.31.40.0-255,66,188214,64,330876
17949,0.008861,74.125.68.0-255,5738,193952,64,330876
17950,0.008868,172.31.40.0-255,66,194018,64,330876
17951,0.01107,74.125.68.0-255,5738,199756,64,330876
17952,0.011078,172.31.40.0-255,66,199822,64,330876
17953,0.013279,74.125.68.0-255,5738,205560,64,330876
17954,0.013287,172.31.40.0-255,66,205626,64,330876
17955,0.015486,74.125.68.0-255,5738,211364,64,330876
17956,0.015494,172.31.40.0-255,66,211430,64,330876
17957,0.017698,74.125.68.0-255,5738,217168,64,330876
17958,0.017712,172.31.40.0-255,66,217234,64,330876
17959,0.019924,74.125.68.0-255,5738,222972,64,330876
17960,0.019938,172.31.40.0-255,66,223038,64,330876
17961,0.022147,74.125.68.0-255,5738,228776,64,330876
17962,0.022161,172.31.40.0-255,66,228842,64,330876
17963,0.024365,74.125.68.0-255,5738,234580,64,330876
17964,0.024372,172.31.40.0-255,66,234646,64,330876
17965,0.026576,74.125.68.0-255,5738,240384,64,330876
17966,0.026584,172.31.40.0-255,66,240450,64,330876
17967,0.028785,74.125.68.0-255,5738,246188,64,330876
17968,0.028791,172.31.40.0-255,66,246254,64,330876
17969,0.029361,172.31.40.0-255,172,246426,64,330876
17970,0.029392,172.31.40.0-255,1107,247533,64,330876
17971,0.029473,172.31.40.0-255,1514,249047,64,330876
17972,0.029475,172.31.40.0-255,340,249387,64,330876
17973,0.030993,74.125.68.0-255,5738,255125,64,330876
17974,0.031,172.31.40.0-255,66,255191,64,330876
17975,0.031007,104.244.42.0-255,66,255257,64,330876
17976,0.033206,74.125.68.0-255,5738,260995,64,330876
17977,0.033212,172.31.40.0-255,66,261061,64,330876
17978,0.035426,74.125.68.0-255,5738,266799,64,330876
17979,0.035432,172.31.40.0-255,66,266865,64,330876
17980,0.037629,74.125.68.0-255,5738,272603,64,330876
17981,0.037636,172.31.40.0-255,66,272669,64,330876
17982,0.03984,74.125.68.0-255,5738,278407,64,330876
17983,0.039846,172.31.40.0-255,66,278473,64,330876
17984,0.039942,172.31.40.0-255,101,278574,64,330876
17985,0.042049,74.125.68.0-255,5738,284312,64,330876
17986,0.042058,172.31.40.0-255,66,284378,64,330876
17987,0.042082,74.125.68.0-255,66,284444,64,330876
17988,0.044261,74.125.68.0-255,5738,290182,64,330876
17989,0.044268,172.31.40.0-255,66,290248,64,330876
17990,0.046487,74.125.68.0-255,5738,295986,64,330876
17991,0.046493,172.31.40.0-255,66,296052,64,330876
17992,0.048693,74.125.68.0-255,5738,301790,64,330876
17993,0.048699,172.31.40.0-255,66,301856,64,330876
17994,0.050904,74.125.68.0-255,5738,307594,64,330876
17995,0.050911,172.31.40.0-255,66,307660,64,330876
17996,0.053111,74.125.68.0-255,5738,313398,64,330876
17997,0.053117,172.31.40.0-255,66,313464,64,330876
17998,0.055333,74.125.68.0-255,5738,319202,64,330876
17999,0.05534,172.31.40.0-255,66,319268,64,330876
18000,0.05755,74.125.68.0-255,5738,325006,64,330876
18001,0.057557,172.31.40.0-255,66,325072,64,330876
18002,0.059764,74.125.68.0-255,5738,330810,64,330876
18003,0.059771,172.31.40.0-255,66,330876,64,330876
18004,0.0,74.125.24.0-255,153,153,64,203760
18005,2.1e-05,172.31.40.0-255,66,219,64,203760
18006,2.8e-05,74.125.24.0-255,1484,1703,64,203760
18007,3.2e-05,172.31.40.0-255,66,1769,64,203760
18008,3.7e-05,74.125.24.0-255,2902,4671,64,203760
18009,3.9e-05,172.31.40.0-255,66,4737,64,203760
18010,6.6e-05,74.125.24.0-255,2902,7639,64,203760
18011,6.9e-05,172.31.40.0-255,66,7705,64,203760
18012,7.9e-05,74.125.24.0-255,4320,12025,64,203760
18013,8.1e-05,172.31.40.0-255,66,12091,64,203760
18014,9.3e-05,74.125.24.0-255,1978,14069,64,203760
18015,9.6e-05,172.31.40.0-255,66,14135,64,203760
18016,0.000383,74.125.24.0-255,1484,15619,64,203760
18017,0.000388,172.31.40.0-255,66,15685,64,203760
18018,0.000393,74.125.24.0-255,2902,18587,64,203760
18019,0.000396,172.31.40.0-255,66,18653,64,203760
18020,0.000421,74.125.24.0-255,5738,24391,64,203760
18021,0.000423,172.31.40.0-255,66,24457,64,203760
18022,0.000445,74.125.24.0-255,1484,25941,64,203760
18023,0.000448,172.31.40.0-255,66,26007,64,203760
18024,0.000473,74.125.24.0-255,4320,30327,64,203760
18025,0.000476,172.31.40.0-255,66,30393,64,203760
18026,0.000489,74.125.24.0-255,1125,31518,64,203760
18027,0.000494,172.31.40.0-255,66,31584,64,203760
18028,0.000906,74.125.24.0-255,1484,33068,64,203760
18029,0.000911,172.31.40.0-255,66,33134,64,203760
18030,0.000919,74.125.24.0-255,2902,36036,64,203760
18031,0.000921,172.31.40.0-255,66,36102,64,203760
18032,0.000953,74.125.24.0-255,5738,41840,64,203760
18033,0.000956,172.31.40.0-255,66,41906,64,203760
18034,0.000958,74.125.24.0-255,1484,43390,64,203760
18035,0.00096,172.31.40.0-255,66,43456,64,203760
18036,0.001002,74.125.24.0-255,4320,47776,64,203760
18037,0.001004,172.31.40.0-255,66,47842,64,203760
18038,0.001024,74.125.24.0-255,5379,53221,64,203760
18039,0.001026,172.31.40.0-255,66,53287,64,203760
18040,0.001035,172.31.40.0-255,66,53353,64,203760
18041,0.001057,74.125.24.0-255,1484,54837,64,203760
18042,0.001062,74.125.24.0-255,2543,57380,64,203760
18043,0.001064,172.31.40.0-255,66,57446,64,203760
18044,0.003346,74.125.24.0-255,4320,61766,64,203760
18045,0.003355,172.31.40.0-255,66,61832,64,203760
18046,0.003382,74.125.24.0-255,1484,63316,64,203760
18047,0.005639,74.125.24.0-255,4320,67636,64,203760
18048,0.005644,172.31.40.0-255,66,67702,64,203760
18049,0.007947,74.125.24.0-255,4320,72022,64,203760
18050,0.007954,172.31.40.0-255,66,72088,64,203760
18051,0.007986,74.125.24.0-255,1484,73572,64,203760
18052,0.010295,74.125.24.0-255,4320,77892,64,203760
18053,0.010304,172.31.40.0-255,66,77958,64,203760
18054,0.012615,74.125.24.0-255,5738,83696,64,203760
18055,0.012626,172.31.40.0-255,66,83762,64,203760
18056,0.014949,74.125.24.0-255,5738,89500,64,203760
18057,0.014959,172.31.40.0-255,66,89566,64,203760
18058,0.017278,74.125.24.0-255,4320,93886,64,203760
18059,0.017286,172.31.40.0-255,66,93952,64,203760
18060,0.017315,74.125.24.0-255,1484,95436,64,203760
18061,0.01961,74.125.24.0-255,4320,99756,64,203760
18062,0.019618,172.31.40.0-255,66,99822,64,203760
18063,0.021991,74.125.24.0-255,5738,105560,64,203760
18064,0.021997,172.31.40.0-255,66,105626,64,203760
18065,0.023222,172.31.40.0-255,170,105796,64,203760
18066,0.023254,172.31.40.0-255,1173,106969,64,203760
18067,0.023316,172.31.40.0-255,1514,108483,64,203760
18068,0.023318,172.31.40.0-255,1514,109997,64,203760
18069,0.023342,172.31.40.0-255,635,110632,64,203760
18070,0.024348,74.125.24.0-255,5738,116370,64,203760
18071,0.024356,172.31.40.0-255,66,116436,64,203760
18072,0.02477,104.244.42.0-255,66,116502,64,203760
18073,0.024793,104.244.42.0-255,66,116568,64,203760
18074,0.024865,104.244.42.0-255,66,116634,64,203760
18075,0.02487,104.244.42.0-255,66,116700,64,203760
18076,0.026682,74.125.24.0-255,5738,122438,64,203760
18077,0.026689,172.31.40.0-255,66,122504,64,203760
18078,0.029026,74.125.24.0-255,5738,128242,64,203760
18079,0.029032,172.31.40.0-255,66,128308,64,203760
18080,0.031324,74.125.24.0-255,5738,134046,64,203760
18081,0.031331,172.31.40.0-255,66,134112,64,203760
18082,0.033648,74.125.24.0-255,5738,139850,64,203760
18083,0.033655,172.31.40.0-255,66,139916,64,203760
18084,0.036009,74.125.24.0-255,5738,145654,64,203760
18085,0.036014,172.31.40.0-255,66,145720,64,203760
18086,0.038336,74.125.24.0-255,5738,151458,64,203760
18087,0.038343,172.31.40.0-255,66,151524,64,203760
18088,0.040646,74.125.24.0-255,5738,157262,64,203760
18089,0.040654,172.31.40.0-255,66,157328,64,203760
18090,0.042998,74.125.24.0-255,5738,163066,64,203760
18091,0.043006,172.31.40.0-255,66,163132,64,203760
18092,0.045343,74.125.24.0-255,5738,168870,64,203760
18093,0.045353,172.31.40.0-255,66,168936,64,203760
18094,0.047707,74.125.24.0-255,5738,174674,64,203760
18095,0.047714,172.31.40.0-255,66,174740,64,203760
18096,0.050023,74.125.24.0-255,5738,180478,64,203760
18097,0.050029,172.31.40.0-255,66,180544,64,203760
18098,0.052337,74.125.24.0-255,5738,186282,64,203760
18099,0.052343,172.31.40.0-255,66,186348,64,203760
18100,0.054648,74.125.24.0-255,5738,192086,64,203760
18101,0.054656,172.31.40.0-255,66,192152,64,203760
18102,0.056991,74.125.24.0-255,5738,197890,64,203760
18103,0.056997,172.31.40.0-255,66,197956,64,203760
18104,0.059323,74.125.24.0-255,5738,203694,64,203760
18105,0.05933,172.31.40.0-255,66,203760,64,203760
18106,0.0,172.217.194.0-255,153,153,64,247275
18107,2.1e-05,172.31.40.0-255,66,219,64,247275
18108,2.9e-05,172.217.194.0-255,1484,1703,64,247275
18109,3.3e-05,172.31.40.0-255,66,1769,64,247275
18110,3.9e-05,172.217.194.0-255,2902,4671,64,247275
18111,4.3e-05,172.31.40.0-255,66,4737,64,247275
18112,5.1e-05,172.217.194.0-255,7156,11893,64,247275
18113,5.5e-05,172.31.40.0-255,66,11959,64,247275
18114,9.8e-05,172.217.194.0-255,2133,14092,64,247275
18115,0.000101,172.31.40.0-255,66,14158,64,247275
18116,0.000126,172.217.194.0-255,2902,17060,64,247275
18117,0.000129,172.31.40.0-255,66,17126,64,247275
18118,0.000153,172.217.194.0-255,5738,22864,64,247275
18119,0.000156,172.31.40.0-255,66,22930,64,247275
18120,0.000173,172.217.194.0-255,1484,24414,64,247275
18121,0.000175,172.31.40.0-255,66,24480,64,247275
18122,0.000225,172.31.40.0-255,66,24546,64,247275
18123,0.000269,172.217.194.0-255,7156,31702,64,247275
18124,0.000273,172.31.40.0-255,66,31768,64,247275
18125,0.000354,172.217.194.0-255,5738,37506,64,247275
18126,0.000358,172.31.40.0-255,66,37572,64,247275
18127,0.000374,172.217.194.0-255,2184,39756,64,247275
18128,0.000376,172.31.40.0-255,66,39822,64,247275
18129,0.000578,172.217.194.0-255,1484,41306,64,247275
18130,0.000582,172.31.40.0-255,66,41372,64,247275
18131,0.000588,172.217.194.0-255,2902,44274,64,247275
18132,0.000591,172.31.40.0-255,66,44340,64,247275
18133,0.000616,172.217.194.0-255,2902,47242,64,247275
18134,0.000619,172.31.40.0-255,66,47308,64,247275
18135,0.000635,172.217.194.0-255,2902,50210,64,247275
18136,0.000637,172.31.40.0-255,66,50276,64,247275
18137,0.00066,172.217.194.0-255,5738,56014,64,247275
18138,0.000673,172.217.194.0-255,1125,57139,64,247275
18139,0.000686,172.31.40.0-255,66,57205,64,247275
18140,0.000716,172.217.194.0-255,1484,58689,64,247275
18141,0.00072,172.217.194.0-255,1484,60173,64,247275
18142,0.000724,172.31.40.0-255,66,60239,64,247275
18143,0.000732,172.217.194.0-255,1484,61723,64,247275
18144,0.000759,172.217.194.0-255,5738,67461,64,247275
18145,0.000767,172.31.40.0-255,66,67527,64,247275
18146,0.000817,172.217.194.0-255,4320,71847,64,247275
18147,0.00085,172.31.40.0-255,66,71913,64,247275
18148,0.000855,172.31.40.0-255,66,71979,64,247275
18149,0.00093,172.217.194.0-255,7156,79135,64,247275
18150,0.000945,172.217.194.0-255,2902,82037,64,247275
18151,0.000957,172.31.40.0-255,66,82103,64,247275
18152,0.001015,172.217.194.0-255,766,82869,64,247275
18153,0.001021,172.217.194.0-255,2902,85771,64,247275
18154,0.001037,172.31.40.0-255,66,85837,64,247275
18155,0.001065,172.31.40.0-255,66,85903,64,247275
18156,0.001228,172.217.194.0-255,1484,87387,64,247275
18157,0.001246,172.217.194.0-255,7156,94543,64,247275
18158,0.001265,172.31.40.0-255,66,94609,64,247275
18159,0.001287,172.31.40.0-255,66,94675,64,247275
18160,0.001309,172.217.194.0-255,6438,101113,64,247275
18161,0.001323,172.31.40.0-255,66,101179,64,247275
18162,0.001562,172.217.194.0-255,7156,108335,64,247275
18163,0.001567,172.31.40.0-255,66,108401,64,247275
18164,0.00159,172.217.194.0-255,4182,112583,64,247275
18165,0.0016,172.31.40.0-255,66,112649,64,247275
18166,0.001653,172.217.194.0-255,1484,114133,64,247275
18167,0.001668,172.217.194.0-255,1484,115617,64,247275
18168,0.001672,172.31.40.0-255,66,115683,64,247275
18169,0.001684,172.217.194.0-255,1484,117167,64,247275
18170,0.0017,172.217.194.0-255,5738,122905,64,247275
18171,0.001704,172.31.40.0-255,66,122971,64,247275
18172,0.001752,172.217.194.0-255,1484,124455,64,247275
18173,0.001802,172.31.40.0-255,66,124521,64,247275
18174,0.001854,172.217.194.0-255,7156,131677,64,247275
18175,0.001858,172.31.40.0-255,66,131743,64,247275
18176,0.001881,172.217.194.0-255,6438,138181,64,247275
18177,0.001895,172.31.40.0-255,66,138247,64,247275
18178,0.001987,172.31.40.0-255,66,138313,64,247275
18179,0.002029,172.31.40.0-255,66,138379,64,247275
18180,0.010698,172.31.40.0-255,66,138445,64,247275
18181,0.012435,172.217.194.0-255,1484,139929,64,247275
18182,0.01332,172.217.194.0-255,4320,144249,64,247275
18183,0.01333,172.31.40.0-255,66,144315,64,247275
18184,0.015964,172.217.194.0-255,5738,150053,64,247275
18185,0.015978,172.31.40.0-255,66,150119,64,247275
18186,0.01861,172.217.194.0-255,5738,155857,64,247275
18187,0.01862,172.31.40.0-255,66,155923,64,247275
18188,0.021256,172.217.194.0-255,5738,161661,64,247275
18189,0.021274,172.31.40.0-255,66,161727,64,247275
18190,0.023892,172.217.194.0-255,5738,167465,64,247275
18191,0.023901,172.31.40.0-255,66,167531,64,247275
18192,0.02656,172.217.194.0-255,5738,173269,64,247275
18193,0.02657,172.31.40.0-255,66,173335,64,247275
18194,0.029179,172.217.194.0-255,5738,179073,64,247275
18195,0.02919,172.31.40.0-255,66,179139,64,247275
18196,0.031823,172.217.194.0-255,5738,184877,64,247275
18197,0.031839,172.31.40.0-255,66,184943,64,247275
18198,0.034481,172.217.194.0-255,5738,190681,64,247275
18199,0.034489,172.31.40.0-255,66,190747,64,247275
18200,0.037146,172.217.194.0-255,5738,196485,64,247275
18201,0.037168,172.31.40.0-255,66,196551,64,247275
18202,0.039815,172.217.194.0-255,5738,202289,64,247275
18203,0.039828,172.31.40.0-255,66,202355,64,247275
18204,0.042463,172.217.194.0-255,5738,208093,64,247275
18205,0.04248,172.31.40.0-255,66,208159,64,247275
18206,0.04513,172.217.194.0-255,5738,213897,64,247275
18207,0.045149,172.31.40.0-255,66,213963,64,247275
18208,0.047763,172.217.194.0-255,5738,219701,64,247275
18209,0.047772,172.31.40.0-255,66,219767,64,247275
18210,0.050427,172.217.194.0-255,5738,225505,64,247275
18211,0.050449,172.31.40.0-255,66,225571,64,247275
18212,0.053101,172.217.194.0-255,5738,231309,64,247275
18213,0.053111,172.31.40.0-255,66,231375,64,247275
18214,0.055741,172.217.194.0-255,5738,237113,64,247275
18215,0.055748,172.31.40.0-255,66,237179,64,247275
18216,0.056408,172.31.40.0-255,172,237351,64,247275
18217,0.056436,172.31.40.0-255,1113,238464,64,247275
18218,0.056494,172.31.40.0-255,1514,239978,64,247275
18219,0.056496,172.31.40.0-255,1295,241273,64,247275
18220,0.058019,104.244.42.0-255,66,241339,64,247275
18221,0.058028,104.244.42.0-255,66,241405,64,247275
18222,0.058041,104.244.42.0-255,66,241471,64,247275
18223,0.058381,172.217.194.0-255,5738,247209,64,247275
18224,0.058389,172.31.40.0-255,66,247275,64,247275
18225,0.0,74.125.68.0-255,153,153,64,335869
18226,2.6e-05,172.31.40.0-255,66,219,64,335869
18227,3.4e-05,74.125.68.0-255,1484,1703,64,335869
18228,3.8e-05,172.31.40.0-255,66,1769,64,335869
18229,4.4e-05,74.125.68.0-255,2902,4671,64,335869
18230,4.8e-05,172.31.40.0-255,66,4737,64,335869
18231,5.9e-05,74.125.68.0-255,1484,6221,64,335869
18232,6.2e-05,172.31.40.0-255,66,6287,64,335869
18233,6.8e-05,74.125.68.0-255,2902,9189,64,335869
18234,7.1e-05,172.31.40.0-255,66,9255,64,335869
18235,0.000106,74.125.68.0-255,6195,15450,64,335869
18236,0.000109,172.31.40.0-255,66,15516,64,335869
18237,0.000112,74.125.68.0-255,1484,17000,64,335869
18238,0.000115,172.31.40.0-255,66,17066,64,335869
18239,0.000158,74.125.68.0-255,5738,22804,64,335869
18240,0.000161,172.31.40.0-255,66,22870,64,335869
18241,0.000172,172.31.40.0-255,66,22936,64,335869
18242,0.000329,74.125.68.0-255,1484,24420,64,335869
18243,0.000334,172.31.40.0-255,66,24486,64,335869
18244,0.000361,74.125.68.0-255,1484,25970,64,335869
18245,0.000363,172.31.40.0-255,66,26036,64,335869
18246,0.000369,74.125.68.0-255,2902,28938,64,335869
18247,0.000371,172.31.40.0-255,66,29004,64,335869
18248,0.000405,74.125.68.0-255,5738,34742,64,335869
18249,0.000409,172.31.40.0-255,66,34808,64,335869
18250,0.00046,74.125.68.0-255,2902,37710,64,335869
18251,0.000463,172.31.40.0-255,66,37776,64,335869
18252,0.000498,74.125.68.0-255,3961,41737,64,335869
18253,0.000501,172.31.40.0-255,66,41803,64,335869
18254,0.000509,74.125.68.0-255,7156,48959,64,335869
18255,0.000512,172.31.40.0-255,66,49025,64,335869
18256,0.00052,74.125.68.0-255,2902,51927,64,335869
18257,0.000522,172.31.40.0-255,66,51993,64,335869
18258,0.000528,74.125.68.0-255,4320,56313,64,335869
18259,0.00053,172.31.40.0-255,66,56379,64,335869
18260,0.000553,74.125.68.0-255,1400,57779,64,335869
18261,0.000608,74.125.68.0-255,130,57909,64,335869
18262,0.000721,74.125.68.0-255,1484,59393,64,335869
18263,0.000726,172.31.40.0-255,66,59459,64,335869
18264,0.000754,74.125.68.0-255,2902,62361,64,335869
18265,0.000757,172.31.40.0-255,66,62427,64,335869
18266,0.000763,74.125.68.0-255,4320,66747,64,335869
18267,0.000766,172.31.40.0-255,66,66813,64,335869
18268,0.000807,74.125.68.0-255,1484,68297,64,335869
18269,0.000815,74.125.68.0-255,7156,75453,64,335869
18270,0.000818,172.31.40.0-255,66,75519,64,335869
18271,0.000823,74.125.68.0-255,2902,78421,64,335869
18272,0.000825,172.31.40.0-255,66,78487,64,335869
18273,0.00086,74.125.68.0-255,7156,85643,64,335869
18274,0.000864,172.31.40.0-255,66,85709,64,335869
18275,0.00087,74.125.68.0-255,5738,91447,64,335869
18276,0.000872,172.31.40.0-255,66,91513,64,335869
18277,0.000902,74.125.68.0-255,766,92279,64,335869
18278,0.000951,74.125.68.0-255,1484,93763,64,335869
18279,0.000955,172.31.40.0-255,66,93829,64,335869
18280,0.000961,74.125.68.0-255,2902,96731,64,335869
18281,0.000964,172.31.40.0-255,66,96797,64,335869
18282,0.000997,74.125.68.0-255,5738,102535,64,335869
18283,0.001,172.31.40.0-255,66,102601,64,335869
18284,0.00103,74.125.68.0-255,7156,109757,64,335869
18285,0.001032,172.31.40.0-255,66,109823,64,335869
18286,0.001061,74.125.68.0-255,4320,114143,64,335869
18287,0.001063,172.31.40.0-255,66,114209,64,335869
18288,0.001076,172.31.40.0-255,66,114275,64,335869
18289,0.001107,74.125.68.0-255,2184,116459,64,335869
18290,0.00111,172.31.40.0-255,66,116525,64,335869
18291,0.001199,74.125.68.0-255,1484,118009,64,335869
18292,0.001219,74.125.68.0-255,2902,120911,64,335869
18293,0.001222,172.31.40.0-255,66,120977,64,335869
18294,0.00125,74.125.68.0-255,5738,126715,64,335869
18295,0.001253,172.31.40.0-255,66,126781,64,335869
18296,0.001258,74.125.68.0-255,2902,129683,64,335869
18297,0.00126,172.31.40.0-255,66,129749,64,335869
18298,0.00129,74.125.68.0-255,4320,134069,64,335869
18299,0.001293,172.31.40.0-255,66,134135,64,335869
18300,0.001318,74.125.68.0-255,2902,137037,64,335869
18301,0.001321,172.31.40.0-255,66,137103,64,335869
18302,0.001352,74.125.68.0-255,4320,141423,64,335869
18303,0.001355,172.31.40.0-255,66,141489,64,335869
18304,0.001358,74.125.68.0-255,1484,142973,64,335869
18305,0.001385,74.125.68.0-255,5738,148711,64,335869
18306,0.001388,172.31.40.0-255,66,148777,64,335869
18307,0.001417,74.125.68.0-255,2184,150961,64,335869
18308,0.001419,172.31.40.0-255,66,151027,64,335869
18309,0.001486,74.125.68.0-255,1484,152511,64,335869
18310,0.001505,74.125.68.0-255,2902,155413,64,335869
18311,0.001508,172.31.40.0-255,66,155479,64,335869
18312,0.001511,74.125.68.0-255,1484,156963,64,335869
18313,0.001539,74.125.68.0-255,2902,159865,64,335869
18314,0.001542,172.31.40.0-255,66,159931,64,335869
18315,0.001548,74.125.68.0-255,4320,164251,64,335869
18316,0.00155,172.31.40.0-255,66,164317,64,335869
18317,0.001586,74.125.68.0-255,1484,165801,64,335869
18318,0.001595,74.125.68.0-255,7156,172957,64,335869
18319,0.001598,172.31.40.0-255,66,173023,64,335869
18320,0.001604,74.125.68.0-255,4320,177343,64,335869
18321,0.001609,172.31.40.0-255,66,177409,64,335869
18322,0.001623,74.125.68.0-255,4320,181729,64,335869
18323,0.001633,172.31.40.0-255,66,181795,64,335869
18324,0.001662,74.125.68.0-255,3602,185397,64,335869
18325,0.001665,172.31.40.0-255,66,185463,64,335869
18326,0.001691,74.125.68.0-255,4320,189783,64,335869
18327,0.001694,172.31.40.0-255,66,189849,64,335869
18328,0.001737,172.31.40.0-255,66,189915,64,335869
18329,0.001778,172.31.40.0-255,66,189981,64,335869
18330,0.00184,74.125.68.0-255,7156,197137,64,335869
18331,0.001843,172.31.40.0-255,66,197203,64,335869
18332,0.00187,74.125.68.0-255,3602,200805,64,335869
18333,0.001873,172.31.40.0-255,66,200871,64,335869
18334,0.001897,74.125.68.0-255,1484,202355,64,335869
18335,0.001928,172.31.40.0-255,66,202421,64,335869
18336,0.001955,74.125.68.0-255,3662,206083,64,335869
18337,0.001964,172.31.40.0-255,66,206149,64,335869
18338,0.00199,74.125.68.0-255,2902,209051,64,335869
18339,0.001992,172.31.40.0-255,66,209117,64,335869
18340,0.002035,172.31.40.0-255,66,209183,64,335869
18341,0.002089,74.125.68.0-255,4320,213503,64,335869
18342,0.002093,172.31.40.0-255,66,213569,64,335869
18343,0.002106,74.125.68.0-255,1484,215053,64,335869
18344,0.002115,74.125.68.0-255,2902,217955,64,335869
18345,0.002118,172.31.40.0-255,66,218021,64,335869
18346,0.00215,74.125.68.0-255,6438,224459,64,335869
18347,0.002156,172.31.40.0-255,66,224525,64,335869
18348,0.002166,74.125.68.0-255,4320,228845,64,335869
18349,0.002169,172.31.40.0-255,66,228911,64,335869
18350,0.0022,172.31.40.0-255,66,228977,64,335869
18351,0.002279,74.125.68.0-255,2902,231879,64,335869
18352,0.002284,172.31.40.0-255,66,231945,64,335869
18353,0.002303,74.125.68.0-255,2902,234847,64,335869
18354,0.002306,172.31.40.0-255,66,234913,64,335869
18355,0.002319,172.31.40.0-255,66,234979,64,335869
18356,0.002401,74.125.68.0-255,4320,239299,64,335869
18357,0.002404,172.31.40.0-255,66,239365,64,335869
18358,0.004614,74.125.68.0-255,1484,240849,64,335869
18359,0.0047,74.125.68.0-255,4320,245169,64,335869
18360,0.004706,172.31.40.0-255,66,245235,64,335869
18361,0.007019,74.125.68.0-255,5738,250973,64,335869
18362,0.007031,172.31.40.0-255,66,251039,64,335869
18363,0.009356,74.125.68.0-255,5738,256777,64,335869
18364,0.009377,172.31.40.0-255,66,256843,64,335869
18365,0.011684,74.125.68.0-255,5738,262581,64,335869
18366,0.011693,172.31.40.0-255,66,262647,64,335869
18367,0.014005,74.125.68.0-255,5738,268385,64,335869
18368,0.014022,172.31.40.0-255,66,268451,64,335869
18369,0.016322,74.125.68.0-255,5738,274189,64,335869
18370,0.016329,172.31.40.0-255,66,274255,64,335869
18371,0.016596,172.31.40.0-255,101,274356,64,335869
18372,0.018633,74.125.68.0-255,5738,280094,64,335869
18373,0.018648,172.31.40.0-255,66,280160,64,335869
18374,0.01885,74.125.68.0-255,66,280226,64,335869
18375,0.020963,74.125.68.0-255,5738,285964,64,335869
18376,0.020976,172.31.40.0-255,66,286030,64,335869
18377,0.023285,74.125.68.0-255,5738,291768,64,335869
18378,0.023295,172.31.40.0-255,66,291834,64,335869
18379,0.025595,74.125.68.0-255,5738,297572,64,335869
18380,0.025603,172.31.40.0-255,66,297638,64,335869
18381,0.027908,74.125.68.0-255,5738,303376,64,335869
18382,0.027919,172.31.40.0-255,66,303442,64,335869
18383,0.030235,74.125.68.0-255,5738,309180,64,335869
18384,0.03025,172.31.40.0-255,66,309246,64,335869
18385,0.032544,74.125.68.0-255,5738,314984,64,335869
18386,0.032552,172.31.40.0-255,66,315050,64,335869
18387,0.034858,74.125.68.0-255,5738,320788,64,335869
18388,0.034867,172.31.40.0-255,66,320854,64,335869
18389,0.037203,74.125.68.0-255,4320,325174,64,335869
18390,0.03721,172.31.40.0-255,66,325240,64,335869
18391,0.037236,74.125.68.0-255,1484,326724,64,335869
18392,0.039536,74.125.68.0-255,3641,330365,64,335869
18393,0.039552,172.31.40.0-255,66,330431,64,335869
18394,0.03982,172.31.40.0-255,105,330536,64,335869
18395,0.046243,74.125.68.0-255,66,330602,64,335869
18396,0.050051,172.31.40.0-255,167,330769,64,335869
18397,0.050085,172.31.40.0-255,1111,331880,64,335869
18398,0.050147,172.31.40.0-255,1514,333394,64,335869
18399,0.050149,172.31.40.0-255,1514,334908,64,335869
18400,0.05015,172.31.40.0-255,697,335605,64,335869
18401,0.051596,104.244.42.0-255,66,335671,64,335869
18402,0.051663,104.244.42.0-255,66,335737,64,335869
18403,0.051752,104.244.42.0-255,66,335803,64,335869
18404,0.051756,104.244.42.0-255,66,335869,64,335869
18405,0.0,74.125.24.0-255,152,152,64,293039
18406,2.2e-05,172.31.40.0-255,66,218,64,293039
18407,2.9e-05,74.125.24.0-255,1484,1702,64,293039
18408,3.4e-05,172.31.40.0-255,66,1768,64,293039
18409,3.9e-05,74.125.24.0-255,2902,4670,64,293039
18410,5e-05,172.31.40.0-255,66,4736,64,293039
18411,5.7e-05,74.125.24.0-255,7156,11892,64,293039
18412,6.1e-05,172.31.40.0-255,66,11958,64,293039
18413,6.8e-05,74.125.24.0-255,5738,17696,64,293039
18414,7.1e-05,172.31.40.0-255,66,17762,64,293039
18415,0.000102,74.125.24.0-255,6271,24033,64,293039
18416,0.000105,172.31.40.0-255,66,24099,64,293039
18417,0.000112,74.125.24.0-255,6797,30896,64,293039
18418,0.000114,172.31.40.0-255,66,30962,64,293039
18419,0.000259,74.125.24.0-255,1484,32446,64,293039
18420,0.000265,172.31.40.0-255,66,32512,64,293039
18421,0.00027,74.125.24.0-255,2902,35414,64,293039
18422,0.000273,172.31.40.0-255,66,35480,64,293039
18423,0.000278,74.125.24.0-255,5738,41218,64,293039
18424,0.000286,172.31.40.0-255,66,41284,64,293039
18425,0.000346,74.125.24.0-255,6797,48081,64,293039
18426,0.00035,172.31.40.0-255,66,48147,64,293039
18427,0.000416,74.125.24.0-255,4320,52467,64,293039
18428,0.000419,172.31.40.0-255,66,52533,64,293039
18429,0.000447,74.125.24.0-255,2902,55435,64,293039
18430,0.00045,172.31.40.0-255,66,55501,64,293039
18431,0.00046,172.31.40.0-255,66,55567,64,293039
18432,0.000488,74.125.24.0-255,1424,56991,64,293039
18433,0.00049,172.31.40.0-255,66,57057,64,293039
18434,0.000516,74.125.24.0-255,409,57466,64,293039
18435,0.000518,172.31.40.0-255,66,57532,64,293039
18436,0.000627,74.125.24.0-255,1484,59016,64,293039
18437,0.000633,74.125.24.0-255,2902,61918,64,293039
18438,0.000637,172.31.40.0-255,66,61984,64,293039
18439,0.000643,74.125.24.0-255,5738,67722,64,293039
18440,0.000646,172.31.40.0-255,66,67788,64,293039
18441,0.000734,74.125.24.0-255,5738,73526,64,293039
18442,0.000738,172.31.40.0-255,66,73592,64,293039
18443,0.000765,74.125.24.0-255,7156,80748,64,293039
18444,0.000768,172.31.40.0-255,66,80814,64,293039
18445,0.000774,74.125.24.0-255,7156,87970,64,293039
18446,0.000776,172.31.40.0-255,66,88036,64,293039
18447,0.000784,74.125.24.0-255,3602,91638,64,293039
18448,0.000787,172.31.40.0-255,66,91704,64,293039
18449,0.001609,74.125.24.0-255,1484,93188,64,293039
18450,0.00162,74.125.24.0-255,2902,96090,64,293039
18451,0.001625,172.31.40.0-255,66,96156,64,293039
18452,0.001632,74.125.24.0-255,5738,101894,64,293039
18453,0.001635,172.31.40.0-255,66,101960,64,293039
18454,0.001638,74.125.24.0-255,1484,103444,64,293039
18455,0.001675,172.31.40.0-255,66,103510,64,293039
18456,0.001685,172.31.40.0-255,66,103576,64,293039
18457,0.001706,74.125.24.0-255,766,104342,64,293039
18458,0.001744,74.125.24.0-255,1484,105826,64,293039
18459,0.001748,172.31.40.0-255,66,105892,64,293039
18460,0.001774,74.125.24.0-255,2902,108794,64,293039
18461,0.001777,172.31.40.0-255,66,108860,64,293039
18462,0.001783,74.125.24.0-255,5738,114598,64,293039
18463,0.001785,172.31.40.0-255,66,114664,64,293039
18464,0.001818,172.31.40.0-255,66,114730,64,293039
18465,0.001863,74.125.24.0-255,7156,121886,64,293039
18466,0.001866,172.31.40.0-255,66,121952,64,293039
18467,0.001895,74.125.24.0-255,5020,126972,64,293039
18468,0.001898,172.31.40.0-255,66,127038,64,293039
18469,0.001919,74.125.24.0-255,1484,128522,64,293039
18470,0.001923,74.125.24.0-255,2902,131424,64,293039
18471,0.001925,172.31.40.0-255,66,131490,64,293039
18472,0.001929,74.125.24.0-255,1484,132974,64,293039
18473,0.001956,74.125.24.0-255,4320,137294,64,293039
18474,0.001958,172.31.40.0-255,66,137360,64,293039
18475,0.001968,172.31.40.0-255,66,137426,64,293039
18476,0.002017,74.125.24.0-255,4320,141746,64,293039
18477,0.00202,172.31.40.0-255,66,141812,64,293039
18478,0.002057,172.31.40.0-255,66,141878,64,293039
18479,0.004344,74.125.24.0-255,5738,147616,64,293039
18480,0.004352,172.31.40.0-255,66,147682,64,293039
18481,0.006644,74.125.24.0-255,5738,153420,64,293039
18482,0.00665,172.31.40.0-255,66,153486,64,293039
18483,0.008964,74.125.24.0-255,5738,159224,64,293039
18484,0.008969,172.31.40.0-255,66,159290,64,293039
18485,0.011263,74.125.24.0-255,5738,165028,64,293039
18486,0.011271,172.31.40.0-255,66,165094,64,293039
18487,0.013566,74.125.24.0-255,5738,170832,64,293039
18488,0.013575,172.31.40.0-255,66,170898,64,293039
18489,0.015862,74.125.24.0-255,5738,176636,64,293039
18490,0.015872,172.31.40.0-255,66,176702,64,293039
18491,0.018148,74.125.24.0-255,5738,182440,64,293039
18492,0.018157,172.31.40.0-255,66,182506,64,293039
18493,0.020446,74.125.24.0-255,5738,188244,64,293039
18494,0.020454,172.31.40.0-255,66,188310,64,293039
18495,0.022754,74.125.24.0-255,5738,194048,64,293039
18496,0.022761,172.31.40.0-255,66,194114,64,293039
18497,0.025061,74.125.24.0-255,5738,199852,64,293039
18498,0.025069,172.31.40.0-255,66,199918,64,293039
18499,0.027406,74.125.24.0-255,5738,205656,64,293039
18500,0.027414,172.31.40.0-255,66,205722,64,293039
18501,0.02969,74.125.24.0-255,2902,208624,64,293039
18502,0.029696,172.31.40.0-255,66,208690,64,293039
18503,0.029733,74.125.24.0-255,2902,211592,64,293039
18504,0.029736,172.31.40.0-255,66,211658,64,293039
18505,0.030997,172.31.40.0-255,172,211830,64,293039
18506,0.031029,172.31.40.0-255,1111,212941,64,293039
18507,0.031089,172.31.40.0-255,1514,214455,64,293039
18508,0.031091,172.31.40.0-255,1514,215969,64,293039
18509,0.031092,172.31.40.0-255,694,216663,64,293039
18510,0.031972,74.125.24.0-255,2902,219565,64,293039
18511,0.031978,172.31.40.0-255,66,219631,64,293039
18512,0.032018,74.125.24.0-255,2902,222533,64,293039
18513,0.032021,172.31.40.0-255,66,222599,64,293039
18514,0.032542,104.244.42.0-255,66,222665,64,293039
18515,0.032585,104.244.42.0-255,66,222731,64,293039
18516,0.032634,104.244.42.0-255,66,222797,64,293039
18517,0.032651,104.244.42.0-255,66,222863,64,293039
18518,0.034268,74.125.24.0-255,2902,225765,64,293039
18519,0.034273,172.31.40.0-255,66,225831,64,293039
18520,0.034308,74.125.24.0-255,2902,228733,64,293039
18521,0.034311,172.31.40.0-255,66,228799,64,293039
18522,0.036567,74.125.24.0-255,2902,231701,64,293039
18523,0.036572,172.31.40.0-255,66,231767,64,293039
18524,0.0366,74.125.24.0-255,2902,234669,64,293039
18525,0.036603,172.31.40.0-255,66,234735,64,293039
18526,0.03885,74.125.24.0-255,2902,237637,64,293039
18527,0.038857,172.31.40.0-255,66,237703,64,293039
18528,0.038888,74.125.24.0-255,2902,240605,64,293039
18529,0.03889,172.31.40.0-255,66,240671,64,293039
18530,0.041139,74.125.24.0-255,2902,243573,64,293039
18531,0.041148,172.31.40.0-255,66,243639,64,293039
18532,0.04118,74.125.24.0-255,2902,246541,64,293039
18533,0.041184,172.31.40.0-255,66,246607,64,293039
18534,0.04346,74.125.24.0-255,5738,252345,64,293039
18535,0.043466,172.31.40.0-255,66,252411,64,293039
18536,0.045756,74.125.24.0-255,5738,258149,64,293039
18537,0.045763,172.31.40.0-255,66,258215,64,293039
18538,0.048056,74.125.24.0-255,5738,263953,64,293039
18539,0.048062,172.31.40.0-255,66,264019,64,293039
18540,0.050369,74.125.24.0-255,5738,269757,64,293039
18541,0.050374,172.31.40.0-255,66,269823,64,293039
18542,0.052662,74.125.24.0-255,5738,275561,64,293039
18543,0.05267,172.31.40.0-255,66,275627,64,293039
18544,0.054974,74.125.24.0-255,5738,281365,64,293039
18545,0.054979,172.31.40.0-255,66,281431,64,293039
18546,0.057275,74.125.24.0-255,5738,287169,64,293039
18547,0.057282,172.31.40.0-255,66,287235,64,293039
18548,0.059581,74.125.24.0-255,5738,292973,64,293039
18549,0.059587,172.31.40.0-255,66,293039,64,293039
18550,0.0,74.125.130.0-255,146,146,64,256287
18551,2.3e-05,172.31.40.0-255,66,212,64,256287
18552,3.1e-05,74.125.130.0-255,1484,1696,64,256287
18553,3.5e-05,172.31.40.0-255,66,1762,64,256287
18554,3.8e-05,74.125.130.0-255,1484,3246,64,256287
18555,4e-05,172.31.40.0-255,66,3312,64,256287
18556,6.6e-05,74.125.130.0-255,2902,6214,64,256287
18557,6.9e-05,172.31.40.0-255,66,6280,64,256287
18558,9.3e-05,74.125.130.0-255,5738,12018,64,256287
18559,9.6e-05,172.31.40.0-255,66,12084,64,256287
18560,0.000148,74.125.130.0-255,2039,14123,64,256287
18561,0.000151,172.31.40.0-255,66,14189,64,256287
18562,0.000318,74.125.130.0-255,1484,15673,64,256287
18563,0.000322,172.31.40.0-255,66,15739,64,256287
18564,0.000335,74.125.130.0-255,2902,18641,64,256287
18565,0.000338,172.31.40.0-255,66,18707,64,256287
18566,0.000341,74.125.130.0-255,1484,20191,64,256287
18567,0.000344,172.31.40.0-255,66,20257,64,256287
18568,0.000368,74.125.130.0-255,2902,23159,64,256287
18569,0.000371,172.31.40.0-255,66,23225,64,256287
18570,0.00039,74.125.130.0-255,2902,26127,64,256287
18571,0.000393,172.31.40.0-255,66,26193,64,256287
18572,0.000412,74.125.130.0-255,2902,29095,64,256287
18573,0.000414,172.31.40.0-255,66,29161,64,256287
18574,0.000419,74.125.130.0-255,2543,31704,64,256287
18575,0.000421,172.31.40.0-255,66,31770,64,256287
18576,0.000455,74.125.130.0-255,2902,34672,64,256287
18577,0.000457,172.31.40.0-255,66,34738,64,256287
18578,0.000484,74.125.130.0-255,4320,39058,64,256287
18579,0.000486,172.31.40.0-255,66,39124,64,256287
18580,0.0005,74.125.130.0-255,2902,42026,64,256287
18581,0.000502,172.31.40.0-255,66,42092,64,256287
18582,0.00052,74.125.130.0-255,2902,44994,64,256287
18583,0.000522,172.31.40.0-255,66,45060,64,256287
18584,0.000563,74.125.130.0-255,3961,49021,64,256287
18585,0.000566,172.31.40.0-255,66,49087,64,256287
18586,0.001255,74.125.130.0-255,1484,50571,64,256287
18587,0.00126,172.31.40.0-255,66,50637,64,256287
18588,0.001268,74.125.130.0-255,2902,53539,64,256287
18589,0.00127,172.31.40.0-255,66,53605,64,256287
18590,0.001296,74.125.130.0-255,4320,57925,64,256287
18591,0.001298,172.31.40.0-255,66,57991,64,256287
18592,0.001307,74.125.130.0-255,1484,59475,64,256287
18593,0.001309,172.31.40.0-255,66,59541,64,256287
18594,0.001313,74.125.130.0-255,2902,62443,64,256287
18595,0.001314,172.31.40.0-255,66,62509,64,256287
18596,0.001342,74.125.130.0-255,3961,66470,64,256287
18597,0.001344,172.31.40.0-255,66,66536,64,256287
18598,0.00136,74.125.130.0-255,1484,68020,64,256287
18599,0.001362,172.31.40.0-255,66,68086,64,256287
18600,0.001381,74.125.130.0-255,2902,70988,64,256287
18601,0.001383,172.31.40.0-255,66,71054,64,256287
18602,0.001397,74.125.130.0-255,1484,72538,64,256287
18603,0.001399,172.31.40.0-255,66,72604,64,256287
18604,0.001414,74.125.130.0-255,4320,76924,64,256287
18605,0.001416,172.31.40.0-255,66,76990,64,256287
18606,0.001419,74.125.130.0-255,1484,78474,64,256287
18607,0.001421,172.31.40.0-255,66,78540,64,256287
18608,0.001443,74.125.130.0-255,2902,81442,64,256287
18609,0.001445,172.31.40.0-255,66,81508,64,256287
18610,0.001462,74.125.130.0-255,1484,82992,64,256287
18611,0.001464,172.31.40.0-255,66,83058,64,256287
18612,0.001484,74.125.130.0-255,1704,84762,64,256287
18613,0.001486,172.31.40.0-255,66,84828,64,256287
18614,0.001552,74.125.130.0-255,1484,86312,64,256287
18615,0.001555,172.31.40.0-255,66,86378,64,256287
18616,0.00157,74.125.130.0-255,1484,87862,64,256287
18617,0.001573,172.31.40.0-255,66,87928,64,256287
18618,0.00159,74.125.130.0-255,1484,89412,64,256287
18619,0.001592,172.31.40.0-255,66,89478,64,256287
18620,0.001597,74.125.130.0-255,2902,92380,64,256287
18621,0.001599,172.31.40.0-255,66,92446,64,256287
18622,0.001622,74.125.130.0-255,2902,95348,64,256287
18623,0.001624,172.31.40.0-255,66,95414,64,256287
18624,0.001628,74.125.130.0-255,2902,98316,64,256287
18625,0.00163,172.31.40.0-255,66,98382,64,256287
18626,0.001663,74.125.130.0-255,3961,102343,64,256287
18627,0.001666,172.31.40.0-255,66,102409,64,256287
18628,0.001724,74.125.130.0-255,1484,103893,64,256287
18629,0.001728,172.31.40.0-255,66,103959,64,256287
18630,0.001731,74.125.130.0-255,1484,105443,64,256287
18631,0.001733,172.31.40.0-255,66,105509,64,256287
18632,0.001745,74.125.130.0-255,1484,106993,64,256287
18633,0.001747,172.31.40.0-255,66,107059,64,256287
18634,0.001769,74.125.130.0-255,4320,111379,64,256287
18635,0.001772,172.31.40.0-255,66,111445,64,256287
18636,0.001788,74.125.130.0-255,1484,112929,64,256287
18637,0.00179,172.31.40.0-255,66,112995,64,256287
18638,0.001793,74.125.130.0-255,1484,114479,64,256287
18639,0.001794,172.31.40.0-255,66,114545,64,256287
18640,0.001809,74.125.130.0-255,4320,118865,64,256287
18641,0.001825,74.125.130.0-255,462,119327,64,256287
18642,0.002221,74.125.130.0-255,198,119525,64,256287
18643,0.006794,172.31.40.0-255,66,119591,64,256287
18644,0.00904,74.125.130.0-255,2902,122493,64,256287
18645,0.009051,172.31.40.0-255,66,122559,64,256287
18646,0.009074,74.125.130.0-255,2902,125461,64,256287
18647,0.009077,172.31.40.0-255,66,125527,64,256287
18648,0.01129,74.125.130.0-255,2902,128429,64,256287
18649,0.011297,172.31.40.0-255,66,128495,64,256287
18650,0.011319,74.125.130.0-255,2902,131397,64,256287
18651,0.011322,172.31.40.0-255,66,131463,64,256287
18652,0.013561,74.125.130.0-255,5738,137201,64,256287
18653,0.013569,172.31.40.0-255,66,137267,64,256287
18654,0.015818,74.125.130.0-255,5738,143005,64,256287
18655,0.015826,172.31.40.0-255,66,143071,64,256287
18656,0.018083,74.125.130.0-255,5738,148809,64,256287
18657,0.018091,172.31.40.0-255,66,148875,64,256287
18658,0.020349,74.125.130.0-255,5738,154613,64,256287
18659,0.020358,172.31.40.0-255,66,154679,64,256287
18660,0.022625,74.125.130.0-255,5738,160417,64,256287
18661,0.022634,172.31.40.0-255,66,160483,64,256287
18662,0.024882,74.125.130.0-255,5738,166221,64,256287
18663,0.024889,172.31.40.0-255,66,166287,64,256287
18664,0.027163,74.125.130.0-255,5738,172025,64,256287
18665,0.027171,172.31.40.0-255,66,172091,64,256287
18666,0.029418,74.125.130.0-255,5738,177829,64,256287
18667,0.029428,172.31.40.0-255,66,177895,64,256287
18668,0.031677,74.125.130.0-255,5738,183633,64,256287
18669,0.031684,172.31.40.0-255,66,183699,64,256287
18670,0.033932,74.125.130.0-255,5738,189437,64,256287
18671,0.03394,172.31.40.0-255,66,189503,64,256287
18672,0.036183,74.125.130.0-255,5738,195241,64,256287
18673,0.03619,172.31.40.0-255,66,195307,64,256287
18674,0.038438,74.125.130.0-255,5738,201045,64,256287
18675,0.038445,172.31.40.0-255,66,201111,64,256287
18676,0.038714,172.31.40.0-255,172,201283,64,256287
18677,0.038859,172.31.40.0-255,1112,202395,64,256287
18678,0.038923,172.31.40.0-255,1514,203909,64,256287
18679,0.038924,172.31.40.0-255,1296,205205,64,256287
18680,0.040276,104.244.42.0-255,66,205271,64,256287
18681,0.040409,104.244.42.0-255,66,205337,64,256287
18682,0.040452,104.244.42.0-255,66,205403,64,256287
18683,0.040687,74.125.130.0-255,5738,211141,64,256287
18684,0.040693,172.31.40.0-255,66,211207,64,256287
18685,0.042953,74.125.130.0-255,5738,216945,64,256287
18686,0.042966,172.31.40.0-255,66,217011,64,256287
18687,0.045222,74.125.130.0-255,5738,222749,64,256287
18688,0.045228,172.31.40.0-255,66,222815,64,256287
18689,0.047487,74.125.130.0-255,5738,228553,64,256287
18690,0.047494,172.31.40.0-255,66,228619,64,256287
18691,0.049731,74.125.130.0-255,5738,234357,64,256287
18692,0.049736,172.31.40.0-255,66,234423,64,256287
18693,0.05199,74.125.130.0-255,5738,240161,64,256287
18694,0.051997,172.31.40.0-255,66,240227,64,256287
18695,0.054243,74.125.130.0-255,5738,245965,64,256287
18696,0.05425,172.31.40.0-255,66,246031,64,256287
18697,0.056526,74.125.130.0-255,4320,250351,64,256287
18698,0.056533,172.31.40.0-255,66,250417,64,256287
18699,0.056554,74.125.130.0-255,1484,251901,64,256287
18700,0.058803,74.125.130.0-255,4320,256221,64,256287
18701,0.058814,172.31.40.0-255,66,256287,64,256287
18702,0.0,172.31.40.0-255,105,105,64,459
18703,0.000151,172.31.40.0-255,90,195,64,459
18704,0.00016,172.31.40.0-255,66,261,64,459
18705,0.002168,172.217.194.0-255,66,327,64,459
18706,0.002196,172.217.194.0-255,66,393,64,459
18707,0.002218,172.31.40.0-255,66,459,64,459
18708,0.0,172.217.194.0-255,152,152,64,150827
18709,2.2e-05,172.31.40.0-255,66,218,64,150827
18710,2.8e-05,172.217.194.0-255,1484,1702,64,150827
18711,3.2e-05,172.31.40.0-255,66,1768,64,150827
18712,3.8e-05,172.217.194.0-255,2902,4670,64,150827
18713,4.9e-05,172.31.40.0-255,66,4736,64,150827
18714,5.5e-05,172.217.194.0-255,5738,10474,64,150827
18715,5.7e-05,172.31.40.0-255,66,10540,64,150827
18716,0.000101,172.31.40.0-255,66,10606,64,150827
18717,0.000108,172.217.194.0-255,6797,17403,64,150827
18718,0.00011,172.31.40.0-255,66,17469,64,150827
18719,0.000155,172.217.194.0-255,1484,18953,64,150827
18720,0.000157,172.31.40.0-255,66,19019,64,150827
18721,0.000161,172.217.194.0-255,2902,21921,64,150827
18722,0.000163,172.31.40.0-255,66,21987,64,150827
18723,0.000169,172.217.194.0-255,5738,27725,64,150827
18724,0.000175,172.31.40.0-255,66,27791,64,150827
18725,0.00018,172.217.194.0-255,4320,32111,64,150827
18726,0.000182,172.31.40.0-255,66,32177,64,150827
18727,0.000219,172.31.40.0-255,66,32243,64,150827
18728,0.000247,172.31.40.0-255,66,32309,64,150827
18729,0.000273,172.217.194.0-255,679,32988,64,150827
18730,0.000275,172.31.40.0-255,66,33054,64,150827
18731,0.000304,172.217.194.0-255,1484,34538,64,150827
18732,0.000306,172.31.40.0-255,66,34604,64,150827
18733,0.00031,172.217.194.0-255,1484,36088,64,150827
18734,0.000312,172.31.40.0-255,66,36154,64,150827
18735,0.000345,172.217.194.0-255,2902,39056,64,150827
18736,0.000348,172.31.40.0-255,66,39122,64,150827
18737,0.00036,172.217.194.0-255,5738,44860,64,150827
18738,0.000362,172.31.40.0-255,66,44926,64,150827
18739,0.000369,172.217.194.0-255,7156,52082,64,150827
18740,0.000371,172.31.40.0-255,66,52148,64,150827
18741,0.000423,172.31.40.0-255,66,52214,64,150827
18742,0.000427,172.217.194.0-255,1633,53847,64,150827
18743,0.000431,172.31.40.0-255,66,53913,64,150827
18744,0.00046,172.217.194.0-255,2902,56815,64,150827
18745,0.000462,172.31.40.0-255,66,56881,64,150827
18746,0.00047,172.217.194.0-255,7156,64037,64,150827
18747,0.000472,172.31.40.0-255,66,64103,64,150827
18748,0.000482,172.217.194.0-255,4320,68423,64,150827
18749,0.000484,172.31.40.0-255,66,68489,64,150827
18750,0.000515,172.31.40.0-255,66,68555,64,150827
18751,0.000547,172.217.194.0-255,7156,75711,64,150827
18752,0.00055,172.31.40.0-255,66,75777,64,150827
18753,0.000569,172.217.194.0-255,3602,79379,64,150827
18754,0.000572,172.31.40.0-255,66,79445,64,150827
18755,0.000687,172.217.194.0-255,1484,80929,64,150827
18756,0.000694,172.217.194.0-255,2902,83831,64,150827
18757,0.000697,172.31.40.0-255,66,83897,64,150827
18758,0.000715,172.217.194.0-255,4320,88217,64,150827
18759,0.000722,172.31.40.0-255,66,88283,64,150827
18760,0.000739,172.217.194.0-255,1484,89767,64,150827
18761,0.000759,172.31.40.0-255,66,89833,64,150827
18762,0.000788,172.217.194.0-255,5738,95571,64,150827
18763,0.000791,172.31.40.0-255,66,95637,64,150827
18764,0.000824,172.31.40.0-255,66,95703,64,150827
18765,0.000941,172.217.194.0-255,1484,97187,64,150827
18766,0.000947,172.217.194.0-255,2902,100089,64,150827
18767,0.000951,172.31.40.0-255,66,100155,64,150827
18768,0.000957,172.217.194.0-255,2902,103057,64,150827
18769,0.000959,172.31.40.0-255,66,103123,64,150827
18770,0.000991,172.217.194.0-255,2902,106025,64,150827
18771,0.000993,172.31.40.0-255,66,106091,64,150827
18772,0.001,172.217.194.0-255,5738,111829,64,150827
18773,0.001003,172.31.40.0-255,66,111895,64,150827
18774,0.001017,172.217.194.0-255,7156,119051,64,150827
18775,0.001019,172.31.40.0-255,66,119117,64,150827
18776,0.001081,172.31.40.0-255,66,119183,64,150827
18777,0.001187,172.217.194.0-255,1484,120667,64,150827
18778,0.001204,172.217.194.0-255,2902,123569,64,150827
18779,0.001207,172.31.40.0-255,66,123635,64,150827
18780,0.001214,172.217.194.0-255,5738,129373,64,150827
18781,0.001217,172.31.40.0-255,66,129439,64,150827
18782,0.001283,172.217.194.0-255,4320,133759,64,150827
18783,0.001286,172.31.40.0-255,66,133825,64,150827
18784,0.001324,172.31.40.0-255,66,133891,64,150827
18785,0.001337,172.31.40.0-255,66,133957,64,150827
18786,0.001355,172.31.40.0-255,66,134023,64,150827
18787,0.001382,172.31.40.0-255,66,134089,64,150827
18788,0.001403,172.31.40.0-255,66,134155,64,150827
18789,0.001451,172.31.40.0-255,66,134221,64,150827
18790,0.001465,172.31.40.0-255,66,134287,64,150827
18791,0.001582,172.217.194.0-255,4320,138607,64,150827
18792,0.001734,172.217.194.0-255,2902,141509,64,150827
18793,0.00174,172.217.194.0-255,3602,145111,64,150827
18794,0.001751,172.217.194.0-255,105,145216,64,150827
18795,0.00187,172.31.40.0-255,66,145282,64,150827
18796,0.010673,172.31.40.0-255,105,145387,64,150827
18797,0.013265,172.217.194.0-255,66,145453,64,150827
18798,0.032504,172.31.40.0-255,167,145620,64,150827
18799,0.032531,172.31.40.0-255,1111,146731,64,150827
18800,0.032588,172.31.40.0-255,1514,148245,64,150827
18801,0.032609,172.31.40.0-255,1514,149759,64,150827
18802,0.03261,172.31.40.0-255,696,150455,64,150827
18803,0.033976,104.244.42.0-255,66,150521,64,150827
18804,0.034006,104.244.42.0-255,66,150587,64,150827
18805,0.034099,104.244.42.0-255,66,150653,64,150827
18806,0.034771,104.244.42.0-255,108,150761,64,150827
18807,0.034778,172.31.40.0-255,66,150827,64,150827
18808,0.0,74.125.68.0-255,153,153,64,291873
18809,2.2e-05,172.31.40.0-255,66,219,64,291873
18810,2.9e-05,74.125.68.0-255,1484,1703,64,291873
18811,3.5e-05,172.31.40.0-255,66,1769,64,291873
18812,4e-05,74.125.68.0-255,2902,4671,64,291873
18813,4.4e-05,172.31.40.0-255,66,4737,64,291873
18814,4.8e-05,74.125.68.0-255,2902,7639,64,291873
18815,5.1e-05,172.31.40.0-255,66,7705,64,291873
18816,7.1e-05,74.125.68.0-255,1484,9189,64,291873
18817,7.4e-05,172.31.40.0-255,66,9255,64,291873
18818,9e-05,74.125.68.0-255,1484,10739,64,291873
18819,9.2e-05,172.31.40.0-255,66,10805,64,291873
18820,0.000111,74.125.68.0-255,3419,14224,64,291873
18821,0.000113,172.31.40.0-255,66,14290,64,291873
18822,0.000193,74.125.68.0-255,1484,15774,64,291873
18823,0.000196,172.31.40.0-255,66,15840,64,291873
18824,0.00022,74.125.68.0-255,2902,18742,64,291873
18825,0.000222,172.31.40.0-255,66,18808,64,291873
18826,0.000229,74.125.68.0-255,5738,24546,64,291873
18827,0.000231,172.31.40.0-255,66,24612,64,291873
18828,0.000258,74.125.68.0-255,6797,31409,64,291873
18829,0.000261,172.31.40.0-255,66,31475,64,291873
18830,0.00031,74.125.68.0-255,1484,32959,64,291873
18831,0.000312,172.31.40.0-255,66,33025,64,291873
18832,0.000317,74.125.68.0-255,2902,35927,64,291873
18833,0.000319,172.31.40.0-255,66,35993,64,291873
18834,0.000339,74.125.68.0-255,2902,38895,64,291873
18835,0.000341,172.31.40.0-255,66,38961,64,291873
18836,0.000357,74.125.68.0-255,1484,40445,64,291873
18837,0.000359,172.31.40.0-255,66,40511,64,291873
18838,0.000396,172.31.40.0-255,66,40577,64,291873
18839,0.000988,74.125.68.0-255,1484,42061,64,291873
18840,0.000999,74.125.68.0-255,2902,44963,64,291873
18841,0.001003,172.31.40.0-255,66,45029,64,291873
18842,0.001063,74.125.68.0-255,1484,46513,64,291873
18843,0.00107,74.125.68.0-255,2902,49415,64,291873
18844,0.001095,74.125.68.0-255,5738,55153,64,291873
18845,0.001156,74.125.68.0-255,2543,57696,64,291873
18846,0.001348,74.125.68.0-255,1484,59180,64,291873
18847,0.001369,74.125.68.0-255,2902,62082,64,291873
18848,0.001398,74.125.68.0-255,5738,67820,64,291873
18849,0.001401,74.125.68.0-255,1484,69304,64,291873
18850,0.001405,74.125.68.0-255,1484,70788,64,291873
18851,0.001421,74.125.68.0-255,1484,72272,64,291873
18852,0.001446,74.125.68.0-255,1484,73756,64,291873
18853,0.001467,74.125.68.0-255,3961,77717,64,291873
18854,0.001507,74.125.68.0-255,5738,83455,64,291873
18855,0.001551,74.125.68.0-255,2902,86357,64,291873
18856,0.001589,74.125.68.0-255,7156,93513,64,291873
18857,0.001613,74.125.68.0-255,5738,99251,64,291873
18858,0.001618,74.125.68.0-255,4320,103571,64,291873
18859,0.001624,74.125.68.0-255,5738,109309,64,291873
18860,0.001715,74.125.68.0-255,5379,114688,64,291873
18861,0.001972,74.125.68.0-255,1484,116172,64,291873
18862,0.001992,74.125.68.0-255,2902,119074,64,291873
18863,0.002018,74.125.68.0-255,5738,124812,64,291873
18864,0.002045,74.125.68.0-255,2902,127714,64,291873
18865,0.002095,74.125.68.0-255,2902,130616,64,291873
18866,0.002153,74.125.68.0-255,1484,132100,64,291873
18867,0.002174,74.125.68.0-255,2902,135002,64,291873
18868,0.002186,74.125.68.0-255,1484,136486,64,291873
18869,0.002201,74.125.68.0-255,4320,140806,64,291873
18870,0.002207,74.125.68.0-255,4320,145126,64,291873
18871,0.002227,74.125.68.0-255,5738,150864,64,291873
18872,0.00226,74.125.68.0-255,4320,155184,64,291873
18873,0.002284,74.125.68.0-255,5738,160922,64,291873
18874,0.002304,74.125.68.0-255,2902,163824,64,291873
18875,0.002345,74.125.68.0-255,766,164590,64,291873
18876,0.00248,74.125.68.0-255,1484,166074,64,291873
18877,0.002485,74.125.68.0-255,2902,168976,64,291873
18878,0.0025,74.125.68.0-255,1484,170460,64,291873
18879,0.007221,172.31.40.0-255,66,170526,64,291873
18880,0.009762,74.125.68.0-255,5738,176264,64,291873
18881,0.00977,172.31.40.0-255,66,176330,64,291873
18882,0.012281,74.125.68.0-255,5738,182068,64,291873
18883,0.012289,172.31.40.0-255,66,182134,64,291873
18884,0.014807,74.125.68.0-255,5738,187872,64,291873
18885,0.014817,172.31.40.0-255,66,187938,64,291873
18886,0.017345,74.125.68.0-255,5738,193676,64,291873
18887,0.018904,172.31.40.0-255,66,193742,64,291873
18888,0.021417,74.125.68.0-255,5738,199480,64,291873
18889,0.021434,172.31.40.0-255,66,199546,64,291873
18890,0.023944,74.125.68.0-255,5738,205284,64,291873
18891,0.023952,172.31.40.0-255,66,205350,64,291873
18892,0.026498,74.125.68.0-255,5738,211088,64,291873
18893,0.026517,172.31.40.0-255,66,211154,64,291873
18894,0.02902,74.125.68.0-255,5738,216892,64,291873
18895,0.029028,172.31.40.0-255,66,216958,64,291873
18896,0.031525,74.125.68.0-255,5738,222696,64,291873
18897,0.031532,172.31.40.0-255,66,222762,64,291873
18898,0.034036,74.125.68.0-255,5738,228500,64,291873
18899,0.034043,172.31.40.0-255,66,228566,64,291873
18900,0.036574,74.125.68.0-255,5738,234304,64,291873
18901,0.036592,172.31.40.0-255,66,234370,64,291873
18902,0.0391,74.125.68.0-255,5738,240108,64,291873
18903,0.039116,172.31.40.0-255,66,240174,64,291873
18904,0.041612,74.125.68.0-255,5738,245912,64,291873
18905,0.041619,172.31.40.0-255,66,245978,64,291873
18906,0.044131,74.125.68.0-255,5738,251716,64,291873
18907,0.044146,172.31.40.0-255,66,251782,64,291873
18908,0.046267,172.31.40.0-255,167,251949,64,291873
18909,0.046302,172.31.40.0-255,1112,253061,64,291873
18910,0.04636,172.31.40.0-255,1514,254575,64,291873
18911,0.046362,172.31.40.0-255,1514,256089,64,291873
18912,0.046363,172.31.40.0-255,696,256785,64,291873
18913,0.04668,74.125.68.0-255,5738,262523,64,291873
18914,0.046687,172.31.40.0-255,66,262589,64,291873
18915,0.047831,104.244.42.0-255,66,262655,64,291873
18916,0.047852,104.244.42.0-255,66,262721,64,291873
18917,0.047924,104.244.42.0-255,66,262787,64,291873
18918,0.047928,104.244.42.0-255,66,262853,64,291873
18919,0.049185,74.125.68.0-255,5738,268591,64,291873
18920,0.049196,172.31.40.0-255,66,268657,64,291873
18921,0.051726,74.125.68.0-255,5738,274395,64,291873
18922,0.051744,172.31.40.0-255,66,274461,64,291873
18923,0.054259,74.125.68.0-255,5738,280199,64,291873
18924,0.054274,172.31.40.0-255,66,280265,64,291873
18925,0.056781,74.125.68.0-255,5738,286003,64,291873
18926,0.056805,172.31.40.0-255,66,286069,64,291873
18927,0.059318,74.125.68.0-255,5738,291807,64,291873
18928,0.059336,172.31.40.0-255,66,291873,64,291873
18929,0.0,74.125.68.0-255,182,182,64,302186
18930,2.2e-05,172.31.40.0-255,66,248,64,302186
18931,2.9e-05,74.125.68.0-255,1484,1732,64,302186
18932,3.3e-05,172.31.40.0-255,66,1798,64,302186
18933,4e-05,74.125.68.0-255,2902,4700,64,302186
18934,4.4e-05,172.31.40.0-255,66,4766,64,302186
18935,4.7e-05,74.125.68.0-255,1484,6250,64,302186
18936,5e-05,172.31.40.0-255,66,6316,64,302186
18937,5.5e-05,74.125.68.0-255,2902,9218,64,302186
18938,5.8e-05,172.31.40.0-255,66,9284,64,302186
18939,8.5e-05,74.125.68.0-255,4823,14107,64,302186
18940,8.9e-05,172.31.40.0-255,66,14173,64,302186
18941,0.000132,74.125.68.0-255,2902,17075,64,302186
18942,0.000134,172.31.40.0-255,66,17141,64,302186
18943,0.000148,74.125.68.0-255,2902,20043,64,302186
18944,0.000151,172.31.40.0-255,66,20109,64,302186
18945,0.000173,74.125.68.0-255,1484,21593,64,302186
18946,0.000176,172.31.40.0-255,66,21659,64,302186
18947,0.000187,172.31.40.0-255,66,21725,64,302186
18948,0.00019,74.125.68.0-255,1125,22850,64,302186
18949,0.000192,172.31.40.0-255,66,22916,64,302186
18950,0.000318,74.125.68.0-255,1484,24400,64,302186
18951,0.000323,172.31.40.0-255,66,24466,64,302186
18952,0.000345,74.125.68.0-255,2902,27368,64,302186
18953,0.000349,172.31.40.0-255,66,27434,64,302186
18954,0.000354,74.125.68.0-255,4320,31754,64,302186
18955,0.000356,172.31.40.0-255,66,31820,64,302186
18956,0.000391,74.125.68.0-255,5738,37558,64,302186
18957,0.000394,172.31.40.0-255,66,37624,64,302186
18958,0.00041,74.125.68.0-255,2543,40167,64,302186
18959,0.000413,172.31.40.0-255,66,40233,64,302186
18960,0.000415,74.125.68.0-255,1484,41717,64,302186
18961,0.000441,74.125.68.0-255,7156,48873,64,302186
18962,0.000444,172.31.40.0-255,66,48939,64,302186
18963,0.000452,74.125.68.0-255,7156,56095,64,302186
18964,0.000454,172.31.40.0-255,66,56161,64,302186
18965,0.000487,74.125.68.0-255,1480,57641,64,302186
18966,0.000516,74.125.68.0-255,332,57973,64,302186
18967,0.000519,172.31.40.0-255,66,58039,64,302186
18968,0.000736,74.125.68.0-255,1484,59523,64,302186
18969,0.000741,74.125.68.0-255,2902,62425,64,302186
18970,0.000747,172.31.40.0-255,66,62491,64,302186
18971,0.000771,74.125.68.0-255,4320,66811,64,302186
18972,0.000774,172.31.40.0-255,66,66877,64,302186
18973,0.00079,74.125.68.0-255,1484,68361,64,302186
18974,0.000796,74.125.68.0-255,4320,72681,64,302186
18975,0.000799,172.31.40.0-255,66,72747,64,302186
18976,0.000828,74.125.68.0-255,2902,75649,64,302186
18977,0.00083,172.31.40.0-255,66,75715,64,302186
18978,0.000841,172.31.40.0-255,66,75781,64,302186
18979,0.000844,74.125.68.0-255,1484,77265,64,302186
18980,0.000865,74.125.68.0-255,6438,83703,64,302186
18981,0.000868,172.31.40.0-255,66,83769,64,302186
18982,0.001066,74.125.68.0-255,1484,85253,64,302186
18983,0.001081,74.125.68.0-255,2902,88155,64,302186
18984,0.001084,172.31.40.0-255,66,88221,64,302186
18985,0.001089,74.125.68.0-255,2902,91123,64,302186
18986,0.001091,172.31.40.0-255,66,91189,64,302186
18987,0.001107,74.125.68.0-255,4320,95509,64,302186
18988,0.001109,172.31.40.0-255,66,95575,64,302186
18989,0.001144,74.125.68.0-255,5738,101313,64,302186
18990,0.001147,172.31.40.0-255,66,101379,64,302186
18991,0.001169,74.125.68.0-255,2902,104281,64,302186
18992,0.001171,172.31.40.0-255,66,104347,64,302186
18993,0.001177,74.125.68.0-255,4320,108667,64,302186
18994,0.001179,172.31.40.0-255,66,108733,64,302186
18995,0.001185,74.125.68.0-255,5738,114471,64,302186
18996,0.001187,172.31.40.0-255,66,114537,64,302186
18997,0.001191,74.125.68.0-255,1484,116021,64,302186
18998,0.001212,74.125.68.0-255,2184,118205,64,302186
18999,0.001216,172.31.40.0-255,66,118271,64,302186
19000,0.002018,74.125.68.0-255,1484,119755,64,302186
19001,0.002069,74.125.68.0-255,1484,121239,64,302186
19002,0.002074,172.31.40.0-255,66,121305,64,302186
19003,0.00208,74.125.68.0-255,2902,124207,64,302186
19004,0.002082,172.31.40.0-255,66,124273,64,302186
19005,0.002102,74.125.68.0-255,1484,125757,64,302186
19006,0.002125,74.125.68.0-255,2902,128659,64,302186
19007,0.002128,172.31.40.0-255,66,128725,64,302186
19008,0.002133,74.125.68.0-255,2902,131627,64,302186
19009,0.002134,172.31.40.0-255,66,131693,64,302186
19010,0.002149,74.125.68.0-255,2902,134595,64,302186
19011,0.002151,172.31.40.0-255,66,134661,64,302186
19012,0.002155,74.125.68.0-255,2902,137563,64,302186
19013,0.002157,172.31.40.0-255,66,137629,64,302186
19014,0.002161,74.125.68.0-255,2902,140531,64,302186
19015,0.002163,172.31.40.0-255,66,140597,64,302186
19016,0.002175,74.125.68.0-255,1484,142081,64,302186
19017,0.002202,74.125.68.0-255,2902,144983,64,302186
19018,0.002204,172.31.40.0-255,66,145049,64,302186
19019,0.002222,74.125.68.0-255,4320,149369,64,302186
19020,0.002224,172.31.40.0-255,66,149435,64,302186
19021,0.002261,74.125.68.0-255,3602,153037,64,302186
19022,0.002263,172.31.40.0-255,66,153103,64,302186
19023,0.004468,74.125.68.0-255,1484,154587,64,302186
19024,0.004514,74.125.68.0-255,4320,158907,64,302186
19025,0.004518,172.31.40.0-255,66,158973,64,302186
19026,0.006768,74.125.68.0-255,5738,164711,64,302186
19027,0.006774,172.31.40.0-255,66,164777,64,302186
19028,0.009024,74.125.68.0-255,5738,170515,64,302186
19029,0.009031,172.31.40.0-255,66,170581,64,302186
19030,0.011289,74.125.68.0-255,5738,176319,64,302186
19031,0.011297,172.31.40.0-255,66,176385,64,302186
19032,0.01356,74.125.68.0-255,5738,182123,64,302186
19033,0.013568,172.31.40.0-255,66,182189,64,302186
19034,0.015823,74.125.68.0-255,5738,187927,64,302186
19035,0.015833,172.31.40.0-255,66,187993,64,302186
19036,0.018104,74.125.68.0-255,5738,193731,64,302186
19037,0.018116,172.31.40.0-255,66,193797,64,302186
19038,0.020365,74.125.68.0-255,5738,199535,64,302186
19039,0.020374,172.31.40.0-255,66,199601,64,302186
19040,0.022623,74.125.68.0-255,5738,205339,64,302186
19041,0.022631,172.31.40.0-255,66,205405,64,302186
19042,0.024891,74.125.68.0-255,5738,211143,64,302186
19043,0.024901,172.31.40.0-255,66,211209,64,302186
19044,0.027157,74.125.68.0-255,4320,215529,64,302186
19045,0.027164,172.31.40.0-255,66,215595,64,302186
19046,0.027181,74.125.68.0-255,1484,217079,64,302186
19047,0.028967,172.31.40.0-255,167,217246,64,302186
19048,0.029,172.31.40.0-255,1112,218358,64,302186
19049,0.029057,172.31.40.0-255,1514,219872,64,302186
19050,0.029059,172.31.40.0-255,1514,221386,64,302186
19051,0.02906,172.31.40.0-255,698,222084,64,302186
19052,0.029425,74.125.68.0-255,4320,226404,64,302186
19053,0.029433,172.31.40.0-255,66,226470,64,302186
19054,0.030508,104.244.42.0-255,66,226536,64,302186
19055,0.030538,104.244.42.0-255,66,226602,64,302186
19056,0.030594,104.244.42.0-255,66,226668,64,302186
19057,0.030612,104.244.42.0-255,66,226734,64,302186
19058,0.03169,74.125.68.0-255,5738,232472,64,302186
19059,0.031695,172.31.40.0-255,66,232538,64,302186
19060,0.033988,74.125.68.0-255,5738,238276,64,302186
19061,0.033994,172.31.40.0-255,66,238342,64,302186
19062,0.036247,74.125.68.0-255,5738,244080,64,302186
19063,0.036254,172.31.40.0-255,66,244146,64,302186
19064,0.038515,74.125.68.0-255,5738,249884,64,302186
19065,0.038522,172.31.40.0-255,66,249950,64,302186
19066,0.040768,74.125.68.0-255,5738,255688,64,302186
19067,0.040774,172.31.40.0-255,66,255754,64,302186
19068,0.043039,74.125.68.0-255,5738,261492,64,302186
19069,0.043049,172.31.40.0-255,66,261558,64,302186
19070,0.045308,74.125.68.0-255,5738,267296,64,302186
19071,0.045315,172.31.40.0-255,66,267362,64,302186
19072,0.047581,74.125.68.0-255,5738,273100,64,302186
19073,0.047587,172.31.40.0-255,66,273166,64,302186
19074,0.049848,74.125.68.0-255,5738,278904,64,302186
19075,0.049854,172.31.40.0-255,66,278970,64,302186
19076,0.052122,74.125.68.0-255,5738,284708,64,302186
19077,0.05213,172.31.40.0-255,66,284774,64,302186
19078,0.05439,74.125.68.0-255,5738,290512,64,302186
19079,0.054397,172.31.40.0-255,66,290578,64,302186
19080,0.056654,74.125.68.0-255,5738,296316,64,302186
19081,0.056661,172.31.40.0-255,66,296382,64,302186
19082,0.058926,74.125.68.0-255,5738,302120,64,302186
19083,0.058933,172.31.40.0-255,66,302186,64,302186
19084,0.0,74.125.68.0-255,153,153,64,284154
19085,2.1e-05,172.31.40.0-255,66,219,64,284154
19086,2.8e-05,74.125.68.0-255,1484,1703,64,284154
19087,3.2e-05,172.31.40.0-255,66,1769,64,284154
19088,3.8e-05,74.125.68.0-255,2902,4671,64,284154
19089,4e-05,172.31.40.0-255,66,4737,64,284154
19090,5.3e-05,74.125.68.0-255,1484,6221,64,284154
19091,5.5e-05,172.31.40.0-255,66,6287,64,284154
19092,6e-05,74.125.68.0-255,2902,9189,64,284154
19093,6.4e-05,172.31.40.0-255,66,9255,64,284154
19094,9.5e-05,74.125.68.0-255,4838,14093,64,284154
19095,9.9e-05,172.31.40.0-255,66,14159,64,284154
19096,0.000204,74.125.68.0-255,1484,15643,64,284154
19097,0.000209,172.31.40.0-255,66,15709,64,284154
19098,0.000214,74.125.68.0-255,2902,18611,64,284154
19099,0.000216,172.31.40.0-255,66,18677,64,284154
19100,0.000223,74.125.68.0-255,5738,24415,64,284154
19101,0.000229,172.31.40.0-255,66,24481,64,284154
19102,0.000258,74.125.68.0-255,4320,28801,64,284154
19103,0.00026,172.31.40.0-255,66,28867,64,284154
19104,0.000293,74.125.68.0-255,2543,31410,64,284154
19105,0.000296,172.31.40.0-255,66,31476,64,284154
19106,0.00062,74.125.68.0-255,1484,32960,64,284154
19107,0.000625,172.31.40.0-255,66,33026,64,284154
19108,0.000631,74.125.68.0-255,2902,35928,64,284154
19109,0.000633,172.31.40.0-255,66,35994,64,284154
19110,0.000657,74.125.68.0-255,4320,40314,64,284154
19111,0.000664,172.31.40.0-255,66,40380,64,284154
19112,0.000697,172.31.40.0-255,66,40446,64,284154
19113,0.001508,74.125.68.0-255,1484,41930,64,284154
19114,0.001515,172.31.40.0-255,66,41996,64,284154
19115,0.001525,74.125.68.0-255,2902,44898,64,284154
19116,0.001527,172.31.40.0-255,66,44964,64,284154
19117,0.00154,74.125.68.0-255,5738,50702,64,284154
19118,0.001542,172.31.40.0-255,66,50768,64,284154
19119,0.001546,74.125.68.0-255,2902,53670,64,284154
19120,0.001548,172.31.40.0-255,66,53736,64,284154
19121,0.001554,74.125.68.0-255,3961,57697,64,284154
19122,0.001557,172.31.40.0-255,66,57763,64,284154
19123,0.0016,74.125.68.0-255,5738,63501,64,284154
19124,0.001602,172.31.40.0-255,66,63567,64,284154
19125,0.001629,74.125.68.0-255,2902,66469,64,284154
19126,0.001631,172.31.40.0-255,66,66535,64,284154
19127,0.001669,172.31.40.0-255,66,66601,64,284154
19128,0.001694,74.125.68.0-255,1484,68085,64,284154
19129,0.001717,74.125.68.0-255,2902,70987,64,284154
19130,0.001719,172.31.40.0-255,66,71053,64,284154
19131,0.001726,74.125.68.0-255,5738,76791,64,284154
19132,0.001729,172.31.40.0-255,66,76857,64,284154
19133,0.001749,74.125.68.0-255,5738,82595,64,284154
19134,0.001751,172.31.40.0-255,66,82661,64,284154
19135,0.001773,74.125.68.0-255,1484,84145,64,284154
19136,0.001776,74.125.68.0-255,288,84433,64,284154
19137,0.001778,172.31.40.0-255,66,84499,64,284154
19138,0.001905,74.125.68.0-255,1484,85983,64,284154
19139,0.001921,74.125.68.0-255,2902,88885,64,284154
19140,0.001924,172.31.40.0-255,66,88951,64,284154
19141,0.001944,74.125.68.0-255,5738,94689,64,284154
19142,0.001946,172.31.40.0-255,66,94755,64,284154
19143,0.001951,74.125.68.0-255,2902,97657,64,284154
19144,0.001953,172.31.40.0-255,66,97723,64,284154
19145,0.001981,74.125.68.0-255,4320,102043,64,284154
19146,0.001984,172.31.40.0-255,66,102109,64,284154
19147,0.001987,74.125.68.0-255,1484,103593,64,284154
19148,0.002014,74.125.68.0-255,7156,110749,64,284154
19149,0.002017,172.31.40.0-255,66,110815,64,284154
19150,0.002023,74.125.68.0-255,5738,116553,64,284154
19151,0.002025,172.31.40.0-255,66,116619,64,284154
19152,0.002052,74.125.68.0-255,2184,118803,64,284154
19153,0.002055,172.31.40.0-255,66,118869,64,284154
19154,0.004087,74.125.68.0-255,2902,121771,64,284154
19155,0.004092,172.31.40.0-255,66,121837,64,284154
19156,0.004118,74.125.68.0-255,2902,124739,64,284154
19157,0.00412,172.31.40.0-255,66,124805,64,284154
19158,0.006153,74.125.68.0-255,2902,127707,64,284154
19159,0.006157,172.31.40.0-255,66,127773,64,284154
19160,0.006215,74.125.68.0-255,2902,130675,64,284154
19161,0.006219,172.31.40.0-255,66,130741,64,284154
19162,0.008225,74.125.68.0-255,2902,133643,64,284154
19163,0.008232,172.31.40.0-255,66,133709,64,284154
19164,0.008269,74.125.68.0-255,2902,136611,64,284154
19165,0.008272,172.31.40.0-255,66,136677,64,284154
19166,0.010299,74.125.68.0-255,2902,139579,64,284154
19167,0.010306,172.31.40.0-255,66,139645,64,284154
19168,0.010334,74.125.68.0-255,2902,142547,64,284154
19169,0.010337,172.31.40.0-255,66,142613,64,284154
19170,0.012373,74.125.68.0-255,2902,145515,64,284154
19171,0.01238,172.31.40.0-255,66,145581,64,284154
19172,0.012402,74.125.68.0-255,2902,148483,64,284154
19173,0.012405,172.31.40.0-255,66,148549,64,284154
19174,0.014445,74.125.68.0-255,2902,151451,64,284154
19175,0.014455,172.31.40.0-255,66,151517,64,284154
19176,0.014487,74.125.68.0-255,2902,154419,64,284154
19177,0.01449,172.31.40.0-255,66,154485,64,284154
19178,0.016529,74.125.68.0-255,2902,157387,64,284154
19179,0.016536,172.31.40.0-255,66,157453,64,284154
19180,0.016574,74.125.68.0-255,2902,160355,64,284154
19181,0.016577,172.31.40.0-255,66,160421,64,284154
19182,0.018613,74.125.68.0-255,2902,163323,64,284154
19183,0.018621,172.31.40.0-255,66,163389,64,284154
19184,0.018653,74.125.68.0-255,2902,166291,64,284154
19185,0.018656,172.31.40.0-255,66,166357,64,284154
19186,0.02069,74.125.68.0-255,2902,169259,64,284154
19187,0.0207,172.31.40.0-255,66,169325,64,284154
19188,0.020732,74.125.68.0-255,2902,172227,64,284154
19189,0.020735,172.31.40.0-255,66,172293,64,284154
19190,0.022766,74.125.68.0-255,2902,175195,64,284154
19191,0.022774,172.31.40.0-255,66,175261,64,284154
19192,0.022809,74.125.68.0-255,2902,178163,64,284154
19193,0.022812,172.31.40.0-255,66,178229,64,284154
19194,0.024838,74.125.68.0-255,2902,181131,64,284154
19195,0.024843,172.31.40.0-255,66,181197,64,284154
19196,0.02488,74.125.68.0-255,2902,184099,64,284154
19197,0.024884,172.31.40.0-255,66,184165,64,284154
19198,0.025695,172.31.40.0-255,172,184337,64,284154
19199,0.025728,172.31.40.0-255,1112,185449,64,284154
19200,0.025784,172.31.40.0-255,1514,186963,64,284154
19201,0.025785,172.31.40.0-255,1514,188477,64,284154
19202,0.025789,172.31.40.0-255,1514,189991,64,284154
19203,0.025791,172.31.40.0-255,1514,191505,64,284154
19204,0.025811,172.31.40.0-255,477,191982,64,284154
19205,0.026909,74.125.68.0-255,2902,194884,64,284154
19206,0.026917,172.31.40.0-255,66,194950,64,284154
19207,0.02695,74.125.68.0-255,2902,197852,64,284154
19208,0.026953,172.31.40.0-255,66,197918,64,284154
19209,0.027258,104.244.42.0-255,66,197984,64,284154
19210,0.0273,104.244.42.0-255,66,198050,64,284154
19211,0.027367,104.244.42.0-255,66,198116,64,284154
19212,0.027373,104.244.42.0-255,66,198182,64,284154
19213,0.02898,74.125.68.0-255,2902,201084,64,284154
19214,0.028986,172.31.40.0-255,66,201150,64,284154
19215,0.029012,74.125.68.0-255,2902,204052,64,284154
19216,0.029015,172.31.40.0-255,66,204118,64,284154
19217,0.031041,74.125.68.0-255,2902,207020,64,284154
19218,0.031048,172.31.40.0-255,66,207086,64,284154
19219,0.031076,74.125.68.0-255,2902,209988,64,284154
19220,0.031079,172.31.40.0-255,66,210054,64,284154
19221,0.033129,74.125.68.0-255,4320,214374,64,284154
19222,0.033135,172.31.40.0-255,66,214440,64,284154
19223,0.033161,74.125.68.0-255,1484,215924,64,284154
19224,0.035208,74.125.68.0-255,4320,220244,64,284154
19225,0.035215,172.31.40.0-255,66,220310,64,284154
19226,0.03729,74.125.68.0-255,5738,226048,64,284154
19227,0.037297,172.31.40.0-255,66,226114,64,284154
19228,0.039371,74.125.68.0-255,5738,231852,64,284154
19229,0.039377,172.31.40.0-255,66,231918,64,284154
19230,0.041456,74.125.68.0-255,5738,237656,64,284154
19231,0.041463,172.31.40.0-255,66,237722,64,284154
19232,0.043541,74.125.68.0-255,5738,243460,64,284154
19233,0.043558,172.31.40.0-255,66,243526,64,284154
19234,0.045668,74.125.68.0-255,5738,249264,64,284154
19235,0.045683,172.31.40.0-255,66,249330,64,284154
19236,0.047761,74.125.68.0-255,5738,255068,64,284154
19237,0.047775,172.31.40.0-255,66,255134,64,284154
19238,0.049876,74.125.68.0-255,5738,260872,64,284154
19239,0.04989,172.31.40.0-255,66,260938,64,284154
19240,0.051983,74.125.68.0-255,5738,266676,64,284154
19241,0.051995,172.31.40.0-255,66,266742,64,284154
19242,0.054086,74.125.68.0-255,5738,272480,64,284154
19243,0.054103,172.31.40.0-255,66,272546,64,284154
19244,0.056172,74.125.68.0-255,5738,278284,64,284154
19245,0.056188,172.31.40.0-255,66,278350,64,284154
19246,0.058276,74.125.68.0-255,5738,284088,64,284154
19247,0.058291,172.31.40.0-255,66,284154,64,284154
19248,0.0,172.31.40.0-255,105,105,64,459
19249,0.000152,172.31.40.0-255,90,195,64,459
19250,0.000163,172.31.40.0-255,66,261,64,459
19251,0.002221,172.217.194.0-255,66,327,64,459
19252,0.002282,172.217.194.0-255,66,393,64,459
19253,0.002307,172.31.40.0-255,66,459,64,459
19254,0.0,74.125.200.0-255,152,152,64,340929
19255,1.6e-05,172.31.40.0-255,66,218,64,340929
19256,2.3e-05,74.125.200.0-255,1484,1702,64,340929
19257,2.7e-05,172.31.40.0-255,66,1768,64,340929
19258,3.3e-05,74.125.200.0-255,2902,4670,64,340929
19259,3.8e-05,172.31.40.0-255,66,4736,64,340929
19260,4.1e-05,74.125.200.0-255,1484,6220,64,340929
19261,4.4e-05,172.31.40.0-255,66,6286,64,340929
19262,6.9e-05,74.125.200.0-255,4320,10606,64,340929
19263,7.2e-05,172.31.40.0-255,66,10672,64,340929
19264,7.7e-05,74.125.200.0-255,3556,14228,64,340929
19265,7.9e-05,172.31.40.0-255,66,14294,64,340929
19266,0.000162,74.125.200.0-255,1484,15778,64,340929
19267,0.000165,172.31.40.0-255,66,15844,64,340929
19268,0.000186,74.125.200.0-255,2902,18746,64,340929
19269,0.000189,172.31.40.0-255,66,18812,64,340929
19270,0.00021,74.125.200.0-255,5738,24550,64,340929
19271,0.000213,172.31.40.0-255,66,24616,64,340929
19272,0.000216,74.125.200.0-255,1484,26100,64,340929
19273,0.000218,172.31.40.0-255,66,26166,64,340929
19274,0.000241,74.125.200.0-255,1484,27650,64,340929
19275,0.000244,172.31.40.0-255,66,27716,64,340929
19276,0.00025,74.125.200.0-255,3961,31677,64,340929
19277,0.000261,172.31.40.0-255,66,31743,64,340929
19278,0.000376,74.125.200.0-255,1484,33227,64,340929
19279,0.00038,172.31.40.0-255,66,33293,64,340929
19280,0.000401,74.125.200.0-255,2902,36195,64,340929
19281,0.000404,172.31.40.0-255,66,36261,64,340929
19282,0.000431,74.125.200.0-255,5738,41999,64,340929
19283,0.000433,172.31.40.0-255,66,42065,64,340929
19284,0.000436,74.125.200.0-255,1484,43549,64,340929
19285,0.000438,172.31.40.0-255,66,43615,64,340929
19286,0.00048,74.125.200.0-255,4320,47935,64,340929
19287,0.000484,172.31.40.0-255,66,48001,64,340929
19288,0.000504,74.125.200.0-255,3961,51962,64,340929
19289,0.000507,172.31.40.0-255,66,52028,64,340929
19290,0.000521,74.125.200.0-255,1484,53512,64,340929
19291,0.000541,74.125.200.0-255,7156,60668,64,340929
19292,0.000544,172.31.40.0-255,66,60734,64,340929
19293,0.000548,74.125.200.0-255,1484,62218,64,340929
19294,0.000587,74.125.200.0-255,4542,66760,64,340929
19295,0.00059,172.31.40.0-255,66,66826,64,340929
19296,0.000817,74.125.200.0-255,1484,68310,64,340929
19297,0.000822,74.125.200.0-255,1484,69794,64,340929
19298,0.000825,172.31.40.0-255,66,69860,64,340929
19299,0.000843,74.125.200.0-255,1484,71344,64,340929
19300,0.000846,74.125.200.0-255,1484,72828,64,340929
19301,0.000848,172.31.40.0-255,66,72894,64,340929
19302,0.000868,74.125.200.0-255,2902,75796,64,340929
19303,0.000871,172.31.40.0-255,66,75862,64,340929
19304,0.000882,74.125.200.0-255,1484,77346,64,340929
19305,0.0009,74.125.200.0-255,7156,84502,64,340929
19306,0.000903,172.31.40.0-255,66,84568,64,340929
19307,0.00093,74.125.200.0-255,2902,87470,64,340929
19308,0.000932,172.31.40.0-255,66,87536,64,340929
19309,0.000958,74.125.200.0-255,7156,94692,64,340929
19310,0.000961,172.31.40.0-255,66,94758,64,340929
19311,0.000964,74.125.200.0-255,1484,96242,64,340929
19312,0.001007,74.125.200.0-255,5020,101262,64,340929
19313,0.00101,172.31.40.0-255,66,101328,64,340929
19314,0.001094,74.125.200.0-255,1484,102812,64,340929
19315,0.001112,74.125.200.0-255,2902,105714,64,340929
19316,0.001116,172.31.40.0-255,66,105780,64,340929
19317,0.001148,74.125.200.0-255,5738,111518,64,340929
19318,0.001151,172.31.40.0-255,66,111584,64,340929
19319,0.001166,74.125.200.0-255,1484,113068,64,340929
19320,0.001185,74.125.200.0-255,5738,118806,64,340929
19321,0.001188,172.31.40.0-255,66,118872,64,340929
19322,0.001194,74.125.200.0-255,4320,123192,64,340929
19323,0.001196,172.31.40.0-255,66,123258,64,340929
19324,0.00122,74.125.200.0-255,5738,128996,64,340929
19325,0.001224,172.31.40.0-255,66,129062,64,340929
19326,0.001243,74.125.200.0-255,4320,133382,64,340929
19327,0.001246,172.31.40.0-255,66,133448,64,340929
19328,0.001258,74.125.200.0-255,1484,134932,64,340929
19329,0.001269,74.125.200.0-255,766,135698,64,340929
19330,0.001272,172.31.40.0-255,66,135764,64,340929
19331,0.001436,74.125.200.0-255,1484,137248,64,340929
19332,0.001459,74.125.200.0-255,2902,140150,64,340929
19333,0.001463,172.31.40.0-255,66,140216,64,340929
19334,0.001488,74.125.200.0-255,5738,145954,64,340929
19335,0.001491,172.31.40.0-255,66,146020,64,340929
19336,0.001494,74.125.200.0-255,1484,147504,64,340929
19337,0.001512,74.125.200.0-255,2902,150406,64,340929
19338,0.001517,172.31.40.0-255,66,150472,64,340929
19339,0.001529,74.125.200.0-255,4320,154792,64,340929
19340,0.001532,172.31.40.0-255,66,154858,64,340929
19341,0.001557,74.125.200.0-255,1484,156342,64,340929
19342,0.001562,74.125.200.0-255,2902,159244,64,340929
19343,0.001564,172.31.40.0-255,66,159310,64,340929
19344,0.001569,74.125.200.0-255,4320,163630,64,340929
19345,0.001571,172.31.40.0-255,66,163696,64,340929
19346,0.001599,74.125.200.0-255,4320,168016,64,340929
19347,0.001603,172.31.40.0-255,66,168082,64,340929
19348,0.001623,74.125.200.0-255,2184,170266,64,340929
19349,0.001626,172.31.40.0-255,66,170332,64,340929
19350,0.001854,74.125.200.0-255,1484,171816,64,340929
19351,0.00187,74.125.200.0-255,2902,174718,64,340929
19352,0.001873,172.31.40.0-255,66,174784,64,340929
19353,0.001906,74.125.200.0-255,5738,180522,64,340929
19354,0.001909,172.31.40.0-255,66,180588,64,340929
19355,0.001933,74.125.200.0-255,5738,186326,64,340929
19356,0.001935,172.31.40.0-255,66,186392,64,340929
19357,0.00195,74.125.200.0-255,1484,187876,64,340929
19358,0.001957,74.125.200.0-255,5738,193614,64,340929
19359,0.001959,172.31.40.0-255,66,193680,64,340929
19360,0.001963,74.125.200.0-255,2902,196582,64,340929
19361,0.001966,172.31.40.0-255,66,196648,64,340929
19362,0.00199,74.125.200.0-255,4320,200968,64,340929
19363,0.001993,172.31.40.0-255,66,201034,64,340929
19364,0.001998,74.125.200.0-255,2902,203936,64,340929
19365,0.002,172.31.40.0-255,66,204002,64,340929
19366,0.002014,74.125.200.0-255,766,204768,64,340929
19367,0.002077,74.125.200.0-255,1484,206252,64,340929
19368,0.002081,172.31.40.0-255,66,206318,64,340929
19369,0.002098,74.125.200.0-255,2902,209220,64,340929
19370,0.002101,172.31.40.0-255,66,209286,64,340929
19371,0.002123,74.125.200.0-255,4320,213606,64,340929
19372,0.002126,172.31.40.0-255,66,213672,64,340929
19373,0.002148,74.125.200.0-255,7156,220828,64,340929
19374,0.002151,172.31.40.0-255,66,220894,64,340929
19375,0.002172,74.125.200.0-255,1484,222378,64,340929
19376,0.002176,74.125.200.0-255,2902,225280,64,340929
19377,0.002178,172.31.40.0-255,66,225346,64,340929
19378,0.002187,74.125.200.0-255,7156,232502,64,340929
19379,0.002189,172.31.40.0-255,66,232568,64,340929
19380,0.002206,74.125.200.0-255,5738,238306,64,340929
19381,0.002209,172.31.40.0-255,66,238372,64,340929
19382,0.002211,74.125.200.0-255,766,239138,64,340929
19383,0.002214,74.125.200.0-255,1484,240622,64,340929
19384,0.002217,172.31.40.0-255,66,240688,64,340929
19385,0.002222,74.125.200.0-255,4320,245008,64,340929
19386,0.002224,172.31.40.0-255,66,245074,64,340929
19387,0.002271,172.31.40.0-255,66,245140,64,340929
19388,0.002275,74.125.200.0-255,2902,248042,64,340929
19389,0.002278,172.31.40.0-255,66,248108,64,340929
19390,0.002292,74.125.200.0-255,1484,249592,64,340929
19391,0.002325,74.125.200.0-255,766,250358,64,340929
19392,0.002423,74.125.200.0-255,2902,253260,64,340929
19393,0.002441,74.125.200.0-255,6438,259698,64,340929
19394,0.002469,74.125.200.0-255,5738,265436,64,340929
19395,0.002484,74.125.200.0-255,2902,268338,64,340929
19396,0.0025,74.125.200.0-255,4320,272658,64,340929
19397,0.002564,74.125.200.0-255,3602,276260,64,340929
19398,0.002567,74.125.200.0-255,1484,277744,64,340929
19399,0.002583,74.125.200.0-255,1484,279228,64,340929
19400,0.002601,74.125.200.0-255,4320,283548,64,340929
19401,0.002604,74.125.200.0-255,1484,285032,64,340929
19402,0.002606,74.125.200.0-255,1484,286516,64,340929
19403,0.00262,74.125.200.0-255,2902,289418,64,340929
19404,0.00263,74.125.200.0-255,1484,290902,64,340929
19405,0.002652,74.125.200.0-255,2902,293804,64,340929
19406,0.00268,74.125.200.0-255,7156,300960,64,340929
19407,0.002683,74.125.200.0-255,1484,302444,64,340929
19408,0.002685,74.125.200.0-255,1484,303928,64,340929
19409,0.002703,74.125.200.0-255,5020,308948,64,340929
19410,0.002706,74.125.200.0-255,1484,310432,64,340929
19411,0.002709,74.125.200.0-255,1484,311916,64,340929
19412,0.002772,74.125.200.0-255,2902,314818,64,340929
19413,0.002775,74.125.200.0-255,1484,316302,64,340929
19414,0.002778,74.125.200.0-255,1484,317786,64,340929
19415,0.00278,74.125.200.0-255,1484,319270,64,340929
19416,0.002783,74.125.200.0-255,1484,320754,64,340929
19417,0.002795,74.125.200.0-255,2902,323656,64,340929
19418,0.002798,74.125.200.0-255,1484,325140,64,340929
19419,0.00281,74.125.200.0-255,1484,326624,64,340929
19420,0.002815,74.125.200.0-255,4320,330944,64,340929
19421,0.002842,74.125.200.0-255,5020,335964,64,340929
19422,0.002855,74.125.200.0-255,1431,337395,64,340929
19423,0.00291,74.125.200.0-255,105,337500,64,340929
19424,0.009971,172.31.40.0-255,66,337566,64,340929
19425,0.021302,172.31.40.0-255,105,337671,64,340929
19426,0.023826,74.125.200.0-255,66,337737,64,340929
19427,0.041142,172.31.40.0-255,167,337904,64,340929
19428,0.041177,172.31.40.0-255,1107,339011,64,340929
19429,0.04124,172.31.40.0-255,1514,340525,64,340929
19430,0.041242,172.31.40.0-255,338,340863,64,340929
19431,0.043229,104.244.42.0-255,66,340929,64,340929
19432,0.0,74.125.24.0-255,152,152,64,265086
19433,2.2e-05,172.31.40.0-255,66,218,64,265086
19434,2.9e-05,74.125.24.0-255,1484,1702,64,265086
19435,3.4e-05,172.31.40.0-255,66,1768,64,265086
19436,4e-05,74.125.24.0-255,2902,4670,64,265086
19437,4.2e-05,172.31.40.0-255,66,4736,64,265086
19438,8e-05,74.125.24.0-255,5738,10474,64,265086
19439,8.3e-05,172.31.40.0-255,66,10540,64,265086
19440,0.000103,74.125.24.0-255,1484,12024,64,265086
19441,0.000105,172.31.40.0-255,66,12090,64,265086
19442,0.00011,74.125.24.0-255,2128,14218,64,265086
19443,0.000112,172.31.40.0-255,66,14284,64,265086
19444,0.000124,172.31.40.0-255,66,14350,64,265086
19445,0.00013,74.125.24.0-255,5379,19729,64,265086
19446,0.000133,172.31.40.0-255,66,19795,64,265086
19447,0.000249,74.125.24.0-255,1484,21279,64,265086
19448,0.000253,172.31.40.0-255,66,21345,64,265086
19449,0.000258,74.125.24.0-255,2902,24247,64,265086
19450,0.000261,172.31.40.0-255,66,24313,64,265086
19451,0.000267,74.125.24.0-255,5738,30051,64,265086
19452,0.000269,172.31.40.0-255,66,30117,64,265086
19453,0.000274,74.125.24.0-255,4320,34437,64,265086
19454,0.000276,172.31.40.0-255,66,34503,64,265086
19455,0.000294,74.125.24.0-255,2543,37046,64,265086
19456,0.000297,172.31.40.0-255,66,37112,64,265086
19457,0.000329,172.31.40.0-255,66,37178,64,265086
19458,0.000332,74.125.24.0-255,1484,38662,64,265086
19459,0.000334,172.31.40.0-255,66,38728,64,265086
19460,0.000371,74.125.24.0-255,1125,39853,64,265086
19461,0.000374,172.31.40.0-255,66,39919,64,265086
19462,0.000508,74.125.24.0-255,397,40316,64,265086
19463,0.000546,74.125.24.0-255,112,40428,64,265086
19464,0.000606,74.125.24.0-255,1484,41912,64,265086
19465,0.000611,172.31.40.0-255,66,41978,64,265086
19466,0.000617,74.125.24.0-255,2902,44880,64,265086
19467,0.000619,172.31.40.0-255,66,44946,64,265086
19468,0.000622,74.125.24.0-255,1484,46430,64,265086
19469,0.000644,74.125.24.0-255,4320,50750,64,265086
19470,0.000647,172.31.40.0-255,66,50816,64,265086
19471,0.000668,74.125.24.0-255,2902,53718,64,265086
19472,0.000671,172.31.40.0-255,66,53784,64,265086
19473,0.000692,74.125.24.0-255,4225,58009,64,265086
19474,0.000695,172.31.40.0-255,66,58075,64,265086
19475,0.000804,74.125.24.0-255,1484,59559,64,265086
19476,0.000818,74.125.24.0-255,2902,62461,64,265086
19477,0.000821,172.31.40.0-255,66,62527,64,265086
19478,0.000845,74.125.24.0-255,5738,68265,64,265086
19479,0.000848,172.31.40.0-255,66,68331,64,265086
19480,0.000873,74.125.24.0-255,2902,71233,64,265086
19481,0.000876,172.31.40.0-255,66,71299,64,265086
19482,0.000896,74.125.24.0-255,3961,75260,64,265086
19483,0.000899,172.31.40.0-255,66,75326,64,265086
19484,0.001326,74.125.24.0-255,1484,76810,64,265086
19485,0.001343,74.125.24.0-255,2902,79712,64,265086
19486,0.001347,172.31.40.0-255,66,79778,64,265086
19487,0.001368,74.125.24.0-255,4320,84098,64,265086
19488,0.00137,172.31.40.0-255,66,84164,64,265086
19489,0.001381,74.125.24.0-255,1484,85648,64,265086
19490,0.001391,172.31.40.0-255,66,85714,64,265086
19491,0.001404,74.125.24.0-255,4320,90034,64,265086
19492,0.001406,172.31.40.0-255,66,90100,64,265086
19493,0.001435,74.125.24.0-255,7156,97256,64,265086
19494,0.001437,172.31.40.0-255,66,97322,64,265086
19495,0.001463,74.125.24.0-255,3602,100924,64,265086
19496,0.001465,172.31.40.0-255,66,100990,64,265086
19497,0.001583,74.125.24.0-255,1484,102474,64,265086
19498,0.001587,74.125.24.0-255,1484,103958,64,265086
19499,0.001589,172.31.40.0-255,66,104024,64,265086
19500,0.001606,74.125.24.0-255,1484,105508,64,265086
19501,0.00161,74.125.24.0-255,2902,108410,64,265086
19502,0.001612,172.31.40.0-255,66,108476,64,265086
19503,0.001632,74.125.24.0-255,2902,111378,64,265086
19504,0.001634,172.31.40.0-255,66,111444,64,265086
19505,0.001642,74.125.24.0-255,7156,118600,64,265086
19506,0.001645,172.31.40.0-255,66,118666,64,265086
19507,0.00167,74.125.24.0-255,5738,124404,64,265086
19508,0.001674,172.31.40.0-255,66,124470,64,265086
19509,0.001681,74.125.24.0-255,7156,131626,64,265086
19510,0.001684,172.31.40.0-255,66,131692,64,265086
19511,0.001711,74.125.24.0-255,3602,135294,64,265086
19512,0.001714,172.31.40.0-255,66,135360,64,265086
19513,0.004219,74.125.24.0-255,1484,136844,64,265086
19514,0.004272,74.125.24.0-255,2902,139746,64,265086
19515,0.004276,172.31.40.0-255,66,139812,64,265086
19516,0.004295,74.125.24.0-255,1484,141296,64,265086
19517,0.00685,74.125.24.0-255,4320,145616,64,265086
19518,0.006854,172.31.40.0-255,66,145682,64,265086
19519,0.009421,74.125.24.0-255,5738,151420,64,265086
19520,0.009429,172.31.40.0-255,66,151486,64,265086
19521,0.011989,74.125.24.0-255,5738,157224,64,265086
19522,0.011997,172.31.40.0-255,66,157290,64,265086
19523,0.014623,74.125.24.0-255,5738,163028,64,265086
19524,0.01463,172.31.40.0-255,66,163094,64,265086
19525,0.01717,74.125.24.0-255,5738,168832,64,265086
19526,0.017183,172.31.40.0-255,66,168898,64,265086
19527,0.019741,74.125.24.0-255,5738,174636,64,265086
19528,0.019749,172.31.40.0-255,66,174702,64,265086
19529,0.022292,74.125.24.0-255,5738,180440,64,265086
19530,0.0223,172.31.40.0-255,66,180506,64,265086
19531,0.024885,74.125.24.0-255,5738,186244,64,265086
19532,0.024892,172.31.40.0-255,66,186310,64,265086
19533,0.025164,172.31.40.0-255,167,186477,64,265086
19534,0.025193,172.31.40.0-255,1107,187584,64,265086
19535,0.025248,172.31.40.0-255,1514,189098,64,265086
19536,0.025249,172.31.40.0-255,338,189436,64,265086
19537,0.026742,104.244.42.0-255,66,189502,64,265086
19538,0.026771,104.244.42.0-255,66,189568,64,265086
19539,0.026823,104.244.42.0-255,66,189634,64,265086
19540,0.027453,74.125.24.0-255,5738,195372,64,265086
19541,0.027459,172.31.40.0-255,66,195438,64,265086
19542,0.030027,74.125.24.0-255,5738,201176,64,265086
19543,0.030034,172.31.40.0-255,66,201242,64,265086
19544,0.032592,74.125.24.0-255,5738,206980,64,265086
19545,0.032599,172.31.40.0-255,66,207046,64,265086
19546,0.035162,74.125.24.0-255,5738,212784,64,265086
19547,0.035169,172.31.40.0-255,66,212850,64,265086
19548,0.037706,74.125.24.0-255,5738,218588,64,265086
19549,0.037713,172.31.40.0-255,66,218654,64,265086
19550,0.040284,74.125.24.0-255,5738,224392,64,265086
19551,0.0403,172.31.40.0-255,66,224458,64,265086
19552,0.042856,74.125.24.0-255,5738,230196,64,265086
19553,0.042874,172.31.40.0-255,66,230262,64,265086
19554,0.04545,74.125.24.0-255,5738,236000,64,265086
19555,0.045472,172.31.40.0-255,66,236066,64,265086
19556,0.048068,74.125.24.0-255,5738,241804,64,265086
19557,0.048074,172.31.40.0-255,66,241870,64,265086
19558,0.050636,74.125.24.0-255,5738,247608,64,265086
19559,0.050642,172.31.40.0-255,66,247674,64,265086
19560,0.053246,74.125.24.0-255,5738,253412,64,265086
19561,0.053254,172.31.40.0-255,66,253478,64,265086
19562,0.055791,74.125.24.0-255,5738,259216,64,265086
19563,0.055797,172.31.40.0-255,66,259282,64,265086
19564,0.058337,74.125.24.0-255,5738,265020,64,265086
19565,0.058343,172.31.40.0-255,66,265086,64,265086
19566,0.0,74.125.24.0-255,152,152,64,270273
19567,2.5e-05,172.31.40.0-255,66,218,64,270273
19568,3.1e-05,74.125.24.0-255,1484,1702,64,270273
19569,3.6e-05,172.31.40.0-255,66,1768,64,270273
19570,4e-05,74.125.24.0-255,1484,3252,64,270273
19571,5.1e-05,172.31.40.0-255,66,3318,64,270273
19572,5.7e-05,74.125.24.0-255,2902,6220,64,270273
19573,6.2e-05,172.31.40.0-255,66,6286,64,270273
19574,9.7e-05,74.125.24.0-255,5738,12024,64,270273
19575,0.0001,172.31.40.0-255,66,12090,64,270273
19576,0.000105,74.125.24.0-255,2000,14090,64,270273
19577,0.000107,172.31.40.0-255,66,14156,64,270273
19578,0.000147,74.125.24.0-255,2902,17058,64,270273
19579,0.00015,172.31.40.0-255,66,17124,64,270273
19580,0.000182,74.125.24.0-255,7156,24280,64,270273
19581,0.000185,172.31.40.0-255,66,24346,64,270273
19582,0.00019,74.125.24.0-255,4320,28666,64,270273
19583,0.000193,172.31.40.0-255,66,28732,64,270273
19584,0.000235,74.125.24.0-255,2543,31275,64,270273
19585,0.000238,172.31.40.0-255,66,31341,64,270273
19586,0.000341,74.125.24.0-255,1484,32825,64,270273
19587,0.000345,172.31.40.0-255,66,32891,64,270273
19588,0.00035,74.125.24.0-255,2902,35793,64,270273
19589,0.000353,172.31.40.0-255,66,35859,64,270273
19590,0.000381,74.125.24.0-255,4320,40179,64,270273
19591,0.000384,172.31.40.0-255,66,40245,64,270273
19592,0.000391,74.125.24.0-255,5738,45983,64,270273
19593,0.000394,172.31.40.0-255,66,46049,64,270273
19594,0.000429,172.31.40.0-255,66,46115,64,270273
19595,0.000436,74.125.24.0-255,6797,52912,64,270273
19596,0.000439,172.31.40.0-255,66,52978,64,270273
19597,0.000465,74.125.24.0-255,401,53379,64,270273
19598,0.000654,74.125.24.0-255,110,53489,64,270273
19599,0.000707,74.125.24.0-255,331,53820,64,270273
19600,0.001045,74.125.24.0-255,1484,55304,64,270273
19601,0.00105,172.31.40.0-255,66,55370,64,270273
19602,0.001056,74.125.24.0-255,2902,58272,64,270273
19603,0.001058,172.31.40.0-255,66,58338,64,270273
19604,0.001071,74.125.24.0-255,5738,64076,64,270273
19605,0.001074,172.31.40.0-255,66,64142,64,270273
19606,0.00108,74.125.24.0-255,5738,69880,64,270273
19607,0.001083,172.31.40.0-255,66,69946,64,270273
19608,0.001119,74.125.24.0-255,4320,74266,64,270273
19609,0.001122,172.31.40.0-255,66,74332,64,270273
19610,0.001148,74.125.24.0-255,5738,80070,64,270273
19611,0.001151,172.31.40.0-255,66,80136,64,270273
19612,0.001176,172.31.40.0-255,66,80202,64,270273
19613,0.001601,74.125.24.0-255,1484,81686,64,270273
19614,0.001608,74.125.24.0-255,2902,84588,64,270273
19615,0.001612,172.31.40.0-255,66,84654,64,270273
19616,0.001643,74.125.24.0-255,5738,90392,64,270273
19617,0.001645,172.31.40.0-255,66,90458,64,270273
19618,0.001657,172.31.40.0-255,66,90524,64,270273
19619,0.001712,74.125.24.0-255,7156,97680,64,270273
19620,0.001715,172.31.40.0-255,66,97746,64,270273
19621,0.001743,74.125.24.0-255,6438,104184,64,270273
19622,0.001746,172.31.40.0-255,66,104250,64,270273
19623,0.003739,74.125.24.0-255,5738,109988,64,270273
19624,0.003746,172.31.40.0-255,66,110054,64,270273
19625,0.005747,74.125.24.0-255,5738,115792,64,270273
19626,0.005751,172.31.40.0-255,66,115858,64,270273
19627,0.007748,74.125.24.0-255,5738,121596,64,270273
19628,0.007755,172.31.40.0-255,66,121662,64,270273
19629,0.009785,74.125.24.0-255,5738,127400,64,270273
19630,0.009795,172.31.40.0-255,66,127466,64,270273
19631,0.011812,74.125.24.0-255,5738,133204,64,270273
19632,0.01182,172.31.40.0-255,66,133270,64,270273
19633,0.013838,74.125.24.0-255,5738,139008,64,270273
19634,0.013846,172.31.40.0-255,66,139074,64,270273
19635,0.01587,74.125.24.0-255,5738,144812,64,270273
19636,0.015878,172.31.40.0-255,66,144878,64,270273
19637,0.017936,74.125.24.0-255,5738,150616,64,270273
19638,0.017943,172.31.40.0-255,66,150682,64,270273
19639,0.019938,74.125.24.0-255,5738,156420,64,270273
19640,0.019944,172.31.40.0-255,66,156486,64,270273
19641,0.020099,172.31.40.0-255,101,156587,64,270273
19642,0.02197,74.125.24.0-255,5738,162325,64,270273
19643,0.021977,172.31.40.0-255,66,162391,64,270273
19644,0.022066,74.125.24.0-255,66,162457,64,270273
19645,0.022641,172.31.40.0-255,187,162644,64,270273
19646,0.022673,172.31.40.0-255,1108,163752,64,270273
19647,0.022734,172.31.40.0-255,1514,165266,64,270273
19648,0.022736,172.31.40.0-255,337,165603,64,270273
19649,0.024002,74.125.24.0-255,5738,171341,64,270273
19650,0.024009,172.31.40.0-255,66,171407,64,270273
19651,0.024182,104.244.42.0-255,66,171473,64,270273
19652,0.024231,104.244.42.0-255,66,171539,64,270273
19653,0.024267,104.244.42.0-255,66,171605,64,270273
19654,0.026005,74.125.24.0-255,5738,177343,64,270273
19655,0.026011,172.31.40.0-255,66,177409,64,270273
19656,0.028042,74.125.24.0-255,5738,183147,64,270273
19657,0.028056,172.31.40.0-255,66,183213,64,270273
19658,0.030068,74.125.24.0-255,5738,188951,64,270273
19659,0.030074,172.31.40.0-255,66,189017,64,270273
19660,0.032106,74.125.24.0-255,5738,194755,64,270273
19661,0.032114,172.31.40.0-255,66,194821,64,270273
19662,0.034121,74.125.24.0-255,5738,200559,64,270273
19663,0.034128,172.31.40.0-255,66,200625,64,270273
19664,0.036127,74.125.24.0-255,5738,206363,64,270273
19665,0.036133,172.31.40.0-255,66,206429,64,270273
19666,0.038131,74.125.24.0-255,5738,212167,64,270273
19667,0.03814,172.31.40.0-255,66,212233,64,270273
19668,0.040165,74.125.24.0-255,5738,217971,64,270273
19669,0.040172,172.31.40.0-255,66,218037,64,270273
19670,0.042268,74.125.24.0-255,5738,223775,64,270273
19671,0.042274,172.31.40.0-255,66,223841,64,270273
19672,0.044366,74.125.24.0-255,5738,229579,64,270273
19673,0.044384,172.31.40.0-255,66,229645,64,270273
19674,0.046409,74.125.24.0-255,5738,235383,64,270273
19675,0.046428,172.31.40.0-255,66,235449,64,270273
19676,0.048458,74.125.24.0-255,5738,241187,64,270273
19677,0.048474,172.31.40.0-255,66,241253,64,270273
19678,0.050496,74.125.24.0-255,5738,246991,64,270273
19679,0.050513,172.31.40.0-255,66,247057,64,270273
19680,0.05254,74.125.24.0-255,5738,252795,64,270273
19681,0.052552,172.31.40.0-255,66,252861,64,270273
19682,0.054565,74.125.24.0-255,5738,258599,64,270273
19683,0.054583,172.31.40.0-255,66,258665,64,270273
19684,0.056596,74.125.24.0-255,5738,264403,64,270273
19685,0.056615,172.31.40.0-255,66,264469,64,270273
19686,0.058629,74.125.24.0-255,5738,270207,64,270273
19687,0.058645,172.31.40.0-255,66,270273,64,270273
19688,0.0,74.125.130.0-255,143,143,64,289923
19689,2.2e-05,172.31.40.0-255,66,209,64,289923
19690,2.9e-05,74.125.130.0-255,1484,1693,64,289923
19691,3.3e-05,172.31.40.0-255,66,1759,64,289923
19692,4.1e-05,74.125.130.0-255,2902,4661,64,289923
19693,4.6e-05,172.31.40.0-255,66,4727,64,289923
19694,7.3e-05,74.125.130.0-255,5738,10465,64,289923
19695,7.7e-05,172.31.40.0-255,66,10531,64,289923
19696,8e-05,74.125.130.0-255,1484,12015,64,289923
19697,8.2e-05,172.31.40.0-255,66,12081,64,289923
19698,8.7e-05,74.125.130.0-255,2068,14149,64,289923
19699,8.9e-05,172.31.40.0-255,66,14215,64,289923
19700,0.000194,74.125.130.0-255,1484,15699,64,289923
19701,0.000198,172.31.40.0-255,66,15765,64,289923
19702,0.000203,74.125.130.0-255,2902,18667,64,289923
19703,0.000206,172.31.40.0-255,66,18733,64,289923
19704,0.000211,74.125.130.0-255,2902,21635,64,289923
19705,0.000213,172.31.40.0-255,66,21701,64,289923
19706,0.000238,74.125.130.0-255,2902,24603,64,289923
19707,0.000241,172.31.40.0-255,66,24669,64,289923
19708,0.000245,74.125.130.0-255,2902,27571,64,289923
19709,0.000247,172.31.40.0-255,66,27637,64,289923
19710,0.000271,74.125.130.0-255,1484,29121,64,289923
19711,0.000273,172.31.40.0-255,66,29187,64,289923
19712,0.000288,74.125.130.0-255,2543,31730,64,289923
19713,0.00029,172.31.40.0-255,66,31796,64,289923
19714,0.000671,74.125.130.0-255,1484,33280,64,289923
19715,0.000676,172.31.40.0-255,66,33346,64,289923
19716,0.000682,74.125.130.0-255,2902,36248,64,289923
19717,0.000684,172.31.40.0-255,66,36314,64,289923
19718,0.000687,74.125.130.0-255,1484,37798,64,289923
19719,0.000688,172.31.40.0-255,66,37864,64,289923
19720,0.000692,74.125.130.0-255,1484,39348,64,289923
19721,0.000715,74.125.130.0-255,1484,40832,64,289923
19722,0.000717,172.31.40.0-255,66,40898,64,289923
19723,0.000724,74.125.130.0-255,5738,46636,64,289923
19724,0.000726,172.31.40.0-255,66,46702,64,289923
19725,0.000739,74.125.130.0-255,1484,48186,64,289923
19726,0.000755,74.125.130.0-255,2543,50729,64,289923
19727,0.000757,172.31.40.0-255,66,50795,64,289923
19728,0.000763,74.125.130.0-255,4320,55115,64,289923
19729,0.000765,172.31.40.0-255,66,55181,64,289923
19730,0.000772,74.125.130.0-255,7156,62337,64,289923
19731,0.000774,172.31.40.0-255,66,62403,64,289923
19732,0.000794,74.125.130.0-255,2902,65305,64,289923
19733,0.000796,172.31.40.0-255,66,65371,64,289923
19734,0.000799,74.125.130.0-255,1125,66496,64,289923
19735,0.000821,74.125.130.0-255,645,67141,64,289923
19736,0.000824,172.31.40.0-255,66,67207,64,289923
19737,0.00101,74.125.130.0-255,1484,68691,64,289923
19738,0.001015,74.125.130.0-255,2902,71593,64,289923
19739,0.001019,172.31.40.0-255,66,71659,64,289923
19740,0.001041,74.125.130.0-255,5738,77397,64,289923
19741,0.001044,172.31.40.0-255,66,77463,64,289923
19742,0.001072,74.125.130.0-255,1484,78947,64,289923
19743,0.001098,74.125.130.0-255,5738,84685,64,289923
19744,0.0011,172.31.40.0-255,66,84751,64,289923
19745,0.001113,172.31.40.0-255,66,84817,64,289923
19746,0.001144,74.125.130.0-255,4320,89137,64,289923
19747,0.001147,172.31.40.0-255,66,89203,64,289923
19748,0.001167,74.125.130.0-255,766,89969,64,289923
19749,0.001494,172.31.40.0-255,66,90035,64,289923
19750,0.001776,74.125.130.0-255,1484,91519,64,289923
19751,0.001786,74.125.130.0-255,1484,93003,64,289923
19752,0.00179,172.31.40.0-255,66,93069,64,289923
19753,0.001814,74.125.130.0-255,2902,95971,64,289923
19754,0.001816,172.31.40.0-255,66,96037,64,289923
19755,0.001848,74.125.130.0-255,4320,100357,64,289923
19756,0.001851,172.31.40.0-255,66,100423,64,289923
19757,0.001871,74.125.130.0-255,1484,101907,64,289923
19758,0.001879,74.125.130.0-255,7156,109063,64,289923
19759,0.001881,172.31.40.0-255,66,109129,64,289923
19760,0.001896,74.125.130.0-255,5738,114867,64,289923
19761,0.001899,172.31.40.0-255,66,114933,64,289923
19762,0.001923,74.125.130.0-255,2902,117835,64,289923
19763,0.001926,172.31.40.0-255,66,117901,64,289923
19764,0.001946,74.125.130.0-255,1484,119385,64,289923
19765,0.001964,74.125.130.0-255,5020,124405,64,289923
19766,0.001967,172.31.40.0-255,66,124471,64,289923
19767,0.003973,74.125.130.0-255,5738,130209,64,289923
19768,0.003981,172.31.40.0-255,66,130275,64,289923
19769,0.005985,74.125.130.0-255,5738,136013,64,289923
19770,0.005989,172.31.40.0-255,66,136079,64,289923
19771,0.007986,74.125.130.0-255,5738,141817,64,289923
19772,0.007992,172.31.40.0-255,66,141883,64,289923
19773,0.009989,74.125.130.0-255,5738,147621,64,289923
19774,0.009997,172.31.40.0-255,66,147687,64,289923
19775,0.012005,74.125.130.0-255,5738,153425,64,289923
19776,0.012013,172.31.40.0-255,66,153491,64,289923
19777,0.014,74.125.130.0-255,4320,157811,64,289923
19778,0.014008,172.31.40.0-255,66,157877,64,289923
19779,0.014031,74.125.130.0-255,1484,159361,64,289923
19780,0.01601,74.125.130.0-255,4320,163681,64,289923
19781,0.01602,172.31.40.0-255,66,163747,64,289923
19782,0.018018,74.125.130.0-255,5738,169485,64,289923
19783,0.018028,172.31.40.0-255,66,169551,64,289923
19784,0.020027,74.125.130.0-255,5738,175289,64,289923
19785,0.020034,172.31.40.0-255,66,175355,64,289923
19786,0.022031,74.125.130.0-255,5738,181093,64,289923
19787,0.02204,172.31.40.0-255,66,181159,64,289923
19788,0.024046,74.125.130.0-255,5738,186897,64,289923
19789,0.024054,172.31.40.0-255,66,186963,64,289923
19790,0.026046,74.125.130.0-255,5738,192701,64,289923
19791,0.026055,172.31.40.0-255,66,192767,64,289923
19792,0.028057,74.125.130.0-255,5738,198505,64,289923
19793,0.028065,172.31.40.0-255,66,198571,64,289923
19794,0.029257,172.31.40.0-255,172,198743,64,289923
19795,0.029292,172.31.40.0-255,1112,199855,64,289923
19796,0.029352,172.31.40.0-255,1514,201369,64,289923
19797,0.029354,172.31.40.0-255,1296,202665,64,289923
19798,0.030068,74.125.130.0-255,5738,208403,64,289923
19799,0.030075,172.31.40.0-255,66,208469,64,289923
19800,0.030789,104.244.42.0-255,66,208535,64,289923
19801,0.030834,104.244.42.0-255,66,208601,64,289923
19802,0.030941,104.244.42.0-255,66,208667,64,289923
19803,0.032078,74.125.130.0-255,5738,214405,64,289923
19804,0.032086,172.31.40.0-255,66,214471,64,289923
19805,0.034083,74.125.130.0-255,5738,220209,64,289923
19806,0.03409,172.31.40.0-255,66,220275,64,289923
19807,0.03609,74.125.130.0-255,5738,226013,64,289923
19808,0.036096,172.31.40.0-255,66,226079,64,289923
19809,0.038092,74.125.130.0-255,5738,231817,64,289923
19810,0.038098,172.31.40.0-255,66,231883,64,289923
19811,0.040098,74.125.130.0-255,5738,237621,64,289923
19812,0.040105,172.31.40.0-255,66,237687,64,289923
19813,0.042136,74.125.130.0-255,5738,243425,64,289923
19814,0.042143,172.31.40.0-255,66,243491,64,289923
19815,0.04416,74.125.130.0-255,5738,249229,64,289923
19816,0.044176,172.31.40.0-255,66,249295,64,289923
19817,0.046221,74.125.130.0-255,5738,255033,64,289923
19818,0.046234,172.31.40.0-255,66,255099,64,289923
19819,0.048239,74.125.130.0-255,5738,260837,64,289923
19820,0.048253,172.31.40.0-255,66,260903,64,289923
19821,0.050251,74.125.130.0-255,5738,266641,64,289923
19822,0.050259,172.31.40.0-255,66,266707,64,289923
19823,0.052272,74.125.130.0-255,5738,272445,64,289923
19824,0.052287,172.31.40.0-255,66,272511,64,289923
19825,0.054295,74.125.130.0-255,5738,278249,64,289923
19826,0.054312,172.31.40.0-255,66,278315,64,289923
19827,0.056325,74.125.130.0-255,5738,284053,64,289923
19828,0.056341,172.31.40.0-255,66,284119,64,289923
19829,0.058344,74.125.130.0-255,5738,289857,64,289923
19830,0.058359,172.31.40.0-255,66,289923,64,289923
19831,0.0,172.217.26.0-255,153,153,64,298753
19832,2.4e-05,172.31.40.0-255,66,219,64,298753
19833,3.2e-05,172.217.26.0-255,1484,1703,64,298753
19834,3.6e-05,172.31.40.0-255,66,1769,64,298753
19835,5e-05,172.217.26.0-255,2902,4671,64,298753
19836,5.4e-05,172.31.40.0-255,66,4737,64,298753
19837,6e-05,172.217.26.0-255,4320,9057,64,298753
19838,6.3e-05,172.31.40.0-255,66,9123,64,298753
19839,9e-05,172.217.26.0-255,5738,14861,64,298753
19840,9.3e-05,172.31.40.0-255,66,14927,64,298753
19841,0.000126,172.217.26.0-255,3485,18412,64,298753
19842,0.000128,172.31.40.0-255,66,18478,64,298753
19843,0.00014,172.31.40.0-255,66,18544,64,298753
19844,0.000145,172.217.26.0-255,2902,21446,64,298753
19845,0.000147,172.31.40.0-255,66,21512,64,298753
19846,0.000178,172.217.26.0-255,1125,22637,64,298753
19847,0.000181,172.31.40.0-255,66,22703,64,298753
19848,0.000211,172.217.26.0-255,1484,24187,64,298753
19849,0.000213,172.31.40.0-255,66,24253,64,298753
19850,0.000218,172.217.26.0-255,2902,27155,64,298753
19851,0.000221,172.31.40.0-255,66,27221,64,298753
19852,0.000257,172.217.26.0-255,5738,32959,64,298753
19853,0.00026,172.31.40.0-255,66,33025,64,298753
19854,0.000266,172.217.26.0-255,5738,38763,64,298753
19855,0.000268,172.31.40.0-255,66,38829,64,298753
19856,0.000278,172.217.26.0-255,4320,43149,64,298753
19857,0.00028,172.31.40.0-255,66,43215,64,298753
19858,0.000303,172.217.26.0-255,2543,45758,64,298753
19859,0.000306,172.31.40.0-255,66,45824,64,298753
19860,0.000313,172.217.26.0-255,7156,52980,64,298753
19861,0.000315,172.31.40.0-255,66,53046,64,298753
19862,0.000345,172.217.26.0-255,4231,57277,64,298753
19863,0.000348,172.31.40.0-255,66,57343,64,298753
19864,0.000896,172.217.26.0-255,385,57728,64,298753
19865,0.001039,172.31.40.0-255,66,57794,64,298753
19866,0.001096,172.217.26.0-255,1484,59278,64,298753
19867,0.001145,172.217.26.0-255,1484,60762,64,298753
19868,0.001149,172.31.40.0-255,66,60828,64,298753
19869,0.001154,172.217.26.0-255,2902,63730,64,298753
19870,0.001156,172.31.40.0-255,66,63796,64,298753
19871,0.001159,172.217.26.0-255,1484,65280,64,298753
19872,0.001185,172.217.26.0-255,1484,66764,64,298753
19873,0.001188,172.31.40.0-255,66,66830,64,298753
19874,0.001211,172.217.26.0-255,2902,69732,64,298753
19875,0.001214,172.31.40.0-255,66,69798,64,298753
19876,0.001217,172.217.26.0-255,1484,71282,64,298753
19877,0.00122,172.217.26.0-255,1484,72766,64,298753
19878,0.001222,172.31.40.0-255,66,72832,64,298753
19879,0.00124,172.217.26.0-255,1484,74316,64,298753
19880,0.001279,172.217.26.0-255,2543,76859,64,298753
19881,0.001283,172.31.40.0-255,66,76925,64,298753
19882,0.001309,172.217.26.0-255,1484,78409,64,298753
19883,0.001321,172.217.26.0-255,1484,79893,64,298753
19884,0.001324,172.31.40.0-255,66,79959,64,298753
19885,0.001357,172.217.26.0-255,1484,81443,64,298753
19886,0.001375,172.217.26.0-255,2902,84345,64,298753
19887,0.001377,172.31.40.0-255,66,84411,64,298753
19888,0.001381,172.217.26.0-255,1484,85895,64,298753
19889,0.001408,172.217.26.0-255,4320,90215,64,298753
19890,0.001411,172.31.40.0-255,66,90281,64,298753
19891,0.001446,172.217.26.0-255,2543,92824,64,298753
19892,0.00145,172.31.40.0-255,66,92890,64,298753
19893,0.00161,172.217.26.0-255,1484,94374,64,298753
19894,0.001617,172.217.26.0-255,2902,97276,64,298753
19895,0.00162,172.31.40.0-255,66,97342,64,298753
19896,0.001677,172.217.26.0-255,5738,103080,64,298753
19897,0.001681,172.31.40.0-255,66,103146,64,298753
19898,0.001692,172.31.40.0-255,66,103212,64,298753
19899,0.001708,172.31.40.0-255,66,103278,64,298753
19900,0.001752,172.217.26.0-255,5020,108298,64,298753
19901,0.001754,172.31.40.0-255,66,108364,64,298753
19902,0.00194,172.217.26.0-255,1484,109848,64,298753
19903,0.001947,172.217.26.0-255,2902,112750,64,298753
19904,0.00195,172.31.40.0-255,66,112816,64,298753
19905,0.001955,172.217.26.0-255,2902,115718,64,298753
19906,0.001957,172.31.40.0-255,66,115784,64,298753
19907,0.001981,172.217.26.0-255,2902,118686,64,298753
19908,0.001983,172.31.40.0-255,66,118752,64,298753
19909,0.002,172.31.40.0-255,66,118818,64,298753
19910,0.002007,172.217.26.0-255,5738,124556,64,298753
19911,0.002009,172.31.40.0-255,66,124622,64,298753
19912,0.003978,172.217.26.0-255,5738,130360,64,298753
19913,0.003986,172.31.40.0-255,66,130426,64,298753
19914,0.006032,172.217.26.0-255,5738,136164,64,298753
19915,0.006036,172.31.40.0-255,66,136230,64,298753
19916,0.008002,172.217.26.0-255,5738,141968,64,298753
19917,0.008008,172.31.40.0-255,66,142034,64,298753
19918,0.009985,172.217.26.0-255,5738,147772,64,298753
19919,0.009991,172.31.40.0-255,66,147838,64,298753
19920,0.01197,172.217.26.0-255,5738,153576,64,298753
19921,0.011979,172.31.40.0-255,66,153642,64,298753
19922,0.013957,172.217.26.0-255,5738,159380,64,298753
19923,0.013966,172.31.40.0-255,66,159446,64,298753
19924,0.015942,172.217.26.0-255,5738,165184,64,298753
19925,0.01595,172.31.40.0-255,66,165250,64,298753
19926,0.01794,172.217.26.0-255,5738,170988,64,298753
19927,0.017947,172.31.40.0-255,66,171054,64,298753
19928,0.019919,172.217.26.0-255,5738,176792,64,298753
19929,0.019926,172.31.40.0-255,66,176858,64,298753
19930,0.021905,172.217.26.0-255,4320,181178,64,298753
19931,0.021912,172.31.40.0-255,66,181244,64,298753
19932,0.021939,172.217.26.0-255,1484,182728,64,298753
19933,0.023884,172.217.26.0-255,4320,187048,64,298753
19934,0.023892,172.31.40.0-255,66,187114,64,298753
19935,0.025865,172.217.26.0-255,5738,192852,64,298753
19936,0.025872,172.31.40.0-255,66,192918,64,298753
19937,0.027846,172.217.26.0-255,5738,198656,64,298753
19938,0.027854,172.31.40.0-255,66,198722,64,298753
19939,0.028831,172.31.40.0-255,172,198894,64,298753
19940,0.028865,172.31.40.0-255,1112,200006,64,298753
19941,0.028943,172.31.40.0-255,1514,201520,64,298753
19942,0.028945,172.31.40.0-255,1514,203034,64,298753
19943,0.028946,172.31.40.0-255,1514,204548,64,298753
19944,0.028973,172.31.40.0-255,1077,205625,64,298753
19945,0.029825,172.217.26.0-255,5738,211363,64,298753
19946,0.029832,172.31.40.0-255,66,211429,64,298753
19947,0.030395,104.244.42.0-255,66,211495,64,298753
19948,0.030446,104.244.42.0-255,66,211561,64,298753
19949,0.030495,104.244.42.0-255,66,211627,64,298753
19950,0.03055,104.244.42.0-255,66,211693,64,298753
19951,0.031812,172.217.26.0-255,5738,217431,64,298753
19952,0.031817,172.31.40.0-255,66,217497,64,298753
19953,0.0338,172.217.26.0-255,5738,223235,64,298753
19954,0.033817,172.31.40.0-255,66,223301,64,298753
19955,0.035806,172.217.26.0-255,5738,229039,64,298753
19956,0.035819,172.31.40.0-255,66,229105,64,298753
19957,0.037803,172.217.26.0-255,5738,234843,64,298753
19958,0.037818,172.31.40.0-255,66,234909,64,298753
19959,0.039806,172.217.26.0-255,5738,240647,64,298753
19960,0.039821,172.31.40.0-255,66,240713,64,298753
19961,0.041799,172.217.26.0-255,5738,246451,64,298753
19962,0.041811,172.31.40.0-255,66,246517,64,298753
19963,0.043784,172.217.26.0-255,5738,252255,64,298753
19964,0.043797,172.31.40.0-255,66,252321,64,298753
19965,0.045813,172.217.26.0-255,5738,258059,64,298753
19966,0.045823,172.31.40.0-255,66,258125,64,298753
19967,0.047806,172.217.26.0-255,5738,263863,64,298753
19968,0.047821,172.31.40.0-255,66,263929,64,298753
19969,0.0498,172.217.26.0-255,5738,269667,64,298753
19970,0.049816,172.31.40.0-255,66,269733,64,298753
19971,0.051809,172.217.26.0-255,5738,275471,64,298753
19972,0.051824,172.31.40.0-255,66,275537,64,298753
19973,0.0538,172.217.26.0-255,5738,281275,64,298753
19974,0.053808,172.31.40.0-255,66,281341,64,298753
19975,0.055801,172.217.26.0-255,5738,287079,64,298753
19976,0.055816,172.31.40.0-255,66,287145,64,298753
19977,0.057798,172.217.26.0-255,5738,292883,64,298753
19978,0.057813,172.31.40.0-255,66,292949,64,298753
19979,0.059804,172.217.26.0-255,5738,298687,64,298753
19980,0.059817,172.31.40.0-255,66,298753,64,298753
19981,0.0,74.125.130.0-255,152,152,64,247543
19982,2.2e-05,172.31.40.0-255,66,218,64,247543
19983,2.9e-05,74.125.130.0-255,1484,1702,64,247543
19984,3.2e-05,172.31.40.0-255,66,1768,64,247543
19985,3.7e-05,74.125.130.0-255,2902,4670,64,247543
19986,4e-05,172.31.40.0-255,66,4736,64,247543
19987,6e-05,74.125.130.0-255,4320,9056,64,247543
19988,6.3e-05,172.31.40.0-255,66,9122,64,247543
19989,8.3e-05,74.125.130.0-255,2902,12024,64,247543
19990,8.5e-05,172.31.40.0-255,66,12090,64,247543
19991,8.9e-05,74.125.130.0-255,2902,14992,64,247543
19992,9.1e-05,172.31.40.0-255,66,15058,64,247543
19993,0.000109,74.125.130.0-255,1938,16996,64,247543
19994,0.000111,172.31.40.0-255,66,17062,64,247543
19995,0.000124,74.125.130.0-255,1484,18546,64,247543
19996,0.000126,172.31.40.0-255,66,18612,64,247543
19997,0.000147,74.125.130.0-255,4320,22932,64,247543
19998,0.000149,172.31.40.0-255,66,22998,64,247543
19999,0.000153,74.125.130.0-255,2902,25900,64,247543
20000,0.000155,172.31.40.0-255,66,25966,64,247543
20001,0.000178,74.125.130.0-255,5379,31345,64,247543
20002,0.00018,172.31.40.0-255,66,31411,64,247543
20003,0.000244,74.125.130.0-255,1484,32895,64,247543
20004,0.000248,172.31.40.0-255,66,32961,64,247543
20005,0.000252,74.125.130.0-255,2902,35863,64,247543
20006,0.000254,172.31.40.0-255,66,35929,64,247543
20007,0.00028,74.125.130.0-255,4320,40249,64,247543
20008,0.000282,172.31.40.0-255,66,40315,64,247543
20009,0.000302,74.125.130.0-255,1484,41799,64,247543
20010,0.000304,172.31.40.0-255,66,41865,64,247543
20011,0.000318,172.31.40.0-255,66,41931,64,247543
20012,0.00043,172.31.40.0-255,66,41997,64,247543
20013,0.001301,74.125.130.0-255,646,42643,64,247543
20014,0.001418,74.125.130.0-255,1484,44127,64,247543
20015,0.001423,172.31.40.0-255,66,44193,64,247543
20016,0.001429,74.125.130.0-255,2902,47095,64,247543
20017,0.001449,74.125.130.0-255,5738,52833,64,247543
20018,0.001455,74.125.130.0-255,7156,59989,64,247543
20019,0.001484,74.125.130.0-255,5738,65727,64,247543
20020,0.001505,74.125.130.0-255,2184,67911,64,247543
20021,0.001665,74.125.130.0-255,1484,69395,64,247543
20022,0.001681,74.125.130.0-255,1484,70879,64,247543
20023,0.001697,74.125.130.0-255,1484,72363,64,247543
20024,0.001701,74.125.130.0-255,2902,75265,64,247543
20025,0.001713,74.125.130.0-255,2902,78167,64,247543
20026,0.00173,74.125.130.0-255,7156,85323,64,247543
20027,0.001747,74.125.130.0-255,4320,89643,64,247543
20028,0.001774,74.125.130.0-255,2184,91827,64,247543
20029,0.001848,74.125.130.0-255,1484,93311,64,247543
20030,0.001853,74.125.130.0-255,2902,96213,64,247543
20031,0.001874,74.125.130.0-255,5738,101951,64,247543
20032,0.001917,74.125.130.0-255,1484,103435,64,247543
20033,0.001932,74.125.130.0-255,7156,110591,64,247543
20034,0.001958,74.125.130.0-255,2184,112775,64,247543
20035,0.003704,172.31.40.0-255,66,112841,64,247543
20036,0.005745,74.125.130.0-255,5738,118579,64,247543
20037,0.005751,172.31.40.0-255,66,118645,64,247543
20038,0.007765,74.125.130.0-255,5738,124383,64,247543
20039,0.007773,172.31.40.0-255,66,124449,64,247543
20040,0.009798,74.125.130.0-255,5738,130187,64,247543
20041,0.009806,172.31.40.0-255,66,130253,64,247543
20042,0.011808,74.125.130.0-255,5738,135991,64,247543
20043,0.011816,172.31.40.0-255,66,136057,64,247543
20044,0.013837,74.125.130.0-255,5738,141795,64,247543
20045,0.013846,172.31.40.0-255,66,141861,64,247543
20046,0.01589,74.125.130.0-255,5738,147599,64,247543
20047,0.015898,172.31.40.0-255,66,147665,64,247543
20048,0.017908,74.125.130.0-255,5738,153403,64,247543
20049,0.017915,172.31.40.0-255,66,153469,64,247543
20050,0.019926,74.125.130.0-255,5738,159207,64,247543
20051,0.019932,172.31.40.0-255,66,159273,64,247543
20052,0.021952,74.125.130.0-255,5738,165011,64,247543
20053,0.02196,172.31.40.0-255,66,165077,64,247543
20054,0.024012,74.125.130.0-255,5738,170815,64,247543
20055,0.02402,172.31.40.0-255,66,170881,64,247543
20056,0.026048,74.125.130.0-255,4320,175201,64,247543
20057,0.026057,172.31.40.0-255,66,175267,64,247543
20058,0.026078,74.125.130.0-255,1484,176751,64,247543
20059,0.028071,74.125.130.0-255,2902,179653,64,247543
20060,0.028078,172.31.40.0-255,66,179719,64,247543
20061,0.0281,74.125.130.0-255,1484,181203,64,247543
20062,0.030095,74.125.130.0-255,4320,185523,64,247543
20063,0.03032,172.31.40.0-255,166,185689,64,247543
20064,0.03035,172.31.40.0-255,1135,186824,64,247543
20065,0.030401,172.31.40.0-255,66,186890,64,247543
20066,0.030473,172.31.40.0-255,1514,188404,64,247543
20067,0.030475,172.31.40.0-255,1514,189918,64,247543
20068,0.030505,172.31.40.0-255,673,190591,64,247543
20069,0.031864,104.244.42.0-255,66,190657,64,247543
20070,0.03191,104.244.42.0-255,66,190723,64,247543
20071,0.032059,104.244.42.0-255,66,190789,64,247543
20072,0.032064,104.244.42.0-255,66,190855,64,247543
20073,0.032422,74.125.130.0-255,4320,195175,64,247543
20074,0.032428,172.31.40.0-255,66,195241,64,247543
20075,0.032455,74.125.130.0-255,1484,196725,64,247543
20076,0.034458,74.125.130.0-255,4320,201045,64,247543
20077,0.034464,172.31.40.0-255,66,201111,64,247543
20078,0.036482,74.125.130.0-255,5738,206849,64,247543
20079,0.043797,172.31.40.0-255,66,206915,64,247543
20080,0.04503,74.125.130.0-255,1484,208399,64,247543
20081,0.045816,74.125.130.0-255,4320,212719,64,247543
20082,0.045824,172.31.40.0-255,66,212785,64,247543
20083,0.04784,74.125.130.0-255,5738,218523,64,247543
20084,0.047883,172.31.40.0-255,66,218589,64,247543
20085,0.0499,74.125.130.0-255,5738,224327,64,247543
20086,0.049906,172.31.40.0-255,66,224393,64,247543
20087,0.051938,74.125.130.0-255,5738,230131,64,247543
20088,0.051953,172.31.40.0-255,66,230197,64,247543
20089,0.053981,74.125.130.0-255,5738,235935,64,247543
20090,0.053993,172.31.40.0-255,66,236001,64,247543
20091,0.056008,74.125.130.0-255,5738,241739,64,247543
20092,0.056017,172.31.40.0-255,66,241805,64,247543
20093,0.058068,74.125.130.0-255,5738,247543,64,247543
20094,0.0,172.217.194.0-255,150,150,64,299252
20095,1.4e-05,172.31.40.0-255,66,216,64,299252
20096,1.9e-05,172.217.194.0-255,1484,1700,64,299252
20097,2.3e-05,172.31.40.0-255,66,1766,64,299252
20098,4.3e-05,172.217.194.0-255,2902,4668,64,299252
20099,4.6e-05,172.31.40.0-255,66,4734,64,299252
20100,5e-05,172.217.194.0-255,2902,7636,64,299252
20101,5.2e-05,172.31.40.0-255,66,7702,64,299252
20102,7.2e-05,172.217.194.0-255,4320,12022,64,299252
20103,7.5e-05,172.31.40.0-255,66,12088,64,299252
20104,7.9e-05,172.217.194.0-255,2127,14215,64,299252
20105,8.2e-05,172.31.40.0-255,66,14281,64,299252
20106,8.6e-05,172.217.194.0-255,2902,17183,64,299252
20107,8.8e-05,172.31.40.0-255,66,17249,64,299252
20108,9.5e-05,172.217.194.0-255,5738,22987,64,299252
20109,9.8e-05,172.31.40.0-255,66,23053,64,299252
20110,0.000117,172.217.194.0-255,1484,24537,64,299252
20111,0.00012,172.31.40.0-255,66,24603,64,299252
20112,0.000128,172.217.194.0-255,6797,31400,64,299252
20113,0.000131,172.31.40.0-255,66,31466,64,299252
20114,0.000423,172.217.194.0-255,1484,32950,64,299252
20115,0.00043,172.31.40.0-255,66,33016,64,299252
20116,0.000436,172.217.194.0-255,2902,35918,64,299252
20117,0.000439,172.31.40.0-255,66,35984,64,299252
20118,0.000441,172.217.194.0-255,1484,37468,64,299252
20119,0.000443,172.31.40.0-255,66,37534,64,299252
20120,0.000464,172.217.194.0-255,4320,41854,64,299252
20121,0.000467,172.31.40.0-255,66,41920,64,299252
20122,0.000471,172.217.194.0-255,2902,44822,64,299252
20123,0.000473,172.31.40.0-255,66,44888,64,299252
20124,0.000494,172.217.194.0-255,5379,50267,64,299252
20125,0.000497,172.31.40.0-255,66,50333,64,299252
20126,0.000508,172.31.40.0-255,66,50399,64,299252
20127,0.000538,172.217.194.0-255,7086,57485,64,299252
20128,0.000542,172.31.40.0-255,66,57551,64,299252
20129,0.000806,172.217.194.0-255,98,57649,64,299252
20130,0.000964,172.217.194.0-255,1484,59133,64,299252
20131,0.000969,172.31.40.0-255,66,59199,64,299252
20132,0.000975,172.217.194.0-255,2902,62101,64,299252
20133,0.000978,172.31.40.0-255,66,62167,64,299252
20134,0.000981,172.217.194.0-255,1484,63651,64,299252
20135,0.001007,172.217.194.0-255,4320,67971,64,299252
20136,0.00101,172.31.40.0-255,66,68037,64,299252
20137,0.001023,172.31.40.0-255,66,68103,64,299252
20138,0.001045,172.217.194.0-255,4320,72423,64,299252
20139,0.001047,172.31.40.0-255,66,72489,64,299252
20140,0.001075,172.217.194.0-255,5738,78227,64,299252
20141,0.001079,172.31.40.0-255,66,78293,64,299252
20142,0.001083,172.217.194.0-255,2543,80836,64,299252
20143,0.001085,172.31.40.0-255,66,80902,64,299252
20144,0.00155,172.217.194.0-255,1484,82386,64,299252
20145,0.001556,172.217.194.0-255,2902,85288,64,299252
20146,0.001561,172.31.40.0-255,66,85354,64,299252
20147,0.001568,172.217.194.0-255,5738,91092,64,299252
20148,0.00157,172.31.40.0-255,66,91158,64,299252
20149,0.001581,172.31.40.0-255,66,91224,64,299252
20150,0.001591,172.31.40.0-255,66,91290,64,299252
20151,0.001736,172.217.194.0-255,1484,92774,64,299252
20152,0.001754,172.217.194.0-255,2902,95676,64,299252
20153,0.001758,172.31.40.0-255,66,95742,64,299252
20154,0.001764,172.217.194.0-255,5738,101480,64,299252
20155,0.001766,172.31.40.0-255,66,101546,64,299252
20156,0.001789,172.217.194.0-255,1484,103030,64,299252
20157,0.001808,172.31.40.0-255,66,103096,64,299252
20158,0.001825,172.217.194.0-255,1484,104580,64,299252
20159,0.001838,172.217.194.0-255,2902,107482,64,299252
20160,0.001841,172.31.40.0-255,66,107548,64,299252
20161,0.001869,172.31.40.0-255,66,107614,64,299252
20162,0.001904,172.217.194.0-255,1484,109098,64,299252
20163,0.001908,172.217.194.0-255,1484,110582,64,299252
20164,0.00191,172.31.40.0-255,66,110648,64,299252
20165,0.001927,172.217.194.0-255,1484,112132,64,299252
20166,0.001933,172.217.194.0-255,4320,116452,64,299252
20167,0.001936,172.31.40.0-255,66,116518,64,299252
20168,0.00195,172.217.194.0-255,1484,118002,64,299252
20169,0.001956,172.217.194.0-255,5738,123740,64,299252
20170,0.001958,172.31.40.0-255,66,123806,64,299252
20171,0.001964,172.217.194.0-255,4320,128126,64,299252
20172,0.001966,172.31.40.0-255,66,128192,64,299252
20173,0.002001,172.31.40.0-255,66,128258,64,299252
20174,0.002006,172.217.194.0-255,5020,133278,64,299252
20175,0.002008,172.31.40.0-255,66,133344,64,299252
20176,0.004026,172.217.194.0-255,5738,139082,64,299252
20177,0.004031,172.31.40.0-255,66,139148,64,299252
20178,0.006076,172.217.194.0-255,5738,144886,64,299252
20179,0.006082,172.31.40.0-255,66,144952,64,299252
20180,0.0081,172.217.194.0-255,5738,150690,64,299252
20181,0.00811,172.31.40.0-255,66,150756,64,299252
20182,0.010123,172.217.194.0-255,5738,156494,64,299252
20183,0.010129,172.31.40.0-255,66,156560,64,299252
20184,0.012147,172.217.194.0-255,5738,162298,64,299252
20185,0.012155,172.31.40.0-255,66,162364,64,299252
20186,0.014171,172.217.194.0-255,5738,168102,64,299252
20187,0.014179,172.31.40.0-255,66,168168,64,299252
20188,0.016226,172.217.194.0-255,5738,173906,64,299252
20189,0.016233,172.31.40.0-255,66,173972,64,299252
20190,0.018234,172.217.194.0-255,5738,179710,64,299252
20191,0.018242,172.31.40.0-255,66,179776,64,299252
20192,0.01843,172.31.40.0-255,172,179948,64,299252
20193,0.018458,172.31.40.0-255,1107,181055,64,299252
20194,0.018498,172.31.40.0-255,1514,182569,64,299252
20195,0.018499,172.31.40.0-255,339,182908,64,299252
20196,0.019994,104.244.42.0-255,66,182974,64,299252
20197,0.020001,104.244.42.0-255,66,183040,64,299252
20198,0.020035,104.244.42.0-255,66,183106,64,299252
20199,0.020256,172.217.194.0-255,5738,188844,64,299252
20200,0.020262,172.31.40.0-255,66,188910,64,299252
20201,0.022288,172.217.194.0-255,5738,194648,64,299252
20202,0.022298,172.31.40.0-255,66,194714,64,299252
20203,0.02432,172.217.194.0-255,5738,200452,64,299252
20204,0.02433,172.31.40.0-255,66,200518,64,299252
20205,0.026332,172.217.194.0-255,5738,206256,64,299252
20206,0.026339,172.31.40.0-255,66,206322,64,299252
20207,0.028395,172.217.194.0-255,5738,212060,64,299252
20208,0.028402,172.31.40.0-255,66,212126,64,299252
20209,0.030411,172.217.194.0-255,5738,217864,64,299252
20210,0.030419,172.31.40.0-255,66,217930,64,299252
20211,0.032453,172.217.194.0-255,5738,223668,64,299252
20212,0.032459,172.31.40.0-255,66,223734,64,299252
20213,0.034477,172.217.194.0-255,5738,229472,64,299252
20214,0.034483,172.31.40.0-255,66,229538,64,299252
20215,0.036486,172.217.194.0-255,5738,235276,64,299252
20216,0.036492,172.31.40.0-255,66,235342,64,299252
20217,0.038517,172.217.194.0-255,5738,241080,64,299252
20218,0.038522,172.31.40.0-255,66,241146,64,299252
20219,0.040537,172.217.194.0-255,5738,246884,64,299252
20220,0.040543,172.31.40.0-255,66,246950,64,299252
20221,0.042529,172.217.194.0-255,5738,252688,64,299252
20222,0.042535,172.31.40.0-255,66,252754,64,299252
20223,0.044567,172.217.194.0-255,5738,258492,64,299252
20224,0.044573,172.31.40.0-255,66,258558,64,299252
20225,0.046619,172.217.194.0-255,5738,264296,64,299252
20226,0.046624,172.31.40.0-255,66,264362,64,299252
20227,0.048623,172.217.194.0-255,5738,270100,64,299252
20228,0.048629,172.31.40.0-255,66,270166,64,299252
20229,0.050627,172.217.194.0-255,5738,275904,64,299252
20230,0.050634,172.31.40.0-255,66,275970,64,299252
20231,0.052635,172.217.194.0-255,5738,281708,64,299252
20232,0.05264,172.31.40.0-255,66,281774,64,299252
20233,0.054655,172.217.194.0-255,5738,287512,64,299252
20234,0.05466,172.31.40.0-255,66,287578,64,299252
20235,0.056664,172.217.194.0-255,5738,293316,64,299252
20236,0.056669,172.31.40.0-255,66,293382,64,299252
20237,0.058684,172.217.194.0-255,4320,297702,64,299252
20238,0.058689,172.31.40.0-255,66,297768,64,299252
20239,0.058718,172.217.194.0-255,1484,299252,64,299252
20240,0.0,216.58.221.0-255,152,152,64,268850
20241,2.5e-05,172.31.40.0-255,66,218,64,268850
20242,3.1e-05,216.58.221.0-255,1484,1702,64,268850
20243,3.6e-05,172.31.40.0-255,66,1768,64,268850
20244,5e-05,216.58.221.0-255,2902,4670,64,268850
20245,5.4e-05,172.31.40.0-255,66,4736,64,268850
20246,5.9e-05,216.58.221.0-255,4320,9056,64,268850
20247,6.2e-05,172.31.40.0-255,66,9122,64,268850
20248,7.5e-05,172.31.40.0-255,66,9188,64,268850
20249,8.7e-05,172.31.40.0-255,66,9254,64,268850
20250,0.000141,216.58.221.0-255,3961,13215,64,268850
20251,0.000144,172.31.40.0-255,66,13281,64,268850
20252,0.00023,216.58.221.0-255,1484,14765,64,268850
20253,0.000234,172.31.40.0-255,66,14831,64,268850
20254,0.00024,216.58.221.0-255,2902,17733,64,268850
20255,0.000243,172.31.40.0-255,66,17799,64,268850
20256,0.000255,216.58.221.0-255,5738,23537,64,268850
20257,0.000257,172.31.40.0-255,66,23603,64,268850
20258,0.000285,216.58.221.0-255,2902,26505,64,268850
20259,0.000288,172.31.40.0-255,66,26571,64,268850
20260,0.000316,216.58.221.0-255,3961,30532,64,268850
20261,0.000319,172.31.40.0-255,66,30598,64,268850
20262,0.000792,216.58.221.0-255,1484,32082,64,268850
20263,0.000798,172.31.40.0-255,66,32148,64,268850
20264,0.000804,216.58.221.0-255,2902,35050,64,268850
20265,0.000807,172.31.40.0-255,66,35116,64,268850
20266,0.00082,216.58.221.0-255,5738,40854,64,268850
20267,0.000823,172.31.40.0-255,66,40920,64,268850
20268,0.000852,216.58.221.0-255,1484,42404,64,268850
20269,0.000855,172.31.40.0-255,66,42470,64,268850
20270,0.000878,216.58.221.0-255,5670,48140,64,268850
20271,0.000881,172.31.40.0-255,66,48206,64,268850
20272,0.001335,216.58.221.0-255,1484,49690,64,268850
20273,0.001355,216.58.221.0-255,1484,51174,64,268850
20274,0.001359,172.31.40.0-255,66,51240,64,268850
20275,0.001365,216.58.221.0-255,2902,54142,64,268850
20276,0.001367,172.31.40.0-255,66,54208,64,268850
20277,0.001378,216.58.221.0-255,5738,59946,64,268850
20278,0.00138,172.31.40.0-255,66,60012,64,268850
20279,0.001414,216.58.221.0-255,5379,65391,64,268850
20280,0.001417,172.31.40.0-255,66,65457,64,268850
20281,0.001444,216.58.221.0-255,4320,69777,64,268850
20282,0.001447,172.31.40.0-255,66,69843,64,268850
20283,0.00145,216.58.221.0-255,1484,71327,64,268850
20284,0.001454,216.58.221.0-255,2902,74229,64,268850
20285,0.001455,172.31.40.0-255,66,74295,64,268850
20286,0.001459,216.58.221.0-255,2902,77197,64,268850
20287,0.001461,172.31.40.0-255,66,77263,64,268850
20288,0.001491,216.58.221.0-255,2902,80165,64,268850
20289,0.001494,172.31.40.0-255,66,80231,64,268850
20290,0.001498,216.58.221.0-255,2283,82514,64,268850
20291,0.001499,172.31.40.0-255,66,82580,64,268850
20292,0.001527,216.58.221.0-255,2902,85482,64,268850
20293,0.001529,172.31.40.0-255,66,85548,64,268850
20294,0.001536,216.58.221.0-255,7156,92704,64,268850
20295,0.001538,172.31.40.0-255,66,92770,64,268850
20296,0.001566,216.58.221.0-255,4320,97090,64,268850
20297,0.001568,172.31.40.0-255,66,97156,64,268850
20298,0.001592,216.58.221.0-255,2429,99585,64,268850
20299,0.001594,172.31.40.0-255,66,99651,64,268850
20300,0.00351,216.58.221.0-255,2902,102553,64,268850
20301,0.003515,172.31.40.0-255,66,102619,64,268850
20302,0.003539,216.58.221.0-255,2902,105521,64,268850
20303,0.003541,172.31.40.0-255,66,105587,64,268850
20304,0.005458,216.58.221.0-255,2902,108489,64,268850
20305,0.005462,172.31.40.0-255,66,108555,64,268850
20306,0.00548,216.58.221.0-255,2902,111457,64,268850
20307,0.005483,172.31.40.0-255,66,111523,64,268850
20308,0.007417,216.58.221.0-255,4320,115843,64,268850
20309,0.007429,172.31.40.0-255,66,115909,64,268850
20310,0.007492,216.58.221.0-255,1484,117393,64,268850
20311,0.009388,216.58.221.0-255,4320,121713,64,268850
20312,0.009403,172.31.40.0-255,66,121779,64,268850
20313,0.011367,216.58.221.0-255,5738,127517,64,268850
20314,0.011377,172.31.40.0-255,66,127583,64,268850
20315,0.013343,216.58.221.0-255,5738,133321,64,268850
20316,0.013356,172.31.40.0-255,66,133387,64,268850
20317,0.015309,216.58.221.0-255,5738,139125,64,268850
20318,0.015322,172.31.40.0-255,66,139191,64,268850
20319,0.017275,216.58.221.0-255,5738,144929,64,268850
20320,0.017286,172.31.40.0-255,66,144995,64,268850
20321,0.019234,216.58.221.0-255,5738,150733,64,268850
20322,0.019241,172.31.40.0-255,66,150799,64,268850
20323,0.019589,172.31.40.0-255,166,150965,64,268850
20324,0.019631,172.31.40.0-255,1131,152096,64,268850
20325,0.019703,172.31.40.0-255,1514,153610,64,268850
20326,0.019705,172.31.40.0-255,314,153924,64,268850
20327,0.021182,216.58.221.0-255,5738,159662,64,268850
20328,0.021189,172.31.40.0-255,66,159728,64,268850
20329,0.02122,104.244.42.0-255,66,159794,64,268850
20330,0.021225,104.244.42.0-255,66,159860,64,268850
20331,0.021262,104.244.42.0-255,66,159926,64,268850
20332,0.023134,216.58.221.0-255,5738,165664,64,268850
20333,0.02314,172.31.40.0-255,66,165730,64,268850
20334,0.025081,216.58.221.0-255,5738,171468,64,268850
20335,0.025091,172.31.40.0-255,66,171534,64,268850
20336,0.02703,216.58.221.0-255,5738,177272,64,268850
20337,0.027036,172.31.40.0-255,66,177338,64,268850
20338,0.02898,216.58.221.0-255,5738,183076,64,268850
20339,0.028987,172.31.40.0-255,66,183142,64,268850
20340,0.030943,216.58.221.0-255,5738,188880,64,268850
20341,0.030953,172.31.40.0-255,66,188946,64,268850
20342,0.032889,216.58.221.0-255,5738,194684,64,268850
20343,0.032895,172.31.40.0-255,66,194750,64,268850
20344,0.03484,216.58.221.0-255,4320,199070,64,268850
20345,0.034846,172.31.40.0-255,66,199136,64,268850
20346,0.034941,216.58.221.0-255,1484,200620,64,268850
20347,0.036793,216.58.221.0-255,4320,204940,64,268850
20348,0.036798,172.31.40.0-255,66,205006,64,268850
20349,0.038755,216.58.221.0-255,5738,210744,64,268850
20350,0.038762,172.31.40.0-255,66,210810,64,268850
20351,0.040712,216.58.221.0-255,5738,216548,64,268850
20352,0.040725,172.31.40.0-255,66,216614,64,268850
20353,0.042756,216.58.221.0-255,5738,222352,64,268850
20354,0.042763,172.31.40.0-255,66,222418,64,268850
20355,0.044718,216.58.221.0-255,5738,228156,64,268850
20356,0.044729,172.31.40.0-255,66,228222,64,268850
20357,0.046692,216.58.221.0-255,5738,233960,64,268850
20358,0.046699,172.31.40.0-255,66,234026,64,268850
20359,0.048689,216.58.221.0-255,5738,239764,64,268850
20360,0.048707,172.31.40.0-255,66,239830,64,268850
20361,0.050678,216.58.221.0-255,5738,245568,64,268850
20362,0.050694,172.31.40.0-255,66,245634,64,268850
20363,0.052661,216.58.221.0-255,5738,251372,64,268850
20364,0.052677,172.31.40.0-255,66,251438,64,268850
20365,0.054648,216.58.221.0-255,5738,257176,64,268850
20366,0.054666,172.31.40.0-255,66,257242,64,268850
20367,0.05665,216.58.221.0-255,5738,262980,64,268850
20368,0.056659,172.31.40.0-255,66,263046,64,268850
20369,0.058604,216.58.221.0-255,5738,268784,64,268850
20370,0.058612,172.31.40.0-255,66,268850,64,268850
20371,0.0,172.31.40.0-255,105,105,64,459
20372,0.000262,172.31.40.0-255,90,195,64,459
20373,0.000272,172.31.40.0-255,66,261,64,459
20374,0.003301,74.125.24.0-255,66,327,64,459
20375,0.00342,74.125.24.0-255,66,393,64,459
20376,0.003444,172.31.40.0-255,66,459,64,459
20377,0.0,172.217.194.0-255,152,152,64,138934
20378,1.3e-05,172.31.40.0-255,66,218,64,138934
20379,2e-05,172.217.194.0-255,1484,1702,64,138934
20380,2.4e-05,172.31.40.0-255,66,1768,64,138934
20381,2.9e-05,172.217.194.0-255,2902,4670,64,138934
20382,3.1e-05,172.31.40.0-255,66,4736,64,138934
20383,3.8e-05,172.217.194.0-255,7156,11892,64,138934
20384,4e-05,172.31.40.0-255,66,11958,64,138934
20385,8.2e-05,172.217.194.0-255,2017,13975,64,138934
20386,8.4e-05,172.31.40.0-255,66,14041,64,138934
20387,0.000138,172.217.194.0-255,1484,15525,64,138934
20388,0.000141,172.31.40.0-255,66,15591,64,138934
20389,0.000145,172.217.194.0-255,2902,18493,64,138934
20390,0.000147,172.31.40.0-255,66,18559,64,138934
20391,0.00015,172.217.194.0-255,1484,20043,64,138934
20392,0.000151,172.31.40.0-255,66,20109,64,138934
20393,0.000178,172.217.194.0-255,4320,24429,64,138934
20394,0.00018,172.31.40.0-255,66,24495,64,138934
20395,0.000194,172.217.194.0-255,4320,28815,64,138934
20396,0.000196,172.31.40.0-255,66,28881,64,138934
20397,0.000221,172.31.40.0-255,66,28947,64,138934
20398,0.000233,172.31.40.0-255,66,29013,64,138934
20399,0.000272,172.31.40.0-255,66,29079,64,138934
20400,0.000275,172.217.194.0-255,400,29479,64,138934
20401,0.000276,172.31.40.0-255,66,29545,64,138934
20402,0.000368,172.217.194.0-255,376,29921,64,138934
20403,0.000371,172.31.40.0-255,66,29987,64,138934
20404,0.000664,172.217.194.0-255,1484,31471,64,138934
20405,0.000668,172.31.40.0-255,66,31537,64,138934
20406,0.000673,172.217.194.0-255,2902,34439,64,138934
20407,0.000675,172.31.40.0-255,66,34505,64,138934
20408,0.000687,172.217.194.0-255,1484,35989,64,138934
20409,0.000701,172.217.194.0-255,4320,40309,64,138934
20410,0.000703,172.31.40.0-255,66,40375,64,138934
20411,0.000706,172.217.194.0-255,1484,41859,64,138934
20412,0.000748,172.31.40.0-255,66,41925,64,138934
20413,0.000775,172.217.194.0-255,4320,46245,64,138934
20414,0.000787,172.31.40.0-255,66,46311,64,138934
20415,0.00079,172.31.40.0-255,66,46377,64,138934
20416,0.001329,172.217.194.0-255,1484,47861,64,138934
20417,0.001346,172.217.194.0-255,2902,50763,64,138934
20418,0.00135,172.31.40.0-255,66,50829,64,138934
20419,0.001358,172.217.194.0-255,5738,56567,64,138934
20420,0.00136,172.31.40.0-255,66,56633,64,138934
20421,0.001394,172.217.194.0-255,7156,63789,64,138934
20422,0.001397,172.31.40.0-255,66,63855,64,138934
20423,0.001407,172.31.40.0-255,66,63921,64,138934
20424,0.001455,172.31.40.0-255,66,63987,64,138934
20425,0.001486,172.217.194.0-255,1484,65471,64,138934
20426,0.00149,172.217.194.0-255,1484,66955,64,138934
20427,0.001492,172.31.40.0-255,66,67021,64,138934
20428,0.001511,172.217.194.0-255,1484,68505,64,138934
20429,0.001517,172.217.194.0-255,5738,74243,64,138934
20430,0.001519,172.31.40.0-255,66,74309,64,138934
20431,0.001523,172.217.194.0-255,2902,77211,64,138934
20432,0.001525,172.31.40.0-255,66,77277,64,138934
20433,0.001552,172.217.194.0-255,5738,83015,64,138934
20434,0.001554,172.31.40.0-255,66,83081,64,138934
20435,0.001593,172.217.194.0-255,2902,85983,64,138934
20436,0.001596,172.31.40.0-255,66,86049,64,138934
20437,0.001619,172.217.194.0-255,5738,91787,64,138934
20438,0.001621,172.31.40.0-255,66,91853,64,138934
20439,0.001649,172.217.194.0-255,6438,98291,64,138934
20440,0.001652,172.31.40.0-255,66,98357,64,138934
20441,0.001667,172.31.40.0-255,66,98423,64,138934
20442,0.001682,172.31.40.0-255,66,98489,64,138934
20443,0.001687,172.217.194.0-255,3602,102091,64,138934
20444,0.001688,172.31.40.0-255,66,102157,64,138934
20445,0.001732,172.217.194.0-255,4320,106477,64,138934
20446,0.001736,172.31.40.0-255,66,106543,64,138934
20447,0.001767,172.31.40.0-255,66,106609,64,138934
20448,0.001782,172.31.40.0-255,66,106675,64,138934
20449,0.001787,172.217.194.0-255,4320,110995,64,138934
20450,0.001789,172.31.40.0-255,66,111061,64,138934
20451,0.001817,172.31.40.0-255,66,111127,64,138934
20452,0.001835,172.31.40.0-255,66,111193,64,138934
20453,0.001866,172.31.40.0-255,66,111259,64,138934
20454,0.001869,172.217.194.0-255,766,112025,64,138934
20455,0.001887,172.217.194.0-255,7156,119181,64,138934
20456,0.00189,172.31.40.0-255,66,119247,64,138934
20457,0.001928,172.31.40.0-255,66,119313,64,138934
20458,0.00194,172.31.40.0-255,66,119379,64,138934
20459,0.001996,172.217.194.0-255,4320,123699,64,138934
20460,0.001999,172.31.40.0-255,66,123765,64,138934
20461,0.00203,172.217.194.0-255,7156,130921,64,138934
20462,0.002165,172.217.194.0-255,4473,135394,64,138934
20463,0.002193,172.217.194.0-255,105,135499,64,138934
20464,0.006637,172.31.40.0-255,66,135565,64,138934
20465,0.009147,172.31.40.0-255,105,135670,64,138934
20466,0.011666,172.217.194.0-255,66,135736,64,138934
20467,0.048891,172.31.40.0-255,172,135908,64,138934
20468,0.048923,172.31.40.0-255,1108,137016,64,138934
20469,0.048982,172.31.40.0-255,1514,138530,64,138934
20470,0.048984,172.31.40.0-255,338,138868,64,138934
20471,0.051109,104.244.42.0-255,66,138934,64,138934
20472,0.0,74.125.200.0-255,153,153,64,388505
20473,3.6e-05,172.31.40.0-255,66,219,64,388505
20474,4.4e-05,74.125.200.0-255,1484,1703,64,388505
20475,4.9e-05,172.31.40.0-255,66,1769,64,388505
20476,5.5e-05,74.125.200.0-255,2902,4671,64,388505
20477,5.9e-05,172.31.40.0-255,66,4737,64,388505
20478,6.4e-05,74.125.200.0-255,4320,9057,64,388505
20479,6.7e-05,172.31.40.0-255,66,9123,64,388505
20480,7.1e-05,74.125.200.0-255,2902,12025,64,388505
20481,7.4e-05,172.31.40.0-255,66,12091,64,388505
20482,0.000104,74.125.200.0-255,6275,18366,64,388505
20483,0.000108,172.31.40.0-255,66,18432,64,388505
20484,0.000118,172.31.40.0-255,66,18498,64,388505
20485,0.000134,74.125.200.0-255,1484,19982,64,388505
20486,0.000137,172.31.40.0-255,66,20048,64,388505
20487,0.000141,74.125.200.0-255,2543,22591,64,388505
20488,0.000143,172.31.40.0-255,66,22657,64,388505
20489,0.000164,74.125.200.0-255,1484,24141,64,388505
20490,0.000167,172.31.40.0-255,66,24207,64,388505
20491,0.000188,74.125.200.0-255,2902,27109,64,388505
20492,0.000192,172.31.40.0-255,66,27175,64,388505
20493,0.000196,74.125.200.0-255,2902,30077,64,388505
20494,0.000198,172.31.40.0-255,66,30143,64,388505
20495,0.000212,74.125.200.0-255,2902,33045,64,388505
20496,0.000215,172.31.40.0-255,66,33111,64,388505
20497,0.00022,74.125.200.0-255,2902,36013,64,388505
20498,0.000222,172.31.40.0-255,66,36079,64,388505
20499,0.000246,74.125.200.0-255,3961,40040,64,388505
20500,0.000249,172.31.40.0-255,66,40106,64,388505
20501,0.000409,74.125.200.0-255,1484,41590,64,388505
20502,0.000415,172.31.40.0-255,66,41656,64,388505
20503,0.000438,74.125.200.0-255,2902,44558,64,388505
20504,0.00044,172.31.40.0-255,66,44624,64,388505
20505,0.000448,74.125.200.0-255,5738,50362,64,388505
20506,0.00045,172.31.40.0-255,66,50428,64,388505
20507,0.000454,74.125.200.0-255,2902,53330,64,388505
20508,0.000456,172.31.40.0-255,66,53396,64,388505
20509,0.000523,74.125.200.0-255,4543,57939,64,388505
20510,0.00054,172.31.40.0-255,66,58005,64,388505
20511,0.000868,74.125.200.0-255,1484,59489,64,388505
20512,0.000877,74.125.200.0-255,2902,62391,64,388505
20513,0.000882,172.31.40.0-255,66,62457,64,388505
20514,0.000887,74.125.200.0-255,2902,65359,64,388505
20515,0.000889,172.31.40.0-255,66,65425,64,388505
20516,0.000906,74.125.200.0-255,2902,68327,64,388505
20517,0.000908,172.31.40.0-255,66,68393,64,388505
20518,0.000922,74.125.200.0-255,4320,72713,64,388505
20519,0.000924,172.31.40.0-255,66,72779,64,388505
20520,0.000958,172.31.40.0-255,66,72845,64,388505
20521,0.000964,74.125.200.0-255,5738,78583,64,388505
20522,0.000966,172.31.40.0-255,66,78649,64,388505
20523,0.000988,74.125.200.0-255,2902,81551,64,388505
20524,0.000991,172.31.40.0-255,66,81617,64,388505
20525,0.001007,74.125.200.0-255,2184,83801,64,388505
20526,0.00101,172.31.40.0-255,66,83867,64,388505
20527,0.001109,74.125.200.0-255,1484,85351,64,388505
20528,0.001152,74.125.200.0-255,1484,86835,64,388505
20529,0.001156,172.31.40.0-255,66,86901,64,388505
20530,0.001173,74.125.200.0-255,1484,88385,64,388505
20531,0.001179,74.125.200.0-255,4320,92705,64,388505
20532,0.001182,172.31.40.0-255,66,92771,64,388505
20533,0.001187,74.125.200.0-255,5738,98509,64,388505
20534,0.00119,172.31.40.0-255,66,98575,64,388505
20535,0.001202,172.31.40.0-255,66,98641,64,388505
20536,0.001207,74.125.200.0-255,4320,102961,64,388505
20537,0.001209,172.31.40.0-255,66,103027,64,388505
20538,0.001251,74.125.200.0-255,3602,106629,64,388505
20539,0.001254,172.31.40.0-255,66,106695,64,388505
20540,0.001294,74.125.200.0-255,1484,108179,64,388505
20541,0.001312,74.125.200.0-255,2902,111081,64,388505
20542,0.001315,172.31.40.0-255,66,111147,64,388505
20543,0.001337,74.125.200.0-255,5738,116885,64,388505
20544,0.00134,172.31.40.0-255,66,116951,64,388505
20545,0.001343,74.125.200.0-255,2902,119853,64,388505
20546,0.001345,172.31.40.0-255,66,119919,64,388505
20547,0.001366,74.125.200.0-255,4320,124239,64,388505
20548,0.001369,172.31.40.0-255,66,124305,64,388505
20549,0.001372,74.125.200.0-255,1484,125789,64,388505
20550,0.001388,74.125.200.0-255,7156,132945,64,388505
20551,0.001391,172.31.40.0-255,66,133011,64,388505
20552,0.001397,74.125.200.0-255,5738,138749,64,388505
20553,0.0014,172.31.40.0-255,66,138815,64,388505
20554,0.001447,74.125.200.0-255,2184,140999,64,388505
20555,0.00145,172.31.40.0-255,66,141065,64,388505
20556,0.001659,74.125.200.0-255,1484,142549,64,388505
20557,0.001666,74.125.200.0-255,2902,145451,64,388505
20558,0.00167,172.31.40.0-255,66,145517,64,388505
20559,0.001674,74.125.200.0-255,1484,147001,64,388505
20560,0.001696,74.125.200.0-255,4320,151321,64,388505
20561,0.001699,172.31.40.0-255,66,151387,64,388505
20562,0.001704,74.125.200.0-255,4320,155707,64,388505
20563,0.001706,172.31.40.0-255,66,155773,64,388505
20564,0.001712,74.125.200.0-255,5738,161511,64,388505
20565,0.001715,172.31.40.0-255,66,161577,64,388505
20566,0.001742,74.125.200.0-255,7156,168733,64,388505
20567,0.001746,172.31.40.0-255,66,168799,64,388505
20568,0.00177,74.125.200.0-255,4320,173119,64,388505
20569,0.001773,172.31.40.0-255,66,173185,64,388505
20570,0.001777,74.125.200.0-255,2184,175369,64,388505
20571,0.00178,172.31.40.0-255,66,175435,64,388505
20572,0.001798,74.125.200.0-255,2902,178337,64,388505
20573,0.0018,172.31.40.0-255,66,178403,64,388505
20574,0.001828,74.125.200.0-255,4320,182723,64,388505
20575,0.001832,172.31.40.0-255,66,182789,64,388505
20576,0.001836,74.125.200.0-255,2902,185691,64,388505
20577,0.001838,172.31.40.0-255,66,185757,64,388505
20578,0.001861,74.125.200.0-255,5738,191495,64,388505
20579,0.001864,172.31.40.0-255,66,191561,64,388505
20580,0.00187,74.125.200.0-255,7156,198717,64,388505
20581,0.001873,172.31.40.0-255,66,198783,64,388505
20582,0.001878,74.125.200.0-255,4320,203103,64,388505
20583,0.00188,172.31.40.0-255,66,203169,64,388505
20584,0.001912,74.125.200.0-255,4320,207489,64,388505
20585,0.001915,172.31.40.0-255,66,207555,64,388505
20586,0.001919,74.125.200.0-255,2184,209739,64,388505
20587,0.001922,172.31.40.0-255,66,209805,64,388505
20588,0.001958,74.125.200.0-255,1484,211289,64,388505
20589,0.001976,74.125.200.0-255,2902,214191,64,388505
20590,0.00198,172.31.40.0-255,66,214257,64,388505
20591,0.002001,74.125.200.0-255,5738,219995,64,388505
20592,0.002004,172.31.40.0-255,66,220061,64,388505
20593,0.00396,74.125.200.0-255,5738,225799,64,388505
20594,0.003967,172.31.40.0-255,66,225865,64,388505
20595,0.005923,74.125.200.0-255,5738,231603,64,388505
20596,0.00593,172.31.40.0-255,66,231669,64,388505
20597,0.007877,74.125.200.0-255,4320,235989,64,388505
20598,0.00788,172.31.40.0-255,66,236055,64,388505
20599,0.0079,74.125.200.0-255,1484,237539,64,388505
20600,0.009854,74.125.200.0-255,4320,241859,64,388505
20601,0.009868,172.31.40.0-255,66,241925,64,388505
20602,0.011838,74.125.200.0-255,5738,247663,64,388505
20603,0.011851,172.31.40.0-255,66,247729,64,388505
20604,0.013833,74.125.200.0-255,5738,253467,64,388505
20605,0.013848,172.31.40.0-255,66,253533,64,388505
20606,0.015822,74.125.200.0-255,5738,259271,64,388505
20607,0.015835,172.31.40.0-255,66,259337,64,388505
20608,0.017833,74.125.200.0-255,5738,265075,64,388505
20609,0.017841,172.31.40.0-255,66,265141,64,388505
20610,0.019799,74.125.200.0-255,5738,270879,64,388505
20611,0.019811,172.31.40.0-255,66,270945,64,388505
20612,0.021774,74.125.200.0-255,5738,276683,64,388505
20613,0.021783,172.31.40.0-255,66,276749,64,388505
20614,0.023748,74.125.200.0-255,5738,282487,64,388505
20615,0.023756,172.31.40.0-255,66,282553,64,388505
20616,0.025711,74.125.200.0-255,5738,288291,64,388505
20617,0.02572,172.31.40.0-255,66,288357,64,388505
20618,0.027669,74.125.200.0-255,1484,289841,64,388505
20619,0.027691,74.125.200.0-255,4320,294161,64,388505
20620,0.027697,172.31.40.0-255,66,294227,64,388505
20621,0.029645,74.125.200.0-255,5738,299965,64,388505
20622,0.029652,172.31.40.0-255,66,300031,64,388505
20623,0.029737,172.31.40.0-255,101,300132,64,388505
20624,0.03161,74.125.200.0-255,5738,305870,64,388505
20625,0.031617,172.31.40.0-255,66,305936,64,388505
20626,0.031647,74.125.200.0-255,66,306002,64,388505
20627,0.033603,74.125.200.0-255,5738,311740,64,388505
20628,0.033618,172.31.40.0-255,66,311806,64,388505
20629,0.035576,74.125.200.0-255,5738,317544,64,388505
20630,0.035583,172.31.40.0-255,66,317610,64,388505
20631,0.037548,74.125.200.0-255,5738,323348,64,388505
20632,0.03758,172.31.40.0-255,66,323414,64,388505
20633,0.039534,74.125.200.0-255,5738,329152,64,388505
20634,0.039541,172.31.40.0-255,66,329218,64,388505
20635,0.041496,74.125.200.0-255,5738,334956,64,388505
20636,0.041509,172.31.40.0-255,66,335022,64,388505
20637,0.043194,172.31.40.0-255,172,335194,64,388505
20638,0.04323,172.31.40.0-255,1108,336302,64,388505
20639,0.043289,172.31.40.0-255,1514,337816,64,388505
20640,0.043291,172.31.40.0-255,337,338153,64,388505
20641,0.043463,74.125.200.0-255,5738,343891,64,388505
20642,0.04347,172.31.40.0-255,66,343957,64,388505
20643,0.045445,74.125.200.0-255,5738,349695,64,388505
20644,0.045459,172.31.40.0-255,66,349761,64,388505
20645,0.045612,104.244.42.0-255,66,349827,64,388505
20646,0.047418,74.125.200.0-255,5738,355565,64,388505
20647,0.04743,172.31.40.0-255,66,355631,64,388505
20648,0.049392,74.125.200.0-255,5738,361369,64,388505
20649,0.049408,172.31.40.0-255,66,361435,64,388505
20650,0.051372,74.125.200.0-255,5738,367173,64,388505
20651,0.051387,172.31.40.0-255,66,367239,64,388505
20652,0.053352,74.125.200.0-255,5738,372977,64,388505
20653,0.053367,172.31.40.0-255,66,373043,64,388505
20654,0.055342,74.125.200.0-255,5738,378781,64,388505
20655,0.055357,172.31.40.0-255,66,378847,64,388505
20656,0.05732,74.125.200.0-255,5738,384585,64,388505
20657,0.057328,172.31.40.0-255,66,384651,64,388505
20658,0.059295,74.125.200.0-255,3683,388334,64,388505
20659,0.059302,172.31.40.0-255,66,388400,64,388505
20660,0.059494,172.31.40.0-255,105,388505,64,388505
20661,0.0,74.125.68.0-255,153,153,64,240220
20662,1.5e-05,172.31.40.0-255,66,219,64,240220
20663,3.9e-05,74.125.68.0-255,1484,1703,64,240220
20664,4.4e-05,172.31.40.0-255,66,1769,64,240220
20665,4.8e-05,74.125.68.0-255,1484,3253,64,240220
20666,5.1e-05,172.31.40.0-255,66,3319,64,240220
20667,5.6e-05,74.125.68.0-255,2902,6221,64,240220
20668,5.9e-05,172.31.40.0-255,66,6287,64,240220
20669,8.8e-05,74.125.68.0-255,5738,12025,64,240220
20670,9e-05,172.31.40.0-255,66,12091,64,240220
20671,0.000111,74.125.68.0-255,1910,14001,64,240220
20672,0.000113,172.31.40.0-255,66,14067,64,240220
20673,0.000285,74.125.68.0-255,1484,15551,64,240220
20674,0.000291,172.31.40.0-255,66,15617,64,240220
20675,0.000295,74.125.68.0-255,1484,17101,64,240220
20676,0.000297,172.31.40.0-255,66,17167,64,240220
20677,0.000302,74.125.68.0-255,2902,20069,64,240220
20678,0.000304,172.31.40.0-255,66,20135,64,240220
20679,0.000331,74.125.68.0-255,4320,24455,64,240220
20680,0.000335,172.31.40.0-255,66,24521,64,240220
20681,0.000355,74.125.68.0-255,1484,26005,64,240220
20682,0.000357,172.31.40.0-255,66,26071,64,240220
20683,0.000363,74.125.68.0-255,4320,30391,64,240220
20684,0.000365,172.31.40.0-255,66,30457,64,240220
20685,0.000399,74.125.68.0-255,5379,35836,64,240220
20686,0.000402,172.31.40.0-255,66,35902,64,240220
20687,0.000419,74.125.68.0-255,2902,38804,64,240220
20688,0.000421,172.31.40.0-255,66,38870,64,240220
20689,0.000428,74.125.68.0-255,5738,44608,64,240220
20690,0.00043,172.31.40.0-255,66,44674,64,240220
20691,0.000453,74.125.68.0-255,3961,48635,64,240220
20692,0.000455,172.31.40.0-255,66,48701,64,240220
20693,0.000488,74.125.68.0-255,1484,50185,64,240220
20694,0.000495,74.125.68.0-255,2902,53087,64,240220
20695,0.000497,172.31.40.0-255,66,53153,64,240220
20696,0.000501,74.125.68.0-255,1484,54637,64,240220
20697,0.000516,74.125.68.0-255,2902,57539,64,240220
20698,0.000519,172.31.40.0-255,66,57605,64,240220
20699,0.000539,74.125.68.0-255,1484,59089,64,240220
20700,0.000563,74.125.68.0-255,4320,63409,64,240220
20701,0.000566,172.31.40.0-255,66,63475,64,240220
20702,0.00057,74.125.68.0-255,2543,66018,64,240220
20703,0.000573,172.31.40.0-255,66,66084,64,240220
20704,0.001046,74.125.68.0-255,413,66497,64,240220
20705,0.001081,74.125.68.0-255,330,66827,64,240220
20706,0.001141,172.31.40.0-255,66,66893,64,240220
20707,0.002039,74.125.68.0-255,1484,68377,64,240220
20708,0.002052,74.125.68.0-255,2902,71279,64,240220
20709,0.002057,172.31.40.0-255,66,71345,64,240220
20710,0.002065,74.125.68.0-255,4320,75665,64,240220
20711,0.002067,172.31.40.0-255,66,75731,64,240220
20712,0.002071,74.125.68.0-255,1484,77215,64,240220
20713,0.002092,74.125.68.0-255,4320,81535,64,240220
20714,0.002095,172.31.40.0-255,66,81601,64,240220
20715,0.002137,172.31.40.0-255,66,81667,64,240220
20716,0.002144,74.125.68.0-255,5738,87405,64,240220
20717,0.002146,172.31.40.0-255,66,87471,64,240220
20718,0.002167,74.125.68.0-255,2184,89655,64,240220
20719,0.002169,172.31.40.0-255,66,89721,64,240220
20720,0.00438,74.125.68.0-255,2902,92623,64,240220
20721,0.004388,172.31.40.0-255,66,92689,64,240220
20722,0.004411,74.125.68.0-255,2902,95591,64,240220
20723,0.004414,172.31.40.0-255,66,95657,64,240220
20724,0.006644,74.125.68.0-255,5738,101395,64,240220
20725,0.006655,172.31.40.0-255,66,101461,64,240220
20726,0.008911,74.125.68.0-255,5738,107199,64,240220
20727,0.008921,172.31.40.0-255,66,107265,64,240220
20728,0.011181,74.125.68.0-255,5738,113003,64,240220
20729,0.011194,172.31.40.0-255,66,113069,64,240220
20730,0.01346,74.125.68.0-255,5738,118807,64,240220
20731,0.013478,172.31.40.0-255,66,118873,64,240220
20732,0.015754,74.125.68.0-255,5738,124611,64,240220
20733,0.015765,172.31.40.0-255,66,124677,64,240220
20734,0.018035,74.125.68.0-255,5738,130415,64,240220
20735,0.018058,172.31.40.0-255,66,130481,64,240220
20736,0.02033,74.125.68.0-255,5738,136219,64,240220
20737,0.02035,172.31.40.0-255,66,136285,64,240220
20738,0.022614,74.125.68.0-255,5738,142023,64,240220
20739,0.022632,172.31.40.0-255,66,142089,64,240220
20740,0.024908,74.125.68.0-255,5738,147827,64,240220
20741,0.024923,172.31.40.0-255,66,147893,64,240220
20742,0.027182,74.125.68.0-255,5738,153631,64,240220
20743,0.027199,172.31.40.0-255,66,153697,64,240220
20744,0.029387,172.31.40.0-255,167,153864,64,240220
20745,0.029422,172.31.40.0-255,1111,154975,64,240220
20746,0.029455,74.125.68.0-255,5738,160713,64,240220
20747,0.029462,172.31.40.0-255,66,160779,64,240220
20748,0.029592,172.31.40.0-255,1514,162293,64,240220
20749,0.029594,172.31.40.0-255,1514,163807,64,240220
20750,0.029619,172.31.40.0-255,697,164504,64,240220
20751,0.030951,104.244.42.0-255,66,164570,64,240220
20752,0.030993,104.244.42.0-255,66,164636,64,240220
20753,0.031172,104.244.42.0-255,66,164702,64,240220
20754,0.031179,104.244.42.0-255,66,164768,64,240220
20755,0.031732,74.125.68.0-255,5738,170506,64,240220
20756,0.03174,172.31.40.0-255,66,170572,64,240220
20757,0.034008,74.125.68.0-255,5738,176310,64,240220
20758,0.034017,172.31.40.0-255,66,176376,64,240220
20759,0.036267,74.125.68.0-255,5738,182114,64,240220
20760,0.036276,172.31.40.0-255,66,182180,64,240220
20761,0.038533,74.125.68.0-255,5738,187918,64,240220
20762,0.038541,172.31.40.0-255,66,187984,64,240220
20763,0.040797,74.125.68.0-255,5738,193722,64,240220
20764,0.040805,172.31.40.0-255,66,193788,64,240220
20765,0.043059,74.125.68.0-255,5738,199526,64,240220
20766,0.043065,172.31.40.0-255,66,199592,64,240220
20767,0.045317,74.125.68.0-255,5738,205330,64,240220
20768,0.045323,172.31.40.0-255,66,205396,64,240220
20769,0.047572,74.125.68.0-255,5738,211134,64,240220
20770,0.04758,172.31.40.0-255,66,211200,64,240220
20771,0.049827,74.125.68.0-255,5738,216938,64,240220
20772,0.049833,172.31.40.0-255,66,217004,64,240220
20773,0.052095,74.125.68.0-255,5738,222742,64,240220
20774,0.052101,172.31.40.0-255,66,222808,64,240220
20775,0.054365,74.125.68.0-255,5738,228546,64,240220
20776,0.054372,172.31.40.0-255,66,228612,64,240220
20777,0.056631,74.125.68.0-255,5738,234350,64,240220
20778,0.056639,172.31.40.0-255,66,234416,64,240220
20779,0.058904,74.125.68.0-255,5738,240154,64,240220
20780,0.058916,172.31.40.0-255,66,240220,64,240220
20781,0.0,74.125.200.0-255,146,146,64,320457
20782,1.5e-05,172.31.40.0-255,66,212,64,320457
20783,4.6e-05,74.125.200.0-255,1484,1696,64,320457
20784,5.2e-05,172.31.40.0-255,66,1762,64,320457
20785,5.8e-05,74.125.200.0-255,2902,4664,64,320457
20786,6.1e-05,172.31.40.0-255,66,4730,64,320457
20787,9.1e-05,74.125.200.0-255,7156,11886,64,320457
20788,9.4e-05,172.31.40.0-255,66,11952,64,320457
20789,0.000125,74.125.200.0-255,2065,14017,64,320457
20790,0.000128,172.31.40.0-255,66,14083,64,320457
20791,0.000167,74.125.200.0-255,2902,16985,64,320457
20792,0.000171,172.31.40.0-255,66,17051,64,320457
20793,0.000198,74.125.200.0-255,4320,21371,64,320457
20794,0.000201,172.31.40.0-255,66,21437,64,320457
20795,0.000234,172.31.40.0-255,66,21503,64,320457
20796,0.000237,74.125.200.0-255,1125,22628,64,320457
20797,0.000239,172.31.40.0-255,66,22694,64,320457
20798,0.000357,74.125.200.0-255,1484,24178,64,320457
20799,0.000362,172.31.40.0-255,66,24244,64,320457
20800,0.000367,74.125.200.0-255,2902,27146,64,320457
20801,0.000369,172.31.40.0-255,66,27212,64,320457
20802,0.000392,74.125.200.0-255,4320,31532,64,320457
20803,0.000395,172.31.40.0-255,66,31598,64,320457
20804,0.000401,74.125.200.0-255,5738,37336,64,320457
20805,0.000404,172.31.40.0-255,66,37402,64,320457
20806,0.000447,74.125.200.0-255,7156,44558,64,320457
20807,0.000449,172.31.40.0-255,66,44624,64,320457
20808,0.00048,74.125.200.0-255,5379,50003,64,320457
20809,0.000483,172.31.40.0-255,66,50069,64,320457
20810,0.000516,74.125.200.0-255,4320,54389,64,320457
20811,0.000518,172.31.40.0-255,66,54455,64,320457
20812,0.000536,74.125.200.0-255,2817,57272,64,320457
20813,0.000539,172.31.40.0-255,66,57338,64,320457
20814,0.000541,74.125.200.0-255,131,57469,64,320457
20815,0.000606,74.125.200.0-255,1484,58953,64,320457
20816,0.000609,172.31.40.0-255,66,59019,64,320457
20817,0.000635,74.125.200.0-255,2902,61921,64,320457
20818,0.000638,172.31.40.0-255,66,61987,64,320457
20819,0.00064,74.125.200.0-255,1484,63471,64,320457
20820,0.000643,74.125.200.0-255,1484,64955,64,320457
20821,0.000644,172.31.40.0-255,66,65021,64,320457
20822,0.000672,74.125.200.0-255,1484,66505,64,320457
20823,0.000678,74.125.200.0-255,5738,72243,64,320457
20824,0.00068,172.31.40.0-255,66,72309,64,320457
20825,0.000685,74.125.200.0-255,4320,76629,64,320457
20826,0.000687,172.31.40.0-255,66,76695,64,320457
20827,0.000708,74.125.200.0-255,4320,81015,64,320457
20828,0.00071,172.31.40.0-255,66,81081,64,320457
20829,0.000722,74.125.200.0-255,766,81847,64,320457
20830,0.000725,172.31.40.0-255,66,81913,64,320457
20831,0.000756,74.125.200.0-255,347,82260,64,320457
20832,0.000787,74.125.200.0-255,1484,83744,64,320457
20833,0.000789,172.31.40.0-255,66,83810,64,320457
20834,0.000802,74.125.200.0-255,4320,88130,64,320457
20835,0.000808,172.31.40.0-255,66,88196,64,320457
20836,0.000849,74.125.200.0-255,7156,95352,64,320457
20837,0.000852,172.31.40.0-255,66,95418,64,320457
20838,0.000878,74.125.200.0-255,5738,101156,64,320457
20839,0.00088,172.31.40.0-255,66,101222,64,320457
20840,0.000905,74.125.200.0-255,2902,104124,64,320457
20841,0.000908,172.31.40.0-255,66,104190,64,320457
20842,0.000913,74.125.200.0-255,4320,108510,64,320457
20843,0.000915,172.31.40.0-255,66,108576,64,320457
20844,0.000924,74.125.200.0-255,5738,114314,64,320457
20845,0.000926,172.31.40.0-255,66,114380,64,320457
20846,0.00093,74.125.200.0-255,2184,116564,64,320457
20847,0.000932,172.31.40.0-255,66,116630,64,320457
20848,0.001007,74.125.200.0-255,1484,118114,64,320457
20849,0.00101,74.125.200.0-255,1484,119598,64,320457
20850,0.001018,172.31.40.0-255,66,119664,64,320457
20851,0.001022,74.125.200.0-255,1484,121148,64,320457
20852,0.001046,74.125.200.0-255,5738,126886,64,320457
20853,0.001049,172.31.40.0-255,66,126952,64,320457
20854,0.001054,74.125.200.0-255,4320,131272,64,320457
20855,0.001056,172.31.40.0-255,66,131338,64,320457
20856,0.001078,74.125.200.0-255,2902,134240,64,320457
20857,0.001081,172.31.40.0-255,66,134306,64,320457
20858,0.001094,74.125.200.0-255,5738,140044,64,320457
20859,0.0011,172.31.40.0-255,66,140110,64,320457
20860,0.001119,74.125.200.0-255,7156,147266,64,320457
20861,0.001122,172.31.40.0-255,66,147332,64,320457
20862,0.001147,74.125.200.0-255,3602,150934,64,320457
20863,0.001149,172.31.40.0-255,66,151000,64,320457
20864,0.001192,74.125.200.0-255,1484,152484,64,320457
20865,0.00121,74.125.200.0-255,2902,155386,64,320457
20866,0.001213,172.31.40.0-255,66,155452,64,320457
20867,0.001216,74.125.200.0-255,1484,156936,64,320457
20868,0.001239,74.125.200.0-255,4320,161256,64,320457
20869,0.001242,172.31.40.0-255,66,161322,64,320457
20870,0.001247,74.125.200.0-255,5738,167060,64,320457
20871,0.001249,172.31.40.0-255,66,167126,64,320457
20872,0.001291,74.125.200.0-255,7156,174282,64,320457
20873,0.001294,172.31.40.0-255,66,174348,64,320457
20874,0.001301,74.125.200.0-255,7156,181504,64,320457
20875,0.001302,172.31.40.0-255,66,181570,64,320457
20876,0.001343,74.125.200.0-255,3602,185172,64,320457
20877,0.001346,172.31.40.0-255,66,185238,64,320457
20878,0.001448,74.125.200.0-255,1484,186722,64,320457
20879,0.001459,74.125.200.0-255,1484,188206,64,320457
20880,0.001462,172.31.40.0-255,66,188272,64,320457
20881,0.001484,74.125.200.0-255,1484,189756,64,320457
20882,0.001487,74.125.200.0-255,1484,191240,64,320457
20883,0.001489,172.31.40.0-255,66,191306,64,320457
20884,0.001502,74.125.200.0-255,4320,195626,64,320457
20885,0.001508,172.31.40.0-255,66,195692,64,320457
20886,0.001511,74.125.200.0-255,1484,197176,64,320457
20887,0.001515,74.125.200.0-255,2902,200078,64,320457
20888,0.001516,172.31.40.0-255,66,200144,64,320457
20889,0.00155,74.125.200.0-255,5738,205882,64,320457
20890,0.001553,172.31.40.0-255,66,205948,64,320457
20891,0.00156,74.125.200.0-255,7156,213104,64,320457
20892,0.001562,172.31.40.0-255,66,213170,64,320457
20893,0.001598,74.125.200.0-255,1484,214654,64,320457
20894,0.001615,74.125.200.0-255,5020,219674,64,320457
20895,0.001618,172.31.40.0-255,66,219740,64,320457
20896,0.001744,74.125.200.0-255,1484,221224,64,320457
20897,0.001749,74.125.200.0-255,2902,224126,64,320457
20898,0.001752,172.31.40.0-255,66,224192,64,320457
20899,0.001757,74.125.200.0-255,4320,228512,64,320457
20900,0.00176,172.31.40.0-255,66,228578,64,320457
20901,0.001823,172.31.40.0-255,66,228644,64,320457
20902,0.001829,74.125.200.0-255,7156,235800,64,320457
20903,0.001831,172.31.40.0-255,66,235866,64,320457
20904,0.00184,172.31.40.0-255,66,235932,64,320457
20905,0.001842,74.125.200.0-255,766,236698,64,320457
20906,0.001906,74.125.200.0-255,1484,238182,64,320457
20907,0.00191,172.31.40.0-255,66,238248,64,320457
20908,0.001927,74.125.200.0-255,2902,241150,64,320457
20909,0.001929,172.31.40.0-255,66,241216,64,320457
20910,0.001931,74.125.200.0-255,1484,242700,64,320457
20911,0.001957,74.125.200.0-255,4320,247020,64,320457
20912,0.001959,172.31.40.0-255,66,247086,64,320457
20913,0.001964,74.125.200.0-255,2902,249988,64,320457
20914,0.001965,172.31.40.0-255,66,250054,64,320457
20915,0.00197,74.125.200.0-255,4320,254374,64,320457
20916,0.001971,172.31.40.0-255,66,254440,64,320457
20917,0.001996,172.31.40.0-255,66,254506,64,320457
20918,0.002001,74.125.200.0-255,4320,258826,64,320457
20919,0.002003,172.31.40.0-255,66,258892,64,320457
20920,0.002031,74.125.200.0-255,3602,262494,64,320457
20921,0.002034,172.31.40.0-255,66,262560,64,320457
20922,0.002044,172.31.40.0-255,66,262626,64,320457
20923,0.002049,74.125.200.0-255,4320,266946,64,320457
20924,0.002061,172.31.40.0-255,66,267012,64,320457
20925,0.002073,74.125.200.0-255,1484,268496,64,320457
20926,0.002078,74.125.200.0-255,4320,272816,64,320457
20927,0.002084,172.31.40.0-255,66,272882,64,320457
20928,0.002106,74.125.200.0-255,2902,275784,64,320457
20929,0.002131,74.125.200.0-255,1484,277268,64,320457
20930,0.002136,172.31.40.0-255,66,277334,64,320457
20931,0.002161,74.125.200.0-255,4320,281654,64,320457
20932,0.002167,172.31.40.0-255,66,281720,64,320457
20933,0.002204,74.125.200.0-255,4320,286040,64,320457
20934,0.002211,172.31.40.0-255,66,286106,64,320457
20935,0.002237,74.125.200.0-255,5020,291126,64,320457
20936,0.002242,74.125.200.0-255,2902,294028,64,320457
20937,0.002246,172.31.40.0-255,66,294094,64,320457
20938,0.002265,74.125.200.0-255,7156,301250,64,320457
20939,0.002268,74.125.200.0-255,1484,302734,64,320457
20940,0.00228,172.31.40.0-255,66,302800,64,320457
20941,0.002298,74.125.200.0-255,4320,307120,64,320457
20942,0.002347,74.125.200.0-255,4320,311440,64,320457
20943,0.002367,74.125.200.0-255,4320,315760,64,320457
20944,0.010361,172.31.40.0-255,66,315826,64,320457
20945,0.012696,74.125.200.0-255,105,315931,64,320457
20946,0.01766,172.31.40.0-255,66,315997,64,320457
20947,0.017737,172.31.40.0-255,105,316102,64,320457
20948,0.020066,74.125.200.0-255,66,316168,64,320457
20949,0.053072,172.31.40.0-255,167,316335,64,320457
20950,0.053105,172.31.40.0-255,1112,317447,64,320457
20951,0.053173,172.31.40.0-255,1514,318961,64,320457
20952,0.053174,172.31.40.0-255,1298,320259,64,320457
20953,0.054626,104.244.42.0-255,66,320325,64,320457
20954,0.054711,104.244.42.0-255,66,320391,64,320457
20955,0.054714,104.244.42.0-255,66,320457,64,320457
20956,0.0,172.217.194.0-255,146,146,64,272423
20957,1.3e-05,172.31.40.0-255,66,212,64,272423
20958,2e-05,172.217.194.0-255,1484,1696,64,272423
20959,2.4e-05,172.31.40.0-255,66,1762,64,272423
20960,3e-05,172.217.194.0-255,2902,4664,64,272423
20961,4e-05,172.31.40.0-255,66,4730,64,272423
20962,4.6e-05,172.217.194.0-255,4320,9050,64,272423
20963,4.9e-05,172.31.40.0-255,66,9116,64,272423
20964,0.000105,172.31.40.0-255,66,9182,64,272423
20965,0.000117,172.31.40.0-255,66,9248,64,272423
20966,0.000246,172.217.194.0-255,1484,10732,64,272423
20967,0.000251,172.31.40.0-255,66,10798,64,272423
20968,0.000257,172.217.194.0-255,2902,13700,64,272423
20969,0.000259,172.31.40.0-255,66,13766,64,272423
20970,0.00027,172.217.194.0-255,5738,19504,64,272423
20971,0.000273,172.31.40.0-255,66,19570,64,272423
20972,0.000276,172.217.194.0-255,1484,21054,64,272423
20973,0.000278,172.31.40.0-255,66,21120,64,272423
20974,0.000302,172.217.194.0-255,2902,24022,64,272423
20975,0.000309,172.31.40.0-255,66,24088,64,272423
20976,0.000338,172.217.194.0-255,2543,26631,64,272423
20977,0.000341,172.31.40.0-255,66,26697,64,272423
20978,0.000384,172.217.194.0-255,1484,28181,64,272423
20979,0.000387,172.31.40.0-255,66,28247,64,272423
20980,0.00039,172.217.194.0-255,1484,29731,64,272423
20981,0.000393,172.31.40.0-255,66,29797,64,272423
20982,0.000415,172.217.194.0-255,1484,31281,64,272423
20983,0.000422,172.31.40.0-255,66,31347,64,272423
20984,0.000428,172.217.194.0-255,5738,37085,64,272423
20985,0.000431,172.31.40.0-255,66,37151,64,272423
20986,0.000459,172.217.194.0-255,6797,43948,64,272423
20987,0.000467,172.31.40.0-255,66,44014,64,272423
20988,0.000635,172.217.194.0-255,364,44378,64,272423
20989,0.000639,172.31.40.0-255,66,44444,64,272423
20990,0.000809,172.217.194.0-255,378,44822,64,272423
20991,0.000812,172.31.40.0-255,66,44888,64,272423
20992,0.001047,172.217.194.0-255,1484,46372,64,272423
20993,0.001051,172.31.40.0-255,66,46438,64,272423
20994,0.001054,172.217.194.0-255,1484,47922,64,272423
20995,0.001055,172.31.40.0-255,66,47988,64,272423
20996,0.001075,172.217.194.0-255,1484,49472,64,272423
20997,0.001078,172.31.40.0-255,66,49538,64,272423
20998,0.001102,172.217.194.0-255,5738,55276,64,272423
20999,0.001105,172.31.40.0-255,66,55342,64,272423
21000,0.001115,172.217.194.0-255,6797,62139,64,272423
21001,0.001117,172.31.40.0-255,66,62205,64,272423
21002,0.001137,172.217.194.0-255,2902,65107,64,272423
21003,0.001139,172.31.40.0-255,66,65173,64,272423
21004,0.001163,172.217.194.0-255,4320,69493,64,272423
21005,0.001165,172.31.40.0-255,66,69559,64,272423
21006,0.001178,172.31.40.0-255,66,69625,64,272423
21007,0.001435,172.217.194.0-255,1484,71109,64,272423
21008,0.001438,172.31.40.0-255,66,71175,64,272423
21009,0.001443,172.217.194.0-255,2902,74077,64,272423
21010,0.001445,172.31.40.0-255,66,74143,64,272423
21011,0.001472,172.217.194.0-255,5738,79881,64,272423
21012,0.001474,172.31.40.0-255,66,79947,64,272423
21013,0.001478,172.217.194.0-255,2902,82849,64,272423
21014,0.00148,172.31.40.0-255,66,82915,64,272423
21015,0.001531,172.31.40.0-255,66,82981,64,272423
21016,0.001534,172.31.40.0-255,66,83047,64,272423
21017,0.001554,172.217.194.0-255,2184,85231,64,272423
21018,0.001556,172.31.40.0-255,66,85297,64,272423
21019,0.001561,172.217.194.0-255,4320,89617,64,272423
21020,0.001563,172.31.40.0-255,66,89683,64,272423
21021,0.001587,172.217.194.0-255,7156,96839,64,272423
21022,0.001648,172.31.40.0-255,66,96905,64,272423
21023,0.001748,172.217.194.0-255,1484,98389,64,272423
21024,0.001755,172.217.194.0-255,2902,101291,64,272423
21025,0.001772,172.31.40.0-255,66,101357,64,272423
21026,0.001779,172.217.194.0-255,5738,107095,64,272423
21027,0.001785,172.31.40.0-255,66,107161,64,272423
21028,0.001824,172.217.194.0-255,2902,110063,64,272423
21029,0.001845,172.217.194.0-255,4320,114383,64,272423
21030,0.001852,172.31.40.0-255,66,114449,64,272423
21031,0.001862,172.217.194.0-255,3602,118051,64,272423
21032,0.001867,172.31.40.0-255,66,118117,64,272423
21033,0.002172,172.217.194.0-255,1484,119601,64,272423
21034,0.002185,172.217.194.0-255,2902,122503,64,272423
21035,0.002189,172.31.40.0-255,66,122569,64,272423
21036,0.002194,172.217.194.0-255,2902,125471,64,272423
21037,0.002218,172.217.194.0-255,2902,128373,64,272423
21038,0.002244,172.31.40.0-255,66,128439,64,272423
21039,0.002271,172.217.194.0-255,5738,134177,64,272423
21040,0.002277,172.31.40.0-255,66,134243,64,272423
21041,0.002331,172.31.40.0-255,66,134309,64,272423
21042,0.004618,172.217.194.0-255,5738,140047,64,272423
21043,0.004625,172.31.40.0-255,66,140113,64,272423
21044,0.006869,172.217.194.0-255,1484,141597,64,272423
21045,0.006872,172.31.40.0-255,66,141663,64,272423
21046,0.006903,172.217.194.0-255,4320,145983,64,272423
21047,0.007841,172.31.40.0-255,66,146049,64,272423
21048,0.009116,172.217.194.0-255,1484,147533,64,272423
21049,0.009122,172.31.40.0-255,66,147599,64,272423
21050,0.010113,172.217.194.0-255,4320,151919,64,272423
21051,0.010119,172.31.40.0-255,66,151985,64,272423
21052,0.011362,172.217.194.0-255,1484,153469,64,272423
21053,0.012368,172.217.194.0-255,4320,157789,64,272423
21054,0.014401,172.31.40.0-255,66,157855,64,272423
21055,0.016676,172.217.194.0-255,5738,163593,64,272423
21056,0.016688,172.31.40.0-255,66,163659,64,272423
21057,0.018968,172.217.194.0-255,5738,169397,64,272423
21058,0.018975,172.31.40.0-255,66,169463,64,272423
21059,0.021253,172.217.194.0-255,5738,175201,64,272423
21060,0.021261,172.31.40.0-255,66,175267,64,272423
21061,0.023504,172.217.194.0-255,5738,181005,64,272423
21062,0.023511,172.31.40.0-255,66,181071,64,272423
21063,0.025768,172.217.194.0-255,5738,186809,64,272423
21064,0.025774,172.31.40.0-255,66,186875,64,272423
21065,0.028044,172.217.194.0-255,5738,192613,64,272423
21066,0.028048,172.31.40.0-255,66,192679,64,272423
21067,0.028927,172.31.40.0-255,172,192851,64,272423
21068,0.028954,172.31.40.0-255,1111,193962,64,272423
21069,0.029003,172.31.40.0-255,1514,195476,64,272423
21070,0.029004,172.31.40.0-255,1297,196773,64,272423
21071,0.030317,172.217.194.0-255,5738,202511,64,272423
21072,0.030323,172.31.40.0-255,66,202577,64,272423
21073,0.030481,104.244.42.0-255,66,202643,64,272423
21074,0.030538,104.244.42.0-255,66,202709,64,272423
21075,0.030584,104.244.42.0-255,66,202775,64,272423
21076,0.032615,172.217.194.0-255,5738,208513,64,272423
21077,0.032622,172.31.40.0-255,66,208579,64,272423
21078,0.034893,172.217.194.0-255,5738,214317,64,272423
21079,0.034899,172.31.40.0-255,66,214383,64,272423
21080,0.037184,172.217.194.0-255,5738,220121,64,272423
21081,0.03719,172.31.40.0-255,66,220187,64,272423
21082,0.039476,172.217.194.0-255,5738,225925,64,272423
21083,0.039482,172.31.40.0-255,66,225991,64,272423
21084,0.041771,172.217.194.0-255,5738,231729,64,272423
21085,0.041778,172.31.40.0-255,66,231795,64,272423
21086,0.044031,172.217.194.0-255,5738,237533,64,272423
21087,0.044038,172.31.40.0-255,66,237599,64,272423
21088,0.046315,172.217.194.0-255,5738,243337,64,272423
21089,0.046322,172.31.40.0-255,66,243403,64,272423
21090,0.048632,172.217.194.0-255,5738,249141,64,272423
21091,0.048641,172.31.40.0-255,66,249207,64,272423
21092,0.050907,172.217.194.0-255,5738,254945,64,272423
21093,0.050912,172.31.40.0-255,66,255011,64,272423
21094,0.053181,172.217.194.0-255,5738,260749,64,272423
21095,0.053187,172.31.40.0-255,66,260815,64,272423
21096,0.055473,172.217.194.0-255,5738,266553,64,272423
21097,0.055479,172.31.40.0-255,66,266619,64,272423
21098,0.057741,172.217.194.0-255,5738,272357,64,272423
21099,0.057746,172.31.40.0-255,66,272423,64,272423
21100,0.0,172.217.194.0-255,150,150,64,204839
21101,2.4e-05,172.31.40.0-255,66,216,64,204839
21102,3.1e-05,172.217.194.0-255,1484,1700,64,204839
21103,3.6e-05,172.31.40.0-255,66,1766,64,204839
21104,5e-05,172.217.194.0-255,2902,4668,64,204839
21105,5.4e-05,172.31.40.0-255,66,4734,64,204839
21106,7.5e-05,172.217.194.0-255,7156,11890,64,204839
21107,7.8e-05,172.31.40.0-255,66,11956,64,204839
21108,9.1e-05,172.31.40.0-255,66,12022,64,204839
21109,0.000137,172.31.40.0-255,66,12088,64,204839
21110,0.000144,172.217.194.0-255,7156,19244,64,204839
21111,0.000146,172.31.40.0-255,66,19310,64,204839
21112,0.000171,172.217.194.0-255,5738,25048,64,204839
21113,0.000174,172.31.40.0-255,66,25114,64,204839
21114,0.000177,172.217.194.0-255,1125,26239,64,204839
21115,0.000178,172.31.40.0-255,66,26305,64,204839
21116,0.000748,172.217.194.0-255,1484,27789,64,204839
21117,0.000754,172.31.40.0-255,66,27855,64,204839
21118,0.000761,172.217.194.0-255,2902,30757,64,204839
21119,0.000763,172.31.40.0-255,66,30823,64,204839
21120,0.000773,172.217.194.0-255,2902,33725,64,204839
21121,0.000775,172.31.40.0-255,66,33791,64,204839
21122,0.000802,172.217.194.0-255,2902,36693,64,204839
21123,0.000809,172.31.40.0-255,66,36759,64,204839
21124,0.000815,172.217.194.0-255,4320,41079,64,204839
21125,0.000817,172.31.40.0-255,66,41145,64,204839
21126,0.000848,172.217.194.0-255,2543,43688,64,204839
21127,0.000851,172.31.40.0-255,66,43754,64,204839
21128,0.001878,172.217.194.0-255,645,44399,64,204839
21129,0.001885,172.31.40.0-255,66,44465,64,204839
21130,0.002911,172.217.194.0-255,1484,45949,64,204839
21131,0.002934,172.217.194.0-255,2902,48851,64,204839
21132,0.002939,172.31.40.0-255,66,48917,64,204839
21133,0.003964,172.217.194.0-255,1484,50401,64,204839
21134,0.005048,172.217.194.0-255,4320,54721,64,204839
21135,0.005054,172.31.40.0-255,66,54787,64,204839
21136,0.007132,172.217.194.0-255,2902,57689,64,204839
21137,0.007136,172.31.40.0-255,66,57755,64,204839
21138,0.007182,172.217.194.0-255,2902,60657,64,204839
21139,0.007185,172.31.40.0-255,66,60723,64,204839
21140,0.009319,172.217.194.0-255,2902,63625,64,204839
21141,0.009328,172.31.40.0-255,66,63691,64,204839
21142,0.00936,172.217.194.0-255,2902,66593,64,204839
21143,0.009363,172.31.40.0-255,66,66659,64,204839
21144,0.011399,172.217.194.0-255,2902,69561,64,204839
21145,0.011407,172.31.40.0-255,66,69627,64,204839
21146,0.011435,172.217.194.0-255,2902,72529,64,204839
21147,0.011438,172.31.40.0-255,66,72595,64,204839
21148,0.013501,172.217.194.0-255,2902,75497,64,204839
21149,0.013509,172.31.40.0-255,66,75563,64,204839
21150,0.013536,172.217.194.0-255,2902,78465,64,204839
21151,0.013538,172.31.40.0-255,66,78531,64,204839
21152,0.015613,172.217.194.0-255,2902,81433,64,204839
21153,0.015622,172.31.40.0-255,66,81499,64,204839
21154,0.015652,172.217.194.0-255,2902,84401,64,204839
21155,0.015655,172.31.40.0-255,66,84467,64,204839
21156,0.017731,172.217.194.0-255,5738,90205,64,204839
21157,0.017742,172.31.40.0-255,66,90271,64,204839
21158,0.019835,172.217.194.0-255,5738,96009,64,204839
21159,0.019846,172.31.40.0-255,66,96075,64,204839
21160,0.021954,172.217.194.0-255,5738,101813,64,204839
21161,0.021964,172.31.40.0-255,66,101879,64,204839
21162,0.024085,172.217.194.0-255,5738,107617,64,204839
21163,0.024096,172.31.40.0-255,66,107683,64,204839
21164,0.025886,172.31.40.0-255,172,107855,64,204839
21165,0.02592,172.31.40.0-255,1111,108966,64,204839
21166,0.025977,172.31.40.0-255,1514,110480,64,204839
21167,0.025979,172.31.40.0-255,1297,111777,64,204839
21168,0.026185,172.217.194.0-255,5738,117515,64,204839
21169,0.026192,172.31.40.0-255,66,117581,64,204839
21170,0.027429,104.244.42.0-255,66,117647,64,204839
21171,0.027471,104.244.42.0-255,66,117713,64,204839
21172,0.027515,104.244.42.0-255,66,117779,64,204839
21173,0.028305,172.217.194.0-255,5738,123517,64,204839
21174,0.028312,172.31.40.0-255,66,123583,64,204839
21175,0.030433,172.217.194.0-255,5738,129321,64,204839
21176,0.030439,172.31.40.0-255,66,129387,64,204839
21177,0.032511,172.217.194.0-255,5738,135125,64,204839
21178,0.032519,172.31.40.0-255,66,135191,64,204839
21179,0.034623,172.217.194.0-255,5738,140929,64,204839
21180,0.034632,172.31.40.0-255,66,140995,64,204839
21181,0.036751,172.217.194.0-255,5738,146733,64,204839
21182,0.036758,172.31.40.0-255,66,146799,64,204839
21183,0.038892,172.217.194.0-255,5738,152537,64,204839
21184,0.0389,172.31.40.0-255,66,152603,64,204839
21185,0.040993,172.217.194.0-255,5738,158341,64,204839
21186,0.041,172.31.40.0-255,66,158407,64,204839
21187,0.043099,172.217.194.0-255,5738,164145,64,204839
21188,0.043107,172.31.40.0-255,66,164211,64,204839
21189,0.045212,172.217.194.0-255,5738,169949,64,204839
21190,0.04522,172.31.40.0-255,66,170015,64,204839
21191,0.047305,172.217.194.0-255,5738,175753,64,204839
21192,0.047312,172.31.40.0-255,66,175819,64,204839
21193,0.049407,172.217.194.0-255,5738,181557,64,204839
21194,0.049414,172.31.40.0-255,66,181623,64,204839
21195,0.051501,172.217.194.0-255,5738,187361,64,204839
21196,0.051508,172.31.40.0-255,66,187427,64,204839
21197,0.05361,172.217.194.0-255,5738,193165,64,204839
21198,0.053617,172.31.40.0-255,66,193231,64,204839
21199,0.055787,172.217.194.0-255,5738,198969,64,204839
21200,0.055794,172.31.40.0-255,66,199035,64,204839
21201,0.057905,172.217.194.0-255,5738,204773,64,204839
21202,0.057912,172.31.40.0-255,66,204839,64,204839
21203,0.0,172.217.194.0-255,148,148,64,229910
21204,2.2e-05,172.31.40.0-255,66,214,64,229910
21205,2.9e-05,172.217.194.0-255,1484,1698,64,229910
21206,3.3e-05,172.31.40.0-255,66,1764,64,229910
21207,4.7e-05,172.217.194.0-255,2902,4666,64,229910
21208,5.1e-05,172.31.40.0-255,66,4732,64,229910
21209,5.9e-05,172.217.194.0-255,7156,11888,64,229910
21210,6.3e-05,172.31.40.0-255,66,11954,64,229910
21211,0.000121,172.31.40.0-255,66,12020,64,229910
21212,0.000125,172.217.194.0-255,2543,14563,64,229910
21213,0.000128,172.31.40.0-255,66,14629,64,229910
21214,0.000165,172.217.194.0-255,1484,16113,64,229910
21215,0.000168,172.31.40.0-255,66,16179,64,229910
21216,0.000173,172.217.194.0-255,2902,19081,64,229910
21217,0.000176,172.31.40.0-255,66,19147,64,229910
21218,0.000186,172.217.194.0-255,5738,24885,64,229910
21219,0.000189,172.31.40.0-255,66,24951,64,229910
21220,0.000196,172.217.194.0-255,6797,31748,64,229910
21221,0.000199,172.31.40.0-255,66,31814,64,229910
21222,0.000206,172.217.194.0-255,5738,37552,64,229910
21223,0.000209,172.31.40.0-255,66,37618,64,229910
21224,0.000257,172.31.40.0-255,66,37684,64,229910
21225,0.000262,172.217.194.0-255,2831,40515,64,229910
21226,0.000264,172.31.40.0-255,66,40581,64,229910
21227,0.000267,172.217.194.0-255,367,40948,64,229910
21228,0.000269,172.31.40.0-255,66,41014,64,229910
21229,0.000301,172.217.194.0-255,1484,42498,64,229910
21230,0.000303,172.31.40.0-255,66,42564,64,229910
21231,0.000309,172.217.194.0-255,4320,46884,64,229910
21232,0.000311,172.31.40.0-255,66,46950,64,229910
21233,0.000354,172.217.194.0-255,5738,52688,64,229910
21234,0.000359,172.31.40.0-255,66,52754,64,229910
21235,0.000383,172.217.194.0-255,5379,58133,64,229910
21236,0.00039,172.217.194.0-255,6248,64381,64,229910
21237,0.000424,172.217.194.0-255,4320,68701,64,229910
21238,0.000437,172.217.194.0-255,2902,71603,64,229910
21239,0.000442,172.217.194.0-255,4320,75923,64,229910
21240,0.000462,172.217.194.0-255,4320,80243,64,229910
21241,0.000482,172.217.194.0-255,2902,83145,64,229910
21242,0.000497,172.217.194.0-255,5738,88883,64,229910
21243,0.000516,172.217.194.0-255,4320,93203,64,229910
21244,0.000539,172.217.194.0-255,4320,97523,64,229910
21245,0.000541,172.217.194.0-255,766,98289,64,229910
21246,0.000561,172.217.194.0-255,4320,102609,64,229910
21247,0.000566,172.217.194.0-255,5738,108347,64,229910
21248,0.000596,172.217.194.0-255,6797,115144,64,229910
21249,0.000689,172.217.194.0-255,1484,116628,64,229910
21250,0.000694,172.217.194.0-255,2902,119530,64,229910
21251,0.000721,172.217.194.0-255,5738,125268,64,229910
21252,0.000727,172.31.40.0-255,66,125334,64,229910
21253,0.000746,172.217.194.0-255,7156,132490,64,229910
21254,0.00075,172.31.40.0-255,66,132556,64,229910
21255,0.000763,172.217.194.0-255,5738,138294,64,229910
21256,0.000818,172.217.194.0-255,6438,144732,64,229910
21257,0.000825,172.217.194.0-255,7156,151888,64,229910
21258,0.000871,172.31.40.0-255,66,151954,64,229910
21259,0.000877,172.31.40.0-255,66,152020,64,229910
21260,0.000913,172.217.194.0-255,1484,153504,64,229910
21261,0.000958,172.217.194.0-255,1484,154988,64,229910
21262,0.000964,172.31.40.0-255,66,155054,64,229910
21263,0.000974,172.217.194.0-255,2902,157956,64,229910
21264,0.00099,172.31.40.0-255,66,158022,64,229910
21265,0.000996,172.217.194.0-255,5738,163760,64,229910
21266,0.000999,172.217.194.0-255,1484,165244,64,229910
21267,0.001059,172.217.194.0-255,5738,170982,64,229910
21268,0.001067,172.31.40.0-255,66,171048,64,229910
21269,0.001078,172.217.194.0-255,6438,177486,64,229910
21270,0.00109,172.31.40.0-255,66,177552,64,229910
21271,0.001101,172.217.194.0-255,1484,179036,64,229910
21272,0.001118,172.217.194.0-255,2902,181938,64,229910
21273,0.001138,172.217.194.0-255,1484,183422,64,229910
21274,0.00114,172.31.40.0-255,66,183488,64,229910
21275,0.001152,172.217.194.0-255,2902,186390,64,229910
21276,0.001173,172.217.194.0-255,1484,187874,64,229910
21277,0.00119,172.217.194.0-255,5738,193612,64,229910
21278,0.001203,172.217.194.0-255,2902,196514,64,229910
21279,0.001215,172.31.40.0-255,66,196580,64,229910
21280,0.001219,172.217.194.0-255,2184,198764,64,229910
21281,0.001224,172.31.40.0-255,66,198830,64,229910
21282,0.001242,172.217.194.0-255,2902,201732,64,229910
21283,0.001256,172.217.194.0-255,2902,204634,64,229910
21284,0.001277,172.217.194.0-255,4320,208954,64,229910
21285,0.001297,172.31.40.0-255,66,209020,64,229910
21286,0.001314,172.217.194.0-255,4320,213340,64,229910
21287,0.001344,172.31.40.0-255,66,213406,64,229910
21288,0.00136,172.217.194.0-255,5738,219144,64,229910
21289,0.001379,172.31.40.0-255,66,219210,64,229910
21290,0.001475,172.217.194.0-255,5738,224948,64,229910
21291,0.001498,172.217.194.0-255,1298,226246,64,229910
21292,0.0015,172.217.194.0-255,105,226351,64,229910
21293,0.001521,172.31.40.0-255,66,226417,64,229910
21294,0.004514,172.31.40.0-255,105,226522,64,229910
21295,0.007066,172.217.194.0-255,66,226588,64,229910
21296,0.04414,172.31.40.0-255,166,226754,64,229910
21297,0.044176,172.31.40.0-255,1137,227891,64,229910
21298,0.044237,172.31.40.0-255,1514,229405,64,229910
21299,0.044239,172.31.40.0-255,307,229712,64,229910
21300,0.045742,104.244.42.0-255,66,229778,64,229910
21301,0.045752,104.244.42.0-255,66,229844,64,229910
21302,0.045821,104.244.42.0-255,66,229910,64,229910
21303,0.0,74.125.24.0-255,150,150,64,273656
21304,2e-05,172.31.40.0-255,66,216,64,273656
21305,2.7e-05,74.125.24.0-255,1484,1700,64,273656
21306,3.1e-05,172.31.40.0-255,66,1766,64,273656
21307,3.7e-05,74.125.24.0-255,2902,4668,64,273656
21308,4.1e-05,172.31.40.0-255,66,4734,64,273656
21309,4.8e-05,74.125.24.0-255,7156,11890,64,273656
21310,5.1e-05,172.31.40.0-255,66,11956,64,273656
21311,5.8e-05,74.125.24.0-255,4908,16864,64,273656
21312,6.1e-05,172.31.40.0-255,66,16930,64,273656
21313,9.1e-05,74.125.24.0-255,5738,22668,64,273656
21314,9.4e-05,172.31.40.0-255,66,22734,64,273656
21315,0.000122,172.31.40.0-255,66,22800,64,273656
21316,0.000238,74.125.24.0-255,1484,24284,64,273656
21317,0.000242,172.31.40.0-255,66,24350,64,273656
21318,0.000248,74.125.24.0-255,2902,27252,64,273656
21319,0.000251,172.31.40.0-255,66,27318,64,273656
21320,0.000264,74.125.24.0-255,2902,30220,64,273656
21321,0.000267,172.31.40.0-255,66,30286,64,273656
21322,0.000287,74.125.24.0-255,2902,33188,64,273656
21323,0.000289,172.31.40.0-255,66,33254,64,273656
21324,0.000295,74.125.24.0-255,4320,37574,64,273656
21325,0.000297,172.31.40.0-255,66,37640,64,273656
21326,0.000319,74.125.24.0-255,2543,40183,64,273656
21327,0.000322,172.31.40.0-255,66,40249,64,273656
21328,0.000406,74.125.24.0-255,1484,41733,64,273656
21329,0.000408,172.31.40.0-255,66,41799,64,273656
21330,0.000412,74.125.24.0-255,1484,43283,64,273656
21331,0.000414,172.31.40.0-255,66,43349,64,273656
21332,0.000434,74.125.24.0-255,1484,44833,64,273656
21333,0.000436,172.31.40.0-255,66,44899,64,273656
21334,0.000443,74.125.24.0-255,5738,50637,64,273656
21335,0.000445,172.31.40.0-255,66,50703,64,273656
21336,0.000452,74.125.24.0-255,5738,56441,64,273656
21337,0.000454,172.31.40.0-255,66,56507,64,273656
21338,0.00048,74.125.24.0-255,1125,57632,64,273656
21339,0.000957,74.125.24.0-255,1484,59116,64,273656
21340,0.000962,172.31.40.0-255,66,59182,64,273656
21341,0.000968,74.125.24.0-255,2902,62084,64,273656
21342,0.00097,172.31.40.0-255,66,62150,64,273656
21343,0.000977,74.125.24.0-255,5738,67888,64,273656
21344,0.000979,172.31.40.0-255,66,67954,64,273656
21345,0.001011,172.31.40.0-255,66,68020,64,273656
21346,0.001032,74.125.24.0-255,1484,69504,64,273656
21347,0.001046,172.31.40.0-255,66,69570,64,273656
21348,0.001071,74.125.24.0-255,2902,72472,64,273656
21349,0.001074,172.31.40.0-255,66,72538,64,273656
21350,0.001093,74.125.24.0-255,4320,76858,64,273656
21351,0.001095,172.31.40.0-255,66,76924,64,273656
21352,0.001102,74.125.24.0-255,5738,82662,64,273656
21353,0.001104,172.31.40.0-255,66,82728,64,273656
21354,0.001129,74.125.24.0-255,2902,85630,64,273656
21355,0.001132,172.31.40.0-255,66,85696,64,273656
21356,0.001161,172.31.40.0-255,66,85762,64,273656
21357,0.001183,74.125.24.0-255,2902,88664,64,273656
21358,0.001186,172.31.40.0-255,66,88730,64,273656
21359,0.001189,74.125.24.0-255,766,89496,64,273656
21360,0.001726,172.31.40.0-255,66,89562,64,273656
21361,0.001908,74.125.24.0-255,1484,91046,64,273656
21362,0.001917,74.125.24.0-255,2902,93948,64,273656
21363,0.00192,172.31.40.0-255,66,94014,64,273656
21364,0.001924,74.125.24.0-255,1484,95498,64,273656
21365,0.001944,74.125.24.0-255,4320,99818,64,273656
21366,0.001947,172.31.40.0-255,66,99884,64,273656
21367,0.001954,74.125.24.0-255,7156,107040,64,273656
21368,0.001956,172.31.40.0-255,66,107106,64,273656
21369,0.001965,172.31.40.0-255,66,107172,64,273656
21370,0.002006,172.31.40.0-255,66,107238,64,273656
21371,0.002195,74.125.24.0-255,1484,108722,64,273656
21372,0.002204,74.125.24.0-255,2902,111624,64,273656
21373,0.002207,172.31.40.0-255,66,111690,64,273656
21374,0.002233,74.125.24.0-255,5738,117428,64,273656
21375,0.002235,172.31.40.0-255,66,117494,64,273656
21376,0.00224,74.125.24.0-255,4320,121814,64,273656
21377,0.002242,172.31.40.0-255,66,121880,64,273656
21378,0.002271,172.31.40.0-255,66,121946,64,273656
21379,0.00228,172.31.40.0-255,66,122012,64,273656
21380,0.002285,74.125.24.0-255,2184,124196,64,273656
21381,0.002286,172.31.40.0-255,66,124262,64,273656
21382,0.004541,74.125.24.0-255,5738,130000,64,273656
21383,0.004547,172.31.40.0-255,66,130066,64,273656
21384,0.006804,74.125.24.0-255,5738,135804,64,273656
21385,0.006812,172.31.40.0-255,66,135870,64,273656
21386,0.00907,74.125.24.0-255,5738,141608,64,273656
21387,0.009074,172.31.40.0-255,66,141674,64,273656
21388,0.011337,74.125.24.0-255,5738,147412,64,273656
21389,0.011345,172.31.40.0-255,66,147478,64,273656
21390,0.013599,74.125.24.0-255,5738,153216,64,273656
21391,0.013608,172.31.40.0-255,66,153282,64,273656
21392,0.015881,74.125.24.0-255,5738,159020,64,273656
21393,0.015892,172.31.40.0-255,66,159086,64,273656
21394,0.018147,74.125.24.0-255,5738,164824,64,273656
21395,0.018153,172.31.40.0-255,66,164890,64,273656
21396,0.020405,74.125.24.0-255,5738,170628,64,273656
21397,0.020413,172.31.40.0-255,66,170694,64,273656
21398,0.022694,74.125.24.0-255,5738,176432,64,273656
21399,0.022701,172.31.40.0-255,66,176498,64,273656
21400,0.024956,74.125.24.0-255,5738,182236,64,273656
21401,0.024964,172.31.40.0-255,66,182302,64,273656
21402,0.027229,74.125.24.0-255,5738,188040,64,273656
21403,0.027236,172.31.40.0-255,66,188106,64,273656
21404,0.028705,172.31.40.0-255,172,188278,64,273656
21405,0.028732,172.31.40.0-255,1112,189390,64,273656
21406,0.028791,172.31.40.0-255,1514,190904,64,273656
21407,0.028793,172.31.40.0-255,1298,192202,64,273656
21408,0.029497,74.125.24.0-255,5738,197940,64,273656
21409,0.029504,172.31.40.0-255,66,198006,64,273656
21410,0.030237,104.244.42.0-255,66,198072,64,273656
21411,0.030294,104.244.42.0-255,66,198138,64,273656
21412,0.030315,104.244.42.0-255,66,198204,64,273656
21413,0.031766,74.125.24.0-255,5738,203942,64,273656
21414,0.03177,172.31.40.0-255,66,204008,64,273656
21415,0.03403,74.125.24.0-255,5738,209746,64,273656
21416,0.034036,172.31.40.0-255,66,209812,64,273656
21417,0.036292,74.125.24.0-255,5738,215550,64,273656
21418,0.036298,172.31.40.0-255,66,215616,64,273656
21419,0.038534,74.125.24.0-255,5738,221354,64,273656
21420,0.038539,172.31.40.0-255,66,221420,64,273656
21421,0.040768,74.125.24.0-255,5738,227158,64,273656
21422,0.040777,172.31.40.0-255,66,227224,64,273656
21423,0.043021,74.125.24.0-255,5738,232962,64,273656
21424,0.043027,172.31.40.0-255,66,233028,64,273656
21425,0.045282,74.125.24.0-255,5738,238766,64,273656
21426,0.045288,172.31.40.0-255,66,238832,64,273656
21427,0.047532,74.125.24.0-255,5738,244570,64,273656
21428,0.047538,172.31.40.0-255,66,244636,64,273656
21429,0.049827,74.125.24.0-255,5738,250374,64,273656
21430,0.049834,172.31.40.0-255,66,250440,64,273656
21431,0.052106,74.125.24.0-255,5738,256178,64,273656
21432,0.052111,172.31.40.0-255,66,256244,64,273656
21433,0.054377,74.125.24.0-255,5738,261982,64,273656
21434,0.054383,172.31.40.0-255,66,262048,64,273656
21435,0.056653,74.125.24.0-255,5738,267786,64,273656
21436,0.05666,172.31.40.0-255,66,267852,64,273656
21437,0.058909,74.125.24.0-255,5738,273590,64,273656
21438,0.058916,172.31.40.0-255,66,273656,64,273656
21439,0.0,74.125.200.0-255,147,147,64,309503
21440,2.4e-05,172.31.40.0-255,66,213,64,309503
21441,3.1e-05,74.125.200.0-255,1484,1697,64,309503
21442,3.6e-05,172.31.40.0-255,66,1763,64,309503
21443,4.9e-05,74.125.200.0-255,2902,4665,64,309503
21444,5.3e-05,172.31.40.0-255,66,4731,64,309503
21445,6e-05,74.125.200.0-255,5738,10469,64,309503
21446,6.3e-05,172.31.40.0-255,66,10535,64,309503
21447,0.000107,74.125.200.0-255,3491,14026,64,309503
21448,0.00011,172.31.40.0-255,66,14092,64,309503
21449,0.000149,74.125.200.0-255,4320,18412,64,309503
21450,0.000152,172.31.40.0-255,66,18478,64,309503
21451,0.000157,74.125.200.0-255,2902,21380,64,309503
21452,0.000159,172.31.40.0-255,66,21446,64,309503
21453,0.000163,74.125.200.0-255,1484,22930,64,309503
21454,0.000165,172.31.40.0-255,66,22996,64,309503
21455,0.0002,74.125.200.0-255,2902,25898,64,309503
21456,0.000202,172.31.40.0-255,66,25964,64,309503
21457,0.000207,74.125.200.0-255,2902,28866,64,309503
21458,0.000209,172.31.40.0-255,66,28932,64,309503
21459,0.000229,74.125.200.0-255,2543,31475,64,309503
21460,0.000236,172.31.40.0-255,66,31541,64,309503
21461,0.00029,74.125.200.0-255,1484,33025,64,309503
21462,0.000293,172.31.40.0-255,66,33091,64,309503
21463,0.000298,74.125.200.0-255,2902,35993,64,309503
21464,0.000301,172.31.40.0-255,66,36059,64,309503
21465,0.000304,74.125.200.0-255,1484,37543,64,309503
21466,0.000306,172.31.40.0-255,66,37609,64,309503
21467,0.00031,74.125.200.0-255,1484,39093,64,309503
21468,0.000312,172.31.40.0-255,66,39159,64,309503
21469,0.000344,74.125.200.0-255,1484,40643,64,309503
21470,0.000346,172.31.40.0-255,66,40709,64,309503
21471,0.000352,74.125.200.0-255,5738,46447,64,309503
21472,0.000355,172.31.40.0-255,66,46513,64,309503
21473,0.000366,74.125.200.0-255,2543,49056,64,309503
21474,0.000368,172.31.40.0-255,66,49122,64,309503
21475,0.00105,74.125.200.0-255,1484,50606,64,309503
21476,0.001061,74.125.200.0-255,2902,53508,64,309503
21477,0.001065,172.31.40.0-255,66,53574,64,309503
21478,0.00107,74.125.200.0-255,1484,55058,64,309503
21479,0.001102,74.125.200.0-255,2902,57960,64,309503
21480,0.001104,172.31.40.0-255,66,58026,64,309503
21481,0.001137,172.31.40.0-255,66,58092,64,309503
21482,0.001201,74.125.200.0-255,1484,59576,64,309503
21483,0.001215,74.125.200.0-255,2902,62478,64,309503
21484,0.001218,172.31.40.0-255,66,62544,64,309503
21485,0.001222,74.125.200.0-255,1484,64028,64,309503
21486,0.001248,74.125.200.0-255,2902,66930,64,309503
21487,0.001251,172.31.40.0-255,66,66996,64,309503
21488,0.001258,74.125.200.0-255,5738,72734,64,309503
21489,0.00126,172.31.40.0-255,66,72800,64,309503
21490,0.001287,74.125.200.0-255,3961,76761,64,309503
21491,0.00129,172.31.40.0-255,66,76827,64,309503
21492,0.001293,74.125.200.0-255,1484,78311,64,309503
21493,0.001298,74.125.200.0-255,2902,81213,64,309503
21494,0.0013,172.31.40.0-255,66,81279,64,309503
21495,0.001306,74.125.200.0-255,4320,85599,64,309503
21496,0.001308,172.31.40.0-255,66,85665,64,309503
21497,0.001347,74.125.200.0-255,1484,87149,64,309503
21498,0.001354,74.125.200.0-255,5379,92528,64,309503
21499,0.001357,172.31.40.0-255,66,92594,64,309503
21500,0.001539,74.125.200.0-255,1484,94078,64,309503
21501,0.001547,74.125.200.0-255,2902,96980,64,309503
21502,0.001551,172.31.40.0-255,66,97046,64,309503
21503,0.001576,74.125.200.0-255,5738,102784,64,309503
21504,0.00158,172.31.40.0-255,66,102850,64,309503
21505,0.001584,74.125.200.0-255,2902,105752,64,309503
21506,0.001586,172.31.40.0-255,66,105818,64,309503
21507,0.001589,74.125.200.0-255,1484,107302,64,309503
21508,0.00163,172.31.40.0-255,66,107368,64,309503
21509,0.001642,172.31.40.0-255,66,107434,64,309503
21510,0.001664,74.125.200.0-255,766,108200,64,309503
21511,0.001669,74.125.200.0-255,2902,111102,64,309503
21512,0.001672,172.31.40.0-255,66,111168,64,309503
21513,0.001709,172.31.40.0-255,66,111234,64,309503
21514,0.001714,74.125.200.0-255,4320,115554,64,309503
21515,0.001717,172.31.40.0-255,66,115620,64,309503
21516,0.001721,74.125.200.0-255,2902,118522,64,309503
21517,0.001728,172.31.40.0-255,66,118588,64,309503
21518,0.001774,172.31.40.0-255,66,118654,64,309503
21519,0.001777,74.125.200.0-255,1346,120000,64,309503
21520,0.001801,74.125.200.0-255,1484,121484,64,309503
21521,0.001803,172.31.40.0-255,66,121550,64,309503
21522,0.001808,74.125.200.0-255,2902,124452,64,309503
21523,0.00181,172.31.40.0-255,66,124518,64,309503
21524,0.001828,74.125.200.0-255,1484,126002,64,309503
21525,0.001887,74.125.200.0-255,2902,128904,64,309503
21526,0.001891,172.31.40.0-255,66,128970,64,309503
21527,0.001898,74.125.200.0-255,5738,134708,64,309503
21528,0.0019,172.31.40.0-255,66,134774,64,309503
21529,0.001936,74.125.200.0-255,4320,139094,64,309503
21530,0.001956,74.125.200.0-255,3602,142696,64,309503
21531,0.002178,74.125.200.0-255,1484,144180,64,309503
21532,0.002186,74.125.200.0-255,2902,147082,64,309503
21533,0.002199,74.125.200.0-255,1484,148566,64,309503
21534,0.002219,74.125.200.0-255,2902,151468,64,309503
21535,0.002244,74.125.200.0-255,2902,154370,64,309503
21536,0.002271,74.125.200.0-255,5738,160108,64,309503
21537,0.002295,74.125.200.0-255,7156,167264,64,309503
21538,0.002298,74.125.200.0-255,766,168030,64,309503
21539,0.00489,172.31.40.0-255,66,168096,64,309503
21540,0.007208,74.125.200.0-255,5738,173834,64,309503
21541,0.007215,172.31.40.0-255,66,173900,64,309503
21542,0.009521,74.125.200.0-255,4320,178220,64,309503
21543,0.009528,172.31.40.0-255,66,178286,64,309503
21544,0.009547,74.125.200.0-255,1484,179770,64,309503
21545,0.011852,74.125.200.0-255,4320,184090,64,309503
21546,0.01186,172.31.40.0-255,66,184156,64,309503
21547,0.014183,74.125.200.0-255,5738,189894,64,309503
21548,0.014193,172.31.40.0-255,66,189960,64,309503
21549,0.016518,74.125.200.0-255,5738,195698,64,309503
21550,0.016532,172.31.40.0-255,66,195764,64,309503
21551,0.01885,74.125.200.0-255,5738,201502,64,309503
21552,0.018866,172.31.40.0-255,66,201568,64,309503
21553,0.021181,74.125.200.0-255,5738,207306,64,309503
21554,0.021195,172.31.40.0-255,66,207372,64,309503
21555,0.02352,74.125.200.0-255,5738,213110,64,309503
21556,0.02353,172.31.40.0-255,66,213176,64,309503
21557,0.025924,74.125.200.0-255,5738,218914,64,309503
21558,0.025942,172.31.40.0-255,66,218980,64,309503
21559,0.028253,74.125.200.0-255,5738,224718,64,309503
21560,0.028261,172.31.40.0-255,66,224784,64,309503
21561,0.030579,74.125.200.0-255,5738,230522,64,309503
21562,0.030587,172.31.40.0-255,66,230588,64,309503
21563,0.032881,74.125.200.0-255,5738,236326,64,309503
21564,0.032888,172.31.40.0-255,66,236392,64,309503
21565,0.035209,74.125.200.0-255,5738,242130,64,309503
21566,0.035228,172.31.40.0-255,66,242196,64,309503
21567,0.037537,74.125.200.0-255,5738,247934,64,309503
21568,0.037545,172.31.40.0-255,66,248000,64,309503
21569,0.039861,74.125.200.0-255,5738,253738,64,309503
21570,0.039878,172.31.40.0-255,66,253804,64,309503
21571,0.042206,74.125.200.0-255,5738,259542,64,309503
21572,0.042215,172.31.40.0-255,66,259608,64,309503
21573,0.044584,74.125.200.0-255,5738,265346,64,309503
21574,0.044596,172.31.40.0-255,66,265412,64,309503
21575,0.046904,74.125.200.0-255,5738,271150,64,309503
21576,0.046915,172.31.40.0-255,66,271216,64,309503
21577,0.049224,74.125.200.0-255,5738,276954,64,309503
21578,0.049232,172.31.40.0-255,66,277020,64,309503
21579,0.051526,74.125.200.0-255,5738,282758,64,309503
21580,0.051535,172.31.40.0-255,66,282824,64,309503
21581,0.052775,172.31.40.0-255,172,282996,64,309503
21582,0.052807,172.31.40.0-255,1112,284108,64,309503
21583,0.05287,172.31.40.0-255,1514,285622,64,309503
21584,0.052872,172.31.40.0-255,1514,287136,64,309503
21585,0.052877,172.31.40.0-255,1514,288650,64,309503
21586,0.052879,172.31.40.0-255,1514,290164,64,309503
21587,0.052918,172.31.40.0-255,1514,291678,64,309503
21588,0.052923,172.31.40.0-255,83,291761,64,309503
21589,0.053876,74.125.200.0-255,5738,297499,64,309503
21590,0.053884,172.31.40.0-255,66,297565,64,309503
21591,0.054312,104.244.42.0-255,66,297631,64,309503
21592,0.054358,104.244.42.0-255,66,297697,64,309503
21593,0.054467,104.244.42.0-255,66,297763,64,309503
21594,0.054513,104.244.42.0-255,66,297829,64,309503
21595,0.056187,74.125.200.0-255,5738,303567,64,309503
21596,0.056194,172.31.40.0-255,66,303633,64,309503
21597,0.058514,74.125.200.0-255,4320,307953,64,309503
21598,0.058521,172.31.40.0-255,66,308019,64,309503
21599,0.058549,74.125.200.0-255,1484,309503,64,309503
21600,0.0,172.217.194.0-255,153,153,64,235021
21601,1.5e-05,172.31.40.0-255,66,219,64,235021
21602,2.1e-05,172.217.194.0-255,1484,1703,64,235021
21603,2.6e-05,172.31.40.0-255,66,1769,64,235021
21604,3.1e-05,172.217.194.0-255,2902,4671,64,235021
21605,3.3e-05,172.31.40.0-255,66,4737,64,235021
21606,5.9e-05,172.217.194.0-255,5738,10475,64,235021
21607,6.2e-05,172.31.40.0-255,66,10541,64,235021
21608,7.7e-05,172.217.194.0-255,5738,16279,64,235021
21609,7.9e-05,172.31.40.0-255,66,16345,64,235021
21610,0.000114,172.31.40.0-255,66,16411,64,235021
21611,0.00012,172.217.194.0-255,6797,23208,64,235021
21612,0.000122,172.31.40.0-255,66,23274,64,235021
21613,0.00015,172.217.194.0-255,1484,24758,64,235021
21614,0.000153,172.31.40.0-255,66,24824,64,235021
21615,0.000157,172.217.194.0-255,2902,27726,64,235021
21616,0.000159,172.31.40.0-255,66,27792,64,235021
21617,0.000163,172.217.194.0-255,2902,30694,64,235021
21618,0.000166,172.31.40.0-255,66,30760,64,235021
21619,0.000189,172.217.194.0-255,2902,33662,64,235021
21620,0.000191,172.31.40.0-255,66,33728,64,235021
21621,0.0002,172.31.40.0-255,66,33794,64,235021
21622,0.000234,172.31.40.0-255,66,33860,64,235021
21623,0.000236,172.217.194.0-255,115,33975,64,235021
21624,0.000237,172.31.40.0-255,66,34041,64,235021
21625,0.00024,172.217.194.0-255,380,34421,64,235021
21626,0.000241,172.31.40.0-255,66,34487,64,235021
21627,0.000512,172.217.194.0-255,1484,35971,64,235021
21628,0.000517,172.31.40.0-255,66,36037,64,235021
21629,0.000522,172.217.194.0-255,2902,38939,64,235021
21630,0.000525,172.31.40.0-255,66,39005,64,235021
21631,0.000542,172.217.194.0-255,5738,44743,64,235021
21632,0.000544,172.31.40.0-255,66,44809,64,235021
21633,0.000582,172.31.40.0-255,66,44875,64,235021
21634,0.000601,172.217.194.0-255,5738,50613,64,235021
21635,0.000603,172.31.40.0-255,66,50679,64,235021
21636,0.000623,172.217.194.0-255,6438,57117,64,235021
21637,0.000625,172.31.40.0-255,66,57183,64,235021
21638,0.000708,172.217.194.0-255,1484,58667,64,235021
21639,0.000712,172.217.194.0-255,2902,61569,64,235021
21640,0.000715,172.31.40.0-255,66,61635,64,235021
21641,0.000736,172.217.194.0-255,5738,67373,64,235021
21642,0.000738,172.31.40.0-255,66,67439,64,235021
21643,0.000757,172.217.194.0-255,7156,74595,64,235021
21644,0.00076,172.31.40.0-255,66,74661,64,235021
21645,0.00078,172.217.194.0-255,5738,80399,64,235021
21646,0.000783,172.31.40.0-255,66,80465,64,235021
21647,0.000785,172.217.194.0-255,1484,81949,64,235021
21648,0.000802,172.217.194.0-255,4320,86269,64,235021
21649,0.000804,172.31.40.0-255,66,86335,64,235021
21650,0.000824,172.217.194.0-255,5020,91355,64,235021
21651,0.000827,172.31.40.0-255,66,91421,64,235021
21652,0.00085,172.217.194.0-255,2902,94323,64,235021
21653,0.000852,172.31.40.0-255,66,94389,64,235021
21654,0.000857,172.217.194.0-255,4320,98709,64,235021
21655,0.000859,172.31.40.0-255,66,98775,64,235021
21656,0.000873,172.217.194.0-255,5738,104513,64,235021
21657,0.000875,172.31.40.0-255,66,104579,64,235021
21658,0.000896,172.217.194.0-255,2902,107481,64,235021
21659,0.000898,172.31.40.0-255,66,107547,64,235021
21660,0.000955,172.31.40.0-255,66,107613,64,235021
21661,0.000961,172.217.194.0-255,5738,113351,64,235021
21662,0.000963,172.31.40.0-255,66,113417,64,235021
21663,0.000967,172.217.194.0-255,2902,116319,64,235021
21664,0.000969,172.31.40.0-255,66,116385,64,235021
21665,0.000986,172.217.194.0-255,4320,120705,64,235021
21666,0.000988,172.31.40.0-255,66,120771,64,235021
21667,0.001,172.31.40.0-255,66,120837,64,235021
21668,0.001023,172.217.194.0-255,6438,127275,64,235021
21669,0.001109,172.217.194.0-255,1484,128759,64,235021
21670,0.001115,172.217.194.0-255,2902,131661,64,235021
21671,0.001133,172.217.194.0-255,5738,137399,64,235021
21672,0.001151,172.217.194.0-255,4320,141719,64,235021
21673,0.001215,172.217.194.0-255,5020,146739,64,235021
21674,0.001221,172.217.194.0-255,4320,151059,64,235021
21675,0.001232,172.217.194.0-255,1484,152543,64,235021
21676,0.001274,172.217.194.0-255,5738,158281,64,235021
21677,0.001299,172.217.194.0-255,7156,165437,64,235021
21678,0.001364,172.217.194.0-255,5020,170457,64,235021
21679,0.001415,172.217.194.0-255,1484,171941,64,235021
21680,0.00142,172.217.194.0-255,2902,174843,64,235021
21681,0.001429,172.217.194.0-255,1484,176327,64,235021
21682,0.001444,172.217.194.0-255,4320,180647,64,235021
21683,0.001497,172.217.194.0-255,2184,182831,64,235021
21684,0.001532,172.217.194.0-255,5738,188569,64,235021
21685,0.001537,172.217.194.0-255,4320,192889,64,235021
21686,0.001549,172.217.194.0-255,2902,195791,64,235021
21687,0.001568,172.217.194.0-255,7156,202947,64,235021
21688,0.001597,172.217.194.0-255,7156,210103,64,235021
21689,0.001606,172.217.194.0-255,6438,216541,64,235021
21690,0.001624,172.217.194.0-255,4320,220861,64,235021
21691,0.001689,172.217.194.0-255,4320,225181,64,235021
21692,0.001705,172.217.194.0-255,5037,230218,64,235021
21693,0.00174,172.217.194.0-255,105,230323,64,235021
21694,0.00533,172.31.40.0-255,66,230389,64,235021
21695,0.007155,172.31.40.0-255,101,230490,64,235021
21696,0.008127,172.31.40.0-255,105,230595,64,235021
21697,0.009191,172.217.194.0-255,66,230661,64,235021
21698,0.010118,172.217.194.0-255,66,230727,64,235021
21699,0.029256,172.31.40.0-255,172,230899,64,235021
21700,0.029291,172.31.40.0-255,1111,232010,64,235021
21701,0.029352,172.31.40.0-255,1514,233524,64,235021
21702,0.029354,172.31.40.0-255,1299,234823,64,235021
21703,0.030749,104.244.42.0-255,66,234889,64,235021
21704,0.030771,104.244.42.0-255,66,234955,64,235021
21705,0.03085,104.244.42.0-255,66,235021,64,235021
21706,0.0,74.125.68.0-255,153,153,64,287928
21707,2.6e-05,172.31.40.0-255,66,219,64,287928
21708,3.3e-05,74.125.68.0-255,1484,1703,64,287928
21709,3.8e-05,172.31.40.0-255,66,1769,64,287928
21710,4.5e-05,74.125.68.0-255,2902,4671,64,287928
21711,4.9e-05,172.31.40.0-255,66,4737,64,287928
21712,5.7e-05,74.125.68.0-255,7156,11893,64,287928
21713,6e-05,172.31.40.0-255,66,11959,64,287928
21714,6.4e-05,74.125.68.0-255,2109,14068,64,287928
21715,6.9e-05,172.31.40.0-255,66,14134,64,287928
21716,0.000101,74.125.68.0-255,2902,17036,64,287928
21717,0.000104,172.31.40.0-255,66,17102,64,287928
21718,0.00011,74.125.68.0-255,5738,22840,64,287928
21719,0.000113,172.31.40.0-255,66,22906,64,287928
21720,0.000116,74.125.68.0-255,1484,24390,64,287928
21721,0.000118,172.31.40.0-255,66,24456,64,287928
21722,0.000143,74.125.68.0-255,5738,30194,64,287928
21723,0.000145,172.31.40.0-255,66,30260,64,287928
21724,0.000152,74.125.68.0-255,5738,35998,64,287928
21725,0.000155,172.31.40.0-255,66,36064,64,287928
21726,0.000185,74.125.68.0-255,7156,43220,64,287928
21727,0.000188,172.31.40.0-255,66,43286,64,287928
21728,0.000215,74.125.68.0-255,5020,48306,64,287928
21729,0.000218,172.31.40.0-255,66,48372,64,287928
21730,0.000259,74.125.68.0-255,5738,54110,64,287928
21731,0.000263,172.31.40.0-255,66,54176,64,287928
21732,0.000267,74.125.68.0-255,2902,57078,64,287928
21733,0.000269,172.31.40.0-255,66,57144,64,287928
21734,0.000276,74.125.68.0-255,4320,61464,64,287928
21735,0.000278,172.31.40.0-255,66,61530,64,287928
21736,0.000301,74.125.68.0-255,2902,64432,64,287928
21737,0.000303,172.31.40.0-255,66,64498,64,287928
21738,0.000321,74.125.68.0-255,1125,65623,64,287928
21739,0.000425,74.125.68.0-255,646,66269,64,287928
21740,0.000429,172.31.40.0-255,66,66335,64,287928
21741,0.000461,74.125.68.0-255,1484,67819,64,287928
21742,0.000486,74.125.68.0-255,4320,72139,64,287928
21743,0.000489,172.31.40.0-255,66,72205,64,287928
21744,0.000497,74.125.68.0-255,7156,79361,64,287928
21745,0.0005,172.31.40.0-255,66,79427,64,287928
21746,0.000513,74.125.68.0-255,2902,82329,64,287928
21747,0.000515,172.31.40.0-255,66,82395,64,287928
21748,0.000518,74.125.68.0-255,576,82971,64,287928
21749,0.00093,74.125.68.0-255,1484,84455,64,287928
21750,0.000936,172.31.40.0-255,66,84521,64,287928
21751,0.00094,74.125.68.0-255,1484,86005,64,287928
21752,0.000957,74.125.68.0-255,2902,88907,64,287928
21753,0.00096,172.31.40.0-255,66,88973,64,287928
21754,0.000966,74.125.68.0-255,4320,93293,64,287928
21755,0.000968,172.31.40.0-255,66,93359,64,287928
21756,0.000985,74.125.68.0-255,1484,94843,64,287928
21757,0.001005,74.125.68.0-255,4320,99163,64,287928
21758,0.001008,172.31.40.0-255,66,99229,64,287928
21759,0.001027,74.125.68.0-255,7156,106385,64,287928
21760,0.00103,172.31.40.0-255,66,106451,64,287928
21761,0.001057,74.125.68.0-255,4320,110771,64,287928
21762,0.00106,172.31.40.0-255,66,110837,64,287928
21763,0.001086,74.125.68.0-255,6438,117275,64,287928
21764,0.001089,172.31.40.0-255,66,117341,64,287928
21765,0.002012,74.125.68.0-255,1484,118825,64,287928
21766,0.002023,74.125.68.0-255,2902,121727,64,287928
21767,0.002028,172.31.40.0-255,66,121793,64,287928
21768,0.002033,74.125.68.0-255,1484,123277,64,287928
21769,0.002052,74.125.68.0-255,1484,124761,64,287928
21770,0.002055,172.31.40.0-255,66,124827,64,287928
21771,0.002061,74.125.68.0-255,4320,129147,64,287928
21772,0.002063,172.31.40.0-255,66,129213,64,287928
21773,0.002073,172.31.40.0-255,66,129279,64,287928
21774,0.002079,74.125.68.0-255,4320,133599,64,287928
21775,0.002081,172.31.40.0-255,66,133665,64,287928
21776,0.002109,74.125.68.0-255,2902,136567,64,287928
21777,0.002112,172.31.40.0-255,66,136633,64,287928
21778,0.002151,74.125.68.0-255,2902,139535,64,287928
21779,0.002154,172.31.40.0-255,66,139601,64,287928
21780,0.002194,74.125.68.0-255,6438,146039,64,287928
21781,0.002197,172.31.40.0-255,66,146105,64,287928
21782,0.002209,172.31.40.0-255,66,146171,64,287928
21783,0.002224,172.31.40.0-255,66,146237,64,287928
21784,0.002238,74.125.68.0-255,4320,150557,64,287928
21785,0.002241,172.31.40.0-255,66,150623,64,287928
21786,0.002257,74.125.68.0-255,3602,154225,64,287928
21787,0.002259,172.31.40.0-255,66,154291,64,287928
21788,0.004744,74.125.68.0-255,1484,155775,64,287928
21789,0.004761,74.125.68.0-255,4320,160095,64,287928
21790,0.004766,172.31.40.0-255,66,160161,64,287928
21791,0.007263,74.125.68.0-255,4320,164481,64,287928
21792,0.00727,172.31.40.0-255,66,164547,64,287928
21793,0.007285,74.125.68.0-255,1484,166031,64,287928
21794,0.009794,74.125.68.0-255,4320,170351,64,287928
21795,0.009802,172.31.40.0-255,66,170417,64,287928
21796,0.012322,74.125.68.0-255,5738,176155,64,287928
21797,0.012343,172.31.40.0-255,66,176221,64,287928
21798,0.014853,74.125.68.0-255,5738,181959,64,287928
21799,0.014872,172.31.40.0-255,66,182025,64,287928
21800,0.01737,74.125.68.0-255,5738,187763,64,287928
21801,0.017381,172.31.40.0-255,66,187829,64,287928
21802,0.019906,74.125.68.0-255,5738,193567,64,287928
21803,0.019914,172.31.40.0-255,66,193633,64,287928
21804,0.022412,74.125.68.0-255,5738,199371,64,287928
21805,0.02242,172.31.40.0-255,66,199437,64,287928
21806,0.024951,74.125.68.0-255,5738,205175,64,287928
21807,0.024959,172.31.40.0-255,66,205241,64,287928
21808,0.027456,74.125.68.0-255,5738,210979,64,287928
21809,0.027464,172.31.40.0-255,66,211045,64,287928
21810,0.029962,74.125.68.0-255,5738,216783,64,287928
21811,0.029969,172.31.40.0-255,66,216849,64,287928
21812,0.030593,172.31.40.0-255,172,217021,64,287928
21813,0.030627,172.31.40.0-255,1112,218133,64,287928
21814,0.030688,172.31.40.0-255,1514,219647,64,287928
21815,0.030694,172.31.40.0-255,1514,221161,64,287928
21816,0.0307,172.31.40.0-255,1514,222675,64,287928
21817,0.030701,172.31.40.0-255,1079,223754,64,287928
21818,0.032179,104.244.42.0-255,66,223820,64,287928
21819,0.032206,104.244.42.0-255,66,223886,64,287928
21820,0.032252,104.244.42.0-255,66,223952,64,287928
21821,0.032257,104.244.42.0-255,66,224018,64,287928
21822,0.03245,74.125.68.0-255,1484,225502,64,287928
21823,0.032477,74.125.68.0-255,4320,229822,64,287928
21824,0.032485,172.31.40.0-255,66,229888,64,287928
21825,0.035,74.125.68.0-255,5738,235626,64,287928
21826,0.035015,172.31.40.0-255,66,235692,64,287928
21827,0.037538,74.125.68.0-255,5738,241430,64,287928
21828,0.037555,172.31.40.0-255,66,241496,64,287928
21829,0.040071,74.125.68.0-255,5738,247234,64,287928
21830,0.040087,172.31.40.0-255,66,247300,64,287928
21831,0.042592,74.125.68.0-255,5738,253038,64,287928
21832,0.042604,172.31.40.0-255,66,253104,64,287928
21833,0.045149,74.125.68.0-255,5738,258842,64,287928
21834,0.045168,172.31.40.0-255,66,258908,64,287928
21835,0.047679,74.125.68.0-255,5738,264646,64,287928
21836,0.047698,172.31.40.0-255,66,264712,64,287928
21837,0.050214,74.125.68.0-255,5738,270450,64,287928
21838,0.050233,172.31.40.0-255,66,270516,64,287928
21839,0.052799,74.125.68.0-255,5738,276254,64,287928
21840,0.052816,172.31.40.0-255,66,276320,64,287928
21841,0.055331,74.125.68.0-255,5738,282058,64,287928
21842,0.05535,172.31.40.0-255,66,282124,64,287928
21843,0.057872,74.125.68.0-255,5738,287862,64,287928
21844,0.057886,172.31.40.0-255,66,287928,64,287928
21845,0.0,216.58.221.0-255,146,146,64,289437
21846,2.5e-05,172.31.40.0-255,66,212,64,289437
21847,3.2e-05,216.58.221.0-255,1484,1696,64,289437
21848,3.7e-05,172.31.40.0-255,66,1762,64,289437
21849,4.3e-05,216.58.221.0-255,2902,4664,64,289437
21850,4.7e-05,172.31.40.0-255,66,4730,64,289437
21851,5.3e-05,216.58.221.0-255,4320,9050,64,289437
21852,5.7e-05,172.31.40.0-255,66,9116,64,289437
21853,8.3e-05,216.58.221.0-255,2902,12018,64,289437
21854,8.7e-05,172.31.40.0-255,66,12084,64,289437
21855,0.000155,216.58.221.0-255,1484,13568,64,289437
21856,0.000158,172.31.40.0-255,66,13634,64,289437
21857,0.000178,216.58.221.0-255,5738,19372,64,289437
21858,0.000181,172.31.40.0-255,66,19438,64,289437
21859,0.000205,216.58.221.0-255,4857,24295,64,289437
21860,0.000208,172.31.40.0-255,66,24361,64,289437
21861,0.000345,216.58.221.0-255,5738,30099,64,289437
21862,0.00035,172.31.40.0-255,66,30165,64,289437
21863,0.000368,216.58.221.0-255,1125,31290,64,289437
21864,0.00037,172.31.40.0-255,66,31356,64,289437
21865,0.000442,216.58.221.0-255,7156,38512,64,289437
21866,0.000445,172.31.40.0-255,66,38578,64,289437
21867,0.000548,216.58.221.0-255,2902,41480,64,289437
21868,0.000552,172.31.40.0-255,66,41546,64,289437
21869,0.000577,216.58.221.0-255,6797,48343,64,289437
21870,0.00058,172.31.40.0-255,66,48409,64,289437
21871,0.000686,216.58.221.0-255,5738,54147,64,289437
21872,0.00069,172.31.40.0-255,66,54213,64,289437
21873,0.000709,216.58.221.0-255,4320,58533,64,289437
21874,0.000712,172.31.40.0-255,66,58599,64,289437
21875,0.000853,216.58.221.0-255,7088,65687,64,289437
21876,0.00086,172.31.40.0-255,66,65753,64,289437
21877,0.000902,172.31.40.0-255,101,65854,64,289437
21878,0.000955,216.58.221.0-255,132,65986,64,289437
21879,0.001104,216.58.221.0-255,1484,67470,64,289437
21880,0.001109,172.31.40.0-255,66,67536,64,289437
21881,0.00112,216.58.221.0-255,2902,70438,64,289437
21882,0.001144,172.31.40.0-255,66,70504,64,289437
21883,0.001151,216.58.221.0-255,5738,76242,64,289437
21884,0.001156,172.31.40.0-255,66,76308,64,289437
21885,0.00123,216.58.221.0-255,4320,80628,64,289437
21886,0.001246,172.31.40.0-255,66,80694,64,289437
21887,0.001252,216.58.221.0-255,5379,86073,64,289437
21888,0.001262,172.31.40.0-255,66,86139,64,289437
21889,0.001381,216.58.221.0-255,4320,90459,64,289437
21890,0.001384,172.31.40.0-255,66,90525,64,289437
21891,0.001405,216.58.221.0-255,5738,96263,64,289437
21892,0.001424,172.31.40.0-255,66,96329,64,289437
21893,0.001527,216.58.221.0-255,4246,100575,64,289437
21894,0.001544,172.31.40.0-255,66,100641,64,289437
21895,0.001597,216.58.221.0-255,4320,104961,64,289437
21896,0.001602,172.31.40.0-255,66,105027,64,289437
21897,0.001678,216.58.221.0-255,4320,109347,64,289437
21898,0.001682,172.31.40.0-255,66,109413,64,289437
21899,0.001696,216.58.221.0-255,5738,115151,64,289437
21900,0.001712,172.31.40.0-255,66,115217,64,289437
21901,0.001807,216.58.221.0-255,1484,116701,64,289437
21902,0.001843,172.31.40.0-255,66,116767,64,289437
21903,0.001861,172.31.40.0-255,66,116833,64,289437
21904,0.002099,216.58.221.0-255,5738,122571,64,289437
21905,0.002103,172.31.40.0-255,66,122637,64,289437
21906,0.00215,216.58.221.0-255,5738,128375,64,289437
21907,0.002191,172.31.40.0-255,66,128441,64,289437
21908,0.002573,216.58.221.0-255,2184,130625,64,289437
21909,0.002579,172.31.40.0-255,66,130691,64,289437
21910,0.002651,216.58.221.0-255,5738,136429,64,289437
21911,0.003049,216.58.221.0-255,66,136495,64,289437
21912,0.008714,172.31.40.0-255,66,136561,64,289437
21913,0.010621,216.58.221.0-255,5738,142299,64,289437
21914,0.01063,172.31.40.0-255,66,142365,64,289437
21915,0.012539,216.58.221.0-255,5738,148103,64,289437
21916,0.012547,172.31.40.0-255,66,148169,64,289437
21917,0.01445,216.58.221.0-255,5738,153907,64,289437
21918,0.014458,172.31.40.0-255,66,153973,64,289437
21919,0.016361,216.58.221.0-255,5738,159711,64,289437
21920,0.016368,172.31.40.0-255,66,159777,64,289437
21921,0.018269,216.58.221.0-255,5738,165515,64,289437
21922,0.018275,172.31.40.0-255,66,165581,64,289437
21923,0.020184,216.58.221.0-255,5738,171319,64,289437
21924,0.020191,172.31.40.0-255,66,171385,64,289437
21925,0.022099,216.58.221.0-255,5738,177123,64,289437
21926,0.022107,172.31.40.0-255,66,177189,64,289437
21927,0.024014,216.58.221.0-255,5738,182927,64,289437
21928,0.024022,172.31.40.0-255,66,182993,64,289437
21929,0.025922,216.58.221.0-255,5738,188731,64,289437
21930,0.02593,172.31.40.0-255,66,188797,64,289437
21931,0.027834,216.58.221.0-255,5738,194535,64,289437
21932,0.027841,172.31.40.0-255,66,194601,64,289437
21933,0.029754,216.58.221.0-255,5738,200339,64,289437
21934,0.029767,172.31.40.0-255,66,200405,64,289437
21935,0.031683,216.58.221.0-255,5738,206143,64,289437
21936,0.0317,172.31.40.0-255,66,206209,64,289437
21937,0.033604,216.58.221.0-255,5738,211947,64,289437
21938,0.033616,172.31.40.0-255,66,212013,64,289437
21939,0.035518,216.58.221.0-255,5738,217751,64,289437
21940,0.035525,172.31.40.0-255,66,217817,64,289437
21941,0.03744,216.58.221.0-255,5738,223555,64,289437
21942,0.037455,172.31.40.0-255,66,223621,64,289437
21943,0.039267,172.31.40.0-255,167,223788,64,289437
21944,0.039301,172.31.40.0-255,1108,224896,64,289437
21945,0.039351,216.58.221.0-255,4320,229216,64,289437
21946,0.039357,172.31.40.0-255,66,229282,64,289437
21947,0.039377,216.58.221.0-255,1484,230766,64,289437
21948,0.039396,172.31.40.0-255,1514,232280,64,289437
21949,0.039398,172.31.40.0-255,337,232617,64,289437
21950,0.040804,104.244.42.0-255,66,232683,64,289437
21951,0.040847,104.244.42.0-255,66,232749,64,289437
21952,0.040946,104.244.42.0-255,66,232815,64,289437
21953,0.041252,216.58.221.0-255,4320,237135,64,289437
21954,0.041258,172.31.40.0-255,66,237201,64,289437
21955,0.043167,216.58.221.0-255,5738,242939,64,289437
21956,0.043175,172.31.40.0-255,66,243005,64,289437
21957,0.045074,216.58.221.0-255,5738,248743,64,289437
21958,0.045084,172.31.40.0-255,66,248809,64,289437
21959,0.046991,216.58.221.0-255,5738,254547,64,289437
21960,0.046999,172.31.40.0-255,66,254613,64,289437
21961,0.048907,216.58.221.0-255,5738,260351,64,289437
21962,0.048921,172.31.40.0-255,66,260417,64,289437
21963,0.050817,216.58.221.0-255,5738,266155,64,289437
21964,0.050824,172.31.40.0-255,66,266221,64,289437
21965,0.052728,216.58.221.0-255,5738,271959,64,289437
21966,0.052741,172.31.40.0-255,66,272025,64,289437
21967,0.054732,216.58.221.0-255,5738,277763,64,289437
21968,0.05474,172.31.40.0-255,66,277829,64,289437
21969,0.056661,216.58.221.0-255,5738,283567,64,289437
21970,0.056678,172.31.40.0-255,66,283633,64,289437
21971,0.058578,216.58.221.0-255,5738,289371,64,289437
21972,0.058585,172.31.40.0-255,66,289437,64,289437
21973,0.0,52.27.36.0-255,97,97,64,260
21974,0.000146,172.31.40.0-255,97,194,64,260
21975,0.000159,172.31.40.0-255,66,260,64,260
21976,0.0,74.125.24.0-255,152,152,64,292231
21977,2.3e-05,172.31.40.0-255,66,218,64,292231
21978,3.1e-05,74.125.24.0-255,1484,1702,64,292231
21979,3.5e-05,172.31.40.0-255,66,1768,64,292231
21980,5.8e-05,74.125.24.0-255,2902,4670,64,292231
21981,6.2e-05,172.31.40.0-255,66,4736,64,292231
21982,7e-05,74.125.24.0-255,7156,11892,64,292231
21983,7.3e-05,172.31.40.0-255,66,11958,64,292231
21984,7.7e-05,74.125.24.0-255,1968,13926,64,292231
21985,7.9e-05,172.31.40.0-255,66,13992,64,292231
21986,0.000323,74.125.24.0-255,1484,15476,64,292231
21987,0.000328,172.31.40.0-255,66,15542,64,292231
21988,0.000348,74.125.24.0-255,2902,18444,64,292231
21989,0.000351,172.31.40.0-255,66,18510,64,292231
21990,0.000358,74.125.24.0-255,4320,22830,64,292231
21991,0.00036,172.31.40.0-255,66,22896,64,292231
21992,0.00039,74.125.24.0-255,1484,24380,64,292231
21993,0.000393,172.31.40.0-255,66,24446,64,292231
21994,0.000396,74.125.24.0-255,1484,25930,64,292231
21995,0.000398,172.31.40.0-255,66,25996,64,292231
21996,0.000437,74.125.24.0-255,5379,31375,64,292231
21997,0.00044,172.31.40.0-255,66,31441,64,292231
21998,0.000479,74.125.24.0-255,5738,37179,64,292231
21999,0.000483,172.31.40.0-255,66,37245,64,292231
22000,0.000494,172.31.40.0-255,66,37311,64,292231
22001,0.000533,172.31.40.0-255,66,37377,64,292231
22002,0.000536,74.125.24.0-255,1484,38861,64,292231
22003,0.000538,172.31.40.0-255,66,38927,64,292231
22004,0.000593,74.125.24.0-255,2902,41829,64,292231
22005,0.000596,172.31.40.0-255,66,41895,64,292231
22006,0.000623,74.125.24.0-255,5020,46915,64,292231
22007,0.000627,172.31.40.0-255,66,46981,64,292231
22008,0.000629,74.125.24.0-255,428,47409,64,292231
22009,0.00091,74.125.24.0-255,1484,48893,64,292231
22010,0.000915,172.31.40.0-255,66,48959,64,292231
22011,0.000921,74.125.24.0-255,2902,51861,64,292231
22012,0.000923,172.31.40.0-255,66,51927,64,292231
22013,0.000926,74.125.24.0-255,1484,53411,64,292231
22014,0.000946,74.125.24.0-255,1484,54895,64,292231
22015,0.000949,172.31.40.0-255,66,54961,64,292231
22016,0.000959,74.125.24.0-255,4320,59281,64,292231
22017,0.000961,172.31.40.0-255,66,59347,64,292231
22018,0.000971,172.31.40.0-255,66,59413,64,292231
22019,0.001018,172.31.40.0-255,66,59479,64,292231
22020,0.001021,74.125.24.0-255,766,60245,64,292231
22021,0.001057,74.125.24.0-255,347,60592,64,292231
22022,0.001079,74.125.24.0-255,1484,62076,64,292231
22023,0.001082,172.31.40.0-255,66,62142,64,292231
22024,0.001117,74.125.24.0-255,4320,66462,64,292231
22025,0.00112,172.31.40.0-255,66,66528,64,292231
22026,0.001155,74.125.24.0-255,5738,72266,64,292231
22027,0.001159,172.31.40.0-255,66,72332,64,292231
22028,0.001163,74.125.24.0-255,2902,75234,64,292231
22029,0.001165,172.31.40.0-255,66,75300,64,292231
22030,0.001204,172.31.40.0-255,66,75366,64,292231
22031,0.001218,172.31.40.0-255,66,75432,64,292231
22032,0.001267,74.125.24.0-255,1484,76916,64,292231
22033,0.001283,74.125.24.0-255,2902,79818,64,292231
22034,0.001286,172.31.40.0-255,66,79884,64,292231
22035,0.001301,74.125.24.0-255,4320,84204,64,292231
22036,0.001308,172.31.40.0-255,66,84270,64,292231
22037,0.001329,74.125.24.0-255,1484,85754,64,292231
22038,0.001348,172.31.40.0-255,66,85820,64,292231
22039,0.001362,172.31.40.0-255,66,85886,64,292231
22040,0.00145,74.125.24.0-255,1484,87370,64,292231
22041,0.001455,74.125.24.0-255,2902,90272,64,292231
22042,0.001458,172.31.40.0-255,66,90338,64,292231
22043,0.001461,74.125.24.0-255,1484,91822,64,292231
22044,0.001489,74.125.24.0-255,4320,96142,64,292231
22045,0.001492,172.31.40.0-255,66,96208,64,292231
22046,0.001504,172.31.40.0-255,66,96274,64,292231
22047,0.001532,74.125.24.0-255,2902,99176,64,292231
22048,0.001544,74.125.24.0-255,7156,106332,64,292231
22049,0.001548,74.125.24.0-255,3602,109934,64,292231
22050,0.001553,172.31.40.0-255,66,110000,64,292231
22051,0.001563,172.31.40.0-255,66,110066,64,292231
22052,0.001566,172.31.40.0-255,66,110132,64,292231
22053,0.001913,74.125.24.0-255,1484,111616,64,292231
22054,0.001918,74.125.24.0-255,1484,113100,64,292231
22055,0.00192,172.31.40.0-255,66,113166,64,292231
22056,0.001946,74.125.24.0-255,1484,114650,64,292231
22057,0.001952,74.125.24.0-255,5738,120388,64,292231
22058,0.001954,172.31.40.0-255,66,120454,64,292231
22059,0.001974,74.125.24.0-255,2902,123356,64,292231
22060,0.001976,172.31.40.0-255,66,123422,64,292231
22061,0.002001,74.125.24.0-255,4320,127742,64,292231
22062,0.002003,172.31.40.0-255,66,127808,64,292231
22063,0.002016,172.31.40.0-255,66,127874,64,292231
22064,0.002062,74.125.24.0-255,3602,131476,64,292231
22065,0.002064,172.31.40.0-255,66,131542,64,292231
22066,0.004051,74.125.24.0-255,1484,133026,64,292231
22067,0.004152,74.125.24.0-255,2902,135928,64,292231
22068,0.004156,172.31.40.0-255,66,135994,64,292231
22069,0.004183,74.125.24.0-255,1484,137478,64,292231
22070,0.006213,74.125.24.0-255,4320,141798,64,292231
22071,0.006217,172.31.40.0-255,66,141864,64,292231
22072,0.008268,74.125.24.0-255,5738,147602,64,292231
22073,0.008273,172.31.40.0-255,66,147668,64,292231
22074,0.010352,74.125.24.0-255,5738,153406,64,292231
22075,0.010367,172.31.40.0-255,66,153472,64,292231
22076,0.012423,74.125.24.0-255,5738,159210,64,292231
22077,0.012437,172.31.40.0-255,66,159276,64,292231
22078,0.014504,74.125.24.0-255,5738,165014,64,292231
22079,0.014518,172.31.40.0-255,66,165080,64,292231
22080,0.016592,74.125.24.0-255,5738,170818,64,292231
22081,0.016605,172.31.40.0-255,66,170884,64,292231
22082,0.018651,74.125.24.0-255,5738,176622,64,292231
22083,0.018659,172.31.40.0-255,66,176688,64,292231
22084,0.020729,74.125.24.0-255,5738,182426,64,292231
22085,0.020738,172.31.40.0-255,66,182492,64,292231
22086,0.022796,74.125.24.0-255,5738,188230,64,292231
22087,0.022805,172.31.40.0-255,66,188296,64,292231
22088,0.024858,74.125.24.0-255,5738,194034,64,292231
22089,0.024867,172.31.40.0-255,66,194100,64,292231
22090,0.026921,74.125.24.0-255,5738,199838,64,292231
22091,0.02693,172.31.40.0-255,66,199904,64,292231
22092,0.029019,74.125.24.0-255,5738,205642,64,292231
22093,0.029025,172.31.40.0-255,66,205708,64,292231
22094,0.031093,74.125.24.0-255,5738,211446,64,292231
22095,0.0311,172.31.40.0-255,66,211512,64,292231
22096,0.033153,74.125.24.0-255,5738,217250,64,292231
22097,0.03316,172.31.40.0-255,66,217316,64,292231
22098,0.035243,74.125.24.0-255,5738,223054,64,292231
22099,0.035253,172.31.40.0-255,66,223120,64,292231
22100,0.03732,74.125.24.0-255,5738,228858,64,292231
22101,0.037329,172.31.40.0-255,66,228924,64,292231
22102,0.039403,74.125.24.0-255,5738,234662,64,292231
22103,0.039415,172.31.40.0-255,66,234728,64,292231
22104,0.041477,74.125.24.0-255,5738,240466,64,292231
22105,0.041488,172.31.40.0-255,66,240532,64,292231
22106,0.043572,74.125.24.0-255,5738,246270,64,292231
22107,0.043589,172.31.40.0-255,66,246336,64,292231
22108,0.045635,74.125.24.0-255,5738,252074,64,292231
22109,0.045642,172.31.40.0-255,66,252140,64,292231
22110,0.047543,172.31.40.0-255,167,252307,64,292231
22111,0.047576,172.31.40.0-255,1111,253418,64,292231
22112,0.047642,172.31.40.0-255,1514,254932,64,292231
22113,0.047664,172.31.40.0-255,1514,256446,64,292231
22114,0.047667,172.31.40.0-255,697,257143,64,292231
22115,0.047708,74.125.24.0-255,5738,262881,64,292231
22116,0.047713,172.31.40.0-255,66,262947,64,292231
22117,0.049096,104.244.42.0-255,66,263013,64,292231
22118,0.049128,104.244.42.0-255,66,263079,64,292231
22119,0.049192,104.244.42.0-255,66,263145,64,292231
22120,0.049236,104.244.42.0-255,66,263211,64,292231
22121,0.049765,74.125.24.0-255,5738,268949,64,292231
22122,0.049774,172.31.40.0-255,66,269015,64,292231
22123,0.051819,74.125.24.0-255,5738,274753,64,292231
22124,0.051833,172.31.40.0-255,66,274819,64,292231
22125,0.053912,74.125.24.0-255,5738,280557,64,292231
22126,0.053928,172.31.40.0-255,66,280623,64,292231
22127,0.055983,74.125.24.0-255,5738,286361,64,292231
22128,0.056004,172.31.40.0-255,66,286427,64,292231
22129,0.058076,74.125.24.0-255,5738,292165,64,292231
22130,0.058093,172.31.40.0-255,66,292231,64,292231
22131,0.0,172.217.194.0-255,153,153,64,159491
22132,2.1e-05,172.31.40.0-255,66,219,64,159491
22133,2.7e-05,172.217.194.0-255,1484,1703,64,159491
22134,3.1e-05,172.31.40.0-255,66,1769,64,159491
22135,3.6e-05,172.217.194.0-255,2902,4671,64,159491
22136,3.8e-05,172.31.40.0-255,66,4737,64,159491
22137,4.5e-05,172.217.194.0-255,7156,11893,64,159491
22138,4.8e-05,172.31.40.0-255,66,11959,64,159491
22139,7.2e-05,172.217.194.0-255,1484,13443,64,159491
22140,7.5e-05,172.31.40.0-255,66,13509,64,159491
22141,0.000114,172.31.40.0-255,66,13575,64,159491
22142,0.000125,172.31.40.0-255,66,13641,64,159491
22143,0.000146,172.217.194.0-255,1484,15125,64,159491
22144,0.000147,172.31.40.0-255,66,15191,64,159491
22145,0.000164,172.217.194.0-255,7156,22347,64,159491
22146,0.000166,172.31.40.0-255,66,22413,64,159491
22147,0.000195,172.31.40.0-255,66,22479,64,159491
22148,0.000505,172.217.194.0-255,119,22598,64,159491
22149,0.00051,172.31.40.0-255,66,22664,64,159491
22150,0.000638,172.217.194.0-255,1484,24148,64,159491
22151,0.000642,172.31.40.0-255,66,24214,64,159491
22152,0.000655,172.217.194.0-255,2902,27116,64,159491
22153,0.000657,172.31.40.0-255,66,27182,64,159491
22154,0.000671,172.217.194.0-255,4320,31502,64,159491
22155,0.000673,172.31.40.0-255,66,31568,64,159491
22156,0.000685,172.217.194.0-255,1484,33052,64,159491
22157,0.000687,172.31.40.0-255,66,33118,64,159491
22158,0.000726,172.31.40.0-255,66,33184,64,159491
22159,0.000736,172.31.40.0-255,66,33250,64,159491
22160,0.000739,172.217.194.0-255,766,34016,64,159491
22161,0.001199,172.31.40.0-255,66,34082,64,159491
22162,0.001969,172.217.194.0-255,1484,35566,64,159491
22163,0.00198,172.217.194.0-255,2902,38468,64,159491
22164,0.001984,172.31.40.0-255,66,38534,64,159491
22165,0.001993,172.217.194.0-255,5738,44272,64,159491
22166,0.001995,172.31.40.0-255,66,44338,64,159491
22167,0.002041,172.31.40.0-255,66,44404,64,159491
22168,0.002051,172.31.40.0-255,66,44470,64,159491
22169,0.00207,172.217.194.0-255,2184,46654,64,159491
22170,0.002072,172.31.40.0-255,66,46720,64,159491
22171,0.002208,172.217.194.0-255,1484,48204,64,159491
22172,0.002223,172.217.194.0-255,2902,51106,64,159491
22173,0.002225,172.31.40.0-255,66,51172,64,159491
22174,0.002246,172.217.194.0-255,5738,56910,64,159491
22175,0.002249,172.31.40.0-255,66,56976,64,159491
22176,0.002255,172.217.194.0-255,4320,61296,64,159491
22177,0.002257,172.31.40.0-255,66,61362,64,159491
22178,0.002277,172.217.194.0-255,5738,67100,64,159491
22179,0.002279,172.31.40.0-255,66,67166,64,159491
22180,0.002293,172.217.194.0-255,1484,68650,64,159491
22181,0.002318,172.31.40.0-255,66,68716,64,159491
22182,0.002432,172.217.194.0-255,1484,70200,64,159491
22183,0.002435,172.217.194.0-255,1484,71684,64,159491
22184,0.002438,172.31.40.0-255,66,71750,64,159491
22185,0.002458,172.217.194.0-255,1484,73234,64,159491
22186,0.002465,172.217.194.0-255,5738,78972,64,159491
22187,0.002467,172.31.40.0-255,66,79038,64,159491
22188,0.00247,172.217.194.0-255,1484,80522,64,159491
22189,0.002491,172.31.40.0-255,66,80588,64,159491
22190,0.002517,172.217.194.0-255,1484,82072,64,159491
22191,0.002529,172.31.40.0-255,66,82138,64,159491
22192,0.002553,172.217.194.0-255,1484,83622,64,159491
22193,0.002557,172.217.194.0-255,2902,86524,64,159491
22194,0.00256,172.31.40.0-255,66,86590,64,159491
22195,0.002563,172.217.194.0-255,1484,88074,64,159491
22196,0.002584,172.217.194.0-255,2902,90976,64,159491
22197,0.002587,172.31.40.0-255,66,91042,64,159491
22198,0.002612,172.217.194.0-255,5738,96780,64,159491
22199,0.002615,172.31.40.0-255,66,96846,64,159491
22200,0.002622,172.217.194.0-255,7156,104002,64,159491
22201,0.002625,172.31.40.0-255,66,104068,64,159491
22202,0.002637,172.31.40.0-255,66,104134,64,159491
22203,0.002665,172.217.194.0-255,5738,109872,64,159491
22204,0.002668,172.31.40.0-255,66,109938,64,159491
22205,0.002702,172.31.40.0-255,66,110004,64,159491
22206,0.002717,172.31.40.0-255,66,110070,64,159491
22207,0.00272,172.217.194.0-255,1484,111554,64,159491
22208,0.002722,172.31.40.0-255,78,111632,64,159491
22209,0.002738,172.31.40.0-255,66,111698,64,159491
22210,0.002744,172.217.194.0-255,5738,117436,64,159491
22211,0.002747,172.31.40.0-255,66,117502,64,159491
22212,0.002754,172.217.194.0-255,7156,124658,64,159491
22213,0.002758,172.31.40.0-255,66,124724,64,159491
22214,0.00276,172.217.194.0-255,1484,126208,64,159491
22215,0.002765,172.217.194.0-255,2902,129110,64,159491
22216,0.002768,172.31.40.0-255,66,129176,64,159491
22217,0.002837,172.31.40.0-255,66,129242,64,159491
22218,0.002842,172.217.194.0-255,4320,133562,64,159491
22219,0.002844,172.31.40.0-255,66,133628,64,159491
22220,0.002847,172.217.194.0-255,1484,135112,64,159491
22221,0.002852,172.217.194.0-255,4320,139432,64,159491
22222,0.002855,172.31.40.0-255,66,139498,64,159491
22223,0.002875,172.31.40.0-255,66,139564,64,159491
22224,0.002888,172.31.40.0-255,66,139630,64,159491
22225,0.002938,172.31.40.0-255,66,139696,64,159491
22226,0.002967,172.31.40.0-255,66,139762,64,159491
22227,0.002974,172.217.194.0-255,7156,146918,64,159491
22228,0.002976,172.31.40.0-255,66,146984,64,159491
22229,0.003025,172.217.194.0-255,4320,151304,64,159491
22230,0.003042,172.217.194.0-255,3386,154690,64,159491
22231,0.003045,172.217.194.0-255,105,154795,64,159491
22232,0.007768,172.31.40.0-255,66,154861,64,159491
22233,0.00923,172.31.40.0-255,101,154962,64,159491
22234,0.010175,172.31.40.0-255,105,155067,64,159491
22235,0.011245,172.217.194.0-255,66,155133,64,159491
22236,0.012195,172.217.194.0-255,66,155199,64,159491
22237,0.031955,172.31.40.0-255,172,155371,64,159491
22238,0.031989,172.31.40.0-255,1111,156482,64,159491
22239,0.03205,172.31.40.0-255,1514,157996,64,159491
22240,0.032052,172.31.40.0-255,1297,159293,64,159491
22241,0.033542,104.244.42.0-255,66,159359,64,159491
22242,0.033584,104.244.42.0-255,66,159425,64,159491
22243,0.03361,104.244.42.0-255,66,159491,64,159491
22244,0.0,172.217.194.0-255,153,153,64,150349
22245,2.6e-05,172.31.40.0-255,66,219,64,150349
22246,3.4e-05,172.217.194.0-255,1484,1703,64,150349
22247,3.8e-05,172.31.40.0-255,66,1769,64,150349
22248,5.2e-05,172.217.194.0-255,2902,4671,64,150349
22249,5.5e-05,172.31.40.0-255,66,4737,64,150349
22250,6.3e-05,172.217.194.0-255,7156,11893,64,150349
22251,6.6e-05,172.31.40.0-255,66,11959,64,150349
22252,6.8e-05,172.217.194.0-255,1484,13443,64,150349
22253,7.1e-05,172.31.40.0-255,66,13509,64,150349
22254,8.6e-05,172.31.40.0-255,66,13575,64,150349
22255,0.000121,172.217.194.0-255,6797,20372,64,150349
22256,0.000124,172.31.40.0-255,66,20438,64,150349
22257,0.000169,172.217.194.0-255,1484,21922,64,150349
22258,0.000171,172.31.40.0-255,66,21988,64,150349
22259,0.000176,172.217.194.0-255,2902,24890,64,150349
22260,0.000178,172.31.40.0-255,66,24956,64,150349
22261,0.000181,172.217.194.0-255,1484,26440,64,150349
22262,0.000183,172.31.40.0-255,66,26506,64,150349
22263,0.000216,172.217.194.0-255,4320,30826,64,150349
22264,0.000219,172.31.40.0-255,66,30892,64,150349
22265,0.000226,172.217.194.0-255,5738,36630,64,150349
22266,0.000228,172.31.40.0-255,66,36696,64,150349
22267,0.000235,172.217.194.0-255,7156,43852,64,150349
22268,0.000238,172.31.40.0-255,66,43918,64,150349
22269,0.00027,172.217.194.0-255,6797,50715,64,150349
22270,0.000274,172.31.40.0-255,66,50781,64,150349
22271,0.000279,172.217.194.0-255,4250,55031,64,150349
22272,0.000281,172.31.40.0-255,66,55097,64,150349
22273,0.000284,172.217.194.0-255,398,55495,64,150349
22274,0.000286,172.31.40.0-255,66,55561,64,150349
22275,0.000413,172.217.194.0-255,1484,57045,64,150349
22276,0.00042,172.217.194.0-255,2902,59947,64,150349
22277,0.000423,172.31.40.0-255,66,60013,64,150349
22278,0.000456,172.217.194.0-255,5738,65751,64,150349
22279,0.000459,172.31.40.0-255,66,65817,64,150349
22280,0.000467,172.217.194.0-255,7156,72973,64,150349
22281,0.00047,172.31.40.0-255,66,73039,64,150349
22282,0.00048,172.217.194.0-255,1484,74523,64,150349
22283,0.000518,172.31.40.0-255,66,74589,64,150349
22284,0.000523,172.217.194.0-255,2184,76773,64,150349
22285,0.000525,172.31.40.0-255,66,76839,64,150349
22286,0.000896,172.217.194.0-255,1484,78323,64,150349
22287,0.000903,172.217.194.0-255,2902,81225,64,150349
22288,0.000906,172.31.40.0-255,66,81291,64,150349
22289,0.000912,172.217.194.0-255,2902,84193,64,150349
22290,0.000913,172.31.40.0-255,66,84259,64,150349
22291,0.000956,172.217.194.0-255,2902,87161,64,150349
22292,0.000959,172.31.40.0-255,66,87227,64,150349
22293,0.000973,172.31.40.0-255,66,87293,64,150349
22294,0.000997,172.217.194.0-255,2902,90195,64,150349
22295,0.000999,172.31.40.0-255,66,90261,64,150349
22296,0.001035,172.31.40.0-255,66,90327,64,150349
22297,0.001111,172.217.194.0-255,1484,91811,64,150349
22298,0.001117,172.217.194.0-255,2902,94713,64,150349
22299,0.00112,172.31.40.0-255,66,94779,64,150349
22300,0.001133,172.217.194.0-255,4320,99099,64,150349
22301,0.001139,172.31.40.0-255,66,99165,64,150349
22302,0.001167,172.217.194.0-255,1484,100649,64,150349
22303,0.001182,172.31.40.0-255,66,100715,64,150349
22304,0.0012,172.31.40.0-255,66,100781,64,150349
22305,0.001226,172.217.194.0-255,4320,105101,64,150349
22306,0.00123,172.31.40.0-255,66,105167,64,150349
22307,0.001259,172.31.40.0-255,66,105233,64,150349
22308,0.001317,172.31.40.0-255,66,105299,64,150349
22309,0.001345,172.217.194.0-255,5738,111037,64,150349
22310,0.001348,172.31.40.0-255,66,111103,64,150349
22311,0.001351,172.217.194.0-255,766,111869,64,150349
22312,0.001364,172.31.40.0-255,66,111935,64,150349
22313,0.001378,172.31.40.0-255,66,112001,64,150349
22314,0.001385,172.217.194.0-255,7156,119157,64,150349
22315,0.001388,172.31.40.0-255,66,119223,64,150349
22316,0.001409,172.217.194.0-255,2184,121407,64,150349
22317,0.001411,172.31.40.0-255,66,121473,64,150349
22318,0.001422,172.217.194.0-255,1484,122957,64,150349
22319,0.001426,172.217.194.0-255,1484,124441,64,150349
22320,0.001428,172.31.40.0-255,66,124507,64,150349
22321,0.001455,172.217.194.0-255,1484,125991,64,150349
22322,0.001461,172.217.194.0-255,5738,131729,64,150349
22323,0.001463,172.31.40.0-255,66,131795,64,150349
22324,0.001466,172.217.194.0-255,1484,133279,64,150349
22325,0.001497,172.31.40.0-255,66,133345,64,150349
22326,0.001509,172.31.40.0-255,66,133411,64,150349
22327,0.001537,172.217.194.0-255,766,134177,64,150349
22328,0.001571,172.217.194.0-255,1484,135661,64,150349
22329,0.001574,172.217.194.0-255,1484,137145,64,150349
22330,0.001578,172.31.40.0-255,66,137211,64,150349
22331,0.001604,172.217.194.0-255,1484,138695,64,150349
22332,0.001607,172.31.40.0-255,66,138761,64,150349
22333,0.001613,172.217.194.0-255,5738,144499,64,150349
22334,0.001616,172.31.40.0-255,66,144565,64,150349
22335,0.00163,172.31.40.0-255,66,144631,64,150349
22336,0.001632,172.217.194.0-255,1484,146115,64,150349
22337,0.001682,172.31.40.0-255,66,146181,64,150349
22338,0.001738,172.31.40.0-255,66,146247,64,150349
22339,0.001754,172.31.40.0-255,66,146313,64,150349
22340,0.001785,172.31.40.0-255,66,146379,64,150349
22341,0.001833,172.31.40.0-255,66,146445,64,150349
22342,0.001885,172.31.40.0-255,66,146511,64,150349
22343,0.001928,172.31.40.0-255,66,146577,64,150349
22344,0.001931,172.217.194.0-255,105,146682,64,150349
22345,0.003904,172.31.40.0-255,101,146783,64,150349
22346,0.004869,172.31.40.0-255,105,146888,64,150349
22347,0.006184,172.217.194.0-255,66,146954,64,150349
22348,0.007104,172.217.194.0-255,66,147020,64,150349
22349,0.046263,172.31.40.0-255,172,147192,64,150349
22350,0.046301,172.31.40.0-255,1108,148300,64,150349
22351,0.046366,172.31.40.0-255,1514,149814,64,150349
22352,0.046367,172.31.40.0-255,337,150151,64,150349
22353,0.047805,104.244.42.0-255,66,150217,64,150349
22354,0.047832,104.244.42.0-255,66,150283,64,150349
22355,0.047926,104.244.42.0-255,66,150349,64,150349
22356,0.0,172.31.40.0-255,105,105,64,459
22357,0.000137,172.31.40.0-255,90,195,64,459
22358,0.000147,172.31.40.0-255,66,261,64,459
22359,0.002483,74.125.24.0-255,66,327,64,459
22360,0.002505,74.125.24.0-255,66,393,64,459
22361,0.002515,172.31.40.0-255,66,459,64,459
22362,0.0,172.31.40.0-255,105,105,64,459
22363,0.000165,172.31.40.0-255,90,195,64,459
22364,0.000176,172.31.40.0-255,66,261,64,459
22365,0.002174,172.217.194.0-255,66,327,64,459
22366,0.002187,172.217.194.0-255,66,393,64,459
22367,0.002193,172.31.40.0-255,66,459,64,459
22368,0.0,74.125.68.0-255,299,299,64,343611
22369,2.3e-05,172.31.40.0-255,66,365,64,343611
22370,3e-05,74.125.68.0-255,1484,1849,64,343611
22371,3.4e-05,172.31.40.0-255,66,1915,64,343611
22372,3.9e-05,74.125.68.0-255,2902,4817,64,343611
22373,4.2e-05,172.31.40.0-255,66,4883,64,343611
22374,4.9e-05,74.125.68.0-255,5738,10621,64,343611
22375,5.2e-05,172.31.40.0-255,66,10687,64,343611
22376,5.8e-05,74.125.68.0-255,3258,13945,64,343611
22377,6e-05,172.31.40.0-255,66,14011,64,343611
22378,9e-05,74.125.68.0-255,4320,18331,64,343611
22379,9.2e-05,172.31.40.0-255,66,18397,64,343611
22380,0.00013,172.31.40.0-255,66,18463,64,343611
22381,0.000151,74.125.68.0-255,3961,22424,64,343611
22382,0.000154,172.31.40.0-255,66,22490,64,343611
22383,0.00047,74.125.68.0-255,1484,23974,64,343611
22384,0.000475,172.31.40.0-255,66,24040,64,343611
22385,0.00048,74.125.68.0-255,1484,25524,64,343611
22386,0.000482,172.31.40.0-255,66,25590,64,343611
22387,0.000497,74.125.68.0-255,1484,27074,64,343611
22388,0.000499,172.31.40.0-255,66,27140,64,343611
22389,0.000519,74.125.68.0-255,4320,31460,64,343611
22390,0.000522,172.31.40.0-255,66,31526,64,343611
22391,0.000546,74.125.68.0-255,5738,37264,64,343611
22392,0.000549,172.31.40.0-255,66,37330,64,343611
22393,0.000568,74.125.68.0-255,2543,39873,64,343611
22394,0.00057,172.31.40.0-255,66,39939,64,343611
22395,0.000584,74.125.68.0-255,2902,42841,64,343611
22396,0.000587,172.31.40.0-255,66,42907,64,343611
22397,0.000614,74.125.68.0-255,2902,45809,64,343611
22398,0.000617,172.31.40.0-255,66,45875,64,343611
22399,0.00062,74.125.68.0-255,1484,47359,64,343611
22400,0.000635,74.125.68.0-255,2902,50261,64,343611
22401,0.000653,172.31.40.0-255,66,50327,64,343611
22402,0.000667,74.125.68.0-255,4320,54647,64,343611
22403,0.000684,74.125.68.0-255,2543,57190,64,343611
22404,0.000695,172.31.40.0-255,66,57256,64,343611
22405,0.000933,74.125.68.0-255,646,57902,64,343611
22406,0.001119,172.31.40.0-255,66,57968,64,343611
22407,0.001166,74.125.68.0-255,1484,59452,64,343611
22408,0.001193,74.125.68.0-255,1484,60936,64,343611
22409,0.001204,74.125.68.0-255,1484,62420,64,343611
22410,0.001208,172.31.40.0-255,66,62486,64,343611
22411,0.00123,74.125.68.0-255,5738,68224,64,343611
22412,0.001245,172.31.40.0-255,66,68290,64,343611
22413,0.001264,74.125.68.0-255,1484,69774,64,343611
22414,0.001287,74.125.68.0-255,5738,75512,64,343611
22415,0.001291,74.125.68.0-255,2902,78414,64,343611
22416,0.001297,74.125.68.0-255,4320,82734,64,343611
22417,0.001317,172.31.40.0-255,66,82800,64,343611
22418,0.001331,74.125.68.0-255,2902,85702,64,343611
22419,0.001345,74.125.68.0-255,4320,90022,64,343611
22420,0.001353,172.31.40.0-255,66,90088,64,343611
22421,0.001381,74.125.68.0-255,2184,92272,64,343611
22422,0.0014,172.31.40.0-255,66,92338,64,343611
22423,0.001521,74.125.68.0-255,1484,93822,64,343611
22424,0.001542,74.125.68.0-255,2902,96724,64,343611
22425,0.001545,172.31.40.0-255,66,96790,64,343611
22426,0.001564,74.125.68.0-255,4320,101110,64,343611
22427,0.001569,172.31.40.0-255,66,101176,64,343611
22428,0.001582,74.125.68.0-255,1484,102660,64,343611
22429,0.001585,74.125.68.0-255,1484,104144,64,343611
22430,0.001589,74.125.68.0-255,2902,107046,64,343611
22431,0.001604,172.31.40.0-255,66,107112,64,343611
22432,0.001612,74.125.68.0-255,1484,108596,64,343611
22433,0.001627,74.125.68.0-255,4320,112916,64,343611
22434,0.00163,74.125.68.0-255,1484,114400,64,343611
22435,0.001642,74.125.68.0-255,1484,115884,64,343611
22436,0.001653,74.125.68.0-255,1484,117368,64,343611
22437,0.001655,172.31.40.0-255,66,117434,64,343611
22438,0.001672,74.125.68.0-255,4320,121754,64,343611
22439,0.001684,74.125.68.0-255,1484,123238,64,343611
22440,0.001686,74.125.68.0-255,1484,124722,64,343611
22441,0.001694,172.31.40.0-255,66,124788,64,343611
22442,0.001709,74.125.68.0-255,2184,126972,64,343611
22443,0.001723,172.31.40.0-255,66,127038,64,343611
22444,0.001874,74.125.68.0-255,1484,128522,64,343611
22445,0.001892,74.125.68.0-255,2902,131424,64,343611
22446,0.001895,172.31.40.0-255,66,131490,64,343611
22447,0.001919,74.125.68.0-255,5738,137228,64,343611
22448,0.001952,74.125.68.0-255,7156,144384,64,343611
22449,0.001958,74.125.68.0-255,5738,150122,64,343611
22450,0.001969,172.31.40.0-255,66,150188,64,343611
22451,0.001973,74.125.68.0-255,2902,153090,64,343611
22452,0.001982,172.31.40.0-255,66,153156,64,343611
22453,0.001989,74.125.68.0-255,5738,158894,64,343611
22454,0.00201,74.125.68.0-255,2184,161078,64,343611
22455,0.002014,172.31.40.0-255,66,161144,64,343611
22456,0.002151,74.125.68.0-255,1484,162628,64,343611
22457,0.002166,74.125.68.0-255,2902,165530,64,343611
22458,0.002169,172.31.40.0-255,66,165596,64,343611
22459,0.002189,74.125.68.0-255,5738,171334,64,343611
22460,0.002201,74.125.68.0-255,2902,174236,64,343611
22461,0.002222,74.125.68.0-255,4320,178556,64,343611
22462,0.002225,172.31.40.0-255,66,178622,64,343611
22463,0.00223,172.31.40.0-255,66,178688,64,343611
22464,0.002251,74.125.68.0-255,2902,181590,64,343611
22465,0.002264,74.125.68.0-255,2902,184492,64,343611
22466,0.002271,172.31.40.0-255,66,184558,64,343611
22467,0.002286,74.125.68.0-255,4320,188878,64,343611
22468,0.002297,172.31.40.0-255,66,188944,64,343611
22469,0.002306,74.125.68.0-255,2902,191846,64,343611
22470,0.002309,74.125.68.0-255,1484,193330,64,343611
22471,0.002312,172.31.40.0-255,66,193396,64,343611
22472,0.002324,74.125.68.0-255,6438,199834,64,343611
22473,0.002343,172.31.40.0-255,66,199900,64,343611
22474,0.004619,74.125.68.0-255,5738,205638,64,343611
22475,0.004626,172.31.40.0-255,66,205704,64,343611
22476,0.006939,74.125.68.0-255,4320,210024,64,343611
22477,0.006955,74.125.68.0-255,1484,211508,64,343611
22478,0.007834,172.31.40.0-255,66,211574,64,343611
22479,0.010115,74.125.68.0-255,5738,217312,64,343611
22480,0.010123,172.31.40.0-255,66,217378,64,343611
22481,0.012401,74.125.68.0-255,5738,223116,64,343611
22482,0.012409,172.31.40.0-255,66,223182,64,343611
22483,0.014699,74.125.68.0-255,5738,228920,64,343611
22484,0.015135,172.31.40.0-255,66,228986,64,343611
22485,0.017417,74.125.68.0-255,5738,234724,64,343611
22486,0.017427,172.31.40.0-255,66,234790,64,343611
22487,0.019713,74.125.68.0-255,5738,240528,64,343611
22488,0.019727,172.31.40.0-255,66,240594,64,343611
22489,0.02208,74.125.68.0-255,5738,246332,64,343611
22490,0.022093,172.31.40.0-255,66,246398,64,343611
22491,0.024393,74.125.68.0-255,5738,252136,64,343611
22492,0.024401,172.31.40.0-255,66,252202,64,343611
22493,0.026687,74.125.68.0-255,5738,257940,64,343611
22494,0.026695,172.31.40.0-255,66,258006,64,343611
22495,0.028986,74.125.68.0-255,5738,263744,64,343611
22496,0.028994,172.31.40.0-255,66,263810,64,343611
22497,0.031272,74.125.68.0-255,5738,269548,64,343611
22498,0.031278,172.31.40.0-255,66,269614,64,343611
22499,0.033027,172.31.40.0-255,229,269843,64,343611
22500,0.033057,172.31.40.0-255,1111,270954,64,343611
22501,0.033115,172.31.40.0-255,1514,272468,64,343611
22502,0.033117,172.31.40.0-255,1297,273765,64,343611
22503,0.033559,74.125.68.0-255,5738,279503,64,343611
22504,0.033565,172.31.40.0-255,66,279569,64,343611
22505,0.034567,104.244.42.0-255,66,279635,64,343611
22506,0.034611,104.244.42.0-255,66,279701,64,343611
22507,0.034672,104.244.42.0-255,66,279767,64,343611
22508,0.035843,74.125.68.0-255,5738,285505,64,343611
22509,0.035849,172.31.40.0-255,66,285571,64,343611
22510,0.03814,74.125.68.0-255,5738,291309,64,343611
22511,0.038147,172.31.40.0-255,66,291375,64,343611
22512,0.040446,74.125.68.0-255,5738,297113,64,343611
22513,0.040452,172.31.40.0-255,66,297179,64,343611
22514,0.042734,74.125.68.0-255,5738,302917,64,343611
22515,0.042741,172.31.40.0-255,66,302983,64,343611
22516,0.045031,74.125.68.0-255,5738,308721,64,343611
22517,0.045038,172.31.40.0-255,66,308787,64,343611
22518,0.047337,74.125.68.0-255,5738,314525,64,343611
22519,0.047343,172.31.40.0-255,66,314591,64,343611
22520,0.049636,74.125.68.0-255,5738,320329,64,343611
22521,0.049644,172.31.40.0-255,66,320395,64,343611
22522,0.051925,74.125.68.0-255,5738,326133,64,343611
22523,0.051937,172.31.40.0-255,66,326199,64,343611
22524,0.054225,74.125.68.0-255,5738,331937,64,343611
22525,0.054232,172.31.40.0-255,66,332003,64,343611
22526,0.056523,74.125.68.0-255,5738,337741,64,343611
22527,0.05653,172.31.40.0-255,66,337807,64,343611
22528,0.058814,74.125.68.0-255,5738,343545,64,343611
22529,0.058821,172.31.40.0-255,66,343611,64,343611
22530,0.0,172.217.26.0-255,297,297,64,341116
22531,1.3e-05,172.31.40.0-255,66,363,64,341116
22532,2e-05,172.217.26.0-255,1484,1847,64,341116
22533,2.4e-05,172.31.40.0-255,66,1913,64,341116
22534,3.1e-05,172.217.26.0-255,4320,6233,64,341116
22535,3.3e-05,172.31.40.0-255,66,6299,64,341116
22536,3.9e-05,172.217.26.0-255,4320,10619,64,341116
22537,4.2e-05,172.31.40.0-255,66,10685,64,341116
22538,7.1e-05,172.217.26.0-255,4701,15386,64,341116
22539,7.4e-05,172.31.40.0-255,66,15452,64,341116
22540,8.8e-05,172.31.40.0-255,66,15518,64,341116
22541,9.3e-05,172.217.26.0-255,3961,19479,64,341116
22542,9.6e-05,172.31.40.0-255,66,19545,64,341116
22543,0.000198,172.217.26.0-255,1484,21029,64,341116
22544,0.000202,172.31.40.0-255,66,21095,64,341116
22545,0.000207,172.217.26.0-255,2902,23997,64,341116
22546,0.00021,172.31.40.0-255,66,24063,64,341116
22547,0.000221,172.217.26.0-255,4320,28383,64,341116
22548,0.000223,172.31.40.0-255,66,28449,64,341116
22549,0.000261,172.217.26.0-255,1484,29933,64,341116
22550,0.000264,172.31.40.0-255,66,29999,64,341116
22551,0.000272,172.217.26.0-255,6797,36796,64,341116
22552,0.000275,172.31.40.0-255,66,36862,64,341116
22553,0.000282,172.217.26.0-255,7156,44018,64,341116
22554,0.000284,172.31.40.0-255,66,44084,64,341116
22555,0.000333,172.31.40.0-255,66,44150,64,341116
22556,0.00089,172.217.26.0-255,386,44536,64,341116
22557,0.000896,172.31.40.0-255,66,44602,64,341116
22558,0.000986,172.217.26.0-255,1484,46086,64,341116
22559,0.00099,172.31.40.0-255,66,46152,64,341116
22560,0.001004,172.217.26.0-255,1484,47636,64,341116
22561,0.001012,172.217.26.0-255,2902,50538,64,341116
22562,0.001018,172.217.26.0-255,5738,56276,64,341116
22563,0.001023,172.31.40.0-255,66,56342,64,341116
22564,0.001032,172.31.40.0-255,66,56408,64,341116
22565,0.001047,172.217.26.0-255,1484,57892,64,341116
22566,0.00107,172.217.26.0-255,3961,61853,64,341116
22567,0.001073,172.31.40.0-255,66,61919,64,341116
22568,0.001076,172.217.26.0-255,1484,63403,64,341116
22569,0.001111,172.217.26.0-255,4320,67723,64,341116
22570,0.001114,172.31.40.0-255,66,67789,64,341116
22571,0.001121,172.217.26.0-255,7156,74945,64,341116
22572,0.001124,172.31.40.0-255,66,75011,64,341116
22573,0.00115,172.217.26.0-255,1484,76495,64,341116
22574,0.001165,172.217.26.0-255,2543,79038,64,341116
22575,0.001168,172.31.40.0-255,66,79104,64,341116
22576,0.001199,172.217.26.0-255,4320,83424,64,341116
22577,0.001202,172.31.40.0-255,66,83490,64,341116
22578,0.001205,172.217.26.0-255,1484,84974,64,341116
22579,0.001227,172.217.26.0-255,1484,86458,64,341116
22580,0.001229,172.31.40.0-255,66,86524,64,341116
22581,0.001232,172.217.26.0-255,1484,88008,64,341116
22582,0.001249,172.217.26.0-255,2902,90910,64,341116
22583,0.001252,172.31.40.0-255,66,90976,64,341116
22584,0.001263,172.31.40.0-255,66,91042,64,341116
22585,0.001294,172.217.26.0-255,2902,93944,64,341116
22586,0.001296,172.31.40.0-255,66,94010,64,341116
22587,0.001326,172.31.40.0-255,66,94076,64,341116
22588,0.001363,172.217.26.0-255,1484,95560,64,341116
22589,0.001368,172.217.26.0-255,2902,98462,64,341116
22590,0.00137,172.31.40.0-255,66,98528,64,341116
22591,0.001376,172.217.26.0-255,5738,104266,64,341116
22592,0.001379,172.31.40.0-255,66,104332,64,341116
22593,0.001382,172.217.26.0-255,1484,105816,64,341116
22594,0.001386,172.217.26.0-255,2902,108718,64,341116
22595,0.001389,172.31.40.0-255,66,108784,64,341116
22596,0.001422,172.217.26.0-255,5738,114522,64,341116
22597,0.001425,172.31.40.0-255,66,114588,64,341116
22598,0.00144,172.31.40.0-255,66,114654,64,341116
22599,0.00162,172.217.26.0-255,1484,116138,64,341116
22600,0.001626,172.217.26.0-255,2902,119040,64,341116
22601,0.001629,172.31.40.0-255,66,119106,64,341116
22602,0.001636,172.217.26.0-255,5738,124844,64,341116
22603,0.001638,172.31.40.0-255,66,124910,64,341116
22604,0.001641,172.217.26.0-255,1484,126394,64,341116
22605,0.001662,172.217.26.0-255,2902,129296,64,341116
22606,0.001664,172.31.40.0-255,66,129362,64,341116
22607,0.001666,172.217.26.0-255,1484,130846,64,341116
22608,0.00167,172.217.26.0-255,2902,133748,64,341116
22609,0.001672,172.31.40.0-255,66,133814,64,341116
22610,0.001677,172.217.26.0-255,2902,136716,64,341116
22611,0.001678,172.31.40.0-255,66,136782,64,341116
22612,0.001699,172.217.26.0-255,2902,139684,64,341116
22613,0.001703,172.31.40.0-255,66,139750,64,341116
22614,0.001719,172.217.26.0-255,1484,141234,64,341116
22615,0.001757,172.31.40.0-255,66,141300,64,341116
22616,0.001801,172.217.26.0-255,1484,142784,64,341116
22617,0.001806,172.217.26.0-255,2902,145686,64,341116
22618,0.001808,172.31.40.0-255,66,145752,64,341116
22619,0.001812,172.217.26.0-255,1484,147236,64,341116
22620,0.001836,172.217.26.0-255,2902,150138,64,341116
22621,0.001839,172.31.40.0-255,66,150204,64,341116
22622,0.001846,172.217.26.0-255,5738,155942,64,341116
22623,0.001848,172.31.40.0-255,66,156008,64,341116
22624,0.001869,172.217.26.0-255,2902,158910,64,341116
22625,0.001876,172.31.40.0-255,66,158976,64,341116
22626,0.001879,172.217.26.0-255,1484,160460,64,341116
22627,0.001926,172.31.40.0-255,66,160526,64,341116
22628,0.003811,172.217.26.0-255,5738,166264,64,341116
22629,0.003818,172.31.40.0-255,66,166330,64,341116
22630,0.005712,172.217.26.0-255,5738,172068,64,341116
22631,0.00572,172.31.40.0-255,66,172134,64,341116
22632,0.007614,172.217.26.0-255,5738,177872,64,341116
22633,0.007617,172.31.40.0-255,66,177938,64,341116
22634,0.009511,172.217.26.0-255,2902,180840,64,341116
22635,0.009518,172.31.40.0-255,66,180906,64,341116
22636,0.009537,172.217.26.0-255,2902,183808,64,341116
22637,0.00954,172.31.40.0-255,66,183874,64,341116
22638,0.01141,172.217.26.0-255,2902,186776,64,341116
22639,0.011418,172.31.40.0-255,66,186842,64,341116
22640,0.011444,172.217.26.0-255,2902,189744,64,341116
22641,0.011447,172.31.40.0-255,66,189810,64,341116
22642,0.013312,172.217.26.0-255,2902,192712,64,341116
22643,0.01332,172.31.40.0-255,66,192778,64,341116
22644,0.013347,172.217.26.0-255,2902,195680,64,341116
22645,0.01335,172.31.40.0-255,66,195746,64,341116
22646,0.015212,172.217.26.0-255,2902,198648,64,341116
22647,0.01522,172.31.40.0-255,66,198714,64,341116
22648,0.015235,172.217.26.0-255,2902,201616,64,341116
22649,0.015242,172.31.40.0-255,66,201682,64,341116
22650,0.017118,172.217.26.0-255,2902,204584,64,341116
22651,0.017128,172.31.40.0-255,66,204650,64,341116
22652,0.01716,172.217.26.0-255,2902,207552,64,341116
22653,0.017163,172.31.40.0-255,66,207618,64,341116
22654,0.019027,172.217.26.0-255,2902,210520,64,341116
22655,0.019034,172.31.40.0-255,66,210586,64,341116
22656,0.019069,172.217.26.0-255,2902,213488,64,341116
22657,0.019072,172.31.40.0-255,66,213554,64,341116
22658,0.020931,172.217.26.0-255,2902,216456,64,341116
22659,0.020938,172.31.40.0-255,66,216522,64,341116
22660,0.020969,172.217.26.0-255,2902,219424,64,341116
22661,0.020972,172.31.40.0-255,66,219490,64,341116
22662,0.022832,172.217.26.0-255,2902,222392,64,341116
22663,0.02284,172.31.40.0-255,66,222458,64,341116
22664,0.022874,172.217.26.0-255,2902,225360,64,341116
22665,0.022877,172.31.40.0-255,66,225426,64,341116
22666,0.024723,172.217.26.0-255,2902,228328,64,341116
22667,0.02473,172.31.40.0-255,66,228394,64,341116
22668,0.024761,172.217.26.0-255,2902,231296,64,341116
22669,0.024763,172.31.40.0-255,66,231362,64,341116
22670,0.026663,172.217.26.0-255,2902,234264,64,341116
22671,0.026671,172.31.40.0-255,66,234330,64,341116
22672,0.026702,172.217.26.0-255,2902,237232,64,341116
22673,0.026705,172.31.40.0-255,66,237298,64,341116
22674,0.028563,172.217.26.0-255,2902,240200,64,341116
22675,0.02857,172.31.40.0-255,66,240266,64,341116
22676,0.028601,172.217.26.0-255,2902,243168,64,341116
22677,0.028604,172.31.40.0-255,66,243234,64,341116
22678,0.030461,172.217.26.0-255,2902,246136,64,341116
22679,0.030468,172.31.40.0-255,66,246202,64,341116
22680,0.030506,172.217.26.0-255,2902,249104,64,341116
22681,0.030508,172.31.40.0-255,66,249170,64,341116
22682,0.032364,172.217.26.0-255,2902,252072,64,341116
22683,0.032371,172.31.40.0-255,66,252138,64,341116
22684,0.032397,172.217.26.0-255,2902,255040,64,341116
22685,0.0324,172.31.40.0-255,66,255106,64,341116
22686,0.033442,172.31.40.0-255,172,255278,64,341116
22687,0.033473,172.31.40.0-255,1112,256390,64,341116
22688,0.033528,172.31.40.0-255,1514,257904,64,341116
22689,0.03353,172.31.40.0-255,1296,259200,64,341116
22690,0.034257,172.217.26.0-255,2902,262102,64,341116
22691,0.034263,172.31.40.0-255,66,262168,64,341116
22692,0.034297,172.217.26.0-255,2902,265070,64,341116
22693,0.0343,172.31.40.0-255,66,265136,64,341116
22694,0.034987,104.244.42.0-255,66,265202,64,341116
22695,0.035035,104.244.42.0-255,66,265268,64,341116
22696,0.035135,104.244.42.0-255,66,265334,64,341116
22697,0.036157,172.217.26.0-255,2902,268236,64,341116
22698,0.036162,172.31.40.0-255,66,268302,64,341116
22699,0.036193,172.217.26.0-255,2902,271204,64,341116
22700,0.036195,172.31.40.0-255,66,271270,64,341116
22701,0.038061,172.217.26.0-255,2902,274172,64,341116
22702,0.038067,172.31.40.0-255,66,274238,64,341116
22703,0.038098,172.217.26.0-255,2902,277140,64,341116
22704,0.038102,172.31.40.0-255,66,277206,64,341116
22705,0.039959,172.217.26.0-255,1484,278690,64,341116
22706,0.039984,172.217.26.0-255,4320,283010,64,341116
22707,0.03999,172.31.40.0-255,66,283076,64,341116
22708,0.041878,172.217.26.0-255,5738,288814,64,341116
22709,0.041884,172.31.40.0-255,66,288880,64,341116
22710,0.043811,172.217.26.0-255,5738,294618,64,341116
22711,0.043817,172.31.40.0-255,66,294684,64,341116
22712,0.045726,172.217.26.0-255,5738,300422,64,341116
22713,0.045733,172.31.40.0-255,66,300488,64,341116
22714,0.047629,172.217.26.0-255,5738,306226,64,341116
22715,0.047635,172.31.40.0-255,66,306292,64,341116
22716,0.049534,172.217.26.0-255,5738,312030,64,341116
22717,0.049541,172.31.40.0-255,66,312096,64,341116
22718,0.051447,172.217.26.0-255,5738,317834,64,341116
22719,0.051453,172.31.40.0-255,66,317900,64,341116
22720,0.053349,172.217.26.0-255,5738,323638,64,341116
22721,0.053355,172.31.40.0-255,66,323704,64,341116
22722,0.055242,172.217.26.0-255,5738,329442,64,341116
22723,0.055248,172.31.40.0-255,66,329508,64,341116
22724,0.057134,172.217.26.0-255,5738,335246,64,341116
22725,0.057141,172.31.40.0-255,66,335312,64,341116
22726,0.059028,172.217.26.0-255,5738,341050,64,341116
22727,0.059034,172.31.40.0-255,66,341116,64,341116
22728,0.0,172.217.194.0-255,150,150,64,234149
22729,1.6e-05,172.31.40.0-255,66,216,64,234149
22730,2.3e-05,172.217.194.0-255,1484,1700,64,234149
22731,2.8e-05,172.31.40.0-255,66,1766,64,234149
22732,3.3e-05,172.217.194.0-255,2902,4668,64,234149
22733,3.6e-05,172.31.40.0-255,66,4734,64,234149
22734,4.3e-05,172.217.194.0-255,7156,11890,64,234149
22735,4.7e-05,172.31.40.0-255,66,11956,64,234149
22736,7.5e-05,172.217.194.0-255,4320,16276,64,234149
22737,7.7e-05,172.31.40.0-255,66,16342,64,234149
22738,0.000108,172.31.40.0-255,66,16408,64,234149
22739,0.000111,172.217.194.0-255,1484,17892,64,234149
22740,0.000113,172.31.40.0-255,66,17958,64,234149
22741,0.000117,172.217.194.0-255,1125,19083,64,234149
22742,0.000119,172.31.40.0-255,66,19149,64,234149
22743,0.000145,172.217.194.0-255,1484,20633,64,234149
22744,0.000147,172.31.40.0-255,66,20699,64,234149
22745,0.000153,172.217.194.0-255,4320,25019,64,234149
22746,0.000155,172.31.40.0-255,66,25085,64,234149
22747,0.000158,172.217.194.0-255,1484,26569,64,234149
22748,0.00016,172.31.40.0-255,66,26635,64,234149
22749,0.000199,172.31.40.0-255,66,26701,64,234149
22750,0.000207,172.217.194.0-255,5379,32080,64,234149
22751,0.000209,172.31.40.0-255,66,32146,64,234149
22752,0.000227,172.217.194.0-255,2902,35048,64,234149
22753,0.000229,172.31.40.0-255,66,35114,64,234149
22754,0.000257,172.31.40.0-255,66,35180,64,234149
22755,0.00026,172.217.194.0-255,117,35297,64,234149
22756,0.000263,172.31.40.0-255,66,35363,64,234149
22757,0.000411,172.217.194.0-255,377,35740,64,234149
22758,0.000722,172.217.194.0-255,1484,37224,64,234149
22759,0.000727,172.31.40.0-255,66,37290,64,234149
22760,0.000733,172.217.194.0-255,2902,40192,64,234149
22761,0.000735,172.31.40.0-255,66,40258,64,234149
22762,0.000773,172.217.194.0-255,4320,44578,64,234149
22763,0.000775,172.31.40.0-255,66,44644,64,234149
22764,0.000801,172.217.194.0-255,1484,46128,64,234149
22765,0.000815,172.31.40.0-255,66,46194,64,234149
22766,0.000829,172.31.40.0-255,66,46260,64,234149
22767,0.001322,172.217.194.0-255,1484,47744,64,234149
22768,0.001328,172.217.194.0-255,2902,50646,64,234149
22769,0.001332,172.31.40.0-255,66,50712,64,234149
22770,0.001336,172.217.194.0-255,1484,52196,64,234149
22771,0.00136,172.217.194.0-255,4320,56516,64,234149
22772,0.001362,172.31.40.0-255,66,56582,64,234149
22773,0.00137,172.217.194.0-255,7156,63738,64,234149
22774,0.001372,172.31.40.0-255,66,63804,64,234149
22775,0.001399,172.31.40.0-255,66,63870,64,234149
22776,0.001426,172.217.194.0-255,4320,68190,64,234149
22777,0.001428,172.31.40.0-255,66,68256,64,234149
22778,0.001432,172.217.194.0-255,2184,70440,64,234149
22779,0.001434,172.31.40.0-255,66,70506,64,234149
22780,0.002226,172.217.194.0-255,1484,71990,64,234149
22781,0.002236,172.217.194.0-255,2902,74892,64,234149
22782,0.002241,172.31.40.0-255,66,74958,64,234149
22783,0.00225,172.217.194.0-255,5738,80696,64,234149
22784,0.002252,172.31.40.0-255,66,80762,64,234149
22785,0.002292,172.31.40.0-255,66,80828,64,234149
22786,0.002332,172.31.40.0-255,66,80894,64,234149
22787,0.00235,172.217.194.0-255,2184,83078,64,234149
22788,0.002353,172.31.40.0-255,66,83144,64,234149
22789,0.004594,172.217.194.0-255,2902,86046,64,234149
22790,0.004598,172.31.40.0-255,66,86112,64,234149
22791,0.004642,172.217.194.0-255,2902,89014,64,234149
22792,0.004644,172.31.40.0-255,66,89080,64,234149
22793,0.00687,172.217.194.0-255,2902,91982,64,234149
22794,0.006876,172.31.40.0-255,66,92048,64,234149
22795,0.006905,172.217.194.0-255,2902,94950,64,234149
22796,0.006908,172.31.40.0-255,66,95016,64,234149
22797,0.00916,172.217.194.0-255,2902,97918,64,234149
22798,0.009167,172.31.40.0-255,66,97984,64,234149
22799,0.009187,172.217.194.0-255,2902,100886,64,234149
22800,0.009189,172.31.40.0-255,66,100952,64,234149
22801,0.011481,172.217.194.0-255,5738,106690,64,234149
22802,0.01149,172.31.40.0-255,66,106756,64,234149
22803,0.013796,172.217.194.0-255,5738,112494,64,234149
22804,0.013807,172.31.40.0-255,66,112560,64,234149
22805,0.016096,172.217.194.0-255,5738,118298,64,234149
22806,0.016104,172.31.40.0-255,66,118364,64,234149
22807,0.018379,172.217.194.0-255,5738,124102,64,234149
22808,0.018386,172.31.40.0-255,66,124168,64,234149
22809,0.02066,172.217.194.0-255,5738,129906,64,234149
22810,0.020668,172.31.40.0-255,66,129972,64,234149
22811,0.02297,172.217.194.0-255,5738,135710,64,234149
22812,0.022977,172.31.40.0-255,66,135776,64,234149
22813,0.025262,172.217.194.0-255,5738,141514,64,234149
22814,0.025269,172.31.40.0-255,66,141580,64,234149
22815,0.027556,172.217.194.0-255,5738,147318,64,234149
22816,0.027563,172.31.40.0-255,66,147384,64,234149
22817,0.029238,172.31.40.0-255,172,147556,64,234149
22818,0.029268,172.31.40.0-255,1111,148667,64,234149
22819,0.029324,172.31.40.0-255,1514,150181,64,234149
22820,0.029326,172.31.40.0-255,1514,151695,64,234149
22821,0.029327,172.31.40.0-255,694,152389,64,234149
22822,0.029836,172.217.194.0-255,5738,158127,64,234149
22823,0.029843,172.31.40.0-255,66,158193,64,234149
22824,0.030763,104.244.42.0-255,66,158259,64,234149
22825,0.030851,104.244.42.0-255,66,158325,64,234149
22826,0.030946,104.244.42.0-255,66,158391,64,234149
22827,0.030953,104.244.42.0-255,66,158457,64,234149
22828,0.031563,104.244.42.0-255,108,158565,64,234149
22829,0.031574,172.31.40.0-255,66,158631,64,234149
22830,0.032131,172.217.194.0-255,5738,164369,64,234149
22831,0.032136,172.31.40.0-255,66,164435,64,234149
22832,0.034452,172.217.194.0-255,5738,170173,64,234149
22833,0.034459,172.31.40.0-255,66,170239,64,234149
22834,0.036766,172.217.194.0-255,5738,175977,64,234149
22835,0.036772,172.31.40.0-255,66,176043,64,234149
22836,0.039086,172.217.194.0-255,5738,181781,64,234149
22837,0.039095,172.31.40.0-255,66,181847,64,234149
22838,0.041383,172.217.194.0-255,5738,187585,64,234149
22839,0.04139,172.31.40.0-255,66,187651,64,234149
22840,0.043683,172.217.194.0-255,5738,193389,64,234149
22841,0.04369,172.31.40.0-255,66,193455,64,234149
22842,0.045994,172.217.194.0-255,5738,199193,64,234149
22843,0.046001,172.31.40.0-255,66,199259,64,234149
22844,0.048296,172.217.194.0-255,5738,204997,64,234149
22845,0.048303,172.31.40.0-255,66,205063,64,234149
22846,0.050603,172.217.194.0-255,5738,210801,64,234149
22847,0.050609,172.31.40.0-255,66,210867,64,234149
22848,0.052893,172.217.194.0-255,1484,212351,64,234149
22849,0.052915,172.217.194.0-255,4320,216671,64,234149
22850,0.05292,172.31.40.0-255,66,216737,64,234149
22851,0.055189,172.217.194.0-255,5738,222475,64,234149
22852,0.055197,172.31.40.0-255,66,222541,64,234149
22853,0.057488,172.217.194.0-255,5738,228279,64,234149
22854,0.057495,172.31.40.0-255,66,228345,64,234149
22855,0.059796,172.217.194.0-255,5738,234083,64,234149
22856,0.059803,172.31.40.0-255,66,234149,64,234149
22857,0.0,172.217.194.0-255,153,153,64,256574
22858,3.6e-05,172.31.40.0-255,66,219,64,256574
22859,4.4e-05,172.217.194.0-255,1484,1703,64,256574
22860,4.9e-05,172.31.40.0-255,66,1769,64,256574
22861,5.4e-05,172.217.194.0-255,2902,4671,64,256574
22862,6.4e-05,172.31.40.0-255,66,4737,64,256574
22863,7.3e-05,172.217.194.0-255,7156,11893,64,256574
22864,7.6e-05,172.31.40.0-255,66,11959,64,256574
22865,8.7e-05,172.31.40.0-255,66,12025,64,256574
22866,0.000145,172.31.40.0-255,66,12091,64,256574
22867,0.000148,172.217.194.0-255,1484,13575,64,256574
22868,0.000151,172.31.40.0-255,66,13641,64,256574
22869,0.000176,172.217.194.0-255,4320,17961,64,256574
22870,0.000183,172.31.40.0-255,66,18027,64,256574
22871,0.000191,172.217.194.0-255,7156,25183,64,256574
22872,0.000194,172.31.40.0-255,66,25249,64,256574
22873,0.000199,172.217.194.0-255,4320,29569,64,256574
22874,0.000201,172.31.40.0-255,66,29635,64,256574
22875,0.000249,172.31.40.0-255,66,29701,64,256574
22876,0.000255,172.217.194.0-255,5700,35401,64,256574
22877,0.000257,172.31.40.0-255,66,35467,64,256574
22878,0.000648,172.217.194.0-255,365,35832,64,256574
22879,0.000655,172.31.40.0-255,66,35898,64,256574
22880,0.000853,172.217.194.0-255,1484,37382,64,256574
22881,0.000859,172.31.40.0-255,66,37448,64,256574
22882,0.000872,172.217.194.0-255,2902,40350,64,256574
22883,0.000879,172.31.40.0-255,66,40416,64,256574
22884,0.000886,172.217.194.0-255,5738,46154,64,256574
22885,0.000889,172.31.40.0-255,66,46220,64,256574
22886,0.000895,172.217.194.0-255,4320,50540,64,256574
22887,0.000902,172.31.40.0-255,66,50606,64,256574
22888,0.000964,172.31.40.0-255,66,50672,64,256574
22889,0.001316,172.217.194.0-255,1484,52156,64,256574
22890,0.001322,172.217.194.0-255,2902,55058,64,256574
22891,0.001326,172.31.40.0-255,66,55124,64,256574
22892,0.001333,172.217.194.0-255,5738,60862,64,256574
22893,0.001351,172.31.40.0-255,66,60928,64,256574
22894,0.001364,172.217.194.0-255,4320,65248,64,256574
22895,0.001409,172.31.40.0-255,66,65314,64,256574
22896,0.001414,172.31.40.0-255,66,65380,64,256574
22897,0.001435,172.217.194.0-255,2184,67564,64,256574
22898,0.001442,172.217.194.0-255,2902,70466,64,256574
22899,0.001446,172.217.194.0-255,2902,73368,64,256574
22900,0.001465,172.217.194.0-255,4320,77688,64,256574
22901,0.001468,172.217.194.0-255,1484,79172,64,256574
22902,0.001476,172.31.40.0-255,66,79238,64,256574
22903,0.0015,172.217.194.0-255,1484,80722,64,256574
22904,0.001512,172.31.40.0-255,66,80788,64,256574
22905,0.001526,172.217.194.0-255,5020,85808,64,256574
22906,0.001549,172.31.40.0-255,66,85874,64,256574
22907,0.001689,172.217.194.0-255,1484,87358,64,256574
22908,0.00171,172.217.194.0-255,2902,90260,64,256574
22909,0.001728,172.31.40.0-255,66,90326,64,256574
22910,0.001739,172.217.194.0-255,4320,94646,64,256574
22911,0.001756,172.31.40.0-255,66,94712,64,256574
22912,0.001784,172.217.194.0-255,4320,99032,64,256574
22913,0.001845,172.31.40.0-255,66,99098,64,256574
22914,0.00189,172.217.194.0-255,1484,100582,64,256574
22915,0.001896,172.217.194.0-255,2902,103484,64,256574
22916,0.001899,172.217.194.0-255,1484,104968,64,256574
22917,0.001911,172.31.40.0-255,66,105034,64,256574
22918,0.001922,172.217.194.0-255,4320,109354,64,256574
22919,0.001924,172.217.194.0-255,1484,110838,64,256574
22920,0.001951,172.31.40.0-255,66,110904,64,256574
22921,0.001982,172.31.40.0-255,66,110970,64,256574
22922,0.001996,172.31.40.0-255,66,111036,64,256574
22923,0.002026,172.217.194.0-255,3602,114638,64,256574
22924,0.002031,172.217.194.0-255,2902,117540,64,256574
22925,0.002036,172.217.194.0-255,4320,121860,64,256574
22926,0.002075,172.31.40.0-255,66,121926,64,256574
22927,0.002128,172.217.194.0-255,6438,128364,64,256574
22928,0.002134,172.31.40.0-255,66,128430,64,256574
22929,0.002143,172.217.194.0-255,1484,129914,64,256574
22930,0.002153,172.217.194.0-255,2902,132816,64,256574
22931,0.002159,172.217.194.0-255,5738,138554,64,256574
22932,0.002185,172.31.40.0-255,66,138620,64,256574
22933,0.002205,172.31.40.0-255,66,138686,64,256574
22934,0.002212,172.217.194.0-255,2902,141588,64,256574
22935,0.002239,172.217.194.0-255,2902,144490,64,256574
22936,0.002247,172.31.40.0-255,66,144556,64,256574
22937,0.002269,172.31.40.0-255,66,144622,64,256574
22938,0.004552,172.217.194.0-255,5738,150360,64,256574
22939,0.004559,172.31.40.0-255,66,150426,64,256574
22940,0.006869,172.217.194.0-255,5738,156164,64,256574
22941,0.013074,172.31.40.0-255,66,156230,64,256574
22942,0.014239,172.217.194.0-255,1484,157714,64,256574
22943,0.015375,172.217.194.0-255,4320,162034,64,256574
22944,0.015385,172.31.40.0-255,66,162100,64,256574
22945,0.0177,172.217.194.0-255,5738,167838,64,256574
22946,0.024074,172.31.40.0-255,66,167904,64,256574
22947,0.026386,172.217.194.0-255,5738,173642,64,256574
22948,0.026403,172.31.40.0-255,66,173708,64,256574
22949,0.028667,172.217.194.0-255,5738,179446,64,256574
22950,0.028675,172.31.40.0-255,66,179512,64,256574
22951,0.030952,172.217.194.0-255,5738,185250,64,256574
22952,0.030961,172.31.40.0-255,66,185316,64,256574
22953,0.033219,172.217.194.0-255,5738,191054,64,256574
22954,0.033231,172.31.40.0-255,66,191120,64,256574
22955,0.035546,172.217.194.0-255,5738,196858,64,256574
22956,0.035559,172.31.40.0-255,66,196924,64,256574
22957,0.037832,172.217.194.0-255,5738,202662,64,256574
22958,0.037842,172.31.40.0-255,66,202728,64,256574
22959,0.040107,172.217.194.0-255,5738,208466,64,256574
22960,0.040122,172.31.40.0-255,66,208532,64,256574
22961,0.042375,172.217.194.0-255,5738,214270,64,256574
22962,0.042383,172.31.40.0-255,66,214336,64,256574
22963,0.044544,172.31.40.0-255,172,214508,64,256574
22964,0.044577,172.31.40.0-255,1113,215621,64,256574
22965,0.044634,172.31.40.0-255,1514,217135,64,256574
22966,0.044636,172.31.40.0-255,1178,218313,64,256574
22967,0.044651,172.217.194.0-255,5738,224051,64,256574
22968,0.04466,172.31.40.0-255,66,224117,64,256574
22969,0.046096,104.244.42.0-255,66,224183,64,256574
22970,0.046224,104.244.42.0-255,66,224249,64,256574
22971,0.046274,104.244.42.0-255,66,224315,64,256574
22972,0.046962,172.217.194.0-255,5738,230053,64,256574
22973,0.046972,172.31.40.0-255,66,230119,64,256574
22974,0.047536,104.244.42.0-255,108,230227,64,256574
22975,0.047541,172.31.40.0-255,66,230293,64,256574
22976,0.049298,172.217.194.0-255,5738,236031,64,256574
22977,0.049311,172.31.40.0-255,66,236097,64,256574
22978,0.051604,172.217.194.0-255,5738,241835,64,256574
22979,0.051622,172.31.40.0-255,66,241901,64,256574
22980,0.053903,172.217.194.0-255,5738,247639,64,256574
22981,0.053922,172.31.40.0-255,66,247705,64,256574
22982,0.05623,172.217.194.0-255,5738,253443,64,256574
22983,0.056246,172.31.40.0-255,66,253509,64,256574
22984,0.058509,172.217.194.0-255,2894,256403,64,256574
22985,0.058526,172.31.40.0-255,66,256469,64,256574
22986,0.05881,172.31.40.0-255,105,256574,64,256574
22987,0.0,172.253.118.0-255,153,153,64,332995
22988,2.3e-05,172.31.40.0-255,66,219,64,332995
22989,3e-05,172.253.118.0-255,1484,1703,64,332995
22990,3.5e-05,172.31.40.0-255,66,1769,64,332995
22991,3.8e-05,172.253.118.0-255,1484,3253,64,332995
22992,4.2e-05,172.31.40.0-255,66,3319,64,332995
22993,6.2e-05,172.253.118.0-255,1484,4803,64,332995
22994,6.5e-05,172.31.40.0-255,66,4869,64,332995
22995,7.7e-05,172.253.118.0-255,1484,6353,64,332995
22996,8e-05,172.31.40.0-255,66,6419,64,332995
22997,0.000109,172.253.118.0-255,5738,12157,64,332995
22998,0.000111,172.31.40.0-255,66,12223,64,332995
22999,0.000131,172.253.118.0-255,2093,14316,64,332995
23000,0.000133,172.31.40.0-255,66,14382,64,332995
23001,0.000336,172.253.118.0-255,1484,15866,64,332995
23002,0.000341,172.31.40.0-255,66,15932,64,332995
23003,0.000363,172.253.118.0-255,1484,17416,64,332995
23004,0.000365,172.31.40.0-255,66,17482,64,332995
23005,0.000371,172.253.118.0-255,2902,20384,64,332995
23006,0.000373,172.31.40.0-255,66,20450,64,332995
23007,0.000399,172.253.118.0-255,1484,21934,64,332995
23008,0.000401,172.31.40.0-255,66,22000,64,332995
23009,0.000434,172.253.118.0-255,4320,26320,64,332995
23010,0.000438,172.31.40.0-255,66,26386,64,332995
23011,0.000444,172.253.118.0-255,5379,31765,64,332995
23012,0.000447,172.31.40.0-255,66,31831,64,332995
23013,0.000454,172.253.118.0-255,5738,37569,64,332995
23014,0.000457,172.31.40.0-255,66,37635,64,332995
23015,0.000468,172.31.40.0-255,66,37701,64,332995
23016,0.000472,172.253.118.0-255,2902,40603,64,332995
23017,0.000474,172.31.40.0-255,66,40669,64,332995
23018,0.000505,172.253.118.0-255,7156,47825,64,332995
23019,0.000508,172.31.40.0-255,66,47891,64,332995
23020,0.000514,172.253.118.0-255,4320,52211,64,332995
23021,0.000516,172.31.40.0-255,66,52277,64,332995
23022,0.000522,172.253.118.0-255,5020,57297,64,332995
23023,0.000525,172.31.40.0-255,66,57363,64,332995
23024,0.000528,172.253.118.0-255,394,57757,64,332995
23025,0.000569,172.253.118.0-255,112,57869,64,332995
23026,0.000676,172.253.118.0-255,1484,59353,64,332995
23027,0.00068,172.31.40.0-255,66,59419,64,332995
23028,0.000685,172.253.118.0-255,2902,62321,64,332995
23029,0.000688,172.31.40.0-255,66,62387,64,332995
23030,0.000701,172.253.118.0-255,2902,65289,64,332995
23031,0.000704,172.31.40.0-255,66,65355,64,332995
23032,0.000723,172.253.118.0-255,2902,68257,64,332995
23033,0.000725,172.31.40.0-255,66,68323,64,332995
23034,0.000762,172.31.40.0-255,66,68389,64,332995
23035,0.000768,172.253.118.0-255,4320,72709,64,332995
23036,0.00077,172.31.40.0-255,66,72775,64,332995
23037,0.000801,172.253.118.0-255,2902,75677,64,332995
23038,0.000804,172.31.40.0-255,66,75743,64,332995
23039,0.000823,172.253.118.0-255,3602,79345,64,332995
23040,0.000826,172.31.40.0-255,66,79411,64,332995
23041,0.001184,172.253.118.0-255,1484,80895,64,332995
23042,0.001216,172.253.118.0-255,2902,83797,64,332995
23043,0.00122,172.31.40.0-255,66,83863,64,332995
23044,0.001244,172.253.118.0-255,5738,89601,64,332995
23045,0.001246,172.31.40.0-255,66,89667,64,332995
23046,0.001263,172.253.118.0-255,1484,91151,64,332995
23047,0.001291,172.253.118.0-255,5738,96889,64,332995
23048,0.001295,172.31.40.0-255,66,96955,64,332995
23049,0.001305,172.31.40.0-255,66,97021,64,332995
23050,0.00131,172.253.118.0-255,4320,101341,64,332995
23051,0.001312,172.31.40.0-255,66,101407,64,332995
23052,0.001334,172.253.118.0-255,3602,105009,64,332995
23053,0.001337,172.31.40.0-255,66,105075,64,332995
23054,0.001389,172.253.118.0-255,1484,106559,64,332995
23055,0.001393,172.253.118.0-255,1484,108043,64,332995
23056,0.001396,172.31.40.0-255,66,108109,64,332995
23057,0.001412,172.253.118.0-255,1484,109593,64,332995
23058,0.001418,172.253.118.0-255,4320,113913,64,332995
23059,0.00142,172.31.40.0-255,66,113979,64,332995
23060,0.001437,172.253.118.0-255,1484,115463,64,332995
23061,0.00146,172.253.118.0-255,5738,121201,64,332995
23062,0.001463,172.31.40.0-255,66,121267,64,332995
23063,0.001489,172.253.118.0-255,7156,128423,64,332995
23064,0.001492,172.31.40.0-255,66,128489,64,332995
23065,0.001497,172.253.118.0-255,2902,131391,64,332995
23066,0.001499,172.31.40.0-255,66,131457,64,332995
23067,0.001545,172.31.40.0-255,66,131523,64,332995
23068,0.001571,172.253.118.0-255,1484,133007,64,332995
23069,0.001583,172.253.118.0-255,2902,135909,64,332995
23070,0.001587,172.31.40.0-255,66,135975,64,332995
23071,0.001609,172.253.118.0-255,5738,141713,64,332995
23072,0.001614,172.253.118.0-255,4320,146033,64,332995
23073,0.001619,172.31.40.0-255,66,146099,64,332995
23074,0.001626,172.31.40.0-255,66,146165,64,332995
23075,0.001664,172.31.40.0-255,66,146231,64,332995
23076,0.001689,172.31.40.0-255,66,146297,64,332995
23077,0.001786,172.253.118.0-255,1484,147781,64,332995
23078,0.001807,172.253.118.0-255,2902,150683,64,332995
23079,0.001811,172.31.40.0-255,66,150749,64,332995
23080,0.001814,172.253.118.0-255,1484,152233,64,332995
23081,0.001831,172.253.118.0-255,1484,153717,64,332995
23082,0.001834,172.31.40.0-255,66,153783,64,332995
23083,0.001839,172.253.118.0-255,4320,158103,64,332995
23084,0.001842,172.31.40.0-255,66,158169,64,332995
23085,0.00188,172.31.40.0-255,66,158235,64,332995
23086,0.001886,172.253.118.0-255,4320,162555,64,332995
23087,0.001888,172.31.40.0-255,66,162621,64,332995
23088,0.001922,172.253.118.0-255,2902,165523,64,332995
23089,0.001925,172.31.40.0-255,66,165589,64,332995
23090,0.001951,172.253.118.0-255,6438,172027,64,332995
23091,0.001954,172.31.40.0-255,66,172093,64,332995
23092,0.002168,172.253.118.0-255,1484,173577,64,332995
23093,0.002184,172.253.118.0-255,1484,175061,64,332995
23094,0.002188,172.31.40.0-255,66,175127,64,332995
23095,0.002212,172.253.118.0-255,1484,176611,64,332995
23096,0.002218,172.253.118.0-255,5738,182349,64,332995
23097,0.002221,172.31.40.0-255,66,182415,64,332995
23098,0.002238,172.253.118.0-255,1484,183899,64,332995
23099,0.002279,172.31.40.0-255,66,183965,64,332995
23100,0.004473,172.253.118.0-255,4320,188285,64,332995
23101,0.004484,172.31.40.0-255,66,188351,64,332995
23102,0.004505,172.253.118.0-255,1484,189835,64,332995
23103,0.006744,172.253.118.0-255,1484,191319,64,332995
23104,0.006747,172.31.40.0-255,66,191385,64,332995
23105,0.006768,172.253.118.0-255,2902,194287,64,332995
23106,0.006771,172.31.40.0-255,66,194353,64,332995
23107,0.008957,172.253.118.0-255,5738,200091,64,332995
23108,0.00897,172.31.40.0-255,66,200157,64,332995
23109,0.011226,172.253.118.0-255,5738,205895,64,332995
23110,0.011241,172.31.40.0-255,66,205961,64,332995
23111,0.013484,172.253.118.0-255,5738,211699,64,332995
23112,0.013496,172.31.40.0-255,66,211765,64,332995
23113,0.015733,172.253.118.0-255,5738,217503,64,332995
23114,0.015752,172.31.40.0-255,66,217569,64,332995
23115,0.017983,172.253.118.0-255,5738,223307,64,332995
23116,0.017999,172.31.40.0-255,66,223373,64,332995
23117,0.020223,172.253.118.0-255,5738,229111,64,332995
23118,0.020233,172.31.40.0-255,66,229177,64,332995
23119,0.022482,172.253.118.0-255,5738,234915,64,332995
23120,0.022492,172.31.40.0-255,66,234981,64,332995
23121,0.024729,172.253.118.0-255,2902,237883,64,332995
23122,0.024738,172.31.40.0-255,66,237949,64,332995
23123,0.02476,172.253.118.0-255,2902,240851,64,332995
23124,0.024762,172.31.40.0-255,66,240917,64,332995
23125,0.027049,172.253.118.0-255,2902,243819,64,332995
23126,0.027056,172.31.40.0-255,66,243885,64,332995
23127,0.027077,172.253.118.0-255,2902,246787,64,332995
23128,0.027079,172.31.40.0-255,66,246853,64,332995
23129,0.029261,172.253.118.0-255,2902,249755,64,332995
23130,0.029269,172.31.40.0-255,66,249821,64,332995
23131,0.0293,172.253.118.0-255,2902,252723,64,332995
23132,0.029304,172.31.40.0-255,66,252789,64,332995
23133,0.031572,172.253.118.0-255,2902,255691,64,332995
23134,0.031582,172.31.40.0-255,66,255757,64,332995
23135,0.031607,172.253.118.0-255,2902,258659,64,332995
23136,0.03161,172.31.40.0-255,66,258725,64,332995
23137,0.033779,172.253.118.0-255,2902,261627,64,332995
23138,0.033786,172.31.40.0-255,66,261693,64,332995
23139,0.033806,172.253.118.0-255,2902,264595,64,332995
23140,0.033809,172.31.40.0-255,66,264661,64,332995
23141,0.036005,172.253.118.0-255,2902,267563,64,332995
23142,0.036016,172.31.40.0-255,66,267629,64,332995
23143,0.036037,172.253.118.0-255,2902,270531,64,332995
23144,0.03604,172.31.40.0-255,66,270597,64,332995
23145,0.038238,172.253.118.0-255,5738,276335,64,332995
23146,0.038248,172.31.40.0-255,66,276401,64,332995
23147,0.040453,172.253.118.0-255,5738,282139,64,332995
23148,0.040461,172.31.40.0-255,66,282205,64,332995
23149,0.042687,172.253.118.0-255,5738,287943,64,332995
23150,0.042701,172.31.40.0-255,66,288009,64,332995
23151,0.044906,172.253.118.0-255,5738,293747,64,332995
23152,0.04492,172.31.40.0-255,66,293813,64,332995
23153,0.04714,172.253.118.0-255,5738,299551,64,332995
23154,0.047158,172.31.40.0-255,66,299617,64,332995
23155,0.049378,172.253.118.0-255,5738,305355,64,332995
23156,0.049386,172.31.40.0-255,66,305421,64,332995
23157,0.051602,172.253.118.0-255,5738,311159,64,332995
23158,0.051612,172.31.40.0-255,66,311225,64,332995
23159,0.053816,172.253.118.0-255,5738,316963,64,332995
23160,0.053822,172.31.40.0-255,66,317029,64,332995
23161,0.055593,172.31.40.0-255,172,317201,64,332995
23162,0.055636,172.31.40.0-255,1112,318313,64,332995
23163,0.055706,172.31.40.0-255,1514,319827,64,332995
23164,0.055708,172.31.40.0-255,1296,321123,64,332995
23165,0.056025,172.253.118.0-255,5738,326861,64,332995
23166,0.056034,172.31.40.0-255,66,326927,64,332995
23167,0.057141,104.244.42.0-255,66,326993,64,332995
23168,0.057192,104.244.42.0-255,66,327059,64,332995
23169,0.057293,104.244.42.0-255,66,327125,64,332995
23170,0.058243,172.253.118.0-255,4320,331445,64,332995
23171,0.058248,172.31.40.0-255,66,331511,64,332995
23172,0.058272,172.253.118.0-255,1484,332995,64,332995
23173,0.0,74.125.24.0-255,150,150,64,239442
23174,2.1e-05,172.31.40.0-255,66,216,64,239442
23175,2.8e-05,74.125.24.0-255,1484,1700,64,239442
23176,3.4e-05,172.31.40.0-255,66,1766,64,239442
23177,3.9e-05,74.125.24.0-255,2902,4668,64,239442
23178,4.3e-05,172.31.40.0-255,66,4734,64,239442
23179,5.1e-05,74.125.24.0-255,7156,11890,64,239442
23180,5.4e-05,172.31.40.0-255,66,11956,64,239442
23181,6.9e-05,172.31.40.0-255,66,12022,64,239442
23182,9.7e-05,74.125.24.0-255,6797,18819,64,239442
23183,0.000101,172.31.40.0-255,66,18885,64,239442
23184,0.00013,74.125.24.0-255,2902,21787,64,239442
23185,0.000132,172.31.40.0-255,66,21853,64,239442
23186,0.000138,74.125.24.0-255,4320,26173,64,239442
23187,0.00014,172.31.40.0-255,66,26239,64,239442
23188,0.000174,172.31.40.0-255,66,26305,64,239442
23189,0.000214,172.31.40.0-255,66,26371,64,239442
23190,0.000259,172.31.40.0-255,66,26437,64,239442
23191,0.000262,74.125.24.0-255,129,26566,64,239442
23192,0.000264,172.31.40.0-255,66,26632,64,239442
23193,0.000351,74.125.24.0-255,1484,28116,64,239442
23194,0.000355,172.31.40.0-255,66,28182,64,239442
23195,0.000361,74.125.24.0-255,2902,31084,64,239442
23196,0.000363,172.31.40.0-255,66,31150,64,239442
23197,0.000366,74.125.24.0-255,1484,32634,64,239442
23198,0.000368,172.31.40.0-255,66,32700,64,239442
23199,0.000388,74.125.24.0-255,4320,37020,64,239442
23200,0.000391,172.31.40.0-255,66,37086,64,239442
23201,0.000396,74.125.24.0-255,5738,42824,64,239442
23202,0.000399,172.31.40.0-255,66,42890,64,239442
23203,0.000424,74.125.24.0-255,7156,50046,64,239442
23204,0.000427,172.31.40.0-255,66,50112,64,239442
23205,0.000451,74.125.24.0-255,7156,57268,64,239442
23206,0.000454,172.31.40.0-255,66,57334,64,239442
23207,0.000472,74.125.24.0-255,3602,60936,64,239442
23208,0.000474,172.31.40.0-255,66,61002,64,239442
23209,0.00051,74.125.24.0-255,1484,62486,64,239442
23210,0.000516,74.125.24.0-255,2902,65388,64,239442
23211,0.000518,172.31.40.0-255,66,65454,64,239442
23212,0.000522,74.125.24.0-255,1484,66938,64,239442
23213,0.000544,74.125.24.0-255,4320,71258,64,239442
23214,0.000547,172.31.40.0-255,66,71324,64,239442
23215,0.000559,172.31.40.0-255,66,71390,64,239442
23216,0.000583,74.125.24.0-255,1484,72874,64,239442
23217,0.000596,172.31.40.0-255,66,72940,64,239442
23218,0.000603,74.125.24.0-255,5738,78678,64,239442
23219,0.000606,172.31.40.0-255,66,78744,64,239442
23220,0.000647,74.125.24.0-255,4320,83064,64,239442
23221,0.00065,172.31.40.0-255,66,83130,64,239442
23222,0.000676,74.125.24.0-255,2902,86032,64,239442
23223,0.000679,172.31.40.0-255,66,86098,64,239442
23224,0.000693,172.31.40.0-255,66,86164,64,239442
23225,0.0007,74.125.24.0-255,6438,92602,64,239442
23226,0.000702,172.31.40.0-255,66,92668,64,239442
23227,0.000779,74.125.24.0-255,1484,94152,64,239442
23228,0.000801,74.125.24.0-255,2902,97054,64,239442
23229,0.000804,172.31.40.0-255,66,97120,64,239442
23230,0.000807,74.125.24.0-255,1484,98604,64,239442
23231,0.000811,74.125.24.0-255,1484,100088,64,239442
23232,0.000813,172.31.40.0-255,66,100154,64,239442
23233,0.000829,74.125.24.0-255,4320,104474,64,239442
23234,0.000832,172.31.40.0-255,66,104540,64,239442
23235,0.000848,74.125.24.0-255,4320,108860,64,239442
23236,0.000851,172.31.40.0-255,66,108926,64,239442
23237,0.000884,172.31.40.0-255,66,108992,64,239442
23238,0.000891,74.125.24.0-255,7156,116148,64,239442
23239,0.000893,172.31.40.0-255,66,116214,64,239442
23240,0.00094,172.31.40.0-255,66,116280,64,239442
23241,0.000972,74.125.24.0-255,766,117046,64,239442
23242,0.00099,172.31.40.0-255,66,117112,64,239442
23243,0.001472,74.125.24.0-255,1484,118596,64,239442
23244,0.001488,74.125.24.0-255,2902,121498,64,239442
23245,0.001494,172.31.40.0-255,66,121564,64,239442
23246,0.001504,74.125.24.0-255,5738,127302,64,239442
23247,0.001507,172.31.40.0-255,66,127368,64,239442
23248,0.001532,74.125.24.0-255,2902,130270,64,239442
23249,0.001535,172.31.40.0-255,66,130336,64,239442
23250,0.001541,74.125.24.0-255,4320,134656,64,239442
23251,0.001543,172.31.40.0-255,66,134722,64,239442
23252,0.001559,74.125.24.0-255,1484,136206,64,239442
23253,0.001586,74.125.24.0-255,7156,143362,64,239442
23254,0.001589,172.31.40.0-255,66,143428,64,239442
23255,0.001612,172.31.40.0-255,66,143494,64,239442
23256,0.001639,74.125.24.0-255,1484,144978,64,239442
23257,0.001673,74.125.24.0-255,2902,147880,64,239442
23258,0.001677,74.125.24.0-255,1484,149364,64,239442
23259,0.001689,74.125.24.0-255,2902,152266,64,239442
23260,0.001694,172.31.40.0-255,66,152332,64,239442
23261,0.001705,74.125.24.0-255,5738,158070,64,239442
23262,0.001714,172.31.40.0-255,66,158136,64,239442
23263,0.001719,74.125.24.0-255,2902,161038,64,239442
23264,0.001736,74.125.24.0-255,4320,165358,64,239442
23265,0.001749,74.125.24.0-255,2902,168260,64,239442
23266,0.001757,172.31.40.0-255,66,168326,64,239442
23267,0.001799,172.31.40.0-255,66,168392,64,239442
23268,0.00181,74.125.24.0-255,1484,169876,64,239442
23269,0.001814,74.125.24.0-255,2902,172778,64,239442
23270,0.001826,172.31.40.0-255,66,172844,64,239442
23271,0.001844,74.125.24.0-255,5738,178582,64,239442
23272,0.001859,172.31.40.0-255,66,178648,64,239442
23273,0.001863,74.125.24.0-255,2902,181550,64,239442
23274,0.001869,172.31.40.0-255,66,181616,64,239442
23275,0.001879,74.125.24.0-255,4320,185936,64,239442
23276,0.001898,74.125.24.0-255,4320,190256,64,239442
23277,0.001908,74.125.24.0-255,1484,191740,64,239442
23278,0.001943,74.125.24.0-255,2902,194642,64,239442
23279,0.001964,74.125.24.0-255,2902,197544,64,239442
23280,0.001968,172.31.40.0-255,66,197610,64,239442
23281,0.00198,74.125.24.0-255,5738,203348,64,239442
23282,0.001985,172.31.40.0-255,66,203414,64,239442
23283,0.001992,74.125.24.0-255,1484,204898,64,239442
23284,0.001994,74.125.24.0-255,1484,206382,64,239442
23285,0.002035,172.31.40.0-255,66,206448,64,239442
23286,0.002048,74.125.24.0-255,4320,210768,64,239442
23287,0.00206,74.125.24.0-255,2902,213670,64,239442
23288,0.002073,172.31.40.0-255,66,213736,64,239442
23289,0.002106,172.31.40.0-255,66,213802,64,239442
23290,0.00211,74.125.24.0-255,2184,215986,64,239442
23291,0.002136,74.125.24.0-255,7156,223142,64,239442
23292,0.002159,74.125.24.0-255,5738,228880,64,239442
23293,0.002162,74.125.24.0-255,766,229646,64,239442
23294,0.002168,74.125.24.0-255,5162,234808,64,239442
23295,0.002171,74.125.24.0-255,105,234913,64,239442
23296,0.002188,172.31.40.0-255,66,234979,64,239442
23297,0.016704,172.31.40.0-255,105,235084,64,239442
23298,0.019219,74.125.24.0-255,66,235150,64,239442
23299,0.049693,172.31.40.0-255,172,235322,64,239442
23300,0.04973,172.31.40.0-255,1113,236435,64,239442
23301,0.049791,172.31.40.0-255,1514,237949,64,239442
23302,0.049793,172.31.40.0-255,1295,239244,64,239442
23303,0.051309,104.244.42.0-255,66,239310,64,239442
23304,0.051322,104.244.42.0-255,66,239376,64,239442
23305,0.051342,104.244.42.0-255,66,239442,64,239442
23306,0.0,172.217.194.0-255,295,295,64,252414
23307,2.7e-05,172.31.40.0-255,66,361,64,252414
23308,3.5e-05,172.217.194.0-255,1484,1845,64,252414
23309,3.9e-05,172.31.40.0-255,66,1911,64,252414
23310,5.5e-05,172.217.194.0-255,4320,6231,64,252414
23311,5.8e-05,172.31.40.0-255,66,6297,64,252414
23312,7.5e-05,172.31.40.0-255,66,6363,64,252414
23313,8.7e-05,172.31.40.0-255,66,6429,64,252414
23314,0.000125,172.217.194.0-255,7156,13585,64,252414
23315,0.000128,172.31.40.0-255,66,13651,64,252414
23316,0.000156,172.217.194.0-255,1125,14776,64,252414
23317,0.000158,172.31.40.0-255,66,14842,64,252414
23318,0.000193,172.217.194.0-255,1484,16326,64,252414
23319,0.000195,172.31.40.0-255,66,16392,64,252414
23320,0.0002,172.217.194.0-255,2902,19294,64,252414
23321,0.000202,172.31.40.0-255,66,19360,64,252414
23322,0.000205,172.217.194.0-255,1484,20844,64,252414
23323,0.000207,172.31.40.0-255,66,20910,64,252414
23324,0.00025,172.217.194.0-255,4320,25230,64,252414
23325,0.000253,172.31.40.0-255,66,25296,64,252414
23326,0.000261,172.217.194.0-255,6797,32093,64,252414
23327,0.000263,172.31.40.0-255,66,32159,64,252414
23328,0.000297,172.217.194.0-255,1484,33643,64,252414
23329,0.000301,172.31.40.0-255,66,33709,64,252414
23330,0.000318,172.217.194.0-255,2902,36611,64,252414
23331,0.000321,172.31.40.0-255,66,36677,64,252414
23332,0.000327,172.217.194.0-255,5738,42415,64,252414
23333,0.000329,172.31.40.0-255,66,42481,64,252414
23334,0.000333,172.217.194.0-255,2902,45383,64,252414
23335,0.000335,172.31.40.0-255,66,45449,64,252414
23336,0.000364,172.217.194.0-255,3961,49410,64,252414
23337,0.000367,172.31.40.0-255,66,49476,64,252414
23338,0.00037,172.217.194.0-255,395,49871,64,252414
23339,0.000664,172.217.194.0-255,379,50250,64,252414
23340,0.000873,172.217.194.0-255,1484,51734,64,252414
23341,0.000879,172.31.40.0-255,66,51800,64,252414
23342,0.000886,172.217.194.0-255,2902,54702,64,252414
23343,0.00089,172.31.40.0-255,66,54768,64,252414
23344,0.000902,172.217.194.0-255,5738,60506,64,252414
23345,0.000904,172.31.40.0-255,66,60572,64,252414
23346,0.000939,172.217.194.0-255,4320,64892,64,252414
23347,0.000942,172.31.40.0-255,66,64958,64,252414
23348,0.000969,172.217.194.0-255,1994,66952,64,252414
23349,0.000972,172.31.40.0-255,66,67018,64,252414
23350,0.001866,172.217.194.0-255,1484,68502,64,252414
23351,0.001886,172.217.194.0-255,2902,71404,64,252414
23352,0.001892,172.31.40.0-255,66,71470,64,252414
23353,0.001902,172.217.194.0-255,5738,77208,64,252414
23354,0.001904,172.31.40.0-255,66,77274,64,252414
23355,0.001915,172.217.194.0-255,1484,78758,64,252414
23356,0.001942,172.217.194.0-255,5738,84496,64,252414
23357,0.001945,172.31.40.0-255,66,84562,64,252414
23358,0.00196,172.31.40.0-255,66,84628,64,252414
23359,0.001992,172.217.194.0-255,2902,87530,64,252414
23360,0.001994,172.31.40.0-255,66,87596,64,252414
23361,0.001999,172.217.194.0-255,2184,89780,64,252414
23362,0.002001,172.31.40.0-255,66,89846,64,252414
23363,0.00203,172.217.194.0-255,1484,91330,64,252414
23364,0.002036,172.217.194.0-255,2902,94232,64,252414
23365,0.002039,172.31.40.0-255,66,94298,64,252414
23366,0.002042,172.217.194.0-255,1484,95782,64,252414
23367,0.002067,172.217.194.0-255,4320,100102,64,252414
23368,0.002069,172.31.40.0-255,66,100168,64,252414
23369,0.002072,172.217.194.0-255,1484,101652,64,252414
23370,0.002111,172.31.40.0-255,66,101718,64,252414
23371,0.002128,172.31.40.0-255,66,101784,64,252414
23372,0.002193,172.217.194.0-255,7156,108940,64,252414
23373,0.002196,172.31.40.0-255,66,109006,64,252414
23374,0.002207,172.31.40.0-255,66,109072,64,252414
23375,0.002226,172.31.40.0-255,66,109138,64,252414
23376,0.002232,172.217.194.0-255,5020,114158,64,252414
23377,0.002235,172.31.40.0-255,66,114224,64,252414
23378,0.002269,172.31.40.0-255,66,114290,64,252414
23379,0.002306,172.31.40.0-255,66,114356,64,252414
23380,0.002313,172.217.194.0-255,5020,119376,64,252414
23381,0.002315,172.31.40.0-255,66,119442,64,252414
23382,0.002364,172.31.40.0-255,66,119508,64,252414
23383,0.002384,172.31.40.0-255,66,119574,64,252414
23384,0.002387,172.217.194.0-255,766,120340,64,252414
23385,0.004806,172.217.194.0-255,4320,124660,64,252414
23386,0.004826,172.31.40.0-255,66,124726,64,252414
23387,0.007221,172.217.194.0-255,5738,130464,64,252414
23388,0.007246,172.31.40.0-255,66,130530,64,252414
23389,0.009634,172.217.194.0-255,5738,136268,64,252414
23390,0.009651,172.31.40.0-255,66,136334,64,252414
23391,0.012008,172.217.194.0-255,5738,142072,64,252414
23392,0.012015,172.31.40.0-255,66,142138,64,252414
23393,0.0144,172.217.194.0-255,5738,147876,64,252414
23394,0.014415,172.31.40.0-255,66,147942,64,252414
23395,0.016832,172.217.194.0-255,5738,153680,64,252414
23396,0.016849,172.31.40.0-255,66,153746,64,252414
23397,0.019194,172.217.194.0-255,5738,159484,64,252414
23398,0.0192,172.31.40.0-255,66,159550,64,252414
23399,0.021579,172.217.194.0-255,5738,165288,64,252414
23400,0.021606,172.31.40.0-255,66,165354,64,252414
23401,0.024012,172.217.194.0-255,5738,171092,64,252414
23402,0.024032,172.31.40.0-255,66,171158,64,252414
23403,0.026382,172.217.194.0-255,5738,176896,64,252414
23404,0.026403,172.31.40.0-255,66,176962,64,252414
23405,0.028782,172.217.194.0-255,5738,182700,64,252414
23406,0.028804,172.31.40.0-255,66,182766,64,252414
23407,0.031159,172.217.194.0-255,5738,188504,64,252414
23408,0.031179,172.31.40.0-255,66,188570,64,252414
23409,0.033516,172.217.194.0-255,5738,194308,64,252414
23410,0.033534,172.31.40.0-255,66,194374,64,252414
23411,0.035915,172.217.194.0-255,5738,200112,64,252414
23412,0.035938,172.31.40.0-255,66,200178,64,252414
23413,0.038394,172.217.194.0-255,5738,205916,64,252414
23414,0.038414,172.31.40.0-255,66,205982,64,252414
23415,0.040829,172.217.194.0-255,5738,211720,64,252414
23416,0.040852,172.31.40.0-255,66,211786,64,252414
23417,0.043225,172.217.194.0-255,5738,217524,64,252414
23418,0.043245,172.31.40.0-255,66,217590,64,252414
23419,0.045647,172.217.194.0-255,5738,223328,64,252414
23420,0.045668,172.31.40.0-255,66,223394,64,252414
23421,0.048057,172.217.194.0-255,5738,229132,64,252414
23422,0.048078,172.31.40.0-255,66,229198,64,252414
23423,0.050443,172.217.194.0-255,5738,234936,64,252414
23424,0.050466,172.31.40.0-255,66,235002,64,252414
23425,0.052895,172.217.194.0-255,5738,240740,64,252414
23426,0.052918,172.31.40.0-255,66,240806,64,252414
23427,0.05526,172.217.194.0-255,5738,246544,64,252414
23428,0.055272,172.31.40.0-255,66,246610,64,252414
23429,0.057664,172.217.194.0-255,5738,252348,64,252414
23430,0.057684,172.31.40.0-255,66,252414,64,252414
23431,0.0,172.31.40.0-255,105,105,64,459
23432,0.000174,172.31.40.0-255,90,195,64,459
23433,0.000185,172.31.40.0-255,66,261,64,459
23434,0.002486,74.125.68.0-255,66,327,64,459
23435,0.002518,74.125.68.0-255,66,393,64,459
23436,0.002541,172.31.40.0-255,66,459,64,459
23437,0.0,172.217.194.0-255,153,153,64,347662
23438,1.6e-05,172.31.40.0-255,66,219,64,347662
23439,2.3e-05,172.217.194.0-255,1484,1703,64,347662
23440,2.8e-05,172.31.40.0-255,66,1769,64,347662
23441,3.4e-05,172.217.194.0-255,2902,4671,64,347662
23442,3.8e-05,172.31.40.0-255,66,4737,64,347662
23443,7.2e-05,172.217.194.0-255,7156,11893,64,347662
23444,7.6e-05,172.31.40.0-255,66,11959,64,347662
23445,8.8e-05,172.31.40.0-255,66,12025,64,347662
23446,0.000111,172.217.194.0-255,5738,17763,64,347662
23447,0.000114,172.31.40.0-255,66,17829,64,347662
23448,0.000133,172.217.194.0-255,4320,22149,64,347662
23449,0.000135,172.31.40.0-255,66,22215,64,347662
23450,0.000138,172.217.194.0-255,1125,23340,64,347662
23451,0.00014,172.31.40.0-255,66,23406,64,347662
23452,0.000272,172.217.194.0-255,1484,24890,64,347662
23453,0.000277,172.31.40.0-255,66,24956,64,347662
23454,0.000284,172.217.194.0-255,2902,27858,64,347662
23455,0.000286,172.31.40.0-255,66,27924,64,347662
23456,0.000308,172.217.194.0-255,5738,33662,64,347662
23457,0.000311,172.31.40.0-255,66,33728,64,347662
23458,0.000314,172.217.194.0-255,1484,35212,64,347662
23459,0.000316,172.31.40.0-255,66,35278,64,347662
23460,0.000343,172.217.194.0-255,5738,41016,64,347662
23461,0.000346,172.31.40.0-255,66,41082,64,347662
23462,0.000366,172.217.194.0-255,2902,43984,64,347662
23463,0.000369,172.31.40.0-255,66,44050,64,347662
23464,0.000377,172.217.194.0-255,7156,51206,64,347662
23465,0.00038,172.31.40.0-255,66,51272,64,347662
23466,0.000392,172.217.194.0-255,2902,54174,64,347662
23467,0.000394,172.31.40.0-255,66,54240,64,347662
23468,0.000399,172.217.194.0-255,3602,57842,64,347662
23469,0.000402,172.31.40.0-255,66,57908,64,347662
23470,0.000459,172.217.194.0-255,379,58287,64,347662
23471,0.000483,172.217.194.0-255,366,58653,64,347662
23472,0.000634,172.217.194.0-255,1484,60137,64,347662
23473,0.000639,172.31.40.0-255,66,60203,64,347662
23474,0.000644,172.217.194.0-255,2902,63105,64,347662
23475,0.000646,172.31.40.0-255,66,63171,64,347662
23476,0.000651,172.217.194.0-255,2902,66073,64,347662
23477,0.000653,172.31.40.0-255,66,66139,64,347662
23478,0.000697,172.217.194.0-255,5738,71877,64,347662
23479,0.000701,172.31.40.0-255,66,71943,64,347662
23480,0.000718,172.217.194.0-255,1484,73427,64,347662
23481,0.000723,172.217.194.0-255,4320,77747,64,347662
23482,0.000735,172.31.40.0-255,66,77813,64,347662
23483,0.000748,172.217.194.0-255,7156,84969,64,347662
23484,0.00075,172.31.40.0-255,66,85035,64,347662
23485,0.000779,172.217.194.0-255,5738,90773,64,347662
23486,0.000782,172.31.40.0-255,66,90839,64,347662
23487,0.000786,172.217.194.0-255,2184,93023,64,347662
23488,0.000788,172.31.40.0-255,66,93089,64,347662
23489,0.000859,172.217.194.0-255,1484,94573,64,347662
23490,0.000872,172.217.194.0-255,2902,97475,64,347662
23491,0.000875,172.31.40.0-255,66,97541,64,347662
23492,0.000882,172.217.194.0-255,5738,103279,64,347662
23493,0.000884,172.31.40.0-255,66,103345,64,347662
23494,0.000924,172.217.194.0-255,1484,104829,64,347662
23495,0.000928,172.31.40.0-255,66,104895,64,347662
23496,0.000936,172.217.194.0-255,1484,106379,64,347662
23497,0.000939,172.31.40.0-255,66,106445,64,347662
23498,0.000984,172.217.194.0-255,5738,112183,64,347662
23499,0.000987,172.31.40.0-255,66,112249,64,347662
23500,0.001007,172.217.194.0-255,2184,114433,64,347662
23501,0.001009,172.31.40.0-255,66,114499,64,347662
23502,0.001014,172.217.194.0-255,2902,117401,64,347662
23503,0.001016,172.31.40.0-255,66,117467,64,347662
23504,0.001034,172.217.194.0-255,5738,123205,64,347662
23505,0.001037,172.31.40.0-255,66,123271,64,347662
23506,0.001042,172.217.194.0-255,4320,127591,64,347662
23507,0.001044,172.31.40.0-255,66,127657,64,347662
23508,0.001108,172.31.40.0-255,66,127723,64,347662
23509,0.001115,172.217.194.0-255,6438,134161,64,347662
23510,0.001118,172.31.40.0-255,66,134227,64,347662
23511,0.001281,172.217.194.0-255,1484,135711,64,347662
23512,0.001287,172.217.194.0-255,2902,138613,64,347662
23513,0.00129,172.31.40.0-255,66,138679,64,347662
23514,0.001367,172.217.194.0-255,1484,140163,64,347662
23515,0.001372,172.217.194.0-255,2902,143065,64,347662
23516,0.001376,172.217.194.0-255,2902,145967,64,347662
23517,0.001381,172.31.40.0-255,66,146033,64,347662
23518,0.001389,172.31.40.0-255,66,146099,64,347662
23519,0.001394,172.217.194.0-255,2902,149001,64,347662
23520,0.001397,172.31.40.0-255,66,149067,64,347662
23521,0.001404,172.217.194.0-255,5738,154805,64,347662
23522,0.001407,172.31.40.0-255,66,154871,64,347662
23523,0.001433,172.217.194.0-255,5738,160609,64,347662
23524,0.001436,172.31.40.0-255,66,160675,64,347662
23525,0.001441,172.217.194.0-255,2902,163577,64,347662
23526,0.001444,172.31.40.0-255,66,163643,64,347662
23527,0.001461,172.217.194.0-255,5020,168663,64,347662
23528,0.001464,172.31.40.0-255,66,168729,64,347662
23529,0.00151,172.217.194.0-255,1484,170213,64,347662
23530,0.001515,172.217.194.0-255,2902,173115,64,347662
23531,0.001519,172.31.40.0-255,66,173181,64,347662
23532,0.001525,172.217.194.0-255,5738,178919,64,347662
23533,0.001527,172.31.40.0-255,66,178985,64,347662
23534,0.001548,172.217.194.0-255,5738,184723,64,347662
23535,0.001565,172.217.194.0-255,7156,191879,64,347662
23536,0.001583,172.31.40.0-255,66,191945,64,347662
23537,0.001593,172.217.194.0-255,766,192711,64,347662
23538,0.001745,172.217.194.0-255,1484,194195,64,347662
23539,0.001749,172.31.40.0-255,66,194261,64,347662
23540,0.00177,172.217.194.0-255,2902,197163,64,347662
23541,0.001777,172.217.194.0-255,5738,202901,64,347662
23542,0.001818,172.31.40.0-255,66,202967,64,347662
23543,0.001852,172.31.40.0-255,66,203033,64,347662
23544,0.001877,172.31.40.0-255,66,203099,64,347662
23545,0.004195,172.217.194.0-255,5738,208837,64,347662
23546,0.004204,172.31.40.0-255,66,208903,64,347662
23547,0.006542,172.217.194.0-255,5738,214641,64,347662
23548,0.006556,172.31.40.0-255,66,214707,64,347662
23549,0.008884,172.217.194.0-255,5738,220445,64,347662
23550,0.008899,172.31.40.0-255,66,220511,64,347662
23551,0.011222,172.217.194.0-255,5738,226249,64,347662
23552,0.011236,172.31.40.0-255,66,226315,64,347662
23553,0.013608,172.217.194.0-255,5738,232053,64,347662
23554,0.013615,172.31.40.0-255,66,232119,64,347662
23555,0.015962,172.217.194.0-255,5738,237857,64,347662
23556,0.015968,172.31.40.0-255,66,237923,64,347662
23557,0.01826,172.217.194.0-255,5738,243661,64,347662
23558,0.018266,172.31.40.0-255,66,243727,64,347662
23559,0.020571,172.217.194.0-255,5738,249465,64,347662
23560,0.020589,172.31.40.0-255,66,249531,64,347662
23561,0.022928,172.217.194.0-255,5738,255269,64,347662
23562,0.022937,172.31.40.0-255,66,255335,64,347662
23563,0.025224,172.217.194.0-255,5738,261073,64,347662
23564,0.02523,172.31.40.0-255,66,261139,64,347662
23565,0.027585,172.217.194.0-255,5738,266877,64,347662
23566,0.027593,172.31.40.0-255,66,266943,64,347662
23567,0.029893,172.217.194.0-255,5738,272681,64,347662
23568,0.0299,172.31.40.0-255,66,272747,64,347662
23569,0.032189,172.217.194.0-255,5738,278485,64,347662
23570,0.032199,172.31.40.0-255,66,278551,64,347662
23571,0.034507,172.217.194.0-255,5738,284289,64,347662
23572,0.034517,172.31.40.0-255,66,284355,64,347662
23573,0.036852,172.217.194.0-255,5738,290093,64,347662
23574,0.03687,172.31.40.0-255,66,290159,64,347662
23575,0.039185,172.217.194.0-255,5738,295897,64,347662
23576,0.039193,172.31.40.0-255,66,295963,64,347662
23577,0.04152,172.217.194.0-255,5738,301701,64,347662
23578,0.041527,172.31.40.0-255,66,301767,64,347662
23579,0.043839,172.217.194.0-255,5738,307505,64,347662
23580,0.043854,172.31.40.0-255,66,307571,64,347662
23581,0.046164,172.217.194.0-255,5738,313309,64,347662
23582,0.046185,172.31.40.0-255,66,313375,64,347662
23583,0.048476,172.217.194.0-255,5738,319113,64,347662
23584,0.048484,172.31.40.0-255,66,319179,64,347662
23585,0.050791,172.217.194.0-255,5738,324917,64,347662
23586,0.0508,172.31.40.0-255,66,324983,64,347662
23587,0.052064,172.31.40.0-255,167,325150,64,347662
23588,0.05209,172.31.40.0-255,1111,326261,64,347662
23589,0.05214,172.31.40.0-255,1514,327775,64,347662
23590,0.052142,172.31.40.0-255,1514,329289,64,347662
23591,0.052143,172.31.40.0-255,697,329986,64,347662
23592,0.053113,172.217.194.0-255,5738,335724,64,347662
23593,0.05312,172.31.40.0-255,66,335790,64,347662
23594,0.053608,104.244.42.0-255,66,335856,64,347662
23595,0.053645,104.244.42.0-255,66,335922,64,347662
23596,0.053693,104.244.42.0-255,66,335988,64,347662
23597,0.053698,104.244.42.0-255,66,336054,64,347662
23598,0.055449,172.217.194.0-255,5738,341792,64,347662
23599,0.055464,172.31.40.0-255,66,341858,64,347662
23600,0.057835,172.217.194.0-255,5738,347596,64,347662
23601,0.057853,172.31.40.0-255,66,347662,64,347662
23602,0.0,74.125.24.0-255,150,150,64,278223
23603,2.5e-05,172.31.40.0-255,66,216,64,278223
23604,3.3e-05,74.125.24.0-255,1484,1700,64,278223
23605,3.7e-05,172.31.40.0-255,66,1766,64,278223
23606,4.4e-05,74.125.24.0-255,2902,4668,64,278223
23607,4.7e-05,172.31.40.0-255,66,4734,64,278223
23608,5.6e-05,74.125.24.0-255,7156,11890,64,278223
23609,5.8e-05,172.31.40.0-255,66,11956,64,278223
23610,6.2e-05,74.125.24.0-255,2135,14091,64,278223
23611,6.5e-05,172.31.40.0-255,66,14157,64,278223
23612,0.000108,74.125.24.0-255,1484,15641,64,278223
23613,0.00011,172.31.40.0-255,66,15707,64,278223
23614,0.000116,74.125.24.0-255,2902,18609,64,278223
23615,0.000118,172.31.40.0-255,66,18675,64,278223
23616,0.000123,74.125.24.0-255,2902,21577,64,278223
23617,0.000126,172.31.40.0-255,66,21643,64,278223
23618,0.000139,74.125.24.0-255,2902,24545,64,278223
23619,0.000141,172.31.40.0-255,66,24611,64,278223
23620,0.000156,74.125.24.0-255,1484,26095,64,278223
23621,0.000159,172.31.40.0-255,66,26161,64,278223
23622,0.000175,74.125.24.0-255,5379,31540,64,278223
23623,0.000178,172.31.40.0-255,66,31606,64,278223
23624,0.000312,74.125.24.0-255,1484,33090,64,278223
23625,0.000316,172.31.40.0-255,66,33156,64,278223
23626,0.000322,74.125.24.0-255,2902,36058,64,278223
23627,0.000324,172.31.40.0-255,66,36124,64,278223
23628,0.000339,74.125.24.0-255,4320,40444,64,278223
23629,0.000342,172.31.40.0-255,66,40510,64,278223
23630,0.00036,74.125.24.0-255,1484,41994,64,278223
23631,0.000362,172.31.40.0-255,66,42060,64,278223
23632,0.000369,74.125.24.0-255,6797,48857,64,278223
23633,0.000372,172.31.40.0-255,66,48923,64,278223
23634,0.000375,74.125.24.0-255,1484,50407,64,278223
23635,0.000392,74.125.24.0-255,7156,57563,64,278223
23636,0.000412,74.125.24.0-255,5738,63301,64,278223
23637,0.000416,74.125.24.0-255,2840,66141,64,278223
23638,0.000483,74.125.24.0-255,135,66276,64,278223
23639,0.000534,172.31.40.0-255,66,66342,64,278223
23640,0.000586,74.125.24.0-255,1484,67826,64,278223
23641,0.000606,74.125.24.0-255,1484,69310,64,278223
23642,0.000613,172.31.40.0-255,66,69376,64,278223
23643,0.00063,74.125.24.0-255,1484,70860,64,278223
23644,0.000637,74.125.24.0-255,5738,76598,64,278223
23645,0.000651,74.125.24.0-255,2902,79500,64,278223
23646,0.000654,172.31.40.0-255,66,79566,64,278223
23647,0.000659,172.31.40.0-255,66,79632,64,278223
23648,0.000675,74.125.24.0-255,3961,83593,64,278223
23649,0.000683,74.125.24.0-255,7156,90749,64,278223
23650,0.000707,74.125.24.0-255,4320,95069,64,278223
23651,0.000711,172.31.40.0-255,66,95135,64,278223
23652,0.000722,74.125.24.0-255,5379,100514,64,278223
23653,0.000733,172.31.40.0-255,66,100580,64,278223
23654,0.00084,74.125.24.0-255,1484,102064,64,278223
23655,0.000846,74.125.24.0-255,2902,104966,64,278223
23656,0.000852,172.31.40.0-255,66,105032,64,278223
23657,0.000872,74.125.24.0-255,5738,110770,64,278223
23658,0.000876,74.125.24.0-255,1484,112254,64,278223
23659,0.000892,172.31.40.0-255,66,112320,64,278223
23660,0.000909,74.125.24.0-255,1484,113804,64,278223
23661,0.000938,172.31.40.0-255,66,113870,64,278223
23662,0.000959,74.125.24.0-255,2460,116330,64,278223
23663,0.000976,172.31.40.0-255,66,116396,64,278223
23664,0.001212,74.125.24.0-255,1484,117880,64,278223
23665,0.001218,74.125.24.0-255,2902,120782,64,278223
23666,0.00123,172.31.40.0-255,66,120848,64,278223
23667,0.001244,74.125.24.0-255,5738,126586,64,278223
23668,0.00126,74.125.24.0-255,2902,129488,64,278223
23669,0.00127,172.31.40.0-255,66,129554,64,278223
23670,0.001289,74.125.24.0-255,4320,133874,64,278223
23671,0.001294,172.31.40.0-255,66,133940,64,278223
23672,0.001316,74.125.24.0-255,6438,140378,64,278223
23673,0.001327,172.31.40.0-255,66,140444,64,278223
23674,0.003674,74.125.24.0-255,5738,146182,64,278223
23675,0.003683,172.31.40.0-255,66,146248,64,278223
23676,0.006021,74.125.24.0-255,5738,151986,64,278223
23677,0.007854,172.31.40.0-255,66,152052,64,278223
23678,0.010178,74.125.24.0-255,5738,157790,64,278223
23679,0.010193,172.31.40.0-255,66,157856,64,278223
23680,0.012495,74.125.24.0-255,5738,163594,64,278223
23681,0.014963,172.31.40.0-255,66,163660,64,278223
23682,0.017278,74.125.24.0-255,5738,169398,64,278223
23683,0.017296,172.31.40.0-255,66,169464,64,278223
23684,0.019613,74.125.24.0-255,5738,175202,64,278223
23685,0.019627,172.31.40.0-255,66,175268,64,278223
23686,0.021941,74.125.24.0-255,5738,181006,64,278223
23687,0.021951,172.31.40.0-255,66,181072,64,278223
23688,0.024274,74.125.24.0-255,5738,186810,64,278223
23689,0.024286,172.31.40.0-255,66,186876,64,278223
23690,0.026602,74.125.24.0-255,5738,192614,64,278223
23691,0.026617,172.31.40.0-255,66,192680,64,278223
23692,0.028961,74.125.24.0-255,5738,198418,64,278223
23693,0.028975,172.31.40.0-255,66,198484,64,278223
23694,0.031274,74.125.24.0-255,5738,204222,64,278223
23695,0.031283,172.31.40.0-255,66,204288,64,278223
23696,0.031694,172.31.40.0-255,167,204455,64,278223
23697,0.031728,172.31.40.0-255,1113,205568,64,278223
23698,0.031787,172.31.40.0-255,1514,207082,64,278223
23699,0.031789,172.31.40.0-255,1295,208377,64,278223
23700,0.033263,104.244.42.0-255,66,208443,64,278223
23701,0.033293,104.244.42.0-255,66,208509,64,278223
23702,0.033351,104.244.42.0-255,66,208575,64,278223
23703,0.033568,74.125.24.0-255,5738,214313,64,278223
23704,0.033574,172.31.40.0-255,66,214379,64,278223
23705,0.035888,74.125.24.0-255,5738,220117,64,278223
23706,0.035896,172.31.40.0-255,66,220183,64,278223
23707,0.038219,74.125.24.0-255,5738,225921,64,278223
23708,0.038228,172.31.40.0-255,66,225987,64,278223
23709,0.040549,74.125.24.0-255,5738,231725,64,278223
23710,0.040572,172.31.40.0-255,66,231791,64,278223
23711,0.042893,74.125.24.0-255,5738,237529,64,278223
23712,0.042909,172.31.40.0-255,66,237595,64,278223
23713,0.045256,74.125.24.0-255,5738,243333,64,278223
23714,0.045275,172.31.40.0-255,66,243399,64,278223
23715,0.047595,74.125.24.0-255,5738,249137,64,278223
23716,0.047612,172.31.40.0-255,66,249203,64,278223
23717,0.049958,74.125.24.0-255,5738,254941,64,278223
23718,0.049977,172.31.40.0-255,66,255007,64,278223
23719,0.052355,74.125.24.0-255,5738,260745,64,278223
23720,0.05238,172.31.40.0-255,66,260811,64,278223
23721,0.054704,74.125.24.0-255,5738,266549,64,278223
23722,0.054722,172.31.40.0-255,66,266615,64,278223
23723,0.057041,74.125.24.0-255,5738,272353,64,278223
23724,0.05706,172.31.40.0-255,66,272419,64,278223
23725,0.059369,74.125.24.0-255,5738,278157,64,278223
23726,0.059388,172.31.40.0-255,66,278223,64,278223
23727,0.0,74.125.130.0-255,153,153,64,348141
23728,1.2e-05,172.31.40.0-255,66,219,64,348141
23729,1.8e-05,74.125.130.0-255,1484,1703,64,348141
23730,2.3e-05,172.31.40.0-255,66,1769,64,348141
23731,2.8e-05,74.125.130.0-255,2902,4671,64,348141
23732,3.7e-05,172.31.40.0-255,66,4737,64,348141
23733,7.7e-05,74.125.130.0-255,7156,11893,64,348141
23734,8e-05,172.31.40.0-255,66,11959,64,348141
23735,8.3e-05,74.125.130.0-255,2030,13989,64,348141
23736,8.5e-05,172.31.40.0-255,66,14055,64,348141
23737,8.9e-05,74.125.130.0-255,2902,16957,64,348141
23738,9.1e-05,172.31.40.0-255,66,17023,64,348141
23739,9.4e-05,74.125.130.0-255,1484,18507,64,348141
23740,9.6e-05,172.31.40.0-255,66,18573,64,348141
23741,0.000128,74.125.130.0-255,5738,24311,64,348141
23742,0.00013,172.31.40.0-255,66,24377,64,348141
23743,0.000134,74.125.130.0-255,2902,27279,64,348141
23744,0.000136,172.31.40.0-255,66,27345,64,348141
23745,0.000162,74.125.130.0-255,3961,31306,64,348141
23746,0.000165,172.31.40.0-255,66,31372,64,348141
23747,0.000262,74.125.130.0-255,1484,32856,64,348141
23748,0.000266,172.31.40.0-255,66,32922,64,348141
23749,0.000283,74.125.130.0-255,2902,35824,64,348141
23750,0.000285,172.31.40.0-255,66,35890,64,348141
23751,0.00029,74.125.130.0-255,2902,38792,64,348141
23752,0.000291,172.31.40.0-255,66,38858,64,348141
23753,0.000308,74.125.130.0-255,2902,41760,64,348141
23754,0.00031,172.31.40.0-255,66,41826,64,348141
23755,0.000315,74.125.130.0-255,4320,46146,64,348141
23756,0.000317,172.31.40.0-255,66,46212,64,348141
23757,0.000344,74.125.130.0-255,5379,51591,64,348141
23758,0.000346,172.31.40.0-255,66,51657,64,348141
23759,0.00038,172.31.40.0-255,66,51723,64,348141
23760,0.000411,74.125.130.0-255,5631,57354,64,348141
23761,0.000416,172.31.40.0-255,66,57420,64,348141
23762,0.000453,74.125.130.0-255,120,57540,64,348141
23763,0.000512,74.125.130.0-255,1484,59024,64,348141
23764,0.000516,172.31.40.0-255,66,59090,64,348141
23765,0.000519,74.125.130.0-255,1484,60574,64,348141
23766,0.000541,74.125.130.0-255,1484,62058,64,348141
23767,0.000543,172.31.40.0-255,66,62124,64,348141
23768,0.00055,74.125.130.0-255,5738,67862,64,348141
23769,0.000552,172.31.40.0-255,66,67928,64,348141
23770,0.000574,74.125.130.0-255,7156,75084,64,348141
23771,0.000577,172.31.40.0-255,66,75150,64,348141
23772,0.000581,74.125.130.0-255,2902,78052,64,348141
23773,0.000583,172.31.40.0-255,66,78118,64,348141
23774,0.000606,74.125.130.0-255,5738,83856,64,348141
23775,0.000608,172.31.40.0-255,66,83922,64,348141
23776,0.000633,172.31.40.0-255,66,83988,64,348141
23777,0.000652,74.125.130.0-255,380,84368,64,348141
23778,0.001038,74.125.130.0-255,1484,85852,64,348141
23779,0.001043,172.31.40.0-255,66,85918,64,348141
23780,0.001049,74.125.130.0-255,2902,88820,64,348141
23781,0.001051,172.31.40.0-255,66,88886,64,348141
23782,0.001056,74.125.130.0-255,5738,94624,64,348141
23783,0.001058,172.31.40.0-255,66,94690,64,348141
23784,0.00112,74.125.130.0-255,5738,100428,64,348141
23785,0.001123,172.31.40.0-255,66,100494,64,348141
23786,0.001129,74.125.130.0-255,7156,107650,64,348141
23787,0.001131,172.31.40.0-255,66,107716,64,348141
23788,0.001143,172.31.40.0-255,66,107782,64,348141
23789,0.001259,74.125.130.0-255,1484,109266,64,348141
23790,0.001263,74.125.130.0-255,1484,110750,64,348141
23791,0.001266,172.31.40.0-255,66,110816,64,348141
23792,0.001291,74.125.130.0-255,1484,112300,64,348141
23793,0.001297,74.125.130.0-255,5738,118038,64,348141
23794,0.001299,172.31.40.0-255,66,118104,64,348141
23795,0.001328,74.125.130.0-255,1484,119588,64,348141
23796,0.001345,74.125.130.0-255,5738,125326,64,348141
23797,0.001347,172.31.40.0-255,66,125392,64,348141
23798,0.001375,74.125.130.0-255,5738,131130,64,348141
23799,0.001377,172.31.40.0-255,66,131196,64,348141
23800,0.001411,172.31.40.0-255,66,131262,64,348141
23801,0.001545,74.125.130.0-255,1484,132746,64,348141
23802,0.001558,74.125.130.0-255,2902,135648,64,348141
23803,0.001561,172.31.40.0-255,66,135714,64,348141
23804,0.001564,74.125.130.0-255,1484,137198,64,348141
23805,0.001594,74.125.130.0-255,4320,141518,64,348141
23806,0.001597,172.31.40.0-255,66,141584,64,348141
23807,0.001603,74.125.130.0-255,7156,148740,64,348141
23808,0.001605,172.31.40.0-255,66,148806,64,348141
23809,0.001654,172.31.40.0-255,66,148872,64,348141
23810,0.001681,74.125.130.0-255,3602,152474,64,348141
23811,0.001683,172.31.40.0-255,66,152540,64,348141
23812,0.001743,74.125.130.0-255,1484,154024,64,348141
23813,0.001759,74.125.130.0-255,2902,156926,64,348141
23814,0.001762,172.31.40.0-255,66,156992,64,348141
23815,0.001773,74.125.130.0-255,1484,158476,64,348141
23816,0.001796,74.125.130.0-255,2902,161378,64,348141
23817,0.001798,172.31.40.0-255,66,161444,64,348141
23818,0.001804,74.125.130.0-255,5738,167182,64,348141
23819,0.001805,172.31.40.0-255,66,167248,64,348141
23820,0.001832,74.125.130.0-255,7156,174404,64,348141
23821,0.001834,172.31.40.0-255,66,174470,64,348141
23822,0.001858,74.125.130.0-255,4320,178790,64,348141
23823,0.00186,172.31.40.0-255,66,178856,64,348141
23824,0.001865,74.125.130.0-255,2902,181758,64,348141
23825,0.001866,172.31.40.0-255,66,181824,64,348141
23826,0.001906,172.31.40.0-255,66,181890,64,348141
23827,0.001911,74.125.130.0-255,4320,186210,64,348141
23828,0.001912,172.31.40.0-255,66,186276,64,348141
23829,0.001936,74.125.130.0-255,4320,190596,64,348141
23830,0.001939,172.31.40.0-255,66,190662,64,348141
23831,0.001973,172.31.40.0-255,66,190728,64,348141
23832,0.001978,74.125.130.0-255,5738,196466,64,348141
23833,0.00198,172.31.40.0-255,66,196532,64,348141
23834,0.001982,74.125.130.0-255,766,197298,64,348141
23835,0.003039,172.31.40.0-255,66,197364,64,348141
23836,0.003995,74.125.130.0-255,4320,201684,64,348141
23837,0.004002,172.31.40.0-255,66,201750,64,348141
23838,0.005058,74.125.130.0-255,1484,203234,64,348141
23839,0.006016,74.125.130.0-255,4320,207554,64,348141
23840,0.00602,172.31.40.0-255,66,207620,64,348141
23841,0.008028,74.125.130.0-255,5738,213358,64,348141
23842,0.00803,172.31.40.0-255,66,213424,64,348141
23843,0.010044,74.125.130.0-255,5738,219162,64,348141
23844,0.01005,172.31.40.0-255,66,219228,64,348141
23845,0.012115,74.125.130.0-255,5738,224966,64,348141
23846,0.012123,172.31.40.0-255,66,225032,64,348141
23847,0.014144,74.125.130.0-255,5738,230770,64,348141
23848,0.014154,172.31.40.0-255,66,230836,64,348141
23849,0.016172,74.125.130.0-255,5738,236574,64,348141
23850,0.016179,172.31.40.0-255,66,236640,64,348141
23851,0.018194,74.125.130.0-255,5738,242378,64,348141
23852,0.0182,172.31.40.0-255,66,242444,64,348141
23853,0.020225,74.125.130.0-255,5738,248182,64,348141
23854,0.020231,172.31.40.0-255,66,248248,64,348141
23855,0.022268,74.125.130.0-255,5738,253986,64,348141
23856,0.022275,172.31.40.0-255,66,254052,64,348141
23857,0.024294,74.125.130.0-255,5738,259790,64,348141
23858,0.024302,172.31.40.0-255,66,259856,64,348141
23859,0.026306,74.125.130.0-255,2902,262758,64,348141
23860,0.026314,172.31.40.0-255,66,262824,64,348141
23861,0.026346,74.125.130.0-255,2902,265726,64,348141
23862,0.026349,172.31.40.0-255,66,265792,64,348141
23863,0.027734,172.31.40.0-255,171,265963,64,348141
23864,0.027761,172.31.40.0-255,1136,267099,64,348141
23865,0.02781,172.31.40.0-255,1514,268613,64,348141
23866,0.027811,172.31.40.0-255,1272,269885,64,348141
23867,0.028331,74.125.130.0-255,2902,272787,64,348141
23868,0.028337,172.31.40.0-255,66,272853,64,348141
23869,0.028367,74.125.130.0-255,2902,275755,64,348141
23870,0.02837,172.31.40.0-255,66,275821,64,348141
23871,0.029319,104.244.42.0-255,66,275887,64,348141
23872,0.029353,104.244.42.0-255,66,275953,64,348141
23873,0.029399,104.244.42.0-255,66,276019,64,348141
23874,0.030118,104.244.42.0-255,108,276127,64,348141
23875,0.030128,172.31.40.0-255,66,276193,64,348141
23876,0.030363,74.125.130.0-255,2902,279095,64,348141
23877,0.030367,172.31.40.0-255,66,279161,64,348141
23878,0.030387,74.125.130.0-255,2902,282063,64,348141
23879,0.03039,172.31.40.0-255,66,282129,64,348141
23880,0.032392,74.125.130.0-255,4320,286449,64,348141
23881,0.032398,172.31.40.0-255,66,286515,64,348141
23882,0.032424,74.125.130.0-255,1484,287999,64,348141
23883,0.034417,74.125.130.0-255,4320,292319,64,348141
23884,0.034424,172.31.40.0-255,66,292385,64,348141
23885,0.036489,74.125.130.0-255,5738,298123,64,348141
23886,0.036495,172.31.40.0-255,66,298189,64,348141
23887,0.038532,74.125.130.0-255,5738,303927,64,348141
23888,0.038538,172.31.40.0-255,66,303993,64,348141
23889,0.040563,74.125.130.0-255,5738,309731,64,348141
23890,0.04057,172.31.40.0-255,66,309797,64,348141
23891,0.042594,74.125.130.0-255,5738,315535,64,348141
23892,0.042601,172.31.40.0-255,66,315601,64,348141
23893,0.044615,74.125.130.0-255,5738,321339,64,348141
23894,0.044622,172.31.40.0-255,66,321405,64,348141
23895,0.04665,74.125.130.0-255,5738,327143,64,348141
23896,0.046656,172.31.40.0-255,66,327209,64,348141
23897,0.048682,74.125.130.0-255,5738,332947,64,348141
23898,0.048688,172.31.40.0-255,66,333013,64,348141
23899,0.050721,74.125.130.0-255,5738,338751,64,348141
23900,0.050727,172.31.40.0-255,66,338817,64,348141
23901,0.052753,74.125.130.0-255,5738,344555,64,348141
23902,0.05276,172.31.40.0-255,66,344621,64,348141
23903,0.054785,74.125.130.0-255,3283,347904,64,348141
23904,0.054793,172.31.40.0-255,66,347970,64,348141
23905,0.05496,172.31.40.0-255,105,348075,64,348141
23906,0.056942,74.125.130.0-255,66,348141,64,348141
23907,0.0,172.217.194.0-255,152,152,64,215641
23908,1.8e-05,172.31.40.0-255,66,218,64,215641
23909,2.5e-05,172.217.194.0-255,1484,1702,64,215641
23910,2.9e-05,172.31.40.0-255,66,1768,64,215641
23911,3.4e-05,172.217.194.0-255,2902,4670,64,215641
23912,4.7e-05,172.31.40.0-255,66,4736,64,215641
23913,5.5e-05,172.217.194.0-255,7156,11892,64,215641
23914,5.8e-05,172.31.40.0-255,66,11958,64,215641
23915,6.2e-05,172.217.194.0-255,2030,13988,64,215641
23916,6.6e-05,172.31.40.0-255,66,14054,64,215641
23917,7e-05,172.217.194.0-255,2902,16956,64,215641
23918,7.3e-05,172.31.40.0-255,66,17022,64,215641
23919,0.000114,172.217.194.0-255,7156,24178,64,215641
23920,0.000117,172.31.40.0-255,66,24244,64,215641
23921,0.000125,172.217.194.0-255,6797,31041,64,215641
23922,0.000127,172.31.40.0-255,66,31107,64,215641
23923,0.000179,172.217.194.0-255,7156,38263,64,215641
23924,0.000182,172.31.40.0-255,66,38329,64,215641
23925,0.000187,172.217.194.0-255,4320,42649,64,215641
23926,0.000189,172.31.40.0-255,66,42715,64,215641
23927,0.000209,172.217.194.0-255,4320,47035,64,215641
23928,0.000216,172.31.40.0-255,66,47101,64,215641
23929,0.000219,172.217.194.0-255,1125,48226,64,215641
23930,0.000221,172.31.40.0-255,66,48292,64,215641
23931,0.000625,172.217.194.0-255,1484,49776,64,215641
23932,0.00063,172.31.40.0-255,66,49842,64,215641
23933,0.000637,172.217.194.0-255,2902,52744,64,215641
23934,0.00064,172.31.40.0-255,66,52810,64,215641
23935,0.000652,172.217.194.0-255,5738,58548,64,215641
23936,0.000654,172.31.40.0-255,66,58614,64,215641
23937,0.00066,172.217.194.0-255,4320,62934,64,215641
23938,0.000663,172.31.40.0-255,66,63000,64,215641
23939,0.000695,172.217.194.0-255,2543,65543,64,215641
23940,0.000698,172.31.40.0-255,66,65609,64,215641
23941,0.000721,172.217.194.0-255,1484,67093,64,215641
23942,0.000726,172.217.194.0-255,2902,69995,64,215641
23943,0.000729,172.31.40.0-255,66,70061,64,215641
23944,0.000732,172.217.194.0-255,1484,71545,64,215641
23945,0.00076,172.217.194.0-255,4320,75865,64,215641
23946,0.000763,172.31.40.0-255,66,75931,64,215641
23947,0.000768,172.217.194.0-255,4320,80251,64,215641
23948,0.000771,172.31.40.0-255,66,80317,64,215641
23949,0.000796,172.217.194.0-255,2543,82860,64,215641
23950,0.000803,172.217.194.0-255,7156,90016,64,215641
23951,0.000829,172.31.40.0-255,66,90082,64,215641
23952,0.000837,172.31.40.0-255,66,90148,64,215641
23953,0.000839,172.31.40.0-255,66,90214,64,215641
23954,0.000856,172.31.40.0-255,66,90280,64,215641
23955,0.000864,172.217.194.0-255,6783,97063,64,215641
23956,0.000866,172.31.40.0-255,66,97129,64,215641
23957,0.000914,172.217.194.0-255,4320,101449,64,215641
23958,0.000919,172.31.40.0-255,66,101515,64,215641
23959,0.000946,172.217.194.0-255,1484,102999,64,215641
23960,0.000954,172.217.194.0-255,7156,110155,64,215641
23961,0.000957,172.31.40.0-255,66,110221,64,215641
23962,0.000962,172.217.194.0-255,2902,113123,64,215641
23963,0.000964,172.31.40.0-255,66,113189,64,215641
23964,0.000997,172.31.40.0-255,66,113255,64,215641
23965,0.001004,172.217.194.0-255,6438,119693,64,215641
23966,0.001006,172.31.40.0-255,66,119759,64,215641
23967,0.001044,172.31.40.0-255,66,119825,64,215641
23968,0.001055,172.31.40.0-255,66,119891,64,215641
23969,0.00108,172.217.194.0-255,2902,122793,64,215641
23970,0.001086,172.31.40.0-255,66,122859,64,215641
23971,0.001101,172.31.40.0-255,66,122925,64,215641
23972,0.001126,172.217.194.0-255,2902,125827,64,215641
23973,0.001132,172.31.40.0-255,66,125893,64,215641
23974,0.001137,172.217.194.0-255,4320,130213,64,215641
23975,0.00114,172.31.40.0-255,66,130279,64,215641
23976,0.001163,172.217.194.0-255,2902,133181,64,215641
23977,0.001165,172.31.40.0-255,66,133247,64,215641
23978,0.001196,172.217.194.0-255,5738,138985,64,215641
23979,0.001203,172.31.40.0-255,66,139051,64,215641
23980,0.001211,172.217.194.0-255,7156,146207,64,215641
23981,0.001213,172.31.40.0-255,66,146273,64,215641
23982,0.001262,172.31.40.0-255,66,146339,64,215641
23983,0.001314,172.217.194.0-255,1484,147823,64,215641
23984,0.001318,172.217.194.0-255,2902,150725,64,215641
23985,0.001321,172.31.40.0-255,66,150791,64,215641
23986,0.001328,172.217.194.0-255,5738,156529,64,215641
23987,0.00133,172.31.40.0-255,66,156595,64,215641
23988,0.001363,172.31.40.0-255,66,156661,64,215641
23989,0.001402,172.31.40.0-255,66,156727,64,215641
23990,0.00148,172.217.194.0-255,1484,158211,64,215641
23991,0.001486,172.217.194.0-255,2902,161113,64,215641
23992,0.001489,172.31.40.0-255,66,161179,64,215641
23993,0.001493,172.217.194.0-255,1484,162663,64,215641
23994,0.001527,172.217.194.0-255,4320,166983,64,215641
23995,0.00153,172.31.40.0-255,66,167049,64,215641
23996,0.001544,172.31.40.0-255,66,167115,64,215641
23997,0.001559,172.31.40.0-255,66,167181,64,215641
23998,0.001586,172.217.194.0-255,5738,172919,64,215641
23999,0.001589,172.31.40.0-255,66,172985,64,215641
24000,0.001638,172.31.40.0-255,66,173051,64,215641
24001,0.001652,172.31.40.0-255,66,173117,64,215641
24002,0.001659,172.217.194.0-255,7156,180273,64,215641
24003,0.001662,172.31.40.0-255,66,180339,64,215641
24004,0.001673,172.31.40.0-255,66,180405,64,215641
24005,0.001713,172.31.40.0-255,66,180471,64,215641
24006,0.001716,172.217.194.0-255,766,181237,64,215641
24007,0.001819,172.217.194.0-255,1484,182721,64,215641
24008,0.001823,172.31.40.0-255,66,182787,64,215641
24009,0.001828,172.217.194.0-255,2902,185689,64,215641
24010,0.00183,172.31.40.0-255,66,185755,64,215641
24011,0.001833,172.217.194.0-255,1484,187239,64,215641
24012,0.00185,172.217.194.0-255,4320,191559,64,215641
24013,0.001852,172.31.40.0-255,66,191625,64,215641
24014,0.001863,172.217.194.0-255,7156,198781,64,215641
24015,0.001866,172.31.40.0-255,66,198847,64,215641
24016,0.001886,172.217.194.0-255,1484,200331,64,215641
24017,0.001919,172.217.194.0-255,5738,206069,64,215641
24018,0.001922,172.31.40.0-255,66,206135,64,215641
24019,0.001958,172.31.40.0-255,66,206201,64,215641
24020,0.001961,172.217.194.0-255,1484,207685,64,215641
24021,0.001997,172.31.40.0-255,66,207751,64,215641
24022,0.002015,172.31.40.0-255,66,207817,64,215641
24023,0.002018,172.217.194.0-255,194,208011,64,215641
24024,0.002076,172.217.194.0-255,105,208116,64,215641
24025,0.011266,172.217.194.0-255,105,208221,64,215641
24026,0.011289,172.31.40.0-255,78,208299,64,215641
24027,0.01463,172.31.40.0-255,105,208404,64,215641
24028,0.016882,172.217.194.0-255,66,208470,64,215641
24029,0.05357,172.31.40.0-255,172,208642,64,215641
24030,0.053604,172.31.40.0-255,1112,209754,64,215641
24031,0.05368,172.31.40.0-255,1514,211268,64,215641
24032,0.053682,172.31.40.0-255,1514,212782,64,215641
24033,0.053683,172.31.40.0-255,1514,214296,64,215641
24034,0.053711,172.31.40.0-255,1081,215377,64,215641
24035,0.055077,104.244.42.0-255,66,215443,64,215641
24036,0.055088,104.244.42.0-255,66,215509,64,215641
24037,0.055204,104.244.42.0-255,66,215575,64,215641
24038,0.055211,104.244.42.0-255,66,215641,64,215641
24039,0.0,172.217.24.0-255,154,154,64,315214
24040,1.4e-05,172.31.40.0-255,66,220,64,315214
24041,5.5e-05,172.217.24.0-255,1484,1704,64,315214
24042,5.9e-05,172.31.40.0-255,66,1770,64,315214
24043,6.4e-05,172.217.24.0-255,2902,4672,64,315214
24044,6.6e-05,172.31.40.0-255,66,4738,64,315214
24045,7.2e-05,172.217.24.0-255,5738,10476,64,315214
24046,7.5e-05,172.31.40.0-255,66,10542,64,315214
24047,8.4e-05,172.217.24.0-255,3410,13952,64,315214
24048,8.7e-05,172.31.40.0-255,66,14018,64,315214
24049,0.000149,172.217.24.0-255,1484,15502,64,315214
24050,0.000153,172.31.40.0-255,66,15568,64,315214
24051,0.000157,172.217.24.0-255,2902,18470,64,315214
24052,0.000159,172.31.40.0-255,66,18536,64,315214
24053,0.000165,172.217.24.0-255,5738,24274,64,315214
24054,0.000167,172.31.40.0-255,66,24340,64,315214
24055,0.000179,172.217.24.0-255,6797,31137,64,315214
24056,0.00018,172.31.40.0-255,66,31203,64,315214
24057,0.000294,172.217.24.0-255,1484,32687,64,315214
24058,0.000297,172.31.40.0-255,66,32753,64,315214
24059,0.000313,172.217.24.0-255,2902,35655,64,315214
24060,0.000319,172.31.40.0-255,66,35721,64,315214
24061,0.000326,172.217.24.0-255,4320,40041,64,315214
24062,0.000329,172.31.40.0-255,66,40107,64,315214
24063,0.000375,172.217.24.0-255,2902,43009,64,315214
24064,0.000377,172.31.40.0-255,66,43075,64,315214
24065,0.000399,172.217.24.0-255,6797,49872,64,315214
24066,0.000402,172.31.40.0-255,66,49938,64,315214
24067,0.000407,172.217.24.0-255,4320,54258,64,315214
24068,0.000409,172.31.40.0-255,66,54324,64,315214
24069,0.000445,172.217.24.0-255,5738,60062,64,315214
24070,0.000448,172.31.40.0-255,66,60128,64,315214
24071,0.000452,172.217.24.0-255,2902,63030,64,315214
24072,0.000454,172.31.40.0-255,66,63096,64,315214
24073,0.000475,172.217.24.0-255,2870,65966,64,315214
24074,0.000478,172.31.40.0-255,66,66032,64,315214
24075,0.001082,172.217.24.0-255,115,66147,64,315214
24076,0.001086,172.217.24.0-255,332,66479,64,315214
24077,0.001149,172.31.40.0-255,66,66545,64,315214
24078,0.001391,172.217.24.0-255,1484,68029,64,315214
24079,0.001401,172.217.24.0-255,2902,70931,64,315214
24080,0.001405,172.31.40.0-255,66,70997,64,315214
24081,0.001412,172.217.24.0-255,4320,75317,64,315214
24082,0.001414,172.31.40.0-255,66,75383,64,315214
24083,0.00145,172.217.24.0-255,1484,76867,64,315214
24084,0.001456,172.217.24.0-255,5738,82605,64,315214
24085,0.001459,172.31.40.0-255,66,82671,64,315214
24086,0.001467,172.217.24.0-255,7156,89827,64,315214
24087,0.001469,172.31.40.0-255,66,89893,64,315214
24088,0.001481,172.217.24.0-255,5738,95631,64,315214
24089,0.001483,172.31.40.0-255,66,95697,64,315214
24090,0.001515,172.217.24.0-255,5020,100717,64,315214
24091,0.001517,172.31.40.0-255,66,100783,64,315214
24092,0.002416,172.217.24.0-255,1484,102267,64,315214
24093,0.002423,172.217.24.0-255,2902,105169,64,315214
24094,0.002427,172.31.40.0-255,66,105235,64,315214
24095,0.002456,172.217.24.0-255,1484,106719,64,315214
24096,0.002504,172.217.24.0-255,2902,109621,64,315214
24097,0.002507,172.31.40.0-255,66,109687,64,315214
24098,0.002513,172.217.24.0-255,5738,115425,64,315214
24099,0.002514,172.31.40.0-255,66,115491,64,315214
24100,0.002525,172.217.24.0-255,7156,122647,64,315214
24101,0.002528,172.31.40.0-255,66,122713,64,315214
24102,0.002537,172.31.40.0-255,66,122779,64,315214
24103,0.002542,172.217.24.0-255,3602,126381,64,315214
24104,0.002547,172.31.40.0-255,66,126447,64,315214
24105,0.002577,172.217.24.0-255,2902,129349,64,315214
24106,0.00258,172.31.40.0-255,66,129415,64,315214
24107,0.002598,172.217.24.0-255,1484,130899,64,315214
24108,0.002603,172.217.24.0-255,2902,133801,64,315214
24109,0.002605,172.31.40.0-255,66,133867,64,315214
24110,0.00261,172.217.24.0-255,4320,138187,64,315214
24111,0.002612,172.31.40.0-255,66,138253,64,315214
24112,0.002616,172.217.24.0-255,4320,142573,64,315214
24113,0.002618,172.31.40.0-255,66,142639,64,315214
24114,0.002649,172.217.24.0-255,4320,146959,64,315214
24115,0.002651,172.31.40.0-255,66,147025,64,315214
24116,0.002666,172.31.40.0-255,66,147091,64,315214
24117,0.002685,172.217.24.0-255,766,147857,64,315214
24118,0.002817,172.217.24.0-255,1484,149341,64,315214
24119,0.002818,172.31.40.0-255,66,149407,64,315214
24120,0.002822,172.217.24.0-255,1484,150891,64,315214
24121,0.00284,172.217.24.0-255,1484,152375,64,315214
24122,0.002842,172.31.40.0-255,66,152441,64,315214
24123,0.002848,172.217.24.0-255,5738,158179,64,315214
24124,0.002851,172.31.40.0-255,66,158245,64,315214
24125,0.00286,172.217.24.0-255,5738,163983,64,315214
24126,0.002862,172.31.40.0-255,66,164049,64,315214
24127,0.002892,172.217.24.0-255,1484,165533,64,315214
24128,0.002905,172.31.40.0-255,66,165599,64,315214
24129,0.002908,172.217.24.0-255,2184,167783,64,315214
24130,0.00291,172.31.40.0-255,66,167849,64,315214
24131,0.003104,172.217.24.0-255,1484,169333,64,315214
24132,0.003123,172.217.24.0-255,1484,170817,64,315214
24133,0.003126,172.31.40.0-255,66,170883,64,315214
24134,0.00315,172.217.24.0-255,1484,172367,64,315214
24135,0.003156,172.217.24.0-255,5738,178105,64,315214
24136,0.003159,172.31.40.0-255,66,178171,64,315214
24137,0.003189,172.31.40.0-255,66,178237,64,315214
24138,0.003195,172.217.24.0-255,5738,183975,64,315214
24139,0.003198,172.31.40.0-255,66,184041,64,315214
24140,0.003233,172.217.24.0-255,6438,190479,64,315214
24141,0.003236,172.31.40.0-255,66,190545,64,315214
24142,0.003397,172.217.24.0-255,1484,192029,64,315214
24143,0.003403,172.217.24.0-255,2902,194931,64,315214
24144,0.003406,172.31.40.0-255,66,194997,64,315214
24145,0.003434,172.217.24.0-255,5738,200735,64,315214
24146,0.003437,172.31.40.0-255,66,200801,64,315214
24147,0.003465,172.217.24.0-255,5738,206539,64,315214
24148,0.003468,172.31.40.0-255,66,206605,64,315214
24149,0.003501,172.217.24.0-255,7156,213761,64,315214
24150,0.003505,172.31.40.0-255,66,213827,64,315214
24151,0.003508,172.217.24.0-255,1484,215311,64,315214
24152,0.003512,172.217.24.0-255,2902,218213,64,315214
24153,0.003514,172.31.40.0-255,66,218279,64,315214
24154,0.003526,172.217.24.0-255,6438,224717,64,315214
24155,0.003529,172.31.40.0-255,66,224783,64,315214
24156,0.003765,172.217.24.0-255,1484,226267,64,315214
24157,0.003771,172.217.24.0-255,2902,229169,64,315214
24158,0.003775,172.31.40.0-255,66,229235,64,315214
24159,0.003779,172.217.24.0-255,2902,232137,64,315214
24160,0.003782,172.31.40.0-255,66,232203,64,315214
24161,0.003816,172.217.24.0-255,2902,235105,64,315214
24162,0.003818,172.31.40.0-255,66,235171,64,315214
24163,0.003837,172.31.40.0-255,66,235237,64,315214
24164,0.003921,172.31.40.0-255,66,235303,64,315214
24165,0.003924,172.217.24.0-255,1484,236787,64,315214
24166,0.003956,172.217.24.0-255,1484,238271,64,315214
24167,0.003959,172.31.40.0-255,66,238337,64,315214
24168,0.003988,172.217.24.0-255,2902,241239,64,315214
24169,0.00399,172.31.40.0-255,66,241305,64,315214
24170,0.003996,172.217.24.0-255,5738,247043,64,315214
24171,0.003999,172.31.40.0-255,66,247109,64,315214
24172,0.004005,172.217.24.0-255,4320,251429,64,315214
24173,0.004007,172.31.40.0-255,66,251495,64,315214
24174,0.004052,172.31.40.0-255,66,251561,64,315214
24175,0.004057,172.217.24.0-255,4320,255881,64,315214
24176,0.00406,172.31.40.0-255,66,255947,64,315214
24177,0.004064,172.217.24.0-255,4320,260267,64,315214
24178,0.004067,172.31.40.0-255,66,260333,64,315214
24179,0.004069,172.217.24.0-255,766,261099,64,315214
24180,0.004154,172.217.24.0-255,1484,262583,64,315214
24181,0.004158,172.31.40.0-255,66,262649,64,315214
24182,0.004164,172.217.24.0-255,2902,265551,64,315214
24183,0.004167,172.31.40.0-255,66,265617,64,315214
24184,0.004198,172.217.24.0-255,5738,271355,64,315214
24185,0.004201,172.31.40.0-255,66,271421,64,315214
24186,0.004208,172.217.24.0-255,5738,277159,64,315214
24187,0.004211,172.31.40.0-255,66,277225,64,315214
24188,0.004237,172.217.24.0-255,7156,284381,64,315214
24189,0.00424,172.31.40.0-255,66,284447,64,315214
24190,0.004253,172.31.40.0-255,66,284513,64,315214
24191,0.004286,172.217.24.0-255,1484,285997,64,315214
24192,0.004294,172.217.24.0-255,1484,287481,64,315214
24193,0.004296,172.31.40.0-255,66,287547,64,315214
24194,0.004328,172.217.24.0-255,1484,289031,64,315214
24195,0.004335,172.217.24.0-255,5738,294769,64,315214
24196,0.004338,172.31.40.0-255,66,294835,64,315214
24197,0.004345,172.217.24.0-255,7156,301991,64,315214
24198,0.004347,172.31.40.0-255,66,302057,64,315214
24199,0.004362,172.31.40.0-255,66,302123,64,315214
24200,0.004364,172.217.24.0-255,1484,303607,64,315214
24201,0.004367,172.217.24.0-255,1484,305091,64,315214
24202,0.004369,172.31.40.0-255,66,305157,64,315214
24203,0.004402,172.217.24.0-255,5020,310177,64,315214
24204,0.004405,172.31.40.0-255,66,310243,64,315214
24205,0.004415,172.31.40.0-255,66,310309,64,315214
24206,0.004422,172.217.24.0-255,97,310406,64,315214
24207,0.004463,172.217.24.0-255,105,310511,64,315214
24208,0.006737,172.31.40.0-255,66,310577,64,315214
24209,0.006769,172.31.40.0-255,105,310682,64,315214
24210,0.008666,172.217.24.0-255,66,310748,64,315214
24211,0.033145,172.31.40.0-255,172,310920,64,315214
24212,0.033179,172.31.40.0-255,1112,312032,64,315214
24213,0.033229,172.31.40.0-255,1514,313546,64,315214
24214,0.033268,172.31.40.0-255,1296,314842,64,315214
24215,0.034738,104.244.42.0-255,66,314908,64,315214
24216,0.034777,104.244.42.0-255,66,314974,64,315214
24217,0.034817,104.244.42.0-255,66,315040,64,315214
24218,0.035438,104.244.42.0-255,108,315148,64,315214
24219,0.035444,172.31.40.0-255,66,315214,64,315214
24220,0.0,172.217.194.0-255,147,147,64,178698
24221,2.4e-05,172.31.40.0-255,66,213,64,178698
24222,3.1e-05,172.217.194.0-255,1484,1697,64,178698
24223,3.6e-05,172.31.40.0-255,66,1763,64,178698
24224,4.3e-05,172.217.194.0-255,2902,4665,64,178698
24225,4.7e-05,172.31.40.0-255,66,4731,64,178698
24226,5.2e-05,172.217.194.0-255,2902,7633,64,178698
24227,5.5e-05,172.31.40.0-255,66,7699,64,178698
24228,6.2e-05,172.217.194.0-255,4320,12019,64,178698
24229,6.5e-05,172.31.40.0-255,66,12085,64,178698
24230,0.000101,172.31.40.0-255,66,12151,64,178698
24231,0.000112,172.31.40.0-255,66,12217,64,178698
24232,0.000157,172.217.194.0-255,7156,19373,64,178698
24233,0.00016,172.31.40.0-255,66,19439,64,178698
24234,0.000182,172.217.194.0-255,4320,23759,64,178698
24235,0.000184,172.31.40.0-255,66,23825,64,178698
24236,0.00019,172.217.194.0-255,5020,28845,64,178698
24237,0.000192,172.31.40.0-255,66,28911,64,178698
24238,0.003231,172.217.194.0-255,1484,30395,64,178698
24239,0.003248,172.31.40.0-255,66,30461,64,178698
24240,0.003262,172.217.194.0-255,2902,33363,64,178698
24241,0.003264,172.31.40.0-255,66,33429,64,178698
24242,0.003268,172.217.194.0-255,1484,34913,64,178698
24243,0.00327,172.31.40.0-255,66,34979,64,178698
24244,0.005602,172.217.194.0-255,2902,37881,64,178698
24245,0.005607,172.31.40.0-255,66,37947,64,178698
24246,0.005624,172.217.194.0-255,2902,40849,64,178698
24247,0.005626,172.31.40.0-255,66,40915,64,178698
24248,0.007928,172.217.194.0-255,5738,46653,64,178698
24249,0.007944,172.31.40.0-255,66,46719,64,178698
24250,0.010282,172.217.194.0-255,5738,52457,64,178698
24251,0.010301,172.31.40.0-255,66,52523,64,178698
24252,0.01265,172.217.194.0-255,5738,58261,64,178698
24253,0.01267,172.31.40.0-255,66,58327,64,178698
24254,0.01499,172.217.194.0-255,5738,64065,64,178698
24255,0.015007,172.31.40.0-255,66,64131,64,178698
24256,0.017369,172.217.194.0-255,5738,69869,64,178698
24257,0.017383,172.31.40.0-255,66,69935,64,178698
24258,0.019724,172.217.194.0-255,5738,75673,64,178698
24259,0.019742,172.31.40.0-255,66,75739,64,178698
24260,0.022093,172.217.194.0-255,5738,81477,64,178698
24261,0.02211,172.31.40.0-255,66,81543,64,178698
24262,0.024429,172.217.194.0-255,5738,87281,64,178698
24263,0.024438,172.31.40.0-255,66,87347,64,178698
24264,0.025192,172.31.40.0-255,171,87518,64,178698
24265,0.025224,172.31.40.0-255,1136,88654,64,178698
24266,0.025286,172.31.40.0-255,1514,90168,64,178698
24267,0.025288,172.31.40.0-255,1272,91440,64,178698
24268,0.026746,172.217.194.0-255,5738,97178,64,178698
24269,0.02676,172.31.40.0-255,66,97244,64,178698
24270,0.026781,104.244.42.0-255,66,97310,64,178698
24271,0.02679,104.244.42.0-255,66,97376,64,178698
24272,0.026837,104.244.42.0-255,66,97442,64,178698
24273,0.029106,172.217.194.0-255,5738,103180,64,178698
24274,0.029119,172.31.40.0-255,66,103246,64,178698
24275,0.031475,172.217.194.0-255,5738,108984,64,178698
24276,0.031493,172.31.40.0-255,66,109050,64,178698
24277,0.033823,172.217.194.0-255,5738,114788,64,178698
24278,0.033836,172.31.40.0-255,66,114854,64,178698
24279,0.036161,172.217.194.0-255,5738,120592,64,178698
24280,0.036172,172.31.40.0-255,66,120658,64,178698
24281,0.038494,172.217.194.0-255,5738,126396,64,178698
24282,0.038506,172.31.40.0-255,66,126462,64,178698
24283,0.040822,172.217.194.0-255,5738,132200,64,178698
24284,0.040837,172.31.40.0-255,66,132266,64,178698
24285,0.043178,172.217.194.0-255,5738,138004,64,178698
24286,0.043194,172.31.40.0-255,66,138070,64,178698
24287,0.045524,172.217.194.0-255,5738,143808,64,178698
24288,0.045539,172.31.40.0-255,66,143874,64,178698
24289,0.04789,172.217.194.0-255,5738,149612,64,178698
24290,0.047906,172.31.40.0-255,66,149678,64,178698
24291,0.050253,172.217.194.0-255,5738,155416,64,178698
24292,0.050269,172.31.40.0-255,66,155482,64,178698
24293,0.052603,172.217.194.0-255,5738,161220,64,178698
24294,0.052615,172.31.40.0-255,66,161286,64,178698
24295,0.054949,172.217.194.0-255,5738,167024,64,178698
24296,0.054956,172.31.40.0-255,66,167090,64,178698
24297,0.057297,172.217.194.0-255,5738,172828,64,178698
24298,0.057312,172.31.40.0-255,66,172894,64,178698
24299,0.05962,172.217.194.0-255,5738,178632,64,178698
24300,0.059631,172.31.40.0-255,66,178698,64,178698
24301,0.0,74.125.68.0-255,146,146,64,306417
24302,2.3e-05,172.31.40.0-255,66,212,64,306417
24303,3.2e-05,74.125.68.0-255,1484,1696,64,306417
24304,3.6e-05,172.31.40.0-255,66,1762,64,306417
24305,5e-05,74.125.68.0-255,2902,4664,64,306417
24306,6.8e-05,172.31.40.0-255,66,4730,64,306417
24307,7.6e-05,74.125.68.0-255,7156,11886,64,306417
24308,7.8e-05,172.31.40.0-255,66,11952,64,306417
24309,8.3e-05,74.125.68.0-255,2031,13983,64,306417
24310,8.6e-05,172.31.40.0-255,66,14049,64,306417
24311,0.000191,74.125.68.0-255,1484,15533,64,306417
24312,0.000195,172.31.40.0-255,66,15599,64,306417
24313,0.000199,74.125.68.0-255,1484,17083,64,306417
24314,0.000201,172.31.40.0-255,66,17149,64,306417
24315,0.00022,74.125.68.0-255,1484,18633,64,306417
24316,0.000222,172.31.40.0-255,66,18699,64,306417
24317,0.000229,74.125.68.0-255,5738,24437,64,306417
24318,0.000231,172.31.40.0-255,66,24503,64,306417
24319,0.000268,74.125.68.0-255,6797,31300,64,306417
24320,0.00027,172.31.40.0-255,66,31366,64,306417
24321,0.000335,74.125.68.0-255,1484,32850,64,306417
24322,0.000339,172.31.40.0-255,66,32916,64,306417
24323,0.000365,74.125.68.0-255,2902,35818,64,306417
24324,0.000368,172.31.40.0-255,66,35884,64,306417
24325,0.000375,74.125.68.0-255,5738,41622,64,306417
24326,0.000377,172.31.40.0-255,66,41688,64,306417
24327,0.000382,74.125.68.0-255,2902,44590,64,306417
24328,0.000389,172.31.40.0-255,66,44656,64,306417
24329,0.000429,74.125.68.0-255,3961,48617,64,306417
24330,0.000431,172.31.40.0-255,66,48683,64,306417
24331,0.000494,74.125.68.0-255,1484,50167,64,306417
24332,0.000497,172.31.40.0-255,66,50233,64,306417
24333,0.0005,74.125.68.0-255,1484,51717,64,306417
24334,0.00052,74.125.68.0-255,1484,53201,64,306417
24335,0.000523,172.31.40.0-255,66,53267,64,306417
24336,0.00053,74.125.68.0-255,5738,59005,64,306417
24337,0.000532,172.31.40.0-255,66,59071,64,306417
24338,0.000536,74.125.68.0-255,2902,61973,64,306417
24339,0.000538,172.31.40.0-255,66,62039,64,306417
24340,0.00058,74.125.68.0-255,1484,63523,64,306417
24341,0.000598,74.125.68.0-255,2888,66411,64,306417
24342,0.000601,172.31.40.0-255,66,66477,64,306417
24343,0.000604,74.125.68.0-255,332,66809,64,306417
24344,0.000889,74.125.68.0-255,1484,68293,64,306417
24345,0.000894,172.31.40.0-255,66,68359,64,306417
24346,0.0009,74.125.68.0-255,2902,71261,64,306417
24347,0.000902,172.31.40.0-255,66,71327,64,306417
24348,0.000925,74.125.68.0-255,5738,77065,64,306417
24349,0.000928,172.31.40.0-255,66,77131,64,306417
24350,0.000955,74.125.68.0-255,6797,83928,64,306417
24351,0.000958,172.31.40.0-255,66,83994,64,306417
24352,0.000988,74.125.68.0-255,1484,85478,64,306417
24353,0.001009,74.125.68.0-255,2902,88380,64,306417
24354,0.001012,172.31.40.0-255,66,88446,64,306417
24355,0.001019,74.125.68.0-255,5738,94184,64,306417
24356,0.001021,172.31.40.0-255,66,94250,64,306417
24357,0.001058,74.125.68.0-255,6797,101047,64,306417
24358,0.001062,172.31.40.0-255,66,101113,64,306417
24359,0.001762,74.125.68.0-255,1484,102597,64,306417
24360,0.001772,74.125.68.0-255,2902,105499,64,306417
24361,0.001776,172.31.40.0-255,66,105565,64,306417
24362,0.001811,74.125.68.0-255,5738,111303,64,306417
24363,0.001814,172.31.40.0-255,66,111369,64,306417
24364,0.00182,74.125.68.0-255,4320,115689,64,306417
24365,0.001822,172.31.40.0-255,66,115755,64,306417
24366,0.001828,74.125.68.0-255,5738,121493,64,306417
24367,0.001831,172.31.40.0-255,66,121559,64,306417
24368,0.001869,172.31.40.0-255,66,121625,64,306417
24369,0.001892,74.125.68.0-255,2184,123809,64,306417
24370,0.001894,172.31.40.0-255,66,123875,64,306417
24371,0.002098,74.125.68.0-255,1484,125359,64,306417
24372,0.002119,74.125.68.0-255,2902,128261,64,306417
24373,0.002123,172.31.40.0-255,66,128327,64,306417
24374,0.002131,74.125.68.0-255,5738,134065,64,306417
24375,0.002133,172.31.40.0-255,66,134131,64,306417
24376,0.002164,74.125.68.0-255,2902,137033,64,306417
24377,0.002167,172.31.40.0-255,66,137099,64,306417
24378,0.002172,74.125.68.0-255,4320,141419,64,306417
24379,0.002174,172.31.40.0-255,66,141485,64,306417
24380,0.00218,74.125.68.0-255,4320,145805,64,306417
24381,0.002182,172.31.40.0-255,66,145871,64,306417
24382,0.002219,74.125.68.0-255,4320,150191,64,306417
24383,0.002222,172.31.40.0-255,66,150257,64,306417
24384,0.002227,74.125.68.0-255,4320,154577,64,306417
24385,0.002229,172.31.40.0-255,66,154643,64,306417
24386,0.002254,74.125.68.0-255,3602,158245,64,306417
24387,0.002257,172.31.40.0-255,66,158311,64,306417
24388,0.004501,74.125.68.0-255,1484,159795,64,306417
24389,0.004536,74.125.68.0-255,4320,164115,64,306417
24390,0.004541,172.31.40.0-255,66,164181,64,306417
24391,0.006829,74.125.68.0-255,5738,169919,64,306417
24392,0.006833,172.31.40.0-255,66,169985,64,306417
24393,0.009112,74.125.68.0-255,5738,175723,64,306417
24394,0.009119,172.31.40.0-255,66,175789,64,306417
24395,0.011421,74.125.68.0-255,5738,181527,64,306417
24396,0.011431,172.31.40.0-255,66,181593,64,306417
24397,0.013722,74.125.68.0-255,5738,187331,64,306417
24398,0.013732,172.31.40.0-255,66,187397,64,306417
24399,0.016015,74.125.68.0-255,5738,193135,64,306417
24400,0.016024,172.31.40.0-255,66,193201,64,306417
24401,0.018309,74.125.68.0-255,5738,198939,64,306417
24402,0.018318,172.31.40.0-255,66,199005,64,306417
24403,0.020608,74.125.68.0-255,5738,204743,64,306417
24404,0.020617,172.31.40.0-255,66,204809,64,306417
24405,0.022908,74.125.68.0-255,5738,210547,64,306417
24406,0.022915,172.31.40.0-255,66,210613,64,306417
24407,0.025203,74.125.68.0-255,5738,216351,64,306417
24408,0.025227,172.31.40.0-255,66,216417,64,306417
24409,0.027547,74.125.68.0-255,5738,222155,64,306417
24410,0.027554,172.31.40.0-255,66,222221,64,306417
24411,0.029562,172.31.40.0-255,172,222393,64,306417
24412,0.029595,172.31.40.0-255,1112,223505,64,306417
24413,0.02965,172.31.40.0-255,1514,225019,64,306417
24414,0.029652,172.31.40.0-255,1296,226315,64,306417
24415,0.029839,74.125.68.0-255,5738,232053,64,306417
24416,0.029845,172.31.40.0-255,66,232119,64,306417
24417,0.031096,104.244.42.0-255,66,232185,64,306417
24418,0.031139,104.244.42.0-255,66,232251,64,306417
24419,0.031186,104.244.42.0-255,66,232317,64,306417
24420,0.032128,74.125.68.0-255,5738,238055,64,306417
24421,0.032134,172.31.40.0-255,66,238121,64,306417
24422,0.034427,74.125.68.0-255,5738,243859,64,306417
24423,0.034436,172.31.40.0-255,66,243925,64,306417
24424,0.036735,74.125.68.0-255,5738,249663,64,306417
24425,0.036743,172.31.40.0-255,66,249729,64,306417
24426,0.039043,74.125.68.0-255,5738,255467,64,306417
24427,0.03905,172.31.40.0-255,66,255533,64,306417
24428,0.041343,74.125.68.0-255,5738,261271,64,306417
24429,0.041352,172.31.40.0-255,66,261337,64,306417
24430,0.04365,74.125.68.0-255,5738,267075,64,306417
24431,0.043657,172.31.40.0-255,66,267141,64,306417
24432,0.045941,74.125.68.0-255,4320,271461,64,306417
24433,0.045947,172.31.40.0-255,66,271527,64,306417
24434,0.045971,74.125.68.0-255,1484,273011,64,306417
24435,0.048237,74.125.68.0-255,4320,277331,64,306417
24436,0.048244,172.31.40.0-255,66,277397,64,306417
24437,0.050522,74.125.68.0-255,5738,283135,64,306417
24438,0.050529,172.31.40.0-255,66,283201,64,306417
24439,0.052829,74.125.68.0-255,5738,288939,64,306417
24440,0.052836,172.31.40.0-255,66,289005,64,306417
24441,0.055154,74.125.68.0-255,5738,294743,64,306417
24442,0.055165,172.31.40.0-255,66,294809,64,306417
24443,0.057455,74.125.68.0-255,5738,300547,64,306417
24444,0.057462,172.31.40.0-255,66,300613,64,306417
24445,0.059751,74.125.68.0-255,5738,306351,64,306417
24446,0.059758,172.31.40.0-255,66,306417,64,306417
24447,0.0,172.31.40.0-255,105,105,64,459
24448,0.000247,172.31.40.0-255,90,195,64,459
24449,0.000258,172.31.40.0-255,66,261,64,459
24450,0.002604,74.125.68.0-255,66,327,64,459
24451,0.002636,74.125.68.0-255,66,393,64,459
24452,0.00266,172.31.40.0-255,66,459,64,459
24453,0.0,74.125.24.0-255,153,153,64,206431
24454,2.4e-05,172.31.40.0-255,66,219,64,206431
24455,3.2e-05,74.125.24.0-255,1484,1703,64,206431
24456,3.7e-05,172.31.40.0-255,66,1769,64,206431
24457,4.4e-05,74.125.24.0-255,2902,4671,64,206431
24458,4.6e-05,172.31.40.0-255,66,4737,64,206431
24459,5.5e-05,74.125.24.0-255,7156,11893,64,206431
24460,5.8e-05,172.31.40.0-255,66,11959,64,206431
24461,8.1e-05,74.125.24.0-255,2158,14117,64,206431
24462,8.5e-05,172.31.40.0-255,66,14183,64,206431
24463,0.00011,74.125.24.0-255,7156,21339,64,206431
24464,0.000114,172.31.40.0-255,66,21405,64,206431
24465,0.000134,74.125.24.0-255,4320,25725,64,206431
24466,0.000136,172.31.40.0-255,66,25791,64,206431
24467,0.000222,74.125.24.0-255,2902,28693,64,206431
24468,0.000226,172.31.40.0-255,66,28759,64,206431
24469,0.00024,74.125.24.0-255,2543,31302,64,206431
24470,0.000243,172.31.40.0-255,66,31368,64,206431
24471,0.000295,74.125.24.0-255,1484,32852,64,206431
24472,0.000297,172.31.40.0-255,66,32918,64,206431
24473,0.000302,74.125.24.0-255,2902,35820,64,206431
24474,0.000304,172.31.40.0-255,66,35886,64,206431
24475,0.000327,74.125.24.0-255,2902,38788,64,206431
24476,0.000329,172.31.40.0-255,66,38854,64,206431
24477,0.000351,74.125.24.0-255,2902,41756,64,206431
24478,0.000354,172.31.40.0-255,66,41822,64,206431
24479,0.000389,74.125.24.0-255,4320,46142,64,206431
24480,0.000392,172.31.40.0-255,66,46208,64,206431
24481,0.000419,172.31.40.0-255,66,46274,64,206431
24482,0.000548,172.31.40.0-255,66,46340,64,206431
24483,0.000651,74.125.24.0-255,352,46692,64,206431
24484,0.001065,74.125.24.0-255,1484,48176,64,206431
24485,0.00107,172.31.40.0-255,66,48242,64,206431
24486,0.001075,74.125.24.0-255,2902,51144,64,206431
24487,0.001077,172.31.40.0-255,66,51210,64,206431
24488,0.0011,74.125.24.0-255,5738,56948,64,206431
24489,0.001102,172.31.40.0-255,66,57014,64,206431
24490,0.001136,74.125.24.0-255,2902,59916,64,206431
24491,0.001139,172.31.40.0-255,66,59982,64,206431
24492,0.00117,172.31.40.0-255,66,60048,64,206431
24493,0.001286,74.125.24.0-255,5738,65786,64,206431
24494,0.00129,172.31.40.0-255,66,65852,64,206431
24495,0.001305,74.125.24.0-255,5020,70872,64,206431
24496,0.001308,172.31.40.0-255,66,70938,64,206431
24497,0.00173,74.125.24.0-255,1484,72422,64,206431
24498,0.001741,74.125.24.0-255,2902,75324,64,206431
24499,0.001746,172.31.40.0-255,66,75390,64,206431
24500,0.001751,74.125.24.0-255,1484,76874,64,206431
24501,0.001769,74.125.24.0-255,4320,81194,64,206431
24502,0.001771,172.31.40.0-255,66,81260,64,206431
24503,0.001812,74.125.24.0-255,5738,86998,64,206431
24504,0.001815,172.31.40.0-255,66,87064,64,206431
24505,0.001832,74.125.24.0-255,1484,88548,64,206431
24506,0.001901,172.31.40.0-255,66,88614,64,206431
24507,0.001911,74.125.24.0-255,1484,90098,64,206431
24508,0.002011,74.125.24.0-255,2902,93000,64,206431
24509,0.002015,172.31.40.0-255,66,93066,64,206431
24510,0.002033,74.125.24.0-255,2184,95250,64,206431
24511,0.002035,172.31.40.0-255,66,95316,64,206431
24512,0.002206,74.125.24.0-255,1484,96800,64,206431
24513,0.002213,74.125.24.0-255,2902,99702,64,206431
24514,0.002217,172.31.40.0-255,66,99768,64,206431
24515,0.00224,74.125.24.0-255,5738,105506,64,206431
24516,0.002243,172.31.40.0-255,66,105572,64,206431
24517,0.002294,74.125.24.0-255,2902,108474,64,206431
24518,0.002297,172.31.40.0-255,66,108540,64,206431
24519,0.002326,74.125.24.0-255,4320,112860,64,206431
24520,0.002329,172.31.40.0-255,66,112926,64,206431
24521,0.002344,74.125.24.0-255,5738,118664,64,206431
24522,0.002347,172.31.40.0-255,66,118730,64,206431
24523,0.002424,74.125.24.0-255,1484,120214,64,206431
24524,0.002449,74.125.24.0-255,4320,124534,64,206431
24525,0.002452,172.31.40.0-255,66,124600,64,206431
24526,0.002489,74.125.24.0-255,1484,126084,64,206431
24527,0.002504,74.125.24.0-255,1484,127568,64,206431
24528,0.002507,172.31.40.0-255,66,127634,64,206431
24529,0.002511,74.125.24.0-255,1484,129118,64,206431
24530,0.002523,74.125.24.0-255,766,129884,64,206431
24531,0.002526,172.31.40.0-255,66,129950,64,206431
24532,0.002648,74.125.24.0-255,1484,131434,64,206431
24533,0.002669,74.125.24.0-255,1484,132918,64,206431
24534,0.002674,172.31.40.0-255,66,132984,64,206431
24535,0.002681,74.125.24.0-255,4320,137304,64,206431
24536,0.002683,172.31.40.0-255,66,137370,64,206431
24537,0.002748,74.125.24.0-255,2902,140272,64,206431
24538,0.00275,172.31.40.0-255,66,140338,64,206431
24539,0.002756,74.125.24.0-255,4320,144658,64,206431
24540,0.002759,172.31.40.0-255,66,144724,64,206431
24541,0.002804,172.31.40.0-255,66,144790,64,206431
24542,0.002882,74.125.24.0-255,2902,147692,64,206431
24543,0.002885,172.31.40.0-255,66,147758,64,206431
24544,0.002902,74.125.24.0-255,1484,149242,64,206431
24545,0.002962,74.125.24.0-255,6438,155680,64,206431
24546,0.002965,172.31.40.0-255,66,155746,64,206431
24547,0.002989,74.125.24.0-255,1484,157230,64,206431
24548,0.003004,74.125.24.0-255,5738,162968,64,206431
24549,0.003007,172.31.40.0-255,66,163034,64,206431
24550,0.003073,74.125.24.0-255,2902,165936,64,206431
24551,0.003076,172.31.40.0-255,66,166002,64,206431
24552,0.0031,74.125.24.0-255,5738,171740,64,206431
24553,0.003103,172.31.40.0-255,66,171806,64,206431
24554,0.003167,74.125.24.0-255,1484,173290,64,206431
24555,0.003208,172.31.40.0-255,66,173356,64,206431
24556,0.003348,74.125.24.0-255,766,174122,64,206431
24557,0.003363,74.125.24.0-255,2902,177024,64,206431
24558,0.003366,172.31.40.0-255,66,177090,64,206431
24559,0.003387,74.125.24.0-255,4320,181410,64,206431
24560,0.003389,172.31.40.0-255,66,181476,64,206431
24561,0.003426,74.125.24.0-255,2902,184378,64,206431
24562,0.003429,172.31.40.0-255,66,184444,64,206431
24563,0.003463,172.31.40.0-255,66,184510,64,206431
24564,0.003488,172.31.40.0-255,66,184576,64,206431
24565,0.003728,172.31.40.0-255,66,184642,64,206431
24566,0.00377,172.31.40.0-255,66,184708,64,206431
24567,0.004113,74.125.24.0-255,5738,190446,64,206431
24568,0.004118,172.31.40.0-255,66,190512,64,206431
24569,0.00416,172.31.40.0-255,66,190578,64,206431
24570,0.004174,74.125.24.0-255,2184,192762,64,206431
24571,0.004176,172.31.40.0-255,66,192828,64,206431
24572,0.004429,74.125.24.0-255,4320,197148,64,206431
24573,0.004434,172.31.40.0-255,66,197214,64,206431
24574,0.004508,172.31.40.0-255,66,197280,64,206431
24575,0.004551,172.31.40.0-255,66,197346,64,206431
24576,0.00513,74.125.24.0-255,5524,202870,64,206431
24577,0.005136,172.31.40.0-255,66,202936,64,206431
24578,0.016159,172.31.40.0-255,105,203041,64,206431
24579,0.018481,74.125.24.0-255,66,203107,64,206431
24580,0.036267,172.31.40.0-255,167,203274,64,206431
24581,0.036315,172.31.40.0-255,1107,204381,64,206431
24582,0.03638,172.31.40.0-255,1514,205895,64,206431
24583,0.036382,172.31.40.0-255,338,206233,64,206431
24584,0.037838,104.244.42.0-255,66,206299,64,206431
24585,0.037877,104.244.42.0-255,66,206365,64,206431
24586,0.037925,104.244.42.0-255,66,206431,64,206431
24587,0.0,172.217.194.0-255,153,153,64,192594
24588,1.6e-05,172.31.40.0-255,66,219,64,192594
24589,2.2e-05,172.217.194.0-255,1484,1703,64,192594
24590,2.6e-05,172.31.40.0-255,66,1769,64,192594
24591,3.8e-05,172.217.194.0-255,2902,4671,64,192594
24592,4.2e-05,172.31.40.0-255,66,4737,64,192594
24593,8.6e-05,172.217.194.0-255,7156,11893,64,192594
24594,9e-05,172.31.40.0-255,66,11959,64,192594
24595,9.4e-05,172.217.194.0-255,2021,13980,64,192594
24596,9.7e-05,172.31.40.0-255,66,14046,64,192594
24597,0.000135,172.31.40.0-255,66,14112,64,192594
24598,0.000166,172.217.194.0-255,2902,17014,64,192594
24599,0.000168,172.31.40.0-255,66,17080,64,192594
24600,0.00018,172.31.40.0-255,66,17146,64,192594
24601,0.000199,172.31.40.0-255,66,17212,64,192594
24602,0.000205,172.217.194.0-255,4320,21532,64,192594
24603,0.000208,172.31.40.0-255,66,21598,64,192594
24604,0.000251,172.31.40.0-255,66,21664,64,192594
24605,0.000255,172.217.194.0-255,2543,24207,64,192594
24606,0.000258,172.31.40.0-255,66,24273,64,192594
24607,0.00026,172.217.194.0-255,676,24949,64,192594
24608,0.000262,172.31.40.0-255,66,25015,64,192594
24609,0.000593,172.217.194.0-255,1484,26499,64,192594
24610,0.000597,172.31.40.0-255,66,26565,64,192594
24611,0.000612,172.217.194.0-255,2902,29467,64,192594
24612,0.000619,172.31.40.0-255,66,29533,64,192594
24613,0.000626,172.217.194.0-255,5738,35271,64,192594
24614,0.000628,172.31.40.0-255,66,35337,64,192594
24615,0.000634,172.217.194.0-255,4320,39657,64,192594
24616,0.000637,172.31.40.0-255,66,39723,64,192594
24617,0.000682,172.31.40.0-255,66,39789,64,192594
24618,0.000685,172.217.194.0-255,1484,41273,64,192594
24619,0.000723,172.217.194.0-255,6438,47711,64,192594
24620,0.000726,172.31.40.0-255,66,47777,64,192594
24621,0.001347,172.217.194.0-255,1484,49261,64,192594
24622,0.001361,172.217.194.0-255,2902,52163,64,192594
24623,0.001364,172.31.40.0-255,66,52229,64,192594
24624,0.001371,172.217.194.0-255,5738,57967,64,192594
24625,0.001373,172.31.40.0-255,66,58033,64,192594
24626,0.001443,172.31.40.0-255,66,58099,64,192594
24627,0.001446,172.217.194.0-255,1484,59583,64,192594
24628,0.00147,172.217.194.0-255,7156,66739,64,192594
24629,0.001473,172.31.40.0-255,66,66805,64,192594
24630,0.001501,172.217.194.0-255,2184,68989,64,192594
24631,0.001503,172.31.40.0-255,66,69055,64,192594
24632,0.001788,172.217.194.0-255,1484,70539,64,192594
24633,0.001795,172.217.194.0-255,2902,73441,64,192594
24634,0.001798,172.31.40.0-255,66,73507,64,192594
24635,0.001805,172.217.194.0-255,5738,79245,64,192594
24636,0.001808,172.31.40.0-255,66,79311,64,192594
24637,0.001828,172.31.40.0-255,66,79377,64,192594
24638,0.001865,172.217.194.0-255,2902,82279,64,192594
24639,0.001867,172.31.40.0-255,66,82345,64,192594
24640,0.001911,172.31.40.0-255,66,82411,64,192594
24641,0.002326,172.217.194.0-255,1484,83895,64,192594
24642,0.00233,172.217.194.0-255,1484,85379,64,192594
24643,0.002333,172.31.40.0-255,66,85445,64,192594
24644,0.002362,172.217.194.0-255,1484,86929,64,192594
24645,0.002368,172.217.194.0-255,5738,92667,64,192594
24646,0.002371,172.31.40.0-255,66,92733,64,192594
24647,0.002379,172.217.194.0-255,7156,99889,64,192594
24648,0.002382,172.31.40.0-255,66,99955,64,192594
24649,0.002416,172.217.194.0-255,5738,105693,64,192594
24650,0.002419,172.31.40.0-255,66,105759,64,192594
24651,0.002425,172.217.194.0-255,5738,111497,64,192594
24652,0.002428,172.31.40.0-255,66,111563,64,192594
24653,0.002435,172.217.194.0-255,1484,113047,64,192594
24654,0.002441,172.217.194.0-255,3602,116649,64,192594
24655,0.002444,172.31.40.0-255,66,116715,64,192594
24656,0.002568,172.217.194.0-255,1484,118199,64,192594
24657,0.002584,172.217.194.0-255,2902,121101,64,192594
24658,0.002588,172.31.40.0-255,66,121167,64,192594
24659,0.002617,172.217.194.0-255,5738,126905,64,192594
24660,0.00262,172.31.40.0-255,66,126971,64,192594
24661,0.002623,172.217.194.0-255,1484,128455,64,192594
24662,0.002626,172.217.194.0-255,1484,129939,64,192594
24663,0.002628,172.31.40.0-255,66,130005,64,192594
24664,0.002652,172.217.194.0-255,2902,132907,64,192594
24665,0.002654,172.31.40.0-255,66,132973,64,192594
24666,0.0027,172.31.40.0-255,66,133039,64,192594
24667,0.002711,172.31.40.0-255,66,133105,64,192594
24668,0.002714,172.217.194.0-255,766,133871,64,192594
24669,0.002731,172.31.40.0-255,66,133937,64,192594
24670,0.002742,172.217.194.0-255,7156,141093,64,192594
24671,0.002746,172.31.40.0-255,66,141159,64,192594
24672,0.002774,172.217.194.0-255,2902,144061,64,192594
24673,0.002776,172.31.40.0-255,66,144127,64,192594
24674,0.002779,172.217.194.0-255,1484,145611,64,192594
24675,0.002816,172.31.40.0-255,66,145677,64,192594
24676,0.002951,172.217.194.0-255,1484,147161,64,192594
24677,0.002974,172.217.194.0-255,1484,148645,64,192594
24678,0.002978,172.31.40.0-255,66,148711,64,192594
24679,0.002992,172.217.194.0-255,1484,150195,64,192594
24680,0.003,172.217.194.0-255,1484,151679,64,192594
24681,0.003003,172.31.40.0-255,66,151745,64,192594
24682,0.003033,172.217.194.0-255,2902,154647,64,192594
24683,0.003036,172.31.40.0-255,66,154713,64,192594
24684,0.003043,172.217.194.0-255,4320,159033,64,192594
24685,0.003045,172.31.40.0-255,66,159099,64,192594
24686,0.003059,172.31.40.0-255,66,159165,64,192594
24687,0.003063,172.217.194.0-255,2902,162067,64,192594
24688,0.003065,172.31.40.0-255,66,162133,64,192594
24689,0.003068,172.217.194.0-255,1484,163617,64,192594
24690,0.003073,172.217.194.0-255,4320,167937,64,192594
24691,0.003076,172.31.40.0-255,66,168003,64,192594
24692,0.003079,172.217.194.0-255,2184,170187,64,192594
24693,0.003082,172.31.40.0-255,66,170253,64,192594
24694,0.003151,172.217.194.0-255,1484,171737,64,192594
24695,0.003156,172.217.194.0-255,2902,174639,64,192594
24696,0.003158,172.31.40.0-255,66,174705,64,192594
24697,0.003165,172.217.194.0-255,5738,180443,64,192594
24698,0.003168,172.31.40.0-255,66,180509,64,192594
24699,0.003222,172.31.40.0-255,66,180575,64,192594
24700,0.003294,172.31.40.0-255,66,180641,64,192594
24701,0.003307,172.217.194.0-255,7156,187797,64,192594
24702,0.003354,172.217.194.0-255,97,187894,64,192594
24703,0.003373,172.31.40.0-255,66,187960,64,192594
24704,0.003382,172.217.194.0-255,105,188065,64,192594
24705,0.006854,172.31.40.0-255,66,188131,64,192594
24706,0.006892,172.31.40.0-255,105,188236,64,192594
24707,0.009229,172.217.194.0-255,66,188302,64,192594
24708,0.041246,172.31.40.0-255,172,188474,64,192594
24709,0.041273,172.31.40.0-255,1112,189586,64,192594
24710,0.041326,172.31.40.0-255,1514,191100,64,192594
24711,0.041328,172.31.40.0-255,1296,192396,64,192594
24712,0.042794,104.244.42.0-255,66,192462,64,192594
24713,0.042843,104.244.42.0-255,66,192528,64,192594
24714,0.042889,104.244.42.0-255,66,192594,64,192594
24715,0.0,172.217.194.0-255,167,167,64,237833
24716,1.8e-05,172.31.40.0-255,66,233,64,237833
24717,2.5e-05,172.217.194.0-255,1484,1717,64,237833
24718,2.9e-05,172.31.40.0-255,66,1783,64,237833
24719,3.5e-05,172.217.194.0-255,2902,4685,64,237833
24720,3.8e-05,172.31.40.0-255,66,4751,64,237833
24721,4.6e-05,172.217.194.0-255,7156,11907,64,237833
24722,5e-05,172.31.40.0-255,66,11973,64,237833
24723,5.6e-05,172.217.194.0-255,4966,16939,64,237833
24724,5.9e-05,172.31.40.0-255,66,17005,64,237833
24725,0.00011,172.31.40.0-255,66,17071,64,237833
24726,0.000323,172.217.194.0-255,1484,18555,64,237833
24727,0.000328,172.31.40.0-255,66,18621,64,237833
24728,0.000335,172.217.194.0-255,2902,21523,64,237833
24729,0.000337,172.31.40.0-255,66,21589,64,237833
24730,0.00036,172.217.194.0-255,5738,27327,64,237833
24731,0.000364,172.31.40.0-255,66,27393,64,237833
24732,0.000398,172.217.194.0-255,7156,34549,64,237833
24733,0.000401,172.31.40.0-255,66,34615,64,237833
24734,0.000408,172.217.194.0-255,7156,41771,64,237833
24735,0.00041,172.31.40.0-255,66,41837,64,237833
24736,0.000428,172.217.194.0-255,7156,48993,64,237833
24737,0.000432,172.31.40.0-255,66,49059,64,237833
24738,0.000485,172.217.194.0-255,2456,51515,64,237833
24739,0.000489,172.31.40.0-255,66,51581,64,237833
24740,0.00053,172.217.194.0-255,436,52017,64,237833
24741,0.000533,172.31.40.0-255,66,52083,64,237833
24742,0.000761,172.217.194.0-255,1484,53567,64,237833
24743,0.000766,172.217.194.0-255,2902,56469,64,237833
24744,0.000806,172.31.40.0-255,66,56535,64,237833
24745,0.000809,172.31.40.0-255,66,56601,64,237833
24746,0.000816,172.217.194.0-255,5738,62339,64,237833
24747,0.000818,172.31.40.0-255,66,62405,64,237833
24748,0.000842,172.31.40.0-255,66,62471,64,237833
24749,0.000864,172.217.194.0-255,1484,63955,64,237833
24750,0.000877,172.31.40.0-255,66,64021,64,237833
24751,0.000894,172.217.194.0-255,2184,66205,64,237833
24752,0.000896,172.31.40.0-255,66,66271,64,237833
24753,0.00286,172.217.194.0-255,2902,69173,64,237833
24754,0.002868,172.31.40.0-255,66,69239,64,237833
24755,0.00289,172.217.194.0-255,2902,72141,64,237833
24756,0.002892,172.31.40.0-255,66,72207,64,237833
24757,0.004887,172.217.194.0-255,4320,76527,64,237833
24758,0.004892,172.31.40.0-255,66,76593,64,237833
24759,0.00491,172.217.194.0-255,1484,78077,64,237833
24760,0.006927,172.217.194.0-255,4320,82397,64,237833
24761,0.006933,172.31.40.0-255,66,82463,64,237833
24762,0.008939,172.217.194.0-255,5738,88201,64,237833
24763,0.008946,172.31.40.0-255,66,88267,64,237833
24764,0.010946,172.217.194.0-255,5738,94005,64,237833
24765,0.010955,172.31.40.0-255,66,94071,64,237833
24766,0.012978,172.217.194.0-255,5738,99809,64,237833
24767,0.012987,172.31.40.0-255,66,99875,64,237833
24768,0.014997,172.217.194.0-255,5738,105613,64,237833
24769,0.015005,172.31.40.0-255,66,105679,64,237833
24770,0.016991,172.217.194.0-255,5738,111417,64,237833
24771,0.017,172.31.40.0-255,66,111483,64,237833
24772,0.019018,172.217.194.0-255,5738,117221,64,237833
24773,0.01903,172.31.40.0-255,66,117287,64,237833
24774,0.021028,172.217.194.0-255,5738,123025,64,237833
24775,0.021036,172.31.40.0-255,66,123091,64,237833
24776,0.02302,172.217.194.0-255,5738,128829,64,237833
24777,0.023031,172.31.40.0-255,66,128895,64,237833
24778,0.025023,172.217.194.0-255,5738,134633,64,237833
24779,0.02503,172.31.40.0-255,66,134699,64,237833
24780,0.025712,172.31.40.0-255,172,134871,64,237833
24781,0.025743,172.31.40.0-255,1112,135983,64,237833
24782,0.025814,172.31.40.0-255,1514,137497,64,237833
24783,0.025817,172.31.40.0-255,1296,138793,64,237833
24784,0.027023,172.217.194.0-255,5738,144531,64,237833
24785,0.027031,172.31.40.0-255,66,144597,64,237833
24786,0.027289,104.244.42.0-255,66,144663,64,237833
24787,0.027297,104.244.42.0-255,66,144729,64,237833
24788,0.027362,104.244.42.0-255,66,144795,64,237833
24789,0.028406,104.244.42.0-255,108,144903,64,237833
24790,0.028414,172.31.40.0-255,66,144969,64,237833
24791,0.029063,172.217.194.0-255,5738,150707,64,237833
24792,0.02907,172.31.40.0-255,66,150773,64,237833
24793,0.031084,172.217.194.0-255,5738,156511,64,237833
24794,0.03109,172.31.40.0-255,66,156577,64,237833
24795,0.033074,172.217.194.0-255,5738,162315,64,237833
24796,0.03308,172.31.40.0-255,66,162381,64,237833
24797,0.035142,172.217.194.0-255,5738,168119,64,237833
24798,0.035148,172.31.40.0-255,66,168185,64,237833
24799,0.037145,172.217.194.0-255,5738,173923,64,237833
24800,0.037152,172.31.40.0-255,66,173989,64,237833
24801,0.039162,172.217.194.0-255,5738,179727,64,237833
24802,0.039169,172.31.40.0-255,66,179793,64,237833
24803,0.041189,172.217.194.0-255,5738,185531,64,237833
24804,0.041195,172.31.40.0-255,66,185597,64,237833
24805,0.043174,172.217.194.0-255,5738,191335,64,237833
24806,0.043184,172.31.40.0-255,66,191401,64,237833
24807,0.04516,172.217.194.0-255,5738,197139,64,237833
24808,0.045167,172.31.40.0-255,66,197205,64,237833
24809,0.04718,172.217.194.0-255,5738,202943,64,237833
24810,0.047186,172.31.40.0-255,66,203009,64,237833
24811,0.049203,172.217.194.0-255,5738,208747,64,237833
24812,0.04921,172.31.40.0-255,66,208813,64,237833
24813,0.051201,172.217.194.0-255,5738,214551,64,237833
24814,0.051208,172.31.40.0-255,66,214617,64,237833
24815,0.053209,172.217.194.0-255,5738,220355,64,237833
24816,0.053216,172.31.40.0-255,66,220421,64,237833
24817,0.055259,172.217.194.0-255,5738,226159,64,237833
24818,0.055282,172.31.40.0-255,66,226225,64,237833
24819,0.057344,172.217.194.0-255,5738,231963,64,237833
24820,0.057362,172.31.40.0-255,66,232029,64,237833
24821,0.059367,172.217.194.0-255,5738,237767,64,237833
24822,0.059382,172.31.40.0-255,66,237833,64,237833
24823,0.0,172.217.194.0-255,150,150,64,293813
24824,2e-05,172.31.40.0-255,66,216,64,293813
24825,2.7e-05,172.217.194.0-255,1484,1700,64,293813
24826,3.2e-05,172.31.40.0-255,66,1766,64,293813
24827,3.8e-05,172.217.194.0-255,2902,4668,64,293813
24828,4.2e-05,172.31.40.0-255,66,4734,64,293813
24829,5e-05,172.217.194.0-255,7156,11890,64,293813
24830,5.3e-05,172.31.40.0-255,66,11956,64,293813
24831,7.6e-05,172.217.194.0-255,1484,13440,64,293813
24832,7.9e-05,172.31.40.0-255,66,13506,64,293813
24833,0.000112,172.31.40.0-255,66,13572,64,293813
24834,0.000118,172.217.194.0-255,3961,17533,64,293813
24835,0.00012,172.31.40.0-255,66,17599,64,293813
24836,0.000263,172.217.194.0-255,1484,19083,64,293813
24837,0.000269,172.31.40.0-255,66,19149,64,293813
24838,0.000275,172.217.194.0-255,2902,22051,64,293813
24839,0.000277,172.31.40.0-255,66,22117,64,293813
24840,0.00028,172.217.194.0-255,1484,23601,64,293813
24841,0.000282,172.31.40.0-255,66,23667,64,293813
24842,0.000313,172.217.194.0-255,4320,27987,64,293813
24843,0.000316,172.31.40.0-255,66,28053,64,293813
24844,0.000324,172.217.194.0-255,7156,35209,64,293813
24845,0.000326,172.31.40.0-255,66,35275,64,293813
24846,0.000342,172.217.194.0-255,6797,42072,64,293813
24847,0.000344,172.31.40.0-255,66,42138,64,293813
24848,0.000363,172.217.194.0-255,2902,45040,64,293813
24849,0.000365,172.31.40.0-255,66,45106,64,293813
24850,0.000398,172.217.194.0-255,7085,52191,64,293813
24851,0.000401,172.31.40.0-255,66,52257,64,293813
24852,0.000404,172.217.194.0-255,100,52357,64,293813
24853,0.000406,172.31.40.0-255,66,52423,64,293813
24854,0.000476,172.217.194.0-255,1484,53907,64,293813
24855,0.000499,172.217.194.0-255,2902,56809,64,293813
24856,0.000504,172.217.194.0-255,5738,62547,64,293813
24857,0.000509,172.31.40.0-255,66,62613,64,293813
24858,0.000517,172.31.40.0-255,66,62679,64,293813
24859,0.000524,172.217.194.0-255,7156,69835,64,293813
24860,0.000527,172.31.40.0-255,66,69901,64,293813
24861,0.000544,172.217.194.0-255,5738,75639,64,293813
24862,0.000546,172.31.40.0-255,66,75705,64,293813
24863,0.000558,172.31.40.0-255,66,75771,64,293813
24864,0.00058,172.217.194.0-255,3320,79091,64,293813
24865,0.000582,172.31.40.0-255,66,79157,64,293813
24866,0.000597,172.31.40.0-255,66,79223,64,293813
24867,0.000757,172.217.194.0-255,1484,80707,64,293813
24868,0.000763,172.217.194.0-255,2902,83609,64,293813
24869,0.000766,172.31.40.0-255,66,83675,64,293813
24870,0.000772,172.217.194.0-255,4320,87995,64,293813
24871,0.000775,172.31.40.0-255,66,88061,64,293813
24872,0.000788,172.217.194.0-255,1484,89545,64,293813
24873,0.000794,172.217.194.0-255,5738,95283,64,293813
24874,0.000796,172.31.40.0-255,66,95349,64,293813
24875,0.000817,172.217.194.0-255,7156,102505,64,293813
24876,0.00082,172.31.40.0-255,66,102571,64,293813
24877,0.000823,172.217.194.0-255,1484,104055,64,293813
24878,0.000862,172.31.40.0-255,66,104121,64,293813
24879,0.001515,172.217.194.0-255,1484,105605,64,293813
24880,0.001522,172.217.194.0-255,2902,108507,64,293813
24881,0.001525,172.31.40.0-255,66,108573,64,293813
24882,0.001532,172.217.194.0-255,4320,112893,64,293813
24883,0.001534,172.31.40.0-255,66,112959,64,293813
24884,0.001546,172.217.194.0-255,1484,114443,64,293813
24885,0.001572,172.31.40.0-255,66,114509,64,293813
24886,0.001592,172.217.194.0-255,4320,118829,64,293813
24887,0.001595,172.31.40.0-255,66,118895,64,293813
24888,0.001623,172.217.194.0-255,6438,125333,64,293813
24889,0.001625,172.31.40.0-255,66,125399,64,293813
24890,0.001786,172.217.194.0-255,1484,126883,64,293813
24891,0.001792,172.217.194.0-255,2902,129785,64,293813
24892,0.001795,172.31.40.0-255,66,129851,64,293813
24893,0.001802,172.217.194.0-255,5738,135589,64,293813
24894,0.001804,172.31.40.0-255,66,135655,64,293813
24895,0.001825,172.217.194.0-255,5738,141393,64,293813
24896,0.001828,172.31.40.0-255,66,141459,64,293813
24897,0.001865,172.217.194.0-255,7156,148615,64,293813
24898,0.001868,172.31.40.0-255,66,148681,64,293813
24899,0.00188,172.31.40.0-255,66,148747,64,293813
24900,0.001883,172.217.194.0-255,766,149513,64,293813
24901,0.002053,172.217.194.0-255,1484,150997,64,293813
24902,0.002058,172.31.40.0-255,66,151063,64,293813
24903,0.002063,172.217.194.0-255,2902,153965,64,293813
24904,0.002065,172.31.40.0-255,66,154031,64,293813
24905,0.002068,172.217.194.0-255,1484,155515,64,293813
24906,0.002087,172.217.194.0-255,4320,159835,64,293813
24907,0.002089,172.31.40.0-255,66,159901,64,293813
24908,0.002101,172.31.40.0-255,66,159967,64,293813
24909,0.00213,172.217.194.0-255,2902,162869,64,293813
24910,0.002133,172.31.40.0-255,66,162935,64,293813
24911,0.002144,172.31.40.0-255,66,163001,64,293813
24912,0.002147,172.217.194.0-255,766,163767,64,293813
24913,0.002217,172.217.194.0-255,1484,165251,64,293813
24914,0.00222,172.31.40.0-255,66,165317,64,293813
24915,0.002225,172.217.194.0-255,2902,168219,64,293813
24916,0.002228,172.31.40.0-255,66,168285,64,293813
24917,0.002234,172.217.194.0-255,5738,174023,64,293813
24918,0.002236,172.31.40.0-255,66,174089,64,293813
24919,0.002271,172.31.40.0-255,66,174155,64,293813
24920,0.002284,172.31.40.0-255,66,174221,64,293813
24921,0.002316,172.217.194.0-255,1484,175705,64,293813
24922,0.002331,172.217.194.0-255,2902,178607,64,293813
24923,0.002334,172.31.40.0-255,66,178673,64,293813
24924,0.002341,172.217.194.0-255,5738,184411,64,293813
24925,0.002344,172.31.40.0-255,66,184477,64,293813
24926,0.002366,172.217.194.0-255,1484,185961,64,293813
24927,0.002403,172.31.40.0-255,66,186027,64,293813
24928,0.00241,172.217.194.0-255,7156,193183,64,293813
24929,0.002412,172.31.40.0-255,66,193249,64,293813
24930,0.004766,172.217.194.0-255,5738,198987,64,293813
24931,0.004783,172.31.40.0-255,66,199053,64,293813
24932,0.007155,172.217.194.0-255,5738,204791,64,293813
24933,0.007173,172.31.40.0-255,66,204857,64,293813
24934,0.009524,172.217.194.0-255,5738,210595,64,293813
24935,0.009531,172.31.40.0-255,66,210661,64,293813
24936,0.011869,172.217.194.0-255,5738,216399,64,293813
24937,0.011876,172.31.40.0-255,66,216465,64,293813
24938,0.014239,172.217.194.0-255,5738,222203,64,293813
24939,0.014257,172.31.40.0-255,66,222269,64,293813
24940,0.016626,172.217.194.0-255,5738,228007,64,293813
24941,0.01664,172.31.40.0-255,66,228073,64,293813
24942,0.018989,172.217.194.0-255,5738,233811,64,293813
24943,0.019007,172.31.40.0-255,66,233877,64,293813
24944,0.021355,172.217.194.0-255,5738,239615,64,293813
24945,0.021363,172.31.40.0-255,66,239681,64,293813
24946,0.023724,172.217.194.0-255,5738,245419,64,293813
24947,0.023733,172.31.40.0-255,66,245485,64,293813
24948,0.026075,172.217.194.0-255,5738,251223,64,293813
24949,0.026083,172.31.40.0-255,66,251289,64,293813
24950,0.028428,172.217.194.0-255,5738,257027,64,293813
24951,0.028436,172.31.40.0-255,66,257093,64,293813
24952,0.030757,172.217.194.0-255,5738,262831,64,293813
24953,0.030766,172.31.40.0-255,66,262897,64,293813
24954,0.033142,172.217.194.0-255,5738,268635,64,293813
24955,0.033151,172.31.40.0-255,66,268701,64,293813
24956,0.035472,172.217.194.0-255,5738,274439,64,293813
24957,0.03548,172.31.40.0-255,66,274505,64,293813
24958,0.037812,172.217.194.0-255,5738,280243,64,293813
24959,0.03782,172.31.40.0-255,66,280309,64,293813
24960,0.040156,172.217.194.0-255,5738,286047,64,293813
24961,0.040167,172.31.40.0-255,66,286113,64,293813
24962,0.042536,172.217.194.0-255,3169,289282,64,293813
24963,0.042544,172.31.40.0-255,66,289348,64,293813
24964,0.042731,172.31.40.0-255,105,289453,64,293813
24965,0.045074,172.217.194.0-255,66,289519,64,293813
24966,0.056048,172.31.40.0-255,172,289691,64,293813
24967,0.056077,172.31.40.0-255,1112,290803,64,293813
24968,0.056125,172.31.40.0-255,1514,292317,64,293813
24969,0.056127,172.31.40.0-255,1298,293615,64,293813
24970,0.057557,104.244.42.0-255,66,293681,64,293813
24971,0.057568,104.244.42.0-255,66,293747,64,293813
24972,0.057624,104.244.42.0-255,66,293813,64,293813
24973,0.0,172.217.194.0-255,152,152,64,291981
24974,3.6e-05,172.31.40.0-255,66,218,64,291981
24975,4.3e-05,172.217.194.0-255,1484,1702,64,291981
24976,4.7e-05,172.31.40.0-255,66,1768,64,291981
24977,5.3e-05,172.217.194.0-255,2902,4670,64,291981
24978,5.7e-05,172.31.40.0-255,66,4736,64,291981
24979,6.5e-05,172.217.194.0-255,7156,11892,64,291981
24980,6.7e-05,172.31.40.0-255,66,11958,64,291981
24981,0.000108,172.31.40.0-255,66,12024,64,291981
24982,0.000131,172.31.40.0-255,66,12090,64,291981
24983,0.000135,172.217.194.0-255,2543,14633,64,291981
24984,0.000137,172.31.40.0-255,66,14699,64,291981
24985,0.000152,172.31.40.0-255,66,14765,64,291981
24986,0.00018,172.217.194.0-255,5738,20503,64,291981
24987,0.000185,172.31.40.0-255,66,20569,64,291981
24988,0.000211,172.217.194.0-255,6797,27366,64,291981
24989,0.000214,172.31.40.0-255,66,27432,64,291981
24990,0.000235,172.217.194.0-255,4320,31752,64,291981
24991,0.000238,172.31.40.0-255,66,31818,64,291981
24992,0.000257,172.217.194.0-255,2543,34361,64,291981
24993,0.00026,172.31.40.0-255,66,34427,64,291981
24994,0.000334,172.217.194.0-255,380,34807,64,291981
24995,0.000338,172.31.40.0-255,66,34873,64,291981
24996,0.000491,172.217.194.0-255,1484,36357,64,291981
24997,0.000497,172.31.40.0-255,66,36423,64,291981
24998,0.000502,172.217.194.0-255,2902,39325,64,291981
24999,0.000507,172.31.40.0-255,66,39391,64,291981
25000,0.000522,172.217.194.0-255,5738,45129,64,291981
25001,0.000526,172.31.40.0-255,66,45195,64,291981
25002,0.000548,172.217.194.0-255,7156,52351,64,291981
25003,0.000552,172.31.40.0-255,66,52417,64,291981
25004,0.000555,172.217.194.0-255,1484,53901,64,291981
25005,0.000585,172.217.194.0-255,7156,61057,64,291981
25006,0.000589,172.31.40.0-255,66,61123,64,291981
25007,0.000616,172.31.40.0-255,66,61189,64,291981
25008,0.001028,172.217.194.0-255,1484,62673,64,291981
25009,0.001037,172.217.194.0-255,2902,65575,64,291981
25010,0.001042,172.31.40.0-255,66,65641,64,291981
25011,0.001049,172.217.194.0-255,5738,71379,64,291981
25012,0.001053,172.31.40.0-255,66,71445,64,291981
25013,0.001066,172.217.194.0-255,1484,72929,64,291981
25014,0.001084,172.217.194.0-255,5738,78667,64,291981
25015,0.001087,172.31.40.0-255,66,78733,64,291981
25016,0.001114,172.217.194.0-255,5738,84471,64,291981
25017,0.001117,172.31.40.0-255,66,84537,64,291981
25018,0.001675,172.217.194.0-255,1484,86021,64,291981
25019,0.001683,172.217.194.0-255,2902,88923,64,291981
25020,0.001706,172.217.194.0-255,5738,94661,64,291981
25021,0.001711,172.217.194.0-255,1484,96145,64,291981
25022,0.001725,172.217.194.0-255,7156,103301,64,291981
25023,0.001739,172.217.194.0-255,4320,107621,64,291981
25024,0.001746,172.217.194.0-255,7156,114777,64,291981
25025,0.001759,172.217.194.0-255,3602,118379,64,291981
25026,0.001826,172.217.194.0-255,1484,119863,64,291981
25027,0.001831,172.217.194.0-255,2902,122765,64,291981
25028,0.001858,172.217.194.0-255,5738,128503,64,291981
25029,0.001902,172.217.194.0-255,2902,131405,64,291981
25030,0.001968,172.217.194.0-255,1484,132889,64,291981
25031,0.001972,172.217.194.0-255,2902,135791,64,291981
25032,0.001986,172.217.194.0-255,1484,137275,64,291981
25033,0.002004,172.217.194.0-255,4320,141595,64,291981
25034,0.002007,172.217.194.0-255,1484,143079,64,291981
25035,0.002067,172.217.194.0-255,2184,145263,64,291981
25036,0.004459,172.31.40.0-255,66,145329,64,291981
25037,0.006778,172.217.194.0-255,5738,151067,64,291981
25038,0.006788,172.31.40.0-255,66,151133,64,291981
25039,0.009035,172.217.194.0-255,5738,156871,64,291981
25040,0.009045,172.31.40.0-255,66,156937,64,291981
25041,0.011281,172.217.194.0-255,5738,162675,64,291981
25042,0.01129,172.31.40.0-255,66,162741,64,291981
25043,0.013553,172.217.194.0-255,5738,168479,64,291981
25044,0.013566,172.31.40.0-255,66,168545,64,291981
25045,0.015876,172.217.194.0-255,5738,174283,64,291981
25046,0.015887,172.31.40.0-255,66,174349,64,291981
25047,0.01818,172.217.194.0-255,5738,180087,64,291981
25048,0.018198,172.31.40.0-255,66,180153,64,291981
25049,0.02048,172.217.194.0-255,5738,185891,64,291981
25050,0.020496,172.31.40.0-255,66,185957,64,291981
25051,0.022791,172.217.194.0-255,5738,191695,64,291981
25052,0.022808,172.31.40.0-255,66,191761,64,291981
25053,0.025117,172.217.194.0-255,5738,197499,64,291981
25054,0.025132,172.31.40.0-255,66,197565,64,291981
25055,0.02745,172.217.194.0-255,5738,203303,64,291981
25056,0.02746,172.31.40.0-255,66,203369,64,291981
25057,0.029772,172.217.194.0-255,5738,209107,64,291981
25058,0.029785,172.31.40.0-255,66,209173,64,291981
25059,0.032069,172.217.194.0-255,5738,214911,64,291981
25060,0.032088,172.31.40.0-255,66,214977,64,291981
25061,0.034359,172.217.194.0-255,5738,220715,64,291981
25062,0.034367,172.31.40.0-255,66,220781,64,291981
25063,0.036629,172.217.194.0-255,5738,226519,64,291981
25064,0.036638,172.31.40.0-255,66,226585,64,291981
25065,0.038884,172.217.194.0-255,5738,232323,64,291981
25066,0.038902,172.31.40.0-255,66,232389,64,291981
25067,0.041145,172.217.194.0-255,5738,238127,64,291981
25068,0.041158,172.31.40.0-255,66,238193,64,291981
25069,0.043445,172.217.194.0-255,5738,243931,64,291981
25070,0.043462,172.31.40.0-255,66,243997,64,291981
25071,0.045744,172.217.194.0-255,5738,249735,64,291981
25072,0.045758,172.31.40.0-255,66,249801,64,291981
25073,0.048035,172.217.194.0-255,5738,255539,64,291981
25074,0.048053,172.31.40.0-255,66,255605,64,291981
25075,0.050337,172.217.194.0-255,5738,261343,64,291981
25076,0.050346,172.31.40.0-255,66,261409,64,291981
25077,0.052627,172.217.194.0-255,5738,267147,64,291981
25078,0.052636,172.31.40.0-255,66,267213,64,291981
25079,0.053666,172.31.40.0-255,187,267400,64,291981
25080,0.053702,172.31.40.0-255,979,268379,64,291981
25081,0.053774,172.31.40.0-255,1514,269893,64,291981
25082,0.053776,172.31.40.0-255,1514,271407,64,291981
25083,0.053778,172.31.40.0-255,1514,272921,64,291981
25084,0.053779,172.31.40.0-255,1210,274131,64,291981
25085,0.054934,172.217.194.0-255,5738,279869,64,291981
25086,0.054942,172.31.40.0-255,66,279935,64,291981
25087,0.055199,104.244.42.0-255,66,280001,64,291981
25088,0.055258,104.244.42.0-255,66,280067,64,291981
25089,0.055327,104.244.42.0-255,66,280133,64,291981
25090,0.055346,104.244.42.0-255,66,280199,64,291981
25091,0.056658,104.244.42.0-255,108,280307,64,291981
25092,0.056673,172.31.40.0-255,66,280373,64,291981
25093,0.057206,172.217.194.0-255,5738,286111,64,291981
25094,0.057211,172.31.40.0-255,66,286177,64,291981
25095,0.059471,172.217.194.0-255,5738,291915,64,291981
25096,0.059479,172.31.40.0-255,66,291981,64,291981
25097,0.0,74.125.24.0-255,153,153,64,275967
25098,2e-05,172.31.40.0-255,66,219,64,275967
25099,2.7e-05,74.125.24.0-255,1484,1703,64,275967
25100,3.1e-05,172.31.40.0-255,66,1769,64,275967
25101,3.8e-05,74.125.24.0-255,2902,4671,64,275967
25102,4.1e-05,172.31.40.0-255,66,4737,64,275967
25103,4.6e-05,74.125.24.0-255,2902,7639,64,275967
25104,5.7e-05,172.31.40.0-255,66,7705,64,275967
25105,6.3e-05,74.125.24.0-255,4320,12025,64,275967
25106,6.6e-05,172.31.40.0-255,66,12091,64,275967
25107,7.1e-05,74.125.24.0-255,4320,16411,64,275967
25108,7.4e-05,172.31.40.0-255,66,16477,64,275967
25109,0.000104,74.125.24.0-255,4872,21349,64,275967
25110,0.000112,172.31.40.0-255,66,21415,64,275967
25111,0.000123,172.31.40.0-255,66,21481,64,275967
25112,0.000126,74.125.24.0-255,1125,22606,64,275967
25113,0.000127,172.31.40.0-255,66,22672,64,275967
25114,0.000211,74.125.24.0-255,1484,24156,64,275967
25115,0.000214,172.31.40.0-255,66,24222,64,275967
25116,0.000219,74.125.24.0-255,2902,27124,64,275967
25117,0.000222,172.31.40.0-255,66,27190,64,275967
25118,0.000228,74.125.24.0-255,5738,32928,64,275967
25119,0.00023,172.31.40.0-255,66,32994,64,275967
25120,0.000244,74.125.24.0-255,6797,39791,64,275967
25121,0.000246,172.31.40.0-255,66,39857,64,275967
25122,0.000286,172.31.40.0-255,66,39923,64,275967
25123,0.00029,74.125.24.0-255,2817,42740,64,275967
25124,0.000292,172.31.40.0-255,66,42806,64,275967
25125,0.000414,74.125.24.0-255,380,43186,64,275967
25126,0.000418,172.31.40.0-255,66,43252,64,275967
25127,0.000509,74.125.24.0-255,1484,44736,64,275967
25128,0.000516,74.125.24.0-255,2902,47638,64,275967
25129,0.000519,172.31.40.0-255,66,47704,64,275967
25130,0.000542,74.125.24.0-255,5738,53442,64,275967
25131,0.000546,172.31.40.0-255,66,53508,64,275967
25132,0.000551,74.125.24.0-255,4320,57828,64,275967
25133,0.000554,172.31.40.0-255,66,57894,64,275967
25134,0.000605,74.125.24.0-255,1995,59889,64,275967
25135,0.000609,172.31.40.0-255,66,59955,64,275967
25136,0.000725,74.125.24.0-255,1484,61439,64,275967
25137,0.000731,74.125.24.0-255,2902,64341,64,275967
25138,0.000735,172.31.40.0-255,66,64407,64,275967
25139,0.000769,74.125.24.0-255,5738,70145,64,275967
25140,0.000772,172.31.40.0-255,66,70211,64,275967
25141,0.000788,172.31.40.0-255,66,70277,64,275967
25142,0.00085,172.31.40.0-255,66,70343,64,275967
25143,0.000878,74.125.24.0-255,1484,71827,64,275967
25144,0.000882,74.125.24.0-255,1484,73311,64,275967
25145,0.000884,172.31.40.0-255,66,73377,64,275967
25146,0.000913,74.125.24.0-255,1484,74861,64,275967
25147,0.00092,74.125.24.0-255,5738,80599,64,275967
25148,0.000923,172.31.40.0-255,66,80665,64,275967
25149,0.000942,74.125.24.0-255,5738,86403,64,275967
25150,0.000947,172.31.40.0-255,66,86469,64,275967
25151,0.000969,74.125.24.0-255,7156,93625,64,275967
25152,0.000972,172.31.40.0-255,66,93691,64,275967
25153,0.000983,172.31.40.0-255,66,93757,64,275967
25154,0.001006,74.125.24.0-255,1484,95241,64,275967
25155,0.001048,172.31.40.0-255,66,95307,64,275967
25156,0.001053,74.125.24.0-255,3961,99268,64,275967
25157,0.001056,172.31.40.0-255,66,99334,64,275967
25158,0.001255,74.125.24.0-255,1484,100818,64,275967
25159,0.001271,74.125.24.0-255,1484,102302,64,275967
25160,0.001274,172.31.40.0-255,66,102368,64,275967
25161,0.001303,74.125.24.0-255,1484,103852,64,275967
25162,0.001311,74.125.24.0-255,5738,109590,64,275967
25163,0.001314,172.31.40.0-255,66,109656,64,275967
25164,0.00132,74.125.24.0-255,7156,116812,64,275967
25165,0.001322,172.31.40.0-255,66,116878,64,275967
25166,0.001367,172.31.40.0-255,66,116944,64,275967
25167,0.001395,74.125.24.0-255,2184,119128,64,275967
25168,0.001398,172.31.40.0-255,66,119194,64,275967
25169,0.00158,74.125.24.0-255,1484,120678,64,275967
25170,0.001629,74.125.24.0-255,2902,123580,64,275967
25171,0.001632,172.31.40.0-255,66,123646,64,275967
25172,0.001639,74.125.24.0-255,5738,129384,64,275967
25173,0.001642,172.31.40.0-255,66,129450,64,275967
25174,0.001644,74.125.24.0-255,1484,130934,64,275967
25175,0.001666,74.125.24.0-255,7156,138090,64,275967
25176,0.001668,172.31.40.0-255,66,138156,64,275967
25177,0.001702,74.125.24.0-255,5738,143894,64,275967
25178,0.001705,172.31.40.0-255,66,143960,64,275967
25179,0.001711,74.125.24.0-255,5738,149698,64,275967
25180,0.001714,172.31.40.0-255,66,149764,64,275967
25181,0.001719,74.125.24.0-255,3602,153366,64,275967
25182,0.001722,172.31.40.0-255,66,153432,64,275967
25183,0.001764,74.125.24.0-255,4320,157752,64,275967
25184,0.001767,172.31.40.0-255,66,157818,64,275967
25185,0.00178,172.31.40.0-255,66,157884,64,275967
25186,0.001795,172.31.40.0-255,66,157950,64,275967
25187,0.00183,74.125.24.0-255,7156,165106,64,275967
25188,0.001833,172.31.40.0-255,66,165172,64,275967
25189,0.001861,74.125.24.0-255,3602,168774,64,275967
25190,0.001864,172.31.40.0-255,66,168840,64,275967
25191,0.001903,74.125.24.0-255,1484,170324,64,275967
25192,0.001915,74.125.24.0-255,1484,171808,64,275967
25193,0.001918,172.31.40.0-255,66,171874,64,275967
25194,0.001943,74.125.24.0-255,1484,173358,64,275967
25195,0.001951,74.125.24.0-255,5738,179096,64,275967
25196,0.001954,172.31.40.0-255,66,179162,64,275967
25197,0.001961,74.125.24.0-255,7156,186318,64,275967
25198,0.001964,172.31.40.0-255,66,186384,64,275967
25199,0.001984,74.125.24.0-255,5738,192122,64,275967
25200,0.001991,172.31.40.0-255,66,192188,64,275967
25201,0.002027,74.125.24.0-255,4320,196508,64,275967
25202,0.002029,172.31.40.0-255,66,196574,64,275967
25203,0.002058,74.125.24.0-255,6438,203012,64,275967
25204,0.002061,172.31.40.0-255,66,203078,64,275967
25205,0.002064,74.125.24.0-255,1484,204562,64,275967
25206,0.002069,74.125.24.0-255,2902,207464,64,275967
25207,0.002071,172.31.40.0-255,66,207530,64,275967
25208,0.002122,74.125.24.0-255,4320,211850,64,275967
25209,0.002126,172.31.40.0-255,66,211916,64,275967
25210,0.00215,74.125.24.0-255,1484,213400,64,275967
25211,0.002157,74.125.24.0-255,7156,220556,64,275967
25212,0.002163,172.31.40.0-255,66,220622,64,275967
25213,0.0022,172.31.40.0-255,66,220688,64,275967
25214,0.002204,74.125.24.0-255,2184,222872,64,275967
25215,0.002206,172.31.40.0-255,66,222938,64,275967
25216,0.002255,74.125.24.0-255,1484,224422,64,275967
25217,0.002269,74.125.24.0-255,2902,227324,64,275967
25218,0.002272,172.31.40.0-255,66,227390,64,275967
25219,0.002306,74.125.24.0-255,5738,233128,64,275967
25220,0.002309,172.31.40.0-255,66,233194,64,275967
25221,0.002324,172.31.40.0-255,66,233260,64,275967
25222,0.002363,74.125.24.0-255,5738,238998,64,275967
25223,0.002368,172.31.40.0-255,66,239064,64,275967
25224,0.002378,74.125.24.0-255,2902,241966,64,275967
25225,0.00238,172.31.40.0-255,66,242032,64,275967
25226,0.002403,74.125.24.0-255,5020,247052,64,275967
25227,0.002405,172.31.40.0-255,66,247118,64,275967
25228,0.00242,172.31.40.0-255,66,247184,64,275967
25229,0.002426,74.125.24.0-255,4320,251504,64,275967
25230,0.002431,172.31.40.0-255,66,251570,64,275967
25231,0.002459,74.125.24.0-255,7156,258726,64,275967
25232,0.002462,172.31.40.0-255,66,258792,64,275967
25233,0.004817,74.125.24.0-255,5738,264530,64,275967
25234,0.004825,172.31.40.0-255,66,264596,64,275967
25235,0.0072,74.125.24.0-255,5738,270334,64,275967
25236,0.007203,172.31.40.0-255,66,270400,64,275967
25237,0.009552,74.125.24.0-255,1038,271438,64,275967
25238,0.009717,172.31.40.0-255,66,271504,64,275967
25239,0.009747,172.31.40.0-255,105,271609,64,275967
25240,0.012074,74.125.24.0-255,66,271675,64,275967
25241,0.030694,172.31.40.0-255,172,271847,64,275967
25242,0.030726,172.31.40.0-255,1111,272958,64,275967
25243,0.030787,172.31.40.0-255,1514,274472,64,275967
25244,0.030809,172.31.40.0-255,1297,275769,64,275967
25245,0.032231,104.244.42.0-255,66,275835,64,275967
25246,0.032292,104.244.42.0-255,66,275901,64,275967
25247,0.032347,104.244.42.0-255,66,275967,64,275967
25248,0.0,74.125.24.0-255,153,153,64,292561
25249,2e-05,172.31.40.0-255,66,219,64,292561
25250,2.7e-05,74.125.24.0-255,1484,1703,64,292561
25251,3.1e-05,172.31.40.0-255,66,1769,64,292561
25252,3.7e-05,74.125.24.0-255,2902,4671,64,292561
25253,4.7e-05,172.31.40.0-255,66,4737,64,292561
25254,5.3e-05,74.125.24.0-255,4320,9057,64,292561
25255,5.5e-05,172.31.40.0-255,66,9123,64,292561
25256,7.3e-05,74.125.24.0-255,1484,10607,64,292561
25257,7.6e-05,172.31.40.0-255,66,10673,64,292561
25258,0.000106,74.125.24.0-255,3411,14084,64,292561
25259,0.000109,172.31.40.0-255,66,14150,64,292561
25260,0.000129,74.125.24.0-255,1484,15634,64,292561
25261,0.000131,172.31.40.0-255,66,15700,64,292561
25262,0.000135,74.125.24.0-255,2902,18602,64,292561
25263,0.000137,172.31.40.0-255,66,18668,64,292561
25264,0.00014,74.125.24.0-255,1484,20152,64,292561
25265,0.000142,172.31.40.0-255,66,20218,64,292561
25266,0.000174,74.125.24.0-255,4320,24538,64,292561
25267,0.000177,172.31.40.0-255,66,24604,64,292561
25268,0.000182,74.125.24.0-255,4320,28924,64,292561
25269,0.000184,172.31.40.0-255,66,28990,64,292561
25270,0.000214,74.125.24.0-255,2543,31533,64,292561
25271,0.000221,74.125.24.0-255,7156,38689,64,292561
25272,0.00025,172.31.40.0-255,66,38755,64,292561
25273,0.000252,172.31.40.0-255,66,38821,64,292561
25274,0.000284,172.31.40.0-255,66,38887,64,292561
25275,0.000594,74.125.24.0-255,1484,40371,64,292561
25276,0.000599,172.31.40.0-255,66,40437,64,292561
25277,0.000605,74.125.24.0-255,2902,43339,64,292561
25278,0.000607,172.31.40.0-255,66,43405,64,292561
25279,0.000612,74.125.24.0-255,4320,47725,64,292561
25280,0.000614,172.31.40.0-255,66,47791,64,292561
25281,0.000635,74.125.24.0-255,1484,49275,64,292561
25282,0.000663,172.31.40.0-255,66,49341,64,292561
25283,0.00069,74.125.24.0-255,1125,50466,64,292561
25284,0.000704,172.31.40.0-255,66,50532,64,292561
25285,0.000711,74.125.24.0-255,7156,57688,64,292561
25286,0.000712,172.31.40.0-255,66,57754,64,292561
25287,0.000749,172.31.40.0-255,66,57820,64,292561
25288,0.000752,74.125.24.0-255,645,58465,64,292561
25289,0.001091,74.125.24.0-255,1484,59949,64,292561
25290,0.001095,172.31.40.0-255,66,60015,64,292561
25291,0.001101,74.125.24.0-255,2902,62917,64,292561
25292,0.001103,172.31.40.0-255,66,62983,64,292561
25293,0.001106,74.125.24.0-255,1484,64467,64,292561
25294,0.001135,74.125.24.0-255,4320,68787,64,292561
25295,0.001138,172.31.40.0-255,66,68853,64,292561
25296,0.001145,74.125.24.0-255,7156,76009,64,292561
25297,0.001148,172.31.40.0-255,66,76075,64,292561
25298,0.001153,74.125.24.0-255,2902,78977,64,292561
25299,0.001154,172.31.40.0-255,66,79043,64,292561
25300,0.001202,172.31.40.0-255,66,79109,64,292561
25301,0.001207,74.125.24.0-255,2184,81293,64,292561
25302,0.001209,172.31.40.0-255,66,81359,64,292561
25303,0.001239,74.125.24.0-255,5738,87097,64,292561
25304,0.001242,172.31.40.0-255,66,87163,64,292561
25305,0.001248,74.125.24.0-255,5738,92901,64,292561
25306,0.001251,172.31.40.0-255,66,92967,64,292561
25307,0.001282,74.125.24.0-255,1484,94451,64,292561
25308,0.001295,172.31.40.0-255,66,94517,64,292561
25309,0.001328,74.125.24.0-255,5738,100255,64,292561
25310,0.001332,172.31.40.0-255,66,100321,64,292561
25311,0.001339,74.125.24.0-255,6438,106759,64,292561
25312,0.001341,172.31.40.0-255,66,106825,64,292561
25313,0.001796,74.125.24.0-255,1484,108309,64,292561
25314,0.001803,74.125.24.0-255,2902,111211,64,292561
25315,0.001807,172.31.40.0-255,66,111277,64,292561
25316,0.001813,74.125.24.0-255,2902,114179,64,292561
25317,0.001814,172.31.40.0-255,66,114245,64,292561
25318,0.001837,74.125.24.0-255,2902,117147,64,292561
25319,0.00184,172.31.40.0-255,66,117213,64,292561
25320,0.001847,74.125.24.0-255,7156,124369,64,292561
25321,0.001849,172.31.40.0-255,66,124435,64,292561
25322,0.00189,74.125.24.0-255,2184,126619,64,292561
25323,0.001895,172.31.40.0-255,66,126685,64,292561
25324,0.001898,172.31.40.0-255,66,126751,64,292561
25325,0.001967,74.125.24.0-255,1484,128235,64,292561
25326,0.001972,74.125.24.0-255,2902,131137,64,292561
25327,0.001975,172.31.40.0-255,66,131203,64,292561
25328,0.001983,74.125.24.0-255,5738,136941,64,292561
25329,0.001985,172.31.40.0-255,66,137007,64,292561
25330,0.002007,74.125.24.0-255,4320,141327,64,292561
25331,0.002009,172.31.40.0-255,66,141393,64,292561
25332,0.002041,172.31.40.0-255,66,141459,64,292561
25333,0.002054,172.31.40.0-255,66,141525,64,292561
25334,0.002131,74.125.24.0-255,1484,143009,64,292561
25335,0.002136,74.125.24.0-255,2902,145911,64,292561
25336,0.00214,172.31.40.0-255,66,145977,64,292561
25337,0.002143,74.125.24.0-255,1484,147461,64,292561
25338,0.002166,74.125.24.0-255,4320,151781,64,292561
25339,0.002169,172.31.40.0-255,66,151847,64,292561
25340,0.002172,74.125.24.0-255,1484,153331,64,292561
25341,0.002177,74.125.24.0-255,2902,156233,64,292561
25342,0.002179,172.31.40.0-255,66,156299,64,292561
25343,0.002224,74.125.24.0-255,5738,162037,64,292561
25344,0.002237,74.125.24.0-255,766,162803,64,292561
25345,0.002245,172.31.40.0-255,66,162869,64,292561
25346,0.002333,74.125.24.0-255,1484,164353,64,292561
25347,0.002337,74.125.24.0-255,1484,165837,64,292561
25348,0.002347,74.125.24.0-255,1484,167321,64,292561
25349,0.002352,74.125.24.0-255,4320,171641,64,292561
25350,0.002367,74.125.24.0-255,1484,173125,64,292561
25351,0.002371,74.125.24.0-255,2902,176027,64,292561
25352,0.002404,74.125.24.0-255,4320,180347,64,292561
25353,0.002432,74.125.24.0-255,6438,186785,64,292561
25354,0.002496,74.125.24.0-255,1484,188269,64,292561
25355,0.002517,74.125.24.0-255,2902,191171,64,292561
25356,0.002522,74.125.24.0-255,2902,194073,64,292561
25357,0.002541,74.125.24.0-255,2902,196975,64,292561
25358,0.002556,74.125.24.0-255,5738,202713,64,292561
25359,0.002572,74.125.24.0-255,7156,209869,64,292561
25360,0.005808,172.31.40.0-255,66,209935,64,292561
25361,0.005814,172.31.40.0-255,66,210001,64,292561
25362,0.005817,172.31.40.0-255,66,210067,64,292561
25363,0.005819,172.31.40.0-255,66,210133,64,292561
25364,0.005822,172.31.40.0-255,66,210199,64,292561
25365,0.005824,172.31.40.0-255,66,210265,64,292561
25366,0.005833,172.31.40.0-255,66,210331,64,292561
25367,0.005836,172.31.40.0-255,66,210397,64,292561
25368,0.005839,172.31.40.0-255,66,210463,64,292561
25369,0.005841,172.31.40.0-255,66,210529,64,292561
25370,0.005844,172.31.40.0-255,66,210595,64,292561
25371,0.005846,172.31.40.0-255,66,210661,64,292561
25372,0.005849,172.31.40.0-255,66,210727,64,292561
25373,0.005851,172.31.40.0-255,66,210793,64,292561
25374,0.008442,74.125.24.0-255,5738,216531,64,292561
25375,0.008449,172.31.40.0-255,66,216597,64,292561
25376,0.011047,74.125.24.0-255,5738,222335,64,292561
25377,0.011055,172.31.40.0-255,66,222401,64,292561
25378,0.01367,74.125.24.0-255,5738,228139,64,292561
25379,0.013678,172.31.40.0-255,66,228205,64,292561
25380,0.016266,74.125.24.0-255,5738,233943,64,292561
25381,0.016272,172.31.40.0-255,66,234009,64,292561
25382,0.018861,74.125.24.0-255,5738,239747,64,292561
25383,0.018872,172.31.40.0-255,66,239813,64,292561
25384,0.021472,74.125.24.0-255,5738,245551,64,292561
25385,0.021485,172.31.40.0-255,66,245617,64,292561
25386,0.024061,74.125.24.0-255,5738,251355,64,292561
25387,0.024071,172.31.40.0-255,66,251421,64,292561
25388,0.026661,74.125.24.0-255,5738,257159,64,292561
25389,0.026671,172.31.40.0-255,66,257225,64,292561
25390,0.028211,172.31.40.0-255,171,257396,64,292561
25391,0.028245,172.31.40.0-255,1136,258532,64,292561
25392,0.0283,172.31.40.0-255,1514,260046,64,292561
25393,0.028302,172.31.40.0-255,1273,261319,64,292561
25394,0.029223,74.125.24.0-255,5738,267057,64,292561
25395,0.029231,172.31.40.0-255,66,267123,64,292561
25396,0.029793,104.244.42.0-255,66,267189,64,292561
25397,0.029802,104.244.42.0-255,66,267255,64,292561
25398,0.029905,104.244.42.0-255,66,267321,64,292561
25399,0.031815,74.125.24.0-255,5738,273059,64,292561
25400,0.031822,172.31.40.0-255,66,273125,64,292561
25401,0.034383,74.125.24.0-255,5738,278863,64,292561
25402,0.034391,172.31.40.0-255,66,278929,64,292561
25403,0.036987,74.125.24.0-255,5738,284667,64,292561
25404,0.036993,172.31.40.0-255,66,284733,64,292561
25405,0.039561,74.125.24.0-255,5738,290471,64,292561
25406,0.039569,172.31.40.0-255,66,290537,64,292561
25407,0.042126,74.125.24.0-255,1787,292324,64,292561
25408,0.042131,172.31.40.0-255,66,292390,64,292561
25409,0.042286,172.31.40.0-255,105,292495,64,292561
25410,0.044838,74.125.24.0-255,66,292561,64,292561
25411,0.0,74.125.200.0-255,146,146,64,246443
25412,2.1e-05,172.31.40.0-255,66,212,64,246443
25413,2.8e-05,74.125.200.0-255,1484,1696,64,246443
25414,3.3e-05,172.31.40.0-255,66,1762,64,246443
25415,5.6e-05,74.125.200.0-255,2902,4664,64,246443
25416,6e-05,172.31.40.0-255,66,4730,64,246443
25417,6.3e-05,74.125.200.0-255,1484,6214,64,246443
25418,6.6e-05,172.31.40.0-255,66,6280,64,246443
25419,7e-05,74.125.200.0-255,2902,9182,64,246443
25420,7.3e-05,172.31.40.0-255,66,9248,64,246443
25421,0.000117,74.125.200.0-255,6372,15620,64,246443
25422,0.000121,172.31.40.0-255,66,15686,64,246443
25423,0.000143,74.125.200.0-255,7156,22842,64,246443
25424,0.000146,172.31.40.0-255,66,22908,64,246443
25425,0.000174,74.125.200.0-255,5738,28646,64,246443
25426,0.000177,172.31.40.0-255,66,28712,64,246443
25427,0.000211,74.125.200.0-255,2543,31255,64,246443
25428,0.000214,172.31.40.0-255,66,31321,64,246443
25429,0.000319,74.125.200.0-255,1484,32805,64,246443
25430,0.000324,172.31.40.0-255,66,32871,64,246443
25431,0.00033,74.125.200.0-255,2902,35773,64,246443
25432,0.000333,172.31.40.0-255,66,35839,64,246443
25433,0.000348,74.125.200.0-255,1484,37323,64,246443
25434,0.000351,172.31.40.0-255,66,37389,64,246443
25435,0.000374,74.125.200.0-255,4320,41709,64,246443
25436,0.000378,172.31.40.0-255,66,41775,64,246443
25437,0.00038,74.125.200.0-255,1484,43259,64,246443
25438,0.000382,172.31.40.0-255,66,43325,64,246443
25439,0.000386,74.125.200.0-255,2902,46227,64,246443
25440,0.000388,172.31.40.0-255,66,46293,64,246443
25441,0.000426,74.125.200.0-255,2543,48836,64,246443
25442,0.00043,172.31.40.0-255,66,48902,64,246443
25443,0.001042,74.125.200.0-255,1484,50386,64,246443
25444,0.001049,172.31.40.0-255,66,50452,64,246443
25445,0.001057,74.125.200.0-255,2902,53354,64,246443
25446,0.00106,172.31.40.0-255,66,53420,64,246443
25447,0.001063,74.125.200.0-255,1484,54904,64,246443
25448,0.001065,172.31.40.0-255,66,54970,64,246443
25449,0.001092,74.125.200.0-255,4320,59290,64,246443
25450,0.001095,172.31.40.0-255,66,59356,64,246443
25451,0.001104,74.125.200.0-255,6797,66153,64,246443
25452,0.001106,172.31.40.0-255,66,66219,64,246443
25453,0.001817,74.125.200.0-255,1484,67703,64,246443
25454,0.001821,172.31.40.0-255,66,67769,64,246443
25455,0.001827,74.125.200.0-255,1484,69253,64,246443
25456,0.001829,172.31.40.0-255,66,69319,64,246443
25457,0.00185,74.125.200.0-255,2902,72221,64,246443
25458,0.001852,172.31.40.0-255,66,72287,64,246443
25459,0.001869,74.125.200.0-255,4320,76607,64,246443
25460,0.001871,172.31.40.0-255,66,76673,64,246443
25461,0.001885,74.125.200.0-255,1484,78157,64,246443
25462,0.001887,172.31.40.0-255,66,78223,64,246443
25463,0.001889,74.125.200.0-255,1484,79707,64,246443
25464,0.001891,172.31.40.0-255,66,79773,64,246443
25465,0.001948,74.125.200.0-255,2902,82675,64,246443
25466,0.001951,172.31.40.0-255,66,82741,64,246443
25467,0.001974,74.125.200.0-255,1484,84225,64,246443
25468,0.001976,172.31.40.0-255,66,84291,64,246443
25469,0.001989,74.125.200.0-255,2902,87193,64,246443
25470,0.00199,172.31.40.0-255,66,87259,64,246443
25471,0.002003,74.125.200.0-255,2902,90161,64,246443
25472,0.002018,74.125.200.0-255,2902,93063,64,246443
25473,0.002031,74.125.200.0-255,4320,97383,64,246443
25474,0.002035,172.31.40.0-255,66,97449,64,246443
25475,0.002053,74.125.200.0-255,3602,101051,64,246443
25476,0.002062,172.31.40.0-255,66,101117,64,246443
25477,0.004376,74.125.200.0-255,1484,102601,64,246443
25478,0.004381,172.31.40.0-255,66,102667,64,246443
25479,0.004405,74.125.200.0-255,4320,106987,64,246443
25480,0.004407,172.31.40.0-255,66,107053,64,246443
25481,0.006721,74.125.200.0-255,1484,108537,64,246443
25482,0.006725,172.31.40.0-255,66,108603,64,246443
25483,0.006751,74.125.200.0-255,4320,112923,64,246443
25484,0.006774,172.31.40.0-255,66,112989,64,246443
25485,0.009071,74.125.200.0-255,1484,114473,64,246443
25486,0.009078,172.31.40.0-255,66,114539,64,246443
25487,0.009101,74.125.200.0-255,1484,116023,64,246443
25488,0.00912,74.125.200.0-255,2902,118925,64,246443
25489,0.00913,172.31.40.0-255,66,118991,64,246443
25490,0.011421,74.125.200.0-255,1484,120475,64,246443
25491,0.011426,172.31.40.0-255,66,120541,64,246443
25492,0.011446,74.125.200.0-255,1484,122025,64,246443
25493,0.011459,74.125.200.0-255,2902,124927,64,246443
25494,0.011477,172.31.40.0-255,66,124993,64,246443
25495,0.013762,74.125.200.0-255,1484,126477,64,246443
25496,0.013816,74.125.200.0-255,4320,130797,64,246443
25497,0.013821,172.31.40.0-255,66,130863,64,246443
25498,0.016168,74.125.200.0-255,5738,136601,64,246443
25499,0.016218,172.31.40.0-255,66,136667,64,246443
25500,0.018595,74.125.200.0-255,5738,142405,64,246443
25501,0.018603,172.31.40.0-255,66,142471,64,246443
25502,0.020952,74.125.200.0-255,5738,148209,64,246443
25503,0.020959,172.31.40.0-255,66,148275,64,246443
25504,0.023008,172.31.40.0-255,167,148442,64,246443
25505,0.023068,172.31.40.0-255,1107,149549,64,246443
25506,0.023142,172.31.40.0-255,1514,151063,64,246443
25507,0.023149,172.31.40.0-255,338,151401,64,246443
25508,0.023312,74.125.200.0-255,5738,157139,64,246443
25509,0.023319,172.31.40.0-255,66,157205,64,246443
25510,0.024549,104.244.42.0-255,66,157271,64,246443
25511,0.02464,104.244.42.0-255,66,157337,64,246443
25512,0.024686,104.244.42.0-255,66,157403,64,246443
25513,0.02566,74.125.200.0-255,2902,160305,64,246443
25514,0.025664,172.31.40.0-255,66,160371,64,246443
25515,0.025683,74.125.200.0-255,2902,163273,64,246443
25516,0.025702,172.31.40.0-255,66,163339,64,246443
25517,0.028012,74.125.200.0-255,2902,166241,64,246443
25518,0.028017,172.31.40.0-255,66,166307,64,246443
25519,0.028051,74.125.200.0-255,2902,169209,64,246443
25520,0.028069,172.31.40.0-255,66,169275,64,246443
25521,0.030357,74.125.200.0-255,2902,172177,64,246443
25522,0.030362,172.31.40.0-255,66,172243,64,246443
25523,0.030394,74.125.200.0-255,2902,175145,64,246443
25524,0.030412,172.31.40.0-255,66,175211,64,246443
25525,0.0327,74.125.200.0-255,2902,178113,64,246443
25526,0.032705,172.31.40.0-255,66,178179,64,246443
25527,0.03274,74.125.200.0-255,2902,181081,64,246443
25528,0.032753,172.31.40.0-255,66,181147,64,246443
25529,0.035046,74.125.200.0-255,2902,184049,64,246443
25530,0.035051,172.31.40.0-255,66,184115,64,246443
25531,0.035084,74.125.200.0-255,2902,187017,64,246443
25532,0.035103,172.31.40.0-255,66,187083,64,246443
25533,0.037402,74.125.200.0-255,2902,189985,64,246443
25534,0.037408,172.31.40.0-255,66,190051,64,246443
25535,0.037463,74.125.200.0-255,2902,192953,64,246443
25536,0.037474,172.31.40.0-255,66,193019,64,246443
25537,0.039756,74.125.200.0-255,2902,195921,64,246443
25538,0.039761,172.31.40.0-255,66,195987,64,246443
25539,0.039822,74.125.200.0-255,2902,198889,64,246443
25540,0.039828,172.31.40.0-255,66,198955,64,246443
25541,0.042115,74.125.200.0-255,2902,201857,64,246443
25542,0.04212,172.31.40.0-255,66,201923,64,246443
25543,0.042188,74.125.200.0-255,2902,204825,64,246443
25544,0.0422,172.31.40.0-255,66,204891,64,246443
25545,0.044457,74.125.200.0-255,2902,207793,64,246443
25546,0.044462,172.31.40.0-255,66,207859,64,246443
25547,0.044555,74.125.200.0-255,2902,210761,64,246443
25548,0.044559,172.31.40.0-255,66,210827,64,246443
25549,0.046816,74.125.200.0-255,2902,213729,64,246443
25550,0.046822,172.31.40.0-255,66,213795,64,246443
25551,0.046889,74.125.200.0-255,2902,216697,64,246443
25552,0.046901,172.31.40.0-255,66,216763,64,246443
25553,0.049161,74.125.200.0-255,2902,219665,64,246443
25554,0.049166,172.31.40.0-255,66,219731,64,246443
25555,0.049239,74.125.200.0-255,2902,222633,64,246443
25556,0.049245,172.31.40.0-255,66,222699,64,246443
25557,0.051612,74.125.200.0-255,2902,225601,64,246443
25558,0.051617,172.31.40.0-255,66,225667,64,246443
25559,0.051691,74.125.200.0-255,2902,228569,64,246443
25560,0.051706,172.31.40.0-255,66,228635,64,246443
25561,0.053958,74.125.200.0-255,2902,231537,64,246443
25562,0.053963,172.31.40.0-255,66,231603,64,246443
25563,0.054055,74.125.200.0-255,2902,234505,64,246443
25564,0.05406,172.31.40.0-255,66,234571,64,246443
25565,0.056368,74.125.200.0-255,2902,237473,64,246443
25566,0.056373,172.31.40.0-255,66,237539,64,246443
25567,0.056404,74.125.200.0-255,2902,240441,64,246443
25568,0.056425,172.31.40.0-255,66,240507,64,246443
25569,0.058722,74.125.200.0-255,2902,243409,64,246443
25570,0.058728,172.31.40.0-255,66,243475,64,246443
25571,0.058762,74.125.200.0-255,2902,246377,64,246443
25572,0.058769,172.31.40.0-255,66,246443,64,246443
25573,0.0,172.217.194.0-255,153,153,64,172671
25574,1.6e-05,172.31.40.0-255,66,219,64,172671
25575,2.3e-05,172.217.194.0-255,1484,1703,64,172671
25576,2.8e-05,172.31.40.0-255,66,1769,64,172671
25577,3.4e-05,172.217.194.0-255,2902,4671,64,172671
25578,3.7e-05,172.31.40.0-255,66,4737,64,172671
25579,4.5e-05,172.217.194.0-255,5738,10475,64,172671
25580,4.8e-05,172.31.40.0-255,66,10541,64,172671
25581,6.8e-05,172.217.194.0-255,1484,12025,64,172671
25582,7.1e-05,172.31.40.0-255,66,12091,64,172671
25583,9.3e-05,172.217.194.0-255,2101,14192,64,172671
25584,9.5e-05,172.31.40.0-255,66,14258,64,172671
25585,0.000127,172.217.194.0-255,1484,15742,64,172671
25586,0.000131,172.31.40.0-255,66,15808,64,172671
25587,0.000135,172.217.194.0-255,2902,18710,64,172671
25588,0.000138,172.31.40.0-255,66,18776,64,172671
25589,0.00015,172.217.194.0-255,1484,20260,64,172671
25590,0.000152,172.31.40.0-255,66,20326,64,172671
25591,0.000187,172.217.194.0-255,4320,24646,64,172671
25592,0.00019,172.31.40.0-255,66,24712,64,172671
25593,0.000198,172.217.194.0-255,6797,31509,64,172671
25594,0.0002,172.31.40.0-255,66,31575,64,172671
25595,0.000205,172.217.194.0-255,4320,35895,64,172671
25596,0.000208,172.31.40.0-255,66,35961,64,172671
25597,0.000237,172.31.40.0-255,66,36027,64,172671
25598,0.000241,172.217.194.0-255,2543,38570,64,172671
25599,0.000243,172.31.40.0-255,66,38636,64,172671
25600,0.000286,172.217.194.0-255,4320,42956,64,172671
25601,0.000289,172.31.40.0-255,66,43022,64,172671
25602,0.000322,172.31.40.0-255,66,43088,64,172671
25603,0.000353,172.217.194.0-255,99,43187,64,172671
25604,0.000414,172.217.194.0-255,1484,44671,64,172671
25605,0.000417,172.31.40.0-255,66,44737,64,172671
25606,0.00042,172.217.194.0-255,1484,46221,64,172671
25607,0.00044,172.217.194.0-255,4320,50541,64,172671
25608,0.000443,172.31.40.0-255,66,50607,64,172671
25609,0.000493,172.217.194.0-255,4320,54927,64,172671
25610,0.000497,172.31.40.0-255,66,54993,64,172671
25611,0.000511,172.217.194.0-255,5379,60372,64,172671
25612,0.000514,172.31.40.0-255,66,60438,64,172671
25613,0.000518,172.217.194.0-255,2902,63340,64,172671
25614,0.00052,172.31.40.0-255,66,63406,64,172671
25615,0.00055,172.217.194.0-255,7156,70562,64,172671
25616,0.000553,172.31.40.0-255,66,70628,64,172671
25617,0.00056,172.217.194.0-255,6797,77425,64,172671
25618,0.000563,172.31.40.0-255,66,77491,64,172671
25619,0.000813,172.217.194.0-255,1484,78975,64,172671
25620,0.000836,172.217.194.0-255,2902,81877,64,172671
25621,0.00084,172.31.40.0-255,66,81943,64,172671
25622,0.000848,172.217.194.0-255,5738,87681,64,172671
25623,0.00085,172.31.40.0-255,66,87747,64,172671
25624,0.000871,172.217.194.0-255,1484,89231,64,172671
25625,0.000909,172.31.40.0-255,66,89297,64,172671
25626,0.000915,172.217.194.0-255,4320,93617,64,172671
25627,0.000917,172.31.40.0-255,66,93683,64,172671
25628,0.000947,172.217.194.0-255,6438,100121,64,172671
25629,0.000951,172.31.40.0-255,66,100187,64,172671
25630,0.001171,172.217.194.0-255,1484,101671,64,172671
25631,0.001191,172.217.194.0-255,2902,104573,64,172671
25632,0.001194,172.31.40.0-255,66,104639,64,172671
25633,0.001207,172.217.194.0-255,2902,107541,64,172671
25634,0.00121,172.31.40.0-255,66,107607,64,172671
25635,0.001229,172.217.194.0-255,2902,110509,64,172671
25636,0.001231,172.31.40.0-255,66,110575,64,172671
25637,0.001236,172.217.194.0-255,2902,113477,64,172671
25638,0.001238,172.31.40.0-255,66,113543,64,172671
25639,0.001271,172.31.40.0-255,66,113609,64,172671
25640,0.001274,172.217.194.0-255,1484,115093,64,172671
25641,0.001312,172.31.40.0-255,66,115159,64,172671
25642,0.001319,172.217.194.0-255,7156,122315,64,172671
25643,0.001322,172.31.40.0-255,66,122381,64,172671
25644,0.001353,172.217.194.0-255,1484,123865,64,172671
25645,0.00138,172.31.40.0-255,66,123931,64,172671
25646,0.001402,172.217.194.0-255,2184,126115,64,172671
25647,0.001405,172.31.40.0-255,66,126181,64,172671
25648,0.001425,172.31.40.0-255,66,126247,64,172671
25649,0.001437,172.31.40.0-255,66,126313,64,172671
25650,0.001532,172.31.40.0-255,66,126379,64,172671
25651,0.001553,172.31.40.0-255,66,126445,64,172671
25652,0.001568,172.31.40.0-255,66,126511,64,172671
25653,0.001579,172.31.40.0-255,66,126577,64,172671
25654,0.001616,172.217.194.0-255,1484,128061,64,172671
25655,0.001641,172.31.40.0-255,66,128127,64,172671
25656,0.001647,172.31.40.0-255,66,128193,64,172671
25657,0.00169,172.217.194.0-255,7156,135349,64,172671
25658,0.001693,172.31.40.0-255,66,135415,64,172671
25659,0.001715,172.217.194.0-255,6438,141853,64,172671
25660,0.00172,172.31.40.0-255,66,141919,64,172671
25661,0.001731,172.217.194.0-255,7156,149075,64,172671
25662,0.001763,172.217.194.0-255,7156,156231,64,172671
25663,0.001767,172.217.194.0-255,1484,157715,64,172671
25664,0.001775,172.31.40.0-255,66,157781,64,172671
25665,0.0018,172.31.40.0-255,66,157847,64,172671
25666,0.001832,172.217.194.0-255,2902,160749,64,172671
25667,0.001859,172.31.40.0-255,66,160815,64,172671
25668,0.001864,172.31.40.0-255,66,160881,64,172671
25669,0.001884,172.217.194.0-255,7156,168037,64,172671
25670,0.001911,172.217.194.0-255,105,168142,64,172671
25671,0.001931,172.31.40.0-255,66,168208,64,172671
25672,0.012778,172.31.40.0-255,105,168313,64,172671
25673,0.015033,172.217.194.0-255,66,168379,64,172671
25674,0.049802,172.31.40.0-255,172,168551,64,172671
25675,0.049838,172.31.40.0-255,1113,169664,64,172671
25676,0.049906,172.31.40.0-255,1514,171178,64,172671
25677,0.049908,172.31.40.0-255,1295,172473,64,172671
25678,0.051362,104.244.42.0-255,66,172539,64,172671
25679,0.05141,104.244.42.0-255,66,172605,64,172671
25680,0.05144,104.244.42.0-255,66,172671,64,172671
25681,0.0,172.31.40.0-255,105,105,64,459
25682,0.000236,172.31.40.0-255,90,195,64,459
25683,0.000245,172.31.40.0-255,66,261,64,459
25684,0.002596,172.217.194.0-255,66,327,64,459
25685,0.002625,172.217.194.0-255,66,393,64,459
25686,0.002645,172.31.40.0-255,66,459,64,459
25687,0.0,172.217.194.0-255,153,153,64,303828
25688,2.2e-05,172.31.40.0-255,66,219,64,303828
25689,2.9e-05,172.217.194.0-255,1484,1703,64,303828
25690,3.4e-05,172.31.40.0-255,66,1769,64,303828
25691,4e-05,172.217.194.0-255,2902,4671,64,303828
25692,5.2e-05,172.31.40.0-255,66,4737,64,303828
25693,6e-05,172.217.194.0-255,7156,11893,64,303828
25694,6.4e-05,172.31.40.0-255,66,11959,64,303828
25695,0.000111,172.31.40.0-255,66,12025,64,303828
25696,0.000132,172.217.194.0-255,3447,15472,64,303828
25697,0.00014,172.31.40.0-255,66,15538,64,303828
25698,0.000144,172.217.194.0-255,2543,18081,64,303828
25699,0.000147,172.31.40.0-255,66,18147,64,303828
25700,0.000244,172.217.194.0-255,1484,19631,64,303828
25701,0.000247,172.31.40.0-255,66,19697,64,303828
25702,0.000252,172.217.194.0-255,2902,22599,64,303828
25703,0.000255,172.31.40.0-255,66,22665,64,303828
25704,0.000294,172.217.194.0-255,5738,28403,64,303828
25705,0.000298,172.31.40.0-255,66,28469,64,303828
25706,0.000304,172.217.194.0-255,5738,34207,64,303828
25707,0.000306,172.31.40.0-255,66,34273,64,303828
25708,0.000338,172.31.40.0-255,66,34339,64,303828
25709,0.000353,172.31.40.0-255,66,34405,64,303828
25710,0.000356,172.217.194.0-255,1439,35844,64,303828
25711,0.000358,172.31.40.0-255,66,35910,64,303828
25712,0.000403,172.217.194.0-255,1484,37394,64,303828
25713,0.000406,172.31.40.0-255,66,37460,64,303828
25714,0.00043,172.217.194.0-255,1484,38944,64,303828
25715,0.000432,172.31.40.0-255,66,39010,64,303828
25716,0.000437,172.217.194.0-255,2902,41912,64,303828
25717,0.000439,172.31.40.0-255,66,41978,64,303828
25718,0.000445,172.217.194.0-255,5738,47716,64,303828
25719,0.000447,172.31.40.0-255,66,47782,64,303828
25720,0.00047,172.217.194.0-255,1484,49266,64,303828
25721,0.000504,172.31.40.0-255,66,49332,64,303828
25722,0.00053,172.217.194.0-255,5738,55070,64,303828
25723,0.000532,172.31.40.0-255,66,55136,64,303828
25724,0.00056,172.217.194.0-255,4830,59966,64,303828
25725,0.000564,172.31.40.0-255,66,60032,64,303828
25726,0.000642,172.217.194.0-255,1484,61516,64,303828
25727,0.000647,172.217.194.0-255,2902,64418,64,303828
25728,0.000649,172.31.40.0-255,66,64484,64,303828
25729,0.000683,172.217.194.0-255,5738,70222,64,303828
25730,0.000686,172.31.40.0-255,66,70288,64,303828
25731,0.000692,172.217.194.0-255,5738,76026,64,303828
25732,0.000695,172.31.40.0-255,66,76092,64,303828
25733,0.000701,172.217.194.0-255,5738,81830,64,303828
25734,0.000708,172.31.40.0-255,66,81896,64,303828
25735,0.000762,172.217.194.0-255,7156,89052,64,303828
25736,0.000766,172.31.40.0-255,66,89118,64,303828
25737,0.000772,172.217.194.0-255,5020,94138,64,303828
25738,0.000775,172.31.40.0-255,66,94204,64,303828
25739,0.00121,172.217.194.0-255,1484,95688,64,303828
25740,0.001216,172.217.194.0-255,2902,98590,64,303828
25741,0.001227,172.31.40.0-255,66,98656,64,303828
25742,0.001233,172.217.194.0-255,4320,102976,64,303828
25743,0.001235,172.31.40.0-255,66,103042,64,303828
25744,0.001264,172.217.194.0-255,1484,104526,64,303828
25745,0.001269,172.217.194.0-255,2902,107428,64,303828
25746,0.001271,172.31.40.0-255,66,107494,64,303828
25747,0.001317,172.31.40.0-255,66,107560,64,303828
25748,0.001328,172.31.40.0-255,66,107626,64,303828
25749,0.001331,172.217.194.0-255,766,108392,64,303828
25750,0.001472,172.217.194.0-255,1484,109876,64,303828
25751,0.001476,172.31.40.0-255,66,109942,64,303828
25752,0.00149,172.217.194.0-255,2902,112844,64,303828
25753,0.001496,172.31.40.0-255,66,112910,64,303828
25754,0.001499,172.217.194.0-255,1484,114394,64,303828
25755,0.001525,172.217.194.0-255,4320,118714,64,303828
25756,0.001527,172.31.40.0-255,66,118780,64,303828
25757,0.001556,172.217.194.0-255,7156,125936,64,303828
25758,0.00156,172.31.40.0-255,66,126002,64,303828
25759,0.001563,172.217.194.0-255,1484,127486,64,303828
25760,0.001592,172.217.194.0-255,7156,134642,64,303828
25761,0.001595,172.31.40.0-255,66,134708,64,303828
25762,0.001599,172.217.194.0-255,4320,139028,64,303828
25763,0.001601,172.31.40.0-255,66,139094,64,303828
25764,0.00164,172.217.194.0-255,3602,142696,64,303828
25765,0.001642,172.31.40.0-255,66,142762,64,303828
25766,0.00365,172.217.194.0-255,1484,144246,64,303828
25767,0.003716,172.217.194.0-255,4320,148566,64,303828
25768,0.003721,172.31.40.0-255,66,148632,64,303828
25769,0.005775,172.217.194.0-255,5738,154370,64,303828
25770,0.005778,172.31.40.0-255,66,154436,64,303828
25771,0.007827,172.217.194.0-255,5738,160174,64,303828
25772,0.00783,172.31.40.0-255,66,160240,64,303828
25773,0.009874,172.217.194.0-255,5738,165978,64,303828
25774,0.009881,172.31.40.0-255,66,166044,64,303828
25775,0.011955,172.217.194.0-255,5738,171782,64,303828
25776,0.011963,172.31.40.0-255,66,171848,64,303828
25777,0.014019,172.217.194.0-255,5738,177586,64,303828
25778,0.014025,172.31.40.0-255,66,177652,64,303828
25779,0.016115,172.217.194.0-255,5738,183390,64,303828
25780,0.016125,172.31.40.0-255,66,183456,64,303828
25781,0.018229,172.217.194.0-255,5738,189194,64,303828
25782,0.018238,172.31.40.0-255,66,189260,64,303828
25783,0.020345,172.217.194.0-255,5738,194998,64,303828
25784,0.020356,172.31.40.0-255,66,195064,64,303828
25785,0.022415,172.217.194.0-255,5738,200802,64,303828
25786,0.022431,172.31.40.0-255,66,200868,64,303828
25787,0.024525,172.217.194.0-255,5738,206606,64,303828
25788,0.024538,172.31.40.0-255,66,206672,64,303828
25789,0.026658,172.217.194.0-255,5738,212410,64,303828
25790,0.026672,172.31.40.0-255,66,212476,64,303828
25791,0.028773,172.217.194.0-255,5738,218214,64,303828
25792,0.028787,172.31.40.0-255,66,218280,64,303828
25793,0.030849,172.217.194.0-255,5738,224018,64,303828
25794,0.030857,172.31.40.0-255,66,224084,64,303828
25795,0.032916,172.217.194.0-255,5738,229822,64,303828
25796,0.032922,172.31.40.0-255,66,229888,64,303828
25797,0.03501,172.217.194.0-255,5738,235626,64,303828
25798,0.035025,172.31.40.0-255,66,235692,64,303828
25799,0.037099,172.217.194.0-255,5738,241430,64,303828
25800,0.037107,172.31.40.0-255,66,241496,64,303828
25801,0.039183,172.217.194.0-255,5738,247234,64,303828
25802,0.039197,172.31.40.0-255,66,247300,64,303828
25803,0.041303,172.217.194.0-255,5738,253038,64,303828
25804,0.041315,172.31.40.0-255,66,253104,64,303828
25805,0.043387,172.217.194.0-255,5738,258842,64,303828
25806,0.043399,172.31.40.0-255,66,258908,64,303828
25807,0.045473,172.217.194.0-255,5738,264646,64,303828
25808,0.045492,172.31.40.0-255,66,264712,64,303828
25809,0.047594,172.217.194.0-255,5738,270450,64,303828
25810,0.047607,172.31.40.0-255,66,270516,64,303828
25811,0.047811,172.31.40.0-255,172,270688,64,303828
25812,0.04784,172.31.40.0-255,1112,271800,64,303828
25813,0.047957,172.31.40.0-255,1514,273314,64,303828
25814,0.047959,172.31.40.0-255,1296,274610,64,303828
25815,0.049382,104.244.42.0-255,66,274676,64,303828
25816,0.049426,104.244.42.0-255,66,274742,64,303828
25817,0.04958,104.244.42.0-255,66,274808,64,303828
25818,0.049664,172.217.194.0-255,5738,280546,64,303828
25819,0.04967,172.31.40.0-255,66,280612,64,303828
25820,0.051735,172.217.194.0-255,5738,286350,64,303828
25821,0.051748,172.31.40.0-255,66,286416,64,303828
25822,0.053844,172.217.194.0-255,5738,292154,64,303828
25823,0.053862,172.31.40.0-255,66,292220,64,303828
25824,0.055928,172.217.194.0-255,5738,297958,64,303828
25825,0.055944,172.31.40.0-255,66,298024,64,303828
25826,0.058013,172.217.194.0-255,5738,303762,64,303828
25827,0.058023,172.31.40.0-255,66,303828,64,303828
25828,0.0,74.125.130.0-255,146,146,64,358749
25829,2.6e-05,172.31.40.0-255,66,212,64,358749
25830,3.4e-05,74.125.130.0-255,1484,1696,64,358749
25831,3.8e-05,172.31.40.0-255,66,1762,64,358749
25832,4.4e-05,74.125.130.0-255,2902,4664,64,358749
25833,4.8e-05,172.31.40.0-255,66,4730,64,358749
25834,5.1e-05,74.125.130.0-255,1484,6214,64,358749
25835,5.4e-05,172.31.40.0-255,66,6280,64,358749
25836,5.8e-05,74.125.130.0-255,1484,7764,64,358749
25837,6.1e-05,172.31.40.0-255,66,7830,64,358749
25838,8e-05,74.125.130.0-255,1484,9314,64,358749
25839,8.3e-05,172.31.40.0-255,66,9380,64,358749
25840,0.000108,74.125.130.0-255,5011,14391,64,358749
25841,0.000111,172.31.40.0-255,66,14457,64,358749
25842,0.000242,74.125.130.0-255,1484,15941,64,358749
25843,0.000246,172.31.40.0-255,66,16007,64,358749
25844,0.00026,74.125.130.0-255,1484,17491,64,358749
25845,0.000263,172.31.40.0-255,66,17557,64,358749
25846,0.000268,74.125.130.0-255,2902,20459,64,358749
25847,0.00027,172.31.40.0-255,66,20525,64,358749
25848,0.000273,74.125.130.0-255,1484,22009,64,358749
25849,0.000275,172.31.40.0-255,66,22075,64,358749
25850,0.000302,74.125.130.0-255,4320,26395,64,358749
25851,0.000304,172.31.40.0-255,66,26461,64,358749
25852,0.000311,74.125.130.0-255,5379,31840,64,358749
25853,0.000314,172.31.40.0-255,66,31906,64,358749
25854,0.000343,74.125.130.0-255,5738,37644,64,358749
25855,0.000346,172.31.40.0-255,66,37710,64,358749
25856,0.000363,74.125.130.0-255,4320,42030,64,358749
25857,0.000366,172.31.40.0-255,66,42096,64,358749
25858,0.000392,74.125.130.0-255,7156,49252,64,358749
25859,0.000395,172.31.40.0-255,66,49318,64,358749
25860,0.000433,172.31.40.0-255,66,49384,64,358749
25861,0.000447,74.125.130.0-255,1484,50868,64,358749
25862,0.000454,74.125.130.0-255,3602,54470,64,358749
25863,0.000456,172.31.40.0-255,66,54536,64,358749
25864,0.000482,74.125.130.0-255,390,54926,64,358749
25865,0.0006,74.125.130.0-255,1484,56410,64,358749
25866,0.000605,172.31.40.0-255,66,56476,64,358749
25867,0.00061,74.125.130.0-255,2902,59378,64,358749
25868,0.000613,172.31.40.0-255,66,59444,64,358749
25869,0.000643,74.125.130.0-255,5738,65182,64,358749
25870,0.000646,172.31.40.0-255,66,65248,64,358749
25871,0.000653,74.125.130.0-255,5738,70986,64,358749
25872,0.000655,172.31.40.0-255,66,71052,64,358749
25873,0.000669,74.125.130.0-255,1484,72536,64,358749
25874,0.000688,74.125.130.0-255,4320,76856,64,358749
25875,0.00069,172.31.40.0-255,66,76922,64,358749
25876,0.000722,172.31.40.0-255,66,76988,64,358749
25877,0.000734,74.125.130.0-255,2184,79172,64,358749
25878,0.000737,172.31.40.0-255,66,79238,64,358749
25879,0.00081,74.125.130.0-255,385,79623,64,358749
25880,0.000945,74.125.130.0-255,1484,81107,64,358749
25881,0.000949,172.31.40.0-255,66,81173,64,358749
25882,0.000954,74.125.130.0-255,2902,84075,64,358749
25883,0.000956,172.31.40.0-255,66,84141,64,358749
25884,0.000971,74.125.130.0-255,1484,85625,64,358749
25885,0.000987,74.125.130.0-255,4320,89945,64,358749
25886,0.000989,172.31.40.0-255,66,90011,64,358749
25887,0.000995,74.125.130.0-255,4320,94331,64,358749
25888,0.000997,172.31.40.0-255,66,94397,64,358749
25889,0.001004,74.125.130.0-255,5738,100135,64,358749
25890,0.001006,172.31.40.0-255,66,100201,64,358749
25891,0.001041,172.31.40.0-255,66,100267,64,358749
25892,0.001062,74.125.130.0-255,2902,103169,64,358749
25893,0.001064,172.31.40.0-255,66,103235,64,358749
25894,0.001068,74.125.130.0-255,2184,105419,64,358749
25895,0.001071,172.31.40.0-255,66,105485,64,358749
25896,0.001118,74.125.130.0-255,1484,106969,64,358749
25897,0.001146,74.125.130.0-255,1484,108453,64,358749
25898,0.00115,172.31.40.0-255,66,108519,64,358749
25899,0.001162,74.125.130.0-255,2902,111421,64,358749
25900,0.001166,172.31.40.0-255,66,111487,64,358749
25901,0.001169,74.125.130.0-255,1484,112971,64,358749
25902,0.001188,74.125.130.0-255,4320,117291,64,358749
25903,0.001191,172.31.40.0-255,66,117357,64,358749
25904,0.001198,74.125.130.0-255,5738,123095,64,358749
25905,0.0012,172.31.40.0-255,66,123161,64,358749
25906,0.001218,74.125.130.0-255,4320,127481,64,358749
25907,0.001221,172.31.40.0-255,66,127547,64,358749
25908,0.001233,172.31.40.0-255,66,127613,64,358749
25909,0.001249,74.125.130.0-255,1484,129097,64,358749
25910,0.001252,74.125.130.0-255,766,129863,64,358749
25911,0.001255,172.31.40.0-255,66,129929,64,358749
25912,0.001301,74.125.130.0-255,1484,131413,64,358749
25913,0.001316,74.125.130.0-255,2902,134315,64,358749
25914,0.00132,172.31.40.0-255,66,134381,64,358749
25915,0.001358,74.125.130.0-255,5738,140119,64,358749
25916,0.001361,172.31.40.0-255,66,140185,64,358749
25917,0.001382,74.125.130.0-255,7156,147341,64,358749
25918,0.001384,172.31.40.0-255,66,147407,64,358749
25919,0.001388,74.125.130.0-255,1484,148891,64,358749
25920,0.001407,74.125.130.0-255,4320,153211,64,358749
25921,0.001411,172.31.40.0-255,66,153277,64,358749
25922,0.00143,74.125.130.0-255,7156,160433,64,358749
25923,0.001433,172.31.40.0-255,66,160499,64,358749
25924,0.001451,74.125.130.0-255,3602,164101,64,358749
25925,0.001454,172.31.40.0-255,66,164167,64,358749
25926,0.001547,74.125.130.0-255,1484,165651,64,358749
25927,0.001566,74.125.130.0-255,2902,168553,64,358749
25928,0.00157,172.31.40.0-255,66,168619,64,358749
25929,0.001574,74.125.130.0-255,1484,170103,64,358749
25930,0.001587,74.125.130.0-255,4320,174423,64,358749
25931,0.00159,172.31.40.0-255,66,174489,64,358749
25932,0.001594,74.125.130.0-255,2902,177391,64,358749
25933,0.001597,172.31.40.0-255,66,177457,64,358749
25934,0.001623,74.125.130.0-255,1484,178941,64,358749
25935,0.001631,74.125.130.0-255,5738,184679,64,358749
25936,0.001633,172.31.40.0-255,66,184745,64,358749
25937,0.001681,74.125.130.0-255,4320,189065,64,358749
25938,0.001686,172.31.40.0-255,66,189131,64,358749
25939,0.001701,74.125.130.0-255,4320,193451,64,358749
25940,0.001705,172.31.40.0-255,66,193517,64,358749
25941,0.001733,74.125.130.0-255,4320,197837,64,358749
25942,0.001737,172.31.40.0-255,66,197903,64,358749
25943,0.001754,74.125.130.0-255,766,198669,64,358749
25944,0.001771,74.125.130.0-255,1484,200153,64,358749
25945,0.001774,172.31.40.0-255,66,200219,64,358749
25946,0.001797,74.125.130.0-255,2902,203121,64,358749
25947,0.001799,172.31.40.0-255,66,203187,64,358749
25948,0.001802,74.125.130.0-255,1484,204671,64,358749
25949,0.001807,74.125.130.0-255,2902,207573,64,358749
25950,0.001809,172.31.40.0-255,66,207639,64,358749
25951,0.001866,74.125.130.0-255,5738,213377,64,358749
25952,0.001869,172.31.40.0-255,66,213443,64,358749
25953,0.001882,172.31.40.0-255,66,213509,64,358749
25954,0.001916,172.31.40.0-255,66,213575,64,358749
25955,0.001969,74.125.130.0-255,1484,215059,64,358749
25956,0.001974,74.125.130.0-255,2902,217961,64,358749
25957,0.001977,172.31.40.0-255,66,218027,64,358749
25958,0.00198,74.125.130.0-255,1484,219511,64,358749
25959,0.002009,74.125.130.0-255,4320,223831,64,358749
25960,0.002012,172.31.40.0-255,66,223897,64,358749
25961,0.002017,74.125.130.0-255,4320,228217,64,358749
25962,0.00202,172.31.40.0-255,66,228283,64,358749
25963,0.002026,74.125.130.0-255,5738,234021,64,358749
25964,0.002028,172.31.40.0-255,66,234087,64,358749
25965,0.002048,74.125.130.0-255,2902,236989,64,358749
25966,0.002051,172.31.40.0-255,66,237055,64,358749
25967,0.002066,74.125.130.0-255,7156,244211,64,358749
25968,0.002069,172.31.40.0-255,66,244277,64,358749
25969,0.002103,74.125.130.0-255,3602,247879,64,358749
25970,0.002106,172.31.40.0-255,66,247945,64,358749
25971,0.002213,74.125.130.0-255,1484,249429,64,358749
25972,0.002225,74.125.130.0-255,1484,250913,64,358749
25973,0.002228,172.31.40.0-255,66,250979,64,358749
25974,0.002246,74.125.130.0-255,1484,252463,64,358749
25975,0.002252,74.125.130.0-255,5738,258201,64,358749
25976,0.002256,74.125.130.0-255,2902,261103,64,358749
25977,0.00226,172.31.40.0-255,66,261169,64,358749
25978,0.002268,172.31.40.0-255,66,261235,64,358749
25979,0.002273,74.125.130.0-255,4320,265555,64,358749
25980,0.002276,172.31.40.0-255,66,265621,64,358749
25981,0.002289,74.125.130.0-255,2902,268523,64,358749
25982,0.002292,172.31.40.0-255,66,268589,64,358749
25983,0.00232,74.125.130.0-255,5738,274327,64,358749
25984,0.002323,172.31.40.0-255,66,274393,64,358749
25985,0.002329,74.125.130.0-255,5738,280131,64,358749
25986,0.002331,172.31.40.0-255,66,280197,64,358749
25987,0.002357,74.125.130.0-255,2184,282381,64,358749
25988,0.002359,172.31.40.0-255,66,282447,64,358749
25989,0.004708,74.125.130.0-255,4320,286767,64,358749
25990,0.004715,172.31.40.0-255,66,286833,64,358749
25991,0.004735,74.125.130.0-255,1484,288317,64,358749
25992,0.007082,74.125.130.0-255,4320,292637,64,358749
25993,0.007085,172.31.40.0-255,66,292703,64,358749
25994,0.009463,74.125.130.0-255,5738,298441,64,358749
25995,0.00947,172.31.40.0-255,66,298507,64,358749
25996,0.011848,74.125.130.0-255,5738,304245,64,358749
25997,0.011855,172.31.40.0-255,66,304311,64,358749
25998,0.014242,74.125.130.0-255,5738,310049,64,358749
25999,0.014251,172.31.40.0-255,66,310115,64,358749
26000,0.016623,74.125.130.0-255,5738,315853,64,358749
26001,0.016632,172.31.40.0-255,66,315919,64,358749
26002,0.019005,74.125.130.0-255,5738,321657,64,358749
26003,0.019014,172.31.40.0-255,66,321723,64,358749
26004,0.021407,74.125.130.0-255,5738,327461,64,358749
26005,0.021425,172.31.40.0-255,66,327527,64,358749
26006,0.023822,74.125.130.0-255,5738,333265,64,358749
26007,0.02383,172.31.40.0-255,66,333331,64,358749
26008,0.0262,74.125.130.0-255,5738,339069,64,358749
26009,0.026208,172.31.40.0-255,66,339135,64,358749
26010,0.028592,74.125.130.0-255,5738,344873,64,358749
26011,0.028603,172.31.40.0-255,66,344939,64,358749
26012,0.030988,74.125.130.0-255,5738,350677,64,358749
26013,0.031003,172.31.40.0-255,66,350743,64,358749
26014,0.033379,74.125.130.0-255,4439,355182,64,358749
26015,0.033387,172.31.40.0-255,66,355248,64,358749
26016,0.033584,172.31.40.0-255,105,355353,64,358749
26017,0.035917,74.125.130.0-255,66,355419,64,358749
26018,0.040053,172.31.40.0-255,172,355591,64,358749
26019,0.040089,172.31.40.0-255,1113,356704,64,358749
26020,0.040153,172.31.40.0-255,1514,358218,64,358749
26021,0.040154,172.31.40.0-255,333,358551,64,358749
26022,0.041656,104.244.42.0-255,66,358617,64,358749
26023,0.041672,104.244.42.0-255,66,358683,64,358749
26024,0.041726,104.244.42.0-255,66,358749,64,358749
26025,0.0,74.125.200.0-255,152,152,64,310567
26026,2.5e-05,172.31.40.0-255,66,218,64,310567
26027,3.3e-05,74.125.200.0-255,1484,1702,64,310567
26028,3.7e-05,172.31.40.0-255,66,1768,64,310567
26029,4e-05,74.125.200.0-255,1484,3252,64,310567
26030,4.3e-05,172.31.40.0-255,66,3318,64,310567
26031,4.8e-05,74.125.200.0-255,2902,6220,64,310567
26032,5.2e-05,172.31.40.0-255,66,6286,64,310567
26033,7.5e-05,74.125.200.0-255,5738,12024,64,310567
26034,7.8e-05,172.31.40.0-255,66,12090,64,310567
26035,8.2e-05,74.125.200.0-255,2125,14215,64,310567
26036,8.4e-05,172.31.40.0-255,66,14281,64,310567
26037,0.000341,74.125.200.0-255,1484,15765,64,310567
26038,0.000347,74.125.200.0-255,2902,18667,64,310567
26039,0.000357,172.31.40.0-255,66,18733,64,310567
26040,0.000361,172.31.40.0-255,66,18799,64,310567
26041,0.000368,74.125.200.0-255,5738,24537,64,310567
26042,0.00037,172.31.40.0-255,66,24603,64,310567
26043,0.000406,74.125.200.0-255,6797,31400,64,310567
26044,0.000409,172.31.40.0-255,66,31466,64,310567
26045,0.000571,74.125.200.0-255,1484,32950,64,310567
26046,0.000575,172.31.40.0-255,66,33016,64,310567
26047,0.000581,74.125.200.0-255,2902,35918,64,310567
26048,0.000583,172.31.40.0-255,66,35984,64,310567
26049,0.000603,74.125.200.0-255,5738,41722,64,310567
26050,0.000606,172.31.40.0-255,66,41788,64,310567
26051,0.000637,74.125.200.0-255,6797,48585,64,310567
26052,0.000641,172.31.40.0-255,66,48651,64,310567
26053,0.000697,172.31.40.0-255,66,48717,64,310567
26054,0.000725,172.31.40.0-255,66,48783,64,310567
26055,0.000784,74.125.200.0-255,127,48910,64,310567
26056,0.000803,74.125.200.0-255,347,49257,64,310567
26057,0.00106,74.125.200.0-255,1484,50741,64,310567
26058,0.001065,172.31.40.0-255,66,50807,64,310567
26059,0.001092,74.125.200.0-255,1484,52291,64,310567
26060,0.001104,74.125.200.0-255,1484,53775,64,310567
26061,0.001106,172.31.40.0-255,66,53841,64,310567
26062,0.001113,74.125.200.0-255,5738,59579,64,310567
26063,0.001116,172.31.40.0-255,66,59645,64,310567
26064,0.001121,74.125.200.0-255,4320,63965,64,310567
26065,0.001124,172.31.40.0-255,66,64031,64,310567
26066,0.001146,74.125.200.0-255,2902,66933,64,310567
26067,0.001148,172.31.40.0-255,66,66999,64,310567
26068,0.001159,74.125.200.0-255,2902,69901,64,310567
26069,0.001161,172.31.40.0-255,66,69967,64,310567
26070,0.00119,74.125.200.0-255,2902,72869,64,310567
26071,0.001193,172.31.40.0-255,66,72935,64,310567
26072,0.001213,74.125.200.0-255,4320,77255,64,310567
26073,0.001216,172.31.40.0-255,66,77321,64,310567
26074,0.001222,74.125.200.0-255,6438,83759,64,310567
26075,0.001224,172.31.40.0-255,66,83825,64,310567
26076,0.001263,74.125.200.0-255,2902,86727,64,310567
26077,0.001266,172.31.40.0-255,66,86793,64,310567
26078,0.001279,74.125.200.0-255,1484,88277,64,310567
26079,0.001286,74.125.200.0-255,5738,94015,64,310567
26080,0.001288,172.31.40.0-255,66,94081,64,310567
26081,0.001292,74.125.200.0-255,1484,95565,64,310567
26082,0.001313,172.31.40.0-255,66,95631,64,310567
26083,0.001338,74.125.200.0-255,1484,97115,64,310567
26084,0.001342,74.125.200.0-255,1484,98599,64,310567
26085,0.001344,172.31.40.0-255,66,98665,64,310567
26086,0.001385,172.31.40.0-255,66,98731,64,310567
26087,0.001525,74.125.200.0-255,1484,100215,64,310567
26088,0.001532,74.125.200.0-255,2902,103117,64,310567
26089,0.001536,172.31.40.0-255,66,103183,64,310567
26090,0.001554,74.125.200.0-255,5738,108921,64,310567
26091,0.001557,172.31.40.0-255,66,108987,64,310567
26092,0.001562,74.125.200.0-255,4320,113307,64,310567
26093,0.001564,172.31.40.0-255,66,113373,64,310567
26094,0.001581,74.125.200.0-255,4320,117693,64,310567
26095,0.001584,172.31.40.0-255,66,117759,64,310567
26096,0.001603,74.125.200.0-255,1484,119243,64,310567
26097,0.001606,74.125.200.0-255,1484,120727,64,310567
26098,0.001608,172.31.40.0-255,66,120793,64,310567
26099,0.001646,172.31.40.0-255,66,120859,64,310567
26100,0.00165,74.125.200.0-255,2184,123043,64,310567
26101,0.001653,172.31.40.0-255,66,123109,64,310567
26102,0.001864,74.125.200.0-255,1484,124593,64,310567
26103,0.001881,74.125.200.0-255,1484,126077,64,310567
26104,0.001883,172.31.40.0-255,66,126143,64,310567
26105,0.001888,74.125.200.0-255,2902,129045,64,310567
26106,0.00189,172.31.40.0-255,66,129111,64,310567
26107,0.001893,74.125.200.0-255,1484,130595,64,310567
26108,0.001917,74.125.200.0-255,4320,134915,64,310567
26109,0.001919,172.31.40.0-255,66,134981,64,310567
26110,0.001946,172.31.40.0-255,66,135047,64,310567
26111,0.001971,74.125.200.0-255,1484,136531,64,310567
26112,0.001982,74.125.200.0-255,2902,139433,64,310567
26113,0.001984,172.31.40.0-255,66,139499,64,310567
26114,0.002002,74.125.200.0-255,6438,145937,64,310567
26115,0.002005,172.31.40.0-255,66,146003,64,310567
26116,0.004024,74.125.200.0-255,5738,151741,64,310567
26117,0.004031,172.31.40.0-255,66,151807,64,310567
26118,0.006063,74.125.200.0-255,5738,157545,64,310567
26119,0.00607,172.31.40.0-255,66,157611,64,310567
26120,0.008111,74.125.200.0-255,5738,163349,64,310567
26121,0.008119,172.31.40.0-255,66,163415,64,310567
26122,0.010166,74.125.200.0-255,5738,169153,64,310567
26123,0.010176,172.31.40.0-255,66,169219,64,310567
26124,0.01222,74.125.200.0-255,5738,174957,64,310567
26125,0.012227,172.31.40.0-255,66,175023,64,310567
26126,0.014267,74.125.200.0-255,5738,180761,64,310567
26127,0.014274,172.31.40.0-255,66,180827,64,310567
26128,0.016305,74.125.200.0-255,5738,186565,64,310567
26129,0.016313,172.31.40.0-255,66,186631,64,310567
26130,0.018349,74.125.200.0-255,5738,192369,64,310567
26131,0.018355,172.31.40.0-255,66,192435,64,310567
26132,0.020442,74.125.200.0-255,5738,198173,64,310567
26133,0.020452,172.31.40.0-255,66,198239,64,310567
26134,0.022507,74.125.200.0-255,5738,203977,64,310567
26135,0.022525,172.31.40.0-255,66,204043,64,310567
26136,0.024589,74.125.200.0-255,5738,209781,64,310567
26137,0.024603,172.31.40.0-255,66,209847,64,310567
26138,0.026665,74.125.200.0-255,5738,215585,64,310567
26139,0.02668,172.31.40.0-255,66,215651,64,310567
26140,0.02874,74.125.200.0-255,5738,221389,64,310567
26141,0.028754,172.31.40.0-255,66,221455,64,310567
26142,0.030807,74.125.200.0-255,5738,227193,64,310567
26143,0.030815,172.31.40.0-255,66,227259,64,310567
26144,0.032861,74.125.200.0-255,5738,232997,64,310567
26145,0.032868,172.31.40.0-255,66,233063,64,310567
26146,0.034927,74.125.200.0-255,5738,238801,64,310567
26147,0.034944,172.31.40.0-255,66,238867,64,310567
26148,0.036981,74.125.200.0-255,5738,244605,64,310567
26149,0.036989,172.31.40.0-255,66,244671,64,310567
26150,0.039033,74.125.200.0-255,5738,250409,64,310567
26151,0.039054,172.31.40.0-255,66,250475,64,310567
26152,0.041097,74.125.200.0-255,5738,256213,64,310567
26153,0.04112,172.31.40.0-255,66,256279,64,310567
26154,0.043164,74.125.200.0-255,5738,262017,64,310567
26155,0.043172,172.31.40.0-255,66,262083,64,310567
26156,0.04522,74.125.200.0-255,5738,267821,64,310567
26157,0.045238,172.31.40.0-255,66,267887,64,310567
26158,0.047275,74.125.200.0-255,5738,273625,64,310567
26159,0.047283,172.31.40.0-255,66,273691,64,310567
26160,0.049315,74.125.200.0-255,5738,279429,64,310567
26161,0.049326,172.31.40.0-255,66,279495,64,310567
26162,0.051378,74.125.200.0-255,5738,285233,64,310567
26163,0.05139,172.31.40.0-255,66,285299,64,310567
26164,0.053449,74.125.200.0-255,5738,291037,64,310567
26165,0.053457,172.31.40.0-255,66,291103,64,310567
26166,0.055488,74.125.200.0-255,5738,296841,64,310567
26167,0.055493,172.31.40.0-255,66,296907,64,310567
26168,0.055721,172.31.40.0-255,172,297079,64,310567
26169,0.055752,172.31.40.0-255,1112,298191,64,310567
26170,0.055861,172.31.40.0-255,570,298761,64,310567
26171,0.057284,104.244.42.0-255,66,298827,64,310567
26172,0.057293,104.244.42.0-255,66,298893,64,310567
26173,0.057395,104.244.42.0-255,66,298959,64,310567
26174,0.057549,74.125.200.0-255,5738,304697,64,310567
26175,0.057556,172.31.40.0-255,66,304763,64,310567
26176,0.059593,74.125.200.0-255,5738,310501,64,310567
26177,0.059601,172.31.40.0-255,66,310567,64,310567
26178,0.0,74.125.200.0-255,153,153,64,207864
26179,2.5e-05,172.31.40.0-255,66,219,64,207864
26180,3.3e-05,74.125.200.0-255,1484,1703,64,207864
26181,3.8e-05,172.31.40.0-255,66,1769,64,207864
26182,5.3e-05,74.125.200.0-255,2902,4671,64,207864
26183,5.7e-05,172.31.40.0-255,66,4737,64,207864
26184,6.5e-05,74.125.200.0-255,7156,11893,64,207864
26185,6.9e-05,172.31.40.0-255,66,11959,64,207864
26186,8e-05,172.31.40.0-255,66,12025,64,207864
26187,8.7e-05,74.125.200.0-255,7156,19181,64,207864
26188,9e-05,172.31.40.0-255,66,19247,64,207864
26189,0.000116,74.125.200.0-255,3961,23208,64,207864
26190,0.000119,172.31.40.0-255,66,23274,64,207864
26191,0.000559,74.125.200.0-255,1484,24758,64,207864
26192,0.000566,172.31.40.0-255,66,24824,64,207864
26193,0.000571,74.125.200.0-255,1484,26308,64,207864
26194,0.000574,172.31.40.0-255,66,26374,64,207864
26195,0.000585,74.125.200.0-255,2902,29276,64,207864
26196,0.000588,172.31.40.0-255,66,29342,64,207864
26197,0.000593,74.125.200.0-255,4320,33662,64,207864
26198,0.000596,172.31.40.0-255,66,33728,64,207864
26199,0.000626,74.125.200.0-255,1484,35212,64,207864
26200,0.000629,172.31.40.0-255,66,35278,64,207864
26201,0.000642,172.31.40.0-255,66,35344,64,207864
26202,0.000666,74.125.200.0-255,2902,38246,64,207864
26203,0.000668,172.31.40.0-255,66,38312,64,207864
26204,0.000706,172.31.40.0-255,66,38378,64,207864
26205,0.000721,74.125.200.0-255,766,39144,64,207864
26206,0.000724,172.31.40.0-255,66,39210,64,207864
26207,0.000942,74.125.200.0-255,364,39574,64,207864
26208,0.001011,74.125.200.0-255,126,39700,64,207864
26209,0.001125,172.31.40.0-255,66,39766,64,207864
26210,0.001673,74.125.200.0-255,1484,41250,64,207864
26211,0.001695,74.125.200.0-255,1484,42734,64,207864
26212,0.001701,172.31.40.0-255,66,42800,64,207864
26213,0.001721,74.125.200.0-255,1484,44284,64,207864
26214,0.001725,74.125.200.0-255,1484,45768,64,207864
26215,0.001727,172.31.40.0-255,66,45834,64,207864
26216,0.001732,74.125.200.0-255,2902,48736,64,207864
26217,0.001734,172.31.40.0-255,66,48802,64,207864
26218,0.00174,74.125.200.0-255,5738,54540,64,207864
26219,0.001742,172.31.40.0-255,66,54606,64,207864
26220,0.001754,172.31.40.0-255,66,54672,64,207864
26221,0.001767,74.125.200.0-255,2902,57574,64,207864
26222,0.001769,172.31.40.0-255,66,57640,64,207864
26223,0.001791,74.125.200.0-255,1484,59124,64,207864
26224,0.001816,74.125.200.0-255,5020,64144,64,207864
26225,0.001819,172.31.40.0-255,66,64210,64,207864
26226,0.004136,74.125.200.0-255,1484,65694,64,207864
26227,0.00418,74.125.200.0-255,4320,70014,64,207864
26228,0.004184,172.31.40.0-255,66,70080,64,207864
26229,0.006525,74.125.200.0-255,5738,75818,64,207864
26230,0.006536,172.31.40.0-255,66,75884,64,207864
26231,0.008878,74.125.200.0-255,5738,81622,64,207864
26232,0.008886,172.31.40.0-255,66,81688,64,207864
26233,0.011231,74.125.200.0-255,5738,87426,64,207864
26234,0.011242,172.31.40.0-255,66,87492,64,207864
26235,0.013589,74.125.200.0-255,5738,93230,64,207864
26236,0.013602,172.31.40.0-255,66,93296,64,207864
26237,0.015937,74.125.200.0-255,5738,99034,64,207864
26238,0.01595,172.31.40.0-255,66,99100,64,207864
26239,0.018311,74.125.200.0-255,5738,104838,64,207864
26240,0.018329,172.31.40.0-255,66,104904,64,207864
26241,0.020683,74.125.200.0-255,5738,110642,64,207864
26242,0.020701,172.31.40.0-255,66,110708,64,207864
26243,0.023052,74.125.200.0-255,5738,116446,64,207864
26244,0.023064,172.31.40.0-255,66,116512,64,207864
26245,0.025415,74.125.200.0-255,5738,122250,64,207864
26246,0.025433,172.31.40.0-255,66,122316,64,207864
26247,0.027789,74.125.200.0-255,5738,128054,64,207864
26248,0.027807,172.31.40.0-255,66,128120,64,207864
26249,0.028436,172.31.40.0-255,172,128292,64,207864
26250,0.028472,172.31.40.0-255,1112,129404,64,207864
26251,0.02855,172.31.40.0-255,1514,130918,64,207864
26252,0.028552,172.31.40.0-255,1296,132214,64,207864
26253,0.029977,104.244.42.0-255,66,132280,64,207864
26254,0.03006,104.244.42.0-255,66,132346,64,207864
26255,0.030105,104.244.42.0-255,66,132412,64,207864
26256,0.030149,74.125.200.0-255,5738,138150,64,207864
26257,0.030158,172.31.40.0-255,66,138216,64,207864
26258,0.032511,74.125.200.0-255,5738,143954,64,207864
26259,0.032525,172.31.40.0-255,66,144020,64,207864
26260,0.034866,74.125.200.0-255,5738,149758,64,207864
26261,0.034875,172.31.40.0-255,66,149824,64,207864
26262,0.037224,74.125.200.0-255,5738,155562,64,207864
26263,0.037232,172.31.40.0-255,66,155628,64,207864
26264,0.039571,74.125.200.0-255,5738,161366,64,207864
26265,0.03958,172.31.40.0-255,66,161432,64,207864
26266,0.041931,74.125.200.0-255,5738,167170,64,207864
26267,0.041939,172.31.40.0-255,66,167236,64,207864
26268,0.044272,74.125.200.0-255,5738,172974,64,207864
26269,0.044284,172.31.40.0-255,66,173040,64,207864
26270,0.046626,74.125.200.0-255,5738,178778,64,207864
26271,0.046632,172.31.40.0-255,66,178844,64,207864
26272,0.048993,74.125.200.0-255,5738,184582,64,207864
26273,0.049004,172.31.40.0-255,66,184648,64,207864
26274,0.051344,74.125.200.0-255,5738,190386,64,207864
26275,0.051351,172.31.40.0-255,66,190452,64,207864
26276,0.053725,74.125.200.0-255,5738,196190,64,207864
26277,0.053732,172.31.40.0-255,66,196256,64,207864
26278,0.056079,74.125.200.0-255,5738,201994,64,207864
26279,0.056088,172.31.40.0-255,66,202060,64,207864
26280,0.058432,74.125.200.0-255,5738,207798,64,207864
26281,0.058439,172.31.40.0-255,66,207864,64,207864
26282,0.0,172.217.194.0-255,153,153,64,255805
26283,2.5e-05,172.31.40.0-255,66,219,64,255805
26284,3.2e-05,172.217.194.0-255,1484,1703,64,255805
26285,3.7e-05,172.31.40.0-255,66,1769,64,255805
26286,5.2e-05,172.217.194.0-255,2902,4671,64,255805
26287,5.6e-05,172.31.40.0-255,66,4737,64,255805
26288,6.4e-05,172.217.194.0-255,5738,10475,64,255805
26289,6.6e-05,172.31.40.0-255,66,10541,64,255805
26290,8.2e-05,172.31.40.0-255,66,10607,64,255805
26291,8.7e-05,172.217.194.0-255,2902,13509,64,255805
26292,8.9e-05,172.31.40.0-255,66,13575,64,255805
26293,0.000109,172.217.194.0-255,3961,17536,64,255805
26294,0.000112,172.31.40.0-255,66,17602,64,255805
26295,0.00016,172.217.194.0-255,1484,19086,64,255805
26296,0.000163,172.31.40.0-255,66,19152,64,255805
26297,0.000166,172.217.194.0-255,1484,20636,64,255805
26298,0.000169,172.31.40.0-255,66,20702,64,255805
26299,0.000208,172.217.194.0-255,1484,22186,64,255805
26300,0.00021,172.31.40.0-255,66,22252,64,255805
26301,0.000218,172.217.194.0-255,5738,27990,64,255805
26302,0.00022,172.31.40.0-255,66,28056,64,255805
26303,0.000239,172.31.40.0-255,66,28122,64,255805
26304,0.00025,172.31.40.0-255,66,28188,64,255805
26305,0.000279,172.217.194.0-255,2797,30985,64,255805
26306,0.000281,172.31.40.0-255,66,31051,64,255805
26307,0.00042,172.217.194.0-255,1484,32535,64,255805
26308,0.000424,172.31.40.0-255,66,32601,64,255805
26309,0.000429,172.217.194.0-255,2902,35503,64,255805
26310,0.000432,172.31.40.0-255,66,35569,64,255805
26311,0.000455,172.217.194.0-255,5738,41307,64,255805
26312,0.000462,172.31.40.0-255,66,41373,64,255805
26313,0.000468,172.217.194.0-255,4320,45693,64,255805
26314,0.000471,172.31.40.0-255,66,45759,64,255805
26315,0.000511,172.31.40.0-255,66,45825,64,255805
26316,0.000524,172.31.40.0-255,66,45891,64,255805
26317,0.000691,172.217.194.0-255,1484,47375,64,255805
26318,0.000699,172.217.194.0-255,2902,50277,64,255805
26319,0.000702,172.31.40.0-255,66,50343,64,255805
26320,0.000709,172.217.194.0-255,5738,56081,64,255805
26321,0.000712,172.31.40.0-255,66,56147,64,255805
26322,0.000719,172.217.194.0-255,1484,57631,64,255805
26323,0.000756,172.31.40.0-255,66,57697,64,255805
26324,0.000772,172.31.40.0-255,66,57763,64,255805
26325,0.000775,172.217.194.0-255,766,58529,64,255805
26326,0.001322,172.217.194.0-255,1484,60013,64,255805
26327,0.001331,172.31.40.0-255,66,60079,64,255805
26328,0.001352,172.217.194.0-255,2902,62981,64,255805
26329,0.001354,172.31.40.0-255,66,63047,64,255805
26330,0.001361,172.217.194.0-255,5738,68785,64,255805
26331,0.001363,172.31.40.0-255,66,68851,64,255805
26332,0.001368,172.217.194.0-255,2902,71753,64,255805
26333,0.00137,172.31.40.0-255,66,71819,64,255805
26334,0.001383,172.217.194.0-255,2902,74721,64,255805
26335,0.001385,172.31.40.0-255,66,74787,64,255805
26336,0.001419,172.217.194.0-255,7156,81943,64,255805
26337,0.001422,172.31.40.0-255,66,82009,64,255805
26338,0.001433,172.217.194.0-255,5738,87747,64,255805
26339,0.001435,172.31.40.0-255,66,87813,64,255805
26340,0.001441,172.217.194.0-255,5020,92833,64,255805
26341,0.001443,172.31.40.0-255,66,92899,64,255805
26342,0.001521,172.217.194.0-255,1484,94383,64,255805
26343,0.001541,172.217.194.0-255,2902,97285,64,255805
26344,0.001545,172.31.40.0-255,66,97351,64,255805
26345,0.001552,172.217.194.0-255,5738,103089,64,255805
26346,0.001554,172.31.40.0-255,66,103155,64,255805
26347,0.001596,172.31.40.0-255,66,103221,64,255805
26348,0.001611,172.31.40.0-255,66,103287,64,255805
26349,0.001614,172.217.194.0-255,766,104053,64,255805
26350,0.001815,172.217.194.0-255,1484,105537,64,255805
26351,0.00182,172.217.194.0-255,2902,108439,64,255805
26352,0.001825,172.31.40.0-255,66,108505,64,255805
26353,0.001828,172.31.40.0-255,66,108571,64,255805
26354,0.00185,172.217.194.0-255,5738,114309,64,255805
26355,0.001853,172.31.40.0-255,66,114375,64,255805
26356,0.001858,172.217.194.0-255,4320,118695,64,255805
26357,0.00186,172.31.40.0-255,66,118761,64,255805
26358,0.001905,172.31.40.0-255,66,118827,64,255805
26359,0.001924,172.31.40.0-255,66,118893,64,255805
26360,0.002204,172.217.194.0-255,1484,120377,64,255805
26361,0.002211,172.217.194.0-255,2902,123279,64,255805
26362,0.002215,172.31.40.0-255,66,123345,64,255805
26363,0.002248,172.217.194.0-255,5738,129083,64,255805
26364,0.002251,172.31.40.0-255,66,129149,64,255805
26365,0.002276,172.31.40.0-255,66,129215,64,255805
26366,0.002348,172.31.40.0-255,66,129281,64,255805
26367,0.002365,172.31.40.0-255,66,129347,64,255805
26368,0.00466,172.217.194.0-255,5738,135085,64,255805
26369,0.00467,172.31.40.0-255,66,135151,64,255805
26370,0.006972,172.217.194.0-255,5738,140889,64,255805
26371,0.006982,172.31.40.0-255,66,140955,64,255805
26372,0.009299,172.217.194.0-255,5738,146693,64,255805
26373,0.009318,172.31.40.0-255,66,146759,64,255805
26374,0.011612,172.217.194.0-255,5738,152497,64,255805
26375,0.011629,172.31.40.0-255,66,152563,64,255805
26376,0.013919,172.217.194.0-255,5738,158301,64,255805
26377,0.013926,172.31.40.0-255,66,158367,64,255805
26378,0.016242,172.217.194.0-255,5738,164105,64,255805
26379,0.016249,172.31.40.0-255,66,164171,64,255805
26380,0.018553,172.217.194.0-255,5738,169909,64,255805
26381,0.018571,172.31.40.0-255,66,169975,64,255805
26382,0.020872,172.217.194.0-255,5738,175713,64,255805
26383,0.02088,172.31.40.0-255,66,175779,64,255805
26384,0.023176,172.217.194.0-255,5738,181517,64,255805
26385,0.02319,172.31.40.0-255,66,181583,64,255805
26386,0.025507,172.217.194.0-255,5738,187321,64,255805
26387,0.025523,172.31.40.0-255,66,187387,64,255805
26388,0.027808,172.217.194.0-255,5738,193125,64,255805
26389,0.02782,172.31.40.0-255,66,193191,64,255805
26390,0.030097,172.217.194.0-255,5738,198929,64,255805
26391,0.030107,172.31.40.0-255,66,198995,64,255805
26392,0.032402,172.217.194.0-255,5738,204733,64,255805
26393,0.03242,172.31.40.0-255,66,204799,64,255805
26394,0.034725,172.217.194.0-255,5738,210537,64,255805
26395,0.034732,172.31.40.0-255,66,210603,64,255805
26396,0.037019,172.217.194.0-255,5738,216341,64,255805
26397,0.037027,172.31.40.0-255,66,216407,64,255805
26398,0.039328,172.217.194.0-255,5738,222145,64,255805
26399,0.039338,172.31.40.0-255,66,222211,64,255805
26400,0.041662,172.217.194.0-255,5738,227949,64,255805
26401,0.041679,172.31.40.0-255,66,228015,64,255805
26402,0.043983,172.217.194.0-255,5738,233753,64,255805
26403,0.043993,172.31.40.0-255,66,233819,64,255805
26404,0.046301,172.217.194.0-255,5738,239557,64,255805
26405,0.046312,172.31.40.0-255,66,239623,64,255805
26406,0.048608,172.217.194.0-255,5738,245361,64,255805
26407,0.048615,172.31.40.0-255,66,245427,64,255805
26408,0.050947,172.217.194.0-255,5738,251165,64,255805
26409,0.050957,172.31.40.0-255,66,251231,64,255805
26410,0.05324,172.217.194.0-255,4337,255568,64,255805
26411,0.053248,172.31.40.0-255,66,255634,64,255805
26412,0.053433,172.31.40.0-255,105,255739,64,255805
26413,0.055695,172.217.194.0-255,66,255805,64,255805
26414,0.0,74.125.24.0-255,153,153,64,157571
26415,1.6e-05,172.31.40.0-255,66,219,64,157571
26416,2.2e-05,74.125.24.0-255,1484,1703,64,157571
26417,2.6e-05,172.31.40.0-255,66,1769,64,157571
26418,3.1e-05,74.125.24.0-255,2902,4671,64,157571
26419,3.3e-05,172.31.40.0-255,66,4737,64,157571
26420,4e-05,74.125.24.0-255,7156,11893,64,157571
26421,4.2e-05,172.31.40.0-255,66,11959,64,157571
26422,4.6e-05,74.125.24.0-255,2061,14020,64,157571
26423,4.9e-05,172.31.40.0-255,66,14086,64,157571
26424,0.000126,74.125.24.0-255,1484,15570,64,157571
26425,0.000129,172.31.40.0-255,66,15636,64,157571
26426,0.000134,74.125.24.0-255,2902,18538,64,157571
26427,0.000136,172.31.40.0-255,66,18604,64,157571
26428,0.00015,74.125.24.0-255,5738,24342,64,157571
26429,0.000153,172.31.40.0-255,66,24408,64,157571
26430,0.000155,74.125.24.0-255,1484,25892,64,157571
26431,0.000157,172.31.40.0-255,66,25958,64,157571
26432,0.000179,74.125.24.0-255,1484,27442,64,157571
26433,0.000181,172.31.40.0-255,66,27508,64,157571
26434,0.000209,172.31.40.0-255,66,27574,64,157571
26435,0.000221,172.31.40.0-255,66,27640,64,157571
26436,0.000236,74.125.24.0-255,4320,31960,64,157571
26437,0.000239,172.31.40.0-255,66,32026,64,157571
26438,0.000276,172.31.40.0-255,66,32092,64,157571
26439,0.000278,74.125.24.0-255,136,32228,64,157571
26440,0.00028,172.31.40.0-255,66,32294,64,157571
26441,0.00039,74.125.24.0-255,1484,33778,64,157571
26442,0.000393,172.31.40.0-255,66,33844,64,157571
26443,0.000398,74.125.24.0-255,2902,36746,64,157571
26444,0.000409,74.125.24.0-255,1484,38230,64,157571
26445,0.000426,74.125.24.0-255,4320,42550,64,157571
26446,0.00044,172.31.40.0-255,66,42616,64,157571
26447,0.000511,74.125.24.0-255,1484,44100,64,157571
26448,0.000517,172.31.40.0-255,66,44166,64,157571
26449,0.000535,74.125.24.0-255,2902,47068,64,157571
26450,0.000541,74.125.24.0-255,5738,52806,64,157571
26451,0.000547,172.31.40.0-255,66,52872,64,157571
26452,0.000562,74.125.24.0-255,7156,60028,64,157571
26453,0.000579,74.125.24.0-255,1484,61512,64,157571
26454,0.000585,172.31.40.0-255,66,61578,64,157571
26455,0.000602,74.125.24.0-255,1879,63457,64,157571
26456,0.000607,172.31.40.0-255,66,63523,64,157571
26457,0.000659,74.125.24.0-255,1484,65007,64,157571
26458,0.000664,74.125.24.0-255,2902,67909,64,157571
26459,0.000681,74.125.24.0-255,5738,73647,64,157571
26460,0.000688,172.31.40.0-255,66,73713,64,157571
26461,0.000708,74.125.24.0-255,2902,76615,64,157571
26462,0.000715,172.31.40.0-255,66,76681,64,157571
26463,0.000734,74.125.24.0-255,7156,83837,64,157571
26464,0.000751,172.31.40.0-255,66,83903,64,157571
26465,0.000765,74.125.24.0-255,2184,86087,64,157571
26466,0.000783,172.31.40.0-255,66,86153,64,157571
26467,0.000815,74.125.24.0-255,1484,87637,64,157571
26468,0.000818,74.125.24.0-255,1484,89121,64,157571
26469,0.000822,172.31.40.0-255,66,89187,64,157571
26470,0.00083,74.125.24.0-255,1484,90671,64,157571
26471,0.000834,74.125.24.0-255,2902,93573,64,157571
26472,0.000838,172.31.40.0-255,66,93639,64,157571
26473,0.00085,74.125.24.0-255,2902,96541,64,157571
26474,0.000855,74.125.24.0-255,5738,102279,64,157571
26475,0.000868,172.31.40.0-255,66,102345,64,157571
26476,0.000898,74.125.24.0-255,1125,103470,64,157571
26477,0.000992,74.125.24.0-255,1484,104954,64,157571
26478,0.001006,172.31.40.0-255,66,105020,64,157571
26479,0.001013,74.125.24.0-255,1484,106504,64,157571
26480,0.001023,74.125.24.0-255,1484,107988,64,157571
26481,0.001028,74.125.24.0-255,4320,112308,64,157571
26482,0.00106,172.31.40.0-255,66,112374,64,157571
26483,0.001087,172.31.40.0-255,66,112440,64,157571
26484,0.001126,74.125.24.0-255,6438,118878,64,157571
26485,0.00114,172.31.40.0-255,66,118944,64,157571
26486,0.00116,74.125.24.0-255,2902,121846,64,157571
26487,0.00117,172.31.40.0-255,66,121912,64,157571
26488,0.00118,74.125.24.0-255,4320,126232,64,157571
26489,0.001196,74.125.24.0-255,2902,129134,64,157571
26490,0.001209,172.31.40.0-255,66,129200,64,157571
26491,0.001215,74.125.24.0-255,5738,134938,64,157571
26492,0.001219,172.31.40.0-255,66,135004,64,157571
26493,0.001227,74.125.24.0-255,4320,139324,64,157571
26494,0.001257,74.125.24.0-255,766,140090,64,157571
26495,0.001279,74.125.24.0-255,5738,145828,64,157571
26496,0.001282,172.31.40.0-255,66,145894,64,157571
26497,0.001288,172.31.40.0-255,66,145960,64,157571
26498,0.001345,172.31.40.0-255,66,146026,64,157571
26499,0.001389,74.125.24.0-255,1484,147510,64,157571
26500,0.001397,172.31.40.0-255,66,147576,64,157571
26501,0.001466,172.31.40.0-255,66,147642,64,157571
26502,0.001492,172.31.40.0-255,66,147708,64,157571
26503,0.001524,74.125.24.0-255,1484,149192,64,157571
26504,0.001526,172.31.40.0-255,66,149258,64,157571
26505,0.001569,172.31.40.0-255,66,149324,64,157571
26506,0.001582,172.31.40.0-255,66,149390,64,157571
26507,0.001591,74.125.24.0-255,3479,152869,64,157571
26508,0.001608,172.31.40.0-255,66,152935,64,157571
26509,0.001629,74.125.24.0-255,105,153040,64,157571
26510,0.004148,172.31.40.0-255,66,153106,64,157571
26511,0.004185,172.31.40.0-255,105,153211,64,157571
26512,0.006455,74.125.24.0-255,66,153277,64,157571
26513,0.046469,172.31.40.0-255,172,153449,64,157571
26514,0.046501,172.31.40.0-255,1112,154561,64,157571
26515,0.046564,172.31.40.0-255,1514,156075,64,157571
26516,0.046566,172.31.40.0-255,1298,157373,64,157571
26517,0.048021,104.244.42.0-255,66,157439,64,157571
26518,0.048049,104.244.42.0-255,66,157505,64,157571
26519,0.048107,104.244.42.0-255,66,157571,64,157571
26520,0.0,172.217.194.0-255,152,152,64,210941
26521,2.3e-05,172.31.40.0-255,66,218,64,210941
26522,3e-05,172.217.194.0-255,1484,1702,64,210941
26523,3.5e-05,172.31.40.0-255,66,1768,64,210941
26524,4.1e-05,172.217.194.0-255,2902,4670,64,210941
26525,4.4e-05,172.31.40.0-255,66,4736,64,210941
26526,5.2e-05,172.217.194.0-255,7156,11892,64,210941
26527,5.5e-05,172.31.40.0-255,66,11958,64,210941
26528,5.9e-05,172.217.194.0-255,1976,13934,64,210941
26529,6.2e-05,172.31.40.0-255,66,14000,64,210941
26530,7.5e-05,172.31.40.0-255,66,14066,64,210941
26531,0.000107,172.217.194.0-255,5379,19445,64,210941
26532,0.000111,172.31.40.0-255,66,19511,64,210941
26533,0.000161,172.217.194.0-255,1484,20995,64,210941
26534,0.000164,172.31.40.0-255,66,21061,64,210941
26535,0.000169,172.217.194.0-255,2902,23963,64,210941
26536,0.000171,172.31.40.0-255,66,24029,64,210941
26537,0.000194,172.217.194.0-255,5738,29767,64,210941
26538,0.000196,172.31.40.0-255,66,29833,64,210941
26539,0.000201,172.217.194.0-255,2902,32735,64,210941
26540,0.000203,172.31.40.0-255,66,32801,64,210941
26541,0.000225,172.217.194.0-255,3961,36762,64,210941
26542,0.000227,172.31.40.0-255,66,36828,64,210941
26543,0.000242,172.217.194.0-255,4320,41148,64,210941
26544,0.000245,172.31.40.0-255,66,41214,64,210941
26545,0.000259,172.217.194.0-255,7156,48370,64,210941
26546,0.000262,172.31.40.0-255,66,48436,64,210941
26547,0.000283,172.217.194.0-255,2902,51338,64,210941
26548,0.000285,172.31.40.0-255,66,51404,64,210941
26549,0.000304,172.217.194.0-255,2836,54240,64,210941
26550,0.000306,172.31.40.0-255,66,54306,64,210941
26551,0.000309,172.217.194.0-255,365,54671,64,210941
26552,0.000357,172.217.194.0-255,1484,56155,64,210941
26553,0.00036,172.31.40.0-255,66,56221,64,210941
26554,0.000366,172.217.194.0-255,4320,60541,64,210941
26555,0.000368,172.31.40.0-255,66,60607,64,210941
26556,0.000397,172.31.40.0-255,66,60673,64,210941
26557,0.000413,172.217.194.0-255,1484,62157,64,210941
26558,0.000416,172.217.194.0-255,573,62730,64,210941
26559,0.000418,172.31.40.0-255,66,62796,64,210941
26560,0.000421,172.217.194.0-255,1484,64280,64,210941
26561,0.000424,172.217.194.0-255,1484,65764,64,210941
26562,0.000425,172.31.40.0-255,66,65830,64,210941
26563,0.000442,172.217.194.0-255,2902,68732,64,210941
26564,0.000444,172.31.40.0-255,66,68798,64,210941
26565,0.00045,172.217.194.0-255,4320,73118,64,210941
26566,0.000452,172.31.40.0-255,66,73184,64,210941
26567,0.00048,172.217.194.0-255,4320,77504,64,210941
26568,0.000482,172.31.40.0-255,66,77570,64,210941
26569,0.000486,172.217.194.0-255,2543,80113,64,210941
26570,0.000489,172.31.40.0-255,66,80179,64,210941
26571,0.000522,172.217.194.0-255,1484,81663,64,210941
26572,0.000527,172.217.194.0-255,2902,84565,64,210941
26573,0.00053,172.31.40.0-255,66,84631,64,210941
26574,0.000533,172.217.194.0-255,1484,86115,64,210941
26575,0.000556,172.217.194.0-255,4320,90435,64,210941
26576,0.000558,172.31.40.0-255,66,90501,64,210941
26577,0.00057,172.31.40.0-255,66,90567,64,210941
26578,0.000597,172.217.194.0-255,4320,94887,64,210941
26579,0.0006,172.31.40.0-255,66,94953,64,210941
26580,0.000612,172.31.40.0-255,66,95019,64,210941
26581,0.000614,172.217.194.0-255,766,95785,64,210941
26582,0.000675,172.217.194.0-255,1484,97269,64,210941
26583,0.000678,172.31.40.0-255,66,97335,64,210941
26584,0.00072,172.217.194.0-255,2902,100237,64,210941
26585,0.000722,172.31.40.0-255,66,100303,64,210941
26586,0.000744,172.217.194.0-255,2902,103205,64,210941
26587,0.000746,172.31.40.0-255,66,103271,64,210941
26588,0.000779,172.217.194.0-255,2902,106173,64,210941
26589,0.000782,172.31.40.0-255,66,106239,64,210941
26590,0.000786,172.217.194.0-255,2902,109141,64,210941
26591,0.000789,172.31.40.0-255,66,109207,64,210941
26592,0.000811,172.31.40.0-255,66,109273,64,210941
26593,0.000819,172.217.194.0-255,1484,110757,64,210941
26594,0.000859,172.217.194.0-255,4320,115077,64,210941
26595,0.000863,172.31.40.0-255,66,115143,64,210941
26596,0.000885,172.217.194.0-255,6438,121581,64,210941
26597,0.000888,172.31.40.0-255,66,121647,64,210941
26598,0.000893,172.217.194.0-255,4320,125967,64,210941
26599,0.000895,172.31.40.0-255,66,126033,64,210941
26600,0.000945,172.31.40.0-255,66,126099,64,210941
26601,0.000962,172.217.194.0-255,4320,130419,64,210941
26602,0.000965,172.31.40.0-255,66,130485,64,210941
26603,0.000976,172.31.40.0-255,66,130551,64,210941
26604,0.001017,172.31.40.0-255,66,130617,64,210941
26605,0.001029,172.31.40.0-255,66,130683,64,210941
26606,0.001042,172.31.40.0-255,66,130749,64,210941
26607,0.001055,172.31.40.0-255,66,130815,64,210941
26608,0.001077,172.217.194.0-255,766,131581,64,210941
26609,0.001133,172.217.194.0-255,1484,133065,64,210941
26610,0.001136,172.31.40.0-255,66,133131,64,210941
26611,0.001141,172.217.194.0-255,2902,136033,64,210941
26612,0.001143,172.31.40.0-255,66,136099,64,210941
26613,0.001148,172.217.194.0-255,2902,139001,64,210941
26614,0.00115,172.31.40.0-255,66,139067,64,210941
26615,0.001171,172.217.194.0-255,2902,141969,64,210941
26616,0.001173,172.31.40.0-255,66,142035,64,210941
26617,0.00118,172.217.194.0-255,5738,147773,64,210941
26618,0.001182,172.31.40.0-255,66,147839,64,210941
26619,0.001212,172.217.194.0-255,7156,154995,64,210941
26620,0.001215,172.31.40.0-255,66,155061,64,210941
26621,0.001225,172.31.40.0-255,66,155127,64,210941
26622,0.001263,172.217.194.0-255,2184,157311,64,210941
26623,0.001266,172.31.40.0-255,66,157377,64,210941
26624,0.001498,172.217.194.0-255,1484,158861,64,210941
26625,0.001504,172.217.194.0-255,2902,161763,64,210941
26626,0.001507,172.31.40.0-255,66,161829,64,210941
26627,0.001534,172.217.194.0-255,5738,167567,64,210941
26628,0.001537,172.31.40.0-255,66,167633,64,210941
26629,0.001578,172.31.40.0-255,66,167699,64,210941
26630,0.00159,172.31.40.0-255,66,167765,64,210941
26631,0.001652,172.217.194.0-255,1484,169249,64,210941
26632,0.00167,172.217.194.0-255,2902,172151,64,210941
26633,0.001673,172.31.40.0-255,66,172217,64,210941
26634,0.00168,172.217.194.0-255,5738,177955,64,210941
26635,0.001683,172.31.40.0-255,66,178021,64,210941
26636,0.001695,172.31.40.0-255,66,178087,64,210941
26637,0.001717,172.217.194.0-255,1484,179571,64,210941
26638,0.001731,172.217.194.0-255,2902,182473,64,210941
26639,0.001734,172.31.40.0-255,66,182539,64,210941
26640,0.001765,172.31.40.0-255,66,182605,64,210941
26641,0.001768,172.217.194.0-255,1484,184089,64,210941
26642,0.00179,172.217.194.0-255,2902,186991,64,210941
26643,0.001793,172.31.40.0-255,66,187057,64,210941
26644,0.001812,172.217.194.0-255,2902,189959,64,210941
26645,0.001815,172.31.40.0-255,66,190025,64,210941
26646,0.001826,172.31.40.0-255,66,190091,64,210941
26647,0.001843,172.31.40.0-255,66,190157,64,210941
26648,0.001846,172.217.194.0-255,766,190923,64,210941
26649,0.001879,172.217.194.0-255,7156,198079,64,210941
26650,0.001884,172.31.40.0-255,66,198145,64,210941
26651,0.001917,172.31.40.0-255,66,198211,64,210941
26652,0.001923,172.217.194.0-255,4067,202278,64,210941
26653,0.001925,172.31.40.0-255,66,202344,64,210941
26654,0.001948,172.217.194.0-255,105,202449,64,210941
26655,0.014663,172.31.40.0-255,66,202515,64,210941
26656,0.014718,172.31.40.0-255,105,202620,64,210941
26657,0.017002,172.217.194.0-255,66,202686,64,210941
26658,0.048126,172.31.40.0-255,172,202858,64,210941
26659,0.048172,172.31.40.0-255,1111,203969,64,210941
26660,0.048241,172.31.40.0-255,1514,205483,64,210941
26661,0.048243,172.31.40.0-255,1514,206997,64,210941
26662,0.048245,172.31.40.0-255,1514,208511,64,210941
26663,0.048247,172.31.40.0-255,1514,210025,64,210941
26664,0.048276,172.31.40.0-255,478,210503,64,210941
26665,0.049683,104.244.42.0-255,66,210569,64,210941
26666,0.049739,104.244.42.0-255,66,210635,64,210941
26667,0.049812,104.244.42.0-255,66,210701,64,210941
26668,0.049817,104.244.42.0-255,66,210767,64,210941
26669,0.050532,104.244.42.0-255,108,210875,64,210941
26670,0.050548,172.31.40.0-255,66,210941,64,210941
26671,0.0,74.125.68.0-255,153,153,64,375588
26672,2.9e-05,172.31.40.0-255,66,219,64,375588
26673,3.5e-05,74.125.68.0-255,1484,1703,64,375588
26674,4e-05,172.31.40.0-255,66,1769,64,375588
26675,4.5e-05,74.125.68.0-255,2902,4671,64,375588
26676,4.7e-05,172.31.40.0-255,66,4737,64,375588
26677,6.1e-05,74.125.68.0-255,1484,6221,64,375588
26678,6.3e-05,172.31.40.0-255,66,6287,64,375588
26679,7.7e-05,74.125.68.0-255,4320,10607,64,375588
26680,8e-05,172.31.40.0-255,66,10673,64,375588
26681,8.3e-05,74.125.68.0-255,1484,12157,64,375588
26682,8.4e-05,172.31.40.0-255,66,12223,64,375588
26683,0.000108,74.125.68.0-255,2000,14223,64,375588
26684,0.000111,172.31.40.0-255,66,14289,64,375588
26685,0.000115,74.125.68.0-255,4320,18609,64,375588
26686,0.000117,172.31.40.0-255,66,18675,64,375588
26687,0.00012,74.125.68.0-255,1484,20159,64,375588
26688,0.000122,172.31.40.0-255,66,20225,64,375588
26689,0.000155,172.31.40.0-255,66,20291,64,375588
26690,0.00017,74.125.68.0-255,2543,22834,64,375588
26691,0.000172,172.31.40.0-255,66,22900,64,375588
26692,0.000274,74.125.68.0-255,1484,24384,64,375588
26693,0.000278,172.31.40.0-255,66,24450,64,375588
26694,0.000283,74.125.68.0-255,2902,27352,64,375588
26695,0.000286,172.31.40.0-255,66,27418,64,375588
26696,0.000305,74.125.68.0-255,1484,28902,64,375588
26697,0.00031,172.31.40.0-255,66,28968,64,375588
26698,0.000317,74.125.68.0-255,4320,33288,64,375588
26699,0.00032,172.31.40.0-255,66,33354,64,375588
26700,0.000325,74.125.68.0-255,2902,36256,64,375588
26701,0.000328,172.31.40.0-255,66,36322,64,375588
26702,0.000352,74.125.68.0-255,3961,40283,64,375588
26703,0.000356,172.31.40.0-255,66,40349,64,375588
26704,0.000362,74.125.68.0-255,7156,47505,64,375588
26705,0.000365,172.31.40.0-255,66,47571,64,375588
26706,0.000407,172.31.40.0-255,66,47637,64,375588
26707,0.000426,74.125.68.0-255,1435,49072,64,375588
26708,0.000522,74.125.68.0-255,344,49416,64,375588
26709,0.000525,172.31.40.0-255,66,49482,64,375588
26710,0.00068,74.125.68.0-255,1484,50966,64,375588
26711,0.0007,74.125.68.0-255,2902,53868,64,375588
26712,0.000703,172.31.40.0-255,66,53934,64,375588
26713,0.000708,74.125.68.0-255,2902,56836,64,375588
26714,0.00071,172.31.40.0-255,66,56902,64,375588
26715,0.000724,74.125.68.0-255,2902,59804,64,375588
26716,0.000727,172.31.40.0-255,66,59870,64,375588
26717,0.000757,74.125.68.0-255,5738,65608,64,375588
26718,0.000759,172.31.40.0-255,66,65674,64,375588
26719,0.000798,74.125.68.0-255,1125,66799,64,375588
26720,0.000814,74.125.68.0-255,1484,68283,64,375588
26721,0.000817,172.31.40.0-255,66,68349,64,375588
26722,0.000841,74.125.68.0-255,1484,69833,64,375588
26723,0.00088,74.125.68.0-255,2902,72735,64,375588
26724,0.000883,172.31.40.0-255,66,72801,64,375588
26725,0.000907,74.125.68.0-255,4320,77121,64,375588
26726,0.000911,172.31.40.0-255,66,77187,64,375588
26727,0.000912,74.125.68.0-255,4320,81507,64,375588
26728,0.000915,172.31.40.0-255,66,81573,64,375588
26729,0.000929,74.125.68.0-255,1484,83057,64,375588
26730,0.000932,74.125.68.0-255,1125,84182,64,375588
26731,0.000935,172.31.40.0-255,66,84248,64,375588
26732,0.001096,74.125.68.0-255,1484,85732,64,375588
26733,0.001138,74.125.68.0-255,2902,88634,64,375588
26734,0.001143,172.31.40.0-255,66,88700,64,375588
26735,0.001148,74.125.68.0-255,4320,93020,64,375588
26736,0.00115,172.31.40.0-255,66,93086,64,375588
26737,0.001162,74.125.68.0-255,1484,94570,64,375588
26738,0.001166,74.125.68.0-255,2902,97472,64,375588
26739,0.001168,172.31.40.0-255,66,97538,64,375588
26740,0.001188,74.125.68.0-255,2902,100440,64,375588
26741,0.001191,172.31.40.0-255,66,100506,64,375588
26742,0.001195,74.125.68.0-255,2902,103408,64,375588
26743,0.001197,172.31.40.0-255,66,103474,64,375588
26744,0.001213,74.125.68.0-255,4320,107794,64,375588
26745,0.001216,172.31.40.0-255,66,107860,64,375588
26746,0.001226,172.31.40.0-255,66,107926,64,375588
26747,0.001312,74.125.68.0-255,1484,109410,64,375588
26748,0.001326,74.125.68.0-255,2902,112312,64,375588
26749,0.001329,172.31.40.0-255,66,112378,64,375588
26750,0.001346,74.125.68.0-255,1484,113862,64,375588
26751,0.001365,74.125.68.0-255,4320,118182,64,375588
26752,0.001367,172.31.40.0-255,66,118248,64,375588
26753,0.001371,74.125.68.0-255,2902,121150,64,375588
26754,0.001373,172.31.40.0-255,66,121216,64,375588
26755,0.0014,74.125.68.0-255,4320,125536,64,375588
26756,0.001402,172.31.40.0-255,66,125602,64,375588
26757,0.001412,74.125.68.0-255,1484,127086,64,375588
26758,0.001427,74.125.68.0-255,2902,129988,64,375588
26759,0.00143,172.31.40.0-255,66,130054,64,375588
26760,0.001459,74.125.68.0-255,2902,132956,64,375588
26761,0.001462,172.31.40.0-255,66,133022,64,375588
26762,0.00148,74.125.68.0-255,2902,135924,64,375588
26763,0.001482,172.31.40.0-255,66,135990,64,375588
26764,0.001485,74.125.68.0-255,1484,137474,64,375588
26765,0.001508,74.125.68.0-255,5020,142494,64,375588
26766,0.00151,172.31.40.0-255,66,142560,64,375588
26767,0.001553,74.125.68.0-255,1484,144044,64,375588
26768,0.001565,74.125.68.0-255,2902,146946,64,375588
26769,0.001568,172.31.40.0-255,66,147012,64,375588
26770,0.001588,74.125.68.0-255,5738,152750,64,375588
26771,0.001591,172.31.40.0-255,66,152816,64,375588
26772,0.001608,74.125.68.0-255,4320,157136,64,375588
26773,0.001611,172.31.40.0-255,66,157202,64,375588
26774,0.00163,74.125.68.0-255,1484,158686,64,375588
26775,0.001636,74.125.68.0-255,5738,164424,64,375588
26776,0.001639,172.31.40.0-255,66,164490,64,375588
26777,0.001655,74.125.68.0-255,1484,165974,64,375588
26778,0.00166,74.125.68.0-255,4320,170294,64,375588
26779,0.001662,172.31.40.0-255,66,170360,64,375588
26780,0.001677,74.125.68.0-255,1484,171844,64,375588
26781,0.00171,74.125.68.0-255,5020,176864,64,375588
26782,0.001715,172.31.40.0-255,66,176930,64,375588
26783,0.001718,74.125.68.0-255,1484,178414,64,375588
26784,0.001736,74.125.68.0-255,4320,182734,64,375588
26785,0.001738,172.31.40.0-255,66,182800,64,375588
26786,0.001751,74.125.68.0-255,1484,184284,64,375588
26787,0.001777,172.31.40.0-255,66,184350,64,375588
26788,0.001802,172.31.40.0-255,66,184416,64,375588
26789,0.001824,74.125.68.0-255,5738,190154,64,375588
26790,0.001826,172.31.40.0-255,66,190220,64,375588
26791,0.001828,74.125.68.0-255,766,190986,64,375588
26792,0.001858,74.125.68.0-255,1484,192470,64,375588
26793,0.001859,172.31.40.0-255,66,192536,64,375588
26794,0.001878,74.125.68.0-255,2902,195438,64,375588
26795,0.00188,172.31.40.0-255,66,195504,64,375588
26796,0.001911,74.125.68.0-255,2902,198406,64,375588
26797,0.001913,172.31.40.0-255,66,198472,64,375588
26798,0.001927,74.125.68.0-255,1484,199956,64,375588
26799,0.001929,74.125.68.0-255,1484,201440,64,375588
26800,0.001931,172.31.40.0-255,66,201506,64,375588
26801,0.001958,74.125.68.0-255,4320,205826,64,375588
26802,0.00196,172.31.40.0-255,66,205892,64,375588
26803,0.001963,74.125.68.0-255,1484,207376,64,375588
26804,0.001979,74.125.68.0-255,1484,208860,64,375588
26805,0.001981,172.31.40.0-255,66,208926,64,375588
26806,0.001985,74.125.68.0-255,4320,213246,64,375588
26807,0.001987,172.31.40.0-255,66,213312,64,375588
26808,0.002012,74.125.68.0-255,1484,214796,64,375588
26809,0.002064,74.125.68.0-255,2902,217698,64,375588
26810,0.002066,172.31.40.0-255,66,217764,64,375588
26811,0.002087,74.125.68.0-255,4320,222084,64,375588
26812,0.002089,172.31.40.0-255,66,222150,64,375588
26813,0.002106,74.125.68.0-255,1484,223634,64,375588
26814,0.002123,74.125.68.0-255,2184,225818,64,375588
26815,0.002124,172.31.40.0-255,66,225884,64,375588
26816,0.002267,74.125.68.0-255,1484,227368,64,375588
26817,0.00227,74.125.68.0-255,1484,228852,64,375588
26818,0.002271,172.31.40.0-255,66,228918,64,375588
26819,0.002283,74.125.68.0-255,1484,230402,64,375588
26820,0.002292,74.125.68.0-255,2902,233304,64,375588
26821,0.002294,172.31.40.0-255,66,233370,64,375588
26822,0.002308,74.125.68.0-255,2902,236272,64,375588
26823,0.002309,172.31.40.0-255,66,236338,64,375588
26824,0.002318,74.125.68.0-255,1484,237822,64,375588
26825,0.002332,74.125.68.0-255,2902,240724,64,375588
26826,0.002334,172.31.40.0-255,66,240790,64,375588
26827,0.002352,74.125.68.0-255,4320,245110,64,375588
26828,0.002354,172.31.40.0-255,66,245176,64,375588
26829,0.002361,74.125.68.0-255,1484,246660,64,375588
26830,0.002373,74.125.68.0-255,4320,250980,64,375588
26831,0.002375,172.31.40.0-255,66,251046,64,375588
26832,0.002397,74.125.68.0-255,7156,258202,64,375588
26833,0.002399,172.31.40.0-255,66,258268,64,375588
26834,0.002401,74.125.68.0-255,1484,259752,64,375588
26835,0.004728,74.125.68.0-255,1484,261236,64,375588
26836,0.004731,172.31.40.0-255,66,261302,64,375588
26837,0.004745,74.125.68.0-255,2902,264204,64,375588
26838,0.004747,172.31.40.0-255,66,264270,64,375588
26839,0.007064,74.125.68.0-255,2902,267172,64,375588
26840,0.007069,172.31.40.0-255,66,267238,64,375588
26841,0.007101,74.125.68.0-255,2902,270140,64,375588
26842,0.007105,172.31.40.0-255,66,270206,64,375588
26843,0.009401,74.125.68.0-255,2902,273108,64,375588
26844,0.009407,172.31.40.0-255,66,273174,64,375588
26845,0.009434,74.125.68.0-255,2902,276076,64,375588
26846,0.009437,172.31.40.0-255,66,276142,64,375588
26847,0.01174,74.125.68.0-255,2902,279044,64,375588
26848,0.011747,172.31.40.0-255,66,279110,64,375588
26849,0.011773,74.125.68.0-255,2902,282012,64,375588
26850,0.011775,172.31.40.0-255,66,282078,64,375588
26851,0.014102,74.125.68.0-255,5738,287816,64,375588
26852,0.014111,172.31.40.0-255,66,287882,64,375588
26853,0.016458,74.125.68.0-255,5738,293620,64,375588
26854,0.016466,172.31.40.0-255,66,293686,64,375588
26855,0.018799,74.125.68.0-255,5738,299424,64,375588
26856,0.018806,172.31.40.0-255,66,299490,64,375588
26857,0.021144,74.125.68.0-255,5738,305228,64,375588
26858,0.021151,172.31.40.0-255,66,305294,64,375588
26859,0.023524,74.125.68.0-255,5738,311032,64,375588
26860,0.023531,172.31.40.0-255,66,311098,64,375588
26861,0.025868,74.125.68.0-255,5738,316836,64,375588
26862,0.025877,172.31.40.0-255,66,316902,64,375588
26863,0.02821,74.125.68.0-255,5738,322640,64,375588
26864,0.028217,172.31.40.0-255,66,322706,64,375588
26865,0.030345,172.31.40.0-255,172,322878,64,375588
26866,0.03037,172.31.40.0-255,1111,323989,64,375588
26867,0.030418,172.31.40.0-255,1514,325503,64,375588
26868,0.03042,172.31.40.0-255,1297,326800,64,375588
26869,0.030539,74.125.68.0-255,4320,331120,64,375588
26870,0.030544,172.31.40.0-255,66,331186,64,375588
26871,0.030575,74.125.68.0-255,1484,332670,64,375588
26872,0.031874,104.244.42.0-255,66,332736,64,375588
26873,0.031922,104.244.42.0-255,66,332802,64,375588
26874,0.031981,104.244.42.0-255,66,332868,64,375588
26875,0.032878,74.125.68.0-255,1484,334352,64,375588
26876,0.032883,172.31.40.0-255,66,334418,64,375588
26877,0.032903,74.125.68.0-255,2902,337320,64,375588
26878,0.032906,172.31.40.0-255,66,337386,64,375588
26879,0.035212,74.125.68.0-255,2902,340288,64,375588
26880,0.035218,172.31.40.0-255,66,340354,64,375588
26881,0.035249,74.125.68.0-255,2902,343256,64,375588
26882,0.035252,172.31.40.0-255,66,343322,64,375588
26883,0.037544,74.125.68.0-255,2902,346224,64,375588
26884,0.037549,172.31.40.0-255,66,346290,64,375588
26885,0.037581,74.125.68.0-255,2902,349192,64,375588
26886,0.037584,172.31.40.0-255,66,349258,64,375588
26887,0.039884,74.125.68.0-255,2902,352160,64,375588
26888,0.039889,172.31.40.0-255,66,352226,64,375588
26889,0.03992,74.125.68.0-255,2902,355128,64,375588
26890,0.039923,172.31.40.0-255,66,355194,64,375588
26891,0.042211,74.125.68.0-255,1484,356678,64,375588
26892,0.04224,74.125.68.0-255,4320,360998,64,375588
26893,0.042244,172.31.40.0-255,66,361064,64,375588
26894,0.044577,74.125.68.0-255,5738,366802,64,375588
26895,0.044583,172.31.40.0-255,66,366868,64,375588
26896,0.046929,74.125.68.0-255,5738,372606,64,375588
26897,0.046935,172.31.40.0-255,66,372672,64,375588
26898,0.049258,74.125.68.0-255,2679,375351,64,375588
26899,0.049263,172.31.40.0-255,66,375417,64,375588
26900,0.049427,172.31.40.0-255,105,375522,64,375588
26901,0.051719,74.125.68.0-255,66,375588,64,375588
26902,0.0,172.217.194.0-255,153,153,64,234272
26903,1.9e-05,172.31.40.0-255,66,219,64,234272
26904,2.6e-05,172.217.194.0-255,1484,1703,64,234272
26905,3.2e-05,172.31.40.0-255,66,1769,64,234272
26906,3.7e-05,172.217.194.0-255,2902,4671,64,234272
26907,4e-05,172.31.40.0-255,66,4737,64,234272
26908,4.7e-05,172.217.194.0-255,7156,11893,64,234272
26909,5.1e-05,172.31.40.0-255,66,11959,64,234272
26910,8.4e-05,172.31.40.0-255,66,12025,64,234272
26911,9.1e-05,172.217.194.0-255,6797,18822,64,234272
26912,9.4e-05,172.31.40.0-255,66,18888,64,234272
26913,0.00018,172.217.194.0-255,1484,20372,64,234272
26914,0.000183,172.31.40.0-255,66,20438,64,234272
26915,0.000188,172.217.194.0-255,2902,23340,64,234272
26916,0.00019,172.31.40.0-255,66,23406,64,234272
26917,0.000218,172.217.194.0-255,5738,29144,64,234272
26918,0.000222,172.31.40.0-255,66,29210,64,234272
26919,0.00024,172.217.194.0-255,2902,32112,64,234272
26920,0.000243,172.31.40.0-255,66,32178,64,234272
26921,0.000268,172.217.194.0-255,3961,36139,64,234272
26922,0.000271,172.31.40.0-255,66,36205,64,234272
26923,0.000278,172.217.194.0-255,7156,43361,64,234272
26924,0.000281,172.31.40.0-255,66,43427,64,234272
26925,0.000284,172.217.194.0-255,1484,44911,64,234272
26926,0.000285,172.31.40.0-255,66,44977,64,234272
26927,0.000315,172.31.40.0-255,66,45043,64,234272
26928,0.000318,172.217.194.0-255,113,45156,64,234272
26929,0.00032,172.31.40.0-255,66,45222,64,234272
26930,0.000347,172.217.194.0-255,1484,46706,64,234272
26931,0.00035,172.31.40.0-255,66,46772,64,234272
26932,0.000371,172.217.194.0-255,2902,49674,64,234272
26933,0.000373,172.31.40.0-255,66,49740,64,234272
26934,0.000378,172.217.194.0-255,2902,52642,64,234272
26935,0.00038,172.31.40.0-255,66,52708,64,234272
26936,0.000405,172.217.194.0-255,4320,57028,64,234272
26937,0.000408,172.31.40.0-255,66,57094,64,234272
26938,0.000414,172.217.194.0-255,5672,62766,64,234272
26939,0.000416,172.31.40.0-255,66,62832,64,234272
26940,0.00044,172.217.194.0-255,2902,65734,64,234272
26941,0.000442,172.31.40.0-255,66,65800,64,234272
26942,0.000467,172.31.40.0-255,66,65866,64,234272
26943,0.000492,172.217.194.0-255,2543,68409,64,234272
26944,0.000494,172.31.40.0-255,66,68475,64,234272
26945,0.00141,172.217.194.0-255,1484,69959,64,234272
26946,0.001419,172.217.194.0-255,2902,72861,64,234272
26947,0.001424,172.31.40.0-255,66,72927,64,234272
26948,0.001429,172.217.194.0-255,1484,74411,64,234272
26949,0.001448,172.217.194.0-255,4320,78731,64,234272
26950,0.001451,172.31.40.0-255,66,78797,64,234272
26951,0.001463,172.31.40.0-255,66,78863,64,234272
26952,0.001494,172.217.194.0-255,4320,83183,64,234272
26953,0.001497,172.31.40.0-255,66,83249,64,234272
26954,0.001508,172.31.40.0-255,66,83315,64,234272
26955,0.001534,172.217.194.0-255,5738,89053,64,234272
26956,0.001537,172.31.40.0-255,66,89119,64,234272
26957,0.001561,172.31.40.0-255,66,89185,64,234272
26958,0.001572,172.31.40.0-255,66,89251,64,234272
26959,0.001607,172.31.40.0-255,66,89317,64,234272
26960,0.001613,172.217.194.0-255,5020,94337,64,234272
26961,0.001615,172.31.40.0-255,66,94403,64,234272
26962,0.001648,172.217.194.0-255,1484,95887,64,234272
26963,0.001686,172.31.40.0-255,66,95953,64,234272
26964,0.001692,172.217.194.0-255,5020,100973,64,234272
26965,0.001695,172.31.40.0-255,66,101039,64,234272
26966,0.001707,172.31.40.0-255,66,101105,64,234272
26967,0.001712,172.217.194.0-255,2902,104007,64,234272
26968,0.001714,172.31.40.0-255,66,104073,64,234272
26969,0.001757,172.31.40.0-255,66,104139,64,234272
26970,0.00177,172.31.40.0-255,66,104205,64,234272
26971,0.001784,172.31.40.0-255,66,104271,64,234272
26972,0.001799,172.31.40.0-255,66,104337,64,234272
26973,0.001828,172.31.40.0-255,66,104403,64,234272
26974,0.002092,172.217.194.0-255,1484,105887,64,234272
26975,0.0021,172.217.194.0-255,2902,108789,64,234272
26976,0.002104,172.31.40.0-255,66,108855,64,234272
26977,0.002112,172.217.194.0-255,5738,114593,64,234272
26978,0.002115,172.31.40.0-255,66,114659,64,234272
26979,0.002151,172.31.40.0-255,66,114725,64,234272
26980,0.002173,172.217.194.0-255,4320,119045,64,234272
26981,0.002176,172.31.40.0-255,66,119111,64,234272
26982,0.002187,172.31.40.0-255,66,119177,64,234272
26983,0.002202,172.217.194.0-255,2184,121361,64,234272
26984,0.002204,172.31.40.0-255,66,121427,64,234272
26985,0.002248,172.217.194.0-255,1484,122911,64,234272
26986,0.002252,172.217.194.0-255,1484,124395,64,234272
26987,0.002256,172.31.40.0-255,66,124461,64,234272
26988,0.002272,172.217.194.0-255,1484,125945,64,234272
26989,0.00228,172.217.194.0-255,5738,131683,64,234272
26990,0.002283,172.31.40.0-255,66,131749,64,234272
26991,0.002299,172.217.194.0-255,7156,138905,64,234272
26992,0.002302,172.31.40.0-255,66,138971,64,234272
26993,0.002318,172.217.194.0-255,5738,144709,64,234272
26994,0.002321,172.31.40.0-255,66,144775,64,234272
26995,0.002354,172.217.194.0-255,7156,151931,64,234272
26996,0.002357,172.31.40.0-255,66,151997,64,234272
26997,0.002375,172.217.194.0-255,3602,155599,64,234272
26998,0.002377,172.31.40.0-255,66,155665,64,234272
26999,0.004972,172.217.194.0-255,1484,157149,64,234272
27000,0.005003,172.217.194.0-255,4320,161469,64,234272
27001,0.005009,172.31.40.0-255,66,161535,64,234272
27002,0.007689,172.217.194.0-255,5738,167273,64,234272
27003,0.007715,172.31.40.0-255,66,167339,64,234272
27004,0.010335,172.217.194.0-255,5738,173077,64,234272
27005,0.010346,172.31.40.0-255,66,173143,64,234272
27006,0.013019,172.217.194.0-255,5738,178881,64,234272
27007,0.013025,172.31.40.0-255,66,178947,64,234272
27008,0.015689,172.217.194.0-255,5738,184685,64,234272
27009,0.015702,172.31.40.0-255,66,184751,64,234272
27010,0.01833,172.217.194.0-255,5738,190489,64,234272
27011,0.018348,172.31.40.0-255,66,190555,64,234272
27012,0.02102,172.217.194.0-255,5738,196293,64,234272
27013,0.02104,172.31.40.0-255,66,196359,64,234272
27014,0.023693,172.217.194.0-255,5738,202097,64,234272
27015,0.023701,172.31.40.0-255,66,202163,64,234272
27016,0.026374,172.217.194.0-255,5738,207901,64,234272
27017,0.026383,172.31.40.0-255,66,207967,64,234272
27018,0.029011,172.217.194.0-255,5738,213705,64,234272
27019,0.029019,172.31.40.0-255,66,213771,64,234272
27020,0.031673,172.217.194.0-255,5738,219509,64,234272
27021,0.031681,172.31.40.0-255,66,219575,64,234272
27022,0.034323,172.217.194.0-255,5738,225313,64,234272
27023,0.03433,172.31.40.0-255,66,225379,64,234272
27024,0.036986,172.217.194.0-255,5333,230712,64,234272
27025,0.037005,172.31.40.0-255,66,230778,64,234272
27026,0.03732,172.31.40.0-255,105,230883,64,234272
27027,0.039943,172.217.194.0-255,66,230949,64,234272
27028,0.047962,172.31.40.0-255,167,231116,64,234272
27029,0.047996,172.31.40.0-255,1113,232229,64,234272
27030,0.048059,172.31.40.0-255,1514,233743,64,234272
27031,0.048061,172.31.40.0-255,331,234074,64,234272
27032,0.04949,104.244.42.0-255,66,234140,64,234272
27033,0.04952,104.244.42.0-255,66,234206,64,234272
27034,0.049618,104.244.42.0-255,66,234272,64,234272
27035,0.0,74.125.130.0-255,147,147,64,300727
27036,2.4e-05,172.31.40.0-255,66,213,64,300727
27037,3.1e-05,74.125.130.0-255,1484,1697,64,300727
27038,3.6e-05,172.31.40.0-255,66,1763,64,300727
27039,6.5e-05,74.125.130.0-255,2902,4665,64,300727
27040,6.8e-05,172.31.40.0-255,66,4731,64,300727
27041,0.000102,74.125.130.0-255,5738,10469,64,300727
27042,0.000105,172.31.40.0-255,66,10535,64,300727
27043,0.000134,74.125.130.0-255,2902,13437,64,300727
27044,0.000137,172.31.40.0-255,66,13503,64,300727
27045,0.000159,74.125.130.0-255,3448,16951,64,300727
27046,0.000162,172.31.40.0-255,66,17017,64,300727
27047,0.000164,74.125.130.0-255,1484,18501,64,300727
27048,0.000167,172.31.40.0-255,66,18567,64,300727
27049,0.000172,74.125.130.0-255,2902,21469,64,300727
27050,0.000175,172.31.40.0-255,66,21535,64,300727
27051,0.000177,74.125.130.0-255,1484,23019,64,300727
27052,0.00018,172.31.40.0-255,66,23085,64,300727
27053,0.000213,74.125.130.0-255,4320,27405,64,300727
27054,0.000216,172.31.40.0-255,66,27471,64,300727
27055,0.000219,74.125.130.0-255,1484,28955,64,300727
27056,0.000221,172.31.40.0-255,66,29021,64,300727
27057,0.000226,74.125.130.0-255,2543,31564,64,300727
27058,0.000228,172.31.40.0-255,66,31630,64,300727
27059,0.000299,74.125.130.0-255,1484,33114,64,300727
27060,0.000303,172.31.40.0-255,66,33180,64,300727
27061,0.000322,74.125.130.0-255,1484,34664,64,300727
27062,0.000324,172.31.40.0-255,66,34730,64,300727
27063,0.00035,74.125.130.0-255,1484,36214,64,300727
27064,0.000353,172.31.40.0-255,66,36280,64,300727
27065,0.00036,74.125.130.0-255,5738,42018,64,300727
27066,0.000362,172.31.40.0-255,66,42084,64,300727
27067,0.000368,74.125.130.0-255,5738,47822,64,300727
27068,0.00037,172.31.40.0-255,66,47888,64,300727
27069,0.000408,74.125.130.0-255,1125,49013,64,300727
27070,0.000717,74.125.130.0-255,1484,50497,64,300727
27071,0.000721,172.31.40.0-255,66,50563,64,300727
27072,0.000726,74.125.130.0-255,2902,53465,64,300727
27073,0.000728,172.31.40.0-255,66,53531,64,300727
27074,0.000759,74.125.130.0-255,5738,59269,64,300727
27075,0.000761,172.31.40.0-255,66,59335,64,300727
27076,0.000765,74.125.130.0-255,2902,62237,64,300727
27077,0.000767,172.31.40.0-255,66,62303,64,300727
27078,0.000772,74.125.130.0-255,3961,66264,64,300727
27079,0.000773,172.31.40.0-255,66,66330,64,300727
27080,0.000794,74.125.130.0-255,646,66976,64,300727
27081,0.000914,74.125.130.0-255,1484,68460,64,300727
27082,0.000917,172.31.40.0-255,66,68526,64,300727
27083,0.000961,74.125.130.0-255,2902,71428,64,300727
27084,0.000963,172.31.40.0-255,66,71494,64,300727
27085,0.000969,74.125.130.0-255,5738,77232,64,300727
27086,0.000971,172.31.40.0-255,66,77298,64,300727
27087,0.001003,74.125.130.0-255,2902,80200,64,300727
27088,0.001006,172.31.40.0-255,66,80266,64,300727
27089,0.001025,74.125.130.0-255,4320,84586,64,300727
27090,0.001028,172.31.40.0-255,66,84652,64,300727
27091,0.001067,74.125.130.0-255,7156,91808,64,300727
27092,0.001071,172.31.40.0-255,66,91874,64,300727
27093,0.001108,74.125.130.0-255,2902,94776,64,300727
27094,0.001111,172.31.40.0-255,66,94842,64,300727
27095,0.00114,74.125.130.0-255,4320,99162,64,300727
27096,0.001142,172.31.40.0-255,66,99228,64,300727
27097,0.001166,74.125.130.0-255,2184,101412,64,300727
27098,0.001168,172.31.40.0-255,66,101478,64,300727
27099,0.001363,74.125.130.0-255,1484,102962,64,300727
27100,0.001386,74.125.130.0-255,2902,105864,64,300727
27101,0.001389,172.31.40.0-255,66,105930,64,300727
27102,0.001416,74.125.130.0-255,4320,110250,64,300727
27103,0.001419,172.31.40.0-255,66,110316,64,300727
27104,0.00144,74.125.130.0-255,1484,111800,64,300727
27105,0.00148,74.125.130.0-255,1484,113284,64,300727
27106,0.001482,172.31.40.0-255,66,113350,64,300727
27107,0.001512,74.125.130.0-255,5738,119088,64,300727
27108,0.001515,172.31.40.0-255,66,119154,64,300727
27109,0.001519,74.125.130.0-255,2902,122056,64,300727
27110,0.00152,172.31.40.0-255,66,122122,64,300727
27111,0.001569,74.125.130.0-255,4320,126442,64,300727
27112,0.001572,172.31.40.0-255,66,126508,64,300727
27113,0.001575,74.125.130.0-255,1484,127992,64,300727
27114,0.0016,74.125.130.0-255,2902,130894,64,300727
27115,0.001602,172.31.40.0-255,66,130960,64,300727
27116,0.001626,74.125.130.0-255,1484,132444,64,300727
27117,0.00163,74.125.130.0-255,2902,135346,64,300727
27118,0.001632,172.31.40.0-255,66,135412,64,300727
27119,0.001654,74.125.130.0-255,217,135629,64,300727
27120,0.001887,74.125.130.0-255,1484,137113,64,300727
27121,0.00189,172.31.40.0-255,66,137179,64,300727
27122,0.001908,74.125.130.0-255,1484,138663,64,300727
27123,0.001919,74.125.130.0-255,1484,140147,64,300727
27124,0.001921,172.31.40.0-255,66,140213,64,300727
27125,0.001924,74.125.130.0-255,1484,141697,64,300727
27126,0.001927,74.125.130.0-255,1484,143181,64,300727
27127,0.001928,172.31.40.0-255,66,143247,64,300727
27128,0.001952,74.125.130.0-255,1484,144731,64,300727
27129,0.001958,74.125.130.0-255,5738,150469,64,300727
27130,0.001961,172.31.40.0-255,66,150535,64,300727
27131,0.001995,74.125.130.0-255,1484,152019,64,300727
27132,0.002022,74.125.130.0-255,1484,153503,64,300727
27133,0.002024,172.31.40.0-255,66,153569,64,300727
27134,0.002049,74.125.130.0-255,2902,156471,64,300727
27135,0.002051,172.31.40.0-255,66,156537,64,300727
27136,0.002074,74.125.130.0-255,1484,158021,64,300727
27137,0.00212,74.125.130.0-255,1484,159505,64,300727
27138,0.002123,172.31.40.0-255,66,159571,64,300727
27139,0.002173,74.125.130.0-255,2902,162473,64,300727
27140,0.002176,172.31.40.0-255,66,162539,64,300727
27141,0.002224,74.125.130.0-255,1484,164023,64,300727
27142,0.00228,74.125.130.0-255,2902,166925,64,300727
27143,0.002284,172.31.40.0-255,66,166991,64,300727
27144,0.002312,74.125.130.0-255,2902,169893,64,300727
27145,0.002314,172.31.40.0-255,66,169959,64,300727
27146,0.002334,74.125.130.0-255,766,170725,64,300727
27147,0.00239,172.31.40.0-255,66,170791,64,300727
27148,0.004777,74.125.130.0-255,1484,172275,64,300727
27149,0.004797,74.125.130.0-255,1484,173759,64,300727
27150,0.004801,172.31.40.0-255,66,173825,64,300727
27151,0.004827,74.125.130.0-255,1484,175309,64,300727
27152,0.004869,74.125.130.0-255,1484,176793,64,300727
27153,0.004871,172.31.40.0-255,66,176859,64,300727
27154,0.007307,74.125.130.0-255,2902,179761,64,300727
27155,0.007315,172.31.40.0-255,66,179827,64,300727
27156,0.007361,74.125.130.0-255,2902,182729,64,300727
27157,0.007364,172.31.40.0-255,66,182795,64,300727
27158,0.009814,74.125.130.0-255,2902,185697,64,300727
27159,0.00982,172.31.40.0-255,66,185763,64,300727
27160,0.009856,74.125.130.0-255,2902,188665,64,300727
27161,0.009859,172.31.40.0-255,66,188731,64,300727
27162,0.012324,74.125.130.0-255,2902,191633,64,300727
27163,0.012331,172.31.40.0-255,66,191699,64,300727
27164,0.012359,74.125.130.0-255,2902,194601,64,300727
27165,0.012362,172.31.40.0-255,66,194667,64,300727
27166,0.014846,74.125.130.0-255,4320,198987,64,300727
27167,0.014855,172.31.40.0-255,66,199053,64,300727
27168,0.014886,74.125.130.0-255,1484,200537,64,300727
27169,0.017371,74.125.130.0-255,4320,204857,64,300727
27170,0.01738,172.31.40.0-255,66,204923,64,300727
27171,0.019906,74.125.130.0-255,5738,210661,64,300727
27172,0.019913,172.31.40.0-255,66,210727,64,300727
27173,0.022417,74.125.130.0-255,5738,216465,64,300727
27174,0.022423,172.31.40.0-255,66,216531,64,300727
27175,0.024924,74.125.130.0-255,5738,222269,64,300727
27176,0.024933,172.31.40.0-255,66,222335,64,300727
27177,0.027444,74.125.130.0-255,5738,228073,64,300727
27178,0.027452,172.31.40.0-255,66,228139,64,300727
27179,0.028929,172.31.40.0-255,172,228311,64,300727
27180,0.028958,172.31.40.0-255,1112,229423,64,300727
27181,0.029009,172.31.40.0-255,1514,230937,64,300727
27182,0.029011,172.31.40.0-255,1296,232233,64,300727
27183,0.029962,74.125.130.0-255,5738,237971,64,300727
27184,0.029969,172.31.40.0-255,66,238037,64,300727
27185,0.030464,104.244.42.0-255,66,238103,64,300727
27186,0.03065,104.244.42.0-255,66,238169,64,300727
27187,0.030658,104.244.42.0-255,66,238235,64,300727
27188,0.03247,74.125.130.0-255,5738,243973,64,300727
27189,0.032481,172.31.40.0-255,66,244039,64,300727
27190,0.035003,74.125.130.0-255,5738,249777,64,300727
27191,0.035013,172.31.40.0-255,66,249843,64,300727
27192,0.037581,74.125.130.0-255,5738,255581,64,300727
27193,0.037599,172.31.40.0-255,66,255647,64,300727
27194,0.040125,74.125.130.0-255,5738,261385,64,300727
27195,0.040144,172.31.40.0-255,66,261451,64,300727
27196,0.042669,74.125.130.0-255,5738,267189,64,300727
27197,0.042686,172.31.40.0-255,66,267255,64,300727
27198,0.045212,74.125.130.0-255,5738,272993,64,300727
27199,0.045229,172.31.40.0-255,66,273059,64,300727
27200,0.047736,74.125.130.0-255,4320,277379,64,300727
27201,0.047742,172.31.40.0-255,66,277445,64,300727
27202,0.047766,74.125.130.0-255,1484,278929,64,300727
27203,0.050275,74.125.130.0-255,4320,283249,64,300727
27204,0.050293,172.31.40.0-255,66,283315,64,300727
27205,0.052815,74.125.130.0-255,5738,289053,64,300727
27206,0.052833,172.31.40.0-255,66,289119,64,300727
27207,0.05535,74.125.130.0-255,5738,294857,64,300727
27208,0.05536,172.31.40.0-255,66,294923,64,300727
27209,0.057895,74.125.130.0-255,5738,300661,64,300727
27210,0.057909,172.31.40.0-255,66,300727,64,300727
27211,0.0,74.125.24.0-255,153,153,64,200912
27212,2.3e-05,172.31.40.0-255,66,219,64,200912
27213,3.1e-05,74.125.24.0-255,1484,1703,64,200912
27214,3.6e-05,172.31.40.0-255,66,1769,64,200912
27215,4.1e-05,74.125.24.0-255,2902,4671,64,200912
27216,5.4e-05,172.31.40.0-255,66,4737,64,200912
27217,6.2e-05,74.125.24.0-255,7156,11893,64,200912
27218,6.5e-05,172.31.40.0-255,66,11959,64,200912
27219,7e-05,74.125.24.0-255,2038,13997,64,200912
27220,7.3e-05,172.31.40.0-255,66,14063,64,200912
27221,0.000181,74.125.24.0-255,1484,15547,64,200912
27222,0.000185,172.31.40.0-255,66,15613,64,200912
27223,0.000191,74.125.24.0-255,2902,18515,64,200912
27224,0.000193,172.31.40.0-255,66,18581,64,200912
27225,0.000215,74.125.24.0-255,5738,24319,64,200912
27226,0.000222,172.31.40.0-255,66,24385,64,200912
27227,0.000251,74.125.24.0-255,5738,30123,64,200912
27228,0.000254,172.31.40.0-255,66,30189,64,200912
27229,0.000266,74.125.24.0-255,1125,31314,64,200912
27230,0.000268,172.31.40.0-255,66,31380,64,200912
27231,0.00028,74.125.24.0-255,7156,38536,64,200912
27232,0.000283,172.31.40.0-255,66,38602,64,200912
27233,0.000348,172.31.40.0-255,66,38668,64,200912
27234,0.000613,74.125.24.0-255,1484,40152,64,200912
27235,0.000618,172.31.40.0-255,66,40218,64,200912
27236,0.000625,74.125.24.0-255,2902,43120,64,200912
27237,0.000627,172.31.40.0-255,66,43186,64,200912
27238,0.000634,74.125.24.0-255,4320,47506,64,200912
27239,0.000637,172.31.40.0-255,66,47572,64,200912
27240,0.000653,74.125.24.0-255,1484,49056,64,200912
27241,0.000655,172.31.40.0-255,66,49122,64,200912
27242,0.000668,74.125.24.0-255,6797,55919,64,200912
27243,0.00067,172.31.40.0-255,66,55985,64,200912
27244,0.000673,74.125.24.0-255,645,56630,64,200912
27245,0.000715,74.125.24.0-255,1484,58114,64,200912
27246,0.000719,172.31.40.0-255,66,58180,64,200912
27247,0.000733,74.125.24.0-255,4320,62500,64,200912
27248,0.00074,172.31.40.0-255,66,62566,64,200912
27249,0.000743,74.125.24.0-255,1484,64050,64,200912
27250,0.000772,74.125.24.0-255,5738,69788,64,200912
27251,0.000775,172.31.40.0-255,66,69854,64,200912
27252,0.000778,74.125.24.0-255,1484,71338,64,200912
27253,0.000828,172.31.40.0-255,66,71404,64,200912
27254,0.000835,74.125.24.0-255,6797,78201,64,200912
27255,0.000838,172.31.40.0-255,66,78267,64,200912
27256,0.001035,74.125.24.0-255,1484,79751,64,200912
27257,0.001042,74.125.24.0-255,2902,82653,64,200912
27258,0.001045,172.31.40.0-255,66,82719,64,200912
27259,0.001049,74.125.24.0-255,1484,84203,64,200912
27260,0.001081,74.125.24.0-255,4320,88523,64,200912
27261,0.001084,172.31.40.0-255,66,88589,64,200912
27262,0.001092,74.125.24.0-255,7156,95745,64,200912
27263,0.001094,172.31.40.0-255,66,95811,64,200912
27264,0.001122,74.125.24.0-255,5738,101549,64,200912
27265,0.001125,172.31.40.0-255,66,101615,64,200912
27266,0.001138,172.31.40.0-255,66,101681,64,200912
27267,0.00114,74.125.24.0-255,766,102447,64,200912
27268,0.001181,74.125.24.0-255,1484,103931,64,200912
27269,0.001184,172.31.40.0-255,66,103997,64,200912
27270,0.001191,74.125.24.0-255,4320,108317,64,200912
27271,0.001193,172.31.40.0-255,66,108383,64,200912
27272,0.00123,172.31.40.0-255,66,108449,64,200912
27273,0.001233,74.125.24.0-255,1484,109933,64,200912
27274,0.001244,172.31.40.0-255,66,109999,64,200912
27275,0.001274,74.125.24.0-255,4320,114319,64,200912
27276,0.001282,74.125.24.0-255,3602,117921,64,200912
27277,0.001287,172.31.40.0-255,66,117987,64,200912
27278,0.00129,172.31.40.0-255,66,118053,64,200912
27279,0.001339,74.125.24.0-255,1484,119537,64,200912
27280,0.001345,74.125.24.0-255,2902,122439,64,200912
27281,0.001348,172.31.40.0-255,66,122505,64,200912
27282,0.001351,74.125.24.0-255,1484,123989,64,200912
27283,0.001379,74.125.24.0-255,4320,128309,64,200912
27284,0.001382,172.31.40.0-255,66,128375,64,200912
27285,0.001387,74.125.24.0-255,4320,132695,64,200912
27286,0.001404,172.31.40.0-255,66,132761,64,200912
27287,0.00145,172.31.40.0-255,66,132827,64,200912
27288,0.001467,172.31.40.0-255,66,132893,64,200912
27289,0.001606,74.125.24.0-255,1484,134377,64,200912
27290,0.001611,74.125.24.0-255,1484,135861,64,200912
27291,0.001614,172.31.40.0-255,66,135927,64,200912
27292,0.001632,74.125.24.0-255,1484,137411,64,200912
27293,0.001643,74.125.24.0-255,5738,143149,64,200912
27294,0.001645,172.31.40.0-255,66,143215,64,200912
27295,0.001648,74.125.24.0-255,1484,144699,64,200912
27296,0.001703,74.125.24.0-255,7156,151855,64,200912
27297,0.001706,172.31.40.0-255,66,151921,64,200912
27298,0.001733,74.125.24.0-255,4320,156241,64,200912
27299,0.001735,172.31.40.0-255,66,156307,64,200912
27300,0.001746,172.31.40.0-255,66,156373,64,200912
27301,0.00178,172.31.40.0-255,66,156439,64,200912
27302,0.001795,172.31.40.0-255,66,156505,64,200912
27303,0.001831,74.125.24.0-255,1484,157989,64,200912
27304,0.001858,74.125.24.0-255,2902,160891,64,200912
27305,0.001861,172.31.40.0-255,66,160957,64,200912
27306,0.001868,74.125.24.0-255,5738,166695,64,200912
27307,0.00187,172.31.40.0-255,66,166761,64,200912
27308,0.001874,74.125.24.0-255,1484,168245,64,200912
27309,0.001902,172.31.40.0-255,66,168311,64,200912
27310,0.001951,172.31.40.0-255,66,168377,64,200912
27311,0.001975,74.125.24.0-255,7156,175533,64,200912
27312,0.001978,172.31.40.0-255,66,175599,64,200912
27313,0.002012,74.125.24.0-255,4320,179919,64,200912
27314,0.002016,172.31.40.0-255,66,179985,64,200912
27315,0.00203,172.31.40.0-255,66,180051,64,200912
27316,0.002048,172.31.40.0-255,66,180117,64,200912
27317,0.002055,74.125.24.0-255,7156,187273,64,200912
27318,0.002058,172.31.40.0-255,66,187339,64,200912
27319,0.002081,74.125.24.0-255,5738,193077,64,200912
27320,0.002118,172.31.40.0-255,66,193143,64,200912
27321,0.002136,74.125.24.0-255,2902,196045,64,200912
27322,0.002169,172.31.40.0-255,66,196111,64,200912
27323,0.002223,74.125.24.0-255,105,196216,64,200912
27324,0.002284,172.31.40.0-255,66,196282,64,200912
27325,0.010688,172.31.40.0-255,101,196383,64,200912
27326,0.011716,172.31.40.0-255,105,196488,64,200912
27327,0.01304,74.125.24.0-255,66,196554,64,200912
27328,0.014027,74.125.24.0-255,66,196620,64,200912
27329,0.036836,172.31.40.0-255,172,196792,64,200912
27330,0.036865,172.31.40.0-255,1111,197903,64,200912
27331,0.036919,172.31.40.0-255,1514,199417,64,200912
27332,0.03692,172.31.40.0-255,1297,200714,64,200912
27333,0.038398,104.244.42.0-255,66,200780,64,200912
27334,0.038408,104.244.42.0-255,66,200846,64,200912
27335,0.038501,104.244.42.0-255,66,200912,64,200912
27336,0.0,172.217.194.0-255,153,153,64,250622
27337,1.7e-05,172.31.40.0-255,66,219,64,250622
27338,2.4e-05,172.217.194.0-255,1484,1703,64,250622
27339,2.8e-05,172.31.40.0-255,66,1769,64,250622
27340,3.4e-05,172.217.194.0-255,2902,4671,64,250622
27341,3.7e-05,172.31.40.0-255,66,4737,64,250622
27342,5.2e-05,172.217.194.0-255,7156,11893,64,250622
27343,5.6e-05,172.31.40.0-255,66,11959,64,250622
27344,6.1e-05,172.217.194.0-255,2139,14098,64,250622
27345,6.4e-05,172.31.40.0-255,66,14164,64,250622
27346,9.9e-05,172.217.194.0-255,2902,17066,64,250622
27347,0.000102,172.31.40.0-255,66,17132,64,250622
27348,0.00011,172.217.194.0-255,7156,24288,64,250622
27349,0.000113,172.31.40.0-255,66,24354,64,250622
27350,0.00012,172.217.194.0-255,6797,31151,64,250622
27351,0.000122,172.31.40.0-255,66,31217,64,250622
27352,0.000188,172.217.194.0-255,1484,32701,64,250622
27353,0.000192,172.31.40.0-255,66,32767,64,250622
27354,0.000204,172.217.194.0-255,2902,35669,64,250622
27355,0.00021,172.31.40.0-255,66,35735,64,250622
27356,0.000217,172.217.194.0-255,4320,40055,64,250622
27357,0.000219,172.31.40.0-255,66,40121,64,250622
27358,0.00024,172.217.194.0-255,1484,41605,64,250622
27359,0.000243,172.31.40.0-255,66,41671,64,250622
27360,0.000276,172.217.194.0-255,6797,48468,64,250622
27361,0.000279,172.31.40.0-255,66,48534,64,250622
27362,0.000282,172.217.194.0-255,1484,50018,64,250622
27363,0.000284,172.31.40.0-255,66,50084,64,250622
27364,0.000317,172.217.194.0-255,5738,55822,64,250622
27365,0.00032,172.31.40.0-255,66,55888,64,250622
27366,0.000354,172.217.194.0-255,4320,60208,64,250622
27367,0.000357,172.31.40.0-255,66,60274,64,250622
27368,0.00039,172.217.194.0-255,5706,65980,64,250622
27369,0.000393,172.31.40.0-255,66,66046,64,250622
27370,0.000395,172.217.194.0-255,382,66428,64,250622
27371,0.000614,172.217.194.0-255,1484,67912,64,250622
27372,0.000619,172.31.40.0-255,66,67978,64,250622
27373,0.000625,172.217.194.0-255,2902,70880,64,250622
27374,0.000627,172.31.40.0-255,66,70946,64,250622
27375,0.00066,172.217.194.0-255,5738,76684,64,250622
27376,0.000663,172.31.40.0-255,66,76750,64,250622
27377,0.000676,172.31.40.0-255,66,76816,64,250622
27378,0.000712,172.217.194.0-255,4320,81136,64,250622
27379,0.000715,172.31.40.0-255,66,81202,64,250622
27380,0.000738,172.217.194.0-255,6438,87640,64,250622
27381,0.000741,172.31.40.0-255,66,87706,64,250622
27382,0.000871,172.217.194.0-255,1484,89190,64,250622
27383,0.000889,172.217.194.0-255,2902,92092,64,250622
27384,0.000892,172.31.40.0-255,66,92158,64,250622
27385,0.000899,172.217.194.0-255,5738,97896,64,250622
27386,0.000901,172.31.40.0-255,66,97962,64,250622
27387,0.000904,172.217.194.0-255,1484,99446,64,250622
27388,0.000921,172.217.194.0-255,2902,102348,64,250622
27389,0.000923,172.31.40.0-255,66,102414,64,250622
27390,0.000955,172.31.40.0-255,66,102480,64,250622
27391,0.000992,172.31.40.0-255,66,102546,64,250622
27392,0.001013,172.217.194.0-255,2902,105448,64,250622
27393,0.001016,172.31.40.0-255,66,105514,64,250622
27394,0.001043,172.217.194.0-255,2902,108416,64,250622
27395,0.001046,172.31.40.0-255,66,108482,64,250622
27396,0.001053,172.217.194.0-255,7156,115638,64,250622
27397,0.001055,172.31.40.0-255,66,115704,64,250622
27398,0.001061,172.217.194.0-255,5738,121442,64,250622
27399,0.001064,172.31.40.0-255,66,121508,64,250622
27400,0.001103,172.217.194.0-255,6438,127946,64,250622
27401,0.001109,172.31.40.0-255,66,128012,64,250622
27402,0.001112,172.31.40.0-255,66,128078,64,250622
27403,0.001149,172.217.194.0-255,2902,130980,64,250622
27404,0.001152,172.31.40.0-255,66,131046,64,250622
27405,0.001168,172.217.194.0-255,5738,136784,64,250622
27406,0.001171,172.31.40.0-255,66,136850,64,250622
27407,0.001199,172.31.40.0-255,66,136916,64,250622
27408,0.001211,172.31.40.0-255,66,136982,64,250622
27409,0.001224,172.31.40.0-255,66,137048,64,250622
27410,0.001255,172.217.194.0-255,1484,138532,64,250622
27411,0.001272,172.31.40.0-255,66,138598,64,250622
27412,0.001277,172.217.194.0-255,3602,142200,64,250622
27413,0.001279,172.31.40.0-255,66,142266,64,250622
27414,0.001334,172.217.194.0-255,1484,143750,64,250622
27415,0.001339,172.217.194.0-255,2902,146652,64,250622
27416,0.001342,172.31.40.0-255,66,146718,64,250622
27417,0.001346,172.217.194.0-255,1484,148202,64,250622
27418,0.001391,172.217.194.0-255,4320,152522,64,250622
27419,0.001395,172.31.40.0-255,66,152588,64,250622
27420,0.001401,172.217.194.0-255,5738,158326,64,250622
27421,0.001403,172.31.40.0-255,66,158392,64,250622
27422,0.001427,172.31.40.0-255,66,158458,64,250622
27423,0.001433,172.217.194.0-255,5020,163478,64,250622
27424,0.001436,172.31.40.0-255,66,163544,64,250622
27425,0.001467,172.217.194.0-255,5738,169282,64,250622
27426,0.00147,172.31.40.0-255,66,169348,64,250622
27427,0.001475,172.217.194.0-255,4320,173668,64,250622
27428,0.001478,172.31.40.0-255,66,173734,64,250622
27429,0.001518,172.217.194.0-255,1484,175218,64,250622
27430,0.001546,172.217.194.0-255,4320,179538,64,250622
27431,0.001549,172.31.40.0-255,66,179604,64,250622
27432,0.001561,172.31.40.0-255,66,179670,64,250622
27433,0.001568,172.217.194.0-255,6438,186108,64,250622
27434,0.00157,172.31.40.0-255,66,186174,64,250622
27435,0.001611,172.31.40.0-255,66,186240,64,250622
27436,0.001623,172.31.40.0-255,66,186306,64,250622
27437,0.001626,172.217.194.0-255,2902,189208,64,250622
27438,0.001628,172.31.40.0-255,66,189274,64,250622
27439,0.001669,172.31.40.0-255,66,189340,64,250622
27440,0.00175,172.217.194.0-255,1484,190824,64,250622
27441,0.001756,172.217.194.0-255,2902,193726,64,250622
27442,0.001759,172.31.40.0-255,66,193792,64,250622
27443,0.001763,172.217.194.0-255,1484,195276,64,250622
27444,0.001786,172.217.194.0-255,4320,199596,64,250622
27445,0.001789,172.31.40.0-255,66,199662,64,250622
27446,0.001797,172.217.194.0-255,7156,206818,64,250622
27447,0.001799,172.31.40.0-255,66,206884,64,250622
27448,0.001806,172.217.194.0-255,7156,214040,64,250622
27449,0.001809,172.31.40.0-255,66,214106,64,250622
27450,0.00182,172.217.194.0-255,1484,215590,64,250622
27451,0.001846,172.217.194.0-255,4320,219910,64,250622
27452,0.001849,172.31.40.0-255,66,219976,64,250622
27453,0.001869,172.217.194.0-255,3602,223578,64,250622
27454,0.001873,172.31.40.0-255,66,223644,64,250622
27455,0.001894,172.217.194.0-255,1484,225128,64,250622
27456,0.00191,172.217.194.0-255,2902,228030,64,250622
27457,0.001913,172.31.40.0-255,66,228096,64,250622
27458,0.001919,172.217.194.0-255,5738,233834,64,250622
27459,0.001922,172.31.40.0-255,66,233900,64,250622
27460,0.00193,172.217.194.0-255,1484,235384,64,250622
27461,0.001953,172.217.194.0-255,7156,242540,64,250622
27462,0.001956,172.31.40.0-255,66,242606,64,250622
27463,0.00198,172.217.194.0-255,2902,245508,64,250622
27464,0.001983,172.31.40.0-255,66,245574,64,250622
27465,0.002016,172.31.40.0-255,66,245640,64,250622
27466,0.002057,172.31.40.0-255,66,245706,64,250622
27467,0.00206,172.217.194.0-255,97,245803,64,250622
27468,0.002063,172.217.194.0-255,105,245908,64,250622
27469,0.012307,172.31.40.0-255,66,245974,64,250622
27470,0.012359,172.31.40.0-255,105,246079,64,250622
27471,0.013248,172.217.194.0-255,105,246184,64,250622
27472,0.013262,172.31.40.0-255,78,246262,64,250622
27473,0.014826,172.217.194.0-255,66,246328,64,250622
27474,0.051497,172.31.40.0-255,172,246500,64,250622
27475,0.051532,172.31.40.0-255,1113,247613,64,250622
27476,0.051588,172.31.40.0-255,1514,249127,64,250622
27477,0.05159,172.31.40.0-255,1297,250424,64,250622
27478,0.053032,104.244.42.0-255,66,250490,64,250622
27479,0.053055,104.244.42.0-255,66,250556,64,250622
27480,0.053149,104.244.42.0-255,66,250622,64,250622
27481,0.0,74.125.24.0-255,153,153,64,302082
27482,2.2e-05,172.31.40.0-255,66,219,64,302082
27483,3e-05,74.125.24.0-255,1484,1703,64,302082
27484,3.5e-05,172.31.40.0-255,66,1769,64,302082
27485,3.8e-05,74.125.24.0-255,1484,3253,64,302082
27486,4.2e-05,172.31.40.0-255,66,3319,64,302082
27487,6.4e-05,74.125.24.0-255,1484,4803,64,302082
27488,6.6e-05,172.31.40.0-255,66,4869,64,302082
27489,7.2e-05,74.125.24.0-255,2902,7771,64,302082
27490,7.5e-05,172.31.40.0-255,66,7837,64,302082
27491,0.000127,172.31.40.0-255,66,7903,64,302082
27492,0.000131,74.125.24.0-255,2902,10805,64,302082
27493,0.000134,172.31.40.0-255,66,10871,64,302082
27494,0.000147,74.125.24.0-255,2902,13773,64,302082
27495,0.00015,172.31.40.0-255,66,13839,64,302082
27496,0.000178,172.31.40.0-255,66,13905,64,302082
27497,0.000191,172.31.40.0-255,66,13971,64,302082
27498,0.000221,74.125.24.0-255,5020,18991,64,302082
27499,0.000223,172.31.40.0-255,66,19057,64,302082
27500,0.000246,74.125.24.0-255,5738,24795,64,302082
27501,0.000249,172.31.40.0-255,66,24861,64,302082
27502,0.000268,74.125.24.0-255,2902,27763,64,302082
27503,0.00027,172.31.40.0-255,66,27829,64,302082
27504,0.000302,172.31.40.0-255,66,27895,64,302082
27505,0.000516,74.125.24.0-255,1484,29379,64,302082
27506,0.000522,172.31.40.0-255,66,29445,64,302082
27507,0.000536,74.125.24.0-255,2902,32347,64,302082
27508,0.000539,172.31.40.0-255,66,32413,64,302082
27509,0.000558,74.125.24.0-255,1484,33897,64,302082
27510,0.000573,74.125.24.0-255,4320,38217,64,302082
27511,0.000576,172.31.40.0-255,66,38283,64,302082
27512,0.000581,74.125.24.0-255,4320,42603,64,302082
27513,0.000584,172.31.40.0-255,66,42669,64,302082
27514,0.000599,74.125.24.0-255,2902,45571,64,302082
27515,0.000601,172.31.40.0-255,66,45637,64,302082
27516,0.000607,74.125.24.0-255,4320,49957,64,302082
27517,0.000609,172.31.40.0-255,66,50023,64,302082
27518,0.000641,172.31.40.0-255,66,50089,64,302082
27519,0.000645,74.125.24.0-255,2184,52273,64,302082
27520,0.000649,172.31.40.0-255,66,52339,64,302082
27521,0.001182,74.125.24.0-255,1484,53823,64,302082
27522,0.001189,74.125.24.0-255,2902,56725,64,302082
27523,0.001193,172.31.40.0-255,66,56791,64,302082
27524,0.001217,74.125.24.0-255,5738,62529,64,302082
27525,0.00122,172.31.40.0-255,66,62595,64,302082
27526,0.001233,74.125.24.0-255,1484,64079,64,302082
27527,0.001246,74.125.24.0-255,4320,68399,64,302082
27528,0.001249,172.31.40.0-255,66,68465,64,302082
27529,0.001269,74.125.24.0-255,2902,71367,64,302082
27530,0.001271,172.31.40.0-255,66,71433,64,302082
27531,0.001291,74.125.24.0-255,4320,75753,64,302082
27532,0.001294,172.31.40.0-255,66,75819,64,302082
27533,0.001317,74.125.24.0-255,5738,81557,64,302082
27534,0.00132,172.31.40.0-255,66,81623,64,302082
27535,0.001352,172.31.40.0-255,66,81689,64,302082
27536,0.001355,74.125.24.0-255,1484,83173,64,302082
27537,0.001374,74.125.24.0-255,5738,88911,64,302082
27538,0.001376,172.31.40.0-255,66,88977,64,302082
27539,0.001408,172.31.40.0-255,66,89043,64,302082
27540,0.001419,172.31.40.0-255,66,89109,64,302082
27541,0.001447,74.125.24.0-255,3602,92711,64,302082
27542,0.00145,172.31.40.0-255,66,92777,64,302082
27543,0.001516,74.125.24.0-255,1484,94261,64,302082
27544,0.001537,74.125.24.0-255,2902,97163,64,302082
27545,0.001541,172.31.40.0-255,66,97229,64,302082
27546,0.001545,74.125.24.0-255,1484,98713,64,302082
27547,0.001566,74.125.24.0-255,4320,103033,64,302082
27548,0.001568,172.31.40.0-255,66,103099,64,302082
27549,0.001583,74.125.24.0-255,4320,107419,64,302082
27550,0.001586,172.31.40.0-255,66,107485,64,302082
27551,0.001608,172.31.40.0-255,66,107551,64,302082
27552,0.001612,74.125.24.0-255,1484,109035,64,302082
27553,0.001631,74.125.24.0-255,4320,113355,64,302082
27554,0.001634,172.31.40.0-255,66,113421,64,302082
27555,0.001653,74.125.24.0-255,5020,118441,64,302082
27556,0.001656,172.31.40.0-255,66,118507,64,302082
27557,0.001958,74.125.24.0-255,1484,119991,64,302082
27558,0.001974,74.125.24.0-255,2902,122893,64,302082
27559,0.001977,172.31.40.0-255,66,122959,64,302082
27560,0.001985,74.125.24.0-255,5738,128697,64,302082
27561,0.001987,172.31.40.0-255,66,128763,64,302082
27562,0.002025,74.125.24.0-255,7156,135919,64,302082
27563,0.002028,172.31.40.0-255,66,135985,64,302082
27564,0.002053,74.125.24.0-255,5738,141723,64,302082
27565,0.002055,172.31.40.0-255,66,141789,64,302082
27566,0.002067,172.31.40.0-255,66,141855,64,302082
27567,0.002096,172.31.40.0-255,66,141921,64,302082
27568,0.002099,74.125.24.0-255,1484,143405,64,302082
27569,0.002107,74.125.24.0-255,6438,149843,64,302082
27570,0.002109,172.31.40.0-255,66,149909,64,302082
27571,0.002134,74.125.24.0-255,2902,152811,64,302082
27572,0.002137,172.31.40.0-255,66,152877,64,302082
27573,0.004266,74.125.24.0-255,5738,158615,64,302082
27574,0.004273,172.31.40.0-255,66,158681,64,302082
27575,0.006382,74.125.24.0-255,5738,164419,64,302082
27576,0.006387,172.31.40.0-255,66,164485,64,302082
27577,0.008485,74.125.24.0-255,5738,170223,64,302082
27578,0.008491,172.31.40.0-255,66,170289,64,302082
27579,0.010665,74.125.24.0-255,5738,176027,64,302082
27580,0.010673,172.31.40.0-255,66,176093,64,302082
27581,0.012764,74.125.24.0-255,5738,181831,64,302082
27582,0.012772,172.31.40.0-255,66,181897,64,302082
27583,0.014884,74.125.24.0-255,5738,187635,64,302082
27584,0.014898,172.31.40.0-255,66,187701,64,302082
27585,0.017039,74.125.24.0-255,5738,193439,64,302082
27586,0.017045,172.31.40.0-255,66,193505,64,302082
27587,0.01921,74.125.24.0-255,5738,199243,64,302082
27588,0.019218,172.31.40.0-255,66,199309,64,302082
27589,0.021393,74.125.24.0-255,5738,205047,64,302082
27590,0.021399,172.31.40.0-255,66,205113,64,302082
27591,0.023519,74.125.24.0-255,5738,210851,64,302082
27592,0.023528,172.31.40.0-255,66,210917,64,302082
27593,0.025642,74.125.24.0-255,5738,216655,64,302082
27594,0.025652,172.31.40.0-255,66,216721,64,302082
27595,0.027747,74.125.24.0-255,5738,222459,64,302082
27596,0.027754,172.31.40.0-255,66,222525,64,302082
27597,0.028869,172.31.40.0-255,172,222697,64,302082
27598,0.028899,172.31.40.0-255,1111,223808,64,302082
27599,0.02896,172.31.40.0-255,1514,225322,64,302082
27600,0.028962,172.31.40.0-255,1514,226836,64,302082
27601,0.028968,172.31.40.0-255,1514,228350,64,302082
27602,0.028969,172.31.40.0-255,1078,229428,64,302082
27603,0.029843,74.125.24.0-255,5738,235166,64,302082
27604,0.029851,172.31.40.0-255,66,235232,64,302082
27605,0.030395,104.244.42.0-255,66,235298,64,302082
27606,0.030463,104.244.42.0-255,66,235364,64,302082
27607,0.03052,104.244.42.0-255,66,235430,64,302082
27608,0.030525,104.244.42.0-255,66,235496,64,302082
27609,0.031981,74.125.24.0-255,5738,241234,64,302082
27610,0.031988,172.31.40.0-255,66,241300,64,302082
27611,0.03409,74.125.24.0-255,5738,247038,64,302082
27612,0.034097,172.31.40.0-255,66,247104,64,302082
27613,0.036251,74.125.24.0-255,5738,252842,64,302082
27614,0.036258,172.31.40.0-255,66,252908,64,302082
27615,0.038343,74.125.24.0-255,5738,258646,64,302082
27616,0.03835,172.31.40.0-255,66,258712,64,302082
27617,0.04044,74.125.24.0-255,5738,264450,64,302082
27618,0.040447,172.31.40.0-255,66,264516,64,302082
27619,0.042562,74.125.24.0-255,5738,270254,64,302082
27620,0.042571,172.31.40.0-255,66,270320,64,302082
27621,0.044725,74.125.24.0-255,5738,276058,64,302082
27622,0.044731,172.31.40.0-255,66,276124,64,302082
27623,0.046817,74.125.24.0-255,5738,281862,64,302082
27624,0.046824,172.31.40.0-255,66,281928,64,302082
27625,0.048966,74.125.24.0-255,5738,287666,64,302082
27626,0.048972,172.31.40.0-255,66,287732,64,302082
27627,0.051076,74.125.24.0-255,5738,293470,64,302082
27628,0.051082,172.31.40.0-255,66,293536,64,302082
27629,0.053177,74.125.24.0-255,5738,299274,64,302082
27630,0.053183,172.31.40.0-255,66,299340,64,302082
27631,0.055321,74.125.24.0-255,2505,301845,64,302082
27632,0.055328,172.31.40.0-255,66,301911,64,302082
27633,0.055492,172.31.40.0-255,105,302016,64,302082
27634,0.057612,74.125.24.0-255,66,302082,64,302082
27635,0.0,74.125.68.0-255,150,150,64,314285
27636,2.2e-05,172.31.40.0-255,66,216,64,314285
27637,2.9e-05,74.125.68.0-255,1484,1700,64,314285
27638,3.4e-05,172.31.40.0-255,66,1766,64,314285
27639,4e-05,74.125.68.0-255,2902,4668,64,314285
27640,4.4e-05,172.31.40.0-255,66,4734,64,314285
27641,7.1e-05,74.125.68.0-255,1484,6218,64,314285
27642,7.4e-05,172.31.40.0-255,66,6284,64,314285
27643,0.0001,74.125.68.0-255,4320,10604,64,314285
27644,0.000103,172.31.40.0-255,66,10670,64,314285
27645,0.000109,74.125.68.0-255,3582,14252,64,314285
27646,0.000111,172.31.40.0-255,66,14318,64,314285
27647,0.000511,74.125.68.0-255,1484,15802,64,314285
27648,0.000516,172.31.40.0-255,66,15868,64,314285
27649,0.000535,74.125.68.0-255,1484,17352,64,314285
27650,0.000538,172.31.40.0-255,66,17418,64,314285
27651,0.000563,74.125.68.0-255,2902,20320,64,314285
27652,0.000565,172.31.40.0-255,66,20386,64,314285
27653,0.000589,74.125.68.0-255,5738,26124,64,314285
27654,0.000591,172.31.40.0-255,66,26190,64,314285
27655,0.000622,74.125.68.0-255,1484,27674,64,314285
27656,0.000625,172.31.40.0-255,66,27740,64,314285
27657,0.000646,74.125.68.0-255,5379,33119,64,314285
27658,0.000649,172.31.40.0-255,66,33185,64,314285
27659,0.000654,74.125.68.0-255,2902,36087,64,314285
27660,0.000656,172.31.40.0-255,66,36153,64,314285
27661,0.000659,74.125.68.0-255,1484,37637,64,314285
27662,0.000661,172.31.40.0-255,66,37703,64,314285
27663,0.000694,172.31.40.0-255,66,37769,64,314285
27664,0.000697,74.125.68.0-255,1125,38894,64,314285
27665,0.000699,172.31.40.0-255,66,38960,64,314285
27666,0.000863,74.125.68.0-255,1484,40444,64,314285
27667,0.000887,74.125.68.0-255,2902,43346,64,314285
27668,0.00089,74.125.68.0-255,1484,44830,64,314285
27669,0.000896,172.31.40.0-255,66,44896,64,314285
27670,0.000906,74.125.68.0-255,2902,47798,64,314285
27671,0.000908,172.31.40.0-255,66,47864,64,314285
27672,0.00095,74.125.68.0-255,5738,53602,64,314285
27673,0.000953,172.31.40.0-255,66,53668,64,314285
27674,0.000956,74.125.68.0-255,1484,55152,64,314285
27675,0.000991,74.125.68.0-255,1398,56550,64,314285
27676,0.000994,172.31.40.0-255,66,56616,64,314285
27677,0.001337,74.125.68.0-255,1484,58100,64,314285
27678,0.001345,74.125.68.0-255,1484,59584,64,314285
27679,0.00135,172.31.40.0-255,66,59650,64,314285
27680,0.001369,74.125.68.0-255,2902,62552,64,314285
27681,0.001372,172.31.40.0-255,66,62618,64,314285
27682,0.001389,74.125.68.0-255,2902,65520,64,314285
27683,0.001391,172.31.40.0-255,66,65586,64,314285
27684,0.001414,74.125.68.0-255,2902,68488,64,314285
27685,0.001417,172.31.40.0-255,66,68554,64,314285
27686,0.001428,172.31.40.0-255,66,68620,64,314285
27687,0.001439,74.125.68.0-255,1484,70104,64,314285
27688,0.001466,172.31.40.0-255,66,70170,64,314285
27689,0.001471,74.125.68.0-255,2902,73072,64,314285
27690,0.001473,172.31.40.0-255,66,73138,64,314285
27691,0.001509,74.125.68.0-255,766,73904,64,314285
27692,0.001575,74.125.68.0-255,1484,75388,64,314285
27693,0.001578,172.31.40.0-255,66,75454,64,314285
27694,0.001584,74.125.68.0-255,2902,78356,64,314285
27695,0.001587,172.31.40.0-255,66,78422,64,314285
27696,0.001604,74.125.68.0-255,1484,79906,64,314285
27697,0.001619,74.125.68.0-255,1484,81390,64,314285
27698,0.001622,172.31.40.0-255,66,81456,64,314285
27699,0.001639,74.125.68.0-255,1484,82940,64,314285
27700,0.001658,74.125.68.0-255,1484,84424,64,314285
27701,0.00166,172.31.40.0-255,66,84490,64,314285
27702,0.001695,74.125.68.0-255,2902,87392,64,314285
27703,0.001698,172.31.40.0-255,66,87458,64,314285
27704,0.001701,74.125.68.0-255,1484,88942,64,314285
27705,0.001718,74.125.68.0-255,1484,90426,64,314285
27706,0.001721,172.31.40.0-255,66,90492,64,314285
27707,0.001727,74.125.68.0-255,4320,94812,64,314285
27708,0.001729,172.31.40.0-255,66,94878,64,314285
27709,0.001742,74.125.68.0-255,1484,96362,64,314285
27710,0.001762,74.125.68.0-255,7156,103518,64,314285
27711,0.001765,172.31.40.0-255,66,103584,64,314285
27712,0.00177,74.125.68.0-255,4320,107904,64,314285
27713,0.001773,172.31.40.0-255,66,107970,64,314285
27714,0.001814,74.125.68.0-255,4320,112290,64,314285
27715,0.001817,172.31.40.0-255,66,112356,64,314285
27716,0.001833,74.125.68.0-255,7156,119512,64,314285
27717,0.001837,172.31.40.0-255,66,119578,64,314285
27718,0.001853,74.125.68.0-255,2184,121762,64,314285
27719,0.001856,172.31.40.0-255,66,121828,64,314285
27720,0.001862,74.125.68.0-255,5738,127566,64,314285
27721,0.001865,172.31.40.0-255,66,127632,64,314285
27722,0.001894,172.31.40.0-255,66,127698,64,314285
27723,0.001899,74.125.68.0-255,4320,132018,64,314285
27724,0.001901,172.31.40.0-255,66,132084,64,314285
27725,0.001924,74.125.68.0-255,2184,134268,64,314285
27726,0.001927,172.31.40.0-255,66,134334,64,314285
27727,0.001956,74.125.68.0-255,381,134715,64,314285
27728,0.00204,74.125.68.0-255,1484,136199,64,314285
27729,0.002045,172.31.40.0-255,66,136265,64,314285
27730,0.002051,74.125.68.0-255,2902,139167,64,314285
27731,0.002054,172.31.40.0-255,66,139233,64,314285
27732,0.002059,74.125.68.0-255,4320,143553,64,314285
27733,0.002061,172.31.40.0-255,66,143619,64,314285
27734,0.002085,74.125.68.0-255,5738,149357,64,314285
27735,0.002088,172.31.40.0-255,66,149423,64,314285
27736,0.002148,172.31.40.0-255,66,149489,64,314285
27737,0.002165,74.125.68.0-255,2902,152391,64,314285
27738,0.002167,172.31.40.0-255,66,152457,64,314285
27739,0.002172,74.125.68.0-255,4320,156777,64,314285
27740,0.002174,172.31.40.0-255,66,156843,64,314285
27741,0.002179,74.125.68.0-255,3602,160445,64,314285
27742,0.002181,172.31.40.0-255,66,160511,64,314285
27743,0.002216,74.125.68.0-255,1484,161995,64,314285
27744,0.002266,74.125.68.0-255,2902,164897,64,314285
27745,0.00227,172.31.40.0-255,66,164963,64,314285
27746,0.002312,74.125.68.0-255,2902,167865,64,314285
27747,0.002315,172.31.40.0-255,66,167931,64,314285
27748,0.002329,74.125.68.0-255,1484,169415,64,314285
27749,0.002333,74.125.68.0-255,1484,170899,64,314285
27750,0.002335,172.31.40.0-255,66,170965,64,314285
27751,0.002377,74.125.68.0-255,2902,173867,64,314285
27752,0.002385,74.125.68.0-255,5738,179605,64,314285
27753,0.00239,74.125.68.0-255,2902,182507,64,314285
27754,0.002429,74.125.68.0-255,1484,183991,64,314285
27755,0.002442,74.125.68.0-255,2902,186893,64,314285
27756,0.002481,74.125.68.0-255,4320,191213,64,314285
27757,0.002535,74.125.68.0-255,3602,194815,64,314285
27758,0.007417,172.31.40.0-255,66,194881,64,314285
27759,0.009941,74.125.68.0-255,5738,200619,64,314285
27760,0.009948,172.31.40.0-255,66,200685,64,314285
27761,0.012465,74.125.68.0-255,5738,206423,64,314285
27762,0.012473,172.31.40.0-255,66,206489,64,314285
27763,0.015029,74.125.68.0-255,5738,212227,64,314285
27764,0.015046,172.31.40.0-255,66,212293,64,314285
27765,0.017583,74.125.68.0-255,5738,218031,64,314285
27766,0.0176,172.31.40.0-255,66,218097,64,314285
27767,0.020131,74.125.68.0-255,5738,223835,64,314285
27768,0.020144,172.31.40.0-255,66,223901,64,314285
27769,0.022671,74.125.68.0-255,5738,229639,64,314285
27770,0.022679,172.31.40.0-255,66,229705,64,314285
27771,0.025218,74.125.68.0-255,5738,235443,64,314285
27772,0.025234,172.31.40.0-255,66,235509,64,314285
27773,0.027757,74.125.68.0-255,5738,241247,64,314285
27774,0.027766,172.31.40.0-255,66,241313,64,314285
27775,0.03029,74.125.68.0-255,5738,247051,64,314285
27776,0.030297,172.31.40.0-255,66,247117,64,314285
27777,0.03283,74.125.68.0-255,5738,252855,64,314285
27778,0.032835,172.31.40.0-255,66,252921,64,314285
27779,0.033707,172.31.40.0-255,167,253088,64,314285
27780,0.033734,172.31.40.0-255,1107,254195,64,314285
27781,0.033785,172.31.40.0-255,1514,255709,64,314285
27782,0.033787,172.31.40.0-255,338,256047,64,314285
27783,0.035266,104.244.42.0-255,66,256113,64,314285
27784,0.0353,104.244.42.0-255,66,256179,64,314285
27785,0.035347,104.244.42.0-255,66,256245,64,314285
27786,0.035391,74.125.68.0-255,5738,261983,64,314285
27787,0.035397,172.31.40.0-255,66,262049,64,314285
27788,0.037925,74.125.68.0-255,5738,267787,64,314285
27789,0.037931,172.31.40.0-255,66,267853,64,314285
27790,0.040489,74.125.68.0-255,5738,273591,64,314285
27791,0.040499,172.31.40.0-255,66,273657,64,314285
27792,0.043021,74.125.68.0-255,5738,279395,64,314285
27793,0.043028,172.31.40.0-255,66,279461,64,314285
27794,0.045556,74.125.68.0-255,5738,285199,64,314285
27795,0.045564,172.31.40.0-255,66,285265,64,314285
27796,0.048091,74.125.68.0-255,5738,291003,64,314285
27797,0.048098,172.31.40.0-255,66,291069,64,314285
27798,0.050632,74.125.68.0-255,5738,296807,64,314285
27799,0.050638,172.31.40.0-255,66,296873,64,314285
27800,0.053156,74.125.68.0-255,5738,302611,64,314285
27801,0.053162,172.31.40.0-255,66,302677,64,314285
27802,0.055697,74.125.68.0-255,5738,308415,64,314285
27803,0.055711,172.31.40.0-255,66,308481,64,314285
27804,0.058245,74.125.68.0-255,5738,314219,64,314285
27805,0.058253,172.31.40.0-255,66,314285,64,314285
27806,0.0,172.217.194.0-255,143,143,64,229070
27807,1.7e-05,172.31.40.0-255,66,209,64,229070
27808,2.4e-05,172.217.194.0-255,1484,1693,64,229070
27809,2.8e-05,172.31.40.0-255,66,1759,64,229070
27810,3.3e-05,172.217.194.0-255,2902,4661,64,229070
27811,4.2e-05,172.31.40.0-255,66,4727,64,229070
27812,4.8e-05,172.217.194.0-255,4320,9047,64,229070
27813,5.1e-05,172.31.40.0-255,66,9113,64,229070
27814,8.2e-05,172.217.194.0-255,2902,12015,64,229070
27815,8.4e-05,172.31.40.0-255,66,12081,64,229070
27816,0.000119,172.217.194.0-255,2074,14155,64,229070
27817,0.000121,172.31.40.0-255,66,14221,64,229070
27818,0.000187,172.217.194.0-255,1484,15705,64,229070
27819,0.000191,172.31.40.0-255,66,15771,64,229070
27820,0.000195,172.217.194.0-255,1484,17255,64,229070
27821,0.000196,172.31.40.0-255,66,17321,64,229070
27822,0.000219,172.217.194.0-255,1484,18805,64,229070
27823,0.000221,172.31.40.0-255,66,18871,64,229070
27824,0.000229,172.217.194.0-255,1484,20355,64,229070
27825,0.000231,172.31.40.0-255,66,20421,64,229070
27826,0.000265,172.217.194.0-255,1484,21905,64,229070
27827,0.000267,172.31.40.0-255,66,21971,64,229070
27828,0.000273,172.217.194.0-255,4320,26291,64,229070
27829,0.000275,172.31.40.0-255,66,26357,64,229070
27830,0.000316,172.217.194.0-255,5738,32095,64,229070
27831,0.000319,172.31.40.0-255,66,32161,64,229070
27832,0.000355,172.217.194.0-255,2543,34704,64,229070
27833,0.000357,172.31.40.0-255,66,34770,64,229070
27834,0.000374,172.31.40.0-255,66,34836,64,229070
27835,0.00038,172.217.194.0-255,5379,40215,64,229070
27836,0.000382,172.31.40.0-255,66,40281,64,229070
27837,0.000564,172.217.194.0-255,1484,41765,64,229070
27838,0.00057,172.217.194.0-255,1484,43249,64,229070
27839,0.000581,172.217.194.0-255,1484,44733,64,229070
27840,0.000588,172.217.194.0-255,5738,50471,64,229070
27841,0.000618,172.217.194.0-255,6797,57268,64,229070
27842,0.000629,172.217.194.0-255,365,57633,64,229070
27843,0.000649,172.31.40.0-255,66,57699,64,229070
27844,0.000748,172.217.194.0-255,377,58076,64,229070
27845,0.001118,172.217.194.0-255,1484,59560,64,229070
27846,0.001122,172.31.40.0-255,66,59626,64,229070
27847,0.001129,172.217.194.0-255,2902,62528,64,229070
27848,0.001131,172.31.40.0-255,66,62594,64,229070
27849,0.001136,172.217.194.0-255,4320,66914,64,229070
27850,0.001159,172.217.194.0-255,1484,68398,64,229070
27851,0.001189,172.217.194.0-255,2902,71300,64,229070
27852,0.001192,172.217.194.0-255,1484,72784,64,229070
27853,0.001199,172.31.40.0-255,66,72850,64,229070
27854,0.001209,172.217.194.0-255,1484,74334,64,229070
27855,0.001257,172.31.40.0-255,66,74400,64,229070
27856,0.001654,172.217.194.0-255,1484,75884,64,229070
27857,0.00166,172.217.194.0-255,2902,78786,64,229070
27858,0.001664,172.31.40.0-255,66,78852,64,229070
27859,0.001668,172.217.194.0-255,1484,80336,64,229070
27860,0.001698,172.217.194.0-255,4320,84656,64,229070
27861,0.0017,172.31.40.0-255,66,84722,64,229070
27862,0.001708,172.217.194.0-255,7156,91878,64,229070
27863,0.00171,172.31.40.0-255,66,91944,64,229070
27864,0.001736,172.217.194.0-255,5738,97682,64,229070
27865,0.00174,172.31.40.0-255,66,97748,64,229070
27866,0.001769,172.217.194.0-255,1484,99232,64,229070
27867,0.0018,172.31.40.0-255,66,99298,64,229070
27868,0.001852,172.217.194.0-255,2902,102200,64,229070
27869,0.001859,172.31.40.0-255,66,102266,64,229070
27870,0.001895,172.217.194.0-255,7156,109422,64,229070
27871,0.001905,172.31.40.0-255,66,109488,64,229070
27872,0.001919,172.217.194.0-255,1484,110972,64,229070
27873,0.001957,172.217.194.0-255,2902,113874,64,229070
27874,0.001963,172.217.194.0-255,4320,118194,64,229070
27875,0.001969,172.217.194.0-255,5738,123932,64,229070
27876,0.001974,172.31.40.0-255,66,123998,64,229070
27877,0.00199,172.217.194.0-255,2902,126900,64,229070
27878,0.002027,172.31.40.0-255,66,126966,64,229070
27879,0.002123,172.217.194.0-255,1484,128450,64,229070
27880,0.002127,172.217.194.0-255,1484,129934,64,229070
27881,0.00214,172.217.194.0-255,1484,131418,64,229070
27882,0.002143,172.31.40.0-255,66,131484,64,229070
27883,0.002174,172.217.194.0-255,5738,137222,64,229070
27884,0.002181,172.217.194.0-255,5738,142960,64,229070
27885,0.002219,172.217.194.0-255,4320,147280,64,229070
27886,0.002238,172.217.194.0-255,2902,150182,64,229070
27887,0.002252,172.31.40.0-255,66,150248,64,229070
27888,0.002261,172.31.40.0-255,66,150314,64,229070
27889,0.002649,172.217.194.0-255,1484,151798,64,229070
27890,0.002655,172.217.194.0-255,2902,154700,64,229070
27891,0.002659,172.31.40.0-255,66,154766,64,229070
27892,0.002667,172.217.194.0-255,5738,160504,64,229070
27893,0.002721,172.217.194.0-255,2902,163406,64,229070
27894,0.003345,172.217.194.0-255,1484,164890,64,229070
27895,0.003353,172.217.194.0-255,2902,167792,64,229070
27896,0.003358,172.217.194.0-255,2902,170694,64,229070
27897,0.003371,172.217.194.0-255,1484,172178,64,229070
27898,0.003375,172.217.194.0-255,1484,173662,64,229070
27899,0.003401,172.217.194.0-255,7156,180818,64,229070
27900,0.003423,172.217.194.0-255,5738,186556,64,229070
27901,0.003471,172.217.194.0-255,5738,192294,64,229070
27902,0.003494,172.217.194.0-255,1484,193778,64,229070
27903,0.003541,172.217.194.0-255,766,194544,64,229070
27904,0.003579,172.217.194.0-255,5738,200282,64,229070
27905,0.003597,172.217.194.0-255,2902,203184,64,229070
27906,0.003662,172.217.194.0-255,6438,209622,64,229070
27907,0.003665,172.217.194.0-255,1484,211106,64,229070
27908,0.003716,172.217.194.0-255,2902,214008,64,229070
27909,0.003731,172.217.194.0-255,1484,215492,64,229070
27910,0.003778,172.217.194.0-255,5738,221230,64,229070
27911,0.003795,172.217.194.0-255,3206,224436,64,229070
27912,0.003798,172.217.194.0-255,105,224541,64,229070
27913,0.009509,172.31.40.0-255,66,224607,64,229070
27914,0.011448,172.31.40.0-255,105,224712,64,229070
27915,0.013503,172.217.194.0-255,66,224778,64,229070
27916,0.029798,172.31.40.0-255,172,224950,64,229070
27917,0.029835,172.31.40.0-255,1112,226062,64,229070
27918,0.029898,172.31.40.0-255,1514,227576,64,229070
27919,0.0299,172.31.40.0-255,1296,228872,64,229070
27920,0.031363,104.244.42.0-255,66,228938,64,229070
27921,0.031394,104.244.42.0-255,66,229004,64,229070
27922,0.03145,104.244.42.0-255,66,229070,64,229070
27923,0.0,172.31.40.0-255,105,105,64,459
27924,0.000169,172.31.40.0-255,90,195,64,459
27925,0.00018,172.31.40.0-255,66,261,64,459
27926,0.002688,172.217.194.0-255,66,327,64,459
27927,0.00272,172.217.194.0-255,66,393,64,459
27928,0.002743,172.31.40.0-255,66,459,64,459
27929,0.0,74.125.200.0-255,153,153,64,371832
27930,2.4e-05,172.31.40.0-255,66,219,64,371832
27931,3.1e-05,74.125.200.0-255,1484,1703,64,371832
27932,3.7e-05,172.31.40.0-255,66,1769,64,371832
27933,5e-05,74.125.200.0-255,2902,4671,64,371832
27934,5.4e-05,172.31.40.0-255,66,4737,64,371832
27935,7.4e-05,74.125.200.0-255,2902,7639,64,371832
27936,8.2e-05,172.31.40.0-255,66,7705,64,371832
27937,0.000112,74.125.200.0-255,4320,12025,64,371832
27938,0.000116,172.31.40.0-255,66,12091,64,371832
27939,0.00012,74.125.200.0-255,2100,14191,64,371832
27940,0.000122,172.31.40.0-255,66,14257,64,371832
27941,0.000258,74.125.200.0-255,1484,15741,64,371832
27942,0.000262,172.31.40.0-255,66,15807,64,371832
27943,0.000291,74.125.200.0-255,2902,18709,64,371832
27944,0.000294,172.31.40.0-255,66,18775,64,371832
27945,0.000298,74.125.200.0-255,2902,21677,64,371832
27946,0.0003,172.31.40.0-255,66,21743,64,371832
27947,0.000311,74.125.200.0-255,4320,26063,64,371832
27948,0.000314,172.31.40.0-255,66,26129,64,371832
27949,0.000336,74.125.200.0-255,2902,29031,64,371832
27950,0.000339,172.31.40.0-255,66,29097,64,371832
27951,0.00036,74.125.200.0-255,2543,31640,64,371832
27952,0.000363,172.31.40.0-255,66,31706,64,371832
27953,0.000391,74.125.200.0-255,1484,33190,64,371832
27954,0.000394,172.31.40.0-255,66,33256,64,371832
27955,0.000399,74.125.200.0-255,2902,36158,64,371832
27956,0.000401,172.31.40.0-255,66,36224,64,371832
27957,0.000429,74.125.200.0-255,5738,41962,64,371832
27958,0.000432,172.31.40.0-255,66,42028,64,371832
27959,0.000444,74.125.200.0-255,6797,48825,64,371832
27960,0.000446,172.31.40.0-255,66,48891,64,371832
27961,0.00113,74.125.200.0-255,1484,50375,64,371832
27962,0.00114,74.125.200.0-255,1484,51859,64,371832
27963,0.001145,172.31.40.0-255,66,51925,64,371832
27964,0.001166,74.125.200.0-255,1484,53409,64,371832
27965,0.001174,74.125.200.0-255,5738,59147,64,371832
27966,0.001176,172.31.40.0-255,66,59213,64,371832
27967,0.001216,74.125.200.0-255,6797,66010,64,371832
27968,0.001219,172.31.40.0-255,66,66076,64,371832
27969,0.001227,74.125.200.0-255,7156,73232,64,371832
27970,0.001234,172.31.40.0-255,66,73298,64,371832
27971,0.00127,172.31.40.0-255,66,73364,64,371832
27972,0.001282,74.125.200.0-255,1484,74848,64,371832
27973,0.001303,74.125.200.0-255,2902,77750,64,371832
27974,0.001305,172.31.40.0-255,66,77816,64,371832
27975,0.001332,74.125.200.0-255,5738,83554,64,371832
27976,0.001335,172.31.40.0-255,66,83620,64,371832
27977,0.001339,74.125.200.0-255,1484,85104,64,371832
27978,0.001371,74.125.200.0-255,2902,88006,64,371832
27979,0.001374,172.31.40.0-255,66,88072,64,371832
27980,0.001408,74.125.200.0-255,2543,90615,64,371832
27981,0.001411,172.31.40.0-255,66,90681,64,371832
27982,0.00147,74.125.200.0-255,1484,92165,64,371832
27983,0.001475,74.125.200.0-255,1484,93649,64,371832
27984,0.001478,172.31.40.0-255,66,93715,64,371832
27985,0.00151,74.125.200.0-255,2902,96617,64,371832
27986,0.001514,172.31.40.0-255,66,96683,64,371832
27987,0.00152,74.125.200.0-255,5738,102421,64,371832
27988,0.00157,74.125.200.0-255,7156,109577,64,371832
27989,0.001584,74.125.200.0-255,1484,111061,64,371832
27990,0.001599,74.125.200.0-255,4182,115243,64,371832
27991,0.001709,74.125.200.0-255,1484,116727,64,371832
27992,0.001732,74.125.200.0-255,2902,119629,64,371832
27993,0.001735,74.125.200.0-255,1484,121113,64,371832
27994,0.001748,74.125.200.0-255,1484,122597,64,371832
27995,0.001769,74.125.200.0-255,4320,126917,64,371832
27996,0.001801,74.125.200.0-255,2902,129819,64,371832
27997,0.001857,74.125.200.0-255,5738,135557,64,371832
27998,0.001876,74.125.200.0-255,5020,140577,64,371832
27999,0.001978,74.125.200.0-255,1484,142061,64,371832
28000,0.002006,74.125.200.0-255,2902,144963,64,371832
28001,0.002013,74.125.200.0-255,4320,149283,64,371832
28002,0.002037,74.125.200.0-255,7156,156439,64,371832
28003,0.002048,74.125.200.0-255,1484,157923,64,371832
28004,0.002053,74.125.200.0-255,4320,162243,64,371832
28005,0.002056,74.125.200.0-255,1484,163727,64,371832
28006,0.002072,74.125.200.0-255,4320,168047,64,371832
28007,0.002094,74.125.200.0-255,1484,169531,64,371832
28008,0.002119,74.125.200.0-255,5020,174551,64,371832
28009,0.00213,74.125.200.0-255,1484,176035,64,371832
28010,0.00215,74.125.200.0-255,5738,181773,64,371832
28011,0.002154,74.125.200.0-255,2902,184675,64,371832
28012,0.002169,74.125.200.0-255,1484,186159,64,371832
28013,0.002182,74.125.200.0-255,4320,190479,64,371832
28014,0.00221,74.125.200.0-255,5738,196217,64,371832
28015,0.002228,74.125.200.0-255,1484,197701,64,371832
28016,0.002252,74.125.200.0-255,2184,199885,64,371832
28017,0.002337,74.125.200.0-255,1484,201369,64,371832
28018,0.00234,74.125.200.0-255,1484,202853,64,371832
28019,0.002352,74.125.200.0-255,1484,204337,64,371832
28020,0.002373,74.125.200.0-255,4320,208657,64,371832
28021,0.00238,74.125.200.0-255,4320,212977,64,371832
28022,0.002405,74.125.200.0-255,4320,217297,64,371832
28023,0.002411,74.125.200.0-255,5738,223035,64,371832
28024,0.00243,74.125.200.0-255,2902,225937,64,371832
28025,0.002454,74.125.200.0-255,2902,228839,64,371832
28026,0.002476,74.125.200.0-255,5020,233859,64,371832
28027,0.003608,74.125.200.0-255,1484,235343,64,371832
28028,0.003616,74.125.200.0-255,1484,236827,64,371832
28029,0.003633,74.125.200.0-255,1484,238311,64,371832
28030,0.00364,74.125.200.0-255,4320,242631,64,371832
28031,0.003676,74.125.200.0-255,5738,248369,64,371832
28032,0.003698,74.125.200.0-255,5738,254107,64,371832
28033,0.003724,74.125.200.0-255,1484,255591,64,371832
28034,0.003727,74.125.200.0-255,1484,257075,64,371832
28035,0.00373,74.125.200.0-255,1484,258559,64,371832
28036,0.003732,74.125.200.0-255,766,259325,64,371832
28037,0.003784,74.125.200.0-255,2902,262227,64,371832
28038,0.003787,74.125.200.0-255,1484,263711,64,371832
28039,0.003795,74.125.200.0-255,7156,270867,64,371832
28040,0.003803,74.125.200.0-255,7156,278023,64,371832
28041,0.003806,74.125.200.0-255,1484,279507,64,371832
28042,0.003833,74.125.200.0-255,5738,285245,64,371832
28043,0.003838,74.125.200.0-255,4320,289565,64,371832
28044,0.003862,74.125.200.0-255,1484,291049,64,371832
28045,0.003876,74.125.200.0-255,3602,294651,64,371832
28046,0.003882,74.125.200.0-255,5738,300389,64,371832
28047,0.003894,74.125.200.0-255,1484,301873,64,371832
28048,0.0039,74.125.200.0-255,5738,307611,64,371832
28049,0.003923,74.125.200.0-255,2902,310513,64,371832
28050,0.003939,74.125.200.0-255,7156,317669,64,371832
28051,0.003967,74.125.200.0-255,7156,324825,64,371832
28052,0.003971,74.125.200.0-255,2184,327009,64,371832
28053,0.00416,74.125.200.0-255,1484,328493,64,371832
28054,0.004164,74.125.200.0-255,1484,329977,64,371832
28055,0.00418,74.125.200.0-255,1484,331461,64,371832
28056,0.004185,74.125.200.0-255,4320,335781,64,371832
28057,0.004204,74.125.200.0-255,4320,340101,64,371832
28058,0.004226,74.125.200.0-255,4320,344421,64,371832
28059,0.00423,74.125.200.0-255,2902,347323,64,371832
28060,0.004248,74.125.200.0-255,4320,351643,64,371832
28061,0.004254,74.125.200.0-255,4320,355963,64,371832
28062,0.004278,74.125.200.0-255,4320,360283,64,371832
28063,0.004282,74.125.200.0-255,2184,362467,64,371832
28064,0.004286,74.125.200.0-255,2902,365369,64,371832
28065,0.004318,74.125.200.0-255,1830,367199,64,371832
28066,0.00435,74.125.200.0-255,105,367304,64,371832
28067,0.009952,172.31.40.0-255,66,367370,64,371832
28068,0.012925,172.31.40.0-255,105,367475,64,371832
28069,0.015417,74.125.200.0-255,66,367541,64,371832
28070,0.0489,172.31.40.0-255,171,367712,64,371832
28071,0.048928,172.31.40.0-255,1137,368849,64,371832
28072,0.048981,172.31.40.0-255,1514,370363,64,371832
28073,0.048982,172.31.40.0-255,1271,371634,64,371832
28074,0.050454,104.244.42.0-255,66,371700,64,371832
28075,0.050502,104.244.42.0-255,66,371766,64,371832
28076,0.05053,104.244.42.0-255,66,371832,64,371832
28077,0.0,74.125.130.0-255,150,150,64,286060
28078,2.1e-05,172.31.40.0-255,66,216,64,286060
28079,2.8e-05,74.125.130.0-255,1484,1700,64,286060
28080,3.4e-05,172.31.40.0-255,66,1766,64,286060
28081,4.7e-05,74.125.130.0-255,2902,4668,64,286060
28082,5.1e-05,172.31.40.0-255,66,4734,64,286060
28083,5.4e-05,74.125.130.0-255,1484,6218,64,286060
28084,5.7e-05,172.31.40.0-255,66,6284,64,286060
28085,6.3e-05,74.125.130.0-255,2902,9186,64,286060
28086,6.5e-05,172.31.40.0-255,66,9252,64,286060
28087,6.9e-05,74.125.130.0-255,2902,12154,64,286060
28088,7.1e-05,172.31.40.0-255,66,12220,64,286060
28089,0.000108,74.125.130.0-255,3544,15764,64,286060
28090,0.000111,172.31.40.0-255,66,15830,64,286060
28091,0.000115,74.125.130.0-255,2902,18732,64,286060
28092,0.000118,172.31.40.0-255,66,18798,64,286060
28093,0.000123,74.125.130.0-255,4320,23118,64,286060
28094,0.000125,172.31.40.0-255,66,23184,64,286060
28095,0.000164,172.31.40.0-255,66,23250,64,286060
28096,0.000293,74.125.130.0-255,1484,24734,64,286060
28097,0.000297,172.31.40.0-255,66,24800,64,286060
28098,0.000303,74.125.130.0-255,2902,27702,64,286060
28099,0.000305,172.31.40.0-255,66,27768,64,286060
28100,0.000326,74.125.130.0-255,4320,32088,64,286060
28101,0.000329,172.31.40.0-255,66,32154,64,286060
28102,0.000353,74.125.130.0-255,1484,33638,64,286060
28103,0.000355,172.31.40.0-255,66,33704,64,286060
28104,0.00036,74.125.130.0-255,2902,36606,64,286060
28105,0.000362,172.31.40.0-255,66,36672,64,286060
28106,0.000367,74.125.130.0-255,3961,40633,64,286060
28107,0.000369,172.31.40.0-255,66,40699,64,286060
28108,0.000391,74.125.130.0-255,1484,42183,64,286060
28109,0.000415,74.125.130.0-255,2902,45085,64,286060
28110,0.000417,172.31.40.0-255,66,45151,64,286060
28111,0.000422,74.125.130.0-255,4320,49471,64,286060
28112,0.000425,172.31.40.0-255,66,49537,64,286060
28113,0.000444,74.125.130.0-255,1484,51021,64,286060
28114,0.000455,74.125.130.0-255,5738,56759,64,286060
28115,0.000458,172.31.40.0-255,66,56825,64,286060
28116,0.000484,74.125.130.0-255,1417,58242,64,286060
28117,0.000862,74.125.130.0-255,98,58340,64,286060
28118,0.001084,172.31.40.0-255,66,58406,64,286060
28119,0.001328,74.125.130.0-255,1484,59890,64,286060
28120,0.001344,74.125.130.0-255,1484,61374,64,286060
28121,0.001348,172.31.40.0-255,66,61440,64,286060
28122,0.001375,74.125.130.0-255,2902,64342,64,286060
28123,0.001378,172.31.40.0-255,66,64408,64,286060
28124,0.001384,74.125.130.0-255,2902,67310,64,286060
28125,0.001385,172.31.40.0-255,66,67376,64,286060
28126,0.001408,74.125.130.0-255,2902,70278,64,286060
28127,0.00141,172.31.40.0-255,66,70344,64,286060
28128,0.001413,74.125.130.0-255,1484,71828,64,286060
28129,0.001417,74.125.130.0-255,2902,74730,64,286060
28130,0.00142,172.31.40.0-255,66,74796,64,286060
28131,0.001457,74.125.130.0-255,3961,78757,64,286060
28132,0.001459,172.31.40.0-255,66,78823,64,286060
28133,0.001462,74.125.130.0-255,1484,80307,64,286060
28134,0.001485,74.125.130.0-255,2902,83209,64,286060
28135,0.001487,172.31.40.0-255,66,83275,64,286060
28136,0.001506,172.31.40.0-255,66,83341,64,286060
28137,0.001513,74.125.130.0-255,5738,89079,64,286060
28138,0.001515,172.31.40.0-255,66,89145,64,286060
28139,0.00152,74.125.130.0-255,2902,92047,64,286060
28140,0.001521,172.31.40.0-255,66,92113,64,286060
28141,0.001551,74.125.130.0-255,4320,96433,64,286060
28142,0.001554,172.31.40.0-255,66,96499,64,286060
28143,0.001559,74.125.130.0-255,3602,100101,64,286060
28144,0.001561,172.31.40.0-255,66,100167,64,286060
28145,0.001974,74.125.130.0-255,1484,101651,64,286060
28146,0.001983,74.125.130.0-255,2902,104553,64,286060
28147,0.001987,172.31.40.0-255,66,104619,64,286060
28148,0.002008,74.125.130.0-255,4320,108939,64,286060
28149,0.002011,172.31.40.0-255,66,109005,64,286060
28150,0.002035,74.125.130.0-255,1484,110489,64,286060
28151,0.002041,74.125.130.0-255,7156,117645,64,286060
28152,0.002045,172.31.40.0-255,66,117711,64,286060
28153,0.002059,74.125.130.0-255,2902,120613,64,286060
28154,0.002061,172.31.40.0-255,66,120679,64,286060
28155,0.002085,74.125.130.0-255,7156,127835,64,286060
28156,0.002092,172.31.40.0-255,66,127901,64,286060
28157,0.002128,172.31.40.0-255,66,127967,64,286060
28158,0.002133,74.125.130.0-255,4320,132287,64,286060
28159,0.002135,172.31.40.0-255,66,132353,64,286060
28160,0.002219,172.31.40.0-255,66,132419,64,286060
28161,0.002226,74.125.130.0-255,7156,139575,64,286060
28162,0.002228,172.31.40.0-255,66,139641,64,286060
28163,0.002231,74.125.130.0-255,766,140407,64,286060
28164,0.00449,74.125.130.0-255,4320,144727,64,286060
28165,0.004498,172.31.40.0-255,66,144793,64,286060
28166,0.006753,74.125.130.0-255,5738,150531,64,286060
28167,0.006757,172.31.40.0-255,66,150597,64,286060
28168,0.009009,74.125.130.0-255,5738,156335,64,286060
28169,0.009016,172.31.40.0-255,66,156401,64,286060
28170,0.01127,74.125.130.0-255,5738,162139,64,286060
28171,0.011277,172.31.40.0-255,66,162205,64,286060
28172,0.013532,74.125.130.0-255,5738,167943,64,286060
28173,0.01354,172.31.40.0-255,66,168009,64,286060
28174,0.015799,74.125.130.0-255,5738,173747,64,286060
28175,0.015807,172.31.40.0-255,66,173813,64,286060
28176,0.018072,74.125.130.0-255,5738,179551,64,286060
28177,0.018081,172.31.40.0-255,66,179617,64,286060
28178,0.020343,74.125.130.0-255,5738,185355,64,286060
28179,0.020355,172.31.40.0-255,66,185421,64,286060
28180,0.022611,74.125.130.0-255,5738,191159,64,286060
28181,0.022619,172.31.40.0-255,66,191225,64,286060
28182,0.024874,74.125.130.0-255,5738,196963,64,286060
28183,0.024881,172.31.40.0-255,66,197029,64,286060
28184,0.027139,74.125.130.0-255,4320,201349,64,286060
28185,0.027145,172.31.40.0-255,66,201415,64,286060
28186,0.02717,74.125.130.0-255,1484,202899,64,286060
28187,0.027188,172.31.40.0-255,166,203065,64,286060
28188,0.027214,172.31.40.0-255,1131,204196,64,286060
28189,0.027263,172.31.40.0-255,1514,205710,64,286060
28190,0.027269,172.31.40.0-255,314,206024,64,286060
28191,0.028727,104.244.42.0-255,66,206090,64,286060
28192,0.028774,104.244.42.0-255,66,206156,64,286060
28193,0.028821,104.244.42.0-255,66,206222,64,286060
28194,0.029401,74.125.130.0-255,4320,210542,64,286060
28195,0.029409,172.31.40.0-255,66,210608,64,286060
28196,0.031693,74.125.130.0-255,5738,216346,64,286060
28197,0.031699,172.31.40.0-255,66,216412,64,286060
28198,0.033965,74.125.130.0-255,5738,222150,64,286060
28199,0.033977,172.31.40.0-255,66,222216,64,286060
28200,0.036232,74.125.130.0-255,5738,227954,64,286060
28201,0.036239,172.31.40.0-255,66,228020,64,286060
28202,0.038495,74.125.130.0-255,5738,233758,64,286060
28203,0.038502,172.31.40.0-255,66,233824,64,286060
28204,0.040771,74.125.130.0-255,5738,239562,64,286060
28205,0.040777,172.31.40.0-255,66,239628,64,286060
28206,0.043032,74.125.130.0-255,5738,245366,64,286060
28207,0.043038,172.31.40.0-255,66,245432,64,286060
28208,0.045311,74.125.130.0-255,5738,251170,64,286060
28209,0.045317,172.31.40.0-255,66,251236,64,286060
28210,0.047573,74.125.130.0-255,5738,256974,64,286060
28211,0.047579,172.31.40.0-255,66,257040,64,286060
28212,0.049837,74.125.130.0-255,5738,262778,64,286060
28213,0.049844,172.31.40.0-255,66,262844,64,286060
28214,0.052112,74.125.130.0-255,5738,268582,64,286060
28215,0.05212,172.31.40.0-255,66,268648,64,286060
28216,0.054392,74.125.130.0-255,5738,274386,64,286060
28217,0.0544,172.31.40.0-255,66,274452,64,286060
28218,0.056665,74.125.130.0-255,5738,280190,64,286060
28219,0.05667,172.31.40.0-255,66,280256,64,286060
28220,0.058936,74.125.130.0-255,5738,285994,64,286060
28221,0.058943,172.31.40.0-255,66,286060,64,286060
28222,0.0,172.253.118.0-255,146,146,64,271614
28223,2.1e-05,172.31.40.0-255,66,212,64,271614
28224,2.8e-05,172.253.118.0-255,1484,1696,64,271614
28225,3.2e-05,172.31.40.0-255,66,1762,64,271614
28226,3.7e-05,172.253.118.0-255,2902,4664,64,271614
28227,4.1e-05,172.31.40.0-255,66,4730,64,271614
28228,5.2e-05,172.253.118.0-255,4320,9050,64,271614
28229,5.5e-05,172.31.40.0-255,66,9116,64,271614
28230,6e-05,172.253.118.0-255,4858,13974,64,271614
28231,6.3e-05,172.31.40.0-255,66,14040,64,271614
28232,0.000127,172.253.118.0-255,1484,15524,64,271614
28233,0.00013,172.31.40.0-255,66,15590,64,271614
28234,0.000144,172.253.118.0-255,2902,18492,64,271614
28235,0.000156,172.31.40.0-255,66,18558,64,271614
28236,0.00016,172.253.118.0-255,2902,21460,64,271614
28237,0.000162,172.31.40.0-255,66,21526,64,271614
28238,0.000195,172.253.118.0-255,2902,24428,64,271614
28239,0.000197,172.31.40.0-255,66,24494,64,271614
28240,0.000204,172.253.118.0-255,6797,31291,64,271614
28241,0.000206,172.31.40.0-255,66,31357,64,271614
28242,0.000368,172.253.118.0-255,1484,32841,64,271614
28243,0.000373,172.31.40.0-255,66,32907,64,271614
28244,0.000378,172.253.118.0-255,2902,35809,64,271614
28245,0.00038,172.31.40.0-255,66,35875,64,271614
28246,0.000383,172.253.118.0-255,1484,37359,64,271614
28247,0.000385,172.31.40.0-255,66,37425,64,271614
28248,0.000412,172.253.118.0-255,4320,41745,64,271614
28249,0.000415,172.31.40.0-255,66,41811,64,271614
28250,0.00042,172.253.118.0-255,4320,46131,64,271614
28251,0.000421,172.31.40.0-255,66,46197,64,271614
28252,0.000455,172.253.118.0-255,2543,48740,64,271614
28253,0.000463,172.31.40.0-255,66,48806,64,271614
28254,0.00047,172.253.118.0-255,7156,55962,64,271614
28255,0.000473,172.31.40.0-255,66,56028,64,271614
28256,0.000479,172.253.118.0-255,5738,61766,64,271614
28257,0.000481,172.31.40.0-255,66,61832,64,271614
28258,0.000505,172.253.118.0-255,3961,65793,64,271614
28259,0.000508,172.31.40.0-255,66,65859,64,271614
28260,0.000689,172.253.118.0-255,396,66255,64,271614
28261,0.000919,172.31.40.0-255,66,66321,64,271614
28262,0.001134,172.253.118.0-255,1484,67805,64,271614
28263,0.001143,172.253.118.0-255,2902,70707,64,271614
28264,0.001147,172.31.40.0-255,66,70773,64,271614
28265,0.001156,172.253.118.0-255,5738,76511,64,271614
28266,0.001158,172.31.40.0-255,66,76577,64,271614
28267,0.001174,172.253.118.0-255,1484,78061,64,271614
28268,0.001211,172.31.40.0-255,66,78127,64,271614
28269,0.001225,172.253.118.0-255,1484,79611,64,271614
28270,0.001255,172.31.40.0-255,66,79677,64,271614
28271,0.001258,172.253.118.0-255,346,80023,64,271614
28272,0.001297,172.253.118.0-255,1484,81507,64,271614
28273,0.001301,172.31.40.0-255,66,81573,64,271614
28274,0.001306,172.253.118.0-255,4320,85893,64,271614
28275,0.001308,172.31.40.0-255,66,85959,64,271614
28276,0.00134,172.31.40.0-255,66,86025,64,271614
28277,0.001345,172.253.118.0-255,4320,90345,64,271614
28278,0.001348,172.31.40.0-255,66,90411,64,271614
28279,0.001372,172.253.118.0-255,2902,93313,64,271614
28280,0.001379,172.31.40.0-255,66,93379,64,271614
28281,0.001425,172.31.40.0-255,66,93445,64,271614
28282,0.001513,172.253.118.0-255,1484,94929,64,271614
28283,0.00152,172.253.118.0-255,2902,97831,64,271614
28284,0.001524,172.31.40.0-255,66,97897,64,271614
28285,0.001531,172.253.118.0-255,4320,102217,64,271614
28286,0.001533,172.31.40.0-255,66,102283,64,271614
28287,0.001557,172.253.118.0-255,1484,103767,64,271614
28288,0.001575,172.31.40.0-255,66,103833,64,271614
28289,0.001638,172.31.40.0-255,66,103899,64,271614
28290,0.003673,172.253.118.0-255,5738,109637,64,271614
28291,0.003679,172.31.40.0-255,66,109703,64,271614
28292,0.005699,172.253.118.0-255,5738,115441,64,271614
28293,0.005706,172.31.40.0-255,66,115507,64,271614
28294,0.007756,172.253.118.0-255,5738,121245,64,271614
28295,0.007766,172.31.40.0-255,66,121311,64,271614
28296,0.009806,172.253.118.0-255,5738,127049,64,271614
28297,0.009823,172.31.40.0-255,66,127115,64,271614
28298,0.011867,172.253.118.0-255,5738,132853,64,271614
28299,0.011881,172.31.40.0-255,66,132919,64,271614
28300,0.013899,172.253.118.0-255,5738,138657,64,271614
28301,0.01391,172.31.40.0-255,66,138723,64,271614
28302,0.015934,172.253.118.0-255,5738,144461,64,271614
28303,0.015946,172.31.40.0-255,66,144527,64,271614
28304,0.017973,172.253.118.0-255,5738,150265,64,271614
28305,0.017987,172.31.40.0-255,66,150331,64,271614
28306,0.019977,172.253.118.0-255,5738,156069,64,271614
28307,0.019989,172.31.40.0-255,66,156135,64,271614
28308,0.022064,172.253.118.0-255,5738,161873,64,271614
28309,0.022075,172.31.40.0-255,66,161939,64,271614
28310,0.024143,172.253.118.0-255,5738,167677,64,271614
28311,0.024151,172.31.40.0-255,66,167743,64,271614
28312,0.026174,172.253.118.0-255,5738,173481,64,271614
28313,0.026186,172.31.40.0-255,66,173547,64,271614
28314,0.028224,172.253.118.0-255,5738,179285,64,271614
28315,0.028237,172.31.40.0-255,66,179351,64,271614
28316,0.030248,172.253.118.0-255,5738,185089,64,271614
28317,0.030256,172.31.40.0-255,66,185155,64,271614
28318,0.030808,172.31.40.0-255,172,185327,64,271614
28319,0.030839,172.31.40.0-255,1111,186438,64,271614
28320,0.030897,172.31.40.0-255,1514,187952,64,271614
28321,0.030923,172.31.40.0-255,1514,189466,64,271614
28322,0.030927,172.31.40.0-255,694,190160,64,271614
28323,0.032236,172.253.118.0-255,5738,195898,64,271614
28324,0.032244,172.31.40.0-255,66,195964,64,271614
28325,0.032342,104.244.42.0-255,66,196030,64,271614
28326,0.032374,104.244.42.0-255,66,196096,64,271614
28327,0.032448,104.244.42.0-255,66,196162,64,271614
28328,0.034235,172.253.118.0-255,5738,201900,64,271614
28329,0.034245,172.31.40.0-255,66,201966,64,271614
28330,0.036268,172.253.118.0-255,5738,207704,64,271614
28331,0.036276,172.31.40.0-255,66,207770,64,271614
28332,0.038334,172.253.118.0-255,5738,213508,64,271614
28333,0.038341,172.31.40.0-255,66,213574,64,271614
28334,0.040339,172.253.118.0-255,5738,219312,64,271614
28335,0.040348,172.31.40.0-255,66,219378,64,271614
28336,0.042337,172.253.118.0-255,5738,225116,64,271614
28337,0.042344,172.31.40.0-255,66,225182,64,271614
28338,0.044359,172.253.118.0-255,5738,230920,64,271614
28339,0.044366,172.31.40.0-255,66,230986,64,271614
28340,0.046508,172.253.118.0-255,5738,236724,64,271614
28341,0.046515,172.31.40.0-255,66,236790,64,271614
28342,0.048552,172.253.118.0-255,5738,242528,64,271614
28343,0.048562,172.31.40.0-255,66,242594,64,271614
28344,0.050586,172.253.118.0-255,5738,248332,64,271614
28345,0.0506,172.31.40.0-255,66,248398,64,271614
28346,0.052632,172.253.118.0-255,5738,254136,64,271614
28347,0.052639,172.31.40.0-255,66,254202,64,271614
28348,0.05465,172.253.118.0-255,5738,259940,64,271614
28349,0.054656,172.31.40.0-255,66,260006,64,271614
28350,0.056712,172.253.118.0-255,5738,265744,64,271614
28351,0.056719,172.31.40.0-255,66,265810,64,271614
28352,0.058753,172.253.118.0-255,5738,271548,64,271614
28353,0.058759,172.31.40.0-255,66,271614,64,271614
28354,0.0,74.125.68.0-255,298,298,64,272284
28355,2.3e-05,172.31.40.0-255,66,364,64,272284
28356,3e-05,74.125.68.0-255,1484,1848,64,272284
28357,3.4e-05,172.31.40.0-255,66,1914,64,272284
28358,6.4e-05,74.125.68.0-255,4320,6234,64,272284
28359,6.7e-05,172.31.40.0-255,66,6300,64,272284
28360,7e-05,74.125.68.0-255,1484,7784,64,272284
28361,7.2e-05,172.31.40.0-255,66,7850,64,272284
28362,0.000118,74.125.68.0-255,2902,10752,64,272284
28363,0.000121,172.31.40.0-255,66,10818,64,272284
28364,0.000127,74.125.68.0-255,3243,14061,64,272284
28365,0.000129,172.31.40.0-255,66,14127,64,272284
28366,0.000239,74.125.68.0-255,1484,15611,64,272284
28367,0.000244,172.31.40.0-255,66,15677,64,272284
28368,0.00025,74.125.68.0-255,2902,18579,64,272284
28369,0.000252,172.31.40.0-255,66,18645,64,272284
28370,0.000286,74.125.68.0-255,4320,22965,64,272284
28371,0.000289,172.31.40.0-255,66,23031,64,272284
28372,0.000328,172.31.40.0-255,66,23097,64,272284
28373,0.000368,172.31.40.0-255,66,23163,64,272284
28374,0.000372,74.125.68.0-255,2902,26065,64,272284
28375,0.000374,172.31.40.0-255,66,26131,64,272284
28376,0.000412,172.31.40.0-255,66,26197,64,272284
28377,0.000418,74.125.68.0-255,4320,30517,64,272284
28378,0.000421,172.31.40.0-255,66,30583,64,272284
28379,0.000427,74.125.68.0-255,5020,35603,64,272284
28380,0.00043,172.31.40.0-255,66,35669,64,272284
28381,0.000433,74.125.68.0-255,359,36028,64,272284
28382,0.000436,172.31.40.0-255,66,36094,64,272284
28383,0.000479,74.125.68.0-255,414,36508,64,272284
28384,0.000815,74.125.68.0-255,1484,37992,64,272284
28385,0.000821,172.31.40.0-255,66,38058,64,272284
28386,0.000828,74.125.68.0-255,2902,40960,64,272284
28387,0.000831,172.31.40.0-255,66,41026,64,272284
28388,0.000866,74.125.68.0-255,2902,43928,64,272284
28389,0.000869,172.31.40.0-255,66,43994,64,272284
28390,0.000891,74.125.68.0-255,2902,46896,64,272284
28391,0.000894,172.31.40.0-255,66,46962,64,272284
28392,0.000916,74.125.68.0-255,7156,54118,64,272284
28393,0.000919,172.31.40.0-255,66,54184,64,272284
28394,0.000948,74.125.68.0-255,1484,55668,64,272284
28395,0.000954,74.125.68.0-255,2902,58570,64,272284
28396,0.000956,172.31.40.0-255,66,58636,64,272284
28397,0.000981,74.125.68.0-255,2902,61538,64,272284
28398,0.000984,172.31.40.0-255,66,61604,64,272284
28399,0.001011,74.125.68.0-255,4320,65924,64,272284
28400,0.001014,172.31.40.0-255,66,65990,64,272284
28401,0.001017,74.125.68.0-255,1484,67474,64,272284
28402,0.001063,74.125.68.0-255,2902,70376,64,272284
28403,0.001066,172.31.40.0-255,66,70442,64,272284
28404,0.001069,74.125.68.0-255,766,71208,64,272284
28405,0.001584,74.125.68.0-255,1484,72692,64,272284
28406,0.001591,172.31.40.0-255,66,72758,64,272284
28407,0.001598,74.125.68.0-255,2902,75660,64,272284
28408,0.0016,172.31.40.0-255,66,75726,64,272284
28409,0.001641,74.125.68.0-255,4320,80046,64,272284
28410,0.001644,172.31.40.0-255,66,80112,64,272284
28411,0.001649,74.125.68.0-255,2902,83014,64,272284
28412,0.001651,172.31.40.0-255,66,83080,64,272284
28413,0.00167,74.125.68.0-255,2902,85982,64,272284
28414,0.001676,172.31.40.0-255,66,86048,64,272284
28415,0.001681,74.125.68.0-255,2902,88950,64,272284
28416,0.001683,172.31.40.0-255,66,89016,64,272284
28417,0.00172,172.31.40.0-255,66,89082,64,272284
28418,0.001726,74.125.68.0-255,5738,94820,64,272284
28419,0.001729,172.31.40.0-255,66,94886,64,272284
28420,0.001737,74.125.68.0-255,2184,97070,64,272284
28421,0.00174,172.31.40.0-255,66,97136,64,272284
28422,0.001868,74.125.68.0-255,1484,98620,64,272284
28423,0.001875,74.125.68.0-255,2902,101522,64,272284
28424,0.001879,172.31.40.0-255,66,101588,64,272284
28425,0.001883,74.125.68.0-255,1484,103072,64,272284
28426,0.001913,74.125.68.0-255,2902,105974,64,272284
28427,0.001916,172.31.40.0-255,66,106040,64,272284
28428,0.001922,74.125.68.0-255,5738,111778,64,272284
28429,0.001924,172.31.40.0-255,66,111844,64,272284
28430,0.002001,172.31.40.0-255,66,111910,64,272284
28431,0.002013,172.31.40.0-255,66,111976,64,272284
28432,0.004081,74.125.68.0-255,5738,117714,64,272284
28433,0.004088,172.31.40.0-255,66,117780,64,272284
28434,0.006157,74.125.68.0-255,5738,123518,64,272284
28435,0.006163,172.31.40.0-255,66,123584,64,272284
28436,0.00823,74.125.68.0-255,2902,126486,64,272284
28437,0.008235,172.31.40.0-255,66,126552,64,272284
28438,0.00826,74.125.68.0-255,2902,129454,64,272284
28439,0.008262,172.31.40.0-255,66,129520,64,272284
28440,0.010293,74.125.68.0-255,2902,132422,64,272284
28441,0.010299,172.31.40.0-255,66,132488,64,272284
28442,0.010326,74.125.68.0-255,2902,135390,64,272284
28443,0.010328,172.31.40.0-255,66,135456,64,272284
28444,0.012366,74.125.68.0-255,2902,138358,64,272284
28445,0.012375,172.31.40.0-255,66,138424,64,272284
28446,0.012404,74.125.68.0-255,2902,141326,64,272284
28447,0.012406,172.31.40.0-255,66,141392,64,272284
28448,0.014431,74.125.68.0-255,2902,144294,64,272284
28449,0.014438,172.31.40.0-255,66,144360,64,272284
28450,0.014468,74.125.68.0-255,2902,147262,64,272284
28451,0.01447,172.31.40.0-255,66,147328,64,272284
28452,0.016497,74.125.68.0-255,2902,150230,64,272284
28453,0.016507,172.31.40.0-255,66,150296,64,272284
28454,0.016534,74.125.68.0-255,2902,153198,64,272284
28455,0.016537,172.31.40.0-255,66,153264,64,272284
28456,0.018575,74.125.68.0-255,4320,157584,64,272284
28457,0.018581,172.31.40.0-255,66,157650,64,272284
28458,0.018609,74.125.68.0-255,1484,159134,64,272284
28459,0.020639,74.125.68.0-255,4320,163454,64,272284
28460,0.020645,172.31.40.0-255,66,163520,64,272284
28461,0.02271,74.125.68.0-255,5738,169258,64,272284
28462,0.022718,172.31.40.0-255,66,169324,64,272284
28463,0.024774,74.125.68.0-255,5738,175062,64,272284
28464,0.024781,172.31.40.0-255,66,175128,64,272284
28465,0.026848,74.125.68.0-255,5738,180866,64,272284
28466,0.026856,172.31.40.0-255,66,180932,64,272284
28467,0.028932,74.125.68.0-255,5738,186670,64,272284
28468,0.028939,172.31.40.0-255,66,186736,64,272284
28469,0.031006,74.125.68.0-255,5738,192474,64,272284
28470,0.031013,172.31.40.0-255,66,192540,64,272284
28471,0.033118,74.125.68.0-255,5738,198278,64,272284
28472,0.033129,172.31.40.0-255,66,198344,64,272284
28473,0.035205,74.125.68.0-255,5738,204082,64,272284
28474,0.035211,172.31.40.0-255,66,204148,64,272284
28475,0.036458,172.31.40.0-255,172,204320,64,272284
28476,0.036493,172.31.40.0-255,1111,205431,64,272284
28477,0.036556,172.31.40.0-255,1514,206945,64,272284
28478,0.036557,172.31.40.0-255,1297,208242,64,272284
28479,0.037275,74.125.68.0-255,5738,213980,64,272284
28480,0.037282,172.31.40.0-255,66,214046,64,272284
28481,0.037978,104.244.42.0-255,66,214112,64,272284
28482,0.038006,104.244.42.0-255,66,214178,64,272284
28483,0.038119,104.244.42.0-255,66,214244,64,272284
28484,0.039355,74.125.68.0-255,5738,219982,64,272284
28485,0.03936,172.31.40.0-255,66,220048,64,272284
28486,0.041435,74.125.68.0-255,5738,225786,64,272284
28487,0.041442,172.31.40.0-255,66,225852,64,272284
28488,0.043508,74.125.68.0-255,5738,231590,64,272284
28489,0.043515,172.31.40.0-255,66,231656,64,272284
28490,0.045653,74.125.68.0-255,5738,237394,64,272284
28491,0.04566,172.31.40.0-255,66,237460,64,272284
28492,0.04772,74.125.68.0-255,5738,243198,64,272284
28493,0.047727,172.31.40.0-255,66,243264,64,272284
28494,0.049779,74.125.68.0-255,5738,249002,64,272284
28495,0.049785,172.31.40.0-255,66,249068,64,272284
28496,0.05189,74.125.68.0-255,5738,254806,64,272284
28497,0.051901,172.31.40.0-255,66,254872,64,272284
28498,0.053982,74.125.68.0-255,5738,260610,64,272284
28499,0.053989,172.31.40.0-255,66,260676,64,272284
28500,0.056059,74.125.68.0-255,5738,266414,64,272284
28501,0.056067,172.31.40.0-255,66,266480,64,272284
28502,0.058146,74.125.68.0-255,5738,272218,64,272284
28503,0.058155,172.31.40.0-255,66,272284,64,272284
28504,0.0,172.217.194.0-255,143,143,64,126474
28505,2.1e-05,172.31.40.0-255,66,209,64,126474
28506,2.9e-05,172.217.194.0-255,1484,1693,64,126474
28507,3.4e-05,172.31.40.0-255,66,1759,64,126474
28508,4.6e-05,172.217.194.0-255,2902,4661,64,126474
28509,5.1e-05,172.31.40.0-255,66,4727,64,126474
28510,6e-05,172.217.194.0-255,7156,11883,64,126474
28511,6.3e-05,172.31.40.0-255,66,11949,64,126474
28512,7.6e-05,172.31.40.0-255,66,12015,64,126474
28513,8.8e-05,172.31.40.0-255,66,12081,64,126474
28514,0.000142,172.217.194.0-255,1484,13565,64,126474
28515,0.000145,172.31.40.0-255,66,13631,64,126474
28516,0.00015,172.217.194.0-255,2902,16533,64,126474
28517,0.000153,172.31.40.0-255,66,16599,64,126474
28518,0.000162,172.217.194.0-255,2902,19501,64,126474
28519,0.000164,172.31.40.0-255,66,19567,64,126474
28520,0.000194,172.217.194.0-255,2902,22469,64,126474
28521,0.000197,172.31.40.0-255,66,22535,64,126474
28522,0.000212,172.31.40.0-255,66,22601,64,126474
28523,0.000225,172.31.40.0-255,66,22667,64,126474
28524,0.000227,172.217.194.0-255,376,23043,64,126474
28525,0.000229,172.31.40.0-255,66,23109,64,126474
28526,0.000346,172.217.194.0-255,368,23477,64,126474
28527,0.000351,172.31.40.0-255,66,23543,64,126474
28528,0.000459,172.217.194.0-255,1484,25027,64,126474
28529,0.000464,172.31.40.0-255,66,25093,64,126474
28530,0.000469,172.217.194.0-255,2902,27995,64,126474
28531,0.000471,172.31.40.0-255,66,28061,64,126474
28532,0.000482,172.217.194.0-255,5738,33799,64,126474
28533,0.000485,172.31.40.0-255,66,33865,64,126474
28534,0.000516,172.217.194.0-255,4320,38185,64,126474
28535,0.000519,172.31.40.0-255,66,38251,64,126474
28536,0.000542,172.217.194.0-255,2543,40794,64,126474
28537,0.000545,172.31.40.0-255,66,40860,64,126474
28538,0.000552,172.217.194.0-255,7156,48016,64,126474
28539,0.000554,172.31.40.0-255,66,48082,64,126474
28540,0.000613,172.31.40.0-255,66,48148,64,126474
28541,0.000967,172.217.194.0-255,1484,49632,64,126474
28542,0.000972,172.217.194.0-255,2902,52534,64,126474
28543,0.000979,172.31.40.0-255,66,52600,64,126474
28544,0.000991,172.217.194.0-255,5738,58338,64,126474
28545,0.000998,172.31.40.0-255,66,58404,64,126474
28546,0.001038,172.31.40.0-255,66,58470,64,126474
28547,0.001043,172.217.194.0-255,2902,61372,64,126474
28548,0.001045,172.31.40.0-255,66,61438,64,126474
28549,0.001085,172.31.40.0-255,66,61504,64,126474
28550,0.001119,172.217.194.0-255,4320,65824,64,126474
28551,0.001121,172.31.40.0-255,66,65890,64,126474
28552,0.001159,172.217.194.0-255,4320,70210,64,126474
28553,0.001162,172.31.40.0-255,66,70276,64,126474
28554,0.00118,172.31.40.0-255,66,70342,64,126474
28555,0.001187,172.217.194.0-255,6438,76780,64,126474
28556,0.001192,172.31.40.0-255,66,76846,64,126474
28557,0.001221,172.217.194.0-255,1484,78330,64,126474
28558,0.001226,172.217.194.0-255,2902,81232,64,126474
28559,0.001229,172.31.40.0-255,66,81298,64,126474
28560,0.001232,172.217.194.0-255,1484,82782,64,126474
28561,0.001257,172.217.194.0-255,4320,87102,64,126474
28562,0.00126,172.31.40.0-255,66,87168,64,126474
28563,0.001274,172.31.40.0-255,66,87234,64,126474
28564,0.001277,172.217.194.0-255,1484,88718,64,126474
28565,0.001328,172.31.40.0-255,66,88784,64,126474
28566,0.001332,172.217.194.0-255,1484,90268,64,126474
28567,0.001376,172.31.40.0-255,66,90334,64,126474
28568,0.001413,172.31.40.0-255,66,90400,64,126474
28569,0.001426,172.31.40.0-255,66,90466,64,126474
28570,0.001463,172.217.194.0-255,5738,96204,64,126474
28571,0.001467,172.31.40.0-255,66,96270,64,126474
28572,0.001487,172.31.40.0-255,66,96336,64,126474
28573,0.001497,172.31.40.0-255,66,96402,64,126474
28574,0.001521,172.31.40.0-255,66,96468,64,126474
28575,0.001581,172.31.40.0-255,66,96534,64,126474
28576,0.00159,172.217.194.0-255,7156,103690,64,126474
28577,0.001592,172.31.40.0-255,66,103756,64,126474
28578,0.001637,172.31.40.0-255,66,103822,64,126474
28579,0.001653,172.31.40.0-255,66,103888,64,126474
28580,0.001656,172.217.194.0-255,1484,105372,64,126474
28581,0.001731,172.217.194.0-255,2902,108274,64,126474
28582,0.001734,172.31.40.0-255,66,108340,64,126474
28583,0.00174,172.217.194.0-255,5738,114078,64,126474
28584,0.001742,172.31.40.0-255,66,114144,64,126474
28585,0.001755,172.31.40.0-255,66,114210,64,126474
28586,0.00176,172.217.194.0-255,4320,118530,64,126474
28587,0.001762,172.31.40.0-255,66,118596,64,126474
28588,0.001821,172.31.40.0-255,66,118662,64,126474
28589,0.001838,172.31.40.0-255,66,118728,64,126474
28590,0.001853,172.31.40.0-255,66,118794,64,126474
28591,0.001864,172.31.40.0-255,66,118860,64,126474
28592,0.001866,172.217.194.0-255,105,118965,64,126474
28593,0.008484,172.31.40.0-255,101,119066,64,126474
28594,0.008761,172.31.40.0-255,105,119171,64,126474
28595,0.011013,172.217.194.0-255,66,119237,64,126474
28596,0.011276,172.217.194.0-255,66,119303,64,126474
28597,0.030094,172.31.40.0-255,172,119475,64,126474
28598,0.030126,172.31.40.0-255,1112,120587,64,126474
28599,0.030178,172.31.40.0-255,1514,122101,64,126474
28600,0.030179,172.31.40.0-255,1514,123615,64,126474
28601,0.030184,172.31.40.0-255,1514,125129,64,126474
28602,0.030185,172.31.40.0-255,1081,126210,64,126474
28603,0.031579,104.244.42.0-255,66,126276,64,126474
28604,0.031604,104.244.42.0-255,66,126342,64,126474
28605,0.031678,104.244.42.0-255,66,126408,64,126474
28606,0.031699,104.244.42.0-255,66,126474,64,126474
28607,0.0,172.217.194.0-255,150,150,64,320094
28608,2.5e-05,172.31.40.0-255,66,216,64,320094
28609,3.2e-05,172.217.194.0-255,1484,1700,64,320094
28610,3.6e-05,172.31.40.0-255,66,1766,64,320094
28611,4.1e-05,172.217.194.0-255,2902,4668,64,320094
28612,4.4e-05,172.31.40.0-255,66,4734,64,320094
28613,5e-05,172.217.194.0-255,5738,10472,64,320094
28614,5.3e-05,172.31.40.0-255,66,10538,64,320094
28615,9.4e-05,172.217.194.0-255,6286,16824,64,320094
28616,9.7e-05,172.31.40.0-255,66,16890,64,320094
28617,0.000104,172.217.194.0-255,7156,24046,64,320094
28618,0.000106,172.31.40.0-255,66,24112,64,320094
28619,0.000123,172.217.194.0-255,1484,25596,64,320094
28620,0.000125,172.31.40.0-255,66,25662,64,320094
28621,0.00015,172.217.194.0-255,5379,31041,64,320094
28622,0.000152,172.31.40.0-255,66,31107,64,320094
28623,0.00017,172.217.194.0-255,5738,36845,64,320094
28624,0.000172,172.31.40.0-255,66,36911,64,320094
28625,0.0002,172.217.194.0-255,1484,38395,64,320094
28626,0.000202,172.31.40.0-255,66,38461,64,320094
28627,0.000213,172.217.194.0-255,7156,45617,64,320094
28628,0.000215,172.31.40.0-255,66,45683,64,320094
28629,0.00023,172.217.194.0-255,2543,48226,64,320094
28630,0.000232,172.31.40.0-255,66,48292,64,320094
28631,0.000627,172.217.194.0-255,1484,49776,64,320094
28632,0.000633,172.31.40.0-255,66,49842,64,320094
28633,0.000638,172.217.194.0-255,2902,52744,64,320094
28634,0.00064,172.31.40.0-255,66,52810,64,320094
28635,0.000672,172.217.194.0-255,2902,55712,64,320094
28636,0.000675,172.31.40.0-255,66,55778,64,320094
28637,0.00068,172.217.194.0-255,4320,60098,64,320094
28638,0.000682,172.31.40.0-255,66,60164,64,320094
28639,0.000702,172.217.194.0-255,4320,64484,64,320094
28640,0.000705,172.31.40.0-255,66,64550,64,320094
28641,0.000728,172.217.194.0-255,5379,69929,64,320094
28642,0.00073,172.31.40.0-255,66,69995,64,320094
28643,0.000736,172.217.194.0-255,5738,75733,64,320094
28644,0.000738,172.31.40.0-255,66,75799,64,320094
28645,0.000756,172.217.194.0-255,6797,82596,64,320094
28646,0.000759,172.31.40.0-255,66,82662,64,320094
28647,0.000785,172.217.194.0-255,2902,85564,64,320094
28648,0.000787,172.31.40.0-255,66,85630,64,320094
28649,0.000808,172.217.194.0-255,4320,89950,64,320094
28650,0.00081,172.31.40.0-255,66,90016,64,320094
28651,0.000816,172.217.194.0-255,5738,95754,64,320094
28652,0.000819,172.31.40.0-255,66,95820,64,320094
28653,0.000839,172.217.194.0-255,4541,100361,64,320094
28654,0.000842,172.31.40.0-255,66,100427,64,320094
28655,0.00087,172.31.40.0-255,66,100493,64,320094
28656,0.000876,172.217.194.0-255,4715,105208,64,320094
28657,0.000877,172.31.40.0-255,66,105274,64,320094
28658,0.000946,172.217.194.0-255,198,105472,64,320094
28659,0.001271,172.217.194.0-255,1484,106956,64,320094
28660,0.001276,172.31.40.0-255,66,107022,64,320094
28661,0.001281,172.217.194.0-255,2902,109924,64,320094
28662,0.001283,172.31.40.0-255,66,109990,64,320094
28663,0.001289,172.217.194.0-255,4320,114310,64,320094
28664,0.001292,172.31.40.0-255,66,114376,64,320094
28665,0.001315,172.217.194.0-255,1484,115860,64,320094
28666,0.001327,172.31.40.0-255,66,115926,64,320094
28667,0.001352,172.217.194.0-255,4320,120246,64,320094
28668,0.001355,172.31.40.0-255,66,120312,64,320094
28669,0.001367,172.31.40.0-255,66,120378,64,320094
28670,0.001593,172.217.194.0-255,1484,121862,64,320094
28671,0.0016,172.217.194.0-255,2902,124764,64,320094
28672,0.001603,172.31.40.0-255,66,124830,64,320094
28673,0.00161,172.217.194.0-255,5738,130568,64,320094
28674,0.001612,172.31.40.0-255,66,130634,64,320094
28675,0.001626,172.217.194.0-255,1484,132118,64,320094
28676,0.001661,172.31.40.0-255,66,132184,64,320094
28677,0.001682,172.217.194.0-255,4320,136504,64,320094
28678,0.001686,172.31.40.0-255,66,136570,64,320094
28679,0.001705,172.31.40.0-255,66,136636,64,320094
28680,0.001939,172.217.194.0-255,1484,138120,64,320094
28681,0.001945,172.217.194.0-255,2902,141022,64,320094
28682,0.001949,172.31.40.0-255,66,141088,64,320094
28683,0.001956,172.217.194.0-255,4320,145408,64,320094
28684,0.001958,172.31.40.0-255,66,145474,64,320094
28685,0.001971,172.217.194.0-255,1484,146958,64,320094
28686,0.001984,172.217.194.0-255,1484,148442,64,320094
28687,0.001987,172.31.40.0-255,66,148508,64,320094
28688,0.00202,172.31.40.0-255,66,148574,64,320094
28689,0.002033,172.31.40.0-255,66,148640,64,320094
28690,0.002057,172.217.194.0-255,1484,150124,64,320094
28691,0.002062,172.217.194.0-255,2902,153026,64,320094
28692,0.002064,172.31.40.0-255,66,153092,64,320094
28693,0.002067,172.217.194.0-255,1484,154576,64,320094
28694,0.002083,172.217.194.0-255,2902,157478,64,320094
28695,0.002085,172.31.40.0-255,66,157544,64,320094
28696,0.002088,172.217.194.0-255,1484,159028,64,320094
28697,0.002112,172.217.194.0-255,7156,166184,64,320094
28698,0.002115,172.31.40.0-255,66,166250,64,320094
28699,0.002136,172.217.194.0-255,4320,170570,64,320094
28700,0.002139,172.31.40.0-255,66,170636,64,320094
28701,0.00218,172.31.40.0-255,66,170702,64,320094
28702,0.004422,172.217.194.0-255,5738,176440,64,320094
28703,0.004446,172.31.40.0-255,66,176506,64,320094
28704,0.006697,172.217.194.0-255,5738,182244,64,320094
28705,0.00672,172.31.40.0-255,66,182310,64,320094
28706,0.008931,172.217.194.0-255,5738,188048,64,320094
28707,0.008946,172.31.40.0-255,66,188114,64,320094
28708,0.011147,172.217.194.0-255,5738,193852,64,320094
28709,0.011155,172.31.40.0-255,66,193918,64,320094
28710,0.013392,172.217.194.0-255,5738,199656,64,320094
28711,0.013412,172.31.40.0-255,66,199722,64,320094
28712,0.015646,172.217.194.0-255,5738,205460,64,320094
28713,0.015663,172.31.40.0-255,66,205526,64,320094
28714,0.017889,172.217.194.0-255,5738,211264,64,320094
28715,0.017902,172.31.40.0-255,66,211330,64,320094
28716,0.020133,172.217.194.0-255,5738,217068,64,320094
28717,0.020146,172.31.40.0-255,66,217134,64,320094
28718,0.022357,172.217.194.0-255,5738,222872,64,320094
28719,0.022366,172.31.40.0-255,66,222938,64,320094
28720,0.024593,172.217.194.0-255,5738,228676,64,320094
28721,0.024611,172.31.40.0-255,66,228742,64,320094
28722,0.026827,172.217.194.0-255,5738,234480,64,320094
28723,0.026844,172.31.40.0-255,66,234546,64,320094
28724,0.029083,172.217.194.0-255,5738,240284,64,320094
28725,0.029101,172.31.40.0-255,66,240350,64,320094
28726,0.031349,172.217.194.0-255,5738,246088,64,320094
28727,0.031369,172.31.40.0-255,66,246154,64,320094
28728,0.033561,172.217.194.0-255,5738,251892,64,320094
28729,0.033569,172.31.40.0-255,66,251958,64,320094
28730,0.035825,172.217.194.0-255,5738,257696,64,320094
28731,0.035839,172.31.40.0-255,66,257762,64,320094
28732,0.038105,172.217.194.0-255,5738,263500,64,320094
28733,0.038124,172.31.40.0-255,66,263566,64,320094
28734,0.040372,172.217.194.0-255,5738,269304,64,320094
28735,0.040396,172.31.40.0-255,66,269370,64,320094
28736,0.042652,172.217.194.0-255,5738,275108,64,320094
28737,0.042672,172.31.40.0-255,66,275174,64,320094
28738,0.044909,172.217.194.0-255,5738,280912,64,320094
28739,0.044929,172.31.40.0-255,66,280978,64,320094
28740,0.047153,172.217.194.0-255,5738,286716,64,320094
28741,0.047174,172.31.40.0-255,66,286782,64,320094
28742,0.049397,172.217.194.0-255,5738,292520,64,320094
28743,0.049411,172.31.40.0-255,66,292586,64,320094
28744,0.051407,172.31.40.0-255,172,292758,64,320094
28745,0.051441,172.31.40.0-255,1112,293870,64,320094
28746,0.051514,172.31.40.0-255,1514,295384,64,320094
28747,0.051516,172.31.40.0-255,1296,296680,64,320094
28748,0.051629,172.217.194.0-255,5738,302418,64,320094
28749,0.051636,172.31.40.0-255,66,302484,64,320094
28750,0.052944,104.244.42.0-255,66,302550,64,320094
28751,0.053,104.244.42.0-255,66,302616,64,320094
28752,0.053123,104.244.42.0-255,66,302682,64,320094
28753,0.053863,172.217.194.0-255,5738,308420,64,320094
28754,0.053876,172.31.40.0-255,66,308486,64,320094
28755,0.056121,172.217.194.0-255,5738,314224,64,320094
28756,0.056141,172.31.40.0-255,66,314290,64,320094
28757,0.058399,172.217.194.0-255,5738,320028,64,320094
28758,0.058419,172.31.40.0-255,66,320094,64,320094
28759,0.0,172.31.40.0-255,105,105,64,105
28760,0.0,74.125.130.0-255,152,152,64,324825
28761,2.3e-05,172.31.40.0-255,66,218,64,324825
28762,3e-05,74.125.130.0-255,1484,1702,64,324825
28763,3.4e-05,172.31.40.0-255,66,1768,64,324825
28764,4e-05,74.125.130.0-255,2902,4670,64,324825
28765,4.5e-05,172.31.40.0-255,66,4736,64,324825
28766,4.8e-05,74.125.130.0-255,1484,6220,64,324825
28767,5e-05,172.31.40.0-255,66,6286,64,324825
28768,5.5e-05,74.125.130.0-255,2902,9188,64,324825
28769,5.7e-05,172.31.40.0-255,66,9254,64,324825
28770,9.7e-05,74.125.130.0-255,2902,12156,64,324825
28771,0.0001,172.31.40.0-255,66,12222,64,324825
28772,0.000117,74.125.130.0-255,2038,14260,64,324825
28773,0.00012,172.31.40.0-255,66,14326,64,324825
28774,0.000345,74.125.130.0-255,1484,15810,64,324825
28775,0.000351,172.31.40.0-255,66,15876,64,324825
28776,0.000369,74.125.130.0-255,2902,18778,64,324825
28777,0.000373,172.31.40.0-255,66,18844,64,324825
28778,0.000378,74.125.130.0-255,4320,23164,64,324825
28779,0.00038,172.31.40.0-255,66,23230,64,324825
28780,0.000395,74.125.130.0-255,1484,24714,64,324825
28781,0.000397,172.31.40.0-255,66,24780,64,324825
28782,0.000403,74.125.130.0-255,5738,30518,64,324825
28783,0.000406,172.31.40.0-255,66,30584,64,324825
28784,0.000463,74.125.130.0-255,2543,33127,64,324825
28785,0.000466,172.31.40.0-255,66,33193,64,324825
28786,0.000487,74.125.130.0-255,2902,36095,64,324825
28787,0.000491,172.31.40.0-255,66,36161,64,324825
28788,0.000506,74.125.130.0-255,5738,41899,64,324825
28789,0.000509,172.31.40.0-255,66,41965,64,324825
28790,0.000521,74.125.130.0-255,1484,43449,64,324825
28791,0.000523,172.31.40.0-255,66,43515,64,324825
28792,0.000527,74.125.130.0-255,1484,44999,64,324825
28793,0.000531,74.125.130.0-255,2902,47901,64,324825
28794,0.000534,172.31.40.0-255,66,47967,64,324825
28795,0.000536,74.125.130.0-255,1125,49092,64,324825
28796,0.000639,74.125.130.0-255,1484,50576,64,324825
28797,0.000643,172.31.40.0-255,66,50642,64,324825
28798,0.000647,74.125.130.0-255,1484,52126,64,324825
28799,0.000663,74.125.130.0-255,2902,55028,64,324825
28800,0.000666,172.31.40.0-255,66,55094,64,324825
28801,0.000668,74.125.130.0-255,1484,56578,64,324825
28802,0.000688,74.125.130.0-255,4320,60898,64,324825
28803,0.000691,172.31.40.0-255,66,60964,64,324825
28804,0.000707,74.125.130.0-255,5379,66343,64,324825
28805,0.00071,172.31.40.0-255,66,66409,64,324825
28806,0.000739,74.125.130.0-255,645,67054,64,324825
28807,0.000897,74.125.130.0-255,1484,68538,64,324825
28808,0.000902,172.31.40.0-255,66,68604,64,324825
28809,0.000908,74.125.130.0-255,2902,71506,64,324825
28810,0.00091,172.31.40.0-255,66,71572,64,324825
28811,0.000936,74.125.130.0-255,1484,73056,64,324825
28812,0.000952,74.125.130.0-255,4320,77376,64,324825
28813,0.000955,172.31.40.0-255,66,77442,64,324825
28814,0.000959,74.125.130.0-255,2902,80344,64,324825
28815,0.000961,172.31.40.0-255,66,80410,64,324825
28816,0.000986,74.125.130.0-255,3961,84371,64,324825
28817,0.00099,172.31.40.0-255,66,84437,64,324825
28818,0.001,74.125.130.0-255,1484,85921,64,324825
28819,0.001012,74.125.130.0-255,1484,87405,64,324825
28820,0.001014,172.31.40.0-255,66,87471,64,324825
28821,0.001033,74.125.130.0-255,4320,91791,64,324825
28822,0.001035,172.31.40.0-255,66,91857,64,324825
28823,0.001061,74.125.130.0-255,4320,96177,64,324825
28824,0.001064,172.31.40.0-255,66,96243,64,324825
28825,0.00109,74.125.130.0-255,5379,101622,64,324825
28826,0.001093,172.31.40.0-255,66,101688,64,324825
28827,0.001532,74.125.130.0-255,1484,103172,64,324825
28828,0.001565,74.125.130.0-255,2902,106074,64,324825
28829,0.001569,172.31.40.0-255,66,106140,64,324825
28830,0.001572,74.125.130.0-255,1484,107624,64,324825
28831,0.001576,74.125.130.0-255,2902,110526,64,324825
28832,0.001578,172.31.40.0-255,66,110592,64,324825
28833,0.001616,74.125.130.0-255,5738,116330,64,324825
28834,0.001617,172.31.40.0-255,66,116396,64,324825
28835,0.001644,74.125.130.0-255,5738,122134,64,324825
28836,0.001646,172.31.40.0-255,66,122200,64,324825
28837,0.001668,74.125.130.0-255,1484,123684,64,324825
28838,0.001673,74.125.130.0-255,4320,128004,64,324825
28839,0.001674,172.31.40.0-255,66,128070,64,324825
28840,0.001703,74.125.130.0-255,4320,132390,64,324825
28841,0.001706,172.31.40.0-255,66,132456,64,324825
28842,0.001718,74.125.130.0-255,1484,133940,64,324825
28843,0.001721,74.125.130.0-255,1484,135424,64,324825
28844,0.001723,172.31.40.0-255,66,135490,64,324825
28845,0.001756,74.125.130.0-255,766,136256,64,324825
28846,0.001897,74.125.130.0-255,1484,137740,64,324825
28847,0.0019,172.31.40.0-255,66,137806,64,324825
28848,0.001921,74.125.130.0-255,1484,139290,64,324825
28849,0.001932,74.125.130.0-255,1484,140774,64,324825
28850,0.001934,172.31.40.0-255,66,140840,64,324825
28851,0.001945,74.125.130.0-255,1484,142324,64,324825
28852,0.001966,74.125.130.0-255,4320,146644,64,324825
28853,0.001969,172.31.40.0-255,66,146710,64,324825
28854,0.001986,74.125.130.0-255,1484,148194,64,324825
28855,0.001989,74.125.130.0-255,1484,149678,64,324825
28856,0.001991,172.31.40.0-255,66,149744,64,324825
28857,0.001995,74.125.130.0-255,2902,152646,64,324825
28858,0.001997,172.31.40.0-255,66,152712,64,324825
28859,0.002021,74.125.130.0-255,5738,158450,64,324825
28860,0.002023,172.31.40.0-255,66,158516,64,324825
28861,0.002027,74.125.130.0-255,2902,161418,64,324825
28862,0.002028,172.31.40.0-255,66,161484,64,324825
28863,0.004049,74.125.130.0-255,5738,167222,64,324825
28864,0.004056,172.31.40.0-255,66,167288,64,324825
28865,0.006088,74.125.130.0-255,4320,171608,64,324825
28866,0.006091,172.31.40.0-255,66,171674,64,324825
28867,0.006103,74.125.130.0-255,1484,173158,64,324825
28868,0.008116,74.125.130.0-255,4320,177478,64,324825
28869,0.008122,172.31.40.0-255,66,177544,64,324825
28870,0.010146,74.125.130.0-255,5738,183282,64,324825
28871,0.010153,172.31.40.0-255,66,183348,64,324825
28872,0.012188,74.125.130.0-255,5738,189086,64,324825
28873,0.012197,172.31.40.0-255,66,189152,64,324825
28874,0.01422,74.125.130.0-255,5738,194890,64,324825
28875,0.014229,172.31.40.0-255,66,194956,64,324825
28876,0.016258,74.125.130.0-255,5738,200694,64,324825
28877,0.016266,172.31.40.0-255,66,200760,64,324825
28878,0.018296,74.125.130.0-255,5738,206498,64,324825
28879,0.018304,172.31.40.0-255,66,206564,64,324825
28880,0.020336,74.125.130.0-255,5738,212302,64,324825
28881,0.020344,172.31.40.0-255,66,212368,64,324825
28882,0.022366,74.125.130.0-255,5738,218106,64,324825
28883,0.022372,172.31.40.0-255,66,218172,64,324825
28884,0.024396,74.125.130.0-255,5738,223910,64,324825
28885,0.024403,172.31.40.0-255,66,223976,64,324825
28886,0.026422,74.125.130.0-255,5738,229714,64,324825
28887,0.02643,172.31.40.0-255,66,229780,64,324825
28888,0.028462,74.125.130.0-255,5738,235518,64,324825
28889,0.028468,172.31.40.0-255,66,235584,64,324825
28890,0.030488,74.125.130.0-255,5738,241322,64,324825
28891,0.030492,172.31.40.0-255,66,241388,64,324825
28892,0.03112,172.31.40.0-255,171,241559,64,324825
28893,0.031147,172.31.40.0-255,1135,242694,64,324825
28894,0.031284,172.31.40.0-255,1514,244208,64,324825
28895,0.031286,172.31.40.0-255,1273,245481,64,324825
28896,0.03252,74.125.130.0-255,4320,249801,64,324825
28897,0.032526,172.31.40.0-255,66,249867,64,324825
28898,0.032551,74.125.130.0-255,1484,251351,64,324825
28899,0.032658,104.244.42.0-255,66,251417,64,324825
28900,0.032762,104.244.42.0-255,66,251483,64,324825
28901,0.032862,104.244.42.0-255,66,251549,64,324825
28902,0.034563,74.125.130.0-255,4320,255869,64,324825
28903,0.034575,172.31.40.0-255,66,255935,64,324825
28904,0.036598,74.125.130.0-255,5738,261673,64,324825
28905,0.036604,172.31.40.0-255,66,261739,64,324825
28906,0.03865,74.125.130.0-255,5738,267477,64,324825
28907,0.038662,172.31.40.0-255,66,267543,64,324825
28908,0.040712,74.125.130.0-255,5738,273281,64,324825
28909,0.040718,172.31.40.0-255,66,273347,64,324825
28910,0.042756,74.125.130.0-255,5738,279085,64,324825
28911,0.042762,172.31.40.0-255,66,279151,64,324825
28912,0.044795,74.125.130.0-255,5738,284889,64,324825
28913,0.044802,172.31.40.0-255,66,284955,64,324825
28914,0.046835,74.125.130.0-255,5738,290693,64,324825
28915,0.046841,172.31.40.0-255,66,290759,64,324825
28916,0.04886,74.125.130.0-255,2902,293661,64,324825
28917,0.048866,172.31.40.0-255,66,293727,64,324825
28918,0.048924,74.125.130.0-255,2902,296629,64,324825
28919,0.048927,172.31.40.0-255,66,296695,64,324825
28920,0.050884,74.125.130.0-255,2902,299597,64,324825
28921,0.05089,172.31.40.0-255,66,299663,64,324825
28922,0.050928,74.125.130.0-255,1484,301147,64,324825
28923,0.050943,74.125.130.0-255,1484,302631,64,324825
28924,0.050946,172.31.40.0-255,66,302697,64,324825
28925,0.052912,74.125.130.0-255,2902,305599,64,324825
28926,0.052919,172.31.40.0-255,66,305665,64,324825
28927,0.052944,74.125.130.0-255,2902,308567,64,324825
28928,0.052947,172.31.40.0-255,66,308633,64,324825
28929,0.054944,74.125.130.0-255,2902,311535,64,324825
28930,0.054951,172.31.40.0-255,66,311601,64,324825
28931,0.054973,74.125.130.0-255,2902,314503,64,324825
28932,0.054976,172.31.40.0-255,66,314569,64,324825
28933,0.056982,74.125.130.0-255,4320,318889,64,324825
28934,0.056987,172.31.40.0-255,66,318955,64,324825
28935,0.057008,74.125.130.0-255,1484,320439,64,324825
28936,0.059013,74.125.130.0-255,4320,324759,64,324825
28937,0.059025,172.31.40.0-255,66,324825,64,324825
28938,0.0,172.217.194.0-255,146,146,64,211268
28939,2.2e-05,172.31.40.0-255,66,212,64,211268
28940,3e-05,172.217.194.0-255,1484,1696,64,211268
28941,3.4e-05,172.31.40.0-255,66,1762,64,211268
28942,4e-05,172.217.194.0-255,2902,4664,64,211268
28943,5.2e-05,172.31.40.0-255,66,4730,64,211268
28944,6e-05,172.217.194.0-255,7156,11886,64,211268
28945,6.3e-05,172.31.40.0-255,66,11952,64,211268
28946,6.9e-05,172.217.194.0-255,5738,17690,64,211268
28947,7.2e-05,172.31.40.0-255,66,17756,64,211268
28948,0.00012,172.31.40.0-255,66,17822,64,211268
28949,0.000135,172.31.40.0-255,66,17888,64,211268
28950,0.000141,172.217.194.0-255,5020,22908,64,211268
28951,0.000144,172.31.40.0-255,66,22974,64,211268
28952,0.001372,172.217.194.0-255,1484,24458,64,211268
28953,0.001379,172.31.40.0-255,66,24524,64,211268
28954,0.001391,172.217.194.0-255,2902,27426,64,211268
28955,0.001394,172.31.40.0-255,66,27492,64,211268
28956,0.001406,172.217.194.0-255,5738,33230,64,211268
28957,0.001408,172.31.40.0-255,66,33296,64,211268
28958,0.001416,172.217.194.0-255,7049,40345,64,211268
28959,0.001418,172.31.40.0-255,66,40411,64,211268
28960,0.001451,172.217.194.0-255,122,40533,64,211268
28961,0.001454,172.31.40.0-255,66,40599,64,211268
28962,0.001997,172.217.194.0-255,1484,42083,64,211268
28963,0.001999,172.31.40.0-255,66,42149,64,211268
28964,0.002013,172.217.194.0-255,2902,45051,64,211268
28965,0.002015,172.31.40.0-255,66,45117,64,211268
28966,0.00202,172.217.194.0-255,2902,48019,64,211268
28967,0.002026,172.31.40.0-255,66,48085,64,211268
28968,0.002064,172.217.194.0-255,2902,50987,64,211268
28969,0.002093,172.217.194.0-255,2902,53889,64,211268
28970,0.002108,172.217.194.0-255,7156,61045,64,211268
28971,0.002125,172.217.194.0-255,766,61811,64,211268
28972,0.004151,172.31.40.0-255,66,61877,64,211268
28973,0.006251,172.217.194.0-255,5738,67615,64,211268
28974,0.006258,172.31.40.0-255,66,67681,64,211268
28975,0.008364,172.217.194.0-255,5738,73419,64,211268
28976,0.008372,172.31.40.0-255,66,73485,64,211268
28977,0.010479,172.217.194.0-255,5738,79223,64,211268
28978,0.013165,172.31.40.0-255,66,79289,64,211268
28979,0.015311,172.217.194.0-255,5738,85027,64,211268
28980,0.015327,172.31.40.0-255,66,85093,64,211268
28981,0.01743,172.217.194.0-255,5738,90831,64,211268
28982,0.017437,172.31.40.0-255,66,90897,64,211268
28983,0.019557,172.217.194.0-255,5738,96635,64,211268
28984,0.019568,172.31.40.0-255,66,96701,64,211268
28985,0.021665,172.217.194.0-255,5738,102439,64,211268
28986,0.021673,172.31.40.0-255,66,102505,64,211268
28987,0.023761,172.217.194.0-255,5738,108243,64,211268
28988,0.023769,172.31.40.0-255,66,108309,64,211268
28989,0.025856,172.217.194.0-255,5738,114047,64,211268
28990,0.025865,172.31.40.0-255,66,114113,64,211268
28991,0.027961,172.217.194.0-255,5738,119851,64,211268
28992,0.027969,172.31.40.0-255,66,119917,64,211268
28993,0.028615,172.31.40.0-255,171,120088,64,211268
28994,0.028647,172.31.40.0-255,1136,121224,64,211268
28995,0.028763,172.31.40.0-255,1514,122738,64,211268
28996,0.028766,172.31.40.0-255,1272,124010,64,211268
28997,0.03009,172.217.194.0-255,5738,129748,64,211268
28998,0.030098,172.31.40.0-255,66,129814,64,211268
28999,0.030158,104.244.42.0-255,66,129880,64,211268
29000,0.030207,104.244.42.0-255,66,129946,64,211268
29001,0.03032,104.244.42.0-255,66,130012,64,211268
29002,0.032226,172.217.194.0-255,5738,135750,64,211268
29003,0.032232,172.31.40.0-255,66,135816,64,211268
29004,0.034323,172.217.194.0-255,5738,141554,64,211268
29005,0.03433,172.31.40.0-255,66,141620,64,211268
29006,0.036446,172.217.194.0-255,5738,147358,64,211268
29007,0.036454,172.31.40.0-255,66,147424,64,211268
29008,0.038566,172.217.194.0-255,5738,153162,64,211268
29009,0.038573,172.31.40.0-255,66,153228,64,211268
29010,0.040693,172.217.194.0-255,5738,158966,64,211268
29011,0.040701,172.31.40.0-255,66,159032,64,211268
29012,0.042838,172.217.194.0-255,5738,164770,64,211268
29013,0.042851,172.31.40.0-255,66,164836,64,211268
29014,0.04498,172.217.194.0-255,5738,170574,64,211268
29015,0.044988,172.31.40.0-255,66,170640,64,211268
29016,0.047112,172.217.194.0-255,5738,176378,64,211268
29017,0.047121,172.31.40.0-255,66,176444,64,211268
29018,0.049261,172.217.194.0-255,5738,182182,64,211268
29019,0.049272,172.31.40.0-255,66,182248,64,211268
29020,0.051409,172.217.194.0-255,5738,187986,64,211268
29021,0.051415,172.31.40.0-255,66,188052,64,211268
29022,0.053511,172.217.194.0-255,5738,193790,64,211268
29023,0.053518,172.31.40.0-255,66,193856,64,211268
29024,0.055645,172.217.194.0-255,5738,199594,64,211268
29025,0.055651,172.31.40.0-255,66,199660,64,211268
29026,0.057762,172.217.194.0-255,5738,205398,64,211268
29027,0.057768,172.31.40.0-255,66,205464,64,211268
29028,0.059908,172.217.194.0-255,5738,211202,64,211268
29029,0.059915,172.31.40.0-255,66,211268,64,211268
29030,0.0,74.125.24.0-255,153,153,64,137497
29031,4.4e-05,172.31.40.0-255,66,219,64,137497
29032,5.2e-05,74.125.24.0-255,1484,1703,64,137497
29033,5.8e-05,172.31.40.0-255,66,1769,64,137497
29034,6.4e-05,74.125.24.0-255,2902,4671,64,137497
29035,7.4e-05,172.31.40.0-255,66,4737,64,137497
29036,8.2e-05,74.125.24.0-255,7156,11893,64,137497
29037,8.5e-05,172.31.40.0-255,66,11959,64,137497
29038,9e-05,74.125.24.0-255,1983,13942,64,137497
29039,9.3e-05,172.31.40.0-255,66,14008,64,137497
29040,9.8e-05,74.125.24.0-255,2902,16910,64,137497
29041,0.000101,172.31.40.0-255,66,16976,64,137497
29042,0.000108,74.125.24.0-255,7156,24132,64,137497
29043,0.000112,172.31.40.0-255,66,24198,64,137497
29044,0.000128,172.31.40.0-255,66,24264,64,137497
29045,0.000138,172.31.40.0-255,66,24330,64,137497
29046,0.000185,74.125.24.0-255,1484,25814,64,137497
29047,0.000187,172.31.40.0-255,66,25880,64,137497
29048,0.000193,74.125.24.0-255,2902,28782,64,137497
29049,0.000195,172.31.40.0-255,66,28848,64,137497
29050,0.000206,74.125.24.0-255,4320,33168,64,137497
29051,0.000208,172.31.40.0-255,66,33234,64,137497
29052,0.000239,74.125.24.0-255,1484,34718,64,137497
29053,0.000242,172.31.40.0-255,66,34784,64,137497
29054,0.000254,74.125.24.0-255,5738,40522,64,137497
29055,0.000256,172.31.40.0-255,66,40588,64,137497
29056,0.000286,74.125.24.0-255,1714,42302,64,137497
29057,0.000288,172.31.40.0-255,66,42368,64,137497
29058,0.00085,74.125.24.0-255,1484,43852,64,137497
29059,0.000856,172.31.40.0-255,66,43918,64,137497
29060,0.000862,74.125.24.0-255,2902,46820,64,137497
29061,0.000865,172.31.40.0-255,66,46886,64,137497
29062,0.000869,74.125.24.0-255,1484,48370,64,137497
29063,0.000902,74.125.24.0-255,4320,52690,64,137497
29064,0.000904,74.125.24.0-255,1484,54174,64,137497
29065,0.000916,172.31.40.0-255,66,54240,64,137497
29066,0.00092,172.31.40.0-255,66,54306,64,137497
29067,0.000965,172.31.40.0-255,66,54372,64,137497
29068,0.001083,74.125.24.0-255,1484,55856,64,137497
29069,0.001088,74.125.24.0-255,1484,57340,64,137497
29070,0.001091,172.31.40.0-255,66,57406,64,137497
29071,0.001115,74.125.24.0-255,1484,58890,64,137497
29072,0.001122,74.125.24.0-255,5738,64628,64,137497
29073,0.001125,172.31.40.0-255,66,64694,64,137497
29074,0.001167,74.125.24.0-255,7156,71850,64,137497
29075,0.001169,172.31.40.0-255,66,71916,64,137497
29076,0.001198,74.125.24.0-255,5738,77654,64,137497
29077,0.0012,172.31.40.0-255,66,77720,64,137497
29078,0.00122,172.31.40.0-255,66,77786,64,137497
29079,0.001226,74.125.24.0-255,7156,84942,64,137497
29080,0.001229,172.31.40.0-255,66,85008,64,137497
29081,0.001235,74.125.24.0-255,5738,90746,64,137497
29082,0.001237,172.31.40.0-255,66,90812,64,137497
29083,0.001261,172.31.40.0-255,66,90878,64,137497
29084,0.001293,74.125.24.0-255,4320,95198,64,137497
29085,0.001296,172.31.40.0-255,66,95264,64,137497
29086,0.001299,74.125.24.0-255,766,96030,64,137497
29087,0.001318,172.31.40.0-255,66,96096,64,137497
29088,0.001346,74.125.24.0-255,7156,103252,64,137497
29089,0.001349,172.31.40.0-255,66,103318,64,137497
29090,0.001369,172.31.40.0-255,66,103384,64,137497
29091,0.001405,172.31.40.0-255,66,103450,64,137497
29092,0.001417,172.31.40.0-255,66,103516,64,137497
29093,0.001477,172.31.40.0-255,66,103582,64,137497
29094,0.001504,74.125.24.0-255,2902,106484,64,137497
29095,0.001507,172.31.40.0-255,66,106550,64,137497
29096,0.001555,172.31.40.0-255,66,106616,64,137497
29097,0.001577,172.31.40.0-255,66,106682,64,137497
29098,0.001603,74.125.24.0-255,4320,111002,64,137497
29099,0.001606,172.31.40.0-255,66,111068,64,137497
29100,0.001705,74.125.24.0-255,1484,112552,64,137497
29101,0.001747,74.125.24.0-255,7156,119708,64,137497
29102,0.00175,172.31.40.0-255,66,119774,64,137497
29103,0.001757,172.31.40.0-255,66,119840,64,137497
29104,0.001806,74.125.24.0-255,5020,124860,64,137497
29105,0.001812,74.125.24.0-255,5738,130598,64,137497
29106,0.001831,172.31.40.0-255,66,130664,64,137497
29107,0.001856,74.125.24.0-255,1121,131785,64,137497
29108,0.001909,74.125.24.0-255,105,131890,64,137497
29109,0.003389,172.31.40.0-255,101,131991,64,137497
29110,0.005631,74.125.24.0-255,66,132057,64,137497
29111,0.012444,172.31.40.0-255,105,132162,64,137497
29112,0.014689,74.125.24.0-255,66,132228,64,137497
29113,0.032174,172.31.40.0-255,172,132400,64,137497
29114,0.032209,172.31.40.0-255,1111,133511,64,137497
29115,0.032272,172.31.40.0-255,1514,135025,64,137497
29116,0.032274,172.31.40.0-255,1514,136539,64,137497
29117,0.032298,172.31.40.0-255,694,137233,64,137497
29118,0.03375,104.244.42.0-255,66,137299,64,137497
29119,0.033783,104.244.42.0-255,66,137365,64,137497
29120,0.033832,104.244.42.0-255,66,137431,64,137497
29121,0.033845,104.244.42.0-255,66,137497,64,137497
29122,0.0,74.125.68.0-255,152,152,64,346430
29123,2.3e-05,172.31.40.0-255,66,218,64,346430
29124,3e-05,74.125.68.0-255,1484,1702,64,346430
29125,3.4e-05,172.31.40.0-255,66,1768,64,346430
29126,4e-05,74.125.68.0-255,2902,4670,64,346430
29127,4.4e-05,172.31.40.0-255,66,4736,64,346430
29128,5e-05,74.125.68.0-255,5738,10474,64,346430
29129,5.3e-05,172.31.40.0-255,66,10540,64,346430
29130,5.7e-05,74.125.68.0-255,2902,13442,64,346430
29131,6.1e-05,172.31.40.0-255,66,13508,64,346430
29132,8.8e-05,74.125.68.0-255,2099,15607,64,346430
29133,9.1e-05,172.31.40.0-255,66,15673,64,346430
29134,9.8e-05,74.125.68.0-255,5738,21411,64,346430
29135,0.0001,172.31.40.0-255,66,21477,64,346430
29136,0.000103,74.125.68.0-255,1484,22961,64,346430
29137,0.000105,172.31.40.0-255,66,23027,64,346430
29138,0.000123,74.125.68.0-255,7156,30183,64,346430
29139,0.000125,172.31.40.0-255,66,30249,64,346430
29140,0.000148,74.125.68.0-255,1125,31374,64,346430
29141,0.000151,172.31.40.0-255,66,31440,64,346430
29142,0.000197,74.125.68.0-255,1484,32924,64,346430
29143,0.0002,172.31.40.0-255,66,32990,64,346430
29144,0.000203,74.125.68.0-255,1484,34474,64,346430
29145,0.000205,172.31.40.0-255,66,34540,64,346430
29146,0.000218,74.125.68.0-255,2902,37442,64,346430
29147,0.00022,172.31.40.0-255,66,37508,64,346430
29148,0.000245,74.125.68.0-255,5738,43246,64,346430
29149,0.000248,172.31.40.0-255,66,43312,64,346430
29150,0.000267,74.125.68.0-255,5379,48691,64,346430
29151,0.00027,172.31.40.0-255,66,48757,64,346430
29152,0.000274,74.125.68.0-255,2902,51659,64,346430
29153,0.000276,172.31.40.0-255,66,51725,64,346430
29154,0.000297,74.125.68.0-255,2902,54627,64,346430
29155,0.0003,172.31.40.0-255,66,54693,64,346430
29156,0.00032,74.125.68.0-255,1484,56177,64,346430
29157,0.000346,172.31.40.0-255,66,56243,64,346430
29158,0.000349,74.125.68.0-255,111,56354,64,346430
29159,0.000425,74.125.68.0-255,1484,57838,64,346430
29160,0.000429,172.31.40.0-255,66,57904,64,346430
29161,0.000444,74.125.68.0-255,2902,60806,64,346430
29162,0.000447,172.31.40.0-255,66,60872,64,346430
29163,0.000469,74.125.68.0-255,5738,66610,64,346430
29164,0.000472,172.31.40.0-255,66,66676,64,346430
29165,0.000476,74.125.68.0-255,2902,69578,64,346430
29166,0.000478,172.31.40.0-255,66,69644,64,346430
29167,0.000505,74.125.68.0-255,3961,73605,64,346430
29168,0.000508,172.31.40.0-255,66,73671,64,346430
29169,0.000515,74.125.68.0-255,5738,79409,64,346430
29170,0.000517,172.31.40.0-255,66,79475,64,346430
29171,0.000549,74.125.68.0-255,1484,80959,64,346430
29172,0.00056,172.31.40.0-255,66,81025,64,346430
29173,0.000563,74.125.68.0-255,1369,82394,64,346430
29174,0.00066,172.31.40.0-255,101,82495,64,346430
29175,0.000698,74.125.68.0-255,1484,83979,64,346430
29176,0.000716,74.125.68.0-255,2902,86881,64,346430
29177,0.000734,74.125.68.0-255,4320,91201,64,346430
29178,0.000753,172.31.40.0-255,66,91267,64,346430
29179,0.000765,74.125.68.0-255,5738,97005,64,346430
29180,0.000781,74.125.68.0-255,2902,99907,64,346430
29181,0.000792,172.31.40.0-255,66,99973,64,346430
29182,0.000804,74.125.68.0-255,2902,102875,64,346430
29183,0.000828,74.125.68.0-255,7156,110031,64,346430
29184,0.000831,74.125.68.0-255,2902,112933,64,346430
29185,0.000866,172.31.40.0-255,66,112999,64,346430
29186,0.000873,172.31.40.0-255,66,113065,64,346430
29187,0.000886,74.125.68.0-255,3602,116667,64,346430
29188,0.00091,172.31.40.0-255,66,116733,64,346430
29189,0.001157,74.125.68.0-255,1484,118217,64,346430
29190,0.001174,74.125.68.0-255,1484,119701,64,346430
29191,0.001177,172.31.40.0-255,66,119767,64,346430
29192,0.001181,74.125.68.0-255,1484,121251,64,346430
29193,0.001195,74.125.68.0-255,1484,122735,64,346430
29194,0.001213,172.31.40.0-255,66,122801,64,346430
29195,0.001224,74.125.68.0-255,2902,125703,64,346430
29196,0.001244,74.125.68.0-255,2902,128605,64,346430
29197,0.001247,74.125.68.0-255,1484,130089,64,346430
29198,0.001252,172.31.40.0-255,66,130155,64,346430
29199,0.00136,74.125.68.0-255,1484,131639,64,346430
29200,0.001428,74.125.68.0-255,1484,133123,64,346430
29201,0.001432,172.31.40.0-255,66,133189,64,346430
29202,0.001456,74.125.68.0-255,2902,136091,64,346430
29203,0.001461,172.31.40.0-255,66,136157,64,346430
29204,0.00148,74.125.68.0-255,5738,141895,64,346430
29205,0.001493,74.125.68.0-255,1484,143379,64,346430
29206,0.001509,74.125.68.0-255,5738,149117,64,346430
29207,0.001512,172.31.40.0-255,66,149183,64,346430
29208,0.001516,172.31.40.0-255,66,149249,64,346430
29209,0.001525,74.125.68.0-255,2184,151433,64,346430
29210,0.00155,172.31.40.0-255,66,151499,64,346430
29211,0.001806,74.125.68.0-255,1484,152983,64,346430
29212,0.001825,74.125.68.0-255,2902,155885,64,346430
29213,0.001828,172.31.40.0-255,66,155951,64,346430
29214,0.00185,74.125.68.0-255,4320,160271,64,346430
29215,0.001852,172.31.40.0-255,66,160337,64,346430
29216,0.001886,74.125.68.0-255,4320,164657,64,346430
29217,0.001889,172.31.40.0-255,66,164723,64,346430
29218,0.00194,74.125.68.0-255,1484,166207,64,346430
29219,0.001964,74.125.68.0-255,2902,169109,64,346430
29220,0.001967,172.31.40.0-255,66,169175,64,346430
29221,0.001983,74.125.68.0-255,1484,170659,64,346430
29222,0.002009,74.125.68.0-255,2902,173561,64,346430
29223,0.002012,172.31.40.0-255,66,173627,64,346430
29224,0.002034,74.125.68.0-255,2902,176529,64,346430
29225,0.002042,172.31.40.0-255,66,176595,64,346430
29226,0.00205,74.125.68.0-255,2902,179497,64,346430
29227,0.002054,172.31.40.0-255,66,179563,64,346430
29228,0.00266,74.125.68.0-255,66,179629,64,346430
29229,0.004069,74.125.68.0-255,5738,185367,64,346430
29230,0.004077,172.31.40.0-255,66,185433,64,346430
29231,0.006102,74.125.68.0-255,5738,191171,64,346430
29232,0.006106,172.31.40.0-255,66,191237,64,346430
29233,0.008127,74.125.68.0-255,5738,196975,64,346430
29234,0.008132,172.31.40.0-255,66,197041,64,346430
29235,0.010151,74.125.68.0-255,5738,202779,64,346430
29236,0.010161,172.31.40.0-255,66,202845,64,346430
29237,0.012192,74.125.68.0-255,5738,208583,64,346430
29238,0.012202,172.31.40.0-255,66,208649,64,346430
29239,0.014228,74.125.68.0-255,5738,214387,64,346430
29240,0.014237,172.31.40.0-255,66,214453,64,346430
29241,0.016265,74.125.68.0-255,5738,220191,64,346430
29242,0.016272,172.31.40.0-255,66,220257,64,346430
29243,0.018309,74.125.68.0-255,5738,225995,64,346430
29244,0.018316,172.31.40.0-255,66,226061,64,346430
29245,0.020351,74.125.68.0-255,5738,231799,64,346430
29246,0.020358,172.31.40.0-255,66,231865,64,346430
29247,0.022401,74.125.68.0-255,5738,237603,64,346430
29248,0.022414,172.31.40.0-255,66,237669,64,346430
29249,0.024462,74.125.68.0-255,5738,243407,64,346430
29250,0.024481,172.31.40.0-255,66,243473,64,346430
29251,0.026526,74.125.68.0-255,5738,249211,64,346430
29252,0.026541,172.31.40.0-255,66,249277,64,346430
29253,0.028584,74.125.68.0-255,5738,255015,64,346430
29254,0.028597,172.31.40.0-255,66,255081,64,346430
29255,0.030646,74.125.68.0-255,5738,260819,64,346430
29256,0.030661,172.31.40.0-255,66,260885,64,346430
29257,0.032699,74.125.68.0-255,5738,266623,64,346430
29258,0.03271,172.31.40.0-255,66,266689,64,346430
29259,0.034747,74.125.68.0-255,5738,272427,64,346430
29260,0.034764,172.31.40.0-255,66,272493,64,346430
29261,0.036793,74.125.68.0-255,5738,278231,64,346430
29262,0.036801,172.31.40.0-255,66,278297,64,346430
29263,0.038835,74.125.68.0-255,5738,284035,64,346430
29264,0.038843,172.31.40.0-255,66,284101,64,346430
29265,0.040884,74.125.68.0-255,5738,289839,64,346430
29266,0.0409,172.31.40.0-255,66,289905,64,346430
29267,0.042936,74.125.68.0-255,5738,295643,64,346430
29268,0.042951,172.31.40.0-255,66,295709,64,346430
29269,0.045019,74.125.68.0-255,5738,301447,64,346430
29270,0.04503,172.31.40.0-255,66,301513,64,346430
29271,0.04705,74.125.68.0-255,5738,307251,64,346430
29272,0.047057,172.31.40.0-255,66,307317,64,346430
29273,0.047103,172.31.40.0-255,167,307484,64,346430
29274,0.047147,172.31.40.0-255,1113,308597,64,346430
29275,0.047254,172.31.40.0-255,1514,310111,64,346430
29276,0.047257,172.31.40.0-255,1297,311408,64,346430
29277,0.048629,104.244.42.0-255,66,311474,64,346430
29278,0.048676,104.244.42.0-255,66,311540,64,346430
29279,0.048804,104.244.42.0-255,66,311606,64,346430
29280,0.049079,74.125.68.0-255,5738,317344,64,346430
29281,0.049086,172.31.40.0-255,66,317410,64,346430
29282,0.051118,74.125.68.0-255,5738,323148,64,346430
29283,0.051134,172.31.40.0-255,66,323214,64,346430
29284,0.053177,74.125.68.0-255,5738,328952,64,346430
29285,0.053193,172.31.40.0-255,66,329018,64,346430
29286,0.055239,74.125.68.0-255,5738,334756,64,346430
29287,0.055254,172.31.40.0-255,66,334822,64,346430
29288,0.057297,74.125.68.0-255,5738,340560,64,346430
29289,0.057311,172.31.40.0-255,66,340626,64,346430
29290,0.059346,74.125.68.0-255,5738,346364,64,346430
29291,0.05936,172.31.40.0-255,66,346430,64,346430
29292,0.0,74.125.24.0-255,146,146,64,327367
29293,2e-05,172.31.40.0-255,66,212,64,327367
29294,2.7e-05,74.125.24.0-255,1484,1696,64,327367
29295,3.2e-05,172.31.40.0-255,66,1762,64,327367
29296,3.7e-05,74.125.24.0-255,2902,4664,64,327367
29297,4.1e-05,172.31.40.0-255,66,4730,64,327367
29298,5e-05,74.125.24.0-255,7156,11886,64,327367
29299,5.3e-05,172.31.40.0-255,66,11952,64,327367
29300,7.7e-05,74.125.24.0-255,1484,13436,64,327367
29301,7.9e-05,172.31.40.0-255,66,13502,64,327367
29302,9.6e-05,74.125.24.0-255,4320,17822,64,327367
29303,9.8e-05,172.31.40.0-255,66,17888,64,327367
29304,0.000114,74.125.24.0-255,6253,24141,64,327367
29305,0.000117,172.31.40.0-255,66,24207,64,327367
29306,0.000123,74.125.24.0-255,6797,31004,64,327367
29307,0.000125,172.31.40.0-255,66,31070,64,327367
29308,0.000194,74.125.24.0-255,1484,32554,64,327367
29309,0.000197,172.31.40.0-255,66,32620,64,327367
29310,0.000201,74.125.24.0-255,2902,35522,64,327367
29311,0.000203,172.31.40.0-255,66,35588,64,327367
29312,0.000216,74.125.24.0-255,4320,39908,64,327367
29313,0.000218,172.31.40.0-255,66,39974,64,327367
29314,0.000236,74.125.24.0-255,1484,41458,64,327367
29315,0.000238,172.31.40.0-255,66,41524,64,327367
29316,0.000241,74.125.24.0-255,1484,43008,64,327367
29317,0.000243,172.31.40.0-255,66,43074,64,327367
29318,0.000264,172.31.40.0-255,66,43140,64,327367
29319,0.000271,74.125.24.0-255,7156,50296,64,327367
29320,0.000273,172.31.40.0-255,66,50362,64,327367
29321,0.000291,74.125.24.0-255,4320,54682,64,327367
29322,0.000293,172.31.40.0-255,66,54748,64,327367
29323,0.000314,74.125.24.0-255,1436,56184,64,327367
29324,0.000316,172.31.40.0-255,66,56250,64,327367
29325,0.000318,74.125.24.0-255,374,56624,64,327367
29326,0.00032,172.31.40.0-255,66,56690,64,327367
29327,0.000619,74.125.24.0-255,1484,58174,64,327367
29328,0.000623,172.31.40.0-255,66,58240,64,327367
29329,0.000628,74.125.24.0-255,2902,61142,64,327367
29330,0.00063,172.31.40.0-255,66,61208,64,327367
29331,0.000635,74.125.24.0-255,2902,64110,64,327367
29332,0.000637,172.31.40.0-255,66,64176,64,327367
29333,0.00065,74.125.24.0-255,2902,67078,64,327367
29334,0.000669,74.125.24.0-255,2902,69980,64,327367
29335,0.00069,74.125.24.0-255,1484,71464,64,327367
29336,0.000706,74.125.24.0-255,7156,78620,64,327367
29337,0.000722,74.125.24.0-255,2184,80804,64,327367
29338,0.000847,172.31.40.0-255,66,80870,64,327367
29339,0.000934,74.125.24.0-255,1484,82354,64,327367
29340,0.00095,74.125.24.0-255,2902,85256,64,327367
29341,0.000958,172.31.40.0-255,66,85322,64,327367
29342,0.000965,74.125.24.0-255,1484,86806,64,327367
29343,0.000982,74.125.24.0-255,4320,91126,64,327367
29344,0.000994,74.125.24.0-255,1484,92610,64,327367
29345,0.000996,172.31.40.0-255,66,92676,64,327367
29346,0.001022,74.125.24.0-255,1484,94160,64,327367
29347,0.00103,172.31.40.0-255,66,94226,64,327367
29348,0.001047,172.31.40.0-255,66,94292,64,327367
29349,0.001071,74.125.24.0-255,2184,96476,64,327367
29350,0.001079,172.31.40.0-255,66,96542,64,327367
29351,0.001171,74.125.24.0-255,1484,98026,64,327367
29352,0.001175,74.125.24.0-255,1484,99510,64,327367
29353,0.001185,74.125.24.0-255,1484,100994,64,327367
29354,0.00119,74.125.24.0-255,5738,106732,64,327367
29355,0.001224,172.31.40.0-255,66,106798,64,327367
29356,0.001245,172.31.40.0-255,66,106864,64,327367
29357,0.001249,74.125.24.0-255,2902,109766,64,327367
29358,0.001285,74.125.24.0-255,2184,111950,64,327367
29359,0.001288,172.31.40.0-255,66,112016,64,327367
29360,0.001292,172.31.40.0-255,66,112082,64,327367
29361,0.001327,74.125.24.0-255,2902,114984,64,327367
29362,0.001332,74.125.24.0-255,2902,117886,64,327367
29363,0.00134,172.31.40.0-255,66,117952,64,327367
29364,0.001349,74.125.24.0-255,2902,120854,64,327367
29365,0.001352,172.31.40.0-255,66,120920,64,327367
29366,0.001363,74.125.24.0-255,4320,125240,64,327367
29367,0.001386,74.125.24.0-255,2902,128142,64,327367
29368,0.001393,172.31.40.0-255,66,128208,64,327367
29369,0.001428,74.125.24.0-255,5020,133228,64,327367
29370,0.001436,172.31.40.0-255,66,133294,64,327367
29371,0.001525,74.125.24.0-255,1484,134778,64,327367
29372,0.001531,74.125.24.0-255,2902,137680,64,327367
29373,0.001554,74.125.24.0-255,2902,140582,64,327367
29374,0.001557,172.31.40.0-255,66,140648,64,327367
29375,0.001561,172.31.40.0-255,66,140714,64,327367
29376,0.001574,74.125.24.0-255,2902,143616,64,327367
29377,0.00158,74.125.24.0-255,5738,149354,64,327367
29378,0.001594,172.31.40.0-255,66,149420,64,327367
29379,0.001599,74.125.24.0-255,4320,153740,64,327367
29380,0.001603,172.31.40.0-255,66,153806,64,327367
29381,0.001615,74.125.24.0-255,5738,159544,64,327367
29382,0.001626,172.31.40.0-255,66,159610,64,327367
29383,0.001637,74.125.24.0-255,7156,166766,64,327367
29384,0.001641,172.31.40.0-255,66,166832,64,327367
29385,0.001655,74.125.24.0-255,1484,168316,64,327367
29386,0.001693,172.31.40.0-255,66,168382,64,327367
29387,0.001725,172.31.40.0-255,66,168448,64,327367
29388,0.001737,74.125.24.0-255,4320,172768,64,327367
29389,0.001743,74.125.24.0-255,6438,179206,64,327367
29390,0.001764,172.31.40.0-255,66,179272,64,327367
29391,0.001856,74.125.24.0-255,1484,180756,64,327367
29392,0.001872,74.125.24.0-255,2902,183658,64,327367
29393,0.001877,74.125.24.0-255,5738,189396,64,327367
29394,0.001882,172.31.40.0-255,66,189462,64,327367
29395,0.001894,74.125.24.0-255,7156,196618,64,327367
29396,0.001914,74.125.24.0-255,5738,202356,64,327367
29397,0.00192,74.125.24.0-255,5738,208094,64,327367
29398,0.001926,172.31.40.0-255,66,208160,64,327367
29399,0.001936,74.125.24.0-255,4320,212480,64,327367
29400,0.001938,74.125.24.0-255,766,213246,64,327367
29401,0.001961,172.31.40.0-255,66,213312,64,327367
29402,0.002354,74.125.24.0-255,1484,214796,64,327367
29403,0.0043,74.125.24.0-255,4320,219116,64,327367
29404,0.004306,172.31.40.0-255,66,219182,64,327367
29405,0.006661,74.125.24.0-255,5738,224920,64,327367
29406,0.006665,172.31.40.0-255,66,224986,64,327367
29407,0.008964,74.125.24.0-255,5738,230724,64,327367
29408,0.009121,172.31.40.0-255,66,230790,64,327367
29409,0.01152,74.125.24.0-255,5738,236528,64,327367
29410,0.011528,172.31.40.0-255,66,236594,64,327367
29411,0.013837,74.125.24.0-255,5738,242332,64,327367
29412,0.013843,172.31.40.0-255,66,242398,64,327367
29413,0.016173,74.125.24.0-255,5738,248136,64,327367
29414,0.018541,172.31.40.0-255,66,248202,64,327367
29415,0.020894,74.125.24.0-255,5738,253940,64,327367
29416,0.020904,172.31.40.0-255,66,254006,64,327367
29417,0.023303,74.125.24.0-255,5738,259744,64,327367
29418,0.023309,172.31.40.0-255,66,259810,64,327367
29419,0.025622,74.125.24.0-255,5738,265548,64,327367
29420,0.025628,172.31.40.0-255,66,265614,64,327367
29421,0.027989,74.125.24.0-255,5738,271352,64,327367
29422,0.027996,172.31.40.0-255,66,271418,64,327367
29423,0.029129,172.31.40.0-255,172,271590,64,327367
29424,0.029159,172.31.40.0-255,1111,272701,64,327367
29425,0.02922,172.31.40.0-255,1514,274215,64,327367
29426,0.029222,172.31.40.0-255,1297,275512,64,327367
29427,0.03033,74.125.24.0-255,5738,281250,64,327367
29428,0.030338,172.31.40.0-255,66,281316,64,327367
29429,0.030673,104.244.42.0-255,66,281382,64,327367
29430,0.030716,104.244.42.0-255,66,281448,64,327367
29431,0.030761,104.244.42.0-255,66,281514,64,327367
29432,0.032668,74.125.24.0-255,5738,287252,64,327367
29433,0.032673,172.31.40.0-255,66,287318,64,327367
29434,0.035028,74.125.24.0-255,5738,293056,64,327367
29435,0.035035,172.31.40.0-255,66,293122,64,327367
29436,0.03737,74.125.24.0-255,5738,298860,64,327367
29437,0.037376,172.31.40.0-255,66,298926,64,327367
29438,0.039705,74.125.24.0-255,5738,304664,64,327367
29439,0.039712,172.31.40.0-255,66,304730,64,327367
29440,0.04209,74.125.24.0-255,5738,310468,64,327367
29441,0.042097,172.31.40.0-255,66,310534,64,327367
29442,0.044504,74.125.24.0-255,5738,316272,64,327367
29443,0.044511,172.31.40.0-255,66,316338,64,327367
29444,0.046834,74.125.24.0-255,5738,322076,64,327367
29445,0.046841,172.31.40.0-255,66,322142,64,327367
29446,0.049169,74.125.24.0-255,4988,327130,64,327367
29447,0.049176,172.31.40.0-255,66,327196,64,327367
29448,0.049357,172.31.40.0-255,105,327301,64,327367
29449,0.051651,74.125.24.0-255,66,327367,64,327367
29450,0.0,172.31.40.0-255,105,105,64,459
29451,0.000245,172.31.40.0-255,90,195,64,459
29452,0.000253,172.31.40.0-255,66,261,64,459
29453,0.002522,74.125.68.0-255,66,327,64,459
29454,0.002536,74.125.68.0-255,66,393,64,459
29455,0.002548,172.31.40.0-255,66,459,64,459
29456,0.0,172.217.194.0-255,153,153,64,267229
29457,2.3e-05,172.31.40.0-255,66,219,64,267229
29458,3.1e-05,172.217.194.0-255,1484,1703,64,267229
29459,3.6e-05,172.31.40.0-255,66,1769,64,267229
29460,4.1e-05,172.217.194.0-255,2902,4671,64,267229
29461,5.3e-05,172.31.40.0-255,66,4737,64,267229
29462,6.1e-05,172.217.194.0-255,7156,11893,64,267229
29463,6.4e-05,172.31.40.0-255,66,11959,64,267229
29464,9.1e-05,172.31.40.0-255,66,12025,64,267229
29465,0.000104,172.217.194.0-255,6797,18822,64,267229
29466,0.000106,172.31.40.0-255,66,18888,64,267229
29467,0.000201,172.217.194.0-255,1484,20372,64,267229
29468,0.000205,172.31.40.0-255,66,20438,64,267229
29469,0.00021,172.217.194.0-255,2902,23340,64,267229
29470,0.000212,172.31.40.0-255,66,23406,64,267229
29471,0.000219,172.217.194.0-255,5738,29144,64,267229
29472,0.000226,172.31.40.0-255,66,29210,64,267229
29473,0.000247,172.217.194.0-255,6797,36007,64,267229
29474,0.00025,172.31.40.0-255,66,36073,64,267229
29475,0.000279,172.217.194.0-255,5738,41811,64,267229
29476,0.000281,172.31.40.0-255,66,41877,64,267229
29477,0.000316,172.31.40.0-255,66,41943,64,267229
29478,0.00032,172.217.194.0-255,2797,44740,64,267229
29479,0.000322,172.31.40.0-255,66,44806,64,267229
29480,0.000325,172.217.194.0-255,432,45238,64,267229
29481,0.000332,172.31.40.0-255,66,45304,64,267229
29482,0.000778,172.217.194.0-255,1484,46788,64,267229
29483,0.000784,172.31.40.0-255,66,46854,64,267229
29484,0.000791,172.217.194.0-255,2902,49756,64,267229
29485,0.000793,172.31.40.0-255,66,49822,64,267229
29486,0.00082,172.217.194.0-255,5738,55560,64,267229
29487,0.000823,172.31.40.0-255,66,55626,64,267229
29488,0.000829,172.217.194.0-255,5738,61364,64,267229
29489,0.000832,172.31.40.0-255,66,61430,64,267229
29490,0.000865,172.217.194.0-255,7156,68586,64,267229
29491,0.000881,172.31.40.0-255,66,68652,64,267229
29492,0.000885,172.31.40.0-255,66,68718,64,267229
29493,0.001316,172.217.194.0-255,1484,70202,64,267229
29494,0.001322,172.217.194.0-255,1484,71686,64,267229
29495,0.001325,172.31.40.0-255,66,71752,64,267229
29496,0.00135,172.217.194.0-255,1484,73236,64,267229
29497,0.001355,172.217.194.0-255,5738,78974,64,267229
29498,0.001361,172.217.194.0-255,7156,86130,64,267229
29499,0.001385,172.31.40.0-255,66,86196,64,267229
29500,0.001387,172.31.40.0-255,66,86262,64,267229
29501,0.001428,172.217.194.0-255,2184,88446,64,267229
29502,0.001432,172.31.40.0-255,66,88512,64,267229
29503,0.001438,172.31.40.0-255,66,88578,64,267229
29504,0.002074,172.217.194.0-255,1484,90062,64,267229
29505,0.002084,172.217.194.0-255,2902,92964,64,267229
29506,0.002088,172.31.40.0-255,66,93030,64,267229
29507,0.002115,172.217.194.0-255,1484,94514,64,267229
29508,0.002119,172.217.194.0-255,2902,97416,64,267229
29509,0.002121,172.31.40.0-255,66,97482,64,267229
29510,0.002127,172.217.194.0-255,5738,103220,64,267229
29511,0.002129,172.31.40.0-255,66,103286,64,267229
29512,0.002167,172.217.194.0-255,2902,106188,64,267229
29513,0.00217,172.31.40.0-255,66,106254,64,267229
29514,0.002186,172.217.194.0-255,4320,110574,64,267229
29515,0.002188,172.31.40.0-255,66,110640,64,267229
29516,0.002191,172.217.194.0-255,1484,112124,64,267229
29517,0.002214,172.217.194.0-255,7156,119280,64,267229
29518,0.002216,172.31.40.0-255,66,119346,64,267229
29519,0.002221,172.217.194.0-255,3602,122948,64,267229
29520,0.002223,172.31.40.0-255,66,123014,64,267229
29521,0.002504,172.217.194.0-255,1484,124498,64,267229
29522,0.00251,172.217.194.0-255,1484,125982,64,267229
29523,0.002513,172.31.40.0-255,66,126048,64,267229
29524,0.002535,172.217.194.0-255,1484,127532,64,267229
29525,0.002542,172.217.194.0-255,5738,133270,64,267229
29526,0.002544,172.31.40.0-255,66,133336,64,267229
29527,0.002576,172.31.40.0-255,66,133402,64,267229
29528,0.002586,172.31.40.0-255,66,133468,64,267229
29529,0.002633,172.31.40.0-255,66,133534,64,267229
29530,0.005217,172.217.194.0-255,5738,139272,64,267229
29531,0.005221,172.31.40.0-255,66,139338,64,267229
29532,0.007786,172.217.194.0-255,5738,145076,64,267229
29533,0.007793,172.31.40.0-255,66,145142,64,267229
29534,0.010391,172.217.194.0-255,5738,150880,64,267229
29535,0.010399,172.31.40.0-255,66,150946,64,267229
29536,0.012958,172.217.194.0-255,5738,156684,64,267229
29537,0.012967,172.31.40.0-255,66,156750,64,267229
29538,0.01555,172.217.194.0-255,5738,162488,64,267229
29539,0.01556,172.31.40.0-255,66,162554,64,267229
29540,0.018128,172.217.194.0-255,5738,168292,64,267229
29541,0.018137,172.31.40.0-255,66,168358,64,267229
29542,0.020721,172.217.194.0-255,5738,174096,64,267229
29543,0.020729,172.31.40.0-255,66,174162,64,267229
29544,0.023294,172.217.194.0-255,5738,179900,64,267229
29545,0.023301,172.31.40.0-255,66,179966,64,267229
29546,0.025899,172.217.194.0-255,5738,185704,64,267229
29547,0.025918,172.31.40.0-255,66,185770,64,267229
29548,0.028485,172.217.194.0-255,5738,191508,64,267229
29549,0.0285,172.31.40.0-255,66,191574,64,267229
29550,0.031076,172.217.194.0-255,5738,197312,64,267229
29551,0.031091,172.31.40.0-255,66,197378,64,267229
29552,0.033673,172.217.194.0-255,5738,203116,64,267229
29553,0.033689,172.31.40.0-255,66,203182,64,267229
29554,0.036285,172.217.194.0-255,5738,208920,64,267229
29555,0.036293,172.31.40.0-255,66,208986,64,267229
29556,0.038155,172.31.40.0-255,172,209158,64,267229
29557,0.038187,172.31.40.0-255,1113,210271,64,267229
29558,0.038245,172.31.40.0-255,1514,211785,64,267229
29559,0.038247,172.31.40.0-255,1514,213299,64,267229
29560,0.038248,172.31.40.0-255,1514,214813,64,267229
29561,0.038249,172.31.40.0-255,114,214927,64,267229
29562,0.03885,172.217.194.0-255,5738,220665,64,267229
29563,0.038868,172.31.40.0-255,66,220731,64,267229
29564,0.040673,104.244.42.0-255,66,220797,64,267229
29565,0.041435,172.217.194.0-255,5738,226535,64,267229
29566,0.041445,172.31.40.0-255,66,226601,64,267229
29567,0.04405,172.217.194.0-255,5738,232339,64,267229
29568,0.04406,172.31.40.0-255,66,232405,64,267229
29569,0.046661,172.217.194.0-255,5738,238143,64,267229
29570,0.04668,172.31.40.0-255,66,238209,64,267229
29571,0.049276,172.217.194.0-255,5738,243947,64,267229
29572,0.049296,172.31.40.0-255,66,244013,64,267229
29573,0.051903,172.217.194.0-255,5738,249751,64,267229
29574,0.051921,172.31.40.0-255,66,249817,64,267229
29575,0.054534,172.217.194.0-255,5738,255555,64,267229
29576,0.054553,172.31.40.0-255,66,255621,64,267229
29577,0.057163,172.217.194.0-255,5738,261359,64,267229
29578,0.057182,172.31.40.0-255,66,261425,64,267229
29579,0.059738,172.217.194.0-255,5738,267163,64,267229
29580,0.059746,172.31.40.0-255,66,267229,64,267229
29581,0.0,172.217.160.0-255,153,153,64,254339
29582,2.4e-05,172.31.40.0-255,66,219,64,254339
29583,3.2e-05,172.217.160.0-255,1484,1703,64,254339
29584,3.7e-05,172.31.40.0-255,66,1769,64,254339
29585,5.2e-05,172.217.160.0-255,2902,4671,64,254339
29586,5.6e-05,172.31.40.0-255,66,4737,64,254339
29587,6.5e-05,172.217.160.0-255,7156,11893,64,254339
29588,6.8e-05,172.31.40.0-255,66,11959,64,254339
29589,0.000127,172.217.160.0-255,2011,13970,64,254339
29590,0.00013,172.31.40.0-255,66,14036,64,254339
29591,0.000163,172.31.40.0-255,66,14102,64,254339
29592,0.000187,172.217.160.0-255,1484,15586,64,254339
29593,0.000189,172.31.40.0-255,66,15652,64,254339
29594,0.000278,172.217.160.0-255,6797,22449,64,254339
29595,0.000282,172.31.40.0-255,66,22515,64,254339
29596,0.000388,172.217.160.0-255,1484,23999,64,254339
29597,0.000391,172.31.40.0-255,66,24065,64,254339
29598,0.000396,172.217.160.0-255,1484,25549,64,254339
29599,0.000398,172.31.40.0-255,66,25615,64,254339
29600,0.000417,172.217.160.0-255,1484,27099,64,254339
29601,0.00042,172.31.40.0-255,66,27165,64,254339
29602,0.000429,172.217.160.0-255,2902,30067,64,254339
29603,0.000431,172.31.40.0-255,66,30133,64,254339
29604,0.000462,172.217.160.0-255,1484,31617,64,254339
29605,0.000464,172.31.40.0-255,66,31683,64,254339
29606,0.000491,172.217.160.0-255,2902,34585,64,254339
29607,0.000494,172.31.40.0-255,66,34651,64,254339
29608,0.00052,172.31.40.0-255,66,34717,64,254339
29609,0.000628,172.217.160.0-255,5738,40455,64,254339
29610,0.000633,172.31.40.0-255,66,40521,64,254339
29611,0.000666,172.217.160.0-255,6797,47318,64,254339
29612,0.000673,172.31.40.0-255,66,47384,64,254339
29613,0.000753,172.217.160.0-255,376,47760,64,254339
29614,0.000832,172.217.160.0-255,101,47861,64,254339
29615,0.000983,172.217.160.0-255,1484,49345,64,254339
29616,0.000989,172.217.160.0-255,2902,52247,64,254339
29617,0.001,172.31.40.0-255,66,52313,64,254339
29618,0.00102,172.217.160.0-255,5738,58051,64,254339
29619,0.001062,172.31.40.0-255,66,58117,64,254339
29620,0.001089,172.217.160.0-255,2902,61019,64,254339
29621,0.001092,172.31.40.0-255,66,61085,64,254339
29622,0.001144,172.31.40.0-255,66,61151,64,254339
29623,0.001255,172.217.160.0-255,5738,66889,64,254339
29624,0.001271,172.217.160.0-255,3961,70850,64,254339
29625,0.001276,172.31.40.0-255,66,70916,64,254339
29626,0.002925,172.217.160.0-255,5738,76654,64,254339
29627,0.002934,172.31.40.0-255,66,76720,64,254339
29628,0.004583,172.217.160.0-255,5738,82458,64,254339
29629,0.007535,172.31.40.0-255,66,82524,64,254339
29630,0.009188,172.217.160.0-255,5738,88262,64,254339
29631,0.009197,172.31.40.0-255,66,88328,64,254339
29632,0.010843,172.217.160.0-255,5738,94066,64,254339
29633,0.012764,172.31.40.0-255,66,94132,64,254339
29634,0.014418,172.217.160.0-255,5738,99870,64,254339
29635,0.014427,172.31.40.0-255,66,99936,64,254339
29636,0.016114,172.217.160.0-255,5738,105674,64,254339
29637,0.016127,172.31.40.0-255,66,105740,64,254339
29638,0.017785,172.217.160.0-255,5738,111478,64,254339
29639,0.017792,172.31.40.0-255,66,111544,64,254339
29640,0.019444,172.217.160.0-255,5738,117282,64,254339
29641,0.019455,172.31.40.0-255,66,117348,64,254339
29642,0.021099,172.217.160.0-255,5738,123086,64,254339
29643,0.021108,172.31.40.0-255,66,123152,64,254339
29644,0.022762,172.217.160.0-255,5738,128890,64,254339
29645,0.022771,172.31.40.0-255,66,128956,64,254339
29646,0.024422,172.217.160.0-255,5738,134694,64,254339
29647,0.024429,172.31.40.0-255,66,134760,64,254339
29648,0.024857,172.31.40.0-255,167,134927,64,254339
29649,0.02489,172.31.40.0-255,1108,136035,64,254339
29650,0.024944,172.31.40.0-255,1514,137549,64,254339
29651,0.024946,172.31.40.0-255,338,137887,64,254339
29652,0.026077,172.217.160.0-255,5738,143625,64,254339
29653,0.026084,172.31.40.0-255,66,143691,64,254339
29654,0.026393,104.244.42.0-255,66,143757,64,254339
29655,0.026438,104.244.42.0-255,66,143823,64,254339
29656,0.026458,104.244.42.0-255,66,143889,64,254339
29657,0.027366,104.244.42.0-255,108,143997,64,254339
29658,0.027374,172.31.40.0-255,66,144063,64,254339
29659,0.027731,172.217.160.0-255,5738,149801,64,254339
29660,0.027736,172.31.40.0-255,66,149867,64,254339
29661,0.029386,172.217.160.0-255,5738,155605,64,254339
29662,0.029394,172.31.40.0-255,66,155671,64,254339
29663,0.031052,172.217.160.0-255,5738,161409,64,254339
29664,0.031059,172.31.40.0-255,66,161475,64,254339
29665,0.032727,172.217.160.0-255,5738,167213,64,254339
29666,0.032735,172.31.40.0-255,66,167279,64,254339
29667,0.034392,172.217.160.0-255,5738,173017,64,254339
29668,0.034398,172.31.40.0-255,66,173083,64,254339
29669,0.036048,172.217.160.0-255,5738,178821,64,254339
29670,0.036055,172.31.40.0-255,66,178887,64,254339
29671,0.037709,172.217.160.0-255,5738,184625,64,254339
29672,0.037716,172.31.40.0-255,66,184691,64,254339
29673,0.039373,172.217.160.0-255,5738,190429,64,254339
29674,0.03938,172.31.40.0-255,66,190495,64,254339
29675,0.041033,172.217.160.0-255,5738,196233,64,254339
29676,0.041041,172.31.40.0-255,66,196299,64,254339
29677,0.042692,172.217.160.0-255,5738,202037,64,254339
29678,0.0427,172.31.40.0-255,66,202103,64,254339
29679,0.044354,172.217.160.0-255,5738,207841,64,254339
29680,0.044361,172.31.40.0-255,66,207907,64,254339
29681,0.046015,172.217.160.0-255,5738,213645,64,254339
29682,0.046023,172.31.40.0-255,66,213711,64,254339
29683,0.047686,172.217.160.0-255,5738,219449,64,254339
29684,0.047693,172.31.40.0-255,66,219515,64,254339
29685,0.049363,172.217.160.0-255,5738,225253,64,254339
29686,0.049369,172.31.40.0-255,66,225319,64,254339
29687,0.051061,172.217.160.0-255,5738,231057,64,254339
29688,0.051079,172.31.40.0-255,66,231123,64,254339
29689,0.052731,172.217.160.0-255,5738,236861,64,254339
29690,0.053807,172.31.40.0-255,66,236927,64,254339
29691,0.05546,172.217.160.0-255,5738,242665,64,254339
29692,0.055472,172.31.40.0-255,66,242731,64,254339
29693,0.057132,172.217.160.0-255,5738,248469,64,254339
29694,0.057145,172.31.40.0-255,66,248535,64,254339
29695,0.058803,172.217.160.0-255,5738,254273,64,254339
29696,0.05884,172.31.40.0-255,66,254339,64,254339
29697,0.0,74.125.68.0-255,152,152,64,271028
29698,1.4e-05,172.31.40.0-255,66,218,64,271028
29699,2.1e-05,74.125.68.0-255,1484,1702,64,271028
29700,2.5e-05,172.31.40.0-255,66,1768,64,271028
29701,3.1e-05,74.125.68.0-255,2902,4670,64,271028
29702,3.5e-05,172.31.40.0-255,66,4736,64,271028
29703,3.8e-05,74.125.68.0-255,1484,6220,64,271028
29704,4.1e-05,172.31.40.0-255,66,6286,64,271028
29705,6.7e-05,74.125.68.0-255,2902,9188,64,271028
29706,6.9e-05,172.31.40.0-255,66,9254,64,271028
29707,8.7e-05,74.125.68.0-255,4320,13574,64,271028
29708,9e-05,172.31.40.0-255,66,13640,64,271028
29709,0.000106,74.125.68.0-255,593,14233,64,271028
29710,0.000108,172.31.40.0-255,66,14299,64,271028
29711,0.000174,74.125.68.0-255,1484,15783,64,271028
29712,0.000176,172.31.40.0-255,66,15849,64,271028
29713,0.000191,74.125.68.0-255,2902,18751,64,271028
29714,0.000194,172.31.40.0-255,66,18817,64,271028
29715,0.000212,74.125.68.0-255,5738,24555,64,271028
29716,0.000215,172.31.40.0-255,66,24621,64,271028
29717,0.000232,74.125.68.0-255,1484,26105,64,271028
29718,0.000235,172.31.40.0-255,66,26171,64,271028
29719,0.000251,74.125.68.0-255,5379,31550,64,271028
29720,0.000254,172.31.40.0-255,66,31616,64,271028
29721,0.000321,74.125.68.0-255,1484,33100,64,271028
29722,0.000324,172.31.40.0-255,66,33166,64,271028
29723,0.000328,74.125.68.0-255,1484,34650,64,271028
29724,0.00033,172.31.40.0-255,66,34716,64,271028
29725,0.000342,74.125.68.0-255,1484,36200,64,271028
29726,0.000344,172.31.40.0-255,66,36266,64,271028
29727,0.000368,74.125.68.0-255,1484,37750,64,271028
29728,0.000371,172.31.40.0-255,66,37816,64,271028
29729,0.000377,74.125.68.0-255,5738,43554,64,271028
29730,0.00038,172.31.40.0-255,66,43620,64,271028
29731,0.000384,74.125.68.0-255,2902,46522,64,271028
29732,0.000386,172.31.40.0-255,66,46588,64,271028
29733,0.00041,74.125.68.0-255,2543,49131,64,271028
29734,0.000413,172.31.40.0-255,66,49197,64,271028
29735,0.000611,74.125.68.0-255,1484,50681,64,271028
29736,0.000616,74.125.68.0-255,1484,52165,64,271028
29737,0.000621,172.31.40.0-255,66,52231,64,271028
29738,0.000635,74.125.68.0-255,1484,53715,64,271028
29739,0.000641,74.125.68.0-255,4320,58035,64,271028
29740,0.000644,172.31.40.0-255,66,58101,64,271028
29741,0.000662,74.125.68.0-255,5738,63839,64,271028
29742,0.00067,172.31.40.0-255,66,63905,64,271028
29743,0.00069,74.125.68.0-255,2888,66793,64,271028
29744,0.000693,172.31.40.0-255,66,66859,64,271028
29745,0.000967,74.125.68.0-255,334,67193,64,271028
29746,0.001153,172.31.40.0-255,66,67259,64,271028
29747,0.001202,74.125.68.0-255,1484,68743,64,271028
29748,0.001216,74.125.68.0-255,2902,71645,64,271028
29749,0.00122,172.31.40.0-255,66,71711,64,271028
29750,0.001264,74.125.68.0-255,5738,77449,64,271028
29751,0.001266,172.31.40.0-255,66,77515,64,271028
29752,0.001272,74.125.68.0-255,5738,83253,64,271028
29753,0.001274,172.31.40.0-255,66,83319,64,271028
29754,0.001285,74.125.68.0-255,1125,84444,64,271028
29755,0.001327,74.125.68.0-255,1484,85928,64,271028
29756,0.00133,172.31.40.0-255,66,85994,64,271028
29757,0.001336,74.125.68.0-255,2902,88896,64,271028
29758,0.001338,172.31.40.0-255,66,88962,64,271028
29759,0.001373,74.125.68.0-255,1484,90446,64,271028
29760,0.001399,74.125.68.0-255,4320,94766,64,271028
29761,0.001404,74.125.68.0-255,5738,100504,64,271028
29762,0.001407,74.125.68.0-255,1125,101629,64,271028
29763,0.00141,172.31.40.0-255,66,101695,64,271028
29764,0.001417,172.31.40.0-255,66,101761,64,271028
29765,0.001626,172.31.40.0-255,66,101827,64,271028
29766,0.002214,74.125.68.0-255,1484,103311,64,271028
29767,0.002226,74.125.68.0-255,2902,106213,64,271028
29768,0.00223,172.31.40.0-255,66,106279,64,271028
29769,0.002236,74.125.68.0-255,2902,109181,64,271028
29770,0.002238,172.31.40.0-255,66,109247,64,271028
29771,0.002243,74.125.68.0-255,4320,113567,64,271028
29772,0.002245,172.31.40.0-255,66,113633,64,271028
29773,0.002289,74.125.68.0-255,5738,119371,64,271028
29774,0.002292,172.31.40.0-255,66,119437,64,271028
29775,0.002309,74.125.68.0-255,2902,122339,64,271028
29776,0.002311,172.31.40.0-255,66,122405,64,271028
29777,0.002314,74.125.68.0-255,1484,123889,64,271028
29778,0.004573,74.125.68.0-255,1484,125373,64,271028
29779,0.004579,172.31.40.0-255,66,125439,64,271028
29780,0.004599,74.125.68.0-255,2902,128341,64,271028
29781,0.004602,172.31.40.0-255,66,128407,64,271028
29782,0.006867,74.125.68.0-255,5738,134145,64,271028
29783,0.006871,172.31.40.0-255,66,134211,64,271028
29784,0.009155,74.125.68.0-255,5738,139949,64,271028
29785,0.009161,172.31.40.0-255,66,140015,64,271028
29786,0.011452,74.125.68.0-255,5738,145753,64,271028
29787,0.01146,172.31.40.0-255,66,145819,64,271028
29788,0.013774,74.125.68.0-255,5738,151557,64,271028
29789,0.013783,172.31.40.0-255,66,151623,64,271028
29790,0.016073,74.125.68.0-255,5738,157361,64,271028
29791,0.016082,172.31.40.0-255,66,157427,64,271028
29792,0.018378,74.125.68.0-255,5738,163165,64,271028
29793,0.018387,172.31.40.0-255,66,163231,64,271028
29794,0.020679,74.125.68.0-255,5738,168969,64,271028
29795,0.020686,172.31.40.0-255,66,169035,64,271028
29796,0.021237,172.31.40.0-255,167,169202,64,271028
29797,0.021272,172.31.40.0-255,1108,170310,64,271028
29798,0.021337,172.31.40.0-255,1514,171824,64,271028
29799,0.021339,172.31.40.0-255,338,172162,64,271028
29800,0.022782,104.244.42.0-255,66,172228,64,271028
29801,0.022812,104.244.42.0-255,66,172294,64,271028
29802,0.022869,104.244.42.0-255,66,172360,64,271028
29803,0.022994,74.125.68.0-255,5738,178098,64,271028
29804,0.022999,172.31.40.0-255,66,178164,64,271028
29805,0.025287,74.125.68.0-255,5738,183902,64,271028
29806,0.025294,172.31.40.0-255,66,183968,64,271028
29807,0.027587,74.125.68.0-255,5738,189706,64,271028
29808,0.027592,172.31.40.0-255,66,189772,64,271028
29809,0.02989,74.125.68.0-255,5738,195510,64,271028
29810,0.029897,172.31.40.0-255,66,195576,64,271028
29811,0.032183,74.125.68.0-255,5738,201314,64,271028
29812,0.032189,172.31.40.0-255,66,201380,64,271028
29813,0.034485,74.125.68.0-255,5738,207118,64,271028
29814,0.034492,172.31.40.0-255,66,207184,64,271028
29815,0.036806,74.125.68.0-255,5738,212922,64,271028
29816,0.036814,172.31.40.0-255,66,212988,64,271028
29817,0.039114,74.125.68.0-255,5738,218726,64,271028
29818,0.039121,172.31.40.0-255,66,218792,64,271028
29819,0.04142,74.125.68.0-255,5738,224530,64,271028
29820,0.041429,172.31.40.0-255,66,224596,64,271028
29821,0.04372,74.125.68.0-255,5738,230334,64,271028
29822,0.043726,172.31.40.0-255,66,230400,64,271028
29823,0.04603,74.125.68.0-255,5738,236138,64,271028
29824,0.046037,172.31.40.0-255,66,236204,64,271028
29825,0.048335,74.125.68.0-255,5738,241942,64,271028
29826,0.048341,172.31.40.0-255,66,242008,64,271028
29827,0.050637,74.125.68.0-255,5738,247746,64,271028
29828,0.050643,172.31.40.0-255,66,247812,64,271028
29829,0.052943,74.125.68.0-255,5738,253550,64,271028
29830,0.05295,172.31.40.0-255,66,253616,64,271028
29831,0.055261,74.125.68.0-255,5738,259354,64,271028
29832,0.05528,172.31.40.0-255,66,259420,64,271028
29833,0.057575,74.125.68.0-255,5738,265158,64,271028
29834,0.05759,172.31.40.0-255,66,265224,64,271028
29835,0.0599,74.125.68.0-255,5738,270962,64,271028
29836,0.059917,172.31.40.0-255,66,271028,64,271028
29837,0.0,172.217.194.0-255,143,143,64,312256
29838,2.6e-05,172.31.40.0-255,66,209,64,312256
29839,3.3e-05,172.217.194.0-255,1484,1693,64,312256
29840,3.8e-05,172.31.40.0-255,66,1759,64,312256
29841,4.3e-05,172.217.194.0-255,2902,4661,64,312256
29842,4.6e-05,172.31.40.0-255,66,4727,64,312256
29843,5.3e-05,172.217.194.0-255,7156,11883,64,312256
29844,5.6e-05,172.31.40.0-255,66,11949,64,312256
29845,6e-05,172.217.194.0-255,2110,14059,64,312256
29846,6.1e-05,172.31.40.0-255,66,14125,64,312256
29847,0.000111,172.217.194.0-255,2902,17027,64,312256
29848,0.000114,172.31.40.0-255,66,17093,64,312256
29849,0.000119,172.217.194.0-255,2902,19995,64,312256
29850,0.000121,172.31.40.0-255,66,20061,64,312256
29851,0.000133,172.217.194.0-255,1484,21545,64,312256
29852,0.000135,172.31.40.0-255,66,21611,64,312256
29853,0.000138,172.217.194.0-255,1484,23095,64,312256
29854,0.00014,172.31.40.0-255,66,23161,64,312256
29855,0.000172,172.217.194.0-255,7156,30317,64,312256
29856,0.000174,172.31.40.0-255,66,30383,64,312256
29857,0.000177,172.217.194.0-255,1125,31508,64,312256
29858,0.000179,172.31.40.0-255,66,31574,64,312256
29859,0.000182,172.217.194.0-255,1484,33058,64,312256
29860,0.000184,172.31.40.0-255,66,33124,64,312256
29861,0.000205,172.217.194.0-255,4320,37444,64,312256
29862,0.000208,172.31.40.0-255,66,37510,64,312256
29863,0.000211,172.217.194.0-255,1484,38994,64,312256
29864,0.000213,172.31.40.0-255,66,39060,64,312256
29865,0.000229,172.217.194.0-255,1484,40544,64,312256
29866,0.000231,172.31.40.0-255,66,40610,64,312256
29867,0.000279,172.31.40.0-255,66,40676,64,312256
29868,0.000305,172.217.194.0-255,1484,42160,64,312256
29869,0.000327,172.217.194.0-255,2902,45062,64,312256
29870,0.00033,172.31.40.0-255,66,45128,64,312256
29871,0.000336,172.217.194.0-255,5738,50866,64,312256
29872,0.000338,172.31.40.0-255,66,50932,64,312256
29873,0.000372,172.217.194.0-255,5738,56670,64,312256
29874,0.000374,172.31.40.0-255,66,56736,64,312256
29875,0.000403,172.217.194.0-255,1706,58442,64,312256
29876,0.000406,172.31.40.0-255,66,58508,64,312256
29877,0.000409,172.217.194.0-255,1484,59992,64,312256
29878,0.000423,172.217.194.0-255,1484,61476,64,312256
29879,0.000425,172.31.40.0-255,66,61542,64,312256
29880,0.000431,172.217.194.0-255,4320,65862,64,312256
29881,0.000433,172.31.40.0-255,66,65928,64,312256
29882,0.000465,172.31.40.0-255,66,65994,64,312256
29883,0.000468,172.217.194.0-255,1125,67119,64,312256
29884,0.000505,172.217.194.0-255,4320,71439,64,312256
29885,0.000508,172.31.40.0-255,66,71505,64,312256
29886,0.000535,172.217.194.0-255,7156,78661,64,312256
29887,0.000538,172.31.40.0-255,66,78727,64,312256
29888,0.000544,172.217.194.0-255,5379,84106,64,312256
29889,0.000546,172.31.40.0-255,66,84172,64,312256
29890,0.001222,172.217.194.0-255,1484,85656,64,312256
29891,0.001247,172.217.194.0-255,2902,88558,64,312256
29892,0.001251,172.31.40.0-255,66,88624,64,312256
29893,0.001259,172.217.194.0-255,5738,94362,64,312256
29894,0.001261,172.31.40.0-255,66,94428,64,312256
29895,0.001298,172.31.40.0-255,66,94494,64,312256
29896,0.001349,172.31.40.0-255,66,94560,64,312256
29897,0.001357,172.217.194.0-255,766,95326,64,312256
29898,0.001671,172.217.194.0-255,1484,96810,64,312256
29899,0.001676,172.31.40.0-255,66,96876,64,312256
29900,0.001681,172.217.194.0-255,2902,99778,64,312256
29901,0.001684,172.31.40.0-255,66,99844,64,312256
29902,0.001689,172.217.194.0-255,4320,104164,64,312256
29903,0.001691,172.31.40.0-255,66,104230,64,312256
29904,0.001705,172.217.194.0-255,1484,105714,64,312256
29905,0.001713,172.217.194.0-255,7156,112870,64,312256
29906,0.001715,172.31.40.0-255,66,112936,64,312256
29907,0.001735,172.217.194.0-255,5738,118674,64,312256
29908,0.001737,172.31.40.0-255,66,118740,64,312256
29909,0.001741,172.217.194.0-255,2902,121642,64,312256
29910,0.001743,172.31.40.0-255,66,121708,64,312256
29911,0.001767,172.31.40.0-255,66,121774,64,312256
29912,0.001863,172.217.194.0-255,1484,123258,64,312256
29913,0.001876,172.217.194.0-255,1484,124742,64,312256
29914,0.001879,172.31.40.0-255,66,124808,64,312256
29915,0.001902,172.217.194.0-255,1484,126292,64,312256
29916,0.001908,172.217.194.0-255,5738,132030,64,312256
29917,0.001911,172.31.40.0-255,66,132096,64,312256
29918,0.001917,172.217.194.0-255,5738,137834,64,312256
29919,0.001919,172.31.40.0-255,66,137900,64,312256
29920,0.001955,172.217.194.0-255,7156,145056,64,312256
29921,0.001958,172.31.40.0-255,66,145122,64,312256
29922,0.001971,172.31.40.0-255,66,145188,64,312256
29923,0.001986,172.31.40.0-255,66,145254,64,312256
29924,0.001989,172.217.194.0-255,1484,146738,64,312256
29925,0.002035,172.31.40.0-255,66,146804,64,312256
29926,0.004066,172.217.194.0-255,5738,152542,64,312256
29927,0.004075,172.31.40.0-255,66,152608,64,312256
29928,0.006079,172.217.194.0-255,4320,156928,64,312256
29929,0.006083,172.31.40.0-255,66,156994,64,312256
29930,0.006108,172.217.194.0-255,1484,158478,64,312256
29931,0.008092,172.217.194.0-255,4320,162798,64,312256
29932,0.008099,172.31.40.0-255,66,162864,64,312256
29933,0.010146,172.217.194.0-255,5738,168602,64,312256
29934,0.010164,172.31.40.0-255,66,168668,64,312256
29935,0.01219,172.217.194.0-255,5738,174406,64,312256
29936,0.012204,172.31.40.0-255,66,174472,64,312256
29937,0.01424,172.217.194.0-255,5738,180210,64,312256
29938,0.014258,172.31.40.0-255,66,180276,64,312256
29939,0.016312,172.217.194.0-255,5738,186014,64,312256
29940,0.016326,172.31.40.0-255,66,186080,64,312256
29941,0.018329,172.217.194.0-255,5738,191818,64,312256
29942,0.01834,172.31.40.0-255,66,191884,64,312256
29943,0.020415,172.217.194.0-255,5738,197622,64,312256
29944,0.020424,172.31.40.0-255,66,197688,64,312256
29945,0.022458,172.217.194.0-255,5738,203426,64,312256
29946,0.022467,172.31.40.0-255,66,203492,64,312256
29947,0.024496,172.217.194.0-255,5738,209230,64,312256
29948,0.024508,172.31.40.0-255,66,209296,64,312256
29949,0.026528,172.217.194.0-255,5738,215034,64,312256
29950,0.026537,172.31.40.0-255,66,215100,64,312256
29951,0.028566,172.217.194.0-255,5738,220838,64,312256
29952,0.028574,172.31.40.0-255,66,220904,64,312256
29953,0.030618,172.217.194.0-255,5738,226642,64,312256
29954,0.030627,172.31.40.0-255,66,226708,64,312256
29955,0.032695,172.217.194.0-255,5738,232446,64,312256
29956,0.032712,172.31.40.0-255,66,232512,64,312256
29957,0.034733,172.217.194.0-255,5738,238250,64,312256
29958,0.034741,172.31.40.0-255,66,238316,64,312256
29959,0.03676,172.217.194.0-255,5738,244054,64,312256
29960,0.036768,172.31.40.0-255,66,244120,64,312256
29961,0.038791,172.217.194.0-255,5738,249858,64,312256
29962,0.038808,172.31.40.0-255,66,249924,64,312256
29963,0.040816,172.217.194.0-255,5738,255662,64,312256
29964,0.040824,172.31.40.0-255,66,255728,64,312256
29965,0.042846,172.217.194.0-255,5738,261466,64,312256
29966,0.042858,172.31.40.0-255,66,261532,64,312256
29967,0.04491,172.217.194.0-255,5738,267270,64,312256
29968,0.04492,172.31.40.0-255,66,267336,64,312256
29969,0.046788,172.31.40.0-255,172,267508,64,312256
29970,0.046824,172.31.40.0-255,1112,268620,64,312256
29971,0.046882,172.31.40.0-255,1514,270134,64,312256
29972,0.046884,172.31.40.0-255,1296,271430,64,312256
29973,0.046966,172.217.194.0-255,5738,277168,64,312256
29974,0.046973,172.31.40.0-255,66,277234,64,312256
29975,0.048326,104.244.42.0-255,66,277300,64,312256
29976,0.048371,104.244.42.0-255,66,277366,64,312256
29977,0.048466,104.244.42.0-255,66,277432,64,312256
29978,0.048964,172.217.194.0-255,5738,283170,64,312256
29979,0.048972,172.31.40.0-255,66,283236,64,312256
29980,0.051028,172.217.194.0-255,5738,288974,64,312256
29981,0.051043,172.31.40.0-255,66,289040,64,312256
29982,0.053079,172.217.194.0-255,5738,294778,64,312256
29983,0.053094,172.31.40.0-255,66,294844,64,312256
29984,0.055096,172.217.194.0-255,5738,300582,64,312256
29985,0.055108,172.31.40.0-255,66,300648,64,312256
29986,0.057159,172.217.194.0-255,5738,306386,64,312256
29987,0.057171,172.31.40.0-255,66,306452,64,312256
29988,0.059186,172.217.194.0-255,5738,312190,64,312256
29989,0.059201,172.31.40.0-255,66,312256,64,312256
29990,0.0,74.125.130.0-255,143,143,64,277892
29991,1.3e-05,172.31.40.0-255,66,209,64,277892
29992,2e-05,74.125.130.0-255,1484,1693,64,277892
29993,2.4e-05,172.31.40.0-255,66,1759,64,277892
29994,3e-05,74.125.130.0-255,2902,4661,64,277892
29995,3.2e-05,172.31.40.0-255,66,4727,64,277892
29996,4.6e-05,74.125.130.0-255,4320,9047,64,277892
29997,4.8e-05,172.31.40.0-255,66,9113,64,277892
29998,8.9e-05,74.125.130.0-255,2902,12015,64,277892
29999,9.1e-05,172.31.40.0-255,66,12081,64,277892
30000,0.000128,74.125.130.0-255,6291,18372,64,277892
30001,0.000131,172.31.40.0-255,66,18438,64,277892
30002,0.000138,74.125.130.0-255,5738,24176,64,277892
30003,0.00014,172.31.40.0-255,66,24242,64,277892
30004,0.00018,74.125.130.0-255,6797,31039,64,277892
30005,0.000182,172.31.40.0-255,66,31105,64,277892
30006,0.000264,74.125.130.0-255,1484,32589,64,277892
30007,0.000267,172.31.40.0-255,66,32655,64,277892
30008,0.000293,74.125.130.0-255,2902,35557,64,277892
30009,0.000295,172.31.40.0-255,66,35623,64,277892
30010,0.000298,74.125.130.0-255,1484,37107,64,277892
30011,0.0003,172.31.40.0-255,66,37173,64,277892
30012,0.000304,74.125.130.0-255,2902,40075,64,277892
30013,0.000314,74.125.130.0-255,4320,44395,64,277892
30014,0.000319,172.31.40.0-255,66,44461,64,277892
30015,0.000321,172.31.40.0-255,66,44527,64,277892
30016,0.000345,74.125.130.0-255,1484,46011,64,277892
30017,0.000348,172.31.40.0-255,66,46077,64,277892
30018,0.000353,74.125.130.0-255,2902,48979,64,277892
30019,0.000355,172.31.40.0-255,66,49045,64,277892
30020,0.000389,172.31.40.0-255,66,49111,64,277892
30021,0.000395,74.125.130.0-255,4320,53431,64,277892
30022,0.000397,172.31.40.0-255,66,53497,64,277892
30023,0.00042,74.125.130.0-255,1440,54937,64,277892
30024,0.000452,74.125.130.0-255,362,55299,64,277892
30025,0.000455,172.31.40.0-255,66,55365,64,277892
30026,0.000807,74.125.130.0-255,1484,56849,64,277892
30027,0.000815,74.125.130.0-255,2902,59751,64,277892
30028,0.00082,172.31.40.0-255,66,59817,64,277892
30029,0.000856,74.125.130.0-255,5738,65555,64,277892
30030,0.00086,172.31.40.0-255,66,65621,64,277892
30031,0.000871,172.31.40.0-255,66,65687,64,277892
30032,0.0009,172.31.40.0-255,66,65753,64,277892
30033,0.000914,74.125.130.0-255,4320,70073,64,277892
30034,0.000917,172.31.40.0-255,66,70139,64,277892
30035,0.000939,74.125.130.0-255,766,70905,64,277892
30036,0.001094,74.125.130.0-255,1484,72389,64,277892
30037,0.001099,172.31.40.0-255,66,72455,64,277892
30038,0.001105,74.125.130.0-255,2902,75357,64,277892
30039,0.001107,172.31.40.0-255,66,75423,64,277892
30040,0.001119,74.125.130.0-255,5738,81161,64,277892
30041,0.001121,172.31.40.0-255,66,81227,64,277892
30042,0.001125,74.125.130.0-255,2902,84129,64,277892
30043,0.001128,172.31.40.0-255,66,84195,64,277892
30044,0.001156,172.31.40.0-255,66,84261,64,277892
30045,0.001199,74.125.130.0-255,5738,89999,64,277892
30046,0.001203,172.31.40.0-255,66,90065,64,277892
30047,0.001227,74.125.130.0-255,2902,92967,64,277892
30048,0.00123,172.31.40.0-255,66,93033,64,277892
30049,0.001235,74.125.130.0-255,2184,95217,64,277892
30050,0.001238,172.31.40.0-255,66,95283,64,277892
30051,0.001999,74.125.130.0-255,1484,96767,64,277892
30052,0.002003,74.125.130.0-255,1484,98251,64,277892
30053,0.002006,172.31.40.0-255,66,98317,64,277892
30054,0.002025,74.125.130.0-255,1484,99801,64,277892
30055,0.002035,74.125.130.0-255,5738,105539,64,277892
30056,0.002037,172.31.40.0-255,66,105605,64,277892
30057,0.002062,74.125.130.0-255,1484,107089,64,277892
30058,0.002096,172.31.40.0-255,66,107155,64,277892
30059,0.002101,74.125.130.0-255,4320,111475,64,277892
30060,0.002102,172.31.40.0-255,66,111541,64,277892
30061,0.002132,74.125.130.0-255,5738,117279,64,277892
30062,0.002135,172.31.40.0-255,66,117345,64,277892
30063,0.002137,74.125.130.0-255,766,118111,64,277892
30064,0.002394,172.31.40.0-255,66,118177,64,277892
30065,0.004224,74.125.130.0-255,4320,122497,64,277892
30066,0.00423,172.31.40.0-255,66,122563,64,277892
30067,0.00447,74.125.130.0-255,1484,124047,64,277892
30068,0.006336,74.125.130.0-255,4320,128367,64,277892
30069,0.006341,172.31.40.0-255,66,128433,64,277892
30070,0.00846,74.125.130.0-255,5738,134171,64,277892
30071,0.008467,172.31.40.0-255,66,134237,64,277892
30072,0.010588,74.125.130.0-255,5738,139975,64,277892
30073,0.010595,172.31.40.0-255,66,140041,64,277892
30074,0.012689,74.125.130.0-255,5738,145779,64,277892
30075,0.0127,172.31.40.0-255,66,145845,64,277892
30076,0.014807,74.125.130.0-255,5738,151583,64,277892
30077,0.014814,172.31.40.0-255,66,151649,64,277892
30078,0.01691,74.125.130.0-255,5738,157387,64,277892
30079,0.016917,172.31.40.0-255,66,157453,64,277892
30080,0.019013,74.125.130.0-255,5738,163191,64,277892
30081,0.01902,172.31.40.0-255,66,163257,64,277892
30082,0.021109,74.125.130.0-255,5738,168995,64,277892
30083,0.021116,172.31.40.0-255,66,169061,64,277892
30084,0.023226,74.125.130.0-255,5738,174799,64,277892
30085,0.023233,172.31.40.0-255,66,174865,64,277892
30086,0.025328,74.125.130.0-255,5738,180603,64,277892
30087,0.025337,172.31.40.0-255,66,180669,64,277892
30088,0.027435,74.125.130.0-255,5738,186407,64,277892
30089,0.027442,172.31.40.0-255,66,186473,64,277892
30090,0.029332,172.31.40.0-255,172,186645,64,277892
30091,0.029364,172.31.40.0-255,1112,187757,64,277892
30092,0.02942,172.31.40.0-255,1514,189271,64,277892
30093,0.029422,172.31.40.0-255,1297,190568,64,277892
30094,0.029541,74.125.130.0-255,5738,196306,64,277892
30095,0.029547,172.31.40.0-255,66,196372,64,277892
30096,0.030863,104.244.42.0-255,66,196438,64,277892
30097,0.030936,104.244.42.0-255,66,196504,64,277892
30098,0.03094,104.244.42.0-255,66,196570,64,277892
30099,0.031646,74.125.130.0-255,5738,202308,64,277892
30100,0.031653,172.31.40.0-255,66,202374,64,277892
30101,0.033759,74.125.130.0-255,5738,208112,64,277892
30102,0.033766,172.31.40.0-255,66,208178,64,277892
30103,0.035868,74.125.130.0-255,5738,213916,64,277892
30104,0.035877,172.31.40.0-255,66,213982,64,277892
30105,0.037964,74.125.130.0-255,5738,219720,64,277892
30106,0.037971,172.31.40.0-255,66,219786,64,277892
30107,0.040087,74.125.130.0-255,5738,225524,64,277892
30108,0.040097,172.31.40.0-255,66,225590,64,277892
30109,0.042236,74.125.130.0-255,5738,231328,64,277892
30110,0.042246,172.31.40.0-255,66,231394,64,277892
30111,0.044365,74.125.130.0-255,5738,237132,64,277892
30112,0.044371,172.31.40.0-255,66,237198,64,277892
30113,0.046481,74.125.130.0-255,5738,242936,64,277892
30114,0.046488,172.31.40.0-255,66,243002,64,277892
30115,0.048591,74.125.130.0-255,5738,248740,64,277892
30116,0.048596,172.31.40.0-255,66,248806,64,277892
30117,0.050681,74.125.130.0-255,1484,250290,64,277892
30118,0.05071,74.125.130.0-255,4320,254610,64,277892
30119,0.050714,172.31.40.0-255,66,254676,64,277892
30120,0.052821,74.125.130.0-255,5738,260414,64,277892
30121,0.052827,172.31.40.0-255,66,260480,64,277892
30122,0.054932,74.125.130.0-255,5738,266218,64,277892
30123,0.054938,172.31.40.0-255,66,266284,64,277892
30124,0.057033,74.125.130.0-255,5738,272022,64,277892
30125,0.057039,172.31.40.0-255,66,272088,64,277892
30126,0.05914,74.125.130.0-255,5738,277826,64,277892
30127,0.059148,172.31.40.0-255,66,277892,64,277892
30128,0.0,172.217.194.0-255,153,153,64,213700
30129,2e-05,172.31.40.0-255,66,219,64,213700
30130,2.7e-05,172.217.194.0-255,1484,1703,64,213700
30131,3.1e-05,172.31.40.0-255,66,1769,64,213700
30132,3.7e-05,172.217.194.0-255,2902,4671,64,213700
30133,3.9e-05,172.31.40.0-255,66,4737,64,213700
30134,8.3e-05,172.217.194.0-255,2902,7639,64,213700
30135,8.7e-05,172.31.40.0-255,66,7705,64,213700
30136,0.000111,172.217.194.0-255,4320,12025,64,213700
30137,0.000114,172.31.40.0-255,66,12091,64,213700
30138,0.000226,172.217.194.0-255,2029,14120,64,213700
30139,0.000231,172.31.40.0-255,66,14186,64,213700
30140,0.000247,172.217.194.0-255,2902,17088,64,213700
30141,0.000249,172.31.40.0-255,66,17154,64,213700
30142,0.000302,172.217.194.0-255,4320,21474,64,213700
30143,0.000305,172.31.40.0-255,66,21540,64,213700
30144,0.000325,172.217.194.0-255,2902,24442,64,213700
30145,0.000328,172.31.40.0-255,66,24508,64,213700
30146,0.000426,172.217.194.0-255,2902,27410,64,213700
30147,0.000429,172.31.40.0-255,66,27476,64,213700
30148,0.000454,172.31.40.0-255,66,27542,64,213700
30149,0.000724,172.31.40.0-255,66,27608,64,213700
30150,0.000748,172.217.194.0-255,7156,34764,64,213700
30151,0.000751,172.31.40.0-255,66,34830,64,213700
30152,0.001069,172.217.194.0-255,5330,40160,64,213700
30153,0.001074,172.31.40.0-255,66,40226,64,213700
30154,0.001132,172.217.194.0-255,100,40326,64,213700
30155,0.001135,172.31.40.0-255,66,40392,64,213700
30156,0.001175,172.31.40.0-255,66,40458,64,213700
30157,0.001685,172.217.194.0-255,5020,45478,64,213700
30158,0.001768,172.217.194.0-255,1484,46962,64,213700
30159,0.001787,172.217.194.0-255,2902,49864,64,213700
30160,0.001858,172.217.194.0-255,4320,54184,64,213700
30161,0.001877,172.217.194.0-255,1484,55668,64,213700
30162,0.001955,172.217.194.0-255,5738,61406,64,213700
30163,0.001973,172.217.194.0-255,4320,65726,64,213700
30164,0.002127,172.217.194.0-255,4320,70046,64,213700
30165,0.002377,172.217.194.0-255,1484,71530,64,213700
30166,0.002632,172.217.194.0-255,4320,75850,64,213700
30167,0.003866,172.31.40.0-255,66,75916,64,213700
30168,0.006136,172.217.194.0-255,5738,81654,64,213700
30169,0.006142,172.31.40.0-255,66,81720,64,213700
30170,0.008412,172.217.194.0-255,5738,87458,64,213700
30171,0.008901,172.31.40.0-255,66,87524,64,213700
30172,0.011183,172.217.194.0-255,5738,93262,64,213700
30173,0.011191,172.31.40.0-255,66,93328,64,213700
30174,0.013446,172.217.194.0-255,5738,99066,64,213700
30175,0.015247,172.31.40.0-255,66,99132,64,213700
30176,0.017505,172.217.194.0-255,5738,104870,64,213700
30177,0.017517,172.31.40.0-255,66,104936,64,213700
30178,0.019757,172.217.194.0-255,5738,110674,64,213700
30179,0.019764,172.31.40.0-255,66,110740,64,213700
30180,0.022033,172.217.194.0-255,5738,116478,64,213700
30181,0.022041,172.31.40.0-255,66,116544,64,213700
30182,0.024323,172.217.194.0-255,5738,122282,64,213700
30183,0.024331,172.31.40.0-255,66,122348,64,213700
30184,0.026633,172.217.194.0-255,5738,128086,64,213700
30185,0.026639,172.31.40.0-255,66,128152,64,213700
30186,0.027808,172.31.40.0-255,172,128324,64,213700
30187,0.02784,172.31.40.0-255,1112,129436,64,213700
30188,0.027897,172.31.40.0-255,1514,130950,64,213700
30189,0.027899,172.31.40.0-255,1296,132246,64,213700
30190,0.028927,172.217.194.0-255,5738,137984,64,213700
30191,0.028934,172.31.40.0-255,66,138050,64,213700
30192,0.029323,104.244.42.0-255,66,138116,64,213700
30193,0.029407,104.244.42.0-255,66,138182,64,213700
30194,0.029457,104.244.42.0-255,66,138248,64,213700
30195,0.031185,172.217.194.0-255,5738,143986,64,213700
30196,0.03119,172.31.40.0-255,66,144052,64,213700
30197,0.033472,172.217.194.0-255,5738,149790,64,213700
30198,0.033478,172.31.40.0-255,66,149856,64,213700
30199,0.035752,172.217.194.0-255,5738,155594,64,213700
30200,0.035759,172.31.40.0-255,66,155660,64,213700
30201,0.038037,172.217.194.0-255,5738,161398,64,213700
30202,0.038045,172.31.40.0-255,66,161464,64,213700
30203,0.040307,172.217.194.0-255,5738,167202,64,213700
30204,0.040313,172.31.40.0-255,66,167268,64,213700
30205,0.042621,172.217.194.0-255,5738,173006,64,213700
30206,0.042639,172.31.40.0-255,66,173072,64,213700
30207,0.044919,172.217.194.0-255,5738,178810,64,213700
30208,0.044934,172.31.40.0-255,66,178876,64,213700
30209,0.047204,172.217.194.0-255,5738,184614,64,213700
30210,0.047218,172.31.40.0-255,66,184680,64,213700
30211,0.0495,172.217.194.0-255,5738,190418,64,213700
30212,0.049514,172.31.40.0-255,66,190484,64,213700
30213,0.051805,172.217.194.0-255,5738,196222,64,213700
30214,0.051827,172.31.40.0-255,66,196288,64,213700
30215,0.054112,172.217.194.0-255,5738,202026,64,213700
30216,0.054125,172.31.40.0-255,66,202092,64,213700
30217,0.056399,172.217.194.0-255,5738,207830,64,213700
30218,0.056415,172.31.40.0-255,66,207896,64,213700
30219,0.058739,172.217.194.0-255,5738,213634,64,213700
30220,0.058757,172.31.40.0-255,66,213700,64,213700
30221,0.0,172.217.194.0-255,153,153,64,315809
30222,2.4e-05,172.31.40.0-255,66,219,64,315809
30223,3.2e-05,172.217.194.0-255,1484,1703,64,315809
30224,3.7e-05,172.31.40.0-255,66,1769,64,315809
30225,4.4e-05,172.217.194.0-255,2902,4671,64,315809
30226,4.7e-05,172.31.40.0-255,66,4737,64,315809
30227,5.5e-05,172.217.194.0-255,7156,11893,64,315809
30228,5.8e-05,172.31.40.0-255,66,11959,64,315809
30229,6.2e-05,172.217.194.0-255,2157,14116,64,315809
30230,6.5e-05,172.31.40.0-255,66,14182,64,315809
30231,0.000167,172.217.194.0-255,1484,15666,64,315809
30232,0.000171,172.31.40.0-255,66,15732,64,315809
30233,0.000177,172.217.194.0-255,2902,18634,64,315809
30234,0.000179,172.31.40.0-255,66,18700,64,315809
30235,0.000185,172.217.194.0-255,4320,23020,64,315809
30236,0.000187,172.31.40.0-255,66,23086,64,315809
30237,0.000202,172.217.194.0-255,1484,24570,64,315809
30238,0.000204,172.31.40.0-255,66,24636,64,315809
30239,0.000208,172.217.194.0-255,2902,27538,64,315809
30240,0.00021,172.31.40.0-255,66,27604,64,315809
30241,0.000235,172.217.194.0-255,1484,29088,64,315809
30242,0.000237,172.31.40.0-255,66,29154,64,315809
30243,0.000268,172.31.40.0-255,66,29220,64,315809
30244,0.000297,172.217.194.0-255,5738,34958,64,315809
30245,0.0003,172.31.40.0-255,66,35024,64,315809
30246,0.000323,172.217.194.0-255,3961,38985,64,315809
30247,0.000325,172.31.40.0-255,66,39051,64,315809
30248,0.000337,172.31.40.0-255,66,39117,64,315809
30249,0.00034,172.217.194.0-255,1484,40601,64,315809
30250,0.000342,172.31.40.0-255,66,40667,64,315809
30251,0.000374,172.217.194.0-255,5629,46296,64,315809
30252,0.000379,172.217.194.0-255,435,46731,64,315809
30253,0.000519,172.31.40.0-255,66,46797,64,315809
30254,0.000591,172.217.194.0-255,1484,48281,64,315809
30255,0.000596,172.217.194.0-255,1484,49765,64,315809
30256,0.000609,172.217.194.0-255,1484,51249,64,315809
30257,0.000616,172.217.194.0-255,5738,56987,64,315809
30258,0.00062,172.31.40.0-255,66,57053,64,315809
30259,0.000633,172.217.194.0-255,4320,61373,64,315809
30260,0.000638,172.31.40.0-255,66,61439,64,315809
30261,0.000675,172.31.40.0-255,66,61505,64,315809
30262,0.000736,172.31.40.0-255,66,61571,64,315809
30263,0.000751,172.217.194.0-255,1484,63055,64,315809
30264,0.000761,172.217.194.0-255,1484,64539,64,315809
30265,0.00077,172.31.40.0-255,66,64605,64,315809
30266,0.000778,172.217.194.0-255,1484,66089,64,315809
30267,0.000791,172.217.194.0-255,1484,67573,64,315809
30268,0.000805,172.217.194.0-255,4320,71893,64,315809
30269,0.000808,172.217.194.0-255,1484,73377,64,315809
30270,0.000824,172.217.194.0-255,7156,80533,64,315809
30271,0.00086,172.217.194.0-255,2902,83435,64,315809
30272,0.000878,172.217.194.0-255,7156,90591,64,315809
30273,0.000884,172.217.194.0-255,4320,94911,64,315809
30274,0.00089,172.31.40.0-255,66,94977,64,315809
30275,0.00093,172.31.40.0-255,66,95043,64,315809
30276,0.000942,172.217.194.0-255,5379,100422,64,315809
30277,0.000946,172.31.40.0-255,66,100488,64,315809
30278,0.001002,172.217.194.0-255,1484,101972,64,315809
30279,0.001008,172.217.194.0-255,2902,104874,64,315809
30280,0.001014,172.217.194.0-255,4320,109194,64,315809
30281,0.001027,172.31.40.0-255,66,109260,64,315809
30282,0.00103,172.217.194.0-255,1484,110744,64,315809
30283,0.001034,172.217.194.0-255,2902,113646,64,315809
30284,0.001039,172.31.40.0-255,66,113712,64,315809
30285,0.001058,172.217.194.0-255,2902,116614,64,315809
30286,0.001096,172.31.40.0-255,66,116680,64,315809
30287,0.001127,172.217.194.0-255,1484,118164,64,315809
30288,0.001132,172.217.194.0-255,2902,121066,64,315809
30289,0.001145,172.31.40.0-255,66,121132,64,315809
30290,0.001155,172.217.194.0-255,5738,126870,64,315809
30291,0.001158,172.217.194.0-255,1484,128354,64,315809
30292,0.001166,172.31.40.0-255,66,128420,64,315809
30293,0.001178,172.217.194.0-255,5738,134158,64,315809
30294,0.001193,172.217.194.0-255,2902,137060,64,315809
30295,0.001221,172.217.194.0-255,7156,144216,64,315809
30296,0.001225,172.31.40.0-255,66,144282,64,315809
30297,0.001236,172.31.40.0-255,66,144348,64,315809
30298,0.001258,172.217.194.0-255,4320,148668,64,315809
30299,0.001272,172.217.194.0-255,2184,150852,64,315809
30300,0.001277,172.31.40.0-255,66,150918,64,315809
30301,0.001305,172.217.194.0-255,2902,153820,64,315809
30302,0.001313,172.31.40.0-255,66,153886,64,315809
30303,0.001326,172.217.194.0-255,4320,158206,64,315809
30304,0.001344,172.31.40.0-255,66,158272,64,315809
30305,0.001356,172.217.194.0-255,2902,161174,64,315809
30306,0.00137,172.217.194.0-255,4320,165494,64,315809
30307,0.001376,172.217.194.0-255,4320,169814,64,315809
30308,0.001394,172.217.194.0-255,4320,174134,64,315809
30309,0.001398,172.31.40.0-255,66,174200,64,315809
30310,0.001422,172.217.194.0-255,7156,181356,64,315809
30311,0.001437,172.217.194.0-255,3602,184958,64,315809
30312,0.001448,172.31.40.0-255,66,185024,64,315809
30313,0.002136,172.217.194.0-255,1484,186508,64,315809
30314,0.002142,172.217.194.0-255,2902,189410,64,315809
30315,0.002145,172.217.194.0-255,2902,192312,64,315809
30316,0.002163,172.217.194.0-255,2902,195214,64,315809
30317,0.002166,172.217.194.0-255,1484,196698,64,315809
30318,0.002181,172.217.194.0-255,5379,202077,64,315809
30319,0.008207,172.31.40.0-255,66,202143,64,315809
30320,0.008284,172.31.40.0-255,66,202209,64,315809
30321,0.010773,172.217.194.0-255,5738,207947,64,315809
30322,0.010782,172.31.40.0-255,66,208013,64,315809
30323,0.013261,172.217.194.0-255,5738,213751,64,315809
30324,0.01327,172.31.40.0-255,66,213817,64,315809
30325,0.015774,172.217.194.0-255,5738,219555,64,315809
30326,0.0173,172.31.40.0-255,66,219621,64,315809
30327,0.019821,172.217.194.0-255,5738,225359,64,315809
30328,0.01984,172.31.40.0-255,66,225425,64,315809
30329,0.022354,172.217.194.0-255,5738,231163,64,315809
30330,0.022367,172.31.40.0-255,66,231229,64,315809
30331,0.024909,172.217.194.0-255,5738,236967,64,315809
30332,0.024922,172.31.40.0-255,66,237033,64,315809
30333,0.027406,172.217.194.0-255,5738,242771,64,315809
30334,0.027417,172.31.40.0-255,66,242837,64,315809
30335,0.029922,172.217.194.0-255,5738,248575,64,315809
30336,0.029939,172.31.40.0-255,66,248641,64,315809
30337,0.032431,172.217.194.0-255,5738,254379,64,315809
30338,0.032447,172.31.40.0-255,66,254445,64,315809
30339,0.034951,172.217.194.0-255,5738,260183,64,315809
30340,0.034961,172.31.40.0-255,66,260249,64,315809
30341,0.035623,172.31.40.0-255,167,260416,64,315809
30342,0.035662,172.31.40.0-255,1107,261523,64,315809
30343,0.035725,172.31.40.0-255,1514,263037,64,315809
30344,0.035727,172.31.40.0-255,338,263375,64,315809
30345,0.037239,104.244.42.0-255,66,263441,64,315809
30346,0.037249,104.244.42.0-255,66,263507,64,315809
30347,0.037298,104.244.42.0-255,66,263573,64,315809
30348,0.037483,172.217.194.0-255,5738,269311,64,315809
30349,0.037489,172.31.40.0-255,66,269377,64,315809
30350,0.039993,172.217.194.0-255,5738,275115,64,315809
30351,0.040001,172.31.40.0-255,66,275181,64,315809
30352,0.042509,172.217.194.0-255,5738,280919,64,315809
30353,0.042517,172.31.40.0-255,66,280985,64,315809
30354,0.045022,172.217.194.0-255,5738,286723,64,315809
30355,0.045031,172.31.40.0-255,66,286789,64,315809
30356,0.047537,172.217.194.0-255,5738,292527,64,315809
30357,0.047547,172.31.40.0-255,66,292593,64,315809
30358,0.050069,172.217.194.0-255,5738,298331,64,315809
30359,0.050079,172.31.40.0-255,66,298397,64,315809
30360,0.052574,172.217.194.0-255,5738,304135,64,315809
30361,0.052587,172.31.40.0-255,66,304201,64,315809
30362,0.055102,172.217.194.0-255,5738,309939,64,315809
30363,0.055112,172.31.40.0-255,66,310005,64,315809
30364,0.05762,172.217.194.0-255,5738,315743,64,315809
30365,0.057629,172.31.40.0-255,66,315809,64,315809
30366,0.0,74.125.200.0-255,291,291,64,276797
30367,2.4e-05,172.31.40.0-255,66,357,64,276797
30368,3e-05,74.125.200.0-255,1484,1841,64,276797
30369,3.5e-05,172.31.40.0-255,66,1907,64,276797
30370,5e-05,74.125.200.0-255,4320,6227,64,276797
30371,5.4e-05,172.31.40.0-255,66,6293,64,276797
30372,6.1e-05,74.125.200.0-255,5738,12031,64,276797
30373,6.4e-05,172.31.40.0-255,66,12097,64,276797
30374,6.8e-05,74.125.200.0-255,1943,14040,64,276797
30375,7.1e-05,172.31.40.0-255,66,14106,64,276797
30376,0.000124,74.125.200.0-255,1484,15590,64,276797
30377,0.000127,172.31.40.0-255,66,15656,64,276797
30378,0.000132,74.125.200.0-255,2902,18558,64,276797
30379,0.000135,172.31.40.0-255,66,18624,64,276797
30380,0.000147,74.125.200.0-255,5738,24362,64,276797
30381,0.000149,172.31.40.0-255,66,24428,64,276797
30382,0.000153,74.125.200.0-255,1484,25912,64,276797
30383,0.000155,172.31.40.0-255,66,25978,64,276797
30384,0.00019,74.125.200.0-255,5379,31357,64,276797
30385,0.000193,172.31.40.0-255,66,31423,64,276797
30386,0.000201,74.125.200.0-255,7156,38579,64,276797
30387,0.000203,172.31.40.0-255,66,38645,64,276797
30388,0.000207,74.125.200.0-255,2902,41547,64,276797
30389,0.00021,172.31.40.0-255,66,41613,64,276797
30390,0.00024,74.125.200.0-255,2902,44515,64,276797
30391,0.000243,172.31.40.0-255,66,44581,64,276797
30392,0.000265,74.125.200.0-255,1484,46065,64,276797
30393,0.000267,172.31.40.0-255,66,46131,64,276797
30394,0.000272,74.125.200.0-255,2543,48674,64,276797
30395,0.000274,172.31.40.0-255,66,48740,64,276797
30396,0.000278,74.125.200.0-255,2902,51642,64,276797
30397,0.00028,172.31.40.0-255,66,51708,64,276797
30398,0.000313,74.125.200.0-255,4320,56028,64,276797
30399,0.000316,172.31.40.0-255,66,56094,64,276797
30400,0.000343,74.125.200.0-255,1484,57578,64,276797
30401,0.000345,172.31.40.0-255,66,57644,64,276797
30402,0.000353,74.125.200.0-255,7156,64800,64,276797
30403,0.000356,172.31.40.0-255,66,64866,64,276797
30404,0.000359,74.125.200.0-255,1125,65991,64,276797
30405,0.000361,172.31.40.0-255,66,66057,64,276797
30406,0.000388,74.125.200.0-255,397,66454,64,276797
30407,0.000391,172.31.40.0-255,66,66520,64,276797
30408,0.000441,74.125.200.0-255,1484,68004,64,276797
30409,0.000445,172.31.40.0-255,66,68070,64,276797
30410,0.000449,74.125.200.0-255,1484,69554,64,276797
30411,0.000451,172.31.40.0-255,66,69620,64,276797
30412,0.000485,74.125.200.0-255,2902,72522,64,276797
30413,0.000488,172.31.40.0-255,66,72588,64,276797
30414,0.000491,74.125.200.0-255,1484,74072,64,276797
30415,0.000493,172.31.40.0-255,66,74138,64,276797
30416,0.000515,74.125.200.0-255,4320,78458,64,276797
30417,0.000518,172.31.40.0-255,66,78524,64,276797
30418,0.000521,74.125.200.0-255,1484,80008,64,276797
30419,0.000523,172.31.40.0-255,66,80074,64,276797
30420,0.000528,74.125.200.0-255,2902,82976,64,276797
30421,0.000531,172.31.40.0-255,66,83042,64,276797
30422,0.000558,74.125.200.0-255,5738,88780,64,276797
30423,0.000561,172.31.40.0-255,66,88846,64,276797
30424,0.000584,74.125.200.0-255,1484,90330,64,276797
30425,0.000587,172.31.40.0-255,66,90396,64,276797
30426,0.000591,74.125.200.0-255,2902,93298,64,276797
30427,0.000594,172.31.40.0-255,66,93364,64,276797
30428,0.000597,74.125.200.0-255,1484,94848,64,276797
30429,0.000599,172.31.40.0-255,66,94914,64,276797
30430,0.000622,74.125.200.0-255,4320,99234,64,276797
30431,0.000625,172.31.40.0-255,66,99300,64,276797
30432,0.000662,74.125.200.0-255,2184,101484,64,276797
30433,0.000665,172.31.40.0-255,66,101550,64,276797
30434,0.002594,74.125.200.0-255,2902,104452,64,276797
30435,0.002602,172.31.40.0-255,66,104518,64,276797
30436,0.002633,74.125.200.0-255,2902,107420,64,276797
30437,0.002636,172.31.40.0-255,66,107486,64,276797
30438,0.004601,74.125.200.0-255,2902,110388,64,276797
30439,0.004606,172.31.40.0-255,66,110454,64,276797
30440,0.004632,74.125.200.0-255,2902,113356,64,276797
30441,0.004634,172.31.40.0-255,66,113422,64,276797
30442,0.006603,74.125.200.0-255,2902,116324,64,276797
30443,0.00661,172.31.40.0-255,66,116390,64,276797
30444,0.006642,74.125.200.0-255,2902,119292,64,276797
30445,0.006645,172.31.40.0-255,66,119358,64,276797
30446,0.008601,74.125.200.0-255,2902,122260,64,276797
30447,0.008609,172.31.40.0-255,66,122326,64,276797
30448,0.008636,74.125.200.0-255,2902,125228,64,276797
30449,0.008639,172.31.40.0-255,66,125294,64,276797
30450,0.010579,74.125.200.0-255,2902,128196,64,276797
30451,0.010587,172.31.40.0-255,66,128262,64,276797
30452,0.010619,74.125.200.0-255,2902,131164,64,276797
30453,0.010622,172.31.40.0-255,66,131230,64,276797
30454,0.012602,74.125.200.0-255,5738,136968,64,276797
30455,0.01262,172.31.40.0-255,66,137034,64,276797
30456,0.014612,74.125.200.0-255,5738,142772,64,276797
30457,0.014621,172.31.40.0-255,66,142838,64,276797
30458,0.016629,74.125.200.0-255,1484,144322,64,276797
30459,0.016657,74.125.200.0-255,4320,148642,64,276797
30460,0.016665,172.31.40.0-255,66,148708,64,276797
30461,0.018641,74.125.200.0-255,5738,154446,64,276797
30462,0.018648,172.31.40.0-255,66,154512,64,276797
30463,0.020662,74.125.200.0-255,2902,157414,64,276797
30464,0.020671,172.31.40.0-255,66,157480,64,276797
30465,0.020701,74.125.200.0-255,2902,160382,64,276797
30466,0.020705,172.31.40.0-255,66,160448,64,276797
30467,0.022644,74.125.200.0-255,2902,163350,64,276797
30468,0.022651,172.31.40.0-255,66,163416,64,276797
30469,0.022682,74.125.200.0-255,2902,166318,64,276797
30470,0.022685,172.31.40.0-255,66,166384,64,276797
30471,0.024633,74.125.200.0-255,2902,169286,64,276797
30472,0.024641,172.31.40.0-255,66,169352,64,276797
30473,0.024672,74.125.200.0-255,2902,172254,64,276797
30474,0.024675,172.31.40.0-255,66,172320,64,276797
30475,0.026616,74.125.200.0-255,2902,175222,64,276797
30476,0.026624,172.31.40.0-255,66,175288,64,276797
30477,0.026655,74.125.200.0-255,2902,178190,64,276797
30478,0.026658,172.31.40.0-255,66,178256,64,276797
30479,0.028603,74.125.200.0-255,2902,181158,64,276797
30480,0.028611,172.31.40.0-255,66,181224,64,276797
30481,0.028641,74.125.200.0-255,2902,184126,64,276797
30482,0.028644,172.31.40.0-255,66,184192,64,276797
30483,0.030599,74.125.200.0-255,2902,187094,64,276797
30484,0.030607,172.31.40.0-255,66,187160,64,276797
30485,0.030637,74.125.200.0-255,2902,190062,64,276797
30486,0.030642,172.31.40.0-255,66,190128,64,276797
30487,0.031024,172.31.40.0-255,171,190299,64,276797
30488,0.031059,172.31.40.0-255,1137,191436,64,276797
30489,0.031179,172.31.40.0-255,1514,192950,64,276797
30490,0.031181,172.31.40.0-255,1271,194221,64,276797
30491,0.032566,104.244.42.0-255,66,194287,64,276797
30492,0.032578,74.125.200.0-255,2902,197189,64,276797
30493,0.032583,172.31.40.0-255,66,197255,64,276797
30494,0.032611,74.125.200.0-255,1484,198739,64,276797
30495,0.032625,74.125.200.0-255,1484,200223,64,276797
30496,0.032628,172.31.40.0-255,66,200289,64,276797
30497,0.032656,104.244.42.0-255,66,200355,64,276797
30498,0.032746,104.244.42.0-255,66,200421,64,276797
30499,0.034558,74.125.200.0-255,2902,203323,64,276797
30500,0.034565,172.31.40.0-255,66,203389,64,276797
30501,0.034599,74.125.200.0-255,2902,206291,64,276797
30502,0.034602,172.31.40.0-255,66,206357,64,276797
30503,0.036544,74.125.200.0-255,2902,209259,64,276797
30504,0.036551,172.31.40.0-255,66,209325,64,276797
30505,0.036581,74.125.200.0-255,2902,212227,64,276797
30506,0.036584,172.31.40.0-255,66,212293,64,276797
30507,0.038523,74.125.200.0-255,2902,215195,64,276797
30508,0.03853,172.31.40.0-255,66,215261,64,276797
30509,0.038562,74.125.200.0-255,2902,218163,64,276797
30510,0.038565,172.31.40.0-255,66,218229,64,276797
30511,0.040517,74.125.200.0-255,2902,221131,64,276797
30512,0.040527,172.31.40.0-255,66,221197,64,276797
30513,0.040562,74.125.200.0-255,2902,224099,64,276797
30514,0.040565,172.31.40.0-255,66,224165,64,276797
30515,0.042509,74.125.200.0-255,2902,227067,64,276797
30516,0.042516,172.31.40.0-255,66,227133,64,276797
30517,0.042551,74.125.200.0-255,2902,230035,64,276797
30518,0.042554,172.31.40.0-255,66,230101,64,276797
30519,0.044559,74.125.200.0-255,2902,233003,64,276797
30520,0.044566,172.31.40.0-255,66,233069,64,276797
30521,0.044593,74.125.200.0-255,2902,235971,64,276797
30522,0.044596,172.31.40.0-255,66,236037,64,276797
30523,0.046542,74.125.200.0-255,2902,238939,64,276797
30524,0.04655,172.31.40.0-255,66,239005,64,276797
30525,0.046576,74.125.200.0-255,2902,241907,64,276797
30526,0.046579,172.31.40.0-255,66,241973,64,276797
30527,0.048546,74.125.200.0-255,5738,247711,64,276797
30528,0.048557,172.31.40.0-255,66,247777,64,276797
30529,0.05059,74.125.200.0-255,5738,253515,64,276797
30530,0.050604,172.31.40.0-255,66,253581,64,276797
30531,0.052605,74.125.200.0-255,5738,259319,64,276797
30532,0.052619,172.31.40.0-255,66,259385,64,276797
30533,0.054616,74.125.200.0-255,5738,265123,64,276797
30534,0.054631,172.31.40.0-255,66,265189,64,276797
30535,0.056631,74.125.200.0-255,5738,270927,64,276797
30536,0.056646,172.31.40.0-255,66,270993,64,276797
30537,0.05862,74.125.200.0-255,5738,276731,64,276797
30538,0.058635,172.31.40.0-255,66,276797,64,276797
30539,0.0,172.217.194.0-255,152,152,64,180647
30540,1.6e-05,172.31.40.0-255,66,218,64,180647
30541,3.5e-05,172.217.194.0-255,1484,1702,64,180647
30542,3.9e-05,172.31.40.0-255,66,1768,64,180647
30543,5.6e-05,172.217.194.0-255,2902,4670,64,180647
30544,6e-05,172.31.40.0-255,66,4736,64,180647
30545,8.5e-05,172.217.194.0-255,5738,10474,64,180647
30546,8.8e-05,172.31.40.0-255,66,10540,64,180647
30547,0.000109,172.217.194.0-255,2902,13442,64,180647
30548,0.000112,172.31.40.0-255,66,13508,64,180647
30549,0.000144,172.31.40.0-255,66,13574,64,180647
30550,0.000163,172.217.194.0-255,5738,19312,64,180647
30551,0.000166,172.31.40.0-255,66,19378,64,180647
30552,0.000187,172.217.194.0-255,2543,21921,64,180647
30553,0.000189,172.31.40.0-255,66,21987,64,180647
30554,0.000253,172.217.194.0-255,1484,23471,64,180647
30555,0.000257,172.31.40.0-255,66,23537,64,180647
30556,0.000273,172.217.194.0-255,2902,26439,64,180647
30557,0.000275,172.31.40.0-255,66,26505,64,180647
30558,0.000297,172.217.194.0-255,1484,27989,64,180647
30559,0.000299,172.31.40.0-255,66,28055,64,180647
30560,0.000321,172.217.194.0-255,4320,32375,64,180647
30561,0.000324,172.31.40.0-255,66,32441,64,180647
30562,0.000328,172.217.194.0-255,2902,35343,64,180647
30563,0.00033,172.31.40.0-255,66,35409,64,180647
30564,0.000362,172.217.194.0-255,5738,41147,64,180647
30565,0.000364,172.31.40.0-255,66,41213,64,180647
30566,0.000385,172.217.194.0-255,5379,46592,64,180647
30567,0.000388,172.31.40.0-255,66,46658,64,180647
30568,0.000394,172.217.194.0-255,5738,52396,64,180647
30569,0.000396,172.31.40.0-255,66,52462,64,180647
30570,0.000432,172.217.194.0-255,4253,56715,64,180647
30571,0.000448,172.217.194.0-255,99,56814,64,180647
30572,0.000606,172.217.194.0-255,361,57175,64,180647
30573,0.000688,172.217.194.0-255,1484,58659,64,180647
30574,0.000691,172.217.194.0-255,1484,60143,64,180647
30575,0.000704,172.217.194.0-255,1484,61627,64,180647
30576,0.000711,172.217.194.0-255,5738,67365,64,180647
30577,0.00073,172.217.194.0-255,5738,73103,64,180647
30578,0.000754,172.217.194.0-255,576,73679,64,180647
30579,0.001049,172.217.194.0-255,1484,75163,64,180647
30580,0.001061,172.217.194.0-255,2902,78065,64,180647
30581,0.001075,172.217.194.0-255,4320,82385,64,180647
30582,0.001088,172.217.194.0-255,1484,83869,64,180647
30583,0.001102,172.217.194.0-255,4320,88189,64,180647
30584,0.001128,172.217.194.0-255,5738,93927,64,180647
30585,0.001159,172.217.194.0-255,5020,98947,64,180647
30586,0.001604,172.217.194.0-255,1484,100431,64,180647
30587,0.001618,172.217.194.0-255,2902,103333,64,180647
30588,0.001639,172.217.194.0-255,5738,109071,64,180647
30589,0.001651,172.217.194.0-255,2902,111973,64,180647
30590,0.001666,172.217.194.0-255,5738,117711,64,180647
30591,0.001679,172.217.194.0-255,4320,122031,64,180647
30592,0.002135,172.31.40.0-255,66,122097,64,180647
30593,0.002846,172.217.194.0-255,1484,123581,64,180647
30594,0.002855,172.217.194.0-255,2902,126483,64,180647
30595,0.00288,172.31.40.0-255,66,126549,64,180647
30596,0.002888,172.217.194.0-255,5738,132287,64,180647
30597,0.002904,172.31.40.0-255,66,132353,64,180647
30598,0.002943,172.31.40.0-255,66,132419,64,180647
30599,0.00311,172.217.194.0-255,1484,133903,64,180647
30600,0.003115,172.217.194.0-255,2902,136805,64,180647
30601,0.003125,172.31.40.0-255,66,136871,64,180647
30602,0.003137,172.217.194.0-255,5738,142609,64,180647
30603,0.003142,172.31.40.0-255,66,142675,64,180647
30604,0.003149,172.217.194.0-255,1484,144159,64,180647
30605,0.003199,172.31.40.0-255,66,144225,64,180647
30606,0.003217,172.217.194.0-255,1484,145709,64,180647
30607,0.003258,172.31.40.0-255,66,145775,64,180647
30608,0.003277,172.217.194.0-255,7156,152931,64,180647
30609,0.003334,172.217.194.0-255,5738,158669,64,180647
30610,0.003338,172.31.40.0-255,66,158735,64,180647
30611,0.003343,172.31.40.0-255,66,158801,64,180647
30612,0.003392,172.31.40.0-255,66,158867,64,180647
30613,0.003417,172.217.194.0-255,5738,164605,64,180647
30614,0.003464,172.217.194.0-255,2902,167507,64,180647
30615,0.003485,172.31.40.0-255,66,167573,64,180647
30616,0.003546,172.31.40.0-255,66,167639,64,180647
30617,0.003592,172.217.194.0-255,5259,172898,64,180647
30618,0.003601,172.31.40.0-255,66,172964,64,180647
30619,0.003636,172.217.194.0-255,105,173069,64,180647
30620,0.006175,172.31.40.0-255,66,173135,64,180647
30621,0.006211,172.31.40.0-255,105,173240,64,180647
30622,0.008513,172.217.194.0-255,66,173306,64,180647
30623,0.037472,172.31.40.0-255,172,173478,64,180647
30624,0.037507,172.31.40.0-255,1111,174589,64,180647
30625,0.037572,172.31.40.0-255,1514,176103,64,180647
30626,0.037574,172.31.40.0-255,1514,177617,64,180647
30627,0.037578,172.31.40.0-255,1514,179131,64,180647
30628,0.037579,172.31.40.0-255,1078,180209,64,180647
30629,0.039031,104.244.42.0-255,66,180275,64,180647
30630,0.039079,104.244.42.0-255,66,180341,64,180647
30631,0.03914,104.244.42.0-255,66,180407,64,180647
30632,0.039145,104.244.42.0-255,66,180473,64,180647
30633,0.039776,104.244.42.0-255,108,180581,64,180647
30634,0.039781,172.31.40.0-255,66,180647,64,180647
30635,0.0,74.125.24.0-255,146,146,64,214346
30636,2.2e-05,172.31.40.0-255,66,212,64,214346
30637,2.8e-05,74.125.24.0-255,1484,1696,64,214346
30638,3.4e-05,172.31.40.0-255,66,1762,64,214346
30639,4e-05,74.125.24.0-255,2902,4664,64,214346
30640,5.1e-05,172.31.40.0-255,66,4730,64,214346
30641,5.7e-05,74.125.24.0-255,4320,9050,64,214346
30642,6.1e-05,172.31.40.0-255,66,9116,64,214346
30643,6.7e-05,74.125.24.0-255,4799,13915,64,214346
30644,6.9e-05,172.31.40.0-255,66,13981,64,214346
30645,0.000106,74.125.24.0-255,1484,15465,64,214346
30646,0.000109,172.31.40.0-255,66,15531,64,214346
30647,0.000115,74.125.24.0-255,2902,18433,64,214346
30648,0.000117,172.31.40.0-255,66,18499,64,214346
30649,0.000129,74.125.24.0-255,5738,24237,64,214346
30650,0.000132,172.31.40.0-255,66,24303,64,214346
30651,0.000135,74.125.24.0-255,2902,27205,64,214346
30652,0.000137,172.31.40.0-255,66,27271,64,214346
30653,0.00017,74.125.24.0-255,3961,31232,64,214346
30654,0.000173,172.31.40.0-255,66,31298,64,214346
30655,0.000266,74.125.24.0-255,1484,32782,64,214346
30656,0.00027,172.31.40.0-255,66,32848,64,214346
30657,0.000276,74.125.24.0-255,2902,35750,64,214346
30658,0.000279,172.31.40.0-255,66,35816,64,214346
30659,0.000283,74.125.24.0-255,2902,38718,64,214346
30660,0.000291,172.31.40.0-255,66,38784,64,214346
30661,0.000294,74.125.24.0-255,1484,40268,64,214346
30662,0.000296,172.31.40.0-255,66,40334,64,214346
30663,0.000325,74.125.24.0-255,2902,43236,64,214346
30664,0.000328,172.31.40.0-255,66,43302,64,214346
30665,0.000343,172.31.40.0-255,66,43368,64,214346
30666,0.000346,74.125.24.0-255,1484,44852,64,214346
30667,0.000384,74.125.24.0-255,7156,52008,64,214346
30668,0.000386,172.31.40.0-255,66,52074,64,214346
30669,0.000425,74.125.24.0-255,4238,56312,64,214346
30670,0.000428,172.31.40.0-255,66,56378,64,214346
30671,0.000453,74.125.24.0-255,380,56758,64,214346
30672,0.000602,74.125.24.0-255,1484,58242,64,214346
30673,0.000607,172.31.40.0-255,66,58308,64,214346
30674,0.000621,74.125.24.0-255,2902,61210,64,214346
30675,0.000628,172.31.40.0-255,66,61276,64,214346
30676,0.000635,74.125.24.0-255,5738,67014,64,214346
30677,0.000637,172.31.40.0-255,66,67080,64,214346
30678,0.000677,172.31.40.0-255,66,67146,64,214346
30679,0.000685,74.125.24.0-255,7156,74302,64,214346
30680,0.000687,172.31.40.0-255,66,74368,64,214346
30681,0.000718,74.125.24.0-255,2543,76911,64,214346
30682,0.000721,172.31.40.0-255,66,76977,64,214346
30683,0.000844,74.125.24.0-255,1484,78461,64,214346
30684,0.000865,74.125.24.0-255,2902,81363,64,214346
30685,0.000868,172.31.40.0-255,66,81429,64,214346
30686,0.000874,74.125.24.0-255,2902,84331,64,214346
30687,0.000876,172.31.40.0-255,66,84397,64,214346
30688,0.000881,74.125.24.0-255,4320,88717,64,214346
30689,0.000888,172.31.40.0-255,66,88783,64,214346
30690,0.000893,74.125.24.0-255,4320,93103,64,214346
30691,0.000895,172.31.40.0-255,66,93169,64,214346
30692,0.000923,74.125.24.0-255,4320,97489,64,214346
30693,0.000925,172.31.40.0-255,66,97555,64,214346
30694,0.000945,172.31.40.0-255,66,97621,64,214346
30695,0.000994,74.125.24.0-255,1484,99105,64,214346
30696,0.001,74.125.24.0-255,2902,102007,64,214346
30697,0.001002,172.31.40.0-255,66,102073,64,214346
30698,0.001032,74.125.24.0-255,5738,107811,64,214346
30699,0.001036,172.31.40.0-255,66,107877,64,214346
30700,0.001042,74.125.24.0-255,5738,113615,64,214346
30701,0.001044,172.31.40.0-255,66,113681,64,214346
30702,0.001091,172.31.40.0-255,66,113747,64,214346
30703,0.001122,74.125.24.0-255,4320,118067,64,214346
30704,0.001124,172.31.40.0-255,66,118133,64,214346
30705,0.00113,74.125.24.0-255,5020,123153,64,214346
30706,0.001133,172.31.40.0-255,66,123219,64,214346
30707,0.001209,74.125.24.0-255,1484,124703,64,214346
30708,0.001215,74.125.24.0-255,2902,127605,64,214346
30709,0.001218,172.31.40.0-255,66,127671,64,214346
30710,0.001251,74.125.24.0-255,5738,133409,64,214346
30711,0.001254,172.31.40.0-255,66,133475,64,214346
30712,0.001273,172.31.40.0-255,66,133541,64,214346
30713,0.001308,74.125.24.0-255,1484,135025,64,214346
30714,0.001322,172.31.40.0-255,66,135091,64,214346
30715,0.001346,74.125.24.0-255,1484,136575,64,214346
30716,0.001351,74.125.24.0-255,2902,139477,64,214346
30717,0.001353,172.31.40.0-255,66,139543,64,214346
30718,0.001359,74.125.24.0-255,4320,143863,64,214346
30719,0.001362,172.31.40.0-255,66,143929,64,214346
30720,0.001395,74.125.24.0-255,1484,145413,64,214346
30721,0.001403,74.125.24.0-255,7156,152569,64,214346
30722,0.001406,172.31.40.0-255,66,152635,64,214346
30723,0.001409,74.125.24.0-255,1484,154119,64,214346
30724,0.00145,172.31.40.0-255,66,154185,64,214346
30725,0.001454,74.125.24.0-255,2184,156369,64,214346
30726,0.001456,172.31.40.0-255,66,156435,64,214346
30727,0.001645,74.125.24.0-255,1484,157919,64,214346
30728,0.001651,74.125.24.0-255,2902,160821,64,214346
30729,0.001655,172.31.40.0-255,66,160887,64,214346
30730,0.001688,74.125.24.0-255,5738,166625,64,214346
30731,0.001692,172.31.40.0-255,66,166691,64,214346
30732,0.001718,172.31.40.0-255,66,166757,64,214346
30733,0.001748,74.125.24.0-255,4320,171077,64,214346
30734,0.001751,172.31.40.0-255,66,171143,64,214346
30735,0.001784,172.31.40.0-255,66,171209,64,214346
30736,0.001843,74.125.24.0-255,1484,172693,64,214346
30737,0.001857,74.125.24.0-255,2902,175595,64,214346
30738,0.00186,172.31.40.0-255,66,175661,64,214346
30739,0.001892,74.125.24.0-255,5738,181399,64,214346
30740,0.001896,172.31.40.0-255,66,181465,64,214346
30741,0.001907,172.31.40.0-255,66,181531,64,214346
30742,0.001933,74.125.24.0-255,1484,183015,64,214346
30743,0.001966,172.31.40.0-255,66,183081,64,214346
30744,0.001988,74.125.24.0-255,5738,188819,64,214346
30745,0.001991,172.31.40.0-255,66,188885,64,214346
30746,0.002015,74.125.24.0-255,2902,191787,64,214346
30747,0.002018,172.31.40.0-255,66,191853,64,214346
30748,0.002034,172.31.40.0-255,66,191919,64,214346
30749,0.002038,74.125.24.0-255,2902,194821,64,214346
30750,0.002041,172.31.40.0-255,66,194887,64,214346
30751,0.002073,74.125.24.0-255,7156,202043,64,214346
30752,0.002075,172.31.40.0-255,66,202109,64,214346
30753,0.002091,172.31.40.0-255,66,202175,64,214346
30754,0.002128,74.125.24.0-255,1484,203659,64,214346
30755,0.002178,172.31.40.0-255,66,203725,64,214346
30756,0.002204,172.31.40.0-255,66,203791,64,214346
30757,0.002215,172.31.40.0-255,66,203857,64,214346
30758,0.002232,172.31.40.0-255,66,203923,64,214346
30759,0.002256,74.125.24.0-255,4748,208671,64,214346
30760,0.002262,172.31.40.0-255,66,208737,64,214346
30761,0.002265,74.125.24.0-255,105,208842,64,214346
30762,0.004529,172.31.40.0-255,66,208908,64,214346
30763,0.004566,172.31.40.0-255,105,209013,64,214346
30764,0.006804,74.125.24.0-255,66,209079,64,214346
30765,0.044823,172.31.40.0-255,167,209246,64,214346
30766,0.044861,172.31.40.0-255,1111,210357,64,214346
30767,0.04492,172.31.40.0-255,1514,211871,64,214346
30768,0.04494,172.31.40.0-255,1514,213385,64,214346
30769,0.044943,172.31.40.0-255,697,214082,64,214346
30770,0.046347,104.244.42.0-255,66,214148,64,214346
30771,0.04636,104.244.42.0-255,66,214214,64,214346
30772,0.04648,104.244.42.0-255,66,214280,64,214346
30773,0.046484,104.244.42.0-255,66,214346,64,214346
30774,0.0,74.125.200.0-255,150,150,64,321029
30775,1.5e-05,172.31.40.0-255,66,216,64,321029
30776,2.2e-05,74.125.200.0-255,1484,1700,64,321029
30777,2.7e-05,172.31.40.0-255,66,1766,64,321029
30778,3.3e-05,74.125.200.0-255,2902,4668,64,321029
30779,3.7e-05,172.31.40.0-255,66,4734,64,321029
30780,6e-05,74.125.200.0-255,4320,9054,64,321029
30781,6.3e-05,172.31.40.0-255,66,9120,64,321029
30782,6.6e-05,74.125.200.0-255,1484,10604,64,321029
30783,6.9e-05,172.31.40.0-255,66,10670,64,321029
30784,8.5e-05,74.125.200.0-255,3456,14126,64,321029
30785,8.8e-05,172.31.40.0-255,66,14192,64,321029
30786,0.000492,74.125.200.0-255,1484,15676,64,321029
30787,0.000498,172.31.40.0-255,66,15742,64,321029
30788,0.000507,74.125.200.0-255,2902,18644,64,321029
30789,0.000509,172.31.40.0-255,66,18710,64,321029
30790,0.000515,74.125.200.0-255,4320,23030,64,321029
30791,0.000518,172.31.40.0-255,66,23096,64,321029
30792,0.000543,74.125.200.0-255,1484,24580,64,321029
30793,0.000545,172.31.40.0-255,66,24646,64,321029
30794,0.000575,172.31.40.0-255,66,24712,64,321029
30795,0.000607,74.125.200.0-255,7156,31868,64,321029
30796,0.000611,172.31.40.0-255,66,31934,64,321029
30797,0.000625,74.125.200.0-255,2902,34836,64,321029
30798,0.000628,172.31.40.0-255,66,34902,64,321029
30799,0.000632,74.125.200.0-255,1484,36386,64,321029
30800,0.000634,172.31.40.0-255,66,36452,64,321029
30801,0.000638,74.125.200.0-255,2902,39354,64,321029
30802,0.00064,172.31.40.0-255,66,39420,64,321029
30803,0.000657,74.125.200.0-255,1484,40904,64,321029
30804,0.00066,172.31.40.0-255,66,40970,64,321029
30805,0.000684,74.125.200.0-255,4320,45290,64,321029
30806,0.000688,172.31.40.0-255,66,45356,64,321029
30807,0.000694,74.125.200.0-255,5738,51094,64,321029
30808,0.000696,172.31.40.0-255,66,51160,64,321029
30809,0.000723,74.125.200.0-255,6438,57598,64,321029
30810,0.000727,172.31.40.0-255,66,57664,64,321029
30811,0.000902,74.125.200.0-255,400,58064,64,321029
30812,0.001011,74.125.200.0-255,1484,59548,64,321029
30813,0.001016,172.31.40.0-255,66,59614,64,321029
30814,0.001039,74.125.200.0-255,2902,62516,64,321029
30815,0.001041,172.31.40.0-255,66,62582,64,321029
30816,0.001048,74.125.200.0-255,5738,68320,64,321029
30817,0.001051,172.31.40.0-255,66,68386,64,321029
30818,0.001078,74.125.200.0-255,4320,72706,64,321029
30819,0.001081,172.31.40.0-255,66,72772,64,321029
30820,0.001107,74.125.200.0-255,7156,79928,64,321029
30821,0.00111,172.31.40.0-255,66,79994,64,321029
30822,0.001128,74.125.200.0-255,5738,85732,64,321029
30823,0.001132,172.31.40.0-255,66,85798,64,321029
30824,0.001156,74.125.200.0-255,6438,92236,64,321029
30825,0.001159,172.31.40.0-255,66,92302,64,321029
30826,0.001195,74.125.200.0-255,5738,98040,64,321029
30827,0.001198,172.31.40.0-255,66,98106,64,321029
30828,0.001219,74.125.200.0-255,5738,103844,64,321029
30829,0.001222,172.31.40.0-255,66,103910,64,321029
30830,0.001241,74.125.200.0-255,1484,105394,64,321029
30831,0.001256,74.125.200.0-255,3658,109052,64,321029
30832,0.001259,172.31.40.0-255,66,109118,64,321029
30833,0.00165,74.125.200.0-255,1484,110602,64,321029
30834,0.001659,74.125.200.0-255,2902,113504,64,321029
30835,0.001664,172.31.40.0-255,66,113570,64,321029
30836,0.00169,74.125.200.0-255,5738,119308,64,321029
30837,0.001693,172.31.40.0-255,66,119374,64,321029
30838,0.0017,74.125.200.0-255,5738,125112,64,321029
30839,0.001703,172.31.40.0-255,66,125178,64,321029
30840,0.001726,74.125.200.0-255,2902,128080,64,321029
30841,0.001728,172.31.40.0-255,66,128146,64,321029
30842,0.00175,74.125.200.0-255,4320,132466,64,321029
30843,0.001753,172.31.40.0-255,66,132532,64,321029
30844,0.001785,74.125.200.0-255,2902,135434,64,321029
30845,0.001787,172.31.40.0-255,66,135500,64,321029
30846,0.00181,172.31.40.0-255,66,135566,64,321029
30847,0.00206,74.125.200.0-255,1484,137050,64,321029
30848,0.002073,74.125.200.0-255,2902,139952,64,321029
30849,0.002076,172.31.40.0-255,66,140018,64,321029
30850,0.002103,74.125.200.0-255,5738,145756,64,321029
30851,0.002106,172.31.40.0-255,66,145822,64,321029
30852,0.002124,74.125.200.0-255,2902,148724,64,321029
30853,0.002127,172.31.40.0-255,66,148790,64,321029
30854,0.002134,74.125.200.0-255,1484,150274,64,321029
30855,0.002152,74.125.200.0-255,2902,153176,64,321029
30856,0.002154,172.31.40.0-255,66,153242,64,321029
30857,0.002157,74.125.200.0-255,1484,154726,64,321029
30858,0.002177,74.125.200.0-255,5738,160464,64,321029
30859,0.00218,172.31.40.0-255,66,160530,64,321029
30860,0.002224,74.125.200.0-255,4320,164850,64,321029
30861,0.002227,172.31.40.0-255,66,164916,64,321029
30862,0.002232,74.125.200.0-255,2902,167818,64,321029
30863,0.002233,172.31.40.0-255,66,167884,64,321029
30864,0.002249,74.125.200.0-255,2184,170068,64,321029
30865,0.002251,172.31.40.0-255,66,170134,64,321029
30866,0.004493,74.125.200.0-255,2902,173036,64,321029
30867,0.004499,172.31.40.0-255,66,173102,64,321029
30868,0.004521,74.125.200.0-255,2902,176004,64,321029
30869,0.004524,172.31.40.0-255,66,176070,64,321029
30870,0.006756,74.125.200.0-255,2902,178972,64,321029
30871,0.006763,172.31.40.0-255,66,179038,64,321029
30872,0.006785,74.125.200.0-255,2902,181940,64,321029
30873,0.006787,172.31.40.0-255,66,182006,64,321029
30874,0.009034,74.125.200.0-255,2902,184908,64,321029
30875,0.009042,172.31.40.0-255,66,184974,64,321029
30876,0.009063,74.125.200.0-255,2902,187876,64,321029
30877,0.009065,172.31.40.0-255,66,187942,64,321029
30878,0.011307,74.125.200.0-255,2902,190844,64,321029
30879,0.011317,172.31.40.0-255,66,190910,64,321029
30880,0.011337,74.125.200.0-255,2902,193812,64,321029
30881,0.011339,172.31.40.0-255,66,193878,64,321029
30882,0.013602,74.125.200.0-255,5738,199616,64,321029
30883,0.013612,172.31.40.0-255,66,199682,64,321029
30884,0.015918,74.125.200.0-255,5738,205420,64,321029
30885,0.015925,172.31.40.0-255,66,205486,64,321029
30886,0.018197,74.125.200.0-255,5738,211224,64,321029
30887,0.018205,172.31.40.0-255,66,211290,64,321029
30888,0.020482,74.125.200.0-255,5738,217028,64,321029
30889,0.02049,172.31.40.0-255,66,217094,64,321029
30890,0.022772,74.125.200.0-255,5738,222832,64,321029
30891,0.022778,172.31.40.0-255,66,222898,64,321029
30892,0.023612,172.31.40.0-255,167,223065,64,321029
30893,0.023644,172.31.40.0-255,1112,224177,64,321029
30894,0.023702,172.31.40.0-255,1514,225691,64,321029
30895,0.023705,172.31.40.0-255,1514,227205,64,321029
30896,0.023729,172.31.40.0-255,696,227901,64,321029
30897,0.025059,74.125.200.0-255,5738,233639,64,321029
30898,0.025067,172.31.40.0-255,66,233705,64,321029
30899,0.025155,104.244.42.0-255,66,233771,64,321029
30900,0.025178,104.244.42.0-255,66,233837,64,321029
30901,0.025273,104.244.42.0-255,66,233903,64,321029
30902,0.025279,104.244.42.0-255,66,233969,64,321029
30903,0.027347,74.125.200.0-255,5738,239707,64,321029
30904,0.027353,172.31.40.0-255,66,239773,64,321029
30905,0.029673,74.125.200.0-255,5738,245511,64,321029
30906,0.029692,172.31.40.0-255,66,245577,64,321029
30907,0.031986,74.125.200.0-255,5738,251315,64,321029
30908,0.032003,172.31.40.0-255,66,251381,64,321029
30909,0.034283,74.125.200.0-255,5738,257119,64,321029
30910,0.034296,172.31.40.0-255,66,257185,64,321029
30911,0.036591,74.125.200.0-255,5738,262923,64,321029
30912,0.036608,172.31.40.0-255,66,262989,64,321029
30913,0.038898,74.125.200.0-255,5738,268727,64,321029
30914,0.038918,172.31.40.0-255,66,268793,64,321029
30915,0.041202,74.125.200.0-255,5738,274531,64,321029
30916,0.041218,172.31.40.0-255,66,274597,64,321029
30917,0.043535,74.125.200.0-255,5738,280335,64,321029
30918,0.043558,172.31.40.0-255,66,280401,64,321029
30919,0.045841,74.125.200.0-255,5738,286139,64,321029
30920,0.045857,172.31.40.0-255,66,286205,64,321029
30921,0.048155,74.125.200.0-255,5738,291943,64,321029
30922,0.048171,172.31.40.0-255,66,292009,64,321029
30923,0.050464,74.125.200.0-255,5738,297747,64,321029
30924,0.05048,172.31.40.0-255,66,297813,64,321029
30925,0.05277,74.125.200.0-255,5738,303551,64,321029
30926,0.052788,172.31.40.0-255,66,303617,64,321029
30927,0.055077,74.125.200.0-255,5738,309355,64,321029
30928,0.055097,172.31.40.0-255,66,309421,64,321029
30929,0.057394,74.125.200.0-255,5738,315159,64,321029
30930,0.057411,172.31.40.0-255,66,315225,64,321029
30931,0.059726,74.125.200.0-255,5738,320963,64,321029
30932,0.05974,172.31.40.0-255,66,321029,64,321029
30933,0.0,172.217.194.0-255,152,152,64,250203
30934,2.2e-05,172.31.40.0-255,66,218,64,250203
30935,3e-05,172.217.194.0-255,1484,1702,64,250203
30936,3.4e-05,172.31.40.0-255,66,1768,64,250203
30937,4e-05,172.217.194.0-255,2902,4670,64,250203
30938,5.1e-05,172.31.40.0-255,66,4736,64,250203
30939,5.6e-05,172.217.194.0-255,2902,7638,64,250203
30940,5.9e-05,172.31.40.0-255,66,7704,64,250203
30941,9.9e-05,172.217.194.0-255,6258,13962,64,250203
30942,0.000102,172.31.40.0-255,66,14028,64,250203
30943,0.000388,172.217.194.0-255,1484,15512,64,250203
30944,0.000394,172.31.40.0-255,66,15578,64,250203
30945,0.000401,172.217.194.0-255,2902,18480,64,250203
30946,0.000404,172.31.40.0-255,66,18546,64,250203
30947,0.000408,172.217.194.0-255,2902,21448,64,250203
30948,0.000416,172.31.40.0-255,66,21514,64,250203
30949,0.000434,172.217.194.0-255,2902,24416,64,250203
30950,0.000437,172.31.40.0-255,66,24482,64,250203
30951,0.000449,172.217.194.0-255,6797,31279,64,250203
30952,0.000452,172.31.40.0-255,66,31345,64,250203
30953,0.000497,172.31.40.0-255,66,31411,64,250203
30954,0.000502,172.217.194.0-255,2543,33954,64,250203
30955,0.000505,172.31.40.0-255,66,34020,64,250203
30956,0.000539,172.217.194.0-255,1484,35504,64,250203
30957,0.000542,172.31.40.0-255,66,35570,64,250203
30958,0.000547,172.217.194.0-255,2902,38472,64,250203
30959,0.000554,172.31.40.0-255,66,38538,64,250203
30960,0.00056,172.217.194.0-255,4320,42858,64,250203
30961,0.000562,172.31.40.0-255,66,42924,64,250203
30962,0.000591,172.217.194.0-255,1484,44408,64,250203
30963,0.000594,172.31.40.0-255,66,44474,64,250203
30964,0.000606,172.217.194.0-255,6797,51271,64,250203
30965,0.000633,172.31.40.0-255,66,51337,64,250203
30966,0.00097,172.217.194.0-255,646,51983,64,250203
30967,0.001074,172.217.194.0-255,1484,53467,64,250203
30968,0.001078,172.31.40.0-255,66,53533,64,250203
30969,0.001085,172.217.194.0-255,2902,56435,64,250203
30970,0.001087,172.31.40.0-255,66,56501,64,250203
30971,0.001092,172.217.194.0-255,2902,59403,64,250203
30972,0.001094,172.31.40.0-255,66,59469,64,250203
30973,0.001124,172.217.194.0-255,2902,62371,64,250203
30974,0.001127,172.31.40.0-255,66,62437,64,250203
30975,0.001134,172.217.194.0-255,6248,68685,64,250203
30976,0.001136,172.31.40.0-255,66,68751,64,250203
30977,0.001311,172.217.194.0-255,1484,70235,64,250203
30978,0.001316,172.217.194.0-255,1484,71719,64,250203
30979,0.001319,172.31.40.0-255,66,71785,64,250203
30980,0.001346,172.217.194.0-255,1484,73269,64,250203
30981,0.001353,172.217.194.0-255,5738,79007,64,250203
30982,0.001356,172.31.40.0-255,66,79073,64,250203
30983,0.001372,172.217.194.0-255,5738,84811,64,250203
30984,0.001374,172.31.40.0-255,66,84877,64,250203
30985,0.00141,172.217.194.0-255,7156,92033,64,250203
30986,0.001413,172.31.40.0-255,66,92099,64,250203
30987,0.001426,172.217.194.0-255,2184,94283,64,250203
30988,0.001431,172.31.40.0-255,66,94349,64,250203
30989,0.002059,172.217.194.0-255,1484,95833,64,250203
30990,0.00207,172.217.194.0-255,2902,98735,64,250203
30991,0.002074,172.31.40.0-255,66,98801,64,250203
30992,0.00208,172.217.194.0-255,1484,100285,64,250203
30993,0.002109,172.217.194.0-255,1484,101769,64,250203
30994,0.002111,172.31.40.0-255,66,101835,64,250203
30995,0.00212,172.217.194.0-255,7156,108991,64,250203
30996,0.002122,172.31.40.0-255,66,109057,64,250203
30997,0.002128,172.217.194.0-255,5738,114795,64,250203
30998,0.00213,172.31.40.0-255,66,114861,64,250203
30999,0.002174,172.31.40.0-255,66,114927,64,250203
31000,0.002179,172.217.194.0-255,3602,118529,64,250203
31001,0.002181,172.31.40.0-255,66,118595,64,250203
31002,0.004684,172.217.194.0-255,4320,122915,64,250203
31003,0.00469,172.31.40.0-255,66,122981,64,250203
31004,0.004711,172.217.194.0-255,1484,124465,64,250203
31005,0.007358,172.217.194.0-255,4320,128785,64,250203
31006,0.007363,172.31.40.0-255,66,128851,64,250203
31007,0.009896,172.217.194.0-255,5738,134589,64,250203
31008,0.009905,172.31.40.0-255,66,134655,64,250203
31009,0.012439,172.217.194.0-255,5738,140393,64,250203
31010,0.012447,172.31.40.0-255,66,140459,64,250203
31011,0.015017,172.217.194.0-255,5738,146197,64,250203
31012,0.015027,172.31.40.0-255,66,146263,64,250203
31013,0.017592,172.217.194.0-255,5738,152001,64,250203
31014,0.017601,172.31.40.0-255,66,152067,64,250203
31015,0.020123,172.217.194.0-255,5738,157805,64,250203
31016,0.02013,172.31.40.0-255,66,157871,64,250203
31017,0.022637,172.217.194.0-255,5738,163609,64,250203
31018,0.022644,172.31.40.0-255,66,163675,64,250203
31019,0.025161,172.217.194.0-255,5738,169413,64,250203
31020,0.02517,172.31.40.0-255,66,169479,64,250203
31021,0.027678,172.217.194.0-255,5738,175217,64,250203
31022,0.027684,172.31.40.0-255,66,175283,64,250203
31023,0.028527,172.31.40.0-255,172,175455,64,250203
31024,0.028558,172.31.40.0-255,1112,176567,64,250203
31025,0.028616,172.31.40.0-255,1514,178081,64,250203
31026,0.028618,172.31.40.0-255,1514,179595,64,250203
31027,0.028619,172.31.40.0-255,696,180291,64,250203
31028,0.030082,104.244.42.0-255,66,180357,64,250203
31029,0.030136,104.244.42.0-255,66,180423,64,250203
31030,0.030194,104.244.42.0-255,66,180489,64,250203
31031,0.0302,104.244.42.0-255,66,180555,64,250203
31032,0.030206,172.217.194.0-255,5738,186293,64,250203
31033,0.030211,172.31.40.0-255,66,186359,64,250203
31034,0.032767,172.217.194.0-255,5738,192097,64,250203
31035,0.032772,172.31.40.0-255,66,192163,64,250203
31036,0.035271,172.217.194.0-255,5738,197901,64,250203
31037,0.035276,172.31.40.0-255,66,197967,64,250203
31038,0.037836,172.217.194.0-255,5738,203705,64,250203
31039,0.037843,172.31.40.0-255,66,203771,64,250203
31040,0.040383,172.217.194.0-255,5738,209509,64,250203
31041,0.040389,172.31.40.0-255,66,209575,64,250203
31042,0.042936,172.217.194.0-255,5738,215313,64,250203
31043,0.042944,172.31.40.0-255,66,215379,64,250203
31044,0.04551,172.217.194.0-255,5738,221117,64,250203
31045,0.045516,172.31.40.0-255,66,221183,64,250203
31046,0.048035,172.217.194.0-255,5738,226921,64,250203
31047,0.048053,172.31.40.0-255,66,226987,64,250203
31048,0.050603,172.217.194.0-255,5738,232725,64,250203
31049,0.050617,172.31.40.0-255,66,232791,64,250203
31050,0.053184,172.217.194.0-255,5738,238529,64,250203
31051,0.053203,172.31.40.0-255,66,238595,64,250203
31052,0.055771,172.217.194.0-255,5738,244333,64,250203
31053,0.05579,172.31.40.0-255,66,244399,64,250203
31054,0.05832,172.217.194.0-255,5738,250137,64,250203
31055,0.058327,172.31.40.0-255,66,250203,64,250203
31056,0.0,172.217.194.0-255,290,290,64,262447
31057,2.1e-05,172.31.40.0-255,66,356,64,262447
31058,2.6e-05,172.217.194.0-255,1484,1840,64,262447
31059,3e-05,172.31.40.0-255,66,1906,64,262447
31060,3.7e-05,172.217.194.0-255,4320,6226,64,262447
31061,4e-05,172.31.40.0-255,66,6292,64,262447
31062,4.6e-05,172.217.194.0-255,5738,12030,64,262447
31063,4.8e-05,172.31.40.0-255,66,12096,64,262447
31064,5.9e-05,172.31.40.0-255,66,12162,64,262447
31065,9.1e-05,172.217.194.0-255,3249,15411,64,262447
31066,9.3e-05,172.31.40.0-255,66,15477,64,262447
31067,0.0001,172.217.194.0-255,6797,22274,64,262447
31068,0.000103,172.31.40.0-255,66,22340,64,262447
31069,0.000171,172.217.194.0-255,1484,23824,64,262447
31070,0.000174,172.31.40.0-255,66,23890,64,262447
31071,0.000178,172.217.194.0-255,2902,26792,64,262447
31072,0.000181,172.31.40.0-255,66,26858,64,262447
31073,0.000186,172.217.194.0-255,4320,31178,64,262447
31074,0.000187,172.31.40.0-255,66,31244,64,262447
31075,0.000205,172.217.194.0-255,1484,32728,64,262447
31076,0.000207,172.31.40.0-255,66,32794,64,262447
31077,0.000247,172.31.40.0-255,66,32860,64,262447
31078,0.000257,172.31.40.0-255,66,32926,64,262447
31079,0.000275,172.217.194.0-255,364,33290,64,262447
31080,0.000277,172.31.40.0-255,66,33356,64,262447
31081,0.000339,172.217.194.0-255,1484,34840,64,262447
31082,0.000342,172.31.40.0-255,66,34906,64,262447
31083,0.000346,172.217.194.0-255,2902,37808,64,262447
31084,0.000349,172.31.40.0-255,66,37874,64,262447
31085,0.000358,172.217.194.0-255,1484,39358,64,262447
31086,0.000374,172.217.194.0-255,4320,43678,64,262447
31087,0.00039,172.217.194.0-255,4320,47998,64,262447
31088,0.000406,172.217.194.0-255,2543,50541,64,262447
31089,0.000426,172.217.194.0-255,1484,52025,64,262447
31090,0.000428,172.217.194.0-255,1484,53509,64,262447
31091,0.000439,172.217.194.0-255,1484,54993,64,262447
31092,0.000444,172.217.194.0-255,4320,59313,64,262447
31093,0.00046,172.217.194.0-255,1484,60797,64,262447
31094,0.000474,172.217.194.0-255,4320,65117,64,262447
31095,0.000525,172.217.194.0-255,7156,72273,64,262447
31096,0.000539,172.217.194.0-255,2543,74816,64,262447
31097,0.00057,172.31.40.0-255,66,74882,64,262447
31098,0.00066,172.217.194.0-255,1484,76366,64,262447
31099,0.000665,172.217.194.0-255,2902,79268,64,262447
31100,0.000678,172.31.40.0-255,66,79334,64,262447
31101,0.000701,172.217.194.0-255,5738,85072,64,262447
31102,0.000707,172.217.194.0-255,4320,89392,64,262447
31103,0.00072,172.31.40.0-255,66,89458,64,262447
31104,0.00074,172.217.194.0-255,4320,93778,64,262447
31105,0.000761,172.217.194.0-255,6438,100216,64,262447
31106,0.000769,172.31.40.0-255,66,100282,64,262447
31107,0.000775,172.217.194.0-255,5738,106020,64,262447
31108,0.00078,172.31.40.0-255,66,106086,64,262447
31109,0.000795,172.217.194.0-255,5738,111824,64,262447
31110,0.000801,172.217.194.0-255,5379,117203,64,262447
31111,0.000819,172.31.40.0-255,66,117269,64,262447
31112,0.000836,172.217.194.0-255,1484,118753,64,262447
31113,0.000852,172.217.194.0-255,1484,120237,64,262447
31114,0.000861,172.31.40.0-255,66,120303,64,262447
31115,0.000868,172.217.194.0-255,1484,121787,64,262447
31116,0.000872,172.217.194.0-255,2902,124689,64,262447
31117,0.000877,172.31.40.0-255,66,124755,64,262447
31118,0.000884,172.217.194.0-255,2902,127657,64,262447
31119,0.000901,172.217.194.0-255,5738,133395,64,262447
31120,0.000915,172.217.194.0-255,5738,139133,64,262447
31121,0.000919,172.31.40.0-255,66,139199,64,262447
31122,0.000975,172.31.40.0-255,66,139265,64,262447
31123,0.001006,172.217.194.0-255,1484,140749,64,262447
31124,0.00101,172.217.194.0-255,1484,142233,64,262447
31125,0.001021,172.217.194.0-255,1484,143717,64,262447
31126,0.001027,172.217.194.0-255,4320,148037,64,262447
31127,0.001036,172.31.40.0-255,66,148103,64,262447
31128,0.001055,172.217.194.0-255,1484,149587,64,262447
31129,0.001074,172.217.194.0-255,6797,156384,64,262447
31130,0.001087,172.217.194.0-255,1484,157868,64,262447
31131,0.001106,172.217.194.0-255,1484,159352,64,262447
31132,0.001111,172.217.194.0-255,4320,163672,64,262447
31133,0.001115,172.217.194.0-255,4320,167992,64,262447
31134,0.00113,172.217.194.0-255,4320,172312,64,262447
31135,0.00115,172.217.194.0-255,5738,178050,64,262447
31136,0.001152,172.31.40.0-255,66,178116,64,262447
31137,0.001157,172.31.40.0-255,66,178182,64,262447
31138,0.00119,172.31.40.0-255,66,178248,64,262447
31139,0.00133,172.217.194.0-255,1484,179732,64,262447
31140,0.001336,172.217.194.0-255,1484,181216,64,262447
31141,0.001347,172.217.194.0-255,1484,182700,64,262447
31142,0.00136,172.31.40.0-255,66,182766,64,262447
31143,0.001365,172.217.194.0-255,5738,188504,64,262447
31144,0.00137,172.31.40.0-255,66,188570,64,262447
31145,0.001405,172.217.194.0-255,7156,195726,64,262447
31146,0.001414,172.31.40.0-255,66,195792,64,262447
31147,0.001425,172.217.194.0-255,3602,199394,64,262447
31148,0.001442,172.31.40.0-255,66,199460,64,262447
31149,0.001649,172.217.194.0-255,1484,200944,64,262447
31150,0.001654,172.217.194.0-255,1484,202428,64,262447
31151,0.00166,172.31.40.0-255,66,202494,64,262447
31152,0.001668,172.217.194.0-255,1484,203978,64,262447
31153,0.001673,172.217.194.0-255,4320,208298,64,262447
31154,0.001682,172.217.194.0-255,1484,209782,64,262447
31155,0.001712,172.31.40.0-255,66,209848,64,262447
31156,0.001752,172.217.194.0-255,766,210614,64,262447
31157,0.001763,172.31.40.0-255,66,210680,64,262447
31158,0.001775,172.217.194.0-255,1484,212164,64,262447
31159,0.001788,172.217.194.0-255,4320,216484,64,262447
31160,0.001793,172.31.40.0-255,66,216550,64,262447
31161,0.001827,172.31.40.0-255,66,216616,64,262447
31162,0.00183,172.217.194.0-255,1484,218100,64,262447
31163,0.001832,172.217.194.0-255,1484,219584,64,262447
31164,0.00185,172.217.194.0-255,2902,222486,64,262447
31165,0.001853,172.31.40.0-255,66,222552,64,262447
31166,0.00187,172.217.194.0-255,3602,226154,64,262447
31167,0.001876,172.31.40.0-255,66,226220,64,262447
31168,0.001893,172.217.194.0-255,4320,230540,64,262447
31169,0.001908,172.31.40.0-255,66,230606,64,262447
31170,0.001915,172.217.194.0-255,7156,237762,64,262447
31171,0.001919,172.31.40.0-255,66,237828,64,262447
31172,0.001927,172.217.194.0-255,1484,239312,64,262447
31173,0.001931,172.217.194.0-255,2902,242214,64,262447
31174,0.001942,172.31.40.0-255,66,242280,64,262447
31175,0.001963,172.31.40.0-255,66,242346,64,262447
31176,0.001969,172.217.194.0-255,5738,248084,64,262447
31177,0.001983,172.217.194.0-255,766,248850,64,262447
31178,0.00199,172.217.194.0-255,7156,256006,64,262447
31179,0.001997,172.31.40.0-255,66,256072,64,262447
31180,0.002044,172.31.40.0-255,66,256138,64,262447
31181,0.00205,172.217.194.0-255,1484,257622,64,262447
31182,0.002053,172.217.194.0-255,123,257745,64,262447
31183,0.002057,172.31.40.0-255,66,257811,64,262447
31184,0.002088,172.217.194.0-255,105,257916,64,262447
31185,0.004048,172.31.40.0-255,66,257982,64,262447
31186,0.004085,172.31.40.0-255,105,258087,64,262447
31187,0.006306,172.217.194.0-255,66,258153,64,262447
31188,0.047306,172.31.40.0-255,172,258325,64,262447
31189,0.04734,172.31.40.0-255,1112,259437,64,262447
31190,0.047396,172.31.40.0-255,1514,260951,64,262447
31191,0.047398,172.31.40.0-255,1298,262249,64,262447
31192,0.04884,104.244.42.0-255,66,262315,64,262447
31193,0.04888,104.244.42.0-255,66,262381,64,262447
31194,0.048908,104.244.42.0-255,66,262447,64,262447
31195,0.0,172.217.194.0-255,146,146,64,245638
31196,2.3e-05,172.31.40.0-255,66,212,64,245638
31197,3e-05,172.217.194.0-255,1484,1696,64,245638
31198,3.4e-05,172.31.40.0-255,66,1762,64,245638
31199,4e-05,172.217.194.0-255,2902,4664,64,245638
31200,4.4e-05,172.31.40.0-255,66,4730,64,245638
31201,5e-05,172.217.194.0-255,4320,9050,64,245638
31202,5.3e-05,172.31.40.0-255,66,9116,64,245638
31203,5.9e-05,172.217.194.0-255,4901,14017,64,245638
31204,6.2e-05,172.31.40.0-255,66,14083,64,245638
31205,0.000112,172.217.194.0-255,1484,15567,64,245638
31206,0.000114,172.31.40.0-255,66,15633,64,245638
31207,0.00012,172.217.194.0-255,2902,18535,64,245638
31208,0.000122,172.31.40.0-255,66,18601,64,245638
31209,0.000151,172.217.194.0-255,4320,22921,64,245638
31210,0.000154,172.31.40.0-255,66,22987,64,245638
31211,0.000161,172.217.194.0-255,5738,28725,64,245638
31212,0.000163,172.31.40.0-255,66,28791,64,245638
31213,0.000189,172.217.194.0-255,2543,31334,64,245638
31214,0.000191,172.31.40.0-255,66,31400,64,245638
31215,0.000269,172.217.194.0-255,1484,32884,64,245638
31216,0.000273,172.31.40.0-255,66,32950,64,245638
31217,0.000279,172.217.194.0-255,2902,35852,64,245638
31218,0.000281,172.31.40.0-255,66,35918,64,245638
31219,0.000288,172.217.194.0-255,5738,41656,64,245638
31220,0.00029,172.31.40.0-255,66,41722,64,245638
31221,0.000295,172.217.194.0-255,2902,44624,64,245638
31222,0.000297,172.31.40.0-255,66,44690,64,245638
31223,0.000321,172.217.194.0-255,2902,47592,64,245638
31224,0.000324,172.31.40.0-255,66,47658,64,245638
31225,0.000341,172.31.40.0-255,66,47724,64,245638
31226,0.000385,172.217.194.0-255,3961,51685,64,245638
31227,0.000388,172.31.40.0-255,66,51751,64,245638
31228,0.000391,172.217.194.0-255,395,52146,64,245638
31229,0.000438,172.217.194.0-255,379,52525,64,245638
31230,0.00063,172.217.194.0-255,1484,54009,64,245638
31231,0.000635,172.31.40.0-255,66,54075,64,245638
31232,0.000641,172.217.194.0-255,2902,56977,64,245638
31233,0.000644,172.31.40.0-255,66,57043,64,245638
31234,0.000664,172.217.194.0-255,5738,62781,64,245638
31235,0.000667,172.31.40.0-255,66,62847,64,245638
31236,0.000732,172.31.40.0-255,66,62913,64,245638
31237,0.000749,172.217.194.0-255,1484,64397,64,245638
31238,0.00076,172.31.40.0-255,66,64463,64,245638
31239,0.000765,172.217.194.0-255,2184,66647,64,245638
31240,0.000767,172.31.40.0-255,66,66713,64,245638
31241,0.001187,172.217.194.0-255,1484,68197,64,245638
31242,0.001194,172.217.194.0-255,2902,71099,64,245638
31243,0.001197,172.31.40.0-255,66,71165,64,245638
31244,0.001205,172.217.194.0-255,5738,76903,64,245638
31245,0.001207,172.31.40.0-255,66,76969,64,245638
31246,0.00121,172.217.194.0-255,1484,78453,64,245638
31247,0.00123,172.217.194.0-255,5738,84191,64,245638
31248,0.001233,172.31.40.0-255,66,84257,64,245638
31249,0.001276,172.31.40.0-255,66,84323,64,245638
31250,0.001291,172.217.194.0-255,1484,85807,64,245638
31251,0.00132,172.217.194.0-255,2184,87991,64,245638
31252,0.001323,172.31.40.0-255,66,88057,64,245638
31253,0.001654,172.217.194.0-255,1484,89541,64,245638
31254,0.001662,172.217.194.0-255,2902,92443,64,245638
31255,0.001665,172.31.40.0-255,66,92509,64,245638
31256,0.00167,172.217.194.0-255,2902,95411,64,245638
31257,0.001672,172.31.40.0-255,66,95477,64,245638
31258,0.001685,172.217.194.0-255,1484,96961,64,245638
31259,0.001705,172.217.194.0-255,5738,102699,64,245638
31260,0.001707,172.31.40.0-255,66,102765,64,245638
31261,0.001711,172.217.194.0-255,1484,104249,64,245638
31262,0.001744,172.31.40.0-255,66,104315,64,245638
31263,0.001781,172.217.194.0-255,3602,107917,64,245638
31264,0.001784,172.31.40.0-255,66,107983,64,245638
31265,0.001894,172.217.194.0-255,1484,109467,64,245638
31266,0.0019,172.217.194.0-255,2902,112369,64,245638
31267,0.001902,172.31.40.0-255,66,112435,64,245638
31268,0.001937,172.217.194.0-255,4320,116755,64,245638
31269,0.001941,172.31.40.0-255,66,116821,64,245638
31270,0.001947,172.217.194.0-255,5738,122559,64,245638
31271,0.001949,172.31.40.0-255,66,122625,64,245638
31272,0.001987,172.31.40.0-255,66,122691,64,245638
31273,0.002005,172.217.194.0-255,1484,124175,64,245638
31274,0.002024,172.217.194.0-255,6438,130613,64,245638
31275,0.002027,172.31.40.0-255,66,130679,64,245638
31276,0.002059,172.217.194.0-255,7156,137835,64,245638
31277,0.002062,172.31.40.0-255,66,137901,64,245638
31278,0.002081,172.217.194.0-255,4320,142221,64,245638
31279,0.002084,172.31.40.0-255,66,142287,64,245638
31280,0.002108,172.217.194.0-255,7156,149443,64,245638
31281,0.002111,172.31.40.0-255,66,149509,64,245638
31282,0.002129,172.217.194.0-255,5738,155247,64,245638
31283,0.002132,172.31.40.0-255,66,155313,64,245638
31284,0.002169,172.217.194.0-255,5738,161051,64,245638
31285,0.002172,172.31.40.0-255,66,161117,64,245638
31286,0.002192,172.217.194.0-255,3602,164719,64,245638
31287,0.002195,172.31.40.0-255,66,164785,64,245638
31288,0.002281,172.217.194.0-255,1484,166269,64,245638
31289,0.002298,172.217.194.0-255,2902,169171,64,245638
31290,0.002301,172.31.40.0-255,66,169237,64,245638
31291,0.002309,172.217.194.0-255,5738,174975,64,245638
31292,0.002311,172.31.40.0-255,66,175041,64,245638
31293,0.002341,172.217.194.0-255,5738,180779,64,245638
31294,0.002344,172.31.40.0-255,66,180845,64,245638
31295,0.002366,172.217.194.0-255,7156,188001,64,245638
31296,0.00237,172.31.40.0-255,66,188067,64,245638
31297,0.002386,172.217.194.0-255,1484,189551,64,245638
31298,0.002412,172.31.40.0-255,66,189617,64,245638
31299,0.002451,172.217.194.0-255,1484,191101,64,245638
31300,0.002454,172.217.194.0-255,1484,192585,64,245638
31301,0.002456,172.31.40.0-255,66,192651,64,245638
31302,0.002475,172.217.194.0-255,1484,194135,64,245638
31303,0.002481,172.217.194.0-255,5738,199873,64,245638
31304,0.002484,172.31.40.0-255,66,199939,64,245638
31305,0.002487,172.217.194.0-255,1484,201423,64,245638
31306,0.002509,172.217.194.0-255,4320,205743,64,245638
31307,0.002511,172.31.40.0-255,66,205809,64,245638
31308,0.002522,172.31.40.0-255,66,205875,64,245638
31309,0.002548,172.217.194.0-255,4320,210195,64,245638
31310,0.002551,172.31.40.0-255,66,210261,64,245638
31311,0.002602,172.31.40.0-255,66,210327,64,245638
31312,0.002616,172.217.194.0-255,766,211093,64,245638
31313,0.002628,172.217.194.0-255,2902,213995,64,245638
31314,0.002631,172.31.40.0-255,66,214061,64,245638
31315,0.002665,172.31.40.0-255,66,214127,64,245638
31316,0.002684,172.217.194.0-255,5738,219865,64,245638
31317,0.002686,172.31.40.0-255,66,219931,64,245638
31318,0.002706,172.217.194.0-255,3602,223533,64,245638
31319,0.002708,172.31.40.0-255,66,223599,64,245638
31320,0.002754,172.217.194.0-255,5738,229337,64,245638
31321,0.002757,172.31.40.0-255,66,229403,64,245638
31322,0.002773,172.217.194.0-255,2902,232305,64,245638
31323,0.002776,172.31.40.0-255,66,232371,64,245638
31324,0.002817,172.31.40.0-255,66,232437,64,245638
31325,0.002848,172.31.40.0-255,66,232503,64,245638
31326,0.002919,172.217.194.0-255,4320,236823,64,245638
31327,0.002922,172.31.40.0-255,66,236889,64,245638
31328,0.002964,172.31.40.0-255,66,236955,64,245638
31329,0.003048,172.217.194.0-255,1484,238439,64,245638
31330,0.003052,172.217.194.0-255,1484,239923,64,245638
31331,0.003055,172.31.40.0-255,66,239989,64,245638
31332,0.012943,172.217.194.0-255,1106,241095,64,245638
31333,0.012958,172.31.40.0-255,78,241173,64,245638
31334,0.015504,172.31.40.0-255,105,241278,64,245638
31335,0.017799,172.217.194.0-255,66,241344,64,245638
31336,0.04417,172.31.40.0-255,172,241516,64,245638
31337,0.044202,172.31.40.0-255,1112,242628,64,245638
31338,0.044264,172.31.40.0-255,1514,244142,64,245638
31339,0.044265,172.31.40.0-255,1298,245440,64,245638
31340,0.045687,104.244.42.0-255,66,245506,64,245638
31341,0.045722,104.244.42.0-255,66,245572,64,245638
31342,0.045814,104.244.42.0-255,66,245638,64,245638
31343,0.0,74.125.24.0-255,290,290,64,192510
31344,2.2e-05,172.31.40.0-255,66,356,64,192510
31345,2.8e-05,74.125.24.0-255,1484,1840,64,192510
31346,3.3e-05,172.31.40.0-255,66,1906,64,192510
31347,4e-05,74.125.24.0-255,4320,6226,64,192510
31348,4.3e-05,172.31.40.0-255,66,6292,64,192510
31349,5.6e-05,172.31.40.0-255,66,6358,64,192510
31350,6.2e-05,74.125.24.0-255,5738,12096,64,192510
31351,6.6e-05,172.31.40.0-255,66,12162,64,192510
31352,0.0001,172.31.40.0-255,66,12228,64,192510
31353,0.000131,74.125.24.0-255,1484,13712,64,192510
31354,0.000134,172.31.40.0-255,66,13778,64,192510
31355,0.000138,74.125.24.0-255,2902,16680,64,192510
31356,0.000141,172.31.40.0-255,66,16746,64,192510
31357,0.000167,74.125.24.0-255,5738,22484,64,192510
31358,0.000171,172.31.40.0-255,66,22550,64,192510
31359,0.000174,74.125.24.0-255,1484,24034,64,192510
31360,0.000176,172.31.40.0-255,66,24100,64,192510
31361,0.000205,172.31.40.0-255,66,24166,64,192510
31362,0.000217,172.31.40.0-255,66,24232,64,192510
31363,0.000261,74.125.24.0-255,133,24365,64,192510
31364,0.000264,172.31.40.0-255,66,24431,64,192510
31365,0.000267,74.125.24.0-255,343,24774,64,192510
31366,0.000269,172.31.40.0-255,66,24840,64,192510
31367,0.000483,74.125.24.0-255,1484,26324,64,192510
31368,0.000489,172.31.40.0-255,66,26390,64,192510
31369,0.000495,74.125.24.0-255,2902,29292,64,192510
31370,0.000498,172.31.40.0-255,66,29358,64,192510
31371,0.000504,74.125.24.0-255,5738,35096,64,192510
31372,0.00051,74.125.24.0-255,4320,39416,64,192510
31373,0.000528,74.125.24.0-255,4320,43736,64,192510
31374,0.000539,172.31.40.0-255,66,43802,64,192510
31375,0.000555,74.125.24.0-255,7156,50958,64,192510
31376,0.000561,74.125.24.0-255,4320,55278,64,192510
31377,0.000578,74.125.24.0-255,3602,58880,64,192510
31378,0.000586,172.31.40.0-255,66,58946,64,192510
31379,0.000937,74.125.24.0-255,1484,60430,64,192510
31380,0.000942,74.125.24.0-255,2902,63332,64,192510
31381,0.000948,172.31.40.0-255,66,63398,64,192510
31382,0.00096,74.125.24.0-255,5738,69136,64,192510
31383,0.00099,74.125.24.0-255,1484,70620,64,192510
31384,0.001012,74.125.24.0-255,4320,74940,64,192510
31385,0.001019,74.125.24.0-255,7156,82096,64,192510
31386,0.001037,172.31.40.0-255,66,82162,64,192510
31387,0.001291,74.125.24.0-255,1484,83646,64,192510
31388,0.001298,74.125.24.0-255,2902,86548,64,192510
31389,0.001301,172.31.40.0-255,66,86614,64,192510
31390,0.001306,74.125.24.0-255,2902,89516,64,192510
31391,0.001327,74.125.24.0-255,2902,92418,64,192510
31392,0.001333,74.125.24.0-255,7156,99574,64,192510
31393,0.001338,74.125.24.0-255,4320,103894,64,192510
31394,0.001362,172.31.40.0-255,66,103960,64,192510
31395,0.001376,74.125.24.0-255,2184,106144,64,192510
31396,0.001388,74.125.24.0-255,2902,109046,64,192510
31397,0.001393,172.31.40.0-255,66,109112,64,192510
31398,0.001407,74.125.24.0-255,7156,116268,64,192510
31399,0.001456,172.31.40.0-255,66,116334,64,192510
31400,0.001488,172.31.40.0-255,66,116400,64,192510
31401,0.001498,74.125.24.0-255,2184,118584,64,192510
31402,0.001518,172.31.40.0-255,66,118650,64,192510
31403,0.001533,74.125.24.0-255,2902,121552,64,192510
31404,0.001547,172.31.40.0-255,66,121618,64,192510
31405,0.001579,172.31.40.0-255,66,121684,64,192510
31406,0.001593,74.125.24.0-255,1484,123168,64,192510
31407,0.001598,74.125.24.0-255,2902,126070,64,192510
31408,0.001618,74.125.24.0-255,5738,131808,64,192510
31409,0.001623,74.125.24.0-255,5738,137546,64,192510
31410,0.001626,172.31.40.0-255,66,137612,64,192510
31411,0.001637,172.31.40.0-255,66,137678,64,192510
31412,0.001668,74.125.24.0-255,4320,141998,64,192510
31413,0.001679,172.31.40.0-255,66,142064,64,192510
31414,0.0017,74.125.24.0-255,766,142830,64,192510
31415,0.001722,74.125.24.0-255,1484,144314,64,192510
31416,0.001727,74.125.24.0-255,2902,147216,64,192510
31417,0.00174,74.125.24.0-255,2902,150118,64,192510
31418,0.001745,172.31.40.0-255,66,150184,64,192510
31419,0.001753,74.125.24.0-255,2902,153086,64,192510
31420,0.001758,172.31.40.0-255,66,153152,64,192510
31421,0.001793,74.125.24.0-255,4320,157472,64,192510
31422,0.001847,172.31.40.0-255,66,157538,64,192510
31423,0.001906,172.31.40.0-255,66,157604,64,192510
31424,0.001942,74.125.24.0-255,5738,163342,64,192510
31425,0.001949,74.125.24.0-255,4320,167662,64,192510
31426,0.001956,172.31.40.0-255,66,167728,64,192510
31427,0.001967,74.125.24.0-255,2902,170630,64,192510
31428,0.00197,74.125.24.0-255,1484,172114,64,192510
31429,0.002,74.125.24.0-255,6438,178552,64,192510
31430,0.00201,172.31.40.0-255,66,178618,64,192510
31431,0.002046,74.125.24.0-255,1484,180102,64,192510
31432,0.002056,172.31.40.0-255,66,180168,64,192510
31433,0.002107,172.31.40.0-255,66,180234,64,192510
31434,0.002112,172.31.40.0-255,66,180300,64,192510
31435,0.002127,74.125.24.0-255,3602,183902,64,192510
31436,0.002149,74.125.24.0-255,5002,188904,64,192510
31437,0.002151,74.125.24.0-255,105,189009,64,192510
31438,0.002154,172.31.40.0-255,66,189075,64,192510
31439,0.002169,172.31.40.0-255,66,189141,64,192510
31440,0.014844,172.31.40.0-255,105,189246,64,192510
31441,0.017145,74.125.24.0-255,66,189312,64,192510
31442,0.044866,172.31.40.0-255,171,189483,64,192510
31443,0.044901,172.31.40.0-255,1132,190615,64,192510
31444,0.044964,172.31.40.0-255,1514,192129,64,192510
31445,0.044966,172.31.40.0-255,315,192444,64,192510
31446,0.04706,104.244.42.0-255,66,192510,64,192510
31447,0.0,172.217.194.0-255,153,153,64,241952
31448,1.4e-05,172.31.40.0-255,66,219,64,241952
31449,2.1e-05,172.217.194.0-255,1484,1703,64,241952
31450,2.5e-05,172.31.40.0-255,66,1769,64,241952
31451,3.1e-05,172.217.194.0-255,2902,4671,64,241952
31452,3.5e-05,172.31.40.0-255,66,4737,64,241952
31453,3.8e-05,172.217.194.0-255,1484,6221,64,241952
31454,4.1e-05,172.31.40.0-255,66,6287,64,241952
31455,6.4e-05,172.217.194.0-255,5738,12025,64,241952
31456,6.7e-05,172.31.40.0-255,66,12091,64,241952
31457,8.5e-05,172.217.194.0-255,7156,19247,64,241952
31458,8.8e-05,172.31.40.0-255,66,19313,64,241952
31459,0.00012,172.31.40.0-255,66,19379,64,241952
31460,0.000124,172.217.194.0-255,2543,21922,64,241952
31461,0.000126,172.31.40.0-255,66,21988,64,241952
31462,0.00017,172.217.194.0-255,2902,24890,64,241952
31463,0.000173,172.31.40.0-255,66,24956,64,241952
31464,0.000193,172.217.194.0-255,4320,29276,64,241952
31465,0.000196,172.31.40.0-255,66,29342,64,241952
31466,0.000222,172.31.40.0-255,66,29408,64,241952
31467,0.000225,172.217.194.0-255,1484,30892,64,241952
31468,0.000227,172.31.40.0-255,66,30958,64,241952
31469,0.00026,172.31.40.0-255,66,31024,64,241952
31470,0.000288,172.217.194.0-255,5633,36657,64,241952
31471,0.00029,172.31.40.0-255,66,36723,64,241952
31472,0.000322,172.217.194.0-255,118,36841,64,241952
31473,0.000326,172.31.40.0-255,66,36907,64,241952
31474,0.000623,172.217.194.0-255,1484,38391,64,241952
31475,0.000629,172.31.40.0-255,66,38457,64,241952
31476,0.000635,172.217.194.0-255,2902,41359,64,241952
31477,0.000638,172.31.40.0-255,66,41425,64,241952
31478,0.000645,172.217.194.0-255,5738,47163,64,241952
31479,0.000647,172.31.40.0-255,66,47229,64,241952
31480,0.000696,172.31.40.0-255,66,47295,64,241952
31481,0.000706,172.31.40.0-255,66,47361,64,241952
31482,0.00072,172.217.194.0-255,1125,48486,64,241952
31483,0.000779,172.217.194.0-255,1484,49970,64,241952
31484,0.000782,172.31.40.0-255,66,50036,64,241952
31485,0.000786,172.217.194.0-255,1484,51520,64,241952
31486,0.000819,172.217.194.0-255,1484,53004,64,241952
31487,0.000826,172.217.194.0-255,5738,58742,64,241952
31488,0.000839,172.31.40.0-255,66,58808,64,241952
31489,0.000848,172.31.40.0-255,66,58874,64,241952
31490,0.00085,172.31.40.0-255,66,58940,64,241952
31491,0.000855,172.217.194.0-255,2902,61842,64,241952
31492,0.000857,172.31.40.0-255,66,61908,64,241952
31493,0.00087,172.31.40.0-255,66,61974,64,241952
31494,0.000872,172.217.194.0-255,500,62474,64,241952
31495,0.000992,172.217.194.0-255,1484,63958,64,241952
31496,0.000997,172.31.40.0-255,66,64024,64,241952
31497,0.001002,172.217.194.0-255,2902,66926,64,241952
31498,0.001004,172.31.40.0-255,66,66992,64,241952
31499,0.001064,172.217.194.0-255,5738,72730,64,241952
31500,0.00109,172.31.40.0-255,66,72796,64,241952
31501,0.001098,172.31.40.0-255,66,72862,64,241952
31502,0.001101,172.31.40.0-255,66,72928,64,241952
31503,0.001464,172.217.194.0-255,1484,74412,64,241952
31504,0.001479,172.217.194.0-255,2902,77314,64,241952
31505,0.001483,172.31.40.0-255,66,77380,64,241952
31506,0.001488,172.217.194.0-255,2902,80282,64,241952
31507,0.00149,172.31.40.0-255,66,80348,64,241952
31508,0.001505,172.217.194.0-255,2902,83250,64,241952
31509,0.001507,172.31.40.0-255,66,83316,64,241952
31510,0.001511,172.217.194.0-255,2902,86218,64,241952
31511,0.001513,172.31.40.0-255,66,86284,64,241952
31512,0.001542,172.31.40.0-255,66,86350,64,241952
31513,0.001569,172.31.40.0-255,66,86416,64,241952
31514,0.001592,172.217.194.0-255,2184,88600,64,241952
31515,0.001595,172.31.40.0-255,66,88666,64,241952
31516,0.001624,172.217.194.0-255,1484,90150,64,241952
31517,0.001627,172.217.194.0-255,1484,91634,64,241952
31518,0.001629,172.31.40.0-255,66,91700,64,241952
31519,0.001647,172.217.194.0-255,1484,93184,64,241952
31520,0.001651,172.217.194.0-255,1484,94668,64,241952
31521,0.001653,172.31.40.0-255,66,94734,64,241952
31522,0.001672,172.217.194.0-255,4320,99054,64,241952
31523,0.001681,172.217.194.0-255,7156,106210,64,241952
31524,0.001695,172.217.194.0-255,2902,109112,64,241952
31525,0.001713,172.217.194.0-255,7156,116268,64,241952
31526,0.001715,172.31.40.0-255,66,116334,64,241952
31527,0.001721,172.31.40.0-255,66,116400,64,241952
31528,0.001737,172.217.194.0-255,6438,122838,64,241952
31529,0.001753,172.31.40.0-255,66,122904,64,241952
31530,0.001853,172.217.194.0-255,1484,124388,64,241952
31531,0.001859,172.217.194.0-255,2902,127290,64,241952
31532,0.001862,172.31.40.0-255,66,127356,64,241952
31533,0.001889,172.217.194.0-255,5738,133094,64,241952
31534,0.001895,172.217.194.0-255,4320,137414,64,241952
31535,0.001903,172.31.40.0-255,66,137480,64,241952
31536,0.001936,172.31.40.0-255,66,137546,64,241952
31537,0.001948,172.217.194.0-255,766,138312,64,241952
31538,0.001986,172.217.194.0-255,1484,139796,64,241952
31539,0.002,172.217.194.0-255,4320,144116,64,241952
31540,0.002007,172.31.40.0-255,66,144182,64,241952
31541,0.002022,172.217.194.0-255,7156,151338,64,241952
31542,0.002025,172.217.194.0-255,1484,152822,64,241952
31543,0.002041,172.217.194.0-255,7156,159978,64,241952
31544,0.002056,172.31.40.0-255,66,160044,64,241952
31545,0.002063,172.217.194.0-255,1484,161528,64,241952
31546,0.002103,172.31.40.0-255,66,161594,64,241952
31547,0.002115,172.217.194.0-255,1484,163078,64,241952
31548,0.002129,172.217.194.0-255,2902,165980,64,241952
31549,0.002132,172.217.194.0-255,1484,167464,64,241952
31550,0.002138,172.31.40.0-255,66,167530,64,241952
31551,0.002152,172.217.194.0-255,4320,171850,64,241952
31552,0.002166,172.217.194.0-255,2902,174752,64,241952
31553,0.002173,172.31.40.0-255,66,174818,64,241952
31554,0.002223,172.217.194.0-255,2902,177720,64,241952
31555,0.002263,172.31.40.0-255,66,177786,64,241952
31556,0.002278,172.217.194.0-255,5738,183524,64,241952
31557,0.0023,172.217.194.0-255,5738,189262,64,241952
31558,0.002313,172.31.40.0-255,66,189328,64,241952
31559,0.002342,172.217.194.0-255,4320,193648,64,241952
31560,0.002348,172.217.194.0-255,5738,199386,64,241952
31561,0.002363,172.217.194.0-255,2902,202288,64,241952
31562,0.002373,172.217.194.0-255,766,203054,64,241952
31563,0.002384,172.31.40.0-255,66,203120,64,241952
31564,0.002449,172.217.194.0-255,1484,204604,64,241952
31565,0.002469,172.217.194.0-255,2902,207506,64,241952
31566,0.002477,172.31.40.0-255,66,207572,64,241952
31567,0.002487,172.217.194.0-255,4320,211892,64,241952
31568,0.002492,172.31.40.0-255,66,211958,64,241952
31569,0.002501,172.217.194.0-255,2902,214860,64,241952
31570,0.002523,172.217.194.0-255,5738,220598,64,241952
31571,0.002526,172.217.194.0-255,1484,222082,64,241952
31572,0.002528,172.217.194.0-255,1484,223566,64,241952
31573,0.002537,172.31.40.0-255,66,223632,64,241952
31574,0.00255,172.217.194.0-255,1484,225116,64,241952
31575,0.002566,172.217.194.0-255,4320,229436,64,241952
31576,0.002579,172.31.40.0-255,66,229502,64,241952
31577,0.002596,172.217.194.0-255,1484,230986,64,241952
31578,0.0026,172.217.194.0-255,2902,233888,64,241952
31579,0.002619,172.217.194.0-255,3262,237150,64,241952
31580,0.002628,172.31.40.0-255,66,237216,64,241952
31581,0.002647,172.217.194.0-255,105,237321,64,241952
31582,0.015475,172.31.40.0-255,101,237422,64,241952
31583,0.017728,172.217.194.0-255,66,237488,64,241952
31584,0.020042,172.31.40.0-255,105,237593,64,241952
31585,0.022291,172.217.194.0-255,66,237659,64,241952
31586,0.046005,172.31.40.0-255,172,237831,64,241952
31587,0.046039,172.31.40.0-255,1112,238943,64,241952
31588,0.0461,172.31.40.0-255,1514,240457,64,241952
31589,0.046102,172.31.40.0-255,1297,241754,64,241952
31590,0.047568,104.244.42.0-255,66,241820,64,241952
31591,0.04758,104.244.42.0-255,66,241886,64,241952
31592,0.047671,104.244.42.0-255,66,241952,64,241952
31593,0.0,172.217.194.0-255,153,153,64,210721
31594,2.2e-05,172.31.40.0-255,66,219,64,210721
31595,2.9e-05,172.217.194.0-255,1484,1703,64,210721
31596,3.5e-05,172.31.40.0-255,66,1769,64,210721
31597,4e-05,172.217.194.0-255,2902,4671,64,210721
31598,4.4e-05,172.31.40.0-255,66,4737,64,210721
31599,4.9e-05,172.217.194.0-255,4320,9057,64,210721
31600,5.3e-05,172.31.40.0-255,66,9123,64,210721
31601,8.3e-05,172.217.194.0-255,4784,13907,64,210721
31602,8.7e-05,172.31.40.0-255,66,13973,64,210721
31603,0.000124,172.217.194.0-255,1484,15457,64,210721
31604,0.000127,172.31.40.0-255,66,15523,64,210721
31605,0.00013,172.217.194.0-255,1484,17007,64,210721
31606,0.000133,172.31.40.0-255,66,17073,64,210721
31607,0.000147,172.217.194.0-255,1484,18557,64,210721
31608,0.00015,172.31.40.0-255,66,18623,64,210721
31609,0.000157,172.217.194.0-255,5738,24361,64,210721
31610,0.000159,172.31.40.0-255,66,24427,64,210721
31611,0.00018,172.217.194.0-255,4320,28747,64,210721
31612,0.000183,172.31.40.0-255,66,28813,64,210721
31613,0.000198,172.217.194.0-255,5738,34551,64,210721
31614,0.000203,172.31.40.0-255,66,34617,64,210721
31615,0.000222,172.217.194.0-255,6797,41414,64,210721
31616,0.000225,172.31.40.0-255,66,41480,64,210721
31617,0.000239,172.31.40.0-255,66,41546,64,210721
31618,0.000299,172.31.40.0-255,66,41612,64,210721
31619,0.000302,172.217.194.0-255,364,41976,64,210721
31620,0.000304,172.31.40.0-255,66,42042,64,210721
31621,0.000372,172.217.194.0-255,1484,43526,64,210721
31622,0.000376,172.31.40.0-255,66,43592,64,210721
31623,0.000381,172.217.194.0-255,2902,46494,64,210721
31624,0.000383,172.31.40.0-255,66,46560,64,210721
31625,0.00039,172.217.194.0-255,5738,52298,64,210721
31626,0.000393,172.31.40.0-255,66,52364,64,210721
31627,0.000422,172.217.194.0-255,7156,59520,64,210721
31628,0.000425,172.31.40.0-255,66,59586,64,210721
31629,0.000444,172.217.194.0-255,5738,65324,64,210721
31630,0.000447,172.31.40.0-255,66,65390,64,210721
31631,0.00047,172.217.194.0-255,2902,68292,64,210721
31632,0.000473,172.31.40.0-255,66,68358,64,210721
31633,0.000497,172.31.40.0-255,66,68424,64,210721
31634,0.000522,172.217.194.0-255,4320,72744,64,210721
31635,0.000525,172.31.40.0-255,66,72810,64,210721
31636,0.00053,172.217.194.0-255,2902,75712,64,210721
31637,0.000532,172.31.40.0-255,66,75778,64,210721
31638,0.000546,172.217.194.0-255,2902,78680,64,210721
31639,0.000549,172.31.40.0-255,66,78746,64,210721
31640,0.000597,172.31.40.0-255,66,78812,64,210721
31641,0.000618,172.217.194.0-255,7156,85968,64,210721
31642,0.000621,172.31.40.0-255,66,86034,64,210721
31643,0.000627,172.217.194.0-255,5020,91054,64,210721
31644,0.000629,172.31.40.0-255,66,91120,64,210721
31645,0.000676,172.217.194.0-255,1484,92604,64,210721
31646,0.000696,172.217.194.0-255,2902,95506,64,210721
31647,0.000699,172.31.40.0-255,66,95572,64,210721
31648,0.000705,172.217.194.0-255,5738,101310,64,210721
31649,0.000708,172.31.40.0-255,66,101376,64,210721
31650,0.000738,172.31.40.0-255,66,101442,64,210721
31651,0.000741,172.217.194.0-255,1484,102926,64,210721
31652,0.000781,172.217.194.0-255,5738,108664,64,210721
31653,0.000784,172.31.40.0-255,66,108730,64,210721
31654,0.000804,172.217.194.0-255,3602,112332,64,210721
31655,0.000807,172.31.40.0-255,66,112398,64,210721
31656,0.000865,172.217.194.0-255,1484,113882,64,210721
31657,0.000889,172.217.194.0-255,2902,116784,64,210721
31658,0.000898,172.31.40.0-255,66,116850,64,210721
31659,0.000904,172.217.194.0-255,4320,121170,64,210721
31660,0.000907,172.31.40.0-255,66,121236,64,210721
31661,0.000933,172.217.194.0-255,1484,122720,64,210721
31662,0.000949,172.31.40.0-255,66,122786,64,210721
31663,0.000959,172.31.40.0-255,66,122852,64,210721
31664,0.000994,172.217.194.0-255,2902,125754,64,210721
31665,0.000997,172.31.40.0-255,66,125820,64,210721
31666,0.001018,172.31.40.0-255,66,125886,64,210721
31667,0.00103,172.31.40.0-255,66,125952,64,210721
31668,0.001061,172.217.194.0-255,7156,133108,64,210721
31669,0.001064,172.31.40.0-255,66,133174,64,210721
31670,0.00107,172.217.194.0-255,4320,137494,64,210721
31671,0.001072,172.31.40.0-255,66,137560,64,210721
31672,0.001074,172.217.194.0-255,766,138326,64,210721
31673,0.001144,172.217.194.0-255,1484,139810,64,210721
31674,0.001148,172.31.40.0-255,66,139876,64,210721
31675,0.001153,172.217.194.0-255,2902,142778,64,210721
31676,0.001155,172.31.40.0-255,66,142844,64,210721
31677,0.001209,172.217.194.0-255,5738,148582,64,210721
31678,0.001212,172.31.40.0-255,66,148648,64,210721
31679,0.001224,172.217.194.0-255,7156,155804,64,210721
31680,0.001226,172.31.40.0-255,66,155870,64,210721
31681,0.001241,172.31.40.0-255,66,155936,64,210721
31682,0.001245,172.217.194.0-255,2184,158120,64,210721
31683,0.001247,172.31.40.0-255,66,158186,64,210721
31684,0.001275,172.217.194.0-255,2902,161088,64,210721
31685,0.001279,172.31.40.0-255,66,161154,64,210721
31686,0.001283,172.217.194.0-255,2902,164056,64,210721
31687,0.001285,172.31.40.0-255,66,164122,64,210721
31688,0.001298,172.217.194.0-255,4320,168442,64,210721
31689,0.001301,172.31.40.0-255,66,168508,64,210721
31690,0.001319,172.217.194.0-255,2902,171410,64,210721
31691,0.001321,172.31.40.0-255,66,171476,64,210721
31692,0.001363,172.217.194.0-255,5020,176496,64,210721
31693,0.001383,172.31.40.0-255,66,176562,64,210721
31694,0.001386,172.31.40.0-255,66,176628,64,210721
31695,0.001437,172.31.40.0-255,66,176694,64,210721
31696,0.001445,172.31.40.0-255,66,176760,64,210721
31697,0.001458,172.217.194.0-255,1484,178244,64,210721
31698,0.00147,172.217.194.0-255,2902,181146,64,210721
31699,0.001473,172.31.40.0-255,66,181212,64,210721
31700,0.001497,172.217.194.0-255,5738,186950,64,210721
31701,0.0015,172.31.40.0-255,66,187016,64,210721
31702,0.001503,172.217.194.0-255,1484,188500,64,210721
31703,0.001508,172.217.194.0-255,4320,192820,64,210721
31704,0.00151,172.31.40.0-255,66,192886,64,210721
31705,0.001525,172.217.194.0-255,4320,197206,64,210721
31706,0.001529,172.31.40.0-255,66,197272,64,210721
31707,0.001579,172.31.40.0-255,66,197338,64,210721
31708,0.001582,172.217.194.0-255,1484,198822,64,210721
31709,0.00161,172.31.40.0-255,66,198888,64,210721
31710,0.001622,172.31.40.0-255,66,198954,64,210721
31711,0.001646,172.217.194.0-255,2902,201856,64,210721
31712,0.001649,172.31.40.0-255,66,201922,64,210721
31713,0.001653,172.217.194.0-255,2902,204824,64,210721
31714,0.001656,172.31.40.0-255,66,204890,64,210721
31715,0.001685,172.31.40.0-255,66,204956,64,210721
31716,0.001688,172.217.194.0-255,97,205053,64,210721
31717,0.00172,172.217.194.0-255,105,205158,64,210721
31718,0.004491,172.31.40.0-255,66,205224,64,210721
31719,0.004528,172.31.40.0-255,105,205329,64,210721
31720,0.006751,172.217.194.0-255,66,205395,64,210721
31721,0.050458,172.31.40.0-255,224,205619,64,210721
31722,0.050488,172.31.40.0-255,1111,206730,64,210721
31723,0.050553,172.31.40.0-255,1514,208244,64,210721
31724,0.050555,172.31.40.0-255,1514,209758,64,210721
31725,0.050556,172.31.40.0-255,699,210457,64,210721
31726,0.051966,104.244.42.0-255,66,210523,64,210721
31727,0.051977,104.244.42.0-255,66,210589,64,210721
31728,0.052063,104.244.42.0-255,66,210655,64,210721
31729,0.052069,104.244.42.0-255,66,210721,64,210721
31730,0.0,74.125.24.0-255,153,153,64,298798
31731,2.5e-05,172.31.40.0-255,66,219,64,298798
31732,3.3e-05,74.125.24.0-255,1484,1703,64,298798
31733,3.8e-05,172.31.40.0-255,66,1769,64,298798
31734,4.3e-05,74.125.24.0-255,2902,4671,64,298798
31735,4.6e-05,172.31.40.0-255,66,4737,64,298798
31736,5.4e-05,74.125.24.0-255,7156,11893,64,298798
31737,5.7e-05,172.31.40.0-255,66,11959,64,298798
31738,9.9e-05,74.125.24.0-255,2037,13996,64,298798
31739,0.000102,172.31.40.0-255,66,14062,64,298798
31740,0.000465,74.125.24.0-255,1484,15546,64,298798
31741,0.00047,172.31.40.0-255,66,15612,64,298798
31742,0.000478,74.125.24.0-255,2902,18514,64,298798
31743,0.000481,172.31.40.0-255,66,18580,64,298798
31744,0.000487,74.125.24.0-255,2902,21482,64,298798
31745,0.000489,172.31.40.0-255,66,21548,64,298798
31746,0.000512,74.125.24.0-255,2902,24450,64,298798
31747,0.000514,172.31.40.0-255,66,24516,64,298798
31748,0.000553,74.125.24.0-255,6797,31313,64,298798
31749,0.000557,172.31.40.0-255,66,31379,64,298798
31750,0.000607,74.125.24.0-255,7156,38535,64,298798
31751,0.00061,172.31.40.0-255,66,38601,64,298798
31752,0.000637,74.125.24.0-255,2902,41503,64,298798
31753,0.000639,172.31.40.0-255,66,41569,64,298798
31754,0.000667,74.125.24.0-255,6797,48366,64,298798
31755,0.00067,172.31.40.0-255,66,48432,64,298798
31756,0.000723,74.125.24.0-255,2902,51334,64,298798
31757,0.000726,172.31.40.0-255,66,51400,64,298798
31758,0.000756,172.31.40.0-255,66,51466,64,298798
31759,0.000825,74.125.24.0-255,5379,56845,64,298798
31760,0.00083,172.31.40.0-255,66,56911,64,298798
31761,0.000851,74.125.24.0-255,398,57309,64,298798
31762,0.000857,74.125.24.0-255,346,57655,64,298798
31763,0.001091,74.125.24.0-255,1484,59139,64,298798
31764,0.001098,172.31.40.0-255,66,59205,64,298798
31765,0.001104,74.125.24.0-255,2902,62107,64,298798
31766,0.001107,172.31.40.0-255,66,62173,64,298798
31767,0.001113,74.125.24.0-255,5738,67911,64,298798
31768,0.001116,172.31.40.0-255,66,67977,64,298798
31769,0.00116,74.125.24.0-255,2902,70879,64,298798
31770,0.001163,172.31.40.0-255,66,70945,64,298798
31771,0.001181,74.125.24.0-255,5738,76683,64,298798
31772,0.001184,172.31.40.0-255,66,76749,64,298798
31773,0.001228,74.125.24.0-255,1484,78233,64,298798
31774,0.001314,74.125.24.0-255,5020,83253,64,298798
31775,0.001381,74.125.24.0-255,1484,84737,64,298798
31776,0.00142,74.125.24.0-255,4320,89057,64,298798
31777,0.001424,74.125.24.0-255,1484,90541,64,298798
31778,0.001431,74.125.24.0-255,7156,97697,64,298798
31779,0.001453,74.125.24.0-255,1484,99181,64,298798
31780,0.001494,74.125.24.0-255,1484,100665,64,298798
31781,0.00153,74.125.24.0-255,1484,102149,64,298798
31782,0.001594,74.125.24.0-255,2902,105051,64,298798
31783,0.001615,74.125.24.0-255,3602,108653,64,298798
31784,0.001709,74.125.24.0-255,1484,110137,64,298798
31785,0.001712,74.125.24.0-255,1484,111621,64,298798
31786,0.001723,74.125.24.0-255,1484,113105,64,298798
31787,0.001726,74.125.24.0-255,1484,114589,64,298798
31788,0.001746,74.125.24.0-255,4320,118909,64,298798
31789,0.001776,74.125.24.0-255,5738,124647,64,298798
31790,0.001793,74.125.24.0-255,7156,131803,64,298798
31791,0.001886,74.125.24.0-255,4320,136123,64,298798
31792,0.001945,74.125.24.0-255,6438,142561,64,298798
31793,0.003768,172.31.40.0-255,66,142627,64,298798
31794,0.005856,74.125.24.0-255,5738,148365,64,298798
31795,0.005863,172.31.40.0-255,66,148431,64,298798
31796,0.007945,74.125.24.0-255,5738,154169,64,298798
31797,0.007953,172.31.40.0-255,66,154235,64,298798
31798,0.010014,74.125.24.0-255,5738,159973,64,298798
31799,0.010022,172.31.40.0-255,66,160039,64,298798
31800,0.012106,74.125.24.0-255,5738,165777,64,298798
31801,0.012117,172.31.40.0-255,66,165843,64,298798
31802,0.014175,74.125.24.0-255,5738,171581,64,298798
31803,0.014183,172.31.40.0-255,66,171647,64,298798
31804,0.01626,74.125.24.0-255,5738,177385,64,298798
31805,0.016268,172.31.40.0-255,66,177451,64,298798
31806,0.018349,74.125.24.0-255,5738,183189,64,298798
31807,0.018356,172.31.40.0-255,66,183255,64,298798
31808,0.020483,74.125.24.0-255,5738,188993,64,298798
31809,0.020491,172.31.40.0-255,66,189059,64,298798
31810,0.02256,74.125.24.0-255,5738,194797,64,298798
31811,0.022568,172.31.40.0-255,66,194863,64,298798
31812,0.023597,172.31.40.0-255,167,195030,64,298798
31813,0.023633,172.31.40.0-255,1112,196142,64,298798
31814,0.02369,172.31.40.0-255,1514,197656,64,298798
31815,0.023691,172.31.40.0-255,1514,199170,64,298798
31816,0.02372,172.31.40.0-255,696,199866,64,298798
31817,0.024636,74.125.24.0-255,5738,205604,64,298798
31818,0.024643,172.31.40.0-255,66,205670,64,298798
31819,0.025122,104.244.42.0-255,66,205736,64,298798
31820,0.025191,104.244.42.0-255,66,205802,64,298798
31821,0.025195,104.244.42.0-255,66,205868,64,298798
31822,0.025213,104.244.42.0-255,66,205934,64,298798
31823,0.026703,74.125.24.0-255,5738,211672,64,298798
31824,0.02671,172.31.40.0-255,66,211738,64,298798
31825,0.028794,74.125.24.0-255,5738,217476,64,298798
31826,0.028801,172.31.40.0-255,66,217542,64,298798
31827,0.030864,74.125.24.0-255,5738,223280,64,298798
31828,0.030874,172.31.40.0-255,66,223346,64,298798
31829,0.032969,74.125.24.0-255,5738,229084,64,298798
31830,0.032975,172.31.40.0-255,66,229150,64,298798
31831,0.035047,74.125.24.0-255,5738,234888,64,298798
31832,0.035065,172.31.40.0-255,66,234954,64,298798
31833,0.037154,74.125.24.0-255,5738,240692,64,298798
31834,0.037168,172.31.40.0-255,66,240758,64,298798
31835,0.039245,74.125.24.0-255,5738,246496,64,298798
31836,0.039258,172.31.40.0-255,66,246562,64,298798
31837,0.041361,74.125.24.0-255,5738,252300,64,298798
31838,0.041376,172.31.40.0-255,66,252366,64,298798
31839,0.043444,74.125.24.0-255,5738,258104,64,298798
31840,0.04346,172.31.40.0-255,66,258170,64,298798
31841,0.045559,74.125.24.0-255,5738,263908,64,298798
31842,0.04557,172.31.40.0-255,66,263974,64,298798
31843,0.047656,74.125.24.0-255,5738,269712,64,298798
31844,0.047672,172.31.40.0-255,66,269778,64,298798
31845,0.049765,74.125.24.0-255,5738,275516,64,298798
31846,0.049781,172.31.40.0-255,66,275582,64,298798
31847,0.051895,74.125.24.0-255,5738,281320,64,298798
31848,0.051912,172.31.40.0-255,66,281386,64,298798
31849,0.053988,74.125.24.0-255,5738,287124,64,298798
31850,0.053994,172.31.40.0-255,66,287190,64,298798
31851,0.056091,74.125.24.0-255,5738,292928,64,298798
31852,0.056107,172.31.40.0-255,66,292994,64,298798
31853,0.058196,74.125.24.0-255,5738,298732,64,298798
31854,0.058209,172.31.40.0-255,66,298798,64,298798
31855,0.0,172.217.194.0-255,153,153,64,262740
31856,2.6e-05,172.31.40.0-255,66,219,64,262740
31857,3.4e-05,172.217.194.0-255,1484,1703,64,262740
31858,3.8e-05,172.31.40.0-255,66,1769,64,262740
31859,4.3e-05,172.217.194.0-255,2902,4671,64,262740
31860,4.6e-05,172.31.40.0-255,66,4737,64,262740
31861,5.3e-05,172.217.194.0-255,7156,11893,64,262740
31862,6.4e-05,172.31.40.0-255,66,11959,64,262740
31863,6.8e-05,172.217.194.0-255,2038,13997,64,262740
31864,7.1e-05,172.31.40.0-255,66,14063,64,262740
31865,0.000129,172.217.194.0-255,1484,15547,64,262740
31866,0.000132,172.31.40.0-255,66,15613,64,262740
31867,0.000138,172.217.194.0-255,2902,18515,64,262740
31868,0.00014,172.31.40.0-255,66,18581,64,262740
31869,0.000145,172.217.194.0-255,4320,22901,64,262740
31870,0.000153,172.31.40.0-255,66,22967,64,262740
31871,0.00019,172.217.194.0-255,1484,24451,64,262740
31872,0.000193,172.31.40.0-255,66,24517,64,262740
31873,0.0002,172.217.194.0-255,6797,31314,64,262740
31874,0.000203,172.31.40.0-255,66,31380,64,262740
31875,0.000401,172.217.194.0-255,1484,32864,64,262740
31876,0.000406,172.31.40.0-255,66,32930,64,262740
31877,0.000412,172.217.194.0-255,2902,35832,64,262740
31878,0.000414,172.31.40.0-255,66,35898,64,262740
31879,0.000419,172.217.194.0-255,4320,40218,64,262740
31880,0.000428,172.31.40.0-255,66,40284,64,262740
31881,0.000472,172.217.194.0-255,5738,46022,64,262740
31882,0.000476,172.31.40.0-255,66,46088,64,262740
31883,0.000507,172.217.194.0-255,3961,50049,64,262740
31884,0.000511,172.31.40.0-255,66,50115,64,262740
31885,0.000521,172.31.40.0-255,66,50181,64,262740
31886,0.000535,172.217.194.0-255,6797,56978,64,262740
31887,0.000538,172.31.40.0-255,66,57044,64,262740
31888,0.000641,172.217.194.0-255,378,57422,64,262740
31889,0.000785,172.31.40.0-255,66,57488,64,262740
31890,0.000796,172.217.194.0-255,365,57853,64,262740
31891,0.000803,172.31.40.0-255,66,57919,64,262740
31892,0.000964,172.217.194.0-255,1484,59403,64,262740
31893,0.000974,172.217.194.0-255,2902,62305,64,262740
31894,0.000978,172.31.40.0-255,66,62371,64,262740
31895,0.000986,172.217.194.0-255,5738,68109,64,262740
31896,0.000989,172.31.40.0-255,66,68175,64,262740
31897,0.000999,172.217.194.0-255,1484,69659,64,262740
31898,0.001031,172.217.194.0-255,7156,76815,64,262740
31899,0.001035,172.31.40.0-255,66,76881,64,262740
31900,0.001068,172.31.40.0-255,66,76947,64,262740
31901,0.001094,172.217.194.0-255,3602,80549,64,262740
31902,0.001097,172.31.40.0-255,66,80615,64,262740
31903,0.0014,172.217.194.0-255,1484,82099,64,262740
31904,0.001406,172.217.194.0-255,2902,85001,64,262740
31905,0.001409,172.31.40.0-255,66,85067,64,262740
31906,0.001413,172.217.194.0-255,1484,86551,64,262740
31907,0.001441,172.217.194.0-255,4320,90871,64,262740
31908,0.001444,172.31.40.0-255,66,90937,64,262740
31909,0.001457,172.31.40.0-255,66,91003,64,262740
31910,0.001477,172.217.194.0-255,1484,92487,64,262740
31911,0.001489,172.31.40.0-255,66,92553,64,262740
31912,0.001523,172.31.40.0-255,66,92619,64,262740
31913,0.001528,172.217.194.0-255,2902,95521,64,262740
31914,0.00153,172.31.40.0-255,66,95587,64,262740
31915,0.001561,172.31.40.0-255,66,95653,64,262740
31916,0.001563,172.217.194.0-255,766,96419,64,262740
31917,0.001612,172.217.194.0-255,1484,97903,64,262740
31918,0.001614,172.31.40.0-255,66,97969,64,262740
31919,0.001618,172.217.194.0-255,2902,100871,64,262740
31920,0.00162,172.31.40.0-255,66,100937,64,262740
31921,0.001646,172.217.194.0-255,5738,106675,64,262740
31922,0.001648,172.31.40.0-255,66,106741,64,262740
31923,0.001653,172.217.194.0-255,4320,111061,64,262740
31924,0.001655,172.31.40.0-255,66,111127,64,262740
31925,0.001694,172.31.40.0-255,66,111193,64,262740
31926,0.001697,172.217.194.0-255,1484,112677,64,262740
31927,0.001715,172.217.194.0-255,1484,114161,64,262740
31928,0.001717,172.31.40.0-255,66,114227,64,262740
31929,0.001744,172.31.40.0-255,66,114293,64,262740
31930,0.00188,172.217.194.0-255,1484,115777,64,262740
31931,0.001884,172.217.194.0-255,1484,117261,64,262740
31932,0.001886,172.31.40.0-255,66,117327,64,262740
31933,0.001918,172.217.194.0-255,1484,118811,64,262740
31934,0.001923,172.217.194.0-255,5738,124549,64,262740
31935,0.001925,172.31.40.0-255,66,124615,64,262740
31936,0.001964,172.217.194.0-255,4320,128935,64,262740
31937,0.001966,172.31.40.0-255,66,129001,64,262740
31938,0.001986,172.31.40.0-255,66,129067,64,262740
31939,0.001996,172.31.40.0-255,66,129133,64,262740
31940,0.002018,172.217.194.0-255,1484,130617,64,262740
31941,0.002022,172.217.194.0-255,2902,133519,64,262740
31942,0.002023,172.31.40.0-255,66,133585,64,262740
31943,0.002028,172.217.194.0-255,4320,137905,64,262740
31944,0.00203,172.31.40.0-255,66,137971,64,262740
31945,0.002061,172.217.194.0-255,1484,139455,64,262740
31946,0.002076,172.31.40.0-255,66,139521,64,262740
31947,0.002086,172.31.40.0-255,66,139587,64,262740
31948,0.002127,172.217.194.0-255,1484,141071,64,262740
31949,0.002145,172.217.194.0-255,2902,143973,64,262740
31950,0.002147,172.31.40.0-255,66,144039,64,262740
31951,0.00215,172.217.194.0-255,1484,145523,64,262740
31952,0.002174,172.217.194.0-255,4320,149843,64,262740
31953,0.002176,172.31.40.0-255,66,149909,64,262740
31954,0.002184,172.31.40.0-255,66,149975,64,262740
31955,0.002224,172.217.194.0-255,4320,154295,64,262740
31956,0.002226,172.31.40.0-255,66,154361,64,262740
31957,0.002249,172.31.40.0-255,66,154427,64,262740
31958,0.002275,172.31.40.0-255,66,154493,64,262740
31959,0.002293,172.217.194.0-255,5738,160231,64,262740
31960,0.002294,172.31.40.0-255,66,160297,64,262740
31961,0.004511,172.217.194.0-255,5738,166035,64,262740
31962,0.004515,172.31.40.0-255,66,166101,64,262740
31963,0.006748,172.217.194.0-255,5738,171839,64,262740
31964,0.006754,172.31.40.0-255,66,171905,64,262740
31965,0.008992,172.217.194.0-255,5738,177643,64,262740
31966,0.008997,172.31.40.0-255,66,177709,64,262740
31967,0.011201,172.217.194.0-255,5738,183447,64,262740
31968,0.011207,172.31.40.0-255,66,183513,64,262740
31969,0.013442,172.217.194.0-255,5738,189251,64,262740
31970,0.01345,172.31.40.0-255,66,189317,64,262740
31971,0.01567,172.217.194.0-255,5738,195055,64,262740
31972,0.015681,172.31.40.0-255,66,195121,64,262740
31973,0.017886,172.217.194.0-255,5738,200859,64,262740
31974,0.017893,172.31.40.0-255,66,200925,64,262740
31975,0.020125,172.217.194.0-255,5738,206663,64,262740
31976,0.020133,172.31.40.0-255,66,206729,64,262740
31977,0.022373,172.217.194.0-255,5738,212467,64,262740
31978,0.02238,172.31.40.0-255,66,212533,64,262740
31979,0.024625,172.217.194.0-255,5738,218271,64,262740
31980,0.024633,172.31.40.0-255,66,218337,64,262740
31981,0.026857,172.217.194.0-255,5738,224075,64,262740
31982,0.026862,172.31.40.0-255,66,224141,64,262740
31983,0.027619,172.31.40.0-255,171,224312,64,262740
31984,0.027658,172.31.40.0-255,1136,225448,64,262740
31985,0.02773,172.31.40.0-255,1514,226962,64,262740
31986,0.027732,172.31.40.0-255,1514,228476,64,262740
31987,0.027736,172.31.40.0-255,1514,229990,64,262740
31988,0.027737,172.31.40.0-255,1053,231043,64,262740
31989,0.029082,172.217.194.0-255,5738,236781,64,262740
31990,0.029088,172.31.40.0-255,66,236847,64,262740
31991,0.029174,104.244.42.0-255,66,236913,64,262740
31992,0.02918,104.244.42.0-255,66,236979,64,262740
31993,0.029282,104.244.42.0-255,66,237045,64,262740
31994,0.029287,104.244.42.0-255,66,237111,64,262740
31995,0.031285,172.217.194.0-255,4320,241431,64,262740
31996,0.031291,172.31.40.0-255,66,241497,64,262740
31997,0.031327,172.217.194.0-255,1484,242981,64,262740
31998,0.033487,172.217.194.0-255,4320,247301,64,262740
31999,0.033491,172.31.40.0-255,66,247367,64,262740
32000,0.035757,172.217.194.0-255,4320,251687,64,262740
32001,0.035762,172.31.40.0-255,66,251753,64,262740
32002,0.03579,172.217.194.0-255,1484,253237,64,262740
32003,0.037984,172.217.194.0-255,4320,257557,64,262740
32004,0.037989,172.31.40.0-255,66,257623,64,262740
32005,0.040214,172.217.194.0-255,2902,260525,64,262740
32006,0.040218,172.31.40.0-255,66,260591,64,262740
32007,0.040252,172.217.194.0-255,1912,262503,64,262740
32008,0.040255,172.31.40.0-255,66,262569,64,262740
32009,0.040375,172.31.40.0-255,105,262674,64,262740
32010,0.042581,172.217.194.0-255,66,262740,64,262740
32011,0.0,74.125.24.0-255,150,150,64,232517
32012,2.3e-05,172.31.40.0-255,66,216,64,232517
32013,3e-05,74.125.24.0-255,1484,1700,64,232517
32014,3.5e-05,172.31.40.0-255,66,1766,64,232517
32015,4e-05,74.125.24.0-255,2902,4668,64,232517
32016,4.3e-05,172.31.40.0-255,66,4734,64,232517
32017,5.1e-05,74.125.24.0-255,7156,11890,64,232517
32018,5.6e-05,172.31.40.0-255,66,11956,64,232517
32019,6e-05,74.125.24.0-255,2152,14108,64,232517
32020,6.2e-05,172.31.40.0-255,66,14174,64,232517
32021,8.8e-05,74.125.24.0-255,2902,17076,64,232517
32022,9.1e-05,172.31.40.0-255,66,17142,64,232517
32023,9.8e-05,74.125.24.0-255,7156,24298,64,232517
32024,0.000101,172.31.40.0-255,66,24364,64,232517
32025,0.000144,74.125.24.0-255,6797,31161,64,232517
32026,0.000147,172.31.40.0-255,66,31227,64,232517
32027,0.000301,74.125.24.0-255,1484,32711,64,232517
32028,0.000306,172.31.40.0-255,66,32777,64,232517
32029,0.000312,74.125.24.0-255,2902,35679,64,232517
32030,0.000314,172.31.40.0-255,66,35745,64,232517
32031,0.000321,74.125.24.0-255,4320,40065,64,232517
32032,0.000323,172.31.40.0-255,66,40131,64,232517
32033,0.000373,172.31.40.0-255,66,40197,64,232517
32034,0.000404,74.125.24.0-255,4320,44517,64,232517
32035,0.000407,172.31.40.0-255,66,44583,64,232517
32036,0.00043,74.125.24.0-255,5738,50321,64,232517
32037,0.000433,172.31.40.0-255,66,50387,64,232517
32038,0.000439,74.125.24.0-255,5653,56040,64,232517
32039,0.000441,172.31.40.0-255,66,56106,64,232517
32040,0.000443,74.125.24.0-255,132,56238,64,232517
32041,0.000446,172.31.40.0-255,66,56304,64,232517
32042,0.000592,74.125.24.0-255,1484,57788,64,232517
32043,0.000599,74.125.24.0-255,2902,60690,64,232517
32044,0.000603,172.31.40.0-255,66,60756,64,232517
32045,0.000626,74.125.24.0-255,5738,66494,64,232517
32046,0.000629,172.31.40.0-255,66,66560,64,232517
32047,0.000633,74.125.24.0-255,2902,69462,64,232517
32048,0.000634,172.31.40.0-255,66,69528,64,232517
32049,0.000664,74.125.24.0-255,2902,72430,64,232517
32050,0.000667,172.31.40.0-255,66,72496,64,232517
32051,0.000695,172.31.40.0-255,66,72562,64,232517
32052,0.000703,74.125.24.0-255,7156,79718,64,232517
32053,0.000705,172.31.40.0-255,66,79784,64,232517
32054,0.000727,74.125.24.0-255,2543,82327,64,232517
32055,0.00073,172.31.40.0-255,66,82393,64,232517
32056,0.000752,74.125.24.0-255,345,82738,64,232517
32057,0.000915,74.125.24.0-255,1484,84222,64,232517
32058,0.000919,172.31.40.0-255,66,84288,64,232517
32059,0.000924,74.125.24.0-255,2902,87190,64,232517
32060,0.000926,172.31.40.0-255,66,87256,64,232517
32061,0.000929,74.125.24.0-255,1484,88740,64,232517
32062,0.000947,74.125.24.0-255,4320,93060,64,232517
32063,0.00095,172.31.40.0-255,66,93126,64,232517
32064,0.000953,74.125.24.0-255,1484,94610,64,232517
32065,0.000971,74.125.24.0-255,7156,101766,64,232517
32066,0.000975,172.31.40.0-255,66,101832,64,232517
32067,0.000985,74.125.24.0-255,4320,106152,64,232517
32068,0.000987,172.31.40.0-255,66,106218,64,232517
32069,0.000992,74.125.24.0-255,4320,110538,64,232517
32070,0.000994,172.31.40.0-255,66,110604,64,232517
32071,0.001027,74.125.24.0-255,6438,117042,64,232517
32072,0.00103,172.31.40.0-255,66,117108,64,232517
32073,0.001195,74.125.24.0-255,1484,118592,64,232517
32074,0.001212,74.125.24.0-255,2902,121494,64,232517
32075,0.001216,172.31.40.0-255,66,121560,64,232517
32076,0.001223,74.125.24.0-255,5738,127298,64,232517
32077,0.001225,172.31.40.0-255,66,127364,64,232517
32078,0.00123,74.125.24.0-255,2902,130266,64,232517
32079,0.001232,172.31.40.0-255,66,130332,64,232517
32080,0.001256,74.125.24.0-255,1484,131816,64,232517
32081,0.001263,74.125.24.0-255,5738,137554,64,232517
32082,0.001265,172.31.40.0-255,66,137620,64,232517
32083,0.001279,172.31.40.0-255,66,137686,64,232517
32084,0.001282,74.125.24.0-255,1484,139170,64,232517
32085,0.00132,172.31.40.0-255,66,139236,64,232517
32086,0.001331,172.31.40.0-255,66,139302,64,232517
32087,0.001335,74.125.24.0-255,1484,140786,64,232517
32088,0.001379,172.31.40.0-255,66,140852,64,232517
32089,0.001417,74.125.24.0-255,2902,143754,64,232517
32090,0.00142,172.31.40.0-255,66,143820,64,232517
32091,0.001445,74.125.24.0-255,4320,148140,64,232517
32092,0.001448,172.31.40.0-255,66,148206,64,232517
32093,0.001454,74.125.24.0-255,4320,152526,64,232517
32094,0.001457,172.31.40.0-255,66,152592,64,232517
32095,0.001463,74.125.24.0-255,5738,158330,64,232517
32096,0.001465,172.31.40.0-255,66,158396,64,232517
32097,0.001477,172.31.40.0-255,66,158462,64,232517
32098,0.001507,74.125.24.0-255,1484,159946,64,232517
32099,0.001515,74.125.24.0-255,5020,164966,64,232517
32100,0.001517,172.31.40.0-255,66,165032,64,232517
32101,0.001524,74.125.24.0-255,5738,170770,64,232517
32102,0.001527,172.31.40.0-255,66,170836,64,232517
32103,0.001565,172.31.40.0-255,66,170902,64,232517
32104,0.001582,172.31.40.0-255,66,170968,64,232517
32105,0.001604,74.125.24.0-255,7156,178124,64,232517
32106,0.001607,172.31.40.0-255,66,178190,64,232517
32107,0.00161,74.125.24.0-255,766,178956,64,232517
32108,0.001716,74.125.24.0-255,1484,180440,64,232517
32109,0.00172,172.31.40.0-255,66,180506,64,232517
32110,0.001725,74.125.24.0-255,2902,183408,64,232517
32111,0.001727,172.31.40.0-255,66,183474,64,232517
32112,0.00173,74.125.24.0-255,1484,184958,64,232517
32113,0.00175,74.125.24.0-255,4320,189278,64,232517
32114,0.001756,74.125.24.0-255,5738,195016,64,232517
32115,0.001761,172.31.40.0-255,66,195082,64,232517
32116,0.001768,172.31.40.0-255,66,195148,64,232517
32117,0.001774,74.125.24.0-255,4320,199468,64,232517
32118,0.001776,172.31.40.0-255,66,199534,64,232517
32119,0.001802,172.31.40.0-255,66,199600,64,232517
32120,0.001808,74.125.24.0-255,5020,204620,64,232517
32121,0.00181,172.31.40.0-255,66,204686,64,232517
32122,0.001853,74.125.24.0-255,1484,206170,64,232517
32123,0.001864,74.125.24.0-255,2902,209072,64,232517
32124,0.001867,172.31.40.0-255,66,209138,64,232517
32125,0.001892,74.125.24.0-255,5738,214876,64,232517
32126,0.001895,172.31.40.0-255,66,214942,64,232517
32127,0.001898,74.125.24.0-255,1484,216426,64,232517
32128,0.001919,172.31.40.0-255,66,216492,64,232517
32129,0.001922,74.125.24.0-255,1484,217976,64,232517
32130,0.001948,172.31.40.0-255,66,218042,64,232517
32131,0.001958,172.31.40.0-255,66,218108,64,232517
32132,0.002019,74.125.24.0-255,6438,224546,64,232517
32133,0.002033,172.31.40.0-255,66,224612,64,232517
32134,0.002079,172.31.40.0-255,66,224678,64,232517
32135,0.00214,172.31.40.0-255,66,224744,64,232517
32136,0.002173,172.31.40.0-255,66,224810,64,232517
32137,0.002337,74.125.24.0-255,1484,226294,64,232517
32138,0.004483,74.125.24.0-255,2657,228951,64,232517
32139,0.004496,172.31.40.0-255,66,229017,64,232517
32140,0.013306,172.31.40.0-255,105,229122,64,232517
32141,0.015574,74.125.24.0-255,66,229188,64,232517
32142,0.031478,172.31.40.0-255,172,229360,64,232517
32143,0.031512,172.31.40.0-255,1107,230467,64,232517
32144,0.03157,172.31.40.0-255,1514,231981,64,232517
32145,0.031572,172.31.40.0-255,338,232319,64,232517
32146,0.03309,104.244.42.0-255,66,232385,64,232517
32147,0.033128,104.244.42.0-255,66,232451,64,232517
32148,0.033175,104.244.42.0-255,66,232517,64,232517
32149,0.0,74.125.24.0-255,153,153,64,208720
32150,1.8e-05,172.31.40.0-255,66,219,64,208720
32151,2.6e-05,74.125.24.0-255,1484,1703,64,208720
32152,3e-05,172.31.40.0-255,66,1769,64,208720
32153,3.5e-05,74.125.24.0-255,2902,4671,64,208720
32154,4.5e-05,172.31.40.0-255,66,4737,64,208720
32155,0.000104,74.125.24.0-255,5738,10475,64,208720
32156,0.000107,172.31.40.0-255,66,10541,64,208720
32157,0.000132,74.125.24.0-255,1484,12025,64,208720
32158,0.000135,172.31.40.0-255,66,12091,64,208720
32159,0.00028,74.125.24.0-255,2030,14121,64,208720
32160,0.000284,172.31.40.0-255,66,14187,64,208720
32161,0.000334,74.125.24.0-255,1484,15671,64,208720
32162,0.000338,172.31.40.0-255,66,15737,64,208720
32163,0.000365,74.125.24.0-255,1484,17221,64,208720
32164,0.000367,172.31.40.0-255,66,17287,64,208720
32165,0.000407,74.125.24.0-255,1484,18771,64,208720
32166,0.00041,172.31.40.0-255,66,18837,64,208720
32167,0.000441,74.125.24.0-255,5738,24575,64,208720
32168,0.000444,172.31.40.0-255,66,24641,64,208720
32169,0.00059,74.125.24.0-255,6797,31438,64,208720
32170,0.000595,172.31.40.0-255,66,31504,64,208720
32171,0.000764,74.125.24.0-255,2902,34406,64,208720
32172,0.000769,172.31.40.0-255,66,34472,64,208720
32173,0.000795,74.125.24.0-255,7156,41628,64,208720
32174,0.000797,172.31.40.0-255,66,41694,64,208720
32175,0.001034,74.125.24.0-255,7156,48850,64,208720
32176,0.00104,172.31.40.0-255,66,48916,64,208720
32177,0.001081,172.31.40.0-255,66,48982,64,208720
32178,0.001499,74.125.24.0-255,4320,53302,64,208720
32179,0.001506,172.31.40.0-255,66,53368,64,208720
32180,0.001534,74.125.24.0-255,1735,55103,64,208720
32181,0.001656,74.125.24.0-255,5738,60841,64,208720
32182,0.002341,74.125.24.0-255,4320,65161,64,208720
32183,0.002362,74.125.24.0-255,2543,67704,64,208720
32184,0.00251,74.125.24.0-255,5738,73442,64,208720
32185,0.003252,172.31.40.0-255,66,73508,64,208720
32186,0.003371,74.125.24.0-255,5738,79246,64,208720
32187,0.003384,172.31.40.0-255,66,79312,64,208720
32188,0.003448,172.31.40.0-255,66,79378,64,208720
32189,0.00348,172.31.40.0-255,66,79444,64,208720
32190,0.005841,74.125.24.0-255,4320,83764,64,208720
32191,0.005846,172.31.40.0-255,66,83830,64,208720
32192,0.005865,74.125.24.0-255,1484,85314,64,208720
32193,0.008212,74.125.24.0-255,4320,89634,64,208720
32194,0.008335,172.31.40.0-255,66,89700,64,208720
32195,0.010719,74.125.24.0-255,5738,95438,64,208720
32196,0.010727,172.31.40.0-255,66,95504,64,208720
32197,0.013154,74.125.24.0-255,5738,101242,64,208720
32198,0.013163,172.31.40.0-255,66,101308,64,208720
32199,0.01555,74.125.24.0-255,5738,107046,64,208720
32200,0.016814,172.31.40.0-255,66,107112,64,208720
32201,0.019188,74.125.24.0-255,5738,112850,64,208720
32202,0.019198,172.31.40.0-255,66,112916,64,208720
32203,0.021598,74.125.24.0-255,5738,118654,64,208720
32204,0.021605,172.31.40.0-255,66,118720,64,208720
32205,0.023996,74.125.24.0-255,5738,124458,64,208720
32206,0.024004,172.31.40.0-255,66,124524,64,208720
32207,0.026368,74.125.24.0-255,5738,130262,64,208720
32208,0.026374,172.31.40.0-255,66,130328,64,208720
32209,0.027223,172.31.40.0-255,172,130500,64,208720
32210,0.027271,172.31.40.0-255,1112,131612,64,208720
32211,0.02733,172.31.40.0-255,1514,133126,64,208720
32212,0.027332,172.31.40.0-255,1296,134422,64,208720
32213,0.028751,74.125.24.0-255,5738,140160,64,208720
32214,0.028759,172.31.40.0-255,66,140226,64,208720
32215,0.028777,104.244.42.0-255,66,140292,64,208720
32216,0.028944,104.244.42.0-255,66,140358,64,208720
32217,0.028991,104.244.42.0-255,66,140424,64,208720
32218,0.031172,74.125.24.0-255,5738,146162,64,208720
32219,0.031178,172.31.40.0-255,66,146228,64,208720
32220,0.033586,74.125.24.0-255,4320,150548,64,208720
32221,0.033593,172.31.40.0-255,66,150614,64,208720
32222,0.033622,74.125.24.0-255,1484,152098,64,208720
32223,0.035999,74.125.24.0-255,4320,156418,64,208720
32224,0.036006,172.31.40.0-255,66,156484,64,208720
32225,0.038391,74.125.24.0-255,5738,162222,64,208720
32226,0.038807,172.31.40.0-255,66,162288,64,208720
32227,0.041221,74.125.24.0-255,5738,168026,64,208720
32228,0.041238,172.31.40.0-255,66,168092,64,208720
32229,0.043646,74.125.24.0-255,5738,173830,64,208720
32230,0.043662,172.31.40.0-255,66,173896,64,208720
32231,0.046057,74.125.24.0-255,5738,179634,64,208720
32232,0.046073,172.31.40.0-255,66,179700,64,208720
32233,0.048486,74.125.24.0-255,5738,185438,64,208720
32234,0.048502,172.31.40.0-255,66,185504,64,208720
32235,0.050892,74.125.24.0-255,5738,191242,64,208720
32236,0.05091,172.31.40.0-255,66,191308,64,208720
32237,0.053306,74.125.24.0-255,5738,197046,64,208720
32238,0.053323,172.31.40.0-255,66,197112,64,208720
32239,0.055733,74.125.24.0-255,5738,202850,64,208720
32240,0.055748,172.31.40.0-255,66,202916,64,208720
32241,0.058191,74.125.24.0-255,5738,208654,64,208720
32242,0.058209,172.31.40.0-255,66,208720,64,208720
32243,0.0,74.125.24.0-255,153,153,64,241984
32244,2.1e-05,172.31.40.0-255,66,219,64,241984
32245,2.7e-05,74.125.24.0-255,1484,1703,64,241984
32246,3.2e-05,172.31.40.0-255,66,1769,64,241984
32247,3.8e-05,74.125.24.0-255,2902,4671,64,241984
32248,4.1e-05,172.31.40.0-255,66,4737,64,241984
32249,4.9e-05,74.125.24.0-255,7156,11893,64,241984
32250,5.2e-05,172.31.40.0-255,66,11959,64,241984
32251,7.8e-05,74.125.24.0-255,1929,13888,64,241984
32252,8.1e-05,172.31.40.0-255,66,13954,64,241984
32253,0.000185,74.125.24.0-255,1484,15438,64,241984
32254,0.000189,172.31.40.0-255,66,15504,64,241984
32255,0.000194,74.125.24.0-255,2902,18406,64,241984
32256,0.000197,172.31.40.0-255,66,18472,64,241984
32257,0.000212,74.125.24.0-255,5738,24210,64,241984
32258,0.000215,172.31.40.0-255,66,24276,64,241984
32259,0.000243,74.125.24.0-255,6797,31073,64,241984
32260,0.000246,172.31.40.0-255,66,31139,64,241984
32261,0.00042,74.125.24.0-255,1484,32623,64,241984
32262,0.000425,172.31.40.0-255,66,32689,64,241984
32263,0.00043,74.125.24.0-255,2902,35591,64,241984
32264,0.000433,172.31.40.0-255,66,35657,64,241984
32265,0.00044,74.125.24.0-255,5738,41395,64,241984
32266,0.000442,172.31.40.0-255,66,41461,64,241984
32267,0.000483,74.125.24.0-255,6797,48258,64,241984
32268,0.000486,172.31.40.0-255,66,48324,64,241984
32269,0.000512,74.125.24.0-255,7156,55480,64,241984
32270,0.000515,172.31.40.0-255,66,55546,64,241984
32271,0.000547,172.31.40.0-255,66,55612,64,241984
32272,0.000723,74.125.24.0-255,347,55959,64,241984
32273,0.000727,172.31.40.0-255,66,56025,64,241984
32274,0.000893,74.125.24.0-255,1484,57509,64,241984
32275,0.000916,74.125.24.0-255,2902,60411,64,241984
32276,0.000919,172.31.40.0-255,66,60477,64,241984
32277,0.000926,74.125.24.0-255,5738,66215,64,241984
32278,0.000942,74.125.24.0-255,6797,73012,64,241984
32279,0.000958,172.31.40.0-255,66,73078,64,241984
32280,0.000987,74.125.24.0-255,1484,74562,64,241984
32281,0.001007,74.125.24.0-255,2902,77464,64,241984
32282,0.001013,74.125.24.0-255,5738,83202,64,241984
32283,0.001042,74.125.24.0-255,6797,89999,64,241984
32284,0.001055,172.31.40.0-255,66,90065,64,241984
32285,0.002115,74.125.24.0-255,1484,91549,64,241984
32286,0.002127,74.125.24.0-255,2902,94451,64,241984
32287,0.002131,172.31.40.0-255,66,94517,64,241984
32288,0.00214,74.125.24.0-255,5738,100255,64,241984
32289,0.002144,74.125.24.0-255,2902,103157,64,241984
32290,0.007131,172.31.40.0-255,66,103223,64,241984
32291,0.009373,74.125.24.0-255,5738,108961,64,241984
32292,0.009381,172.31.40.0-255,66,109027,64,241984
32293,0.01163,74.125.24.0-255,5738,114765,64,241984
32294,0.011637,172.31.40.0-255,66,114831,64,241984
32295,0.013907,74.125.24.0-255,5738,120569,64,241984
32296,0.014341,172.31.40.0-255,66,120635,64,241984
32297,0.016587,74.125.24.0-255,5738,126373,64,241984
32298,0.016594,172.31.40.0-255,66,126439,64,241984
32299,0.018824,74.125.24.0-255,5738,132177,64,241984
32300,0.018831,172.31.40.0-255,66,132243,64,241984
32301,0.021086,74.125.24.0-255,5738,137981,64,241984
32302,0.021092,172.31.40.0-255,66,138047,64,241984
32303,0.023339,74.125.24.0-255,5738,143785,64,241984
32304,0.023347,172.31.40.0-255,66,143851,64,241984
32305,0.025597,74.125.24.0-255,5738,149589,64,241984
32306,0.025603,172.31.40.0-255,66,149655,64,241984
32307,0.027443,172.31.40.0-255,167,149822,64,241984
32308,0.027474,172.31.40.0-255,1111,150933,64,241984
32309,0.027534,172.31.40.0-255,1514,152447,64,241984
32310,0.027536,172.31.40.0-255,1514,153961,64,241984
32311,0.027559,172.31.40.0-255,699,154660,64,241984
32312,0.027862,74.125.24.0-255,5738,160398,64,241984
32313,0.027869,172.31.40.0-255,66,160464,64,241984
32314,0.028971,104.244.42.0-255,66,160530,64,241984
32315,0.029009,104.244.42.0-255,66,160596,64,241984
32316,0.029045,104.244.42.0-255,66,160662,64,241984
32317,0.029059,104.244.42.0-255,66,160728,64,241984
32318,0.030126,74.125.24.0-255,5738,166466,64,241984
32319,0.030131,172.31.40.0-255,66,166532,64,241984
32320,0.032437,74.125.24.0-255,5738,172270,64,241984
32321,0.032444,172.31.40.0-255,66,172336,64,241984
32322,0.03468,74.125.24.0-255,5738,178074,64,241984
32323,0.034686,172.31.40.0-255,66,178140,64,241984
32324,0.03695,74.125.24.0-255,5738,183878,64,241984
32325,0.036954,172.31.40.0-255,66,183944,64,241984
32326,0.039206,74.125.24.0-255,5738,189682,64,241984
32327,0.039211,172.31.40.0-255,66,189748,64,241984
32328,0.041448,74.125.24.0-255,5738,195486,64,241984
32329,0.041453,172.31.40.0-255,66,195552,64,241984
32330,0.043764,74.125.24.0-255,5738,201290,64,241984
32331,0.043771,172.31.40.0-255,66,201356,64,241984
32332,0.046031,74.125.24.0-255,5738,207094,64,241984
32333,0.046037,172.31.40.0-255,66,207160,64,241984
32334,0.048293,74.125.24.0-255,5738,212898,64,241984
32335,0.048299,172.31.40.0-255,66,212964,64,241984
32336,0.050561,74.125.24.0-255,5738,218702,64,241984
32337,0.050567,172.31.40.0-255,66,218768,64,241984
32338,0.052812,74.125.24.0-255,5738,224506,64,241984
32339,0.052821,172.31.40.0-255,66,224572,64,241984
32340,0.055149,74.125.24.0-255,5738,230310,64,241984
32341,0.055167,172.31.40.0-255,66,230376,64,241984
32342,0.057415,74.125.24.0-255,5738,236114,64,241984
32343,0.057431,172.31.40.0-255,66,236180,64,241984
32344,0.059676,74.125.24.0-255,5738,241918,64,241984
32345,0.059684,172.31.40.0-255,66,241984,64,241984
32346,0.0,74.125.68.0-255,151,151,64,281482
32347,2.2e-05,172.31.40.0-255,66,217,64,281482
32348,2.9e-05,74.125.68.0-255,1484,1701,64,281482
32349,3.4e-05,172.31.40.0-255,66,1767,64,281482
32350,4e-05,74.125.68.0-255,2902,4669,64,281482
32351,5.1e-05,172.31.40.0-255,66,4735,64,281482
32352,5.8e-05,74.125.68.0-255,5738,10473,64,281482
32353,6.1e-05,172.31.40.0-255,66,10539,64,281482
32354,9.9e-05,74.125.68.0-255,3447,13986,64,281482
32355,0.000101,172.31.40.0-255,66,14052,64,281482
32356,0.000246,74.125.68.0-255,1484,15536,64,281482
32357,0.000251,172.31.40.0-255,66,15602,64,281482
32358,0.000256,74.125.68.0-255,2902,18504,64,281482
32359,0.000258,172.31.40.0-255,66,18570,64,281482
32360,0.00028,74.125.68.0-255,5738,24308,64,281482
32361,0.000283,172.31.40.0-255,66,24374,64,281482
32362,0.000327,74.125.68.0-255,6797,31171,64,281482
32363,0.00033,172.31.40.0-255,66,31237,64,281482
32364,0.000454,74.125.68.0-255,1484,32721,64,281482
32365,0.000458,172.31.40.0-255,66,32787,64,281482
32366,0.000462,74.125.68.0-255,1484,34271,64,281482
32367,0.000463,172.31.40.0-255,66,34337,64,281482
32368,0.000484,74.125.68.0-255,1484,35821,64,281482
32369,0.00049,172.31.40.0-255,66,35887,64,281482
32370,0.000493,74.125.68.0-255,1484,37371,64,281482
32371,0.000495,172.31.40.0-255,66,37437,64,281482
32372,0.000529,74.125.68.0-255,2902,40339,64,281482
32373,0.000535,74.125.68.0-255,5738,46077,64,281482
32374,0.000538,74.125.68.0-255,2543,48620,64,281482
32375,0.000542,74.125.68.0-255,2902,51522,64,281482
32376,0.000547,172.31.40.0-255,66,51588,64,281482
32377,0.00055,172.31.40.0-255,66,51654,64,281482
32378,0.000552,172.31.40.0-255,66,51720,64,281482
32379,0.000555,172.31.40.0-255,66,51786,64,281482
32380,0.000579,74.125.68.0-255,7156,58942,64,281482
32381,0.000582,172.31.40.0-255,66,59008,64,281482
32382,0.000589,74.125.68.0-255,7104,66112,64,281482
32383,0.000591,172.31.40.0-255,66,66178,64,281482
32384,0.000998,74.125.68.0-255,113,66291,64,281482
32385,0.001125,172.31.40.0-255,66,66357,64,281482
32386,0.001143,74.125.68.0-255,1484,67841,64,281482
32387,0.001148,74.125.68.0-255,2902,70743,64,281482
32388,0.001151,172.31.40.0-255,66,70809,64,281482
32389,0.001158,74.125.68.0-255,5738,76547,64,281482
32390,0.001161,172.31.40.0-255,66,76613,64,281482
32391,0.001167,74.125.68.0-255,5738,82351,64,281482
32392,0.001169,172.31.40.0-255,66,82417,64,281482
32393,0.001193,74.125.68.0-255,1484,83901,64,281482
32394,0.001201,74.125.68.0-255,7156,91057,64,281482
32395,0.001203,172.31.40.0-255,66,91123,64,281482
32396,0.00125,172.31.40.0-255,66,91189,64,281482
32397,0.001275,74.125.68.0-255,766,91955,64,281482
32398,0.001313,74.125.68.0-255,331,92286,64,281482
32399,0.001526,172.31.40.0-255,66,92352,64,281482
32400,0.001724,74.125.68.0-255,1484,93836,64,281482
32401,0.001772,74.125.68.0-255,2902,96738,64,281482
32402,0.001776,172.31.40.0-255,66,96804,64,281482
32403,0.001783,74.125.68.0-255,4320,101124,64,281482
32404,0.001785,172.31.40.0-255,66,101190,64,281482
32405,0.001797,74.125.68.0-255,7156,108346,64,281482
32406,0.001799,172.31.40.0-255,66,108412,64,281482
32407,0.001829,74.125.68.0-255,1484,109896,64,281482
32408,0.001835,74.125.68.0-255,4320,114216,64,281482
32409,0.001838,172.31.40.0-255,66,114282,64,281482
32410,0.001862,74.125.68.0-255,2902,117184,64,281482
32411,0.001864,172.31.40.0-255,66,117250,64,281482
32412,0.0019,172.31.40.0-255,66,117316,64,281482
32413,0.003891,74.125.68.0-255,5738,123054,64,281482
32414,0.003898,172.31.40.0-255,66,123120,64,281482
32415,0.005897,74.125.68.0-255,4320,127440,64,281482
32416,0.005903,172.31.40.0-255,66,127506,64,281482
32417,0.00593,74.125.68.0-255,1484,128990,64,281482
32418,0.007886,74.125.68.0-255,4320,133310,64,281482
32419,0.00789,172.31.40.0-255,66,133376,64,281482
32420,0.009883,74.125.68.0-255,5738,139114,64,281482
32421,0.009889,172.31.40.0-255,66,139180,64,281482
32422,0.011884,74.125.68.0-255,5738,144918,64,281482
32423,0.011891,172.31.40.0-255,66,144984,64,281482
32424,0.013892,74.125.68.0-255,5738,150722,64,281482
32425,0.013899,172.31.40.0-255,66,150788,64,281482
32426,0.015889,74.125.68.0-255,5738,156526,64,281482
32427,0.015897,172.31.40.0-255,66,156592,64,281482
32428,0.01789,74.125.68.0-255,5738,162330,64,281482
32429,0.017898,172.31.40.0-255,66,162396,64,281482
32430,0.019896,74.125.68.0-255,5738,168134,64,281482
32431,0.019903,172.31.40.0-255,66,168200,64,281482
32432,0.021898,74.125.68.0-255,5738,173938,64,281482
32433,0.021906,172.31.40.0-255,66,174004,64,281482
32434,0.023906,74.125.68.0-255,5738,179742,64,281482
32435,0.023914,172.31.40.0-255,66,179808,64,281482
32436,0.02591,74.125.68.0-255,1484,181292,64,281482
32437,0.025933,74.125.68.0-255,4320,185612,64,281482
32438,0.025938,172.31.40.0-255,66,185678,64,281482
32439,0.027981,74.125.68.0-255,5738,191416,64,281482
32440,0.027989,172.31.40.0-255,66,191482,64,281482
32441,0.029664,172.31.40.0-255,172,191654,64,281482
32442,0.029698,172.31.40.0-255,1112,192766,64,281482
32443,0.029755,172.31.40.0-255,1514,194280,64,281482
32444,0.029757,172.31.40.0-255,1296,195576,64,281482
32445,0.029984,74.125.68.0-255,5738,201314,64,281482
32446,0.029991,172.31.40.0-255,66,201380,64,281482
32447,0.031204,104.244.42.0-255,66,201446,64,281482
32448,0.031275,104.244.42.0-255,66,201512,64,281482
32449,0.031317,104.244.42.0-255,66,201578,64,281482
32450,0.031997,74.125.68.0-255,5738,207316,64,281482
32451,0.032004,172.31.40.0-255,66,207382,64,281482
32452,0.034013,74.125.68.0-255,5738,213120,64,281482
32453,0.03402,172.31.40.0-255,66,213186,64,281482
32454,0.036024,74.125.68.0-255,5738,218924,64,281482
32455,0.036031,172.31.40.0-255,66,218990,64,281482
32456,0.038043,74.125.68.0-255,5738,224728,64,281482
32457,0.038049,172.31.40.0-255,66,224794,64,281482
32458,0.040056,74.125.68.0-255,5738,230532,64,281482
32459,0.040063,172.31.40.0-255,66,230598,64,281482
32460,0.042069,74.125.68.0-255,5738,236336,64,281482
32461,0.042075,172.31.40.0-255,66,236402,64,281482
32462,0.044077,74.125.68.0-255,5738,242140,64,281482
32463,0.044084,172.31.40.0-255,66,242206,64,281482
32464,0.046105,74.125.68.0-255,5738,247944,64,281482
32465,0.046111,172.31.40.0-255,66,248010,64,281482
32466,0.048101,74.125.68.0-255,4320,252330,64,281482
32467,0.048107,172.31.40.0-255,66,252396,64,281482
32468,0.048136,74.125.68.0-255,1484,253880,64,281482
32469,0.050106,74.125.68.0-255,4320,258200,64,281482
32470,0.050113,172.31.40.0-255,66,258266,64,281482
32471,0.052095,74.125.68.0-255,5738,264004,64,281482
32472,0.052102,172.31.40.0-255,66,264070,64,281482
32473,0.054096,74.125.68.0-255,5738,269808,64,281482
32474,0.054102,172.31.40.0-255,66,269874,64,281482
32475,0.05615,74.125.68.0-255,5738,275612,64,281482
32476,0.056157,172.31.40.0-255,66,275678,64,281482
32477,0.058171,74.125.68.0-255,5738,281416,64,281482
32478,0.058176,172.31.40.0-255,66,281482,64,281482
32479,0.0,74.125.200.0-255,146,146,64,337747
32480,2.7e-05,172.31.40.0-255,66,212,64,337747
32481,3.5e-05,74.125.200.0-255,1484,1696,64,337747
32482,4.1e-05,172.31.40.0-255,66,1762,64,337747
32483,4.4e-05,74.125.200.0-255,1484,3246,64,337747
32484,5.6e-05,172.31.40.0-255,66,3312,64,337747
32485,6.2e-05,74.125.200.0-255,2902,6214,64,337747
32486,6.5e-05,172.31.40.0-255,66,6280,64,337747
32487,9.6e-05,74.125.200.0-255,1484,7764,64,337747
32488,9.9e-05,172.31.40.0-255,66,7830,64,337747
32489,0.000105,74.125.200.0-255,2902,10732,64,337747
32490,0.000107,172.31.40.0-255,66,10798,64,337747
32491,0.000159,74.125.200.0-255,3517,14315,64,337747
32492,0.000162,172.31.40.0-255,66,14381,64,337747
32493,0.000167,74.125.200.0-255,4320,18701,64,337747
32494,0.00017,172.31.40.0-255,66,18767,64,337747
32495,0.000181,172.31.40.0-255,66,18833,64,337747
32496,0.000185,74.125.200.0-255,2543,21376,64,337747
32497,0.000188,172.31.40.0-255,66,21442,64,337747
32498,0.000336,74.125.200.0-255,1484,22926,64,337747
32499,0.00034,172.31.40.0-255,66,22992,64,337747
32500,0.00036,74.125.200.0-255,2902,25894,64,337747
32501,0.000363,172.31.40.0-255,66,25960,64,337747
32502,0.000366,74.125.200.0-255,1484,27444,64,337747
32503,0.000368,172.31.40.0-255,66,27510,64,337747
32504,0.000398,74.125.200.0-255,4320,31830,64,337747
32505,0.000401,172.31.40.0-255,66,31896,64,337747
32506,0.000409,74.125.200.0-255,6797,38693,64,337747
32507,0.000411,172.31.40.0-255,66,38759,64,337747
32508,0.00045,74.125.200.0-255,4320,43079,64,337747
32509,0.000452,172.31.40.0-255,66,43145,64,337747
32510,0.000483,74.125.200.0-255,7156,50301,64,337747
32511,0.000486,172.31.40.0-255,66,50367,64,337747
32512,0.000492,74.125.200.0-255,5691,56058,64,337747
32513,0.000495,172.31.40.0-255,66,56124,64,337747
32514,0.000497,74.125.200.0-255,111,56235,64,337747
32515,0.0005,172.31.40.0-255,66,56301,64,337747
32516,0.000612,74.125.200.0-255,1484,57785,64,337747
32517,0.000616,172.31.40.0-255,66,57851,64,337747
32518,0.00062,74.125.200.0-255,1484,59335,64,337747
32519,0.000622,172.31.40.0-255,66,59401,64,337747
32520,0.000626,74.125.200.0-255,1484,60885,64,337747
32521,0.000633,172.31.40.0-255,66,60951,64,337747
32522,0.000667,74.125.200.0-255,1484,62435,64,337747
32523,0.00067,172.31.40.0-255,66,62501,64,337747
32524,0.000676,74.125.200.0-255,5738,68239,64,337747
32525,0.000679,172.31.40.0-255,66,68305,64,337747
32526,0.000684,74.125.200.0-255,4320,72625,64,337747
32527,0.000686,172.31.40.0-255,66,72691,64,337747
32528,0.000716,74.125.200.0-255,3961,76652,64,337747
32529,0.000718,172.31.40.0-255,66,76718,64,337747
32530,0.000752,172.31.40.0-255,66,76784,64,337747
32531,0.000785,74.125.200.0-255,2902,79686,64,337747
32532,0.000789,172.31.40.0-255,66,79752,64,337747
32533,0.000801,74.125.200.0-255,2543,82295,64,337747
32534,0.000807,172.31.40.0-255,66,82361,64,337747
32535,0.00087,74.125.200.0-255,1484,83845,64,337747
32536,0.000874,172.31.40.0-255,66,83911,64,337747
32537,0.000878,74.125.200.0-255,1484,85395,64,337747
32538,0.00088,172.31.40.0-255,66,85461,64,337747
32539,0.000914,74.125.200.0-255,1484,86945,64,337747
32540,0.000917,172.31.40.0-255,66,87011,64,337747
32541,0.000923,74.125.200.0-255,5738,92749,64,337747
32542,0.000925,172.31.40.0-255,66,92815,64,337747
32543,0.000955,74.125.200.0-255,1484,94299,64,337747
32544,0.000957,172.31.40.0-255,66,94365,64,337747
32545,0.000983,74.125.200.0-255,2902,97267,64,337747
32546,0.000986,172.31.40.0-255,66,97333,64,337747
32547,0.001012,74.125.200.0-255,4320,101653,64,337747
32548,0.001015,172.31.40.0-255,66,101719,64,337747
32549,0.001021,74.125.200.0-255,4320,106039,64,337747
32550,0.001028,172.31.40.0-255,66,106105,64,337747
32551,0.001043,74.125.200.0-255,4320,110425,64,337747
32552,0.001053,74.125.200.0-255,5738,116163,64,337747
32553,0.001058,172.31.40.0-255,66,116229,64,337747
32554,0.001088,74.125.200.0-255,766,116995,64,337747
32555,0.001249,74.125.200.0-255,1484,118479,64,337747
32556,0.001254,74.125.200.0-255,1484,119963,64,337747
32557,0.001264,172.31.40.0-255,66,120029,64,337747
32558,0.001271,74.125.200.0-255,1484,121513,64,337747
32559,0.001273,74.125.200.0-255,1484,122997,64,337747
32560,0.001291,74.125.200.0-255,4320,127317,64,337747
32561,0.001295,74.125.200.0-255,2902,130219,64,337747
32562,0.0013,74.125.200.0-255,4320,134539,64,337747
32563,0.001309,172.31.40.0-255,66,134605,64,337747
32564,0.001354,172.31.40.0-255,66,134671,64,337747
32565,0.001608,74.125.200.0-255,1484,136155,64,337747
32566,0.001613,74.125.200.0-255,1484,137639,64,337747
32567,0.001616,172.31.40.0-255,66,137705,64,337747
32568,0.001639,74.125.200.0-255,1484,139189,64,337747
32569,0.001645,74.125.200.0-255,5738,144927,64,337747
32570,0.001648,172.31.40.0-255,66,144993,64,337747
32571,0.001652,74.125.200.0-255,2902,147895,64,337747
32572,0.001759,172.31.40.0-255,66,147961,64,337747
32573,0.001788,74.125.200.0-255,5738,153699,64,337747
32574,0.001813,74.125.200.0-255,5738,159437,64,337747
32575,0.00182,74.125.200.0-255,7156,166593,64,337747
32576,0.001831,172.31.40.0-255,66,166659,64,337747
32577,0.001855,74.125.200.0-255,5020,171679,64,337747
32578,0.001868,172.31.40.0-255,66,171745,64,337747
32579,0.00187,74.125.200.0-255,1484,173229,64,337747
32580,0.001884,74.125.200.0-255,1484,174713,64,337747
32581,0.001904,74.125.200.0-255,2902,177615,64,337747
32582,0.00191,74.125.200.0-255,5738,183353,64,337747
32583,0.001912,172.31.40.0-255,66,183419,64,337747
32584,0.001917,172.31.40.0-255,66,183485,64,337747
32585,0.001946,74.125.200.0-255,5738,189223,64,337747
32586,0.00197,74.125.200.0-255,5738,194961,64,337747
32587,0.001983,74.125.200.0-255,1484,196445,64,337747
32588,0.001998,74.125.200.0-255,1484,197929,64,337747
32589,0.002003,172.31.40.0-255,66,197995,64,337747
32590,0.00202,74.125.200.0-255,7156,205151,64,337747
32591,0.002033,74.125.200.0-255,766,205917,64,337747
32592,0.002044,172.31.40.0-255,66,205983,64,337747
32593,0.002067,74.125.200.0-255,1484,207467,64,337747
32594,0.002082,74.125.200.0-255,2902,210369,64,337747
32595,0.002087,172.31.40.0-255,66,210435,64,337747
32596,0.002094,74.125.200.0-255,1484,211919,64,337747
32597,0.002097,74.125.200.0-255,1484,213403,64,337747
32598,0.002124,74.125.200.0-255,5738,219141,64,337747
32599,0.002131,74.125.200.0-255,5738,224879,64,337747
32600,0.002143,74.125.200.0-255,2902,227781,64,337747
32601,0.002155,74.125.200.0-255,2902,230683,64,337747
32602,0.002161,172.31.40.0-255,66,230749,64,337747
32603,0.002199,172.31.40.0-255,66,230815,64,337747
32604,0.002217,74.125.200.0-255,4320,235135,64,337747
32605,0.002247,74.125.200.0-255,5738,240873,64,337747
32606,0.002251,74.125.200.0-255,2902,243775,64,337747
32607,0.002259,172.31.40.0-255,66,243841,64,337747
32608,0.002277,74.125.200.0-255,4320,248161,64,337747
32609,0.00229,172.31.40.0-255,66,248227,64,337747
32610,0.004459,74.125.200.0-255,1484,249711,64,337747
32611,0.004478,74.125.200.0-255,4320,254031,64,337747
32612,0.004483,172.31.40.0-255,66,254097,64,337747
32613,0.006674,74.125.200.0-255,2902,256999,64,337747
32614,0.006688,74.125.200.0-255,2902,259901,64,337747
32615,0.008356,172.31.40.0-255,66,259967,64,337747
32616,0.010553,74.125.200.0-255,1484,261451,64,337747
32617,0.010559,172.31.40.0-255,66,261517,64,337747
32618,0.010589,74.125.200.0-255,4320,265837,64,337747
32619,0.010592,172.31.40.0-255,66,265903,64,337747
32620,0.012763,74.125.200.0-255,1484,267387,64,337747
32621,0.012772,172.31.40.0-255,66,267453,64,337747
32622,0.012807,74.125.200.0-255,4320,271773,64,337747
32623,0.012811,172.31.40.0-255,66,271839,64,337747
32624,0.014965,74.125.200.0-255,1484,273323,64,337747
32625,0.014992,74.125.200.0-255,1484,274807,64,337747
32626,0.014997,172.31.40.0-255,66,274873,64,337747
32627,0.015018,74.125.200.0-255,2902,277775,64,337747
32628,0.015022,172.31.40.0-255,66,277841,64,337747
32629,0.017218,74.125.200.0-255,5738,283579,64,337747
32630,0.017232,172.31.40.0-255,66,283645,64,337747
32631,0.019437,74.125.200.0-255,5738,289383,64,337747
32632,0.019445,172.31.40.0-255,66,289449,64,337747
32633,0.021658,74.125.200.0-255,5738,295187,64,337747
32634,0.021673,172.31.40.0-255,66,295253,64,337747
32635,0.023887,74.125.200.0-255,5738,300991,64,337747
32636,0.023895,172.31.40.0-255,66,301057,64,337747
32637,0.026138,74.125.200.0-255,5738,306795,64,337747
32638,0.026146,172.31.40.0-255,66,306861,64,337747
32639,0.028353,74.125.200.0-255,5738,312599,64,337747
32640,0.028362,172.31.40.0-255,66,312665,64,337747
32641,0.030581,74.125.200.0-255,5738,318403,64,337747
32642,0.030598,172.31.40.0-255,66,318469,64,337747
32643,0.032807,74.125.200.0-255,5738,324207,64,337747
32644,0.032817,172.31.40.0-255,66,324273,64,337747
32645,0.035044,74.125.200.0-255,5738,330011,64,337747
32646,0.035062,172.31.40.0-255,66,330077,64,337747
32647,0.037283,74.125.200.0-255,3141,333218,64,337747
32648,0.037295,172.31.40.0-255,66,333284,64,337747
32649,0.037871,172.31.40.0-255,105,333389,64,337747
32650,0.040055,74.125.200.0-255,66,333455,64,337747
32651,0.049498,172.31.40.0-255,172,333627,64,337747
32652,0.049536,172.31.40.0-255,1113,334740,64,337747
32653,0.049595,172.31.40.0-255,1514,336254,64,337747
32654,0.049616,172.31.40.0-255,1295,337549,64,337747
32655,0.051035,104.244.42.0-255,66,337615,64,337747
32656,0.051167,104.244.42.0-255,66,337681,64,337747
32657,0.051172,104.244.42.0-255,66,337747,64,337747
32658,0.0,172.253.118.0-255,146,146,64,192413
32659,2.3e-05,172.31.40.0-255,66,212,64,192413
32660,3.1e-05,172.253.118.0-255,1484,1696,64,192413
32661,3.5e-05,172.31.40.0-255,66,1762,64,192413
32662,4e-05,172.253.118.0-255,2902,4664,64,192413
32663,4.3e-05,172.31.40.0-255,66,4730,64,192413
32664,5.1e-05,172.253.118.0-255,7156,11886,64,192413
32665,5.5e-05,172.31.40.0-255,66,11952,64,192413
32666,5.9e-05,172.253.118.0-255,2018,13970,64,192413
32667,6.2e-05,172.31.40.0-255,66,14036,64,192413
32668,9.3e-05,172.31.40.0-255,66,14102,64,192413
32669,0.0001,172.253.118.0-255,5738,19840,64,192413
32670,0.000102,172.31.40.0-255,66,19906,64,192413
32671,0.000117,172.253.118.0-255,5738,25644,64,192413
32672,0.00012,172.31.40.0-255,66,25710,64,192413
32673,0.000162,172.253.118.0-255,5738,31448,64,192413
32674,0.000165,172.31.40.0-255,66,31514,64,192413
32675,0.000203,172.31.40.0-255,66,31580,64,192413
32676,0.000208,172.253.118.0-255,2823,34403,64,192413
32677,0.00021,172.31.40.0-255,66,34469,64,192413
32678,0.000229,172.253.118.0-255,127,34596,64,192413
32679,0.000231,172.31.40.0-255,66,34662,64,192413
32680,0.000336,172.253.118.0-255,1484,36146,64,192413
32681,0.000339,172.31.40.0-255,66,36212,64,192413
32682,0.000353,172.253.118.0-255,2902,39114,64,192413
32683,0.000356,172.31.40.0-255,66,39180,64,192413
32684,0.000385,172.253.118.0-255,5738,44918,64,192413
32685,0.000388,172.31.40.0-255,66,44984,64,192413
32686,0.000445,172.31.40.0-255,66,45050,64,192413
32687,0.000453,172.253.118.0-255,7156,52206,64,192413
32688,0.000455,172.31.40.0-255,66,52272,64,192413
32689,0.00046,172.253.118.0-255,3602,55874,64,192413
32690,0.000462,172.31.40.0-255,66,55940,64,192413
32691,0.000738,172.253.118.0-255,1484,57424,64,192413
32692,0.000745,172.253.118.0-255,2902,60326,64,192413
32693,0.00075,172.31.40.0-255,66,60392,64,192413
32694,0.000756,172.253.118.0-255,4320,64712,64,192413
32695,0.000758,172.31.40.0-255,66,64778,64,192413
32696,0.000775,172.253.118.0-255,1484,66262,64,192413
32697,0.000782,172.253.118.0-255,7156,73418,64,192413
32698,0.000785,172.31.40.0-255,66,73484,64,192413
32699,0.000834,172.31.40.0-255,66,73550,64,192413
32700,0.000837,172.253.118.0-255,2184,75734,64,192413
32701,0.000839,172.31.40.0-255,66,75800,64,192413
32702,0.000896,172.253.118.0-255,1484,77284,64,192413
32703,0.000901,172.253.118.0-255,2902,80186,64,192413
32704,0.000904,172.31.40.0-255,66,80252,64,192413
32705,0.000924,172.253.118.0-255,5738,85990,64,192413
32706,0.000945,172.253.118.0-255,5738,91728,64,192413
32707,0.000972,172.253.118.0-255,7156,98884,64,192413
32708,0.001038,172.31.40.0-255,66,98950,64,192413
32709,0.001277,172.253.118.0-255,1484,100434,64,192413
32710,0.001283,172.253.118.0-255,2902,103336,64,192413
32711,0.00129,172.31.40.0-255,66,103402,64,192413
32712,0.001303,172.253.118.0-255,5738,109140,64,192413
32713,0.001323,172.31.40.0-255,66,109206,64,192413
32714,0.001362,172.31.40.0-255,66,109272,64,192413
32715,0.001383,172.253.118.0-255,5738,115010,64,192413
32716,0.001403,172.253.118.0-255,5020,120030,64,192413
32717,0.001414,172.31.40.0-255,66,120096,64,192413
32718,0.001589,172.253.118.0-255,1484,121580,64,192413
32719,0.001594,172.253.118.0-255,2902,124482,64,192413
32720,0.001597,172.31.40.0-255,66,124548,64,192413
32721,0.001624,172.253.118.0-255,5738,130286,64,192413
32722,0.001632,172.253.118.0-255,7156,137442,64,192413
32723,0.001646,172.31.40.0-255,66,137508,64,192413
32724,0.001665,172.253.118.0-255,5738,143246,64,192413
32725,0.001673,172.31.40.0-255,66,143312,64,192413
32726,0.001702,172.253.118.0-255,2184,145496,64,192413
32727,0.001712,172.31.40.0-255,66,145562,64,192413
32728,0.001752,172.253.118.0-255,4320,149882,64,192413
32729,0.001768,172.31.40.0-255,66,149948,64,192413
32730,0.001783,172.253.118.0-255,5738,155686,64,192413
32731,0.00179,172.253.118.0-255,6438,162124,64,192413
32732,0.001826,172.31.40.0-255,66,162190,64,192413
32733,0.001884,172.31.40.0-255,66,162256,64,192413
32734,0.001924,172.253.118.0-255,7156,169412,64,192413
32735,0.001928,172.31.40.0-255,66,169478,64,192413
32736,0.001933,172.31.40.0-255,66,169544,64,192413
32737,0.001941,172.253.118.0-255,2902,172446,64,192413
32738,0.00197,172.253.118.0-255,4320,176766,64,192413
32739,0.001985,172.31.40.0-255,66,176832,64,192413
32740,0.002041,172.31.40.0-255,66,176898,64,192413
32741,0.00205,172.253.118.0-255,4320,181218,64,192413
32742,0.002055,172.31.40.0-255,66,181284,64,192413
32743,0.002116,172.253.118.0-255,2184,183468,64,192413
32744,0.002118,172.31.40.0-255,66,183534,64,192413
32745,0.002123,172.31.40.0-255,66,183600,64,192413
32746,0.002137,172.253.118.0-255,1484,185084,64,192413
32747,0.002149,172.253.118.0-255,2693,187777,64,192413
32748,0.002164,172.253.118.0-255,105,187882,64,192413
32749,0.002173,172.31.40.0-255,66,187948,64,192413
32750,0.004779,172.31.40.0-255,105,188053,64,192413
32751,0.007299,172.253.118.0-255,66,188119,64,192413
32752,0.033654,172.31.40.0-255,172,188291,64,192413
32753,0.033681,172.31.40.0-255,1112,189403,64,192413
32754,0.033732,172.31.40.0-255,1514,190917,64,192413
32755,0.033733,172.31.40.0-255,1298,192215,64,192413
32756,0.035156,104.244.42.0-255,66,192281,64,192413
32757,0.035193,104.244.42.0-255,66,192347,64,192413
32758,0.035261,104.244.42.0-255,66,192413,64,192413
32759,0.0,172.31.40.0-255,105,105,64,459
32760,0.000209,172.31.40.0-255,90,195,64,459
32761,0.000219,172.31.40.0-255,66,261,64,459
32762,0.002762,74.125.130.0-255,66,327,64,459
32763,0.002793,74.125.130.0-255,66,393,64,459
32764,0.002816,172.31.40.0-255,66,459,64,459
32765,0.0,74.125.200.0-255,297,297,64,263946
32766,2.3e-05,172.31.40.0-255,66,363,64,263946
32767,3e-05,74.125.200.0-255,1484,1847,64,263946
32768,3.5e-05,172.31.40.0-255,66,1913,64,263946
32769,4.2e-05,74.125.200.0-255,4320,6233,64,263946
32770,4.5e-05,172.31.40.0-255,66,6299,64,263946
32771,7.2e-05,74.125.200.0-255,5738,12037,64,263946
32772,7.5e-05,172.31.40.0-255,66,12103,64,263946
32773,9.2e-05,74.125.200.0-255,3220,15323,64,263946
32774,9.4e-05,172.31.40.0-255,66,15389,64,263946
32775,0.00012,74.125.200.0-255,4320,19709,64,263946
32776,0.000122,172.31.40.0-255,66,19775,64,263946
32777,0.000139,74.125.200.0-255,4320,24095,64,263946
32778,0.000142,172.31.40.0-255,66,24161,64,263946
32779,0.000163,74.125.200.0-255,2902,27063,64,263946
32780,0.000165,172.31.40.0-255,66,27129,64,263946
32781,0.000194,74.125.200.0-255,3961,31090,64,263946
32782,0.000197,172.31.40.0-255,66,31156,64,263946
32783,0.001346,74.125.200.0-255,1484,32640,64,263946
32784,0.001353,172.31.40.0-255,66,32706,64,263946
32785,0.001363,74.125.200.0-255,2902,35608,64,263946
32786,0.001365,172.31.40.0-255,66,35674,64,263946
32787,0.00137,74.125.200.0-255,2902,38576,64,263946
32788,0.001373,172.31.40.0-255,66,38642,64,263946
32789,0.001392,74.125.200.0-255,2902,41544,64,263946
32790,0.001394,172.31.40.0-255,66,41610,64,263946
32791,0.001431,74.125.200.0-255,4320,45930,64,263946
32792,0.001433,172.31.40.0-255,66,45996,64,263946
32793,0.001451,74.125.200.0-255,2543,48539,64,263946
32794,0.001453,172.31.40.0-255,66,48605,64,263946
32795,0.001476,74.125.200.0-255,2902,51507,64,263946
32796,0.001479,172.31.40.0-255,66,51573,64,263946
32797,0.001498,74.125.200.0-255,4320,55893,64,263946
32798,0.0015,172.31.40.0-255,66,55959,64,263946
32799,0.001536,74.125.200.0-255,5738,61697,64,263946
32800,0.001538,172.31.40.0-255,66,61763,64,263946
32801,0.001554,74.125.200.0-255,4272,66035,64,263946
32802,0.001556,172.31.40.0-255,66,66101,64,263946
32803,0.001645,74.125.200.0-255,111,66212,64,263946
32804,0.001765,74.125.200.0-255,1484,67696,64,263946
32805,0.001771,172.31.40.0-255,66,67762,64,263946
32806,0.001787,74.125.200.0-255,2902,70664,64,263946
32807,0.001789,172.31.40.0-255,66,70730,64,263946
32808,0.001808,74.125.200.0-255,2902,73632,64,263946
32809,0.00181,172.31.40.0-255,66,73698,64,263946
32810,0.001825,74.125.200.0-255,2902,76600,64,263946
32811,0.001828,172.31.40.0-255,66,76666,64,263946
32812,0.001851,74.125.200.0-255,1484,78150,64,263946
32813,0.001862,172.31.40.0-255,66,78216,64,263946
32814,0.001866,74.125.200.0-255,2902,81118,64,263946
32815,0.001868,172.31.40.0-255,66,81184,64,263946
32816,0.00192,74.125.200.0-255,7156,88340,64,263946
32817,0.001922,172.31.40.0-255,66,88406,64,263946
32818,0.00194,74.125.200.0-255,3602,92008,64,263946
32819,0.001942,172.31.40.0-255,66,92074,64,263946
32820,0.003077,172.31.40.0-255,101,92175,64,263946
32821,0.003852,74.125.200.0-255,1484,93659,64,263946
32822,0.003872,74.125.200.0-255,4320,97979,64,263946
32823,0.003877,172.31.40.0-255,66,98045,64,263946
32824,0.004978,74.125.200.0-255,66,98111,64,263946
32825,0.005841,74.125.200.0-255,5738,103849,64,263946
32826,0.005844,172.31.40.0-255,66,103915,64,263946
32827,0.007794,74.125.200.0-255,5738,109653,64,263946
32828,0.007801,172.31.40.0-255,66,109719,64,263946
32829,0.009761,74.125.200.0-255,5738,115457,64,263946
32830,0.00977,172.31.40.0-255,66,115523,64,263946
32831,0.011721,74.125.200.0-255,5738,121261,64,263946
32832,0.01173,172.31.40.0-255,66,121327,64,263946
32833,0.013688,74.125.200.0-255,5738,127065,64,263946
32834,0.013698,172.31.40.0-255,66,127131,64,263946
32835,0.015647,74.125.200.0-255,5738,132869,64,263946
32836,0.015657,172.31.40.0-255,66,132935,64,263946
32837,0.017611,74.125.200.0-255,5738,138673,64,263946
32838,0.017625,172.31.40.0-255,66,138739,64,263946
32839,0.019564,74.125.200.0-255,5738,144477,64,263946
32840,0.019574,172.31.40.0-255,66,144543,64,263946
32841,0.021524,74.125.200.0-255,5738,150281,64,263946
32842,0.021533,172.31.40.0-255,66,150347,64,263946
32843,0.023476,74.125.200.0-255,5738,156085,64,263946
32844,0.023483,172.31.40.0-255,66,156151,64,263946
32845,0.024435,172.31.40.0-255,166,156317,64,263946
32846,0.024474,172.31.40.0-255,1146,157463,64,263946
32847,0.024535,172.31.40.0-255,1514,158977,64,263946
32848,0.024537,172.31.40.0-255,299,159276,64,263946
32849,0.025433,74.125.200.0-255,5738,165014,64,263946
32850,0.025441,172.31.40.0-255,66,165080,64,263946
32851,0.026009,104.244.42.0-255,66,165146,64,263946
32852,0.026018,104.244.42.0-255,66,165212,64,263946
32853,0.026058,104.244.42.0-255,66,165278,64,263946
32854,0.027404,74.125.200.0-255,5738,171016,64,263946
32855,0.027415,172.31.40.0-255,66,171082,64,263946
32856,0.029368,74.125.200.0-255,5738,176820,64,263946
32857,0.029377,172.31.40.0-255,66,176886,64,263946
32858,0.031334,74.125.200.0-255,5738,182624,64,263946
32859,0.031341,172.31.40.0-255,66,182690,64,263946
32860,0.033297,74.125.200.0-255,5738,188428,64,263946
32861,0.033303,172.31.40.0-255,66,188494,64,263946
32862,0.035263,74.125.200.0-255,5738,194232,64,263946
32863,0.03527,172.31.40.0-255,66,194298,64,263946
32864,0.037223,74.125.200.0-255,5738,200036,64,263946
32865,0.037229,172.31.40.0-255,66,200102,64,263946
32866,0.03919,74.125.200.0-255,5738,205840,64,263946
32867,0.039197,172.31.40.0-255,66,205906,64,263946
32868,0.041154,74.125.200.0-255,5738,211644,64,263946
32869,0.04116,172.31.40.0-255,66,211710,64,263946
32870,0.043115,74.125.200.0-255,5738,217448,64,263946
32871,0.043124,172.31.40.0-255,66,217514,64,263946
32872,0.045074,74.125.200.0-255,5738,223252,64,263946
32873,0.04508,172.31.40.0-255,66,223318,64,263946
32874,0.047025,74.125.200.0-255,5738,229056,64,263946
32875,0.047032,172.31.40.0-255,66,229122,64,263946
32876,0.048976,74.125.200.0-255,5738,234860,64,263946
32877,0.048984,172.31.40.0-255,66,234926,64,263946
32878,0.050929,74.125.200.0-255,5738,240664,64,263946
32879,0.050935,172.31.40.0-255,66,240730,64,263946
32880,0.0529,74.125.200.0-255,5738,246468,64,263946
32881,0.052907,172.31.40.0-255,66,246534,64,263946
32882,0.05486,74.125.200.0-255,5738,252272,64,263946
32883,0.054874,172.31.40.0-255,66,252338,64,263946
32884,0.056831,74.125.200.0-255,5738,258076,64,263946
32885,0.056846,172.31.40.0-255,66,258142,64,263946
32886,0.058799,74.125.200.0-255,5738,263880,64,263946
32887,0.058812,172.31.40.0-255,66,263946,64,263946
32888,0.0,216.58.221.0-255,298,298,64,310358
32889,1.9e-05,172.31.40.0-255,66,364,64,310358
32890,2.4e-05,216.58.221.0-255,1484,1848,64,310358
32891,2.8e-05,172.31.40.0-255,66,1914,64,310358
32892,3.6e-05,216.58.221.0-255,2902,4816,64,310358
32893,3.9e-05,172.31.40.0-255,66,4882,64,310358
32894,7.5e-05,216.58.221.0-255,1484,6366,64,310358
32895,7.8e-05,172.31.40.0-255,66,6432,64,310358
32896,9e-05,172.31.40.0-255,66,6498,64,310358
32897,0.000106,172.31.40.0-255,66,6564,64,310358
32898,0.000109,216.58.221.0-255,1484,8048,64,310358
32899,0.000111,172.31.40.0-255,66,8114,64,310358
32900,0.000144,216.58.221.0-255,5738,13852,64,310358
32901,0.000148,172.31.40.0-255,66,13918,64,310358
32902,0.000172,216.58.221.0-255,1125,15043,64,310358
32903,0.000175,172.31.40.0-255,66,15109,64,310358
32904,0.000284,216.58.221.0-255,1484,16593,64,310358
32905,0.000288,172.31.40.0-255,66,16659,64,310358
32906,0.000293,216.58.221.0-255,2902,19561,64,310358
32907,0.000296,172.31.40.0-255,66,19627,64,310358
32908,0.000299,216.58.221.0-255,1484,21111,64,310358
32909,0.000301,172.31.40.0-255,66,21177,64,310358
32910,0.000341,216.58.221.0-255,4320,25497,64,310358
32911,0.000345,172.31.40.0-255,66,25563,64,310358
32912,0.000351,216.58.221.0-255,5738,31301,64,310358
32913,0.000353,172.31.40.0-255,66,31367,64,310358
32914,0.000364,216.58.221.0-255,6797,38164,64,310358
32915,0.000367,172.31.40.0-255,66,38230,64,310358
32916,0.000419,172.31.40.0-255,66,38296,64,310358
32917,0.000999,216.58.221.0-255,136,38432,64,310358
32918,0.001104,216.58.221.0-255,1484,39916,64,310358
32919,0.001109,216.58.221.0-255,2902,42818,64,310358
32920,0.001114,172.31.40.0-255,66,42884,64,310358
32921,0.001119,172.31.40.0-255,66,42950,64,310358
32922,0.001145,216.58.221.0-255,2902,45852,64,310358
32923,0.001152,172.31.40.0-255,66,45918,64,310358
32924,0.001158,216.58.221.0-255,4320,50238,64,310358
32925,0.001159,172.31.40.0-255,66,50304,64,310358
32926,0.001193,216.58.221.0-255,5379,55683,64,310358
32927,0.001196,172.31.40.0-255,66,55749,64,310358
32928,0.001203,216.58.221.0-255,5738,61487,64,310358
32929,0.001205,172.31.40.0-255,66,61553,64,310358
32930,0.001231,216.58.221.0-255,4320,65873,64,310358
32931,0.001233,172.31.40.0-255,66,65939,64,310358
32932,0.001267,216.58.221.0-255,6797,72736,64,310358
32933,0.001269,172.31.40.0-255,66,72802,64,310358
32934,0.001409,216.58.221.0-255,1484,74286,64,310358
32935,0.001425,216.58.221.0-255,2902,77188,64,310358
32936,0.001428,172.31.40.0-255,66,77254,64,310358
32937,0.001434,216.58.221.0-255,5738,82992,64,310358
32938,0.001436,172.31.40.0-255,66,83058,64,310358
32939,0.001439,216.58.221.0-255,1484,84542,64,310358
32940,0.001469,216.58.221.0-255,5738,90280,64,310358
32941,0.001472,172.31.40.0-255,66,90346,64,310358
32942,0.001486,172.31.40.0-255,66,90412,64,310358
32943,0.001494,216.58.221.0-255,2184,92596,64,310358
32944,0.001497,172.31.40.0-255,66,92662,64,310358
32945,0.001529,216.58.221.0-255,2902,95564,64,310358
32946,0.001532,216.58.221.0-255,1484,97048,64,310358
32947,0.001535,172.31.40.0-255,66,97114,64,310358
32948,0.001566,216.58.221.0-255,2902,100016,64,310358
32949,0.00157,172.31.40.0-255,66,100082,64,310358
32950,0.001581,172.31.40.0-255,66,100148,64,310358
32951,0.001587,216.58.221.0-255,1484,101632,64,310358
32952,0.001649,172.31.40.0-255,66,101698,64,310358
32953,0.001676,216.58.221.0-255,2184,103882,64,310358
32954,0.001678,216.58.221.0-255,1484,105366,64,310358
32955,0.001682,172.31.40.0-255,66,105432,64,310358
32956,0.001716,216.58.221.0-255,2902,108334,64,310358
32957,0.001719,172.31.40.0-255,66,108400,64,310358
32958,0.001725,216.58.221.0-255,5738,114138,64,310358
32959,0.001727,172.31.40.0-255,66,114204,64,310358
32960,0.001744,172.31.40.0-255,66,114270,64,310358
32961,0.001778,216.58.221.0-255,1484,115754,64,310358
32962,0.001791,172.31.40.0-255,66,115820,64,310358
32963,0.00186,216.58.221.0-255,1484,117304,64,310358
32964,0.001866,216.58.221.0-255,2902,120206,64,310358
32965,0.001869,172.31.40.0-255,66,120272,64,310358
32966,0.001873,216.58.221.0-255,2902,123174,64,310358
32967,0.001875,172.31.40.0-255,66,123240,64,310358
32968,0.001911,216.58.221.0-255,2902,126142,64,310358
32969,0.001914,172.31.40.0-255,66,126208,64,310358
32970,0.00192,216.58.221.0-255,4320,130528,64,310358
32971,0.001923,172.31.40.0-255,66,130594,64,310358
32972,0.001928,216.58.221.0-255,5738,136332,64,310358
32973,0.001935,172.31.40.0-255,66,136398,64,310358
32974,0.001948,172.31.40.0-255,66,136464,64,310358
32975,0.001952,216.58.221.0-255,2184,138648,64,310358
32976,0.001955,172.31.40.0-255,66,138714,64,310358
32977,0.003885,216.58.221.0-255,5738,144452,64,310358
32978,0.003891,172.31.40.0-255,66,144518,64,310358
32979,0.005831,216.58.221.0-255,5738,150256,64,310358
32980,0.005838,172.31.40.0-255,66,150322,64,310358
32981,0.007781,216.58.221.0-255,5738,156060,64,310358
32982,0.007788,172.31.40.0-255,66,156126,64,310358
32983,0.009744,216.58.221.0-255,5738,161864,64,310358
32984,0.00976,172.31.40.0-255,66,161930,64,310358
32985,0.01171,216.58.221.0-255,5738,167668,64,310358
32986,0.011724,172.31.40.0-255,66,167734,64,310358
32987,0.013663,216.58.221.0-255,5738,173472,64,310358
32988,0.01367,172.31.40.0-255,66,173538,64,310358
32989,0.015613,216.58.221.0-255,5738,179276,64,310358
32990,0.015621,172.31.40.0-255,66,179342,64,310358
32991,0.017567,216.58.221.0-255,5738,185080,64,310358
32992,0.017581,172.31.40.0-255,66,185146,64,310358
32993,0.019524,216.58.221.0-255,5738,190884,64,310358
32994,0.019531,172.31.40.0-255,66,190950,64,310358
32995,0.021471,216.58.221.0-255,5738,196688,64,310358
32996,0.021479,172.31.40.0-255,66,196754,64,310358
32997,0.023422,216.58.221.0-255,5738,202492,64,310358
32998,0.02343,172.31.40.0-255,66,202558,64,310358
32999,0.025398,216.58.221.0-255,5738,208296,64,310358
33000,0.025405,172.31.40.0-255,66,208362,64,310358
33001,0.027362,216.58.221.0-255,5738,214100,64,310358
33002,0.027376,172.31.40.0-255,66,214166,64,310358
33003,0.029314,216.58.221.0-255,5738,219904,64,310358
33004,0.029321,172.31.40.0-255,66,219970,64,310358
33005,0.031264,216.58.221.0-255,5738,225708,64,310358
33006,0.031272,172.31.40.0-255,66,225774,64,310358
33007,0.033211,216.58.221.0-255,5738,231512,64,310358
33008,0.033218,172.31.40.0-255,66,231578,64,310358
33009,0.035184,216.58.221.0-255,5738,237316,64,310358
33010,0.0352,172.31.40.0-255,66,237382,64,310358
33011,0.037142,216.58.221.0-255,5738,243120,64,310358
33012,0.037149,172.31.40.0-255,66,243186,64,310358
33013,0.039102,216.58.221.0-255,5738,248924,64,310358
33014,0.039117,172.31.40.0-255,66,248990,64,310358
33015,0.041112,216.58.221.0-255,5738,254728,64,310358
33016,0.041127,172.31.40.0-255,66,254794,64,310358
33017,0.043086,216.58.221.0-255,5738,260532,64,310358
33018,0.043098,172.31.40.0-255,66,260598,64,310358
33019,0.045066,216.58.221.0-255,5738,266336,64,310358
33020,0.045072,172.31.40.0-255,66,266402,64,310358
33021,0.047027,216.58.221.0-255,5738,272140,64,310358
33022,0.04704,172.31.40.0-255,66,272206,64,310358
33023,0.048803,172.31.40.0-255,172,272378,64,310358
33024,0.048836,172.31.40.0-255,1113,273491,64,310358
33025,0.048894,172.31.40.0-255,1514,275005,64,310358
33026,0.048895,172.31.40.0-255,331,275336,64,310358
33027,0.048977,216.58.221.0-255,5738,281074,64,310358
33028,0.048982,172.31.40.0-255,66,281140,64,310358
33029,0.050373,104.244.42.0-255,66,281206,64,310358
33030,0.05041,104.244.42.0-255,66,281272,64,310358
33031,0.050456,104.244.42.0-255,66,281338,64,310358
33032,0.050918,216.58.221.0-255,5738,287076,64,310358
33033,0.050924,172.31.40.0-255,66,287142,64,310358
33034,0.052881,216.58.221.0-255,5738,292880,64,310358
33035,0.052897,172.31.40.0-255,66,292946,64,310358
33036,0.05486,216.58.221.0-255,5738,298684,64,310358
33037,0.054874,172.31.40.0-255,66,298750,64,310358
33038,0.056813,216.58.221.0-255,5738,304488,64,310358
33039,0.056822,172.31.40.0-255,66,304554,64,310358
33040,0.058774,216.58.221.0-255,5738,310292,64,310358
33041,0.058788,172.31.40.0-255,66,310358,64,310358
33042,0.0,74.125.200.0-255,154,154,64,369470
33043,2.3e-05,172.31.40.0-255,66,220,64,369470
33044,3e-05,74.125.200.0-255,1484,1704,64,369470
33045,3.4e-05,172.31.40.0-255,66,1770,64,369470
33046,4e-05,74.125.200.0-255,2902,4672,64,369470
33047,4.3e-05,172.31.40.0-255,66,4738,64,369470
33048,7.3e-05,74.125.200.0-255,4320,9058,64,369470
33049,7.7e-05,172.31.40.0-255,66,9124,64,369470
33050,8.3e-05,74.125.200.0-255,4986,14110,64,369470
33051,8.5e-05,172.31.40.0-255,66,14176,64,369470
33052,0.000128,74.125.200.0-255,7156,21332,64,369470
33053,0.00013,172.31.40.0-255,66,21398,64,369470
33054,0.000153,74.125.200.0-255,7156,28554,64,369470
33055,0.000156,172.31.40.0-255,66,28620,64,369470
33056,0.000176,74.125.200.0-255,1484,30104,64,369470
33057,0.000179,172.31.40.0-255,66,30170,64,369470
33058,0.000181,74.125.200.0-255,1125,31295,64,369470
33059,0.000184,172.31.40.0-255,66,31361,64,369470
33060,0.000251,74.125.200.0-255,1484,32845,64,369470
33061,0.000255,172.31.40.0-255,66,32911,64,369470
33062,0.000259,74.125.200.0-255,1484,34395,64,369470
33063,0.000261,172.31.40.0-255,66,34461,64,369470
33064,0.000264,74.125.200.0-255,1484,35945,64,369470
33065,0.000266,172.31.40.0-255,66,36011,64,369470
33066,0.000286,74.125.200.0-255,1484,37495,64,369470
33067,0.000289,172.31.40.0-255,66,37561,64,369470
33068,0.000295,74.125.200.0-255,5738,43299,64,369470
33069,0.000298,172.31.40.0-255,66,43365,64,369470
33070,0.000311,74.125.200.0-255,1484,44849,64,369470
33071,0.000313,172.31.40.0-255,66,44915,64,369470
33072,0.000332,74.125.200.0-255,6797,51712,64,369470
33073,0.000335,172.31.40.0-255,66,51778,64,369470
33074,0.000346,172.31.40.0-255,66,51844,64,369470
33075,0.000372,74.125.200.0-255,5659,57503,64,369470
33076,0.000375,172.31.40.0-255,66,57569,64,369470
33077,0.00039,74.125.200.0-255,129,57698,64,369470
33078,0.000576,74.125.200.0-255,1484,59182,64,369470
33079,0.00058,172.31.40.0-255,66,59248,64,369470
33080,0.000586,74.125.200.0-255,2902,62150,64,369470
33081,0.000589,172.31.40.0-255,66,62216,64,369470
33082,0.000614,74.125.200.0-255,5738,67954,64,369470
33083,0.000617,172.31.40.0-255,66,68020,64,369470
33084,0.000621,74.125.200.0-255,1484,69504,64,369470
33085,0.000655,74.125.200.0-255,5738,75242,64,369470
33086,0.000659,172.31.40.0-255,66,75308,64,369470
33087,0.000677,74.125.200.0-255,3961,79269,64,369470
33088,0.00068,172.31.40.0-255,66,79335,64,369470
33089,0.000685,74.125.200.0-255,4320,83655,64,369470
33090,0.000687,172.31.40.0-255,66,83721,64,369470
33091,0.00069,74.125.200.0-255,1484,85205,64,369470
33092,0.000715,74.125.200.0-255,4320,89525,64,369470
33093,0.000719,172.31.40.0-255,66,89591,64,369470
33094,0.00077,74.125.200.0-255,2543,92134,64,369470
33095,0.000773,172.31.40.0-255,66,92200,64,369470
33096,0.000965,74.125.200.0-255,1484,93684,64,369470
33097,0.000971,74.125.200.0-255,2902,96586,64,369470
33098,0.000974,172.31.40.0-255,66,96652,64,369470
33099,0.001002,74.125.200.0-255,5738,102390,64,369470
33100,0.001004,172.31.40.0-255,66,102456,64,369470
33101,0.001031,172.31.40.0-255,66,102522,64,369470
33102,0.001048,74.125.200.0-255,4320,106842,64,369470
33103,0.001051,172.31.40.0-255,66,106908,64,369470
33104,0.001056,74.125.200.0-255,4320,111228,64,369470
33105,0.001059,172.31.40.0-255,66,111294,64,369470
33106,0.001086,74.125.200.0-255,2902,114196,64,369470
33107,0.001091,172.31.40.0-255,66,114262,64,369470
33108,0.001115,74.125.200.0-255,3602,117864,64,369470
33109,0.001118,74.125.200.0-255,1484,119348,64,369470
33110,0.001135,74.125.200.0-255,5738,125086,64,369470
33111,0.001139,74.125.200.0-255,2902,127988,64,369470
33112,0.001141,172.31.40.0-255,66,128054,64,369470
33113,0.001147,172.31.40.0-255,66,128120,64,369470
33114,0.001166,74.125.200.0-255,1484,129604,64,369470
33115,0.001174,74.125.200.0-255,5738,135342,64,369470
33116,0.001179,74.125.200.0-255,4320,139662,64,369470
33117,0.001184,172.31.40.0-255,66,139728,64,369470
33118,0.001197,74.125.200.0-255,7156,146884,64,369470
33119,0.001202,74.125.200.0-255,4320,151204,64,369470
33120,0.001223,74.125.200.0-255,766,151970,64,369470
33121,0.001234,172.31.40.0-255,66,152036,64,369470
33122,0.001553,74.125.200.0-255,1484,153520,64,369470
33123,0.001591,74.125.200.0-255,1484,155004,64,369470
33124,0.001596,172.31.40.0-255,66,155070,64,369470
33125,0.001601,74.125.200.0-255,2902,157972,64,369470
33126,0.001603,172.31.40.0-255,66,158038,64,369470
33127,0.001636,74.125.200.0-255,5738,163776,64,369470
33128,0.001643,172.31.40.0-255,66,163842,64,369470
33129,0.001651,74.125.200.0-255,1484,165326,64,369470
33130,0.001676,74.125.200.0-255,2902,168228,64,369470
33131,0.001679,172.31.40.0-255,66,168294,64,369470
33132,0.001695,74.125.200.0-255,1484,169778,64,369470
33133,0.001711,74.125.200.0-255,2902,172680,64,369470
33134,0.001713,172.31.40.0-255,66,172746,64,369470
33135,0.001746,74.125.200.0-255,1484,174230,64,369470
33136,0.001765,74.125.200.0-255,2902,177132,64,369470
33137,0.001768,172.31.40.0-255,66,177198,64,369470
33138,0.001785,74.125.200.0-255,1484,178682,64,369470
33139,0.001805,74.125.200.0-255,4320,183002,64,369470
33140,0.001808,172.31.40.0-255,66,183068,64,369470
33141,0.001848,74.125.200.0-255,3602,186670,64,369470
33142,0.001854,172.31.40.0-255,66,186736,64,369470
33143,0.002113,74.125.200.0-255,1484,188220,64,369470
33144,0.002118,74.125.200.0-255,2902,191122,64,369470
33145,0.002123,74.125.200.0-255,4320,195442,64,369470
33146,0.002128,172.31.40.0-255,66,195508,64,369470
33147,0.002136,172.31.40.0-255,66,195574,64,369470
33148,0.002139,74.125.200.0-255,1484,197058,64,369470
33149,0.002155,74.125.200.0-255,5738,202796,64,369470
33150,0.002174,74.125.200.0-255,4320,207116,64,369470
33151,0.00218,74.125.200.0-255,4320,211436,64,369470
33152,0.002198,74.125.200.0-255,5738,217174,64,369470
33153,0.002201,172.31.40.0-255,66,217240,64,369470
33154,0.002207,172.31.40.0-255,66,217306,64,369470
33155,0.002218,74.125.200.0-255,1484,218790,64,369470
33156,0.002222,74.125.200.0-255,2184,220974,64,369470
33157,0.002224,172.31.40.0-255,66,221040,64,369470
33158,0.002229,74.125.200.0-255,2902,223942,64,369470
33159,0.00223,172.31.40.0-255,66,224008,64,369470
33160,0.002238,74.125.200.0-255,7156,231164,64,369470
33161,0.002261,74.125.200.0-255,7156,238320,64,369470
33162,0.00228,74.125.200.0-255,2902,241222,64,369470
33163,0.002283,74.125.200.0-255,1484,242706,64,369470
33164,0.011079,74.125.200.0-255,1484,244190,64,369470
33165,0.011348,172.31.40.0-255,66,244256,64,369470
33166,0.01359,74.125.200.0-255,5738,249994,64,369470
33167,0.013597,172.31.40.0-255,66,250060,64,369470
33168,0.015836,74.125.200.0-255,5738,255798,64,369470
33169,0.015843,172.31.40.0-255,66,255864,64,369470
33170,0.018084,74.125.200.0-255,5738,261602,64,369470
33171,0.018092,172.31.40.0-255,66,261668,64,369470
33172,0.020363,74.125.200.0-255,5738,267406,64,369470
33173,0.02037,172.31.40.0-255,66,267472,64,369470
33174,0.022623,74.125.200.0-255,5738,273210,64,369470
33175,0.022632,172.31.40.0-255,66,273276,64,369470
33176,0.024872,74.125.200.0-255,5738,279014,64,369470
33177,0.024878,172.31.40.0-255,66,279080,64,369470
33178,0.027113,74.125.200.0-255,5738,284818,64,369470
33179,0.027121,172.31.40.0-255,66,284884,64,369470
33180,0.02936,74.125.200.0-255,5738,290622,64,369470
33181,0.029367,172.31.40.0-255,66,290688,64,369470
33182,0.031604,74.125.200.0-255,5738,296426,64,369470
33183,0.031611,172.31.40.0-255,66,296492,64,369470
33184,0.03212,172.31.40.0-255,172,296664,64,369470
33185,0.032151,172.31.40.0-255,1107,297771,64,369470
33186,0.032215,172.31.40.0-255,1514,299285,64,369470
33187,0.032217,172.31.40.0-255,339,299624,64,369470
33188,0.033636,104.244.42.0-255,66,299690,64,369470
33189,0.033681,104.244.42.0-255,66,299756,64,369470
33190,0.033772,104.244.42.0-255,66,299822,64,369470
33191,0.033846,74.125.200.0-255,5738,305560,64,369470
33192,0.033851,172.31.40.0-255,66,305626,64,369470
33193,0.036078,74.125.200.0-255,5738,311364,64,369470
33194,0.036085,172.31.40.0-255,66,311430,64,369470
33195,0.038325,74.125.200.0-255,5738,317168,64,369470
33196,0.038332,172.31.40.0-255,66,317234,64,369470
33197,0.040572,74.125.200.0-255,5738,322972,64,369470
33198,0.040581,172.31.40.0-255,66,323038,64,369470
33199,0.042828,74.125.200.0-255,5738,328776,64,369470
33200,0.042835,172.31.40.0-255,66,328842,64,369470
33201,0.045077,74.125.200.0-255,5738,334580,64,369470
33202,0.045084,172.31.40.0-255,66,334646,64,369470
33203,0.04733,74.125.200.0-255,5738,340384,64,369470
33204,0.047337,172.31.40.0-255,66,340450,64,369470
33205,0.049588,74.125.200.0-255,5738,346188,64,369470
33206,0.049595,172.31.40.0-255,66,346254,64,369470
33207,0.051841,74.125.200.0-255,5738,351992,64,369470
33208,0.051847,172.31.40.0-255,66,352058,64,369470
33209,0.054094,74.125.200.0-255,5738,357796,64,369470
33210,0.054101,172.31.40.0-255,66,357862,64,369470
33211,0.056356,74.125.200.0-255,5738,363600,64,369470
33212,0.056362,172.31.40.0-255,66,363666,64,369470
33213,0.058606,74.125.200.0-255,5738,369404,64,369470
33214,0.058613,172.31.40.0-255,66,369470,64,369470
33215,0.0,216.58.203.0-255,295,295,64,280205
33216,2.2e-05,172.31.40.0-255,66,361,64,280205
33217,2.9e-05,216.58.203.0-255,1484,1845,64,280205
33218,3.5e-05,172.31.40.0-255,66,1911,64,280205
33219,4.2e-05,216.58.203.0-255,4320,6231,64,280205
33220,4.6e-05,172.31.40.0-255,66,6297,64,280205
33221,5.7e-05,172.31.40.0-255,66,6363,64,280205
33222,0.000449,216.58.203.0-255,1484,7847,64,280205
33223,0.000455,172.31.40.0-255,66,7913,64,280205
33224,0.000461,216.58.203.0-255,2902,10815,64,280205
33225,0.000464,172.31.40.0-255,66,10881,64,280205
33226,0.000481,216.58.203.0-255,4320,15201,64,280205
33227,0.000485,172.31.40.0-255,66,15267,64,280205
33228,0.000504,216.58.203.0-255,1484,16751,64,280205
33229,0.000506,172.31.40.0-255,66,16817,64,280205
33230,0.000528,216.58.203.0-255,4320,21137,64,280205
33231,0.000531,172.31.40.0-255,66,21203,64,280205
33232,0.000535,216.58.203.0-255,2543,23746,64,280205
33233,0.000537,172.31.40.0-255,66,23812,64,280205
33234,0.000697,216.58.203.0-255,1484,25296,64,280205
33235,0.000701,172.31.40.0-255,66,25362,64,280205
33236,0.000707,216.58.203.0-255,2902,28264,64,280205
33237,0.000709,172.31.40.0-255,66,28330,64,280205
33238,0.000716,216.58.203.0-255,5738,34068,64,280205
33239,0.000719,172.31.40.0-255,66,34134,64,280205
33240,0.000739,216.58.203.0-255,4320,38454,64,280205
33241,0.000741,172.31.40.0-255,66,38520,64,280205
33242,0.000775,216.58.203.0-255,5379,43899,64,280205
33243,0.000777,172.31.40.0-255,66,43965,64,280205
33244,0.000789,172.31.40.0-255,66,44031,64,280205
33245,0.000795,216.58.203.0-255,3961,47992,64,280205
33246,0.000797,172.31.40.0-255,66,48058,64,280205
33247,0.001276,216.58.203.0-255,646,48704,64,280205
33248,0.001463,216.58.203.0-255,1484,50188,64,280205
33249,0.001469,172.31.40.0-255,66,50254,64,280205
33250,0.001475,216.58.203.0-255,2902,53156,64,280205
33251,0.001477,172.31.40.0-255,66,53222,64,280205
33252,0.001481,216.58.203.0-255,2902,56124,64,280205
33253,0.001483,172.31.40.0-255,66,56190,64,280205
33254,0.001505,216.58.203.0-255,2902,59092,64,280205
33255,0.001507,172.31.40.0-255,66,59158,64,280205
33256,0.001512,216.58.203.0-255,4320,63478,64,280205
33257,0.001514,172.31.40.0-255,66,63544,64,280205
33258,0.00152,216.58.203.0-255,5379,68923,64,280205
33259,0.001522,172.31.40.0-255,66,68989,64,280205
33260,0.00156,172.31.40.0-255,66,69055,64,280205
33261,0.001601,216.58.203.0-255,5379,74434,64,280205
33262,0.001604,172.31.40.0-255,66,74500,64,280205
33263,0.003256,216.58.203.0-255,5738,80238,64,280205
33264,0.003263,172.31.40.0-255,66,80304,64,280205
33265,0.004912,216.58.203.0-255,5738,86042,64,280205
33266,0.004919,172.31.40.0-255,66,86108,64,280205
33267,0.006571,216.58.203.0-255,4320,90428,64,280205
33268,0.006575,172.31.40.0-255,66,90494,64,280205
33269,0.006593,216.58.203.0-255,1484,91978,64,280205
33270,0.00822,216.58.203.0-255,4320,96298,64,280205
33271,0.008228,172.31.40.0-255,66,96364,64,280205
33272,0.009874,216.58.203.0-255,5738,102102,64,280205
33273,0.009881,172.31.40.0-255,66,102168,64,280205
33274,0.011532,216.58.203.0-255,5738,107906,64,280205
33275,0.01154,172.31.40.0-255,66,107972,64,280205
33276,0.01319,216.58.203.0-255,5738,113710,64,280205
33277,0.013198,172.31.40.0-255,66,113776,64,280205
33278,0.014855,216.58.203.0-255,5738,119514,64,280205
33279,0.014864,172.31.40.0-255,66,119580,64,280205
33280,0.016522,216.58.203.0-255,5738,125318,64,280205
33281,0.01653,172.31.40.0-255,66,125384,64,280205
33282,0.018182,216.58.203.0-255,5738,131122,64,280205
33283,0.018189,172.31.40.0-255,66,131188,64,280205
33284,0.019842,216.58.203.0-255,5738,136926,64,280205
33285,0.019848,172.31.40.0-255,66,136992,64,280205
33286,0.021497,216.58.203.0-255,5738,142730,64,280205
33287,0.021504,172.31.40.0-255,66,142796,64,280205
33288,0.023161,216.58.203.0-255,5738,148534,64,280205
33289,0.023169,172.31.40.0-255,66,148600,64,280205
33290,0.024816,216.58.203.0-255,5738,154338,64,280205
33291,0.024823,172.31.40.0-255,66,154404,64,280205
33292,0.025948,172.31.40.0-255,172,154576,64,280205
33293,0.025983,172.31.40.0-255,1112,155688,64,280205
33294,0.02604,172.31.40.0-255,1514,157202,64,280205
33295,0.026042,172.31.40.0-255,1514,158716,64,280205
33296,0.026065,172.31.40.0-255,693,159409,64,280205
33297,0.026479,216.58.203.0-255,5738,165147,64,280205
33298,0.026486,172.31.40.0-255,66,165213,64,280205
33299,0.027486,104.244.42.0-255,66,165279,64,280205
33300,0.027527,104.244.42.0-255,66,165345,64,280205
33301,0.027641,104.244.42.0-255,66,165411,64,280205
33302,0.027647,104.244.42.0-255,66,165477,64,280205
33303,0.028133,216.58.203.0-255,4320,169797,64,280205
33304,0.028139,172.31.40.0-255,66,169863,64,280205
33305,0.028157,216.58.203.0-255,1484,171347,64,280205
33306,0.029803,216.58.203.0-255,4320,175667,64,280205
33307,0.029809,172.31.40.0-255,66,175733,64,280205
33308,0.031577,216.58.203.0-255,5738,181471,64,280205
33309,0.031584,172.31.40.0-255,66,181537,64,280205
33310,0.033255,216.58.203.0-255,5738,187275,64,280205
33311,0.033263,172.31.40.0-255,66,187341,64,280205
33312,0.034921,216.58.203.0-255,5738,193079,64,280205
33313,0.034927,172.31.40.0-255,66,193145,64,280205
33314,0.036591,216.58.203.0-255,5738,198883,64,280205
33315,0.036598,172.31.40.0-255,66,198949,64,280205
33316,0.038256,216.58.203.0-255,5738,204687,64,280205
33317,0.038263,172.31.40.0-255,66,204753,64,280205
33318,0.039921,216.58.203.0-255,5738,210491,64,280205
33319,0.039927,172.31.40.0-255,66,210557,64,280205
33320,0.041589,216.58.203.0-255,5738,216295,64,280205
33321,0.041595,172.31.40.0-255,66,216361,64,280205
33322,0.043251,216.58.203.0-255,5738,222099,64,280205
33323,0.043258,172.31.40.0-255,66,222165,64,280205
33324,0.044923,216.58.203.0-255,5738,227903,64,280205
33325,0.044928,172.31.40.0-255,66,227969,64,280205
33326,0.046591,216.58.203.0-255,5738,233707,64,280205
33327,0.046598,172.31.40.0-255,66,233773,64,280205
33328,0.048252,216.58.203.0-255,5738,239511,64,280205
33329,0.048258,172.31.40.0-255,66,239577,64,280205
33330,0.049921,216.58.203.0-255,5738,245315,64,280205
33331,0.049928,172.31.40.0-255,66,245381,64,280205
33332,0.051587,216.58.203.0-255,5738,251119,64,280205
33333,0.051594,172.31.40.0-255,66,251185,64,280205
33334,0.053253,216.58.203.0-255,5738,256923,64,280205
33335,0.05326,172.31.40.0-255,66,256989,64,280205
33336,0.054956,216.58.203.0-255,5738,262727,64,280205
33337,0.054962,172.31.40.0-255,66,262793,64,280205
33338,0.056615,216.58.203.0-255,5738,268531,64,280205
33339,0.056621,172.31.40.0-255,66,268597,64,280205
33340,0.058264,216.58.203.0-255,5738,274335,64,280205
33341,0.05827,172.31.40.0-255,66,274401,64,280205
33342,0.059918,216.58.203.0-255,5738,280139,64,280205
33343,0.059925,172.31.40.0-255,66,280205,64,280205
33344,0.0,172.31.40.0-255,105,105,64,459
33345,0.000159,172.31.40.0-255,90,195,64,459
33346,0.00017,172.31.40.0-255,66,261,64,459
33347,0.002432,74.125.68.0-255,66,327,64,459
33348,0.002464,74.125.68.0-255,66,393,64,459
33349,0.00249,172.31.40.0-255,66,459,64,459
33350,0.0,74.125.24.0-255,150,150,64,163221
33351,2.4e-05,172.31.40.0-255,66,216,64,163221
33352,3.2e-05,74.125.24.0-255,1484,1700,64,163221
33353,3.7e-05,172.31.40.0-255,66,1766,64,163221
33354,4.3e-05,74.125.24.0-255,2902,4668,64,163221
33355,5.4e-05,172.31.40.0-255,66,4734,64,163221
33356,7.7e-05,74.125.24.0-255,7156,11890,64,163221
33357,8.1e-05,172.31.40.0-255,66,11956,64,163221
33358,9.6e-05,172.31.40.0-255,66,12022,64,163221
33359,0.000133,74.125.24.0-255,5379,17401,64,163221
33360,0.000136,172.31.40.0-255,66,17467,64,163221
33361,0.000175,74.125.24.0-255,1484,18951,64,163221
33362,0.000177,172.31.40.0-255,66,19017,64,163221
33363,0.000181,74.125.24.0-255,1484,20501,64,163221
33364,0.000183,172.31.40.0-255,66,20567,64,163221
33365,0.000209,74.125.24.0-255,1484,22051,64,163221
33366,0.000212,172.31.40.0-255,66,22117,64,163221
33367,0.000219,74.125.24.0-255,5738,27855,64,163221
33368,0.000225,172.31.40.0-255,66,27921,64,163221
33369,0.000238,172.31.40.0-255,66,27987,64,163221
33370,0.000294,172.31.40.0-255,66,28053,64,163221
33371,0.000445,74.125.24.0-255,137,28190,64,163221
33372,0.00045,172.31.40.0-255,66,28256,64,163221
33373,0.000563,74.125.24.0-255,1484,29740,64,163221
33374,0.000567,172.31.40.0-255,66,29806,64,163221
33375,0.000572,74.125.24.0-255,2902,32708,64,163221
33376,0.000574,172.31.40.0-255,66,32774,64,163221
33377,0.000602,74.125.24.0-255,5738,38512,64,163221
33378,0.000605,172.31.40.0-255,66,38578,64,163221
33379,0.000643,172.31.40.0-255,66,38644,64,163221
33380,0.000655,172.31.40.0-255,66,38710,64,163221
33381,0.000684,74.125.24.0-255,1125,39835,64,163221
33382,0.000806,74.125.24.0-255,1484,41319,64,163221
33383,0.00081,172.31.40.0-255,66,41385,64,163221
33384,0.000815,74.125.24.0-255,2902,44287,64,163221
33385,0.000817,172.31.40.0-255,66,44353,64,163221
33386,0.000872,74.125.24.0-255,5738,50091,64,163221
33387,0.000875,172.31.40.0-255,66,50157,64,163221
33388,0.000894,172.31.40.0-255,66,50223,64,163221
33389,0.000905,172.31.40.0-255,66,50289,64,163221
33390,0.000908,74.125.24.0-255,766,51055,64,163221
33391,0.001242,74.125.24.0-255,1484,52539,64,163221
33392,0.001246,172.31.40.0-255,66,52605,64,163221
33393,0.001252,74.125.24.0-255,2902,55507,64,163221
33394,0.001254,172.31.40.0-255,66,55573,64,163221
33395,0.001266,74.125.24.0-255,5738,61311,64,163221
33396,0.001268,172.31.40.0-255,66,61377,64,163221
33397,0.00131,172.31.40.0-255,66,61443,64,163221
33398,0.001315,74.125.24.0-255,4320,65763,64,163221
33399,0.001317,172.31.40.0-255,66,65829,64,163221
33400,0.001358,74.125.24.0-255,6438,72267,64,163221
33401,0.00136,172.31.40.0-255,66,72333,64,163221
33402,0.001453,74.125.24.0-255,1484,73817,64,163221
33403,0.001458,74.125.24.0-255,2902,76719,64,163221
33404,0.001461,172.31.40.0-255,66,76785,64,163221
33405,0.001465,74.125.24.0-255,1484,78269,64,163221
33406,0.001494,74.125.24.0-255,4320,82589,64,163221
33407,0.001497,172.31.40.0-255,66,82655,64,163221
33408,0.001512,172.31.40.0-255,66,82721,64,163221
33409,0.001547,74.125.24.0-255,2902,85623,64,163221
33410,0.00155,172.31.40.0-255,66,85689,64,163221
33411,0.001588,172.31.40.0-255,66,85755,64,163221
33412,0.001712,74.125.24.0-255,1484,87239,64,163221
33413,0.001718,74.125.24.0-255,2902,90141,64,163221
33414,0.00172,172.31.40.0-255,66,90207,64,163221
33415,0.001724,74.125.24.0-255,1484,91691,64,163221
33416,0.00175,74.125.24.0-255,4320,96011,64,163221
33417,0.001753,172.31.40.0-255,66,96077,64,163221
33418,0.001759,74.125.24.0-255,5738,101815,64,163221
33419,0.001761,172.31.40.0-255,66,101881,64,163221
33420,0.001766,74.125.24.0-255,2902,104783,64,163221
33421,0.001773,172.31.40.0-255,66,104849,64,163221
33422,0.001813,172.31.40.0-255,66,104915,64,163221
33423,0.001819,74.125.24.0-255,5020,109935,64,163221
33424,0.001821,172.31.40.0-255,66,110001,64,163221
33425,0.00202,74.125.24.0-255,1484,111485,64,163221
33426,0.002025,74.125.24.0-255,2902,114387,64,163221
33427,0.002028,172.31.40.0-255,66,114453,64,163221
33428,0.002036,74.125.24.0-255,5738,120191,64,163221
33429,0.002039,172.31.40.0-255,66,120257,64,163221
33430,0.002049,74.125.24.0-255,4320,124577,64,163221
33431,0.002051,172.31.40.0-255,66,124643,64,163221
33432,0.00215,172.31.40.0-255,66,124709,64,163221
33433,0.002255,74.125.24.0-255,7156,131865,64,163221
33434,0.00226,74.125.24.0-255,3602,135467,64,163221
33435,0.002264,74.125.24.0-255,2902,138369,64,163221
33436,0.002279,74.125.24.0-255,1484,139853,64,163221
33437,0.002281,74.125.24.0-255,1484,141337,64,163221
33438,0.002321,74.125.24.0-255,5738,147075,64,163221
33439,0.002361,74.125.24.0-255,5738,152813,64,163221
33440,0.002401,74.125.24.0-255,1484,154297,64,163221
33441,0.002454,74.125.24.0-255,3407,157704,64,163221
33442,0.00248,74.125.24.0-255,105,157809,64,163221
33443,0.002509,74.125.24.0-255,129,157938,64,163221
33444,0.010814,172.31.40.0-255,66,158004,64,163221
33445,0.010822,172.31.40.0-255,66,158070,64,163221
33446,0.010826,172.31.40.0-255,66,158136,64,163221
33447,0.010849,172.31.40.0-255,66,158202,64,163221
33448,0.010853,172.31.40.0-255,66,158268,64,163221
33449,0.010856,172.31.40.0-255,66,158334,64,163221
33450,0.01086,172.31.40.0-255,66,158400,64,163221
33451,0.010863,172.31.40.0-255,66,158466,64,163221
33452,0.010869,172.31.40.0-255,66,158532,64,163221
33453,0.010872,172.31.40.0-255,66,158598,64,163221
33454,0.010875,172.31.40.0-255,66,158664,64,163221
33455,0.010878,172.31.40.0-255,66,158730,64,163221
33456,0.010881,172.31.40.0-255,66,158796,64,163221
33457,0.010885,172.31.40.0-255,66,158862,64,163221
33458,0.010888,172.31.40.0-255,66,158928,64,163221
33459,0.010891,172.31.40.0-255,66,158994,64,163221
33460,0.012979,74.125.24.0-255,129,159123,64,163221
33461,0.012988,172.31.40.0-255,78,159201,64,163221
33462,0.013413,172.31.40.0-255,105,159306,64,163221
33463,0.01345,172.31.40.0-255,105,159411,64,163221
33464,0.013698,172.31.40.0-255,90,159501,64,163221
33465,0.013708,172.31.40.0-255,66,159567,64,163221
33466,0.015989,74.125.24.0-255,66,159633,64,163221
33467,0.016022,74.125.24.0-255,66,159699,64,163221
33468,0.01627,74.125.24.0-255,66,159765,64,163221
33469,0.016293,74.125.24.0-255,66,159831,64,163221
33470,0.016301,172.31.40.0-255,66,159897,64,163221
33471,0.030746,172.31.40.0-255,167,160064,64,163221
33472,0.030779,172.31.40.0-255,1107,161171,64,163221
33473,0.03084,172.31.40.0-255,1514,162685,64,163221
33474,0.030842,172.31.40.0-255,338,163023,64,163221
33475,0.032333,104.244.42.0-255,66,163089,64,163221
33476,0.032381,104.244.42.0-255,66,163155,64,163221
33477,0.032402,104.244.42.0-255,66,163221,64,163221
33478,0.0,74.125.24.0-255,153,153,64,262174
33479,1.8e-05,172.31.40.0-255,66,219,64,262174
33480,2.5e-05,74.125.24.0-255,1484,1703,64,262174
33481,3e-05,172.31.40.0-255,66,1769,64,262174
33482,3.5e-05,74.125.24.0-255,2902,4671,64,262174
33483,3.9e-05,172.31.40.0-255,66,4737,64,262174
33484,4.6e-05,74.125.24.0-255,7156,11893,64,262174
33485,5e-05,172.31.40.0-255,66,11959,64,262174
33486,5.4e-05,74.125.24.0-255,2038,13997,64,262174
33487,5.7e-05,172.31.40.0-255,66,14063,64,262174
33488,0.000284,74.125.24.0-255,1484,15547,64,262174
33489,0.00029,172.31.40.0-255,66,15613,64,262174
33490,0.000296,74.125.24.0-255,2902,18515,64,262174
33491,0.000299,172.31.40.0-255,66,18581,64,262174
33492,0.000301,74.125.24.0-255,1484,20065,64,262174
33493,0.000304,172.31.40.0-255,66,20131,64,262174
33494,0.000333,74.125.24.0-255,4320,24451,64,262174
33495,0.000337,172.31.40.0-255,66,24517,64,262174
33496,0.000351,74.125.24.0-255,5738,30255,64,262174
33497,0.000354,172.31.40.0-255,66,30321,64,262174
33498,0.000374,172.31.40.0-255,66,30387,64,262174
33499,0.000385,172.31.40.0-255,66,30453,64,262174
33500,0.000407,74.125.24.0-255,1125,31578,64,262174
33501,0.000409,172.31.40.0-255,66,31644,64,262174
33502,0.000413,74.125.24.0-255,1484,33128,64,262174
33503,0.000414,172.31.40.0-255,66,33194,64,262174
33504,0.000418,74.125.24.0-255,1484,34678,64,262174
33505,0.00042,172.31.40.0-255,66,34744,64,262174
33506,0.000447,74.125.24.0-255,1484,36228,64,262174
33507,0.000449,172.31.40.0-255,66,36294,64,262174
33508,0.000456,74.125.24.0-255,5738,42032,64,262174
33509,0.000459,172.31.40.0-255,66,42098,64,262174
33510,0.000464,74.125.24.0-255,4320,46418,64,262174
33511,0.000466,172.31.40.0-255,66,46484,64,262174
33512,0.00049,74.125.24.0-255,2854,49338,64,262174
33513,0.000492,172.31.40.0-255,66,49404,64,262174
33514,0.000522,74.125.24.0-255,375,49779,64,262174
33515,0.000754,74.125.24.0-255,1484,51263,64,262174
33516,0.000758,172.31.40.0-255,66,51329,64,262174
33517,0.000772,74.125.24.0-255,2902,54231,64,262174
33518,0.000774,74.125.24.0-255,1484,55715,64,262174
33519,0.000777,172.31.40.0-255,66,55781,64,262174
33520,0.000787,74.125.24.0-255,4320,60101,64,262174
33521,0.000789,172.31.40.0-255,66,60167,64,262174
33522,0.000822,172.31.40.0-255,66,60233,64,262174
33523,0.000828,74.125.24.0-255,5738,65971,64,262174
33524,0.00083,172.31.40.0-255,66,66037,64,262174
33525,0.000842,74.125.24.0-255,2902,68939,64,262174
33526,0.000844,172.31.40.0-255,66,69005,64,262174
33527,0.000884,74.125.24.0-255,2184,71189,64,262174
33528,0.000887,172.31.40.0-255,66,71255,64,262174
33529,0.00115,74.125.24.0-255,1484,72739,64,262174
33530,0.001154,74.125.24.0-255,2902,75641,64,262174
33531,0.001159,172.31.40.0-255,66,75707,64,262174
33532,0.001173,74.125.24.0-255,5738,81445,64,262174
33533,0.001176,172.31.40.0-255,66,81511,64,262174
33534,0.001227,172.31.40.0-255,66,81577,64,262174
33535,0.001238,172.31.40.0-255,66,81643,64,262174
33536,0.001258,74.125.24.0-255,766,82409,64,262174
33537,0.001546,172.31.40.0-255,66,82475,64,262174
33538,0.002013,74.125.24.0-255,1484,83959,64,262174
33539,0.002023,74.125.24.0-255,2902,86861,64,262174
33540,0.002026,172.31.40.0-255,66,86927,64,262174
33541,0.002033,74.125.24.0-255,5738,92665,64,262174
33542,0.002035,172.31.40.0-255,66,92731,64,262174
33543,0.002072,172.31.40.0-255,66,92797,64,262174
33544,0.002101,172.31.40.0-255,66,92863,64,262174
33545,0.002127,74.125.24.0-255,1484,94347,64,262174
33546,0.002149,74.125.24.0-255,2902,97249,64,262174
33547,0.002151,172.31.40.0-255,66,97315,64,262174
33548,0.002156,74.125.24.0-255,4320,101635,64,262174
33549,0.002158,172.31.40.0-255,66,101701,64,262174
33550,0.002173,74.125.24.0-255,1484,103185,64,262174
33551,0.002178,74.125.24.0-255,4320,107505,64,262174
33552,0.00218,172.31.40.0-255,66,107571,64,262174
33553,0.002206,172.31.40.0-255,66,107637,64,262174
33554,0.002216,172.31.40.0-255,66,107703,64,262174
33555,0.002227,74.125.24.0-255,766,108469,64,262174
33556,0.002273,74.125.24.0-255,1484,109953,64,262174
33557,0.002276,172.31.40.0-255,66,110019,64,262174
33558,0.002279,74.125.24.0-255,1484,111503,64,262174
33559,0.002295,74.125.24.0-255,1484,112987,64,262174
33560,0.002297,172.31.40.0-255,66,113053,64,262174
33561,0.002303,74.125.24.0-255,5738,118791,64,262174
33562,0.002304,172.31.40.0-255,66,118857,64,262174
33563,0.002333,172.31.40.0-255,66,118923,64,262174
33564,0.002345,74.125.24.0-255,1484,120407,64,262174
33565,0.002354,172.31.40.0-255,66,120473,64,262174
33566,0.002387,74.125.24.0-255,2184,122657,64,262174
33567,0.00239,172.31.40.0-255,66,122723,64,262174
33568,0.002417,74.125.24.0-255,2902,125625,64,262174
33569,0.002419,172.31.40.0-255,66,125691,64,262174
33570,0.002449,74.125.24.0-255,7156,132847,64,262174
33571,0.002451,172.31.40.0-255,66,132913,64,262174
33572,0.002461,74.125.24.0-255,5738,138651,64,262174
33573,0.002463,172.31.40.0-255,66,138717,64,262174
33574,0.002468,74.125.24.0-255,5738,144455,64,262174
33575,0.00247,172.31.40.0-255,66,144521,64,262174
33576,0.002499,172.31.40.0-255,66,144587,64,262174
33577,0.002509,172.31.40.0-255,66,144653,64,262174
33578,0.00253,74.125.24.0-255,766,145419,64,262174
33579,0.00254,172.31.40.0-255,66,145485,64,262174
33580,0.002571,74.125.24.0-255,1484,146969,64,262174
33581,0.002592,172.31.40.0-255,66,147035,64,262174
33582,0.005167,74.125.24.0-255,5738,152773,64,262174
33583,0.005172,172.31.40.0-255,66,152839,64,262174
33584,0.006912,172.31.40.0-255,101,152940,64,262174
33585,0.007746,74.125.24.0-255,2902,155842,64,262174
33586,0.007752,172.31.40.0-255,66,155908,64,262174
33587,0.007773,74.125.24.0-255,2902,158810,64,262174
33588,0.007775,172.31.40.0-255,66,158876,64,262174
33589,0.009436,74.125.24.0-255,66,158942,64,262174
33590,0.01033,74.125.24.0-255,2902,161844,64,262174
33591,0.010336,172.31.40.0-255,66,161910,64,262174
33592,0.010379,74.125.24.0-255,2902,164812,64,262174
33593,0.010382,172.31.40.0-255,66,164878,64,262174
33594,0.012913,74.125.24.0-255,2902,167780,64,262174
33595,0.012919,172.31.40.0-255,66,167846,64,262174
33596,0.012942,74.125.24.0-255,2902,170748,64,262174
33597,0.012945,172.31.40.0-255,66,170814,64,262174
33598,0.0155,74.125.24.0-255,2902,173716,64,262174
33599,0.01551,172.31.40.0-255,66,173782,64,262174
33600,0.015537,74.125.24.0-255,2902,176684,64,262174
33601,0.01554,172.31.40.0-255,66,176750,64,262174
33602,0.018088,74.125.24.0-255,2902,179652,64,262174
33603,0.018096,172.31.40.0-255,66,179718,64,262174
33604,0.018118,74.125.24.0-255,2902,182620,64,262174
33605,0.018122,172.31.40.0-255,66,182686,64,262174
33606,0.020709,74.125.24.0-255,5738,188424,64,262174
33607,0.020717,172.31.40.0-255,66,188490,64,262174
33608,0.023303,74.125.24.0-255,5738,194228,64,262174
33609,0.023309,172.31.40.0-255,66,194294,64,262174
33610,0.025894,74.125.24.0-255,5738,200032,64,262174
33611,0.025903,172.31.40.0-255,66,200098,64,262174
33612,0.027833,172.31.40.0-255,172,200270,64,262174
33613,0.027862,172.31.40.0-255,1112,201382,64,262174
33614,0.02791,172.31.40.0-255,1514,202896,64,262174
33615,0.027912,172.31.40.0-255,1514,204410,64,262174
33616,0.027935,172.31.40.0-255,693,205103,64,262174
33617,0.028498,74.125.24.0-255,5738,210841,64,262174
33618,0.028505,172.31.40.0-255,66,210907,64,262174
33619,0.029363,104.244.42.0-255,66,210973,64,262174
33620,0.029406,104.244.42.0-255,66,211039,64,262174
33621,0.029493,104.244.42.0-255,66,211105,64,262174
33622,0.029507,104.244.42.0-255,66,211171,64,262174
33623,0.031084,74.125.24.0-255,5738,216909,64,262174
33624,0.031091,172.31.40.0-255,66,216975,64,262174
33625,0.033694,74.125.24.0-255,5738,222713,64,262174
33626,0.033699,172.31.40.0-255,66,222779,64,262174
33627,0.036302,74.125.24.0-255,5738,228517,64,262174
33628,0.036309,172.31.40.0-255,66,228583,64,262174
33629,0.038879,74.125.24.0-255,5738,234321,64,262174
33630,0.038888,172.31.40.0-255,66,234387,64,262174
33631,0.041459,74.125.24.0-255,5738,240125,64,262174
33632,0.041465,172.31.40.0-255,66,240191,64,262174
33633,0.044058,74.125.24.0-255,5738,245929,64,262174
33634,0.044064,172.31.40.0-255,66,245995,64,262174
33635,0.0467,74.125.24.0-255,5738,251733,64,262174
33636,0.046706,172.31.40.0-255,66,251799,64,262174
33637,0.049287,74.125.24.0-255,5738,257537,64,262174
33638,0.049293,172.31.40.0-255,66,257603,64,262174
33639,0.051873,74.125.24.0-255,4334,261937,64,262174
33640,0.051879,172.31.40.0-255,66,262003,64,262174
33641,0.052033,172.31.40.0-255,105,262108,64,262174
33642,0.059861,74.125.24.0-255,66,262174,64,262174
33643,0.0,74.125.24.0-255,153,153,64,189878
33644,2.3e-05,172.31.40.0-255,66,219,64,189878
33645,3e-05,74.125.24.0-255,1484,1703,64,189878
33646,3.5e-05,172.31.40.0-255,66,1769,64,189878
33647,4.1e-05,74.125.24.0-255,2902,4671,64,189878
33648,4.3e-05,172.31.40.0-255,66,4737,64,189878
33649,5.9e-05,74.125.24.0-255,7156,11893,64,189878
33650,6.3e-05,172.31.40.0-255,66,11959,64,189878
33651,8.1e-05,172.31.40.0-255,66,12025,64,189878
33652,0.000109,74.125.24.0-255,2543,14568,64,189878
33653,0.000112,172.31.40.0-255,66,14634,64,189878
33654,0.000139,74.125.24.0-255,2902,17536,64,189878
33655,0.000141,172.31.40.0-255,66,17602,64,189878
33656,0.000144,74.125.24.0-255,1484,19086,64,189878
33657,0.000147,172.31.40.0-255,66,19152,64,189878
33658,0.000168,74.125.24.0-255,4320,23472,64,189878
33659,0.000171,172.31.40.0-255,66,23538,64,189878
33660,0.000187,172.31.40.0-255,66,23604,64,189878
33661,0.000216,74.125.24.0-255,1484,25088,64,189878
33662,0.000218,172.31.40.0-255,66,25154,64,189878
33663,0.000253,172.31.40.0-255,66,25220,64,189878
33664,0.000278,74.125.24.0-255,342,25562,64,189878
33665,0.00028,172.31.40.0-255,66,25628,64,189878
33666,0.000382,74.125.24.0-255,1484,27112,64,189878
33667,0.000386,172.31.40.0-255,66,27178,64,189878
33668,0.00039,74.125.24.0-255,1484,28662,64,189878
33669,0.000392,172.31.40.0-255,66,28728,64,189878
33670,0.000416,74.125.24.0-255,1484,30212,64,189878
33671,0.000418,172.31.40.0-255,66,30278,64,189878
33672,0.000425,74.125.24.0-255,5738,36016,64,189878
33673,0.000428,172.31.40.0-255,66,36082,64,189878
33674,0.000436,74.125.24.0-255,7156,43238,64,189878
33675,0.000443,172.31.40.0-255,66,43304,64,189878
33676,0.000476,74.125.24.0-255,5738,49042,64,189878
33677,0.00048,172.31.40.0-255,66,49108,64,189878
33678,0.000484,74.125.24.0-255,2902,52010,64,189878
33679,0.000486,172.31.40.0-255,66,52076,64,189878
33680,0.000517,172.31.40.0-255,66,52142,64,189878
33681,0.000595,74.125.24.0-255,1484,53626,64,189878
33682,0.0006,74.125.24.0-255,1484,55110,64,189878
33683,0.000603,172.31.40.0-255,66,55176,64,189878
33684,0.000625,74.125.24.0-255,1484,56660,64,189878
33685,0.000659,74.125.24.0-255,1484,58144,64,189878
33686,0.000661,172.31.40.0-255,66,58210,64,189878
33687,0.000692,74.125.24.0-255,4320,62530,64,189878
33688,0.000695,172.31.40.0-255,66,62596,64,189878
33689,0.000708,172.31.40.0-255,66,62662,64,189878
33690,0.000714,74.125.24.0-255,4320,66982,64,189878
33691,0.000716,172.31.40.0-255,66,67048,64,189878
33692,0.000747,74.125.24.0-255,4320,71368,64,189878
33693,0.00075,172.31.40.0-255,66,71434,64,189878
33694,0.000754,74.125.24.0-255,2184,73618,64,189878
33695,0.000756,172.31.40.0-255,66,73684,64,189878
33696,0.000761,74.125.24.0-255,2902,76586,64,189878
33697,0.000763,172.31.40.0-255,66,76652,64,189878
33698,0.00077,74.125.24.0-255,7156,83808,64,189878
33699,0.000778,172.31.40.0-255,66,83874,64,189878
33700,0.000781,74.125.24.0-255,1484,85358,64,189878
33701,0.000795,172.31.40.0-255,66,85424,64,189878
33702,0.000806,172.31.40.0-255,66,85490,64,189878
33703,0.001347,74.125.24.0-255,1484,86974,64,189878
33704,0.001354,74.125.24.0-255,2902,89876,64,189878
33705,0.001357,172.31.40.0-255,66,89942,64,189878
33706,0.001361,74.125.24.0-255,1484,91426,64,189878
33707,0.001392,74.125.24.0-255,4320,95746,64,189878
33708,0.001395,172.31.40.0-255,66,95812,64,189878
33709,0.001429,172.31.40.0-255,66,95878,64,189878
33710,0.001432,74.125.24.0-255,1484,97362,64,189878
33711,0.001455,74.125.24.0-255,4320,101682,64,189878
33712,0.001458,172.31.40.0-255,66,101748,64,189878
33713,0.001485,74.125.24.0-255,5020,106768,64,189878
33714,0.001487,172.31.40.0-255,66,106834,64,189878
33715,0.001587,74.125.24.0-255,1484,108318,64,189878
33716,0.001602,74.125.24.0-255,2902,111220,64,189878
33717,0.001605,172.31.40.0-255,66,111286,64,189878
33718,0.001609,74.125.24.0-255,1484,112770,64,189878
33719,0.001634,74.125.24.0-255,4320,117090,64,189878
33720,0.001637,172.31.40.0-255,66,117156,64,189878
33721,0.001643,74.125.24.0-255,5738,122894,64,189878
33722,0.001645,172.31.40.0-255,66,122960,64,189878
33723,0.001684,172.31.40.0-255,66,123026,64,189878
33724,0.001689,74.125.24.0-255,2902,125928,64,189878
33725,0.001691,172.31.40.0-255,66,125994,64,189878
33726,0.00171,74.125.24.0-255,2184,128178,64,189878
33727,0.001713,172.31.40.0-255,66,128244,64,189878
33728,0.001781,74.125.24.0-255,1484,129728,64,189878
33729,0.001787,74.125.24.0-255,2902,132630,64,189878
33730,0.00179,172.31.40.0-255,66,132696,64,189878
33731,0.001796,74.125.24.0-255,4320,137016,64,189878
33732,0.001799,172.31.40.0-255,66,137082,64,189878
33733,0.00183,74.125.24.0-255,1484,138566,64,189878
33734,0.001836,74.125.24.0-255,5738,144304,64,189878
33735,0.001839,172.31.40.0-255,66,144370,64,189878
33736,0.001864,74.125.24.0-255,5738,150108,64,189878
33737,0.001867,172.31.40.0-255,66,150174,64,189878
33738,0.001893,74.125.24.0-255,7156,157330,64,189878
33739,0.001896,172.31.40.0-255,66,157396,64,189878
33740,0.001903,74.125.24.0-255,5020,162416,64,189878
33741,0.001905,172.31.40.0-255,66,162482,64,189878
33742,0.001926,74.125.24.0-255,5738,168220,64,189878
33743,0.001929,172.31.40.0-255,66,168286,64,189878
33744,0.001962,74.125.24.0-255,7156,175442,64,189878
33745,0.001965,172.31.40.0-255,66,175508,64,189878
33746,0.001985,172.31.40.0-255,66,175574,64,189878
33747,0.002026,74.125.24.0-255,4320,179894,64,189878
33748,0.002028,172.31.40.0-255,66,179960,64,189878
33749,0.002059,74.125.24.0-255,3602,183562,64,189878
33750,0.002062,172.31.40.0-255,66,183628,64,189878
33751,0.002083,172.31.40.0-255,66,183694,64,189878
33752,0.002103,74.125.24.0-255,1484,185178,64,189878
33753,0.002118,172.31.40.0-255,66,185244,64,189878
33754,0.00224,74.125.24.0-255,105,185349,64,189878
33755,0.006136,172.31.40.0-255,66,185415,64,189878
33756,0.009634,172.31.40.0-255,105,185520,64,189878
33757,0.011901,74.125.24.0-255,66,185586,64,189878
33758,0.032876,172.31.40.0-255,172,185758,64,189878
33759,0.032908,172.31.40.0-255,1112,186870,64,189878
33760,0.032968,172.31.40.0-255,1514,188384,64,189878
33761,0.03297,172.31.40.0-255,1296,189680,64,189878
33762,0.034448,104.244.42.0-255,66,189746,64,189878
33763,0.03449,104.244.42.0-255,66,189812,64,189878
33764,0.034542,104.244.42.0-255,66,189878,64,189878
33765,0.0,172.217.194.0-255,150,150,64,259269
33766,2.7e-05,172.31.40.0-255,66,216,64,259269
33767,3.5e-05,172.217.194.0-255,1484,1700,64,259269
33768,4e-05,172.31.40.0-255,66,1766,64,259269
33769,4.6e-05,172.217.194.0-255,2902,4668,64,259269
33770,4.8e-05,172.31.40.0-255,66,4734,64,259269
33771,5.6e-05,172.217.194.0-255,7156,11890,64,259269
33772,5.8e-05,172.31.40.0-255,66,11956,64,259269
33773,6.3e-05,172.217.194.0-255,2148,14104,64,259269
33774,6.6e-05,172.31.40.0-255,66,14170,64,259269
33775,0.000243,172.217.194.0-255,1484,15654,64,259269
33776,0.000248,172.31.40.0-255,66,15720,64,259269
33777,0.000255,172.217.194.0-255,2902,18622,64,259269
33778,0.000258,172.31.40.0-255,66,18688,64,259269
33779,0.000262,172.217.194.0-255,2902,21590,64,259269
33780,0.000264,172.31.40.0-255,66,21656,64,259269
33781,0.000285,172.217.194.0-255,2902,24558,64,259269
33782,0.000287,172.31.40.0-255,66,24624,64,259269
33783,0.000318,172.217.194.0-255,6797,31421,64,259269
33784,0.000321,172.31.40.0-255,66,31487,64,259269
33785,0.000661,172.217.194.0-255,1484,32971,64,259269
33786,0.000667,172.31.40.0-255,66,33037,64,259269
33787,0.000673,172.217.194.0-255,2902,35939,64,259269
33788,0.000675,172.31.40.0-255,66,36005,64,259269
33789,0.00069,172.217.194.0-255,4320,40325,64,259269
33790,0.000692,172.31.40.0-255,66,40391,64,259269
33791,0.00074,172.217.194.0-255,4320,44711,64,259269
33792,0.000743,172.31.40.0-255,66,44777,64,259269
33793,0.000762,172.217.194.0-255,3961,48738,64,259269
33794,0.000764,172.31.40.0-255,66,48804,64,259269
33795,0.000939,172.217.194.0-255,1484,50288,64,259269
33796,0.000946,172.31.40.0-255,66,50354,64,259269
33797,0.000968,172.217.194.0-255,2902,53256,64,259269
33798,0.000971,172.31.40.0-255,66,53322,64,259269
33799,0.000977,172.217.194.0-255,5738,59060,64,259269
33800,0.000979,172.31.40.0-255,66,59126,64,259269
33801,0.000999,172.217.194.0-255,5738,64864,64,259269
33802,0.001002,172.31.40.0-255,66,64930,64,259269
33803,0.001025,172.217.194.0-255,1418,66348,64,259269
33804,0.00103,172.217.194.0-255,385,66733,64,259269
33805,0.001032,172.31.40.0-255,66,66799,64,259269
33806,0.001196,172.217.194.0-255,1484,68283,64,259269
33807,0.001203,172.217.194.0-255,2902,71185,64,259269
33808,0.001206,172.31.40.0-255,66,71251,64,259269
33809,0.00121,172.217.194.0-255,1484,72735,64,259269
33810,0.001228,172.217.194.0-255,4320,77055,64,259269
33811,0.00123,172.31.40.0-255,66,77121,64,259269
33812,0.001233,172.217.194.0-255,1484,78605,64,259269
33813,0.001253,172.217.194.0-255,2902,81507,64,259269
33814,0.001255,172.31.40.0-255,66,81573,64,259269
33815,0.001288,172.217.194.0-255,5379,86952,64,259269
33816,0.001291,172.31.40.0-255,66,87018,64,259269
33817,0.001342,172.217.194.0-255,5738,92756,64,259269
33818,0.001356,172.31.40.0-255,66,92822,64,259269
33819,0.001493,172.217.194.0-255,1484,94306,64,259269
33820,0.00151,172.217.194.0-255,2902,97208,64,259269
33821,0.001521,172.31.40.0-255,66,97274,64,259269
33822,0.001538,172.217.194.0-255,5738,103012,64,259269
33823,0.001541,172.31.40.0-255,66,103078,64,259269
33824,0.001545,172.217.194.0-255,2902,105980,64,259269
33825,0.001562,172.31.40.0-255,66,106046,64,259269
33826,0.001617,172.217.194.0-255,5738,111784,64,259269
33827,0.001623,172.217.194.0-255,5020,116804,64,259269
33828,0.001636,172.31.40.0-255,66,116870,64,259269
33829,0.001649,172.217.194.0-255,5738,122608,64,259269
33830,0.001684,172.217.194.0-255,7156,129764,64,259269
33831,0.001689,172.31.40.0-255,66,129830,64,259269
33832,0.001708,172.217.194.0-255,5738,135568,64,259269
33833,0.001716,172.31.40.0-255,66,135634,64,259269
33834,0.00177,172.31.40.0-255,66,135700,64,259269
33835,0.001976,172.217.194.0-255,1484,137184,64,259269
33836,0.001982,172.217.194.0-255,2902,140086,64,259269
33837,0.001985,172.31.40.0-255,66,140152,64,259269
33838,0.001989,172.217.194.0-255,1484,141636,64,259269
33839,0.002009,172.217.194.0-255,4320,145956,64,259269
33840,0.002012,172.217.194.0-255,1484,147440,64,259269
33841,0.002025,172.31.40.0-255,66,147506,64,259269
33842,0.002038,172.217.194.0-255,4320,151826,64,259269
33843,0.002052,172.217.194.0-255,4320,156146,64,259269
33844,0.002066,172.31.40.0-255,66,156212,64,259269
33845,0.002078,172.217.194.0-255,5738,161950,64,259269
33846,0.002116,172.31.40.0-255,66,162016,64,259269
33847,0.003321,172.217.194.0-255,1484,163500,64,259269
33848,0.003335,172.217.194.0-255,2902,166402,64,259269
33849,0.003341,172.31.40.0-255,66,166468,64,259269
33850,0.00335,172.217.194.0-255,5738,172206,64,259269
33851,0.003352,172.31.40.0-255,66,172272,64,259269
33852,0.003356,172.217.194.0-255,1484,173756,64,259269
33853,0.003375,172.217.194.0-255,5738,179494,64,259269
33854,0.003377,172.31.40.0-255,66,179560,64,259269
33855,0.003383,172.217.194.0-255,4320,183880,64,259269
33856,0.003385,172.31.40.0-255,66,183946,64,259269
33857,0.003414,172.217.194.0-255,4320,188266,64,259269
33858,0.003872,172.217.194.0-255,1484,189750,64,259269
33859,0.003877,172.217.194.0-255,2902,192652,64,259269
33860,0.003899,172.217.194.0-255,5738,198390,64,259269
33861,0.003916,172.217.194.0-255,2902,201292,64,259269
33862,0.00405,172.217.194.0-255,2902,204194,64,259269
33863,0.004227,172.217.194.0-255,1484,205678,64,259269
33864,0.004231,172.217.194.0-255,2902,208580,64,259269
33865,0.004256,172.217.194.0-255,5738,214318,64,259269
33866,0.004276,172.217.194.0-255,2902,217220,64,259269
33867,0.004307,172.217.194.0-255,7156,224376,64,259269
33868,0.004347,172.217.194.0-255,4320,228696,64,259269
33869,0.00443,172.217.194.0-255,2902,231598,64,259269
33870,0.004458,172.217.194.0-255,5738,237336,64,259269
33871,0.004511,172.217.194.0-255,7156,244492,64,259269
33872,0.004523,172.217.194.0-255,2184,246676,64,259269
33873,0.004561,172.217.194.0-255,4320,250996,64,259269
33874,0.004579,172.217.194.0-255,647,251643,64,259269
33875,0.004582,172.217.194.0-255,105,251748,64,259269
33876,0.012449,172.217.194.0-255,105,251853,64,259269
33877,0.012461,172.31.40.0-255,78,251931,64,259269
33878,0.015411,172.31.40.0-255,105,252036,64,259269
33879,0.017492,172.217.194.0-255,66,252102,64,259269
33880,0.053003,172.31.40.0-255,172,252274,64,259269
33881,0.053035,172.31.40.0-255,1112,253386,64,259269
33882,0.0531,172.31.40.0-255,1514,254900,64,259269
33883,0.053102,172.31.40.0-255,1514,256414,64,259269
33884,0.053107,172.31.40.0-255,1514,257928,64,259269
33885,0.053109,172.31.40.0-255,1077,259005,64,259269
33886,0.05453,104.244.42.0-255,66,259071,64,259269
33887,0.054656,104.244.42.0-255,66,259137,64,259269
33888,0.054707,104.244.42.0-255,66,259203,64,259269
33889,0.054713,104.244.42.0-255,66,259269,64,259269
33890,0.0,74.125.24.0-255,152,152,64,182970
33891,1.8e-05,172.31.40.0-255,66,218,64,182970
33892,2.6e-05,74.125.24.0-255,1484,1702,64,182970
33893,3.2e-05,172.31.40.0-255,66,1768,64,182970
33894,3.8e-05,74.125.24.0-255,2902,4670,64,182970
33895,4.1e-05,172.31.40.0-255,66,4736,64,182970
33896,8.4e-05,74.125.24.0-255,4320,9056,64,182970
33897,8.8e-05,172.31.40.0-255,66,9122,64,182970
33898,0.000132,74.125.24.0-255,4947,14069,64,182970
33899,0.000135,172.31.40.0-255,66,14135,64,182970
33900,0.00021,74.125.24.0-255,1484,15619,64,182970
33901,0.000214,172.31.40.0-255,66,15685,64,182970
33902,0.000219,74.125.24.0-255,2902,18587,64,182970
33903,0.000221,172.31.40.0-255,66,18653,64,182970
33904,0.000261,74.125.24.0-255,2902,21555,64,182970
33905,0.000264,172.31.40.0-255,66,21621,64,182970
33906,0.000282,74.125.24.0-255,2902,24523,64,182970
33907,0.000285,172.31.40.0-255,66,24589,64,182970
33908,0.000345,74.125.24.0-255,2902,27491,64,182970
33909,0.000349,172.31.40.0-255,66,27557,64,182970
33910,0.000367,74.125.24.0-255,3961,31518,64,182970
33911,0.00037,172.31.40.0-255,66,31584,64,182970
33912,0.000597,74.125.24.0-255,1484,33068,64,182970
33913,0.000602,172.31.40.0-255,66,33134,64,182970
33914,0.000608,74.125.24.0-255,2902,36036,64,182970
33915,0.00061,172.31.40.0-255,66,36102,64,182970
33916,0.000638,74.125.24.0-255,4320,40422,64,182970
33917,0.000641,172.31.40.0-255,66,40488,64,182970
33918,0.00066,74.125.24.0-255,1484,41972,64,182970
33919,0.000662,172.31.40.0-255,66,42038,64,182970
33920,0.000743,74.125.24.0-255,5738,47776,64,182970
33921,0.000746,172.31.40.0-255,66,47842,64,182970
33922,0.000788,172.31.40.0-255,66,47908,64,182970
33923,0.000928,74.125.24.0-255,5738,53646,64,182970
33924,0.000933,172.31.40.0-255,66,53712,64,182970
33925,0.000962,172.31.40.0-255,101,53813,64,182970
33926,0.001024,74.125.24.0-255,3961,57774,64,182970
33927,0.001031,172.31.40.0-255,66,57840,64,182970
33928,0.001577,74.125.24.0-255,394,58234,64,182970
33929,0.001606,74.125.24.0-255,350,58584,64,182970
33930,0.002194,74.125.24.0-255,1484,60068,64,182970
33931,0.002201,172.31.40.0-255,66,60134,64,182970
33932,0.002208,74.125.24.0-255,2902,63036,64,182970
33933,0.002234,74.125.24.0-255,2902,65938,64,182970
33934,0.002253,74.125.24.0-255,2902,68840,64,182970
33935,0.002322,74.125.24.0-255,5738,74578,64,182970
33936,0.002339,74.125.24.0-255,7156,81734,64,182970
33937,0.002501,74.125.24.0-255,1484,83218,64,182970
33938,0.002521,74.125.24.0-255,1484,84702,64,182970
33939,0.002538,74.125.24.0-255,4320,89022,64,182970
33940,0.002558,74.125.24.0-255,3602,92624,64,182970
33941,0.002659,74.125.24.0-255,1484,94108,64,182970
33942,0.002682,74.125.24.0-255,2902,97010,64,182970
33943,0.00272,74.125.24.0-255,5738,102748,64,182970
33944,0.002803,74.125.24.0-255,5738,108486,64,182970
33945,0.00283,74.125.24.0-255,7156,115642,64,182970
33946,0.002988,74.125.24.0-255,1484,117126,64,182970
33947,0.003009,74.125.24.0-255,7156,124282,64,182970
33948,0.003115,74.125.24.0-255,2184,126466,64,182970
33949,0.003155,74.125.24.0-255,1484,127950,64,182970
33950,0.003547,74.125.24.0-255,2902,130852,64,182970
33951,0.003561,74.125.24.0-255,3602,134454,64,182970
33952,0.003644,74.125.24.0-255,2902,137356,64,182970
33953,0.003655,74.125.24.0-255,2902,140258,64,182970
33954,0.003728,74.125.24.0-255,1484,141742,64,182970
33955,0.003877,74.125.24.0-255,7156,148898,64,182970
33956,0.004133,74.125.24.0-255,5738,154636,64,182970
33957,0.004195,74.125.24.0-255,4320,158956,64,182970
33958,0.004208,74.125.24.0-255,5738,164694,64,182970
33959,0.004951,74.125.24.0-255,66,164760,64,182970
33960,0.00572,74.125.24.0-255,5738,170498,64,182970
33961,0.00584,74.125.24.0-255,2902,173400,64,182970
33962,0.010346,172.31.40.0-255,66,173466,64,182970
33963,0.012722,172.31.40.0-255,66,173532,64,182970
33964,0.012761,172.31.40.0-255,66,173598,64,182970
33965,0.014124,172.31.40.0-255,105,173703,64,182970
33966,0.020147,74.125.24.0-255,66,173769,64,182970
33967,0.052135,172.31.40.0-255,172,173941,64,182970
33968,0.052172,172.31.40.0-255,1112,175053,64,182970
33969,0.052239,172.31.40.0-255,1514,176567,64,182970
33970,0.052241,172.31.40.0-255,1514,178081,64,182970
33971,0.052247,172.31.40.0-255,1514,179595,64,182970
33972,0.052248,172.31.40.0-255,1514,181109,64,182970
33973,0.052271,172.31.40.0-255,1514,182623,64,182970
33974,0.052272,172.31.40.0-255,83,182706,64,182970
33975,0.053667,104.244.42.0-255,66,182772,64,182970
33976,0.053718,104.244.42.0-255,66,182838,64,182970
33977,0.053818,104.244.42.0-255,66,182904,64,182970
33978,0.053825,104.244.42.0-255,66,182970,64,182970
33979,0.0,74.125.24.0-255,150,150,64,262350
33980,2.2e-05,172.31.40.0-255,66,216,64,262350
33981,3e-05,74.125.24.0-255,1484,1700,64,262350
33982,3.4e-05,172.31.40.0-255,66,1766,64,262350
33983,3.9e-05,74.125.24.0-255,2902,4668,64,262350
33984,4.3e-05,172.31.40.0-255,66,4734,64,262350
33985,5.1e-05,74.125.24.0-255,7156,11890,64,262350
33986,5.4e-05,172.31.40.0-255,66,11956,64,262350
33987,8.7e-05,172.31.40.0-255,66,12022,64,262350
33988,0.000122,74.125.24.0-255,5379,17401,64,262350
33989,0.000125,172.31.40.0-255,66,17467,64,262350
33990,0.000178,74.125.24.0-255,1484,18951,64,262350
33991,0.000181,172.31.40.0-255,66,19017,64,262350
33992,0.000186,74.125.24.0-255,2902,21919,64,262350
33993,0.000188,172.31.40.0-255,66,21985,64,262350
33994,0.000193,74.125.24.0-255,2902,24887,64,262350
33995,0.000195,172.31.40.0-255,66,24953,64,262350
33996,0.000223,74.125.24.0-255,2902,27855,64,262350
33997,0.000225,172.31.40.0-255,66,27921,64,262350
33998,0.000232,74.125.24.0-255,7156,35077,64,262350
33999,0.000234,172.31.40.0-255,66,35143,64,262350
34000,0.00027,172.31.40.0-255,66,35209,64,262350
34001,0.000274,74.125.24.0-255,2483,37692,64,262350
34002,0.000277,172.31.40.0-255,66,37758,64,262350
34003,0.000294,74.125.24.0-255,130,37888,64,262350
34004,0.000296,172.31.40.0-255,66,37954,64,262350
34005,0.000369,74.125.24.0-255,1484,39438,64,262350
34006,0.000373,172.31.40.0-255,66,39504,64,262350
34007,0.000391,74.125.24.0-255,2902,42406,64,262350
34008,0.000394,172.31.40.0-255,66,42472,64,262350
34009,0.000399,74.125.24.0-255,5738,48210,64,262350
34010,0.000402,172.31.40.0-255,66,48276,64,262350
34011,0.000421,74.125.24.0-255,5738,54014,64,262350
34012,0.000423,172.31.40.0-255,66,54080,64,262350
34013,0.000442,74.125.24.0-255,824,54904,64,262350
34014,0.000567,74.125.24.0-255,1484,56388,64,262350
34015,0.000572,172.31.40.0-255,66,56454,64,262350
34016,0.000577,74.125.24.0-255,2902,59356,64,262350
34017,0.000579,172.31.40.0-255,66,59422,64,262350
34018,0.000585,74.125.24.0-255,5738,65160,64,262350
34019,0.000588,172.31.40.0-255,66,65226,64,262350
34020,0.000605,74.125.24.0-255,2902,68128,64,262350
34021,0.000608,172.31.40.0-255,66,68194,64,262350
34022,0.00065,172.31.40.0-255,66,68260,64,262350
34023,0.00066,172.31.40.0-255,66,68326,64,262350
34024,0.000662,74.125.24.0-255,766,69092,64,262350
34025,0.000804,74.125.24.0-255,1484,70576,64,262350
34026,0.000808,172.31.40.0-255,66,70642,64,262350
34027,0.000813,74.125.24.0-255,2902,73544,64,262350
34028,0.000816,172.31.40.0-255,66,73610,64,262350
34029,0.000837,74.125.24.0-255,5738,79348,64,262350
34030,0.00084,172.31.40.0-255,66,79414,64,262350
34031,0.000879,74.125.24.0-255,7156,86570,64,262350
34032,0.000882,172.31.40.0-255,66,86636,64,262350
34033,0.000899,74.125.24.0-255,5738,92374,64,262350
34034,0.000902,172.31.40.0-255,66,92440,64,262350
34035,0.000914,172.31.40.0-255,66,92506,64,262350
34036,0.000949,74.125.24.0-255,1484,93990,64,262350
34037,0.000961,74.125.24.0-255,1484,95474,64,262350
34038,0.000964,172.31.40.0-255,66,95540,64,262350
34039,0.000983,74.125.24.0-255,1484,97024,64,262350
34040,0.000987,74.125.24.0-255,2902,99926,64,262350
34041,0.00099,172.31.40.0-255,66,99992,64,262350
34042,0.000997,74.125.24.0-255,7156,107148,64,262350
34043,0.000999,172.31.40.0-255,66,107214,64,262350
34044,0.001027,172.31.40.0-255,66,107280,64,262350
34045,0.001055,74.125.24.0-255,5738,113018,64,262350
34046,0.001058,172.31.40.0-255,66,113084,64,262350
34047,0.001063,74.125.24.0-255,3602,116686,64,262350
34048,0.001065,172.31.40.0-255,66,116752,64,262350
34049,0.001208,74.125.24.0-255,1484,118236,64,262350
34050,0.001222,74.125.24.0-255,2902,121138,64,262350
34051,0.001226,172.31.40.0-255,66,121204,64,262350
34052,0.001232,74.125.24.0-255,5738,126942,64,262350
34053,0.001234,172.31.40.0-255,66,127008,64,262350
34054,0.001238,74.125.24.0-255,2902,129910,64,262350
34055,0.001241,172.31.40.0-255,66,129976,64,262350
34056,0.001268,172.31.40.0-255,66,130042,64,262350
34057,0.001285,74.125.24.0-255,7156,137198,64,262350
34058,0.001288,172.31.40.0-255,66,137264,64,262350
34059,0.001308,74.125.24.0-255,3602,140866,64,262350
34060,0.001313,172.31.40.0-255,66,140932,64,262350
34061,0.001357,74.125.24.0-255,1484,142416,64,262350
34062,0.001361,74.125.24.0-255,1484,143900,64,262350
34063,0.001364,172.31.40.0-255,66,143966,64,262350
34064,0.001381,74.125.24.0-255,1484,145450,64,262350
34065,0.001388,74.125.24.0-255,5738,151188,64,262350
34066,0.00139,172.31.40.0-255,66,151254,64,262350
34067,0.001392,74.125.24.0-255,1484,152738,64,262350
34068,0.001409,74.125.24.0-255,5738,158476,64,262350
34069,0.001411,172.31.40.0-255,66,158542,64,262350
34070,0.001437,74.125.24.0-255,5738,164280,64,262350
34071,0.00144,172.31.40.0-255,66,164346,64,262350
34072,0.001457,172.31.40.0-255,66,164412,64,262350
34073,0.001645,74.125.24.0-255,1484,165896,64,262350
34074,0.001651,74.125.24.0-255,2902,168798,64,262350
34075,0.001654,172.31.40.0-255,66,168864,64,262350
34076,0.001676,74.125.24.0-255,5738,174602,64,262350
34077,0.001678,172.31.40.0-255,66,174668,64,262350
34078,0.001681,74.125.24.0-255,1484,176152,64,262350
34079,0.001709,172.31.40.0-255,66,176218,64,262350
34080,0.001751,172.31.40.0-255,66,176284,64,262350
34081,0.001769,74.125.24.0-255,2184,178468,64,262350
34082,0.001772,172.31.40.0-255,66,178534,64,262350
34083,0.001792,74.125.24.0-255,7156,185690,64,262350
34084,0.001795,172.31.40.0-255,66,185756,64,262350
34085,0.001801,74.125.24.0-255,5738,191494,64,262350
34086,0.001803,172.31.40.0-255,66,191560,64,262350
34087,0.00182,74.125.24.0-255,2902,194462,64,262350
34088,0.001823,172.31.40.0-255,66,194528,64,262350
34089,0.001825,74.125.24.0-255,1484,196012,64,262350
34090,0.001865,172.31.40.0-255,66,196078,64,262350
34091,0.001868,74.125.24.0-255,766,196844,64,262350
34092,0.001915,74.125.24.0-255,1484,198328,64,262350
34093,0.001919,74.125.24.0-255,2902,201230,64,262350
34094,0.001923,172.31.40.0-255,66,201296,64,262350
34095,0.001927,172.31.40.0-255,66,201362,64,262350
34096,0.001947,74.125.24.0-255,5738,207100,64,262350
34097,0.001951,172.31.40.0-255,66,207166,64,262350
34098,0.001955,74.125.24.0-255,2902,210068,64,262350
34099,0.001957,172.31.40.0-255,66,210134,64,262350
34100,0.001968,172.31.40.0-255,66,210200,64,262350
34101,0.001987,74.125.24.0-255,1484,211684,64,262350
34102,0.001992,74.125.24.0-255,2902,214586,64,262350
34103,0.001995,172.31.40.0-255,66,214652,64,262350
34104,0.002021,172.31.40.0-255,66,214718,64,262350
34105,0.002208,74.125.24.0-255,1484,216202,64,262350
34106,0.002214,74.125.24.0-255,2902,219104,64,262350
34107,0.002217,172.31.40.0-255,66,219170,64,262350
34108,0.002222,74.125.24.0-255,2902,222072,64,262350
34109,0.002224,172.31.40.0-255,66,222138,64,262350
34110,0.002238,74.125.24.0-255,2902,225040,64,262350
34111,0.00224,172.31.40.0-255,66,225106,64,262350
34112,0.002247,74.125.24.0-255,5738,230844,64,262350
34113,0.002249,172.31.40.0-255,66,230910,64,262350
34114,0.00228,74.125.24.0-255,7156,238066,64,262350
34115,0.002283,172.31.40.0-255,66,238132,64,262350
34116,0.002297,172.31.40.0-255,66,238198,64,262350
34117,0.002303,74.125.24.0-255,7156,245354,64,262350
34118,0.002306,172.31.40.0-255,66,245420,64,262350
34119,0.002333,74.125.24.0-255,7156,252576,64,262350
34120,0.002336,172.31.40.0-255,66,252642,64,262350
34121,0.00235,74.125.24.0-255,5014,257656,64,262350
34122,0.002353,172.31.40.0-255,66,257722,64,262350
34123,0.002374,74.125.24.0-255,105,257827,64,262350
34124,0.004656,172.31.40.0-255,66,257893,64,262350
34125,0.004694,172.31.40.0-255,105,257998,64,262350
34126,0.007178,74.125.24.0-255,66,258064,64,262350
34127,0.049097,172.31.40.0-255,166,258230,64,262350
34128,0.049147,172.31.40.0-255,1137,259367,64,262350
34129,0.049244,172.31.40.0-255,1514,260881,64,262350
34130,0.049246,172.31.40.0-255,1271,262152,64,262350
34131,0.050615,104.244.42.0-255,66,262218,64,262350
34132,0.050639,104.244.42.0-255,66,262284,64,262350
34133,0.050748,104.244.42.0-255,66,262350,64,262350
34134,0.0,172.217.194.0-255,146,146,64,188468
34135,2.1e-05,172.31.40.0-255,66,212,64,188468
34136,2.8e-05,172.217.194.0-255,1484,1696,64,188468
34137,3.3e-05,172.31.40.0-255,66,1762,64,188468
34138,3.9e-05,172.217.194.0-255,2902,4664,64,188468
34139,4.2e-05,172.31.40.0-255,66,4730,64,188468
34140,5e-05,172.217.194.0-255,7156,11886,64,188468
34141,5.2e-05,172.31.40.0-255,66,11952,64,188468
34142,7.8e-05,172.217.194.0-255,1910,13862,64,188468
34143,8e-05,172.31.40.0-255,66,13928,64,188468
34144,0.000215,172.217.194.0-255,1484,15412,64,188468
34145,0.00022,172.31.40.0-255,66,15478,64,188468
34146,0.000226,172.217.194.0-255,2902,18380,64,188468
34147,0.000228,172.31.40.0-255,66,18446,64,188468
34148,0.000232,172.217.194.0-255,2902,21348,64,188468
34149,0.000235,172.31.40.0-255,66,21414,64,188468
34150,0.000251,172.217.194.0-255,1484,22898,64,188468
34151,0.000253,172.31.40.0-255,66,22964,64,188468
34152,0.00027,172.217.194.0-255,7156,30120,64,188468
34153,0.000272,172.31.40.0-255,66,30186,64,188468
34154,0.0003,172.217.194.0-255,2543,32729,64,188468
34155,0.000303,172.31.40.0-255,66,32795,64,188468
34156,0.000316,172.31.40.0-255,66,32861,64,188468
34157,0.000339,172.217.194.0-255,5738,38599,64,188468
34158,0.000342,172.31.40.0-255,66,38665,64,188468
34159,0.000362,172.217.194.0-255,5379,44044,64,188468
34160,0.000364,172.31.40.0-255,66,44110,64,188468
34161,0.000389,172.217.194.0-255,7156,51266,64,188468
34162,0.000392,172.31.40.0-255,66,51332,64,188468
34163,0.000409,172.217.194.0-255,1441,52773,64,188468
34164,0.000411,172.31.40.0-255,66,52839,64,188468
34165,0.000532,172.217.194.0-255,362,53201,64,188468
34166,0.000536,172.31.40.0-255,66,53267,64,188468
34167,0.000749,172.217.194.0-255,1484,54751,64,188468
34168,0.000765,172.217.194.0-255,2902,57653,64,188468
34169,0.000771,172.217.194.0-255,5738,63391,64,188468
34170,0.000778,172.31.40.0-255,66,63457,64,188468
34171,0.000796,172.217.194.0-255,7156,70613,64,188468
34172,0.000815,172.31.40.0-255,66,70679,64,188468
34173,0.000833,172.217.194.0-255,1484,72163,64,188468
34174,0.00089,172.31.40.0-255,66,72229,64,188468
34175,0.001074,172.217.194.0-255,1484,73713,64,188468
34176,0.001082,172.217.194.0-255,2902,76615,64,188468
34177,0.001086,172.31.40.0-255,66,76681,64,188468
34178,0.001092,172.217.194.0-255,5738,82419,64,188468
34179,0.001163,172.217.194.0-255,1484,83903,64,188468
34180,0.001168,172.217.194.0-255,2902,86805,64,188468
34181,0.001193,172.217.194.0-255,5738,92543,64,188468
34182,0.001207,172.217.194.0-255,1484,94027,64,188468
34183,0.001264,172.217.194.0-255,2902,96929,64,188468
34184,0.001354,172.217.194.0-255,1484,98413,64,188468
34185,0.001372,172.217.194.0-255,2902,101315,64,188468
34186,0.001395,172.217.194.0-255,5738,107053,64,188468
34187,0.001429,172.217.194.0-255,1484,108537,64,188468
34188,0.001464,172.217.194.0-255,5738,114275,64,188468
34189,0.001485,172.217.194.0-255,5020,119295,64,188468
34190,0.001579,172.217.194.0-255,1484,120779,64,188468
34191,0.001584,172.217.194.0-255,2902,123681,64,188468
34192,0.001588,172.217.194.0-255,1484,125165,64,188468
34193,0.001612,172.217.194.0-255,4320,129485,64,188468
34194,0.001617,172.217.194.0-255,5738,135223,64,188468
34195,0.001626,172.217.194.0-255,1484,136707,64,188468
34196,0.001672,172.217.194.0-255,5738,142445,64,188468
34197,0.001736,172.217.194.0-255,2902,145347,64,188468
34198,0.001757,172.217.194.0-255,5738,151085,64,188468
34199,0.001782,172.217.194.0-255,5738,156823,64,188468
34200,0.001795,172.217.194.0-255,2902,159725,64,188468
34201,0.001837,172.217.194.0-255,1484,161209,64,188468
34202,0.001849,172.217.194.0-255,2902,164111,64,188468
34203,0.001861,172.217.194.0-255,1484,165595,64,188468
34204,0.001877,172.217.194.0-255,5738,171333,64,188468
34205,0.001896,172.217.194.0-255,2184,173517,64,188468
34206,0.002026,172.217.194.0-255,3602,177119,64,188468
34207,0.002074,172.217.194.0-255,5738,182857,64,188468
34208,0.0023,172.217.194.0-255,105,182962,64,188468
34209,0.008779,172.31.40.0-255,66,183028,64,188468
34210,0.011673,172.31.40.0-255,105,183133,64,188468
34211,0.014018,172.217.194.0-255,66,183199,64,188468
34212,0.048829,172.31.40.0-255,167,183366,64,188468
34213,0.048856,172.31.40.0-255,1111,184477,64,188468
34214,0.048906,172.31.40.0-255,1514,185991,64,188468
34215,0.048907,172.31.40.0-255,1514,187505,64,188468
34216,0.048928,172.31.40.0-255,699,188204,64,188468
34217,0.050341,104.244.42.0-255,66,188270,64,188468
34218,0.050373,104.244.42.0-255,66,188336,64,188468
34219,0.050432,104.244.42.0-255,66,188402,64,188468
34220,0.050436,104.244.42.0-255,66,188468,64,188468
34221,0.0,74.125.68.0-255,156,156,64,235425
34222,1.8e-05,172.31.40.0-255,66,222,64,235425
34223,2.4e-05,74.125.68.0-255,1484,1706,64,235425
34224,2.8e-05,172.31.40.0-255,66,1772,64,235425
34225,3.4e-05,74.125.68.0-255,2902,4674,64,235425
34226,3.8e-05,172.31.40.0-255,66,4740,64,235425
34227,7.2e-05,74.125.68.0-255,7156,11896,64,235425
34228,7.6e-05,172.31.40.0-255,66,11962,64,235425
34229,9.1e-05,74.125.68.0-255,2138,14100,64,235425
34230,9.4e-05,172.31.40.0-255,66,14166,64,235425
34231,0.000141,74.125.68.0-255,1484,15650,64,235425
34232,0.000143,172.31.40.0-255,66,15716,64,235425
34233,0.000149,74.125.68.0-255,2902,18618,64,235425
34234,0.000151,172.31.40.0-255,66,18684,64,235425
34235,0.000178,74.125.68.0-255,2902,21586,64,235425
34236,0.000181,172.31.40.0-255,66,21652,64,235425
34237,0.000186,74.125.68.0-255,4320,25972,64,235425
34238,0.000189,172.31.40.0-255,66,26038,64,235425
34239,0.000225,74.125.68.0-255,5379,31417,64,235425
34240,0.000228,172.31.40.0-255,66,31483,64,235425
34241,0.000427,74.125.68.0-255,1484,32967,64,235425
34242,0.000443,172.31.40.0-255,66,33033,64,235425
34243,0.000449,74.125.68.0-255,2902,35935,64,235425
34244,0.000451,172.31.40.0-255,66,36001,64,235425
34245,0.000477,74.125.68.0-255,5738,41739,64,235425
34246,0.000481,172.31.40.0-255,66,41805,64,235425
34247,0.000485,74.125.68.0-255,2902,44707,64,235425
34248,0.000487,172.31.40.0-255,66,44773,64,235425
34249,0.000493,74.125.68.0-255,3961,48734,64,235425
34250,0.000495,172.31.40.0-255,66,48800,64,235425
34251,0.000566,74.125.68.0-255,1484,50284,64,235425
34252,0.000569,172.31.40.0-255,66,50350,64,235425
34253,0.000574,74.125.68.0-255,2902,53252,64,235425
34254,0.000577,172.31.40.0-255,66,53318,64,235425
34255,0.000601,74.125.68.0-255,4320,57638,64,235425
34256,0.000605,172.31.40.0-255,66,57704,64,235425
34257,0.000615,74.125.68.0-255,2902,60606,64,235425
34258,0.000617,172.31.40.0-255,66,60672,64,235425
34259,0.000638,74.125.68.0-255,5709,66381,64,235425
34260,0.000641,172.31.40.0-255,66,66447,64,235425
34261,0.000679,74.125.68.0-255,348,66795,64,235425
34262,0.001136,172.31.40.0-255,66,66861,64,235425
34263,0.001288,74.125.68.0-255,1484,68345,64,235425
34264,0.001298,74.125.68.0-255,2902,71247,64,235425
34265,0.001302,172.31.40.0-255,66,71313,64,235425
34266,0.001306,74.125.68.0-255,1484,72797,64,235425
34267,0.001322,74.125.68.0-255,2902,75699,64,235425
34268,0.001325,172.31.40.0-255,66,75765,64,235425
34269,0.00134,74.125.68.0-255,2902,78667,64,235425
34270,0.001343,172.31.40.0-255,66,78733,64,235425
34271,0.00136,74.125.68.0-255,2902,81635,64,235425
34272,0.001362,172.31.40.0-255,66,81701,64,235425
34273,0.001401,172.31.40.0-255,66,81767,64,235425
34274,0.001409,74.125.68.0-255,5738,87505,64,235425
34275,0.001411,172.31.40.0-255,66,87571,64,235425
34276,0.001428,74.125.68.0-255,3602,91173,64,235425
34277,0.00143,172.31.40.0-255,66,91239,64,235425
34278,0.003651,74.125.68.0-255,1484,92723,64,235425
34279,0.003675,74.125.68.0-255,1484,94207,64,235425
34280,0.00368,172.31.40.0-255,66,94273,64,235425
34281,0.0037,74.125.68.0-255,2902,97175,64,235425
34282,0.003703,172.31.40.0-255,66,97241,64,235425
34283,0.005936,74.125.68.0-255,4320,101561,64,235425
34284,0.005941,172.31.40.0-255,66,101627,64,235425
34285,0.005957,74.125.68.0-255,1484,103111,64,235425
34286,0.0082,74.125.68.0-255,2902,106013,64,235425
34287,0.008207,172.31.40.0-255,66,106079,64,235425
34288,0.008227,74.125.68.0-255,1484,107563,64,235425
34289,0.010495,74.125.68.0-255,4320,111883,64,235425
34290,0.010504,172.31.40.0-255,66,111949,64,235425
34291,0.012768,74.125.68.0-255,5738,117687,64,235425
34292,0.012776,172.31.40.0-255,66,117753,64,235425
34293,0.015036,74.125.68.0-255,5738,123491,64,235425
34294,0.015044,172.31.40.0-255,66,123557,64,235425
34295,0.017326,74.125.68.0-255,5738,129295,64,235425
34296,0.017335,172.31.40.0-255,66,129361,64,235425
34297,0.019598,74.125.68.0-255,5738,135099,64,235425
34298,0.019607,172.31.40.0-255,66,135165,64,235425
34299,0.021881,74.125.68.0-255,4320,139485,64,235425
34300,0.021888,172.31.40.0-255,66,139551,64,235425
34301,0.021906,74.125.68.0-255,1484,141035,64,235425
34302,0.024155,74.125.68.0-255,4320,145355,64,235425
34303,0.024163,172.31.40.0-255,66,145421,64,235425
34304,0.025818,172.31.40.0-255,176,145597,64,235425
34305,0.025846,172.31.40.0-255,1113,146710,64,235425
34306,0.025894,172.31.40.0-255,1514,148224,64,235425
34307,0.025895,172.31.40.0-255,1295,149519,64,235425
34308,0.026432,74.125.68.0-255,5738,155257,64,235425
34309,0.026439,172.31.40.0-255,66,155323,64,235425
34310,0.027363,104.244.42.0-255,66,155389,64,235425
34311,0.027552,104.244.42.0-255,66,155455,64,235425
34312,0.027557,104.244.42.0-255,66,155521,64,235425
34313,0.028695,74.125.68.0-255,5738,161259,64,235425
34314,0.028701,172.31.40.0-255,66,161325,64,235425
34315,0.030972,74.125.68.0-255,5738,167063,64,235425
34316,0.030979,172.31.40.0-255,66,167129,64,235425
34317,0.03326,74.125.68.0-255,5738,172867,64,235425
34318,0.033267,172.31.40.0-255,66,172933,64,235425
34319,0.03553,74.125.68.0-255,5738,178671,64,235425
34320,0.035537,172.31.40.0-255,66,178737,64,235425
34321,0.037811,74.125.68.0-255,5738,184475,64,235425
34322,0.037818,172.31.40.0-255,66,184541,64,235425
34323,0.040097,74.125.68.0-255,5738,190279,64,235425
34324,0.040104,172.31.40.0-255,66,190345,64,235425
34325,0.042377,74.125.68.0-255,5738,196083,64,235425
34326,0.042383,172.31.40.0-255,66,196149,64,235425
34327,0.044644,74.125.68.0-255,5738,201887,64,235425
34328,0.044651,172.31.40.0-255,66,201953,64,235425
34329,0.046913,74.125.68.0-255,5738,207691,64,235425
34330,0.04692,172.31.40.0-255,66,207757,64,235425
34331,0.049187,74.125.68.0-255,5738,213495,64,235425
34332,0.049194,172.31.40.0-255,66,213561,64,235425
34333,0.051453,74.125.68.0-255,5738,219299,64,235425
34334,0.05146,172.31.40.0-255,66,219365,64,235425
34335,0.053755,74.125.68.0-255,5738,225103,64,235425
34336,0.053762,172.31.40.0-255,66,225169,64,235425
34337,0.056027,74.125.68.0-255,4320,229489,64,235425
34338,0.056033,172.31.40.0-255,66,229555,64,235425
34339,0.056053,74.125.68.0-255,1484,231039,64,235425
34340,0.058303,74.125.68.0-255,4320,235359,64,235425
34341,0.05831,172.31.40.0-255,66,235425,64,235425
34342,0.0,74.125.24.0-255,153,153,64,293917
34343,1.6e-05,172.31.40.0-255,66,219,64,293917
34344,2.3e-05,74.125.24.0-255,1484,1703,64,293917
34345,2.7e-05,172.31.40.0-255,66,1769,64,293917
34346,3.3e-05,74.125.24.0-255,2902,4671,64,293917
34347,3.6e-05,172.31.40.0-255,66,4737,64,293917
34348,4.2e-05,74.125.24.0-255,4320,9057,64,293917
34349,4.6e-05,172.31.40.0-255,66,9123,64,293917
34350,4.9e-05,74.125.24.0-255,1484,10607,64,293917
34351,5.2e-05,172.31.40.0-255,66,10673,64,293917
34352,8.5e-05,172.31.40.0-255,66,10739,64,293917
34353,9.7e-05,172.31.40.0-255,66,10805,64,293917
34354,0.000117,74.125.24.0-255,3961,14766,64,293917
34355,0.000119,172.31.40.0-255,66,14832,64,293917
34356,0.000168,74.125.24.0-255,1484,16316,64,293917
34357,0.00017,172.31.40.0-255,66,16382,64,293917
34358,0.000175,74.125.24.0-255,2902,19284,64,293917
34359,0.000177,172.31.40.0-255,66,19350,64,293917
34360,0.00018,74.125.24.0-255,1484,20834,64,293917
34361,0.000182,172.31.40.0-255,66,20900,64,293917
34362,0.000204,74.125.24.0-255,4320,25220,64,293917
34363,0.000207,172.31.40.0-255,66,25286,64,293917
34364,0.000218,172.31.40.0-255,66,25352,64,293917
34365,0.00023,172.31.40.0-255,66,25418,64,293917
34366,0.000253,74.125.24.0-255,1484,26902,64,293917
34367,0.000256,172.31.40.0-255,66,26968,64,293917
34368,0.000278,74.125.24.0-255,5651,32619,64,293917
34369,0.000281,172.31.40.0-255,66,32685,64,293917
34370,0.000343,74.125.24.0-255,129,32814,64,293917
34371,0.000524,74.125.24.0-255,1484,34298,64,293917
34372,0.00053,172.31.40.0-255,66,34364,64,293917
34373,0.000536,74.125.24.0-255,2902,37266,64,293917
34374,0.000539,172.31.40.0-255,66,37332,64,293917
34375,0.000546,74.125.24.0-255,5738,43070,64,293917
34376,0.000548,172.31.40.0-255,66,43136,64,293917
34377,0.000572,74.125.24.0-255,6797,49933,64,293917
34378,0.000575,172.31.40.0-255,66,49999,64,293917
34379,0.000615,172.31.40.0-255,66,50065,64,293917
34380,0.000619,74.125.24.0-255,2248,52313,64,293917
34381,0.000621,172.31.40.0-255,66,52379,64,293917
34382,0.00072,74.125.24.0-255,1484,53863,64,293917
34383,0.000727,74.125.24.0-255,2902,56765,64,293917
34384,0.000729,172.31.40.0-255,66,56831,64,293917
34385,0.000755,74.125.24.0-255,5738,62569,64,293917
34386,0.000758,172.31.40.0-255,66,62635,64,293917
34387,0.000772,172.31.40.0-255,66,62701,64,293917
34388,0.000818,74.125.24.0-255,5738,68439,64,293917
34389,0.000821,172.31.40.0-255,66,68505,64,293917
34390,0.000843,74.125.24.0-255,5020,73525,64,293917
34391,0.000845,172.31.40.0-255,66,73591,64,293917
34392,0.001288,74.125.24.0-255,1484,75075,64,293917
34393,0.001295,74.125.24.0-255,2902,77977,64,293917
34394,0.0013,74.125.24.0-255,4320,82297,64,293917
34395,0.001307,172.31.40.0-255,66,82363,64,293917
34396,0.001311,172.31.40.0-255,66,82429,64,293917
34397,0.001319,74.125.24.0-255,1484,83913,64,293917
34398,0.001326,74.125.24.0-255,5738,89651,64,293917
34399,0.001328,172.31.40.0-255,66,89717,64,293917
34400,0.001372,172.31.40.0-255,66,89783,64,293917
34401,0.001378,74.125.24.0-255,5020,94803,64,293917
34402,0.00138,172.31.40.0-255,66,94869,64,293917
34403,0.001449,74.125.24.0-255,1484,96353,64,293917
34404,0.001493,74.125.24.0-255,2902,99255,64,293917
34405,0.001497,172.31.40.0-255,66,99321,64,293917
34406,0.001504,74.125.24.0-255,5738,105059,64,293917
34407,0.001506,172.31.40.0-255,66,105125,64,293917
34408,0.001511,74.125.24.0-255,2902,108027,64,293917
34409,0.001513,172.31.40.0-255,66,108093,64,293917
34410,0.001545,74.125.24.0-255,1484,109577,64,293917
34411,0.001562,172.31.40.0-255,66,109643,64,293917
34412,0.001568,74.125.24.0-255,3602,113245,64,293917
34413,0.00157,172.31.40.0-255,66,113311,64,293917
34414,0.002074,74.125.24.0-255,1484,114795,64,293917
34415,0.002081,74.125.24.0-255,2902,117697,64,293917
34416,0.002085,172.31.40.0-255,66,117763,64,293917
34417,0.002109,74.125.24.0-255,4320,122083,64,293917
34418,0.002111,172.31.40.0-255,66,122149,64,293917
34419,0.002114,74.125.24.0-255,1484,123633,64,293917
34420,0.002135,74.125.24.0-255,4320,127953,64,293917
34421,0.002137,172.31.40.0-255,66,128019,64,293917
34422,0.002175,74.125.24.0-255,7156,135175,64,293917
34423,0.002177,172.31.40.0-255,66,135241,64,293917
34424,0.002196,74.125.24.0-255,4320,139561,64,293917
34425,0.002199,172.31.40.0-255,66,139627,64,293917
34426,0.002209,172.31.40.0-255,66,139693,64,293917
34427,0.002415,74.125.24.0-255,1484,141177,64,293917
34428,0.00242,74.125.24.0-255,2902,144079,64,293917
34429,0.002425,172.31.40.0-255,66,144145,64,293917
34430,0.002437,74.125.24.0-255,5738,149883,64,293917
34431,0.002439,172.31.40.0-255,66,149949,64,293917
34432,0.002445,74.125.24.0-255,4320,154269,64,293917
34433,0.002447,172.31.40.0-255,66,154335,64,293917
34434,0.002479,74.125.24.0-255,1484,155819,64,293917
34435,0.002499,172.31.40.0-255,66,155885,64,293917
34436,0.002505,74.125.24.0-255,5020,160905,64,293917
34437,0.002507,172.31.40.0-255,66,160971,64,293917
34438,0.005054,74.125.24.0-255,2902,163873,64,293917
34439,0.005059,172.31.40.0-255,66,163939,64,293917
34440,0.005081,74.125.24.0-255,2902,166841,64,293917
34441,0.005083,172.31.40.0-255,66,166907,64,293917
34442,0.007597,74.125.24.0-255,2902,169809,64,293917
34443,0.007601,172.31.40.0-255,66,169875,64,293917
34444,0.007627,74.125.24.0-255,2902,172777,64,293917
34445,0.007629,172.31.40.0-255,66,172843,64,293917
34446,0.010138,74.125.24.0-255,2902,175745,64,293917
34447,0.010145,172.31.40.0-255,66,175811,64,293917
34448,0.010215,74.125.24.0-255,2902,178713,64,293917
34449,0.010219,172.31.40.0-255,66,178779,64,293917
34450,0.012681,74.125.24.0-255,2902,181681,64,293917
34451,0.012703,172.31.40.0-255,66,181747,64,293917
34452,0.012771,74.125.24.0-255,2902,184649,64,293917
34453,0.012775,172.31.40.0-255,66,184715,64,293917
34454,0.015252,74.125.24.0-255,2902,187617,64,293917
34455,0.01526,172.31.40.0-255,66,187683,64,293917
34456,0.015312,74.125.24.0-255,2902,190585,64,293917
34457,0.015315,172.31.40.0-255,66,190651,64,293917
34458,0.017823,74.125.24.0-255,2902,193553,64,293917
34459,0.017831,172.31.40.0-255,66,193619,64,293917
34460,0.017852,74.125.24.0-255,2902,196521,64,293917
34461,0.017854,172.31.40.0-255,66,196587,64,293917
34462,0.020378,74.125.24.0-255,5738,202325,64,293917
34463,0.020387,172.31.40.0-255,66,202391,64,293917
34464,0.022928,74.125.24.0-255,5738,208129,64,293917
34465,0.022934,172.31.40.0-255,66,208195,64,293917
34466,0.025479,74.125.24.0-255,5738,213933,64,293917
34467,0.025485,172.31.40.0-255,66,213999,64,293917
34468,0.028031,74.125.24.0-255,5738,219737,64,293917
34469,0.028038,172.31.40.0-255,66,219803,64,293917
34470,0.030344,172.31.40.0-255,172,219975,64,293917
34471,0.030375,172.31.40.0-255,1112,221087,64,293917
34472,0.030432,172.31.40.0-255,1514,222601,64,293917
34473,0.030433,172.31.40.0-255,1296,223897,64,293917
34474,0.030589,74.125.24.0-255,5738,229635,64,293917
34475,0.030595,172.31.40.0-255,66,229701,64,293917
34476,0.031884,104.244.42.0-255,66,229767,64,293917
34477,0.031952,104.244.42.0-255,66,229833,64,293917
34478,0.031974,104.244.42.0-255,66,229899,64,293917
34479,0.032623,104.244.42.0-255,108,230007,64,293917
34480,0.03263,172.31.40.0-255,66,230073,64,293917
34481,0.033144,74.125.24.0-255,5738,235811,64,293917
34482,0.033149,172.31.40.0-255,66,235877,64,293917
34483,0.035716,74.125.24.0-255,5738,241615,64,293917
34484,0.035723,172.31.40.0-255,66,241681,64,293917
34485,0.038266,74.125.24.0-255,5738,247419,64,293917
34486,0.038275,172.31.40.0-255,66,247485,64,293917
34487,0.040839,74.125.24.0-255,5738,253223,64,293917
34488,0.040848,172.31.40.0-255,66,253289,64,293917
34489,0.043424,74.125.24.0-255,5738,259027,64,293917
34490,0.043431,172.31.40.0-255,66,259093,64,293917
34491,0.045994,74.125.24.0-255,5738,264831,64,293917
34492,0.046,172.31.40.0-255,66,264897,64,293917
34493,0.048531,74.125.24.0-255,5738,270635,64,293917
34494,0.048538,172.31.40.0-255,66,270701,64,293917
34495,0.051079,74.125.24.0-255,5738,276439,64,293917
34496,0.051087,172.31.40.0-255,66,276505,64,293917
34497,0.053629,74.125.24.0-255,5738,282243,64,293917
34498,0.053638,172.31.40.0-255,66,282309,64,293917
34499,0.056203,74.125.24.0-255,5738,288047,64,293917
34500,0.056209,172.31.40.0-255,66,288113,64,293917
34501,0.058748,74.125.24.0-255,5738,293851,64,293917
34502,0.058754,172.31.40.0-255,66,293917,64,293917
34503,0.0,172.217.194.0-255,153,153,64,313682
34504,2.4e-05,172.31.40.0-255,66,219,64,313682
34505,3.1e-05,172.217.194.0-255,1484,1703,64,313682
34506,3.6e-05,172.31.40.0-255,66,1769,64,313682
34507,5e-05,172.217.194.0-255,2902,4671,64,313682
34508,5.3e-05,172.31.40.0-255,66,4737,64,313682
34509,6.1e-05,172.217.194.0-255,7156,11893,64,313682
34510,6.4e-05,172.31.40.0-255,66,11959,64,313682
34511,6.8e-05,172.217.194.0-255,1984,13943,64,313682
34512,7.1e-05,172.31.40.0-255,66,14009,64,313682
34513,0.000105,172.217.194.0-255,5738,19747,64,313682
34514,0.000108,172.31.40.0-255,66,19813,64,313682
34515,0.000141,172.217.194.0-255,5738,25551,64,313682
34516,0.000144,172.31.40.0-255,66,25617,64,313682
34517,0.00015,172.217.194.0-255,5379,30996,64,313682
34518,0.000152,172.31.40.0-255,66,31062,64,313682
34519,0.000257,172.217.194.0-255,1484,32546,64,313682
34520,0.000261,172.31.40.0-255,66,32612,64,313682
34521,0.000267,172.217.194.0-255,2902,35514,64,313682
34522,0.000269,172.31.40.0-255,66,35580,64,313682
34523,0.000284,172.217.194.0-255,1484,37064,64,313682
34524,0.000286,172.31.40.0-255,66,37130,64,313682
34525,0.00031,172.217.194.0-255,4320,41450,64,313682
34526,0.000314,172.31.40.0-255,66,41516,64,313682
34527,0.000322,172.217.194.0-255,6797,48313,64,313682
34528,0.000324,172.31.40.0-255,66,48379,64,313682
34529,0.00096,172.217.194.0-255,1484,49863,64,313682
34530,0.000966,172.31.40.0-255,66,49929,64,313682
34531,0.000976,172.217.194.0-255,2902,52831,64,313682
34532,0.000978,172.31.40.0-255,66,52897,64,313682
34533,0.00099,172.217.194.0-255,5738,58635,64,313682
34534,0.000992,172.31.40.0-255,66,58701,64,313682
34535,0.001024,172.217.194.0-255,5738,64439,64,313682
34536,0.001027,172.31.40.0-255,66,64505,64,313682
34537,0.001049,172.217.194.0-255,1125,65630,64,313682
34538,0.001076,172.217.194.0-255,4320,69950,64,313682
34539,0.001079,172.31.40.0-255,66,70016,64,313682
34540,0.001085,172.217.194.0-255,4320,74336,64,313682
34541,0.001087,172.31.40.0-255,66,74402,64,313682
34542,0.001112,172.217.194.0-255,1484,75886,64,313682
34543,0.001118,172.217.194.0-255,5738,81624,64,313682
34544,0.001121,172.31.40.0-255,66,81690,64,313682
34545,0.001144,172.217.194.0-255,1125,82815,64,313682
34546,0.001157,172.217.194.0-255,1484,84299,64,313682
34547,0.001159,172.31.40.0-255,66,84365,64,313682
34548,0.001191,172.217.194.0-255,6318,90683,64,313682
34549,0.001193,172.31.40.0-255,66,90749,64,313682
34550,0.001201,172.217.194.0-255,7156,97905,64,313682
34551,0.001203,172.31.40.0-255,66,97971,64,313682
34552,0.001234,172.217.194.0-255,2543,100514,64,313682
34553,0.001238,172.31.40.0-255,66,100580,64,313682
34554,0.001871,172.217.194.0-255,1484,102064,64,313682
34555,0.001879,172.217.194.0-255,2902,104966,64,313682
34556,0.001885,172.31.40.0-255,66,105032,64,313682
34557,0.001892,172.217.194.0-255,5738,110770,64,313682
34558,0.001895,172.31.40.0-255,66,110836,64,313682
34559,0.001907,172.217.194.0-255,5738,116574,64,313682
34560,0.001909,172.31.40.0-255,66,116640,64,313682
34561,0.001916,172.217.194.0-255,5738,122378,64,313682
34562,0.001918,172.31.40.0-255,66,122444,64,313682
34563,0.001969,172.31.40.0-255,66,122510,64,313682
34564,0.001972,172.217.194.0-255,766,123276,64,313682
34565,0.001975,172.217.194.0-255,1484,124760,64,313682
34566,0.001977,172.31.40.0-255,66,124826,64,313682
34567,0.001982,172.217.194.0-255,4320,129146,64,313682
34568,0.001985,172.31.40.0-255,66,129212,64,313682
34569,0.001996,172.31.40.0-255,66,129278,64,313682
34570,0.002037,172.217.194.0-255,7156,136434,64,313682
34571,0.00204,172.31.40.0-255,66,136500,64,313682
34572,0.002077,172.217.194.0-255,5738,142238,64,313682
34573,0.00208,172.31.40.0-255,66,142304,64,313682
34574,0.002086,172.217.194.0-255,5020,147324,64,313682
34575,0.002088,172.31.40.0-255,66,147390,64,313682
34576,0.002094,172.217.194.0-255,5738,153128,64,313682
34577,0.002096,172.31.40.0-255,66,153194,64,313682
34578,0.002107,172.31.40.0-255,66,153260,64,313682
34579,0.002158,172.31.40.0-255,66,153326,64,313682
34580,0.00216,172.217.194.0-255,766,154092,64,313682
34581,0.002261,172.217.194.0-255,1484,155576,64,313682
34582,0.002264,172.31.40.0-255,66,155642,64,313682
34583,0.002293,172.217.194.0-255,2902,158544,64,313682
34584,0.002296,172.31.40.0-255,66,158610,64,313682
34585,0.0023,172.217.194.0-255,2902,161512,64,313682
34586,0.002302,172.31.40.0-255,66,161578,64,313682
34587,0.002307,172.217.194.0-255,4320,165898,64,313682
34588,0.002315,172.31.40.0-255,66,165964,64,313682
34589,0.002345,172.217.194.0-255,2902,168866,64,313682
34590,0.002347,172.31.40.0-255,66,168932,64,313682
34591,0.002362,172.31.40.0-255,66,168998,64,313682
34592,0.002366,172.217.194.0-255,3602,172600,64,313682
34593,0.002368,172.31.40.0-255,66,172666,64,313682
34594,0.004708,172.217.194.0-255,1484,174150,64,313682
34595,0.004733,172.217.194.0-255,4320,178470,64,313682
34596,0.004738,172.31.40.0-255,66,178536,64,313682
34597,0.007128,172.217.194.0-255,5738,184274,64,313682
34598,0.007134,172.31.40.0-255,66,184340,64,313682
34599,0.00951,172.217.194.0-255,5738,190078,64,313682
34600,0.009517,172.31.40.0-255,66,190144,64,313682
34601,0.011936,172.217.194.0-255,5738,195882,64,313682
34602,0.011948,172.31.40.0-255,66,195948,64,313682
34603,0.014343,172.217.194.0-255,5738,201686,64,313682
34604,0.014352,172.31.40.0-255,66,201752,64,313682
34605,0.016706,172.217.194.0-255,5738,207490,64,313682
34606,0.016715,172.31.40.0-255,66,207556,64,313682
34607,0.019103,172.217.194.0-255,5738,213294,64,313682
34608,0.019112,172.31.40.0-255,66,213360,64,313682
34609,0.021446,172.217.194.0-255,1484,214844,64,313682
34610,0.021473,172.217.194.0-255,4320,219164,64,313682
34611,0.021479,172.31.40.0-255,66,219230,64,313682
34612,0.023806,172.217.194.0-255,5738,224968,64,313682
34613,0.023813,172.31.40.0-255,66,225034,64,313682
34614,0.026197,172.217.194.0-255,5738,230772,64,313682
34615,0.026206,172.31.40.0-255,66,230838,64,313682
34616,0.028558,172.217.194.0-255,5738,236576,64,313682
34617,0.028565,172.31.40.0-255,66,236642,64,313682
34618,0.030927,172.217.194.0-255,5738,242380,64,313682
34619,0.030935,172.31.40.0-255,66,242446,64,313682
34620,0.032124,172.31.40.0-255,172,242618,64,313682
34621,0.032157,172.31.40.0-255,1111,243729,64,313682
34622,0.032219,172.31.40.0-255,1514,245243,64,313682
34623,0.03222,172.31.40.0-255,1297,246540,64,313682
34624,0.033324,172.217.194.0-255,4320,250860,64,313682
34625,0.033332,172.31.40.0-255,66,250926,64,313682
34626,0.033357,172.217.194.0-255,1484,252410,64,313682
34627,0.033642,104.244.42.0-255,66,252476,64,313682
34628,0.033696,104.244.42.0-255,66,252542,64,313682
34629,0.033794,104.244.42.0-255,66,252608,64,313682
34630,0.035695,172.217.194.0-255,4320,256928,64,313682
34631,0.035701,172.31.40.0-255,66,256994,64,313682
34632,0.038108,172.217.194.0-255,5738,262732,64,313682
34633,0.038114,172.31.40.0-255,66,262798,64,313682
34634,0.040526,172.217.194.0-255,4320,267118,64,313682
34635,0.040532,172.31.40.0-255,66,267184,64,313682
34636,0.040558,172.217.194.0-255,1484,268668,64,313682
34637,0.042915,172.217.194.0-255,4320,272988,64,313682
34638,0.042921,172.31.40.0-255,66,273054,64,313682
34639,0.045303,172.217.194.0-255,5738,278792,64,313682
34640,0.04531,172.31.40.0-255,66,278858,64,313682
34641,0.0477,172.217.194.0-255,5738,284596,64,313682
34642,0.047705,172.31.40.0-255,66,284662,64,313682
34643,0.050112,172.217.194.0-255,5738,290400,64,313682
34644,0.050119,172.31.40.0-255,66,290466,64,313682
34645,0.052509,172.217.194.0-255,5738,296204,64,313682
34646,0.052515,172.31.40.0-255,66,296270,64,313682
34647,0.054896,172.217.194.0-255,5738,302008,64,313682
34648,0.054904,172.31.40.0-255,66,302074,64,313682
34649,0.057309,172.217.194.0-255,5738,307812,64,313682
34650,0.057316,172.31.40.0-255,66,307878,64,313682
34651,0.059728,172.217.194.0-255,5738,313616,64,313682
34652,0.059735,172.31.40.0-255,66,313682,64,313682
34653,0.0,172.217.194.0-255,150,150,64,291946
34654,2.2e-05,172.31.40.0-255,66,216,64,291946
34655,3e-05,172.217.194.0-255,1484,1700,64,291946
34656,3.4e-05,172.31.40.0-255,66,1766,64,291946
34657,4.8e-05,172.217.194.0-255,2902,4668,64,291946
34658,5.2e-05,172.31.40.0-255,66,4734,64,291946
34659,5.9e-05,172.217.194.0-255,7156,11890,64,291946
34660,6.2e-05,172.31.40.0-255,66,11956,64,291946
34661,6.6e-05,172.217.194.0-255,2130,14086,64,291946
34662,7e-05,172.31.40.0-255,66,14152,64,291946
34663,7.6e-05,172.217.194.0-255,2902,17054,64,291946
34664,7.8e-05,172.31.40.0-255,66,17120,64,291946
34665,8.4e-05,172.217.194.0-255,4320,21440,64,291946
34666,8.7e-05,172.31.40.0-255,66,21506,64,291946
34667,0.000121,172.217.194.0-255,2902,24408,64,291946
34668,0.000125,172.31.40.0-255,66,24474,64,291946
34669,0.000148,172.217.194.0-255,6797,31271,64,291946
34670,0.000152,172.31.40.0-255,66,31337,64,291946
34671,0.000329,172.217.194.0-255,1484,32821,64,291946
34672,0.000333,172.31.40.0-255,66,32887,64,291946
34673,0.000339,172.217.194.0-255,2902,35789,64,291946
34674,0.000342,172.31.40.0-255,66,35855,64,291946
34675,0.000345,172.217.194.0-255,1484,37339,64,291946
34676,0.000352,172.31.40.0-255,66,37405,64,291946
34677,0.000389,172.217.194.0-255,4320,41725,64,291946
34678,0.000391,172.31.40.0-255,66,41791,64,291946
34679,0.000399,172.217.194.0-255,6797,48588,64,291946
34680,0.000401,172.31.40.0-255,66,48654,64,291946
34681,0.000427,172.217.194.0-255,7156,55810,64,291946
34682,0.00043,172.31.40.0-255,66,55876,64,291946
34683,0.000462,172.217.194.0-255,7156,63032,64,291946
34684,0.000465,172.31.40.0-255,66,63098,64,291946
34685,0.000468,172.217.194.0-255,2543,65641,64,291946
34686,0.00047,172.31.40.0-255,66,65707,64,291946
34687,0.000473,172.217.194.0-255,677,66384,64,291946
34688,0.001007,172.217.194.0-255,1484,67868,64,291946
34689,0.001013,172.31.40.0-255,66,67934,64,291946
34690,0.00102,172.217.194.0-255,2902,70836,64,291946
34691,0.001022,172.31.40.0-255,66,70902,64,291946
34692,0.001033,172.217.194.0-255,5738,76640,64,291946
34693,0.001035,172.31.40.0-255,66,76706,64,291946
34694,0.001038,172.217.194.0-255,1484,78190,64,291946
34695,0.001062,172.217.194.0-255,4320,82510,64,291946
34696,0.001065,172.31.40.0-255,66,82576,64,291946
34697,0.001082,172.31.40.0-255,66,82642,64,291946
34698,0.001089,172.217.194.0-255,5020,87662,64,291946
34699,0.001091,172.31.40.0-255,66,87728,64,291946
34700,0.001314,172.217.194.0-255,1484,89212,64,291946
34701,0.001321,172.217.194.0-255,2902,92114,64,291946
34702,0.001324,172.31.40.0-255,66,92180,64,291946
34703,0.001329,172.217.194.0-255,2902,95082,64,291946
34704,0.001331,172.31.40.0-255,66,95148,64,291946
34705,0.001357,172.217.194.0-255,2902,98050,64,291946
34706,0.001364,172.217.194.0-255,5738,103788,64,291946
34707,0.0014,172.217.194.0-255,5738,109526,64,291946
34708,0.001405,172.31.40.0-255,66,109592,64,291946
34709,0.001407,172.31.40.0-255,66,109658,64,291946
34710,0.001414,172.31.40.0-255,66,109724,64,291946
34711,0.001427,172.217.194.0-255,7156,116880,64,291946
34712,0.001429,172.31.40.0-255,66,116946,64,291946
34713,0.001435,172.217.194.0-255,5020,121966,64,291946
34714,0.001437,172.31.40.0-255,66,122032,64,291946
34715,0.001693,172.217.194.0-255,1484,123516,64,291946
34716,0.0017,172.217.194.0-255,2902,126418,64,291946
34717,0.001703,172.31.40.0-255,66,126484,64,291946
34718,0.00171,172.217.194.0-255,5738,132222,64,291946
34719,0.001712,172.31.40.0-255,66,132288,64,291946
34720,0.001748,172.31.40.0-255,66,132354,64,291946
34721,0.001777,172.217.194.0-255,4320,136674,64,291946
34722,0.001788,172.217.194.0-255,766,137440,64,291946
34723,0.001793,172.31.40.0-255,66,137506,64,291946
34724,0.001796,172.31.40.0-255,66,137572,64,291946
34725,0.002202,172.31.40.0-255,66,137638,64,291946
34726,0.002246,172.217.194.0-255,1484,139122,64,291946
34727,0.002252,172.217.194.0-255,2902,142024,64,291946
34728,0.002255,172.31.40.0-255,66,142090,64,291946
34729,0.002262,172.217.194.0-255,5738,147828,64,291946
34730,0.002264,172.31.40.0-255,66,147894,64,291946
34731,0.002279,172.217.194.0-255,1484,149378,64,291946
34732,0.002315,172.31.40.0-255,66,149444,64,291946
34733,0.002355,172.31.40.0-255,66,149510,64,291946
34734,0.004652,172.217.194.0-255,5738,155248,64,291946
34735,0.004658,172.31.40.0-255,66,155314,64,291946
34736,0.006965,172.217.194.0-255,5738,161052,64,291946
34737,0.006968,172.31.40.0-255,66,161118,64,291946
34738,0.009301,172.217.194.0-255,5738,166856,64,291946
34739,0.009308,172.31.40.0-255,66,166922,64,291946
34740,0.01162,172.217.194.0-255,5738,172660,64,291946
34741,0.011629,172.31.40.0-255,66,172726,64,291946
34742,0.01393,172.217.194.0-255,5738,178464,64,291946
34743,0.013939,172.31.40.0-255,66,178530,64,291946
34744,0.016261,172.217.194.0-255,5738,184268,64,291946
34745,0.016273,172.31.40.0-255,66,184334,64,291946
34746,0.018583,172.217.194.0-255,5738,190072,64,291946
34747,0.018592,172.31.40.0-255,66,190138,64,291946
34748,0.020905,172.217.194.0-255,5738,195876,64,291946
34749,0.020914,172.31.40.0-255,66,195942,64,291946
34750,0.023229,172.217.194.0-255,5738,201680,64,291946
34751,0.023238,172.31.40.0-255,66,201746,64,291946
34752,0.025566,172.217.194.0-255,5738,207484,64,291946
34753,0.025584,172.31.40.0-255,66,207550,64,291946
34754,0.027909,172.217.194.0-255,5738,213288,64,291946
34755,0.027923,172.31.40.0-255,66,213354,64,291946
34756,0.030237,172.217.194.0-255,5738,219092,64,291946
34757,0.030257,172.31.40.0-255,66,219158,64,291946
34758,0.032589,172.217.194.0-255,5738,224896,64,291946
34759,0.032597,172.31.40.0-255,66,224962,64,291946
34760,0.034927,172.217.194.0-255,5738,230700,64,291946
34761,0.034936,172.31.40.0-255,66,230766,64,291946
34762,0.037348,172.217.194.0-255,5738,236504,64,291946
34763,0.037364,172.31.40.0-255,66,236570,64,291946
34764,0.039733,172.217.194.0-255,5738,242308,64,291946
34765,0.03974,172.31.40.0-255,66,242374,64,291946
34766,0.042105,172.217.194.0-255,5738,248112,64,291946
34767,0.042122,172.31.40.0-255,66,248178,64,291946
34768,0.0445,172.217.194.0-255,5738,253916,64,291946
34769,0.044507,172.31.40.0-255,66,253982,64,291946
34770,0.046833,172.217.194.0-255,5738,259720,64,291946
34771,0.046852,172.31.40.0-255,66,259786,64,291946
34772,0.047505,172.31.40.0-255,198,259984,64,291946
34773,0.047538,172.31.40.0-255,955,260939,64,291946
34774,0.047598,172.31.40.0-255,1514,262453,64,291946
34775,0.0476,172.31.40.0-255,1453,263906,64,291946
34776,0.049039,104.244.42.0-255,66,263972,64,291946
34777,0.049081,104.244.42.0-255,66,264038,64,291946
34778,0.049149,172.217.194.0-255,4320,268358,64,291946
34779,0.049155,172.31.40.0-255,66,268424,64,291946
34780,0.049186,172.217.194.0-255,1484,269908,64,291946
34781,0.04922,104.244.42.0-255,66,269974,64,291946
34782,0.050186,104.244.42.0-255,108,270082,64,291946
34783,0.050194,172.31.40.0-255,66,270148,64,291946
34784,0.051484,172.217.194.0-255,4320,274468,64,291946
34785,0.051493,172.31.40.0-255,66,274534,64,291946
34786,0.053814,172.217.194.0-255,5738,280272,64,291946
34787,0.053832,172.31.40.0-255,66,280338,64,291946
34788,0.056159,172.217.194.0-255,5738,286076,64,291946
34789,0.056175,172.31.40.0-255,66,286142,64,291946
34790,0.058512,172.217.194.0-255,5738,291880,64,291946
34791,0.05853,172.31.40.0-255,66,291946,64,291946
34792,0.0,74.125.130.0-255,153,153,64,294001
34793,2.2e-05,172.31.40.0-255,66,219,64,294001
34794,2.9e-05,74.125.130.0-255,1484,1703,64,294001
34795,3.4e-05,172.31.40.0-255,66,1769,64,294001
34796,3.9e-05,74.125.130.0-255,2902,4671,64,294001
34797,4.2e-05,172.31.40.0-255,66,4737,64,294001
34798,6.7e-05,74.125.130.0-255,7156,11893,64,294001
34799,7e-05,172.31.40.0-255,66,11959,64,294001
34800,7.4e-05,74.125.130.0-255,1911,13870,64,294001
34801,7.6e-05,172.31.40.0-255,66,13936,64,294001
34802,0.000193,74.125.130.0-255,1484,15420,64,294001
34803,0.000198,172.31.40.0-255,66,15486,64,294001
34804,0.000203,74.125.130.0-255,2902,18388,64,294001
34805,0.000206,172.31.40.0-255,66,18454,64,294001
34806,0.000209,74.125.130.0-255,1484,19938,64,294001
34807,0.000211,172.31.40.0-255,66,20004,64,294001
34808,0.000233,74.125.130.0-255,2902,22906,64,294001
34809,0.000237,172.31.40.0-255,66,22972,64,294001
34810,0.000242,74.125.130.0-255,4320,27292,64,294001
34811,0.000244,172.31.40.0-255,66,27358,64,294001
34812,0.000264,74.125.130.0-255,1484,28842,64,294001
34813,0.000266,172.31.40.0-255,66,28908,64,294001
34814,0.000282,74.125.130.0-255,2543,31451,64,294001
34815,0.000285,172.31.40.0-255,66,31517,64,294001
34816,0.00043,74.125.130.0-255,1484,33001,64,294001
34817,0.000435,172.31.40.0-255,66,33067,64,294001
34818,0.000439,74.125.130.0-255,2902,35969,64,294001
34819,0.000442,172.31.40.0-255,66,36035,64,294001
34820,0.000465,74.125.130.0-255,5738,41773,64,294001
34821,0.000468,172.31.40.0-255,66,41839,64,294001
34822,0.000473,74.125.130.0-255,4320,46159,64,294001
34823,0.000475,172.31.40.0-255,66,46225,64,294001
34824,0.000506,74.125.130.0-255,5379,51604,64,294001
34825,0.00051,172.31.40.0-255,66,51670,64,294001
34826,0.000513,74.125.130.0-255,1484,53154,64,294001
34827,0.000531,74.125.130.0-255,2902,56056,64,294001
34828,0.000534,172.31.40.0-255,66,56122,64,294001
34829,0.00054,74.125.130.0-255,5738,61860,64,294001
34830,0.000543,172.31.40.0-255,66,61926,64,294001
34831,0.000577,74.125.130.0-255,3961,65887,64,294001
34832,0.000581,172.31.40.0-255,66,65953,64,294001
34833,0.000869,74.125.130.0-255,646,66599,64,294001
34834,0.001061,74.125.130.0-255,1484,68083,64,294001
34835,0.001066,172.31.40.0-255,66,68149,64,294001
34836,0.001071,74.125.130.0-255,2902,71051,64,294001
34837,0.001073,172.31.40.0-255,66,71117,64,294001
34838,0.001097,74.125.130.0-255,4320,75437,64,294001
34839,0.0011,172.31.40.0-255,66,75503,64,294001
34840,0.001118,74.125.130.0-255,1484,76987,64,294001
34841,0.001122,74.125.130.0-255,1484,78471,64,294001
34842,0.001124,172.31.40.0-255,66,78537,64,294001
34843,0.001145,74.125.130.0-255,2902,81439,64,294001
34844,0.001148,172.31.40.0-255,66,81505,64,294001
34845,0.001168,74.125.130.0-255,1484,82989,64,294001
34846,0.001181,74.125.130.0-255,2543,85532,64,294001
34847,0.001183,172.31.40.0-255,66,85598,64,294001
34848,0.001187,74.125.130.0-255,2902,88500,64,294001
34849,0.001189,172.31.40.0-255,66,88566,64,294001
34850,0.001202,74.125.130.0-255,1484,90050,64,294001
34851,0.001234,74.125.130.0-255,1125,91175,64,294001
34852,0.001238,172.31.40.0-255,66,91241,64,294001
34853,0.001479,172.31.40.0-255,66,91307,64,294001
34854,0.001863,74.125.130.0-255,1484,92791,64,294001
34855,0.001873,74.125.130.0-255,2902,95693,64,294001
34856,0.001878,172.31.40.0-255,66,95759,64,294001
34857,0.001898,74.125.130.0-255,1484,97243,64,294001
34858,0.001922,74.125.130.0-255,2902,100145,64,294001
34859,0.001924,172.31.40.0-255,66,100211,64,294001
34860,0.001928,74.125.130.0-255,1484,101695,64,294001
34861,0.001942,74.125.130.0-255,2902,104597,64,294001
34862,0.001944,172.31.40.0-255,66,104663,64,294001
34863,0.001967,74.125.130.0-255,1484,106147,64,294001
34864,0.001975,74.125.130.0-255,7156,113303,64,294001
34865,0.001976,172.31.40.0-255,66,113369,64,294001
34866,0.001997,74.125.130.0-255,2902,116271,64,294001
34867,0.001999,172.31.40.0-255,66,116337,64,294001
34868,0.002021,74.125.130.0-255,7156,123493,64,294001
34869,0.002024,172.31.40.0-255,66,123559,64,294001
34870,0.002038,74.125.130.0-255,2184,125743,64,294001
34871,0.00204,172.31.40.0-255,66,125809,64,294001
34872,0.002117,74.125.130.0-255,1484,127293,64,294001
34873,0.002121,74.125.130.0-255,1484,128777,64,294001
34874,0.002124,172.31.40.0-255,66,128843,64,294001
34875,0.002137,74.125.130.0-255,1484,130327,64,294001
34876,0.002143,74.125.130.0-255,2902,133229,64,294001
34877,0.002144,172.31.40.0-255,66,133295,64,294001
34878,0.002148,74.125.130.0-255,1484,134779,64,294001
34879,0.002163,74.125.130.0-255,2902,137681,64,294001
34880,0.002165,172.31.40.0-255,66,137747,64,294001
34881,0.002185,74.125.130.0-255,2902,140649,64,294001
34882,0.002187,172.31.40.0-255,66,140715,64,294001
34883,0.002209,74.125.130.0-255,5738,146453,64,294001
34884,0.002211,172.31.40.0-255,66,146519,64,294001
34885,0.002222,172.31.40.0-255,66,146585,64,294001
34886,0.002237,74.125.130.0-255,1484,148069,64,294001
34887,0.002252,74.125.130.0-255,2184,150253,64,294001
34888,0.002254,172.31.40.0-255,66,150319,64,294001
34889,0.002496,74.125.130.0-255,1484,151803,64,294001
34890,0.002504,74.125.130.0-255,2902,154705,64,294001
34891,0.002508,172.31.40.0-255,66,154771,64,294001
34892,0.002525,74.125.130.0-255,2902,157673,64,294001
34893,0.002528,172.31.40.0-255,66,157739,64,294001
34894,0.002552,74.125.130.0-255,2902,160641,64,294001
34895,0.002555,172.31.40.0-255,66,160707,64,294001
34896,0.005024,74.125.130.0-255,1484,162191,64,294001
34897,0.005041,74.125.130.0-255,1484,163675,64,294001
34898,0.005044,172.31.40.0-255,66,163741,64,294001
34899,0.005064,74.125.130.0-255,2902,166643,64,294001
34900,0.005067,172.31.40.0-255,66,166709,64,294001
34901,0.007557,74.125.130.0-255,2902,169611,64,294001
34902,0.007566,172.31.40.0-255,66,169677,64,294001
34903,0.007581,74.125.130.0-255,2902,172579,64,294001
34904,0.007585,172.31.40.0-255,66,172645,64,294001
34905,0.010081,74.125.130.0-255,5738,178383,64,294001
34906,0.010089,172.31.40.0-255,66,178449,64,294001
34907,0.012626,74.125.130.0-255,5738,184187,64,294001
34908,0.012635,172.31.40.0-255,66,184253,64,294001
34909,0.015158,74.125.130.0-255,5738,189991,64,294001
34910,0.015189,172.31.40.0-255,66,190057,64,294001
34911,0.017709,74.125.130.0-255,5738,195795,64,294001
34912,0.017718,172.31.40.0-255,66,195861,64,294001
34913,0.020244,74.125.130.0-255,5738,201599,64,294001
34914,0.020255,172.31.40.0-255,66,201665,64,294001
34915,0.022767,74.125.130.0-255,5738,207403,64,294001
34916,0.022777,172.31.40.0-255,66,207469,64,294001
34917,0.025306,74.125.130.0-255,5738,213207,64,294001
34918,0.025317,172.31.40.0-255,66,213273,64,294001
34919,0.027828,74.125.130.0-255,5738,219011,64,294001
34920,0.027837,172.31.40.0-255,66,219077,64,294001
34921,0.029246,172.31.40.0-255,176,219253,64,294001
34922,0.02928,172.31.40.0-255,1111,220364,64,294001
34923,0.029359,172.31.40.0-255,1514,221878,64,294001
34924,0.029362,172.31.40.0-255,1514,223392,64,294001
34925,0.029363,172.31.40.0-255,697,224089,64,294001
34926,0.030351,74.125.130.0-255,5738,229827,64,294001
34927,0.03036,172.31.40.0-255,66,229893,64,294001
34928,0.030831,104.244.42.0-255,66,229959,64,294001
34929,0.030839,104.244.42.0-255,66,230025,64,294001
34930,0.03091,104.244.42.0-255,66,230091,64,294001
34931,0.030914,104.244.42.0-255,66,230157,64,294001
34932,0.03288,74.125.130.0-255,5738,235895,64,294001
34933,0.032894,172.31.40.0-255,66,235961,64,294001
34934,0.035417,74.125.130.0-255,5738,241699,64,294001
34935,0.035434,172.31.40.0-255,66,241765,64,294001
34936,0.037979,74.125.130.0-255,5738,247503,64,294001
34937,0.037997,172.31.40.0-255,66,247569,64,294001
34938,0.040522,74.125.130.0-255,5738,253307,64,294001
34939,0.040542,172.31.40.0-255,66,253373,64,294001
34940,0.043075,74.125.130.0-255,5738,259111,64,294001
34941,0.043096,172.31.40.0-255,66,259177,64,294001
34942,0.045636,74.125.130.0-255,5738,264915,64,294001
34943,0.045657,172.31.40.0-255,66,264981,64,294001
34944,0.048205,74.125.130.0-255,5738,270719,64,294001
34945,0.048226,172.31.40.0-255,66,270785,64,294001
34946,0.050769,74.125.130.0-255,5738,276523,64,294001
34947,0.050791,172.31.40.0-255,66,276589,64,294001
34948,0.053334,74.125.130.0-255,5738,282327,64,294001
34949,0.053355,172.31.40.0-255,66,282393,64,294001
34950,0.055891,74.125.130.0-255,5738,288131,64,294001
34951,0.05591,172.31.40.0-255,66,288197,64,294001
34952,0.058464,74.125.130.0-255,5738,293935,64,294001
34953,0.058489,172.31.40.0-255,66,294001,64,294001
34954,0.0,172.217.194.0-255,152,152,64,265236
34955,2.7e-05,172.31.40.0-255,66,218,64,265236
34956,3.5e-05,172.217.194.0-255,1484,1702,64,265236
34957,4e-05,172.31.40.0-255,66,1768,64,265236
34958,4.5e-05,172.217.194.0-255,2902,4670,64,265236
34959,4.7e-05,172.31.40.0-255,66,4736,64,265236
34960,6.1e-05,172.217.194.0-255,7156,11892,64,265236
34961,6.4e-05,172.31.40.0-255,66,11958,64,265236
34962,9.8e-05,172.217.194.0-255,2029,13987,64,265236
34963,0.000101,172.31.40.0-255,66,14053,64,265236
34964,0.00024,172.217.194.0-255,1484,15537,64,265236
34965,0.000244,172.31.40.0-255,66,15603,64,265236
34966,0.00025,172.217.194.0-255,2902,18505,64,265236
34967,0.000252,172.31.40.0-255,66,18571,64,265236
34968,0.000255,172.217.194.0-255,1484,20055,64,265236
34969,0.000257,172.31.40.0-255,66,20121,64,265236
34970,0.000298,172.217.194.0-255,4320,24441,64,265236
34971,0.0003,172.31.40.0-255,66,24507,64,265236
34972,0.000311,172.31.40.0-255,66,24573,64,265236
34973,0.00034,172.217.194.0-255,5379,29952,64,265236
34974,0.000343,172.31.40.0-255,66,30018,64,265236
34975,0.000398,172.217.194.0-255,4320,34338,64,265236
34976,0.0004,172.31.40.0-255,66,34404,64,265236
34977,0.000438,172.31.40.0-255,66,34470,64,265236
34978,0.000545,172.217.194.0-255,4320,38790,64,265236
34979,0.000549,172.31.40.0-255,66,38856,64,265236
34980,0.000578,172.217.194.0-255,3912,42768,64,265236
34981,0.000582,172.31.40.0-255,66,42834,64,265236
34982,0.000584,172.217.194.0-255,98,42932,64,265236
34983,0.000586,172.31.40.0-255,66,42998,64,265236
34984,0.000619,172.217.194.0-255,4320,47318,64,265236
34985,0.000623,172.31.40.0-255,66,47384,64,265236
34986,0.000635,172.217.194.0-255,5738,53122,64,265236
34987,0.000638,172.31.40.0-255,66,53188,64,265236
34988,0.000701,172.217.194.0-255,7156,60344,64,265236
34989,0.000705,172.31.40.0-255,66,60410,64,265236
34990,0.000745,172.31.40.0-255,66,60476,64,265236
34991,0.000863,172.217.194.0-255,3602,64078,64,265236
34992,0.000867,172.31.40.0-255,66,64144,64,265236
34993,0.001649,172.217.194.0-255,1484,65628,64,265236
34994,0.001658,172.217.194.0-255,1484,67112,64,265236
34995,0.001662,172.31.40.0-255,66,67178,64,265236
34996,0.001682,172.217.194.0-255,1484,68662,64,265236
34997,0.001688,172.217.194.0-255,5738,74400,64,265236
34998,0.00169,172.31.40.0-255,66,74466,64,265236
34999,0.00172,172.217.194.0-255,4320,78786,64,265236
35000,0.001723,172.31.40.0-255,66,78852,64,265236
35001,0.001753,172.217.194.0-255,7156,86008,64,265236
35002,0.001755,172.31.40.0-255,66,86074,64,265236
35003,0.001816,172.217.194.0-255,5738,91812,64,265236
35004,0.00182,172.31.40.0-255,66,91878,64,265236
35005,0.001847,172.217.194.0-255,6158,98036,64,265236
35006,0.00185,172.31.40.0-255,66,98102,64,265236
35007,0.001919,172.31.40.0-255,66,98168,64,265236
35008,0.001962,172.31.40.0-255,66,98234,64,265236
35009,0.00212,172.31.40.0-255,66,98300,64,265236
35010,0.002173,172.217.194.0-255,4320,102620,64,265236
35011,0.002176,172.31.40.0-255,66,102686,64,265236
35012,0.002195,172.217.194.0-255,4320,107006,64,265236
35013,0.002197,172.31.40.0-255,66,107072,64,265236
35014,0.00227,172.217.194.0-255,5738,112810,64,265236
35015,0.002274,172.31.40.0-255,66,112876,64,265236
35016,0.002312,172.31.40.0-255,66,112942,64,265236
35017,0.002395,172.217.194.0-255,5738,118680,64,265236
35018,0.002399,172.31.40.0-255,66,118746,64,265236
35019,0.002448,172.31.40.0-255,66,118812,64,265236
35020,0.002568,172.217.194.0-255,5738,124550,64,265236
35021,0.00272,172.217.194.0-255,4320,128870,64,265236
35022,0.002732,172.217.194.0-255,4320,133190,64,265236
35023,0.005514,172.31.40.0-255,66,133256,64,265236
35024,0.007902,172.217.194.0-255,5738,138994,64,265236
35025,0.007913,172.31.40.0-255,66,139060,64,265236
35026,0.010269,172.217.194.0-255,5738,144798,64,265236
35027,0.010278,172.31.40.0-255,66,144864,64,265236
35028,0.012655,172.217.194.0-255,5738,150602,64,265236
35029,0.012664,172.31.40.0-255,66,150668,64,265236
35030,0.015026,172.217.194.0-255,5738,156406,64,265236
35031,0.015035,172.31.40.0-255,66,156472,64,265236
35032,0.01746,172.217.194.0-255,5738,162210,64,265236
35033,0.017469,172.31.40.0-255,66,162276,64,265236
35034,0.019832,172.217.194.0-255,5738,168014,64,265236
35035,0.019849,172.31.40.0-255,66,168080,64,265236
35036,0.022219,172.217.194.0-255,5738,173818,64,265236
35037,0.022228,172.31.40.0-255,66,173884,64,265236
35038,0.024569,172.217.194.0-255,5738,179622,64,265236
35039,0.024577,172.31.40.0-255,66,179688,64,265236
35040,0.026915,172.217.194.0-255,5738,185426,64,265236
35041,0.026924,172.31.40.0-255,66,185492,64,265236
35042,0.029253,172.217.194.0-255,5738,191230,64,265236
35043,0.029267,172.31.40.0-255,66,191296,64,265236
35044,0.031628,172.217.194.0-255,5738,197034,64,265236
35045,0.031635,172.31.40.0-255,66,197100,64,265236
35046,0.03396,172.217.194.0-255,5738,202838,64,265236
35047,0.033975,172.31.40.0-255,66,202904,64,265236
35048,0.036292,172.217.194.0-255,5738,208642,64,265236
35049,0.036303,172.31.40.0-255,66,208708,64,265236
35050,0.03863,172.217.194.0-255,5738,214446,64,265236
35051,0.038645,172.31.40.0-255,66,214512,64,265236
35052,0.040645,172.31.40.0-255,172,214684,64,265236
35053,0.040676,172.31.40.0-255,1112,215796,64,265236
35054,0.040749,172.31.40.0-255,1514,217310,64,265236
35055,0.040751,172.31.40.0-255,1296,218606,64,265236
35056,0.04102,172.217.194.0-255,5738,224344,64,265236
35057,0.041031,172.31.40.0-255,66,224410,64,265236
35058,0.042237,104.244.42.0-255,66,224476,64,265236
35059,0.042247,104.244.42.0-255,66,224542,64,265236
35060,0.042294,104.244.42.0-255,66,224608,64,265236
35061,0.043344,172.217.194.0-255,5738,230346,64,265236
35062,0.043356,172.31.40.0-255,66,230412,64,265236
35063,0.04571,172.217.194.0-255,5738,236150,64,265236
35064,0.045723,172.31.40.0-255,66,236216,64,265236
35065,0.048116,172.217.194.0-255,5738,241954,64,265236
35066,0.048134,172.31.40.0-255,66,242020,64,265236
35067,0.050535,172.217.194.0-255,5738,247758,64,265236
35068,0.050551,172.31.40.0-255,66,247824,64,265236
35069,0.052896,172.217.194.0-255,5738,253562,64,265236
35070,0.052914,172.31.40.0-255,66,253628,64,265236
35071,0.055284,172.217.194.0-255,5738,259366,64,265236
35072,0.055298,172.31.40.0-255,66,259432,64,265236
35073,0.057635,172.217.194.0-255,5738,265170,64,265236
35074,0.057653,172.31.40.0-255,66,265236,64,265236
35075,0.0,172.217.194.0-255,146,146,64,280261
35076,1.9e-05,172.31.40.0-255,66,212,64,280261
35077,2.5e-05,172.217.194.0-255,1484,1696,64,280261
35078,3e-05,172.31.40.0-255,66,1762,64,280261
35079,3.6e-05,172.217.194.0-255,2902,4664,64,280261
35080,4e-05,172.31.40.0-255,66,4730,64,280261
35081,4.8e-05,172.217.194.0-255,7156,11886,64,280261
35082,5.1e-05,172.31.40.0-255,66,11952,64,280261
35083,5.5e-05,172.217.194.0-255,1988,13940,64,280261
35084,5.8e-05,172.31.40.0-255,66,14006,64,280261
35085,8.6e-05,172.31.40.0-255,66,14072,64,280261
35086,9.8e-05,172.217.194.0-255,1484,15556,64,280261
35087,0.0001,172.31.40.0-255,66,15622,64,280261
35088,0.00012,172.217.194.0-255,3961,19583,64,280261
35089,0.000123,172.31.40.0-255,66,19649,64,280261
35090,0.00021,172.217.194.0-255,1484,21133,64,280261
35091,0.000213,172.31.40.0-255,66,21199,64,280261
35092,0.000234,172.217.194.0-255,2902,24101,64,280261
35093,0.000237,172.31.40.0-255,66,24167,64,280261
35094,0.000243,172.217.194.0-255,5738,29905,64,280261
35095,0.000245,172.31.40.0-255,66,29971,64,280261
35096,0.000248,172.217.194.0-255,1484,31455,64,280261
35097,0.000251,172.31.40.0-255,66,31521,64,280261
35098,0.000269,172.217.194.0-255,5379,36900,64,280261
35099,0.000272,172.31.40.0-255,66,36966,64,280261
35100,0.000288,172.217.194.0-255,4320,41286,64,280261
35101,0.00029,172.31.40.0-255,66,41352,64,280261
35102,0.000319,172.31.40.0-255,66,41418,64,280261
35103,0.000323,172.217.194.0-255,2833,44251,64,280261
35104,0.000326,172.31.40.0-255,66,44317,64,280261
35105,0.000459,172.217.194.0-255,100,44417,64,280261
35106,0.000463,172.31.40.0-255,66,44483,64,280261
35107,0.000467,172.217.194.0-255,364,44847,64,280261
35108,0.000469,172.31.40.0-255,66,44913,64,280261
35109,0.000631,172.217.194.0-255,1484,46397,64,280261
35110,0.000636,172.31.40.0-255,66,46463,64,280261
35111,0.000642,172.217.194.0-255,2902,49365,64,280261
35112,0.000644,172.31.40.0-255,66,49431,64,280261
35113,0.000667,172.217.194.0-255,5738,55169,64,280261
35114,0.00067,172.31.40.0-255,66,55235,64,280261
35115,0.000674,172.217.194.0-255,2902,58137,64,280261
35116,0.000676,172.31.40.0-255,66,58203,64,280261
35117,0.00069,172.217.194.0-255,1484,59687,64,280261
35118,0.000693,172.31.40.0-255,66,59753,64,280261
35119,0.000725,172.31.40.0-255,66,59819,64,280261
35120,0.000752,172.217.194.0-255,2902,62721,64,280261
35121,0.000755,172.31.40.0-255,66,62787,64,280261
35122,0.000766,172.31.40.0-255,66,62853,64,280261
35123,0.001027,172.217.194.0-255,1484,64337,64,280261
35124,0.001043,172.217.194.0-255,2902,67239,64,280261
35125,0.001046,172.31.40.0-255,66,67305,64,280261
35126,0.001052,172.217.194.0-255,2902,70207,64,280261
35127,0.001053,172.31.40.0-255,66,70273,64,280261
35128,0.001071,172.217.194.0-255,2902,73175,64,280261
35129,0.001073,172.31.40.0-255,66,73241,64,280261
35130,0.001081,172.217.194.0-255,7156,80397,64,280261
35131,0.001083,172.31.40.0-255,66,80463,64,280261
35132,0.001113,172.217.194.0-255,5738,86201,64,280261
35133,0.001116,172.31.40.0-255,66,86267,64,280261
35134,0.00113,172.31.40.0-255,66,86333,64,280261
35135,0.001653,172.217.194.0-255,1484,87817,64,280261
35136,0.001659,172.217.194.0-255,2902,90719,64,280261
35137,0.001663,172.31.40.0-255,66,90785,64,280261
35138,0.001669,172.217.194.0-255,4320,95105,64,280261
35139,0.001671,172.31.40.0-255,66,95171,64,280261
35140,0.001683,172.217.194.0-255,1484,96655,64,280261
35141,0.001703,172.31.40.0-255,66,96721,64,280261
35142,0.001717,172.217.194.0-255,1484,98205,64,280261
35143,0.001753,172.217.194.0-255,7156,105361,64,280261
35144,0.001756,172.31.40.0-255,66,105427,64,280261
35145,0.001776,172.217.194.0-255,6438,111865,64,280261
35146,0.001778,172.31.40.0-255,66,111931,64,280261
35147,0.001832,172.31.40.0-255,66,111997,64,280261
35148,0.001865,172.31.40.0-255,66,112063,64,280261
35149,0.001873,172.217.194.0-255,6438,118501,64,280261
35150,0.001875,172.31.40.0-255,66,118567,64,280261
35151,0.001903,172.217.194.0-255,2902,121469,64,280261
35152,0.001906,172.31.40.0-255,66,121535,64,280261
35153,0.00193,172.31.40.0-255,66,121601,64,280261
35154,0.001939,172.217.194.0-255,1484,123085,64,280261
35155,0.001951,172.31.40.0-255,66,123151,64,280261
35156,0.001981,172.31.40.0-255,66,123217,64,280261
35157,0.001984,172.217.194.0-255,766,123983,64,280261
35158,0.002004,172.217.194.0-255,7156,131139,64,280261
35159,0.002008,172.31.40.0-255,66,131205,64,280261
35160,0.002015,172.217.194.0-255,1484,132689,64,280261
35161,0.002023,172.217.194.0-255,7156,139845,64,280261
35162,0.002026,172.31.40.0-255,66,139911,64,280261
35163,0.002052,172.217.194.0-255,2902,142813,64,280261
35164,0.002082,172.217.194.0-255,5020,147833,64,280261
35165,0.002175,172.217.194.0-255,1484,149317,64,280261
35166,0.00221,172.217.194.0-255,1484,150801,64,280261
35167,0.002228,172.217.194.0-255,1484,152285,64,280261
35168,0.002235,172.217.194.0-255,5738,158023,64,280261
35169,0.002242,172.217.194.0-255,7156,165179,64,280261
35170,0.002272,172.217.194.0-255,4320,169499,64,280261
35171,0.002277,172.217.194.0-255,2184,171683,64,280261
35172,0.002302,172.217.194.0-255,4320,176003,64,280261
35173,0.002322,172.217.194.0-255,2902,178905,64,280261
35174,0.002334,172.217.194.0-255,2902,181807,64,280261
35175,0.00235,172.217.194.0-255,7156,188963,64,280261
35176,0.002376,172.217.194.0-255,7156,196119,64,280261
35177,0.002379,172.217.194.0-255,766,196885,64,280261
35178,0.006547,172.31.40.0-255,66,196951,64,280261
35179,0.00889,172.217.194.0-255,5738,202689,64,280261
35180,0.008896,172.31.40.0-255,66,202755,64,280261
35181,0.011235,172.217.194.0-255,5738,208493,64,280261
35182,0.011243,172.31.40.0-255,66,208559,64,280261
35183,0.013592,172.217.194.0-255,5738,214297,64,280261
35184,0.0136,172.31.40.0-255,66,214363,64,280261
35185,0.015942,172.217.194.0-255,5738,220101,64,280261
35186,0.015952,172.31.40.0-255,66,220167,64,280261
35187,0.018281,172.217.194.0-255,5738,225905,64,280261
35188,0.01829,172.31.40.0-255,66,225971,64,280261
35189,0.020661,172.217.194.0-255,5738,231709,64,280261
35190,0.020668,172.31.40.0-255,66,231775,64,280261
35191,0.023015,172.217.194.0-255,5738,237513,64,280261
35192,0.023022,172.31.40.0-255,66,237579,64,280261
35193,0.025375,172.217.194.0-255,5738,243317,64,280261
35194,0.025381,172.31.40.0-255,66,243383,64,280261
35195,0.027726,172.217.194.0-255,5738,249121,64,280261
35196,0.027742,172.31.40.0-255,66,249187,64,280261
35197,0.030089,172.217.194.0-255,5738,254925,64,280261
35198,0.030098,172.31.40.0-255,66,254991,64,280261
35199,0.032455,172.217.194.0-255,5738,260729,64,280261
35200,0.03246,172.31.40.0-255,66,260795,64,280261
35201,0.03258,172.31.40.0-255,172,260967,64,280261
35202,0.032604,172.31.40.0-255,1112,262079,64,280261
35203,0.032701,172.31.40.0-255,1514,263593,64,280261
35204,0.032702,172.31.40.0-255,1514,265107,64,280261
35205,0.032707,172.31.40.0-255,1514,266621,64,280261
35206,0.032708,172.31.40.0-255,1077,267698,64,280261
35207,0.034132,104.244.42.0-255,66,267764,64,280261
35208,0.034169,104.244.42.0-255,66,267830,64,280261
35209,0.034254,104.244.42.0-255,66,267896,64,280261
35210,0.034269,104.244.42.0-255,66,267962,64,280261
35211,0.034805,172.217.194.0-255,5738,273700,64,280261
35212,0.034812,172.31.40.0-255,66,273766,64,280261
35213,0.037186,172.217.194.0-255,5738,279504,64,280261
35214,0.037191,172.31.40.0-255,66,279570,64,280261
35215,0.039506,172.217.194.0-255,454,280024,64,280261
35216,0.039617,172.31.40.0-255,66,280090,64,280261
35217,0.03965,172.31.40.0-255,105,280195,64,280261
35218,0.041975,172.217.194.0-255,66,280261,64,280261
35219,0.0,172.217.194.0-255,155,155,64,263988
35220,2.4e-05,172.31.40.0-255,66,221,64,263988
35221,3.1e-05,172.217.194.0-255,1484,1705,64,263988
35222,3.7e-05,172.31.40.0-255,66,1771,64,263988
35223,5e-05,172.217.194.0-255,2902,4673,64,263988
35224,5.3e-05,172.31.40.0-255,66,4739,64,263988
35225,6.1e-05,172.217.194.0-255,7156,11895,64,263988
35226,6.4e-05,172.31.40.0-255,66,11961,64,263988
35227,6.8e-05,172.217.194.0-255,2023,13984,64,263988
35228,7.1e-05,172.31.40.0-255,66,14050,64,263988
35229,0.000441,172.217.194.0-255,1484,15534,64,263988
35230,0.000448,172.31.40.0-255,66,15600,64,263988
35231,0.000454,172.217.194.0-255,2902,18502,64,263988
35232,0.000456,172.31.40.0-255,66,18568,64,263988
35233,0.000462,172.217.194.0-255,4320,22888,64,263988
35234,0.000464,172.31.40.0-255,66,22954,64,263988
35235,0.000491,172.217.194.0-255,1484,24438,64,263988
35236,0.000499,172.217.194.0-255,6797,31235,64,263988
35237,0.000504,172.31.40.0-255,66,31301,64,263988
35238,0.000513,172.31.40.0-255,66,31367,64,263988
35239,0.000578,172.217.194.0-255,1484,32851,64,263988
35240,0.000582,172.31.40.0-255,66,32917,64,263988
35241,0.000587,172.217.194.0-255,2902,35819,64,263988
35242,0.000589,172.31.40.0-255,66,35885,64,263988
35243,0.000595,172.217.194.0-255,5738,41623,64,263988
35244,0.000598,172.31.40.0-255,66,41689,64,263988
35245,0.000642,172.217.194.0-255,7156,48845,64,263988
35246,0.000646,172.31.40.0-255,66,48911,64,263988
35247,0.000679,172.217.194.0-255,1125,50036,64,263988
35248,0.000682,172.31.40.0-255,66,50102,64,263988
35249,0.000693,172.31.40.0-255,66,50168,64,263988
35250,0.000701,172.217.194.0-255,7069,57237,64,263988
35251,0.000703,172.31.40.0-255,66,57303,64,263988
35252,0.000706,172.217.194.0-255,120,57423,64,263988
35253,0.001032,172.217.194.0-255,382,57805,64,263988
35254,0.001087,172.31.40.0-255,66,57871,64,263988
35255,0.001409,172.217.194.0-255,1484,59355,64,263988
35256,0.00142,172.217.194.0-255,2902,62257,64,263988
35257,0.001424,172.31.40.0-255,66,62323,64,263988
35258,0.001432,172.217.194.0-255,5738,68061,64,263988
35259,0.001435,172.31.40.0-255,66,68127,64,263988
35260,0.00144,172.217.194.0-255,4320,72447,64,263988
35261,0.001442,172.31.40.0-255,66,72513,64,263988
35262,0.001475,172.31.40.0-255,66,72579,64,263988
35263,0.001492,172.31.40.0-255,66,72645,64,263988
35264,0.001772,172.217.194.0-255,1484,74129,64,263988
35265,0.001778,172.217.194.0-255,1484,75613,64,263988
35266,0.001783,172.31.40.0-255,66,75679,64,263988
35267,0.001816,172.217.194.0-255,1484,77163,64,263988
35268,0.001823,172.217.194.0-255,5738,82901,64,263988
35269,0.001826,172.31.40.0-255,66,82967,64,263988
35270,0.00184,172.31.40.0-255,66,83033,64,263988
35271,0.001873,172.217.194.0-255,5738,88771,64,263988
35272,0.001876,172.31.40.0-255,66,88837,64,263988
35273,0.001902,172.217.194.0-255,5020,93857,64,263988
35274,0.001905,172.31.40.0-255,66,93923,64,263988
35275,0.002156,172.217.194.0-255,1484,95407,64,263988
35276,0.002161,172.217.194.0-255,1484,96891,64,263988
35277,0.002164,172.31.40.0-255,66,96957,64,263988
35278,0.002213,172.217.194.0-255,1484,98441,64,263988
35279,0.002219,172.217.194.0-255,4320,102761,64,263988
35280,0.002222,172.31.40.0-255,66,102827,64,263988
35281,0.002233,172.31.40.0-255,66,102893,64,263988
35282,0.002239,172.217.194.0-255,5738,108631,64,263988
35283,0.002241,172.31.40.0-255,66,108697,64,263988
35284,0.002271,172.31.40.0-255,66,108763,64,263988
35285,0.002366,172.217.194.0-255,1484,110247,64,263988
35286,0.002371,172.217.194.0-255,2902,113149,64,263988
35287,0.002373,172.31.40.0-255,66,113215,64,263988
35288,0.002402,172.217.194.0-255,5738,118953,64,263988
35289,0.002405,172.31.40.0-255,66,119019,64,263988
35290,0.002442,172.217.194.0-255,2902,121921,64,263988
35291,0.002444,172.31.40.0-255,66,121987,64,263988
35292,0.002485,172.31.40.0-255,66,122053,64,263988
35293,0.002492,172.217.194.0-255,7156,129209,64,263988
35294,0.002494,172.31.40.0-255,66,129275,64,263988
35295,0.002499,172.217.194.0-255,3602,132877,64,263988
35296,0.002501,172.31.40.0-255,66,132943,64,263988
35297,0.005045,172.217.194.0-255,2902,135845,64,263988
35298,0.00505,172.31.40.0-255,66,135911,64,263988
35299,0.005085,172.217.194.0-255,2902,138813,64,263988
35300,0.005088,172.31.40.0-255,66,138879,64,263988
35301,0.007636,172.217.194.0-255,2902,141781,64,263988
35302,0.007644,172.31.40.0-255,66,141847,64,263988
35303,0.007686,172.217.194.0-255,2902,144749,64,263988
35304,0.007689,172.31.40.0-255,66,144815,64,263988
35305,0.010201,172.217.194.0-255,2902,147717,64,263988
35306,0.010206,172.31.40.0-255,66,147783,64,263988
35307,0.010277,172.217.194.0-255,2902,150685,64,263988
35308,0.010281,172.31.40.0-255,66,150751,64,263988
35309,0.012742,172.217.194.0-255,2902,153653,64,263988
35310,0.012749,172.31.40.0-255,66,153719,64,263988
35311,0.012835,172.217.194.0-255,2902,156621,64,263988
35312,0.012839,172.31.40.0-255,66,156687,64,263988
35313,0.015337,172.217.194.0-255,2902,159589,64,263988
35314,0.015345,172.31.40.0-255,66,159655,64,263988
35315,0.015389,172.217.194.0-255,2902,162557,64,263988
35316,0.015393,172.31.40.0-255,66,162623,64,263988
35317,0.017921,172.217.194.0-255,2902,165525,64,263988
35318,0.017931,172.31.40.0-255,66,165591,64,263988
35319,0.01798,172.217.194.0-255,2902,168493,64,263988
35320,0.017984,172.31.40.0-255,66,168559,64,263988
35321,0.020535,172.217.194.0-255,5738,174297,64,263988
35322,0.020544,172.31.40.0-255,66,174363,64,263988
35323,0.023121,172.217.194.0-255,5738,180101,64,263988
35324,0.023129,172.31.40.0-255,66,180167,64,263988
35325,0.025703,172.217.194.0-255,5738,185905,64,263988
35326,0.025711,172.31.40.0-255,66,185971,64,263988
35327,0.028303,172.217.194.0-255,5738,191709,64,263988
35328,0.02831,172.31.40.0-255,66,191775,64,263988
35329,0.029911,172.31.40.0-255,172,191947,64,263988
35330,0.029944,172.31.40.0-255,1111,193058,64,263988
35331,0.030004,172.31.40.0-255,1514,194572,64,263988
35332,0.030006,172.31.40.0-255,1514,196086,64,263988
35333,0.030097,172.31.40.0-255,694,196780,64,263988
35334,0.030898,172.217.194.0-255,5738,202518,64,263988
35335,0.030905,172.31.40.0-255,66,202584,64,263988
35336,0.03147,104.244.42.0-255,66,202650,64,263988
35337,0.031518,104.244.42.0-255,66,202716,64,263988
35338,0.031643,104.244.42.0-255,66,202782,64,263988
35339,0.031647,104.244.42.0-255,66,202848,64,263988
35340,0.033459,172.217.194.0-255,5738,208586,64,263988
35341,0.033466,172.31.40.0-255,66,208652,64,263988
35342,0.036042,172.217.194.0-255,5738,214390,64,263988
35343,0.03605,172.31.40.0-255,66,214456,64,263988
35344,0.038626,172.217.194.0-255,5738,220194,64,263988
35345,0.038636,172.31.40.0-255,66,220260,64,263988
35346,0.0412,172.217.194.0-255,5738,225998,64,263988
35347,0.041209,172.31.40.0-255,66,226064,64,263988
35348,0.043784,172.217.194.0-255,4320,230384,64,263988
35349,0.043791,172.31.40.0-255,66,230450,64,263988
35350,0.043834,172.217.194.0-255,1484,231934,64,263988
35351,0.046379,172.217.194.0-255,4320,236254,64,263988
35352,0.046387,172.31.40.0-255,66,236320,64,263988
35353,0.048934,172.217.194.0-255,5738,242058,64,263988
35354,0.048939,172.31.40.0-255,66,242124,64,263988
35355,0.051539,172.217.194.0-255,4320,246444,64,263988
35356,0.051545,172.31.40.0-255,66,246510,64,263988
35357,0.051566,172.217.194.0-255,1484,247994,64,263988
35358,0.054089,172.217.194.0-255,4320,252314,64,263988
35359,0.054096,172.31.40.0-255,66,252380,64,263988
35360,0.056647,172.217.194.0-255,5738,258118,64,263988
35361,0.056654,172.31.40.0-255,66,258184,64,263988
35362,0.059216,172.217.194.0-255,5738,263922,64,263988
35363,0.059227,172.31.40.0-255,66,263988,64,263988
35364,0.0,172.217.194.0-255,146,146,64,218532
35365,2.3e-05,172.31.40.0-255,66,212,64,218532
35366,3.1e-05,172.217.194.0-255,1484,1696,64,218532
35367,3.5e-05,172.31.40.0-255,66,1762,64,218532
35368,4e-05,172.217.194.0-255,2902,4664,64,218532
35369,4.3e-05,172.31.40.0-255,66,4730,64,218532
35370,5.1e-05,172.217.194.0-255,7156,11886,64,218532
35371,6.2e-05,172.31.40.0-255,66,11952,64,218532
35372,6.7e-05,172.217.194.0-255,3392,15344,64,218532
35373,7e-05,172.31.40.0-255,66,15410,64,218532
35374,9.8e-05,172.217.194.0-255,1484,16894,64,218532
35375,0.000101,172.31.40.0-255,66,16960,64,218532
35376,0.000145,172.31.40.0-255,66,17026,64,218532
35377,0.000149,172.217.194.0-255,2543,19569,64,218532
35378,0.000152,172.31.40.0-255,66,19635,64,218532
35379,0.000186,172.217.194.0-255,1484,21119,64,218532
35380,0.000189,172.31.40.0-255,66,21185,64,218532
35381,0.000214,172.217.194.0-255,2902,24087,64,218532
35382,0.000217,172.31.40.0-255,66,24153,64,218532
35383,0.000221,172.217.194.0-255,2902,27055,64,218532
35384,0.000223,172.31.40.0-255,66,27121,64,218532
35385,0.000229,172.217.194.0-255,4320,31441,64,218532
35386,0.000232,172.31.40.0-255,66,31507,64,218532
35387,0.000273,172.31.40.0-255,66,31573,64,218532
35388,0.000279,172.217.194.0-255,5738,37311,64,218532
35389,0.000282,172.31.40.0-255,66,37377,64,218532
35390,0.000303,172.217.194.0-255,2902,40279,64,218532
35391,0.000306,172.31.40.0-255,66,40345,64,218532
35392,0.00033,172.217.194.0-255,4217,44562,64,218532
35393,0.000333,172.31.40.0-255,66,44628,64,218532
35394,0.000336,172.217.194.0-255,118,44746,64,218532
35395,0.000339,172.31.40.0-255,66,44812,64,218532
35396,0.000435,172.217.194.0-255,1484,46296,64,218532
35397,0.000439,172.31.40.0-255,66,46362,64,218532
35398,0.000472,172.217.194.0-255,2902,49264,64,218532
35399,0.000475,172.31.40.0-255,66,49330,64,218532
35400,0.000482,172.217.194.0-255,5738,55068,64,218532
35401,0.000485,172.31.40.0-255,66,55134,64,218532
35402,0.000552,172.217.194.0-255,378,55512,64,218532
35403,0.000688,172.217.194.0-255,1484,56996,64,218532
35404,0.000693,172.217.194.0-255,1484,58480,64,218532
35405,0.000715,172.217.194.0-255,1484,59964,64,218532
35406,0.000721,172.217.194.0-255,5738,65702,64,218532
35407,0.000726,172.217.194.0-255,2902,68604,64,218532
35408,0.000756,172.217.194.0-255,1484,70088,64,218532
35409,0.000795,172.31.40.0-255,66,70154,64,218532
35410,0.000805,172.217.194.0-255,4320,74474,64,218532
35411,0.000811,172.31.40.0-255,66,74540,64,218532
35412,0.000834,172.217.194.0-255,7156,81696,64,218532
35413,0.000879,172.217.194.0-255,5738,87434,64,218532
35414,0.000894,172.217.194.0-255,6438,93872,64,218532
35415,0.000913,172.31.40.0-255,66,93938,64,218532
35416,0.001466,172.217.194.0-255,1484,95422,64,218532
35417,0.001473,172.217.194.0-255,2902,98324,64,218532
35418,0.001476,172.31.40.0-255,66,98390,64,218532
35419,0.00148,172.217.194.0-255,1484,99874,64,218532
35420,0.00152,172.217.194.0-255,4320,104194,64,218532
35421,0.001535,172.217.194.0-255,2902,107096,64,218532
35422,0.001606,172.31.40.0-255,66,107162,64,218532
35423,0.001634,172.31.40.0-255,66,107228,64,218532
35424,0.001678,172.217.194.0-255,3602,110830,64,218532
35425,0.001685,172.31.40.0-255,66,110896,64,218532
35426,0.001885,172.217.194.0-255,1484,112380,64,218532
35427,0.001889,172.217.194.0-255,1484,113864,64,218532
35428,0.001892,172.31.40.0-255,66,113930,64,218532
35429,0.001905,172.217.194.0-255,1484,115414,64,218532
35430,0.001915,172.217.194.0-255,5738,121152,64,218532
35431,0.001918,172.217.194.0-255,1484,122636,64,218532
35432,0.001924,172.31.40.0-255,66,122702,64,218532
35433,0.001954,172.31.40.0-255,66,122768,64,218532
35434,0.001969,172.217.194.0-255,1484,124252,64,218532
35435,0.001996,172.31.40.0-255,66,124318,64,218532
35436,0.002027,172.217.194.0-255,1484,125802,64,218532
35437,0.002031,172.217.194.0-255,1484,127286,64,218532
35438,0.002041,172.31.40.0-255,66,127352,64,218532
35439,0.00206,172.217.194.0-255,1484,128836,64,218532
35440,0.002067,172.217.194.0-255,5738,134574,64,218532
35441,0.002074,172.217.194.0-255,5738,140312,64,218532
35442,0.002093,172.217.194.0-255,4320,144632,64,218532
35443,0.002105,172.217.194.0-255,1484,146116,64,218532
35444,0.00211,172.31.40.0-255,66,146182,64,218532
35445,0.00214,172.31.40.0-255,66,146248,64,218532
35446,0.00216,172.217.194.0-255,2184,148432,64,218532
35447,0.002183,172.217.194.0-255,5738,154170,64,218532
35448,0.002189,172.31.40.0-255,66,154236,64,218532
35449,0.002222,172.217.194.0-255,3602,157838,64,218532
35450,0.002237,172.31.40.0-255,66,157904,64,218532
35451,0.002244,172.217.194.0-255,1484,159388,64,218532
35452,0.00227,172.217.194.0-255,2902,162290,64,218532
35453,0.002277,172.217.194.0-255,5738,168028,64,218532
35454,0.002279,172.217.194.0-255,1484,169512,64,218532
35455,0.002295,172.31.40.0-255,66,169578,64,218532
35456,0.002309,172.31.40.0-255,66,169644,64,218532
35457,0.002328,172.217.194.0-255,1484,171128,64,218532
35458,0.002368,172.31.40.0-255,66,171194,64,218532
35459,0.004683,172.217.194.0-255,5738,176932,64,218532
35460,0.00469,172.31.40.0-255,66,176998,64,218532
35461,0.00699,172.217.194.0-255,5738,182736,64,218532
35462,0.006997,172.31.40.0-255,66,182802,64,218532
35463,0.009332,172.217.194.0-255,4320,187122,64,218532
35464,0.009349,172.217.194.0-255,1484,188606,64,218532
35465,0.015115,172.31.40.0-255,66,188672,64,218532
35466,0.017052,172.217.194.0-255,1484,190156,64,218532
35467,0.017409,172.217.194.0-255,4320,194476,64,218532
35468,0.017415,172.31.40.0-255,66,194542,64,218532
35469,0.019746,172.217.194.0-255,5738,200280,64,218532
35470,0.019764,172.31.40.0-255,66,200346,64,218532
35471,0.022078,172.217.194.0-255,5738,206084,64,218532
35472,0.022085,172.31.40.0-255,66,206150,64,218532
35473,0.024405,172.217.194.0-255,5738,211888,64,218532
35474,0.024412,172.31.40.0-255,66,211954,64,218532
35475,0.026713,172.217.194.0-255,1074,213028,64,218532
35476,0.026903,172.31.40.0-255,66,213094,64,218532
35477,0.026944,172.31.40.0-255,105,213199,64,218532
35478,0.029239,172.217.194.0-255,66,213265,64,218532
35479,0.048805,172.31.40.0-255,167,213432,64,218532
35480,0.048837,172.31.40.0-255,1111,214543,64,218532
35481,0.048902,172.31.40.0-255,1514,216057,64,218532
35482,0.048904,172.31.40.0-255,1514,217571,64,218532
35483,0.04893,172.31.40.0-255,697,218268,64,218532
35484,0.050386,104.244.42.0-255,66,218334,64,218532
35485,0.0504,104.244.42.0-255,66,218400,64,218532
35486,0.05046,104.244.42.0-255,66,218466,64,218532
35487,0.050465,104.244.42.0-255,66,218532,64,218532
35488,0.0,172.217.194.0-255,152,152,64,277373
35489,2.4e-05,172.31.40.0-255,66,218,64,277373
35490,3.1e-05,172.217.194.0-255,1484,1702,64,277373
35491,3.6e-05,172.31.40.0-255,66,1768,64,277373
35492,4.2e-05,172.217.194.0-255,2902,4670,64,277373
35493,4.6e-05,172.31.40.0-255,66,4736,64,277373
35494,5.3e-05,172.217.194.0-255,7156,11892,64,277373
35495,5.7e-05,172.31.40.0-255,66,11958,64,277373
35496,6.1e-05,172.217.194.0-255,2902,14860,64,277373
35497,6.5e-05,172.31.40.0-255,66,14926,64,277373
35498,0.000104,172.31.40.0-255,66,14992,64,277373
35499,0.00011,172.217.194.0-255,5379,20371,64,277373
35500,0.000113,172.31.40.0-255,66,20437,64,277373
35501,0.00025,172.217.194.0-255,1484,21921,64,277373
35502,0.000254,172.31.40.0-255,66,21987,64,277373
35503,0.000283,172.217.194.0-255,2902,24889,64,277373
35504,0.000286,172.31.40.0-255,66,24955,64,277373
35505,0.000292,172.217.194.0-255,4320,29275,64,277373
35506,0.000294,172.31.40.0-255,66,29341,64,277373
35507,0.000325,172.217.194.0-255,7156,36497,64,277373
35508,0.000329,172.31.40.0-255,66,36563,64,277373
35509,0.000347,172.217.194.0-255,1125,37688,64,277373
35510,0.000349,172.31.40.0-255,66,37754,64,277373
35511,0.00036,172.31.40.0-255,66,37820,64,277373
35512,0.000365,172.217.194.0-255,2902,40722,64,277373
35513,0.000367,172.31.40.0-255,66,40788,64,277373
35514,0.000389,172.217.194.0-255,5379,46167,64,277373
35515,0.000391,172.31.40.0-255,66,46233,64,277373
35516,0.000394,172.217.194.0-255,380,46613,64,277373
35517,0.000396,172.31.40.0-255,66,46679,64,277373
35518,0.00044,172.217.194.0-255,362,47041,64,277373
35519,0.00068,172.217.194.0-255,1484,48525,64,277373
35520,0.000684,172.31.40.0-255,66,48591,64,277373
35521,0.00069,172.217.194.0-255,2902,51493,64,277373
35522,0.000692,172.31.40.0-255,66,51559,64,277373
35523,0.000736,172.217.194.0-255,5738,57297,64,277373
35524,0.000739,172.31.40.0-255,66,57363,64,277373
35525,0.000747,172.217.194.0-255,7156,64519,64,277373
35526,0.000749,172.31.40.0-255,66,64585,64,277373
35527,0.000752,172.217.194.0-255,1484,66069,64,277373
35528,0.000789,172.31.40.0-255,66,66135,64,277373
35529,0.000793,172.217.194.0-255,2184,68319,64,277373
35530,0.000795,172.31.40.0-255,66,68385,64,277373
35531,0.001211,172.217.194.0-255,1484,69869,64,277373
35532,0.001216,172.217.194.0-255,1484,71353,64,277373
35533,0.001219,172.31.40.0-255,66,71419,64,277373
35534,0.001241,172.217.194.0-255,1484,72903,64,277373
35535,0.001246,172.217.194.0-255,4320,77223,64,277373
35536,0.001248,172.31.40.0-255,66,77289,64,277373
35537,0.001258,172.31.40.0-255,66,77355,64,277373
35538,0.001272,172.217.194.0-255,1484,78839,64,277373
35539,0.001319,172.31.40.0-255,66,78905,64,277373
35540,0.001328,172.217.194.0-255,2902,81807,64,277373
35541,0.00133,172.31.40.0-255,66,81873,64,277373
35542,0.001359,172.217.194.0-255,3602,85475,64,277373
35543,0.001362,172.31.40.0-255,66,85541,64,277373
35544,0.001399,172.217.194.0-255,5738,91279,64,277373
35545,0.001402,172.31.40.0-255,66,91345,64,277373
35546,0.001409,172.217.194.0-255,7156,98501,64,277373
35547,0.00141,172.31.40.0-255,66,98567,64,277373
35548,0.001421,172.31.40.0-255,66,98633,64,277373
35549,0.001454,172.217.194.0-255,5738,104371,64,277373
35550,0.001456,172.31.40.0-255,66,104437,64,277373
35551,0.001463,172.217.194.0-255,5738,110175,64,277373
35552,0.001465,172.31.40.0-255,66,110241,64,277373
35553,0.001468,172.217.194.0-255,766,111007,64,277373
35554,0.001491,172.217.194.0-255,1484,112491,64,277373
35555,0.001495,172.31.40.0-255,66,112557,64,277373
35556,0.001519,172.217.194.0-255,4320,116877,64,277373
35557,0.001523,172.217.194.0-255,2902,119779,64,277373
35558,0.001527,172.31.40.0-255,66,119845,64,277373
35559,0.00153,172.31.40.0-255,66,119911,64,277373
35560,0.001552,172.217.194.0-255,5738,125649,64,277373
35561,0.001555,172.31.40.0-255,66,125715,64,277373
35562,0.001566,172.31.40.0-255,66,125781,64,277373
35563,0.001584,172.217.194.0-255,4320,130101,64,277373
35564,0.001589,172.217.194.0-255,5020,135121,64,277373
35565,0.001592,172.31.40.0-255,66,135187,64,277373
35566,0.001599,172.31.40.0-255,66,135253,64,277373
35567,0.001606,172.217.194.0-255,5738,140991,64,277373
35568,0.001608,172.31.40.0-255,66,141057,64,277373
35569,0.001624,172.217.194.0-255,1484,142541,64,277373
35570,0.001665,172.31.40.0-255,66,142607,64,277373
35571,0.001677,172.217.194.0-255,1484,144091,64,277373
35572,0.001708,172.31.40.0-255,66,144157,64,277373
35573,0.001895,172.217.194.0-255,1484,145641,64,277373
35574,0.0019,172.217.194.0-255,1484,147125,64,277373
35575,0.001903,172.31.40.0-255,66,147191,64,277373
35576,0.001924,172.217.194.0-255,1484,148675,64,277373
35577,0.001931,172.217.194.0-255,5738,154413,64,277373
35578,0.001933,172.31.40.0-255,66,154479,64,277373
35579,0.001938,172.217.194.0-255,4320,158799,64,277373
35580,0.00194,172.31.40.0-255,66,158865,64,277373
35581,0.001985,172.31.40.0-255,66,158931,64,277373
35582,0.001995,172.31.40.0-255,66,158997,64,277373
35583,0.002046,172.217.194.0-255,5738,164735,64,277373
35584,0.002049,172.31.40.0-255,66,164801,64,277373
35585,0.002055,172.217.194.0-255,7156,171957,64,277373
35586,0.002058,172.31.40.0-255,66,172023,64,277373
35587,0.002082,172.31.40.0-255,66,172089,64,277373
35588,0.0021,172.217.194.0-255,2902,174991,64,277373
35589,0.002102,172.31.40.0-255,66,175057,64,277373
35590,0.002109,172.217.194.0-255,6438,181495,64,277373
35591,0.002112,172.31.40.0-255,66,181561,64,277373
35592,0.002146,172.217.194.0-255,1484,183045,64,277373
35593,0.002151,172.217.194.0-255,2902,185947,64,277373
35594,0.002153,172.31.40.0-255,66,186013,64,277373
35595,0.002159,172.217.194.0-255,4320,190333,64,277373
35596,0.002162,172.31.40.0-255,66,190399,64,277373
35597,0.002197,172.217.194.0-255,1484,191883,64,277373
35598,0.002211,172.31.40.0-255,66,191949,64,277373
35599,0.002228,172.217.194.0-255,1484,193433,64,277373
35600,0.002234,172.217.194.0-255,4320,197753,64,277373
35601,0.002237,172.31.40.0-255,66,197819,64,277373
35602,0.002272,172.31.40.0-255,66,197885,64,277373
35603,0.004852,172.217.194.0-255,5738,203623,64,277373
35604,0.00486,172.31.40.0-255,66,203689,64,277373
35605,0.007432,172.217.194.0-255,5738,209427,64,277373
35606,0.007436,172.31.40.0-255,66,209493,64,277373
35607,0.009969,172.217.194.0-255,5738,215231,64,277373
35608,0.009979,172.31.40.0-255,66,215297,64,277373
35609,0.012542,172.217.194.0-255,5738,221035,64,277373
35610,0.012555,172.31.40.0-255,66,221101,64,277373
35611,0.015114,172.217.194.0-255,5738,226839,64,277373
35612,0.015127,172.31.40.0-255,66,226905,64,277373
35613,0.017667,172.217.194.0-255,5738,232643,64,277373
35614,0.017683,172.31.40.0-255,66,232709,64,277373
35615,0.020271,172.217.194.0-255,5738,238447,64,277373
35616,0.020284,172.31.40.0-255,66,238513,64,277373
35617,0.022819,172.217.194.0-255,5738,244251,64,277373
35618,0.022827,172.31.40.0-255,66,244317,64,277373
35619,0.025379,172.217.194.0-255,5738,250055,64,277373
35620,0.025387,172.31.40.0-255,66,250121,64,277373
35621,0.027924,172.217.194.0-255,5738,255859,64,277373
35622,0.027934,172.31.40.0-255,66,255925,64,277373
35623,0.030513,172.217.194.0-255,5738,261663,64,277373
35624,0.030526,172.31.40.0-255,66,261729,64,277373
35625,0.033058,172.217.194.0-255,5738,267467,64,277373
35626,0.033066,172.31.40.0-255,66,267533,64,277373
35627,0.034053,172.31.40.0-255,211,267744,64,277373
35628,0.034085,172.31.40.0-255,1112,268856,64,277373
35629,0.034144,172.31.40.0-255,1514,270370,64,277373
35630,0.034165,172.31.40.0-255,1296,271666,64,277373
35631,0.035582,104.244.42.0-255,66,271732,64,277373
35632,0.03562,172.217.194.0-255,5272,277004,64,277373
35633,0.035625,172.31.40.0-255,66,277070,64,277373
35634,0.035635,104.244.42.0-255,66,277136,64,277373
35635,0.035723,104.244.42.0-255,66,277202,64,277373
35636,0.035819,172.31.40.0-255,105,277307,64,277373
35637,0.038381,172.217.194.0-255,66,277373,64,277373
35638,0.0,74.125.68.0-255,150,150,64,213306
35639,2.3e-05,172.31.40.0-255,66,216,64,213306
35640,3.1e-05,74.125.68.0-255,1484,1700,64,213306
35641,3.6e-05,172.31.40.0-255,66,1766,64,213306
35642,6.1e-05,74.125.68.0-255,2902,4668,64,213306
35643,6.4e-05,172.31.40.0-255,66,4734,64,213306
35644,7.1e-05,74.125.68.0-255,5738,10472,64,213306
35645,7.4e-05,172.31.40.0-255,66,10538,64,213306
35646,0.000102,74.125.68.0-255,3555,14093,64,213306
35647,0.000106,172.31.40.0-255,66,14159,64,213306
35648,0.000228,74.125.68.0-255,1484,15643,64,213306
35649,0.000232,172.31.40.0-255,66,15709,64,213306
35650,0.000238,74.125.68.0-255,2902,18611,64,213306
35651,0.000241,172.31.40.0-255,66,18677,64,213306
35652,0.000257,74.125.68.0-255,4320,22997,64,213306
35653,0.00026,172.31.40.0-255,66,23063,64,213306
35654,0.000279,74.125.68.0-255,1484,24547,64,213306
35655,0.000282,172.31.40.0-255,66,24613,64,213306
35656,0.000314,74.125.68.0-255,2902,27515,64,213306
35657,0.000317,172.31.40.0-255,66,27581,64,213306
35658,0.000342,74.125.68.0-255,3961,31542,64,213306
35659,0.000345,172.31.40.0-255,66,31608,64,213306
35660,0.000352,74.125.68.0-255,7156,38764,64,213306
35661,0.000356,172.31.40.0-255,66,38830,64,213306
35662,0.000362,74.125.68.0-255,5738,44568,64,213306
35663,0.000364,172.31.40.0-255,66,44634,64,213306
35664,0.000381,74.125.68.0-255,1484,46118,64,213306
35665,0.000384,172.31.40.0-255,66,46184,64,213306
35666,0.000405,74.125.68.0-255,2543,48727,64,213306
35667,0.000407,172.31.40.0-255,66,48793,64,213306
35668,0.000412,74.125.68.0-255,2902,51695,64,213306
35669,0.000414,172.31.40.0-255,66,51761,64,213306
35670,0.000431,74.125.68.0-255,1484,53245,64,213306
35671,0.000449,74.125.68.0-255,7156,60401,64,213306
35672,0.000452,172.31.40.0-255,66,60467,64,213306
35673,0.000464,74.125.68.0-255,2902,63369,64,213306
35674,0.000467,172.31.40.0-255,66,63435,64,213306
35675,0.000485,74.125.68.0-255,2543,65978,64,213306
35676,0.000487,172.31.40.0-255,66,66044,64,213306
35677,0.002326,74.125.68.0-255,645,66689,64,213306
35678,0.002804,74.125.68.0-255,4320,71009,64,213306
35679,0.00281,172.31.40.0-255,66,71075,64,213306
35680,0.005123,74.125.68.0-255,4320,75395,64,213306
35681,0.005127,172.31.40.0-255,66,75461,64,213306
35682,0.005148,74.125.68.0-255,1484,76945,64,213306
35683,0.007462,74.125.68.0-255,4320,81265,64,213306
35684,0.007469,172.31.40.0-255,66,81331,64,213306
35685,0.009803,74.125.68.0-255,5738,87069,64,213306
35686,0.009819,172.31.40.0-255,66,87135,64,213306
35687,0.012177,74.125.68.0-255,5738,92873,64,213306
35688,0.01219,172.31.40.0-255,66,92939,64,213306
35689,0.014539,74.125.68.0-255,5738,98677,64,213306
35690,0.014552,172.31.40.0-255,66,98743,64,213306
35691,0.01689,74.125.68.0-255,5738,104481,64,213306
35692,0.0169,172.31.40.0-255,66,104547,64,213306
35693,0.019241,74.125.68.0-255,5738,110285,64,213306
35694,0.019249,172.31.40.0-255,66,110351,64,213306
35695,0.021584,74.125.68.0-255,5738,116089,64,213306
35696,0.021594,172.31.40.0-255,66,116155,64,213306
35697,0.02392,74.125.68.0-255,5738,121893,64,213306
35698,0.023928,172.31.40.0-255,66,121959,64,213306
35699,0.026386,172.31.40.0-255,167,122126,64,213306
35700,0.026417,172.31.40.0-255,1113,123239,64,213306
35701,0.026478,172.31.40.0-255,1514,124753,64,213306
35702,0.02648,172.31.40.0-255,1295,126048,64,213306
35703,0.026532,74.125.68.0-255,5738,131786,64,213306
35704,0.026538,172.31.40.0-255,66,131852,64,213306
35705,0.027935,104.244.42.0-255,66,131918,64,213306
35706,0.027998,104.244.42.0-255,66,131984,64,213306
35707,0.02806,104.244.42.0-255,66,132050,64,213306
35708,0.028862,74.125.68.0-255,5738,137788,64,213306
35709,0.02887,172.31.40.0-255,66,137854,64,213306
35710,0.031197,74.125.68.0-255,5738,143592,64,213306
35711,0.031205,172.31.40.0-255,66,143658,64,213306
35712,0.033561,74.125.68.0-255,5738,149396,64,213306
35713,0.033572,172.31.40.0-255,66,149462,64,213306
35714,0.035911,74.125.68.0-255,5738,155200,64,213306
35715,0.035918,172.31.40.0-255,66,155266,64,213306
35716,0.038251,74.125.68.0-255,5738,161004,64,213306
35717,0.038258,172.31.40.0-255,66,161070,64,213306
35718,0.040587,74.125.68.0-255,5738,166808,64,213306
35719,0.040594,172.31.40.0-255,66,166874,64,213306
35720,0.042917,74.125.68.0-255,5738,172612,64,213306
35721,0.042925,172.31.40.0-255,66,172678,64,213306
35722,0.045254,74.125.68.0-255,5738,178416,64,213306
35723,0.045269,172.31.40.0-255,66,178482,64,213306
35724,0.047605,74.125.68.0-255,5738,184220,64,213306
35725,0.047614,172.31.40.0-255,66,184286,64,213306
35726,0.049945,74.125.68.0-255,5738,190024,64,213306
35727,0.049953,172.31.40.0-255,66,190090,64,213306
35728,0.052298,74.125.68.0-255,5738,195828,64,213306
35729,0.052306,172.31.40.0-255,66,195894,64,213306
35730,0.054651,74.125.68.0-255,5738,201632,64,213306
35731,0.054659,172.31.40.0-255,66,201698,64,213306
35732,0.056996,74.125.68.0-255,5738,207436,64,213306
35733,0.057002,172.31.40.0-255,66,207502,64,213306
35734,0.059333,74.125.68.0-255,5738,213240,64,213306
35735,0.05934,172.31.40.0-255,66,213306,64,213306
35736,0.0,74.125.24.0-255,291,291,64,271970
35737,2.1e-05,172.31.40.0-255,66,357,64,271970
35738,2.7e-05,74.125.24.0-255,1484,1841,64,271970
35739,3.1e-05,172.31.40.0-255,66,1907,64,271970
35740,3.6e-05,74.125.24.0-255,2902,4809,64,271970
35741,3.9e-05,172.31.40.0-255,66,4875,64,271970
35742,4.6e-05,74.125.24.0-255,5738,10613,64,271970
35743,4.9e-05,172.31.40.0-255,66,10679,64,271970
35744,8.5e-05,172.31.40.0-255,66,10745,64,271970
35745,8.9e-05,74.125.24.0-255,2902,13647,64,271970
35746,9.1e-05,172.31.40.0-255,66,13713,64,271970
35747,0.000111,74.125.24.0-255,7156,20869,64,271970
35748,0.000114,172.31.40.0-255,66,20935,64,271970
35749,0.000125,74.125.24.0-255,1125,22060,64,271970
35750,0.000127,172.31.40.0-255,66,22126,64,271970
35751,0.000214,74.125.24.0-255,1484,23610,64,271970
35752,0.000217,172.31.40.0-255,66,23676,64,271970
35753,0.00023,74.125.24.0-255,1484,25160,64,271970
35754,0.000232,172.31.40.0-255,66,25226,64,271970
35755,0.000251,74.125.24.0-255,1484,26710,64,271970
35756,0.000254,172.31.40.0-255,66,26776,64,271970
35757,0.00026,74.125.24.0-255,5738,32514,64,271970
35758,0.000261,172.31.40.0-255,66,32580,64,271970
35759,0.000264,74.125.24.0-255,1484,34064,64,271970
35760,0.000266,172.31.40.0-255,66,34130,64,271970
35761,0.000287,74.125.24.0-255,2902,37032,64,271970
35762,0.00029,172.31.40.0-255,66,37098,64,271970
35763,0.000292,74.125.24.0-255,1484,38582,64,271970
35764,0.000294,172.31.40.0-255,66,38648,64,271970
35765,0.000338,172.31.40.0-255,66,38714,64,271970
35766,0.000345,74.125.24.0-255,7109,45823,64,271970
35767,0.000347,172.31.40.0-255,66,45889,64,271970
35768,0.00035,74.125.24.0-255,110,45999,64,271970
35769,0.000353,172.31.40.0-255,66,46065,64,271970
35770,0.000584,74.125.24.0-255,331,46396,64,271970
35771,0.000588,172.31.40.0-255,66,46462,64,271970
35772,0.001043,74.125.24.0-255,1484,47946,64,271970
35773,0.001049,172.31.40.0-255,66,48012,64,271970
35774,0.001059,74.125.24.0-255,2902,50914,64,271970
35775,0.001061,172.31.40.0-255,66,50980,64,271970
35776,0.001067,74.125.24.0-255,5738,56718,64,271970
35777,0.001069,172.31.40.0-255,66,56784,64,271970
35778,0.001074,74.125.24.0-255,2902,59686,64,271970
35779,0.001076,172.31.40.0-255,66,59752,64,271970
35780,0.001117,74.125.24.0-255,1484,61236,64,271970
35781,0.001134,74.125.24.0-255,4320,65556,64,271970
35782,0.001163,74.125.24.0-255,5020,70576,64,271970
35783,0.001274,74.125.24.0-255,1484,72060,64,271970
35784,0.001292,74.125.24.0-255,2902,74962,64,271970
35785,0.001317,74.125.24.0-255,4320,79282,64,271970
35786,0.001356,74.125.24.0-255,2902,82184,64,271970
35787,0.001371,74.125.24.0-255,2902,85086,64,271970
35788,0.001416,74.125.24.0-255,5738,90824,64,271970
35789,0.001436,74.125.24.0-255,2184,93008,64,271970
35790,0.001452,74.125.24.0-255,4320,97328,64,271970
35791,0.001468,74.125.24.0-255,4320,101648,64,271970
35792,0.001475,74.125.24.0-255,7156,108804,64,271970
35793,0.001492,74.125.24.0-255,2902,111706,64,271970
35794,0.001518,74.125.24.0-255,4320,116026,64,271970
35795,0.001802,74.125.24.0-255,1484,117510,64,271970
35796,0.001824,74.125.24.0-255,2902,120412,64,271970
35797,0.001851,74.125.24.0-255,2902,123314,64,271970
35798,0.001868,74.125.24.0-255,2902,126216,64,271970
35799,0.001872,74.125.24.0-255,2902,129118,64,271970
35800,0.001886,74.125.24.0-255,4320,133438,64,271970
35801,0.001903,74.125.24.0-255,5738,139176,64,271970
35802,0.00192,74.125.24.0-255,2902,142078,64,271970
35803,0.002585,74.125.24.0-255,1484,143562,64,271970
35804,0.002593,74.125.24.0-255,2902,146464,64,271970
35805,0.002622,74.125.24.0-255,5738,152202,64,271970
35806,0.002628,74.125.24.0-255,4320,156522,64,271970
35807,0.002642,74.125.24.0-255,1484,158006,64,271970
35808,0.002647,74.125.24.0-255,4320,162326,64,271970
35809,0.002664,74.125.24.0-255,2902,165228,64,271970
35810,0.002682,74.125.24.0-255,4320,169548,64,271970
35811,0.002696,74.125.24.0-255,6438,175986,64,271970
35812,0.002833,74.125.24.0-255,1484,177470,64,271970
35813,0.002851,74.125.24.0-255,2902,180372,64,271970
35814,0.002856,74.125.24.0-255,4320,184692,64,271970
35815,0.002873,74.125.24.0-255,1484,186176,64,271970
35816,0.002877,74.125.24.0-255,2902,189078,64,271970
35817,0.00296,74.125.24.0-255,2184,191262,64,271970
35818,0.003071,74.125.24.0-255,1484,192746,64,271970
35819,0.003084,74.125.24.0-255,1484,194230,64,271970
35820,0.003107,74.125.24.0-255,1484,195714,64,271970
35821,0.003115,74.125.24.0-255,5738,201452,64,271970
35822,0.003131,74.125.24.0-255,2902,204354,64,271970
35823,0.003212,74.125.24.0-255,4320,208674,64,271970
35824,0.003256,74.125.24.0-255,1484,210158,64,271970
35825,0.003269,74.125.24.0-255,2902,213060,64,271970
35826,0.003285,74.125.24.0-255,5738,218798,64,271970
35827,0.003288,74.125.24.0-255,1484,220282,64,271970
35828,0.003305,74.125.24.0-255,2902,223184,64,271970
35829,0.003328,74.125.24.0-255,1484,224668,64,271970
35830,0.003367,74.125.24.0-255,7156,231824,64,271970
35831,0.003429,74.125.24.0-255,4320,236144,64,271970
35832,0.003435,74.125.24.0-255,4320,240464,64,271970
35833,0.003458,74.125.24.0-255,6438,246902,64,271970
35834,0.003465,74.125.24.0-255,5738,252640,64,271970
35835,0.003506,74.125.24.0-255,4320,256960,64,271970
35836,0.003553,74.125.24.0-255,3602,260562,64,271970
35837,0.003587,74.125.24.0-255,6770,267332,64,271970
35838,0.003591,74.125.24.0-255,105,267437,64,271970
35839,0.009089,172.31.40.0-255,66,267503,64,271970
35840,0.014697,172.31.40.0-255,105,267608,64,271970
35841,0.016694,74.125.24.0-255,66,267674,64,271970
35842,0.047949,172.31.40.0-255,176,267850,64,271970
35843,0.048003,172.31.40.0-255,1112,268962,64,271970
35844,0.04807,172.31.40.0-255,1514,270476,64,271970
35845,0.048072,172.31.40.0-255,1296,271772,64,271970
35846,0.049514,104.244.42.0-255,66,271838,64,271970
35847,0.049612,104.244.42.0-255,66,271904,64,271970
35848,0.049655,104.244.42.0-255,66,271970,64,271970
35849,0.0,172.217.194.0-255,150,150,64,241864
35850,2.2e-05,172.31.40.0-255,66,216,64,241864
35851,2.9e-05,172.217.194.0-255,1484,1700,64,241864
35852,3.2e-05,172.31.40.0-255,66,1766,64,241864
35853,3.7e-05,172.217.194.0-255,2902,4668,64,241864
35854,4.1e-05,172.31.40.0-255,66,4734,64,241864
35855,5.3e-05,172.217.194.0-255,7156,11890,64,241864
35856,5.7e-05,172.31.40.0-255,66,11956,64,241864
35857,6.3e-05,172.217.194.0-255,6321,18277,64,241864
35858,6.6e-05,172.31.40.0-255,66,18343,64,241864
35859,0.000104,172.217.194.0-255,7156,25499,64,241864
35860,0.000107,172.31.40.0-255,66,25565,64,241864
35861,0.000137,172.217.194.0-255,5379,30944,64,241864
35862,0.00014,172.31.40.0-255,66,31010,64,241864
35863,0.000145,172.217.194.0-255,2902,33912,64,241864
35864,0.000147,172.31.40.0-255,66,33978,64,241864
35865,0.00015,172.217.194.0-255,1484,35462,64,241864
35866,0.000152,172.31.40.0-255,66,35528,64,241864
35867,0.000193,172.217.194.0-255,2902,38430,64,241864
35868,0.000196,172.31.40.0-255,66,38496,64,241864
35869,0.000206,172.31.40.0-255,66,38562,64,241864
35870,0.000229,172.31.40.0-255,66,38628,64,241864
35871,0.000232,172.217.194.0-255,121,38749,64,241864
35872,0.000235,172.31.40.0-255,66,38815,64,241864
35873,0.000679,172.217.194.0-255,381,39196,64,241864
35874,0.000686,172.31.40.0-255,66,39262,64,241864
35875,0.00097,172.217.194.0-255,1484,40746,64,241864
35876,0.000974,172.31.40.0-255,66,40812,64,241864
35877,0.000993,172.217.194.0-255,2902,43714,64,241864
35878,0.000996,172.31.40.0-255,66,43780,64,241864
35879,0.001002,172.217.194.0-255,5738,49518,64,241864
35880,0.001004,172.31.40.0-255,66,49584,64,241864
35881,0.00105,172.31.40.0-255,66,49650,64,241864
35882,0.001086,172.31.40.0-255,66,49716,64,241864
35883,0.001221,172.217.194.0-255,1484,51200,64,241864
35884,0.001227,172.217.194.0-255,2902,54102,64,241864
35885,0.00123,172.31.40.0-255,66,54168,64,241864
35886,0.001234,172.217.194.0-255,1484,55652,64,241864
35887,0.001263,172.217.194.0-255,4320,59972,64,241864
35888,0.001265,172.31.40.0-255,66,60038,64,241864
35889,0.001278,172.31.40.0-255,66,60104,64,241864
35890,0.001294,172.31.40.0-255,66,60170,64,241864
35891,0.001322,172.217.194.0-255,766,60936,64,241864
35892,0.001779,172.31.40.0-255,66,61002,64,241864
35893,0.001953,172.217.194.0-255,1484,62486,64,241864
35894,0.001961,172.217.194.0-255,2902,65388,64,241864
35895,0.001964,172.31.40.0-255,66,65454,64,241864
35896,0.001968,172.217.194.0-255,1484,66938,64,241864
35897,0.001993,172.217.194.0-255,4320,71258,64,241864
35898,0.001995,172.31.40.0-255,66,71324,64,241864
35899,0.002001,172.217.194.0-255,7156,78480,64,241864
35900,0.002003,172.31.40.0-255,66,78546,64,241864
35901,0.002008,172.217.194.0-255,5738,84284,64,241864
35902,0.002014,172.31.40.0-255,66,84350,64,241864
35903,0.002049,172.31.40.0-255,66,84416,64,241864
35904,0.002053,172.217.194.0-255,2184,86600,64,241864
35905,0.002054,172.31.40.0-255,66,86666,64,241864
35906,0.004254,172.217.194.0-255,5738,92404,64,241864
35907,0.004261,172.31.40.0-255,66,92470,64,241864
35908,0.006469,172.217.194.0-255,5738,98208,64,241864
35909,0.006474,172.31.40.0-255,66,98274,64,241864
35910,0.008658,172.217.194.0-255,5738,104012,64,241864
35911,0.008664,172.31.40.0-255,66,104078,64,241864
35912,0.010869,172.217.194.0-255,5738,109816,64,241864
35913,0.010877,172.31.40.0-255,66,109882,64,241864
35914,0.013109,172.217.194.0-255,5738,115620,64,241864
35915,0.013116,172.31.40.0-255,66,115686,64,241864
35916,0.01533,172.217.194.0-255,5738,121424,64,241864
35917,0.015341,172.31.40.0-255,66,121490,64,241864
35918,0.017538,172.217.194.0-255,5738,127228,64,241864
35919,0.017547,172.31.40.0-255,66,127294,64,241864
35920,0.01975,172.217.194.0-255,5738,133032,64,241864
35921,0.019757,172.31.40.0-255,66,133098,64,241864
35922,0.021966,172.217.194.0-255,5738,138836,64,241864
35923,0.021972,172.31.40.0-255,66,138902,64,241864
35924,0.024192,172.217.194.0-255,5738,144640,64,241864
35925,0.024201,172.31.40.0-255,66,144706,64,241864
35926,0.026408,172.217.194.0-255,5738,150444,64,241864
35927,0.026421,172.31.40.0-255,66,150510,64,241864
35928,0.028621,172.217.194.0-255,5738,156248,64,241864
35929,0.028629,172.31.40.0-255,66,156314,64,241864
35930,0.03084,172.217.194.0-255,5738,162052,64,241864
35931,0.030847,172.31.40.0-255,66,162118,64,241864
35932,0.031439,172.31.40.0-255,172,162290,64,241864
35933,0.031473,172.31.40.0-255,1112,163402,64,241864
35934,0.031534,172.31.40.0-255,1514,164916,64,241864
35935,0.031556,172.31.40.0-255,1298,166214,64,241864
35936,0.032984,104.244.42.0-255,66,166280,64,241864
35937,0.032993,104.244.42.0-255,66,166346,64,241864
35938,0.033046,172.217.194.0-255,5738,172084,64,241864
35939,0.033055,172.31.40.0-255,66,172150,64,241864
35940,0.033082,104.244.42.0-255,66,172216,64,241864
35941,0.03527,172.217.194.0-255,5738,177954,64,241864
35942,0.035288,172.31.40.0-255,66,178020,64,241864
35943,0.0375,172.217.194.0-255,5738,183758,64,241864
35944,0.037515,172.31.40.0-255,66,183824,64,241864
35945,0.039745,172.217.194.0-255,5738,189562,64,241864
35946,0.03976,172.31.40.0-255,66,189628,64,241864
35947,0.041964,172.217.194.0-255,5738,195366,64,241864
35948,0.041986,172.31.40.0-255,66,195432,64,241864
35949,0.04422,172.217.194.0-255,5738,201170,64,241864
35950,0.044237,172.31.40.0-255,66,201236,64,241864
35951,0.046472,172.217.194.0-255,5738,206974,64,241864
35952,0.046478,172.31.40.0-255,66,207040,64,241864
35953,0.048665,172.217.194.0-255,5738,212778,64,241864
35954,0.04867,172.31.40.0-255,66,212844,64,241864
35955,0.050906,172.217.194.0-255,5738,218582,64,241864
35956,0.050925,172.31.40.0-255,66,218648,64,241864
35957,0.053138,172.217.194.0-255,5738,224386,64,241864
35958,0.053153,172.31.40.0-255,66,224452,64,241864
35959,0.055376,172.217.194.0-255,5738,230190,64,241864
35960,0.055388,172.31.40.0-255,66,230256,64,241864
35961,0.057622,172.217.194.0-255,5738,235994,64,241864
35962,0.057639,172.31.40.0-255,66,236060,64,241864
35963,0.059877,172.217.194.0-255,5738,241798,64,241864
35964,0.059893,172.31.40.0-255,66,241864,64,241864
35965,0.0,74.125.68.0-255,152,152,64,315182
35966,2.4e-05,172.31.40.0-255,66,218,64,315182
35967,4e-05,74.125.68.0-255,1484,1702,64,315182
35968,5.1e-05,172.31.40.0-255,66,1768,64,315182
35969,5.7e-05,74.125.68.0-255,2902,4670,64,315182
35970,6.1e-05,172.31.40.0-255,66,4736,64,315182
35971,6.6e-05,74.125.68.0-255,2902,7638,64,315182
35972,6.9e-05,172.31.40.0-255,66,7704,64,315182
35973,9.8e-05,74.125.68.0-255,1484,9188,64,315182
35974,0.000101,172.31.40.0-255,66,9254,64,315182
35975,0.000108,74.125.68.0-255,4904,14158,64,315182
35976,0.00011,172.31.40.0-255,66,14224,64,315182
35977,0.000249,74.125.68.0-255,1484,15708,64,315182
35978,0.000254,172.31.40.0-255,66,15774,64,315182
35979,0.000259,74.125.68.0-255,2902,18676,64,315182
35980,0.000262,172.31.40.0-255,66,18742,64,315182
35981,0.000318,74.125.68.0-255,1484,20226,64,315182
35982,0.000321,172.31.40.0-255,66,20292,64,315182
35983,0.000352,74.125.68.0-255,2902,23194,64,315182
35984,0.000355,172.31.40.0-255,66,23260,64,315182
35985,0.000359,74.125.68.0-255,2902,26162,64,315182
35986,0.000361,172.31.40.0-255,66,26228,64,315182
35987,0.000367,74.125.68.0-255,4320,30548,64,315182
35988,0.000374,172.31.40.0-255,66,30614,64,315182
35989,0.000414,74.125.68.0-255,1125,31739,64,315182
35990,0.000417,172.31.40.0-255,66,31805,64,315182
35991,0.000481,74.125.68.0-255,1484,33289,64,315182
35992,0.000485,172.31.40.0-255,66,33355,64,315182
35993,0.000488,74.125.68.0-255,1484,34839,64,315182
35994,0.00049,172.31.40.0-255,66,34905,64,315182
35995,0.000522,74.125.68.0-255,1484,36389,64,315182
35996,0.000525,172.31.40.0-255,66,36455,64,315182
35997,0.00053,74.125.68.0-255,2902,39357,64,315182
35998,0.000566,74.125.68.0-255,4320,43677,64,315182
35999,0.000572,74.125.68.0-255,4320,47997,64,315182
36000,0.000589,74.125.68.0-255,2902,50899,64,315182
36001,0.000601,74.125.68.0-255,2543,53442,64,315182
36002,0.000613,74.125.68.0-255,1484,54926,64,315182
36003,0.000629,74.125.68.0-255,4320,59246,64,315182
36004,0.000644,74.125.68.0-255,1484,60730,64,315182
36005,0.000649,172.31.40.0-255,66,60796,64,315182
36006,0.000677,74.125.68.0-255,5651,66447,64,315182
36007,0.000681,74.125.68.0-255,132,66579,64,315182
36008,0.000704,172.31.40.0-255,66,66645,64,315182
36009,0.000825,74.125.68.0-255,347,66992,64,315182
36010,0.000871,74.125.68.0-255,1484,68476,64,315182
36011,0.000875,74.125.68.0-255,1484,69960,64,315182
36012,0.000886,172.31.40.0-255,66,70026,64,315182
36013,0.00089,74.125.68.0-255,1484,71510,64,315182
36014,0.000921,74.125.68.0-255,4320,75830,64,315182
36015,0.000928,74.125.68.0-255,5738,81568,64,315182
36016,0.000936,172.31.40.0-255,66,81634,64,315182
36017,0.000989,74.125.68.0-255,1484,83118,64,315182
36018,0.000996,74.125.68.0-255,5738,88856,64,315182
36019,0.001002,172.31.40.0-255,66,88922,64,315182
36020,0.001031,74.125.68.0-255,2184,91106,64,315182
36021,0.001051,172.31.40.0-255,66,91172,64,315182
36022,0.001759,74.125.68.0-255,1484,92656,64,315182
36023,0.001764,74.125.68.0-255,1484,94140,64,315182
36024,0.001768,172.31.40.0-255,66,94206,64,315182
36025,0.001781,74.125.68.0-255,1484,95690,64,315182
36026,0.00179,74.125.68.0-255,2902,98592,64,315182
36027,0.001795,74.125.68.0-255,4320,102912,64,315182
36028,0.001829,74.125.68.0-255,2902,105814,64,315182
36029,0.001851,74.125.68.0-255,5738,111552,64,315182
36030,0.001867,74.125.68.0-255,4320,115872,64,315182
36031,0.001893,74.125.68.0-255,5738,121610,64,315182
36032,0.001897,74.125.68.0-255,3602,125212,64,315182
36033,0.001925,74.125.68.0-255,1484,126696,64,315182
36034,0.001943,74.125.68.0-255,2902,129598,64,315182
36035,0.001971,74.125.68.0-255,5738,135336,64,315182
36036,0.001973,74.125.68.0-255,1484,136820,64,315182
36037,0.001991,74.125.68.0-255,1484,138304,64,315182
36038,0.002011,74.125.68.0-255,5738,144042,64,315182
36039,0.002024,74.125.68.0-255,4320,148362,64,315182
36040,0.002083,74.125.68.0-255,4320,152682,64,315182
36041,0.002101,74.125.68.0-255,6438,159120,64,315182
36042,0.002106,74.125.68.0-255,2902,162022,64,315182
36043,0.00213,74.125.68.0-255,1484,163506,64,315182
36044,0.002133,74.125.68.0-255,1484,164990,64,315182
36045,0.002143,74.125.68.0-255,1484,166474,64,315182
36046,0.002163,74.125.68.0-255,5738,172212,64,315182
36047,0.00219,74.125.68.0-255,2184,174396,64,315182
36048,0.002378,74.125.68.0-255,1484,175880,64,315182
36049,0.002434,74.125.68.0-255,2902,178782,64,315182
36050,0.002471,74.125.68.0-255,4320,183102,64,315182
36051,0.002485,74.125.68.0-255,2902,186004,64,315182
36052,0.002546,74.125.68.0-255,2902,188906,64,315182
36053,0.00259,74.125.68.0-255,2902,191808,64,315182
36054,0.002606,74.125.68.0-255,1484,193292,64,315182
36055,0.006404,172.31.40.0-255,66,193358,64,315182
36056,0.009007,74.125.68.0-255,5738,199096,64,315182
36057,0.009014,172.31.40.0-255,66,199162,64,315182
36058,0.011604,74.125.68.0-255,5738,204900,64,315182
36059,0.011612,172.31.40.0-255,66,204966,64,315182
36060,0.014206,74.125.68.0-255,5738,210704,64,315182
36061,0.014215,172.31.40.0-255,66,210770,64,315182
36062,0.016811,74.125.68.0-255,5738,216508,64,315182
36063,0.016821,172.31.40.0-255,66,216574,64,315182
36064,0.019411,74.125.68.0-255,5738,222312,64,315182
36065,0.01942,172.31.40.0-255,66,222378,64,315182
36066,0.022026,74.125.68.0-255,5738,228116,64,315182
36067,0.022035,172.31.40.0-255,66,228182,64,315182
36068,0.024637,74.125.68.0-255,5738,233920,64,315182
36069,0.024646,172.31.40.0-255,66,233986,64,315182
36070,0.027239,74.125.68.0-255,5738,239724,64,315182
36071,0.027249,172.31.40.0-255,66,239790,64,315182
36072,0.029847,74.125.68.0-255,5738,245528,64,315182
36073,0.029854,172.31.40.0-255,66,245594,64,315182
36074,0.030446,172.31.40.0-255,172,245766,64,315182
36075,0.030478,172.31.40.0-255,1112,246878,64,315182
36076,0.030532,172.31.40.0-255,1514,248392,64,315182
36077,0.030534,172.31.40.0-255,1296,249688,64,315182
36078,0.032005,104.244.42.0-255,66,249754,64,315182
36079,0.032042,104.244.42.0-255,66,249820,64,315182
36080,0.032091,104.244.42.0-255,66,249886,64,315182
36081,0.032432,74.125.68.0-255,2902,252788,64,315182
36082,0.032437,172.31.40.0-255,66,252854,64,315182
36083,0.032467,74.125.68.0-255,2902,255756,64,315182
36084,0.032489,172.31.40.0-255,66,255822,64,315182
36085,0.035041,74.125.68.0-255,2902,258724,64,315182
36086,0.035048,172.31.40.0-255,66,258790,64,315182
36087,0.035077,74.125.68.0-255,2902,261692,64,315182
36088,0.035099,172.31.40.0-255,66,261758,64,315182
36089,0.037627,74.125.68.0-255,2902,264660,64,315182
36090,0.037634,172.31.40.0-255,66,264726,64,315182
36091,0.037679,74.125.68.0-255,2902,267628,64,315182
36092,0.037714,172.31.40.0-255,66,267694,64,315182
36093,0.040232,74.125.68.0-255,2902,270596,64,315182
36094,0.040241,172.31.40.0-255,66,270662,64,315182
36095,0.040278,74.125.68.0-255,2902,273564,64,315182
36096,0.04032,172.31.40.0-255,66,273630,64,315182
36097,0.042833,74.125.68.0-255,2902,276532,64,315182
36098,0.042839,172.31.40.0-255,66,276598,64,315182
36099,0.042895,74.125.68.0-255,2902,279500,64,315182
36100,0.042945,172.31.40.0-255,66,279566,64,315182
36101,0.045434,74.125.68.0-255,2902,282468,64,315182
36102,0.045439,172.31.40.0-255,66,282534,64,315182
36103,0.045516,74.125.68.0-255,2902,285436,64,315182
36104,0.045522,172.31.40.0-255,66,285502,64,315182
36105,0.04802,74.125.68.0-255,2902,288404,64,315182
36106,0.048026,172.31.40.0-255,66,288470,64,315182
36107,0.048093,74.125.68.0-255,2902,291372,64,315182
36108,0.048109,172.31.40.0-255,66,291438,64,315182
36109,0.050617,74.125.68.0-255,2902,294340,64,315182
36110,0.050623,172.31.40.0-255,66,294406,64,315182
36111,0.050685,74.125.68.0-255,2902,297308,64,315182
36112,0.050718,172.31.40.0-255,66,297374,64,315182
36113,0.053219,74.125.68.0-255,2902,300276,64,315182
36114,0.053226,172.31.40.0-255,66,300342,64,315182
36115,0.053292,74.125.68.0-255,2902,303244,64,315182
36116,0.053411,172.31.40.0-255,66,303310,64,315182
36117,0.055808,74.125.68.0-255,2902,306212,64,315182
36118,0.055814,172.31.40.0-255,66,306278,64,315182
36119,0.055981,74.125.68.0-255,2902,309180,64,315182
36120,0.056419,172.31.40.0-255,66,309246,64,315182
36121,0.058438,74.125.68.0-255,2902,312148,64,315182
36122,0.058445,172.31.40.0-255,66,312214,64,315182
36123,0.059011,74.125.68.0-255,2902,315116,64,315182
36124,0.059017,172.31.40.0-255,66,315182,64,315182
36125,0.0,172.217.194.0-255,153,153,64,245448
36126,3.3e-05,172.31.40.0-255,66,219,64,245448
36127,4.1e-05,172.217.194.0-255,1484,1703,64,245448
36128,4.5e-05,172.31.40.0-255,66,1769,64,245448
36129,5e-05,172.217.194.0-255,2902,4671,64,245448
36130,6e-05,172.31.40.0-255,66,4737,64,245448
36131,6.3e-05,172.217.194.0-255,1484,6221,64,245448
36132,6.6e-05,172.31.40.0-255,66,6287,64,245448
36133,0.000104,172.217.194.0-255,2902,9189,64,245448
36134,0.000107,172.31.40.0-255,66,9255,64,245448
36135,0.000122,172.217.194.0-255,4902,14157,64,245448
36136,0.000129,172.31.40.0-255,66,14223,64,245448
36137,0.000195,172.217.194.0-255,1484,15707,64,245448
36138,0.000198,172.31.40.0-255,66,15773,64,245448
36139,0.000204,172.217.194.0-255,2902,18675,64,245448
36140,0.000206,172.31.40.0-255,66,18741,64,245448
36141,0.000252,172.217.194.0-255,5738,24479,64,245448
36142,0.000255,172.31.40.0-255,66,24545,64,245448
36143,0.000262,172.217.194.0-255,6797,31342,64,245448
36144,0.000264,172.31.40.0-255,66,31408,64,245448
36145,0.000342,172.217.194.0-255,1484,32892,64,245448
36146,0.000345,172.31.40.0-255,66,32958,64,245448
36147,0.00035,172.217.194.0-255,2902,35860,64,245448
36148,0.000354,172.31.40.0-255,66,35926,64,245448
36149,0.000388,172.217.194.0-255,5738,41664,64,245448
36150,0.000393,172.31.40.0-255,66,41730,64,245448
36151,0.0004,172.217.194.0-255,4320,46050,64,245448
36152,0.000403,172.31.40.0-255,66,46116,64,245448
36153,0.000428,172.31.40.0-255,66,46182,64,245448
36154,0.000471,172.31.40.0-255,66,46248,64,245448
36155,0.000474,172.217.194.0-255,395,46643,64,245448
36156,0.000514,172.217.194.0-255,380,47023,64,245448
36157,0.000766,172.217.194.0-255,1484,48507,64,245448
36158,0.000771,172.31.40.0-255,66,48573,64,245448
36159,0.000776,172.217.194.0-255,2902,51475,64,245448
36160,0.000778,172.31.40.0-255,66,51541,64,245448
36161,0.000805,172.217.194.0-255,5738,57279,64,245448
36162,0.000814,172.31.40.0-255,66,57345,64,245448
36163,0.000828,172.31.40.0-255,66,57411,64,245448
36164,0.000863,172.31.40.0-255,66,57477,64,245448
36165,0.001105,172.217.194.0-255,1484,58961,64,245448
36166,0.001123,172.217.194.0-255,2902,61863,64,245448
36167,0.001126,172.31.40.0-255,66,61929,64,245448
36168,0.00113,172.217.194.0-255,1484,63413,64,245448
36169,0.001157,172.217.194.0-255,4320,67733,64,245448
36170,0.001161,172.31.40.0-255,66,67799,64,245448
36171,0.001167,172.217.194.0-255,5738,73537,64,245448
36172,0.001169,172.31.40.0-255,66,73603,64,245448
36173,0.001182,172.31.40.0-255,66,73669,64,245448
36174,0.001207,172.217.194.0-255,1484,75153,64,245448
36175,0.001214,172.217.194.0-255,5020,80173,64,245448
36176,0.001217,172.31.40.0-255,66,80239,64,245448
36177,0.001293,172.217.194.0-255,1484,81723,64,245448
36178,0.001316,172.217.194.0-255,2902,84625,64,245448
36179,0.00132,172.31.40.0-255,66,84691,64,245448
36180,0.001326,172.217.194.0-255,5738,90429,64,245448
36181,0.001328,172.31.40.0-255,66,90495,64,245448
36182,0.001348,172.217.194.0-255,4320,94815,64,245448
36183,0.001352,172.31.40.0-255,66,94881,64,245448
36184,0.001392,172.31.40.0-255,66,94947,64,245448
36185,0.001401,172.31.40.0-255,66,95013,64,245448
36186,0.001406,172.217.194.0-255,2184,97197,64,245448
36187,0.001408,172.31.40.0-255,66,97263,64,245448
36188,0.001453,172.217.194.0-255,1484,98747,64,245448
36189,0.001472,172.217.194.0-255,2902,101649,64,245448
36190,0.001475,172.31.40.0-255,66,101715,64,245448
36191,0.001481,172.217.194.0-255,4320,106035,64,245448
36192,0.001483,172.31.40.0-255,66,106101,64,245448
36193,0.00151,172.217.194.0-255,1484,107585,64,245448
36194,0.001524,172.31.40.0-255,66,107651,64,245448
36195,0.001529,172.217.194.0-255,4320,111971,64,245448
36196,0.001531,172.31.40.0-255,66,112037,64,245448
36197,0.001556,172.217.194.0-255,4320,116357,64,245448
36198,0.001564,172.31.40.0-255,66,116423,64,245448
36199,0.001568,172.217.194.0-255,2184,118607,64,245448
36200,0.00157,172.31.40.0-255,66,118673,64,245448
36201,0.001859,172.217.194.0-255,1484,120157,64,245448
36202,0.001865,172.217.194.0-255,2902,123059,64,245448
36203,0.001868,172.31.40.0-255,66,123125,64,245448
36204,0.001874,172.217.194.0-255,4320,127445,64,245448
36205,0.001876,172.31.40.0-255,66,127511,64,245448
36206,0.0019,172.217.194.0-255,1484,128995,64,245448
36207,0.001918,172.31.40.0-255,66,129061,64,245448
36208,0.001928,172.31.40.0-255,66,129127,64,245448
36209,0.001958,172.217.194.0-255,2184,131311,64,245448
36210,0.001963,172.31.40.0-255,66,131377,64,245448
36211,0.001988,172.217.194.0-255,1484,132861,64,245448
36212,0.002002,172.217.194.0-255,2902,135763,64,245448
36213,0.002005,172.31.40.0-255,66,135829,64,245448
36214,0.002039,172.217.194.0-255,5738,141567,64,245448
36215,0.002043,172.31.40.0-255,66,141633,64,245448
36216,0.002046,172.217.194.0-255,1484,143117,64,245448
36217,0.002072,172.31.40.0-255,66,143183,64,245448
36218,0.002077,172.217.194.0-255,2902,146085,64,245448
36219,0.002079,172.31.40.0-255,66,146151,64,245448
36220,0.002122,172.31.40.0-255,66,146217,64,245448
36221,0.002127,172.217.194.0-255,4320,150537,64,245448
36222,0.00213,172.31.40.0-255,66,150603,64,245448
36223,0.002134,172.217.194.0-255,2902,153505,64,245448
36224,0.002137,172.31.40.0-255,66,153571,64,245448
36225,0.002166,172.217.194.0-255,2902,156473,64,245448
36226,0.00217,172.31.40.0-255,66,156539,64,245448
36227,0.002183,172.31.40.0-255,66,156605,64,245448
36228,0.002193,172.31.40.0-255,66,156671,64,245448
36229,0.002216,172.217.194.0-255,3602,160273,64,245448
36230,0.002219,172.31.40.0-255,66,160339,64,245448
36231,0.002234,172.217.194.0-255,1484,161823,64,245448
36232,0.002242,172.217.194.0-255,1484,163307,64,245448
36233,0.002245,172.31.40.0-255,66,163373,64,245448
36234,0.002278,172.217.194.0-255,1484,164857,64,245448
36235,0.002285,172.217.194.0-255,5738,170595,64,245448
36236,0.002288,172.31.40.0-255,66,170661,64,245448
36237,0.002293,172.217.194.0-255,4320,174981,64,245448
36238,0.002296,172.31.40.0-255,66,175047,64,245448
36239,0.002315,172.31.40.0-255,66,175113,64,245448
36240,0.002319,172.217.194.0-255,2902,178015,64,245448
36241,0.002322,172.31.40.0-255,66,178081,64,245448
36242,0.002351,172.217.194.0-255,5020,183101,64,245448
36243,0.002354,172.31.40.0-255,66,183167,64,245448
36244,0.002379,172.31.40.0-255,66,183233,64,245448
36245,0.002385,172.217.194.0-255,4320,187553,64,245448
36246,0.002387,172.31.40.0-255,66,187619,64,245448
36247,0.002417,172.217.194.0-255,5738,193357,64,245448
36248,0.002421,172.31.40.0-255,66,193423,64,245448
36249,0.002432,172.31.40.0-255,66,193489,64,245448
36250,0.004796,172.217.194.0-255,5738,199227,64,245448
36251,0.004804,172.31.40.0-255,66,199293,64,245448
36252,0.007188,172.217.194.0-255,5738,205031,64,245448
36253,0.007196,172.31.40.0-255,66,205097,64,245448
36254,0.009593,172.217.194.0-255,5738,210835,64,245448
36255,0.009613,172.31.40.0-255,66,210901,64,245448
36256,0.012018,172.217.194.0-255,5738,216639,64,245448
36257,0.012028,172.31.40.0-255,66,216705,64,245448
36258,0.014419,172.217.194.0-255,5738,222443,64,245448
36259,0.01443,172.31.40.0-255,66,222509,64,245448
36260,0.015124,172.31.40.0-255,101,222610,64,245448
36261,0.016825,172.217.194.0-255,5738,228348,64,245448
36262,0.016839,172.31.40.0-255,66,228414,64,245448
36263,0.01747,172.217.194.0-255,66,228480,64,245448
36264,0.019228,172.217.194.0-255,5738,234218,64,245448
36265,0.019243,172.31.40.0-255,66,234284,64,245448
36266,0.021642,172.217.194.0-255,5738,240022,64,245448
36267,0.021661,172.31.40.0-255,66,240088,64,245448
36268,0.024025,172.217.194.0-255,900,240988,64,245448
36269,0.024212,172.31.40.0-255,105,241093,64,245448
36270,0.030476,172.217.194.0-255,66,241159,64,245448
36271,0.048556,172.31.40.0-255,167,241326,64,245448
36272,0.048584,172.31.40.0-255,1112,242438,64,245448
36273,0.048633,172.31.40.0-255,1514,243952,64,245448
36274,0.048634,172.31.40.0-255,1298,245250,64,245448
36275,0.050078,104.244.42.0-255,66,245316,64,245448
36276,0.050139,104.244.42.0-255,66,245382,64,245448
36277,0.050195,104.244.42.0-255,66,245448,64,245448
36278,0.0,74.125.68.0-255,167,167,64,239730
36279,1.8e-05,172.31.40.0-255,66,233,64,239730
36280,2.4e-05,74.125.68.0-255,1484,1717,64,239730
36281,2.9e-05,172.31.40.0-255,66,1783,64,239730
36282,3.4e-05,74.125.68.0-255,2902,4685,64,239730
36283,3.7e-05,172.31.40.0-255,66,4751,64,239730
36284,4.5e-05,74.125.68.0-255,7156,11907,64,239730
36285,4.9e-05,172.31.40.0-255,66,11973,64,239730
36286,5.2e-05,74.125.68.0-255,2039,14012,64,239730
36287,5.5e-05,172.31.40.0-255,66,14078,64,239730
36288,9.5e-05,74.125.68.0-255,1484,15562,64,239730
36289,9.7e-05,172.31.40.0-255,66,15628,64,239730
36290,0.00013,74.125.68.0-255,2902,18530,64,239730
36291,0.000133,172.31.40.0-255,66,18596,64,239730
36292,0.000152,74.125.68.0-255,5738,24334,64,239730
36293,0.000155,172.31.40.0-255,66,24400,64,239730
36294,0.000159,74.125.68.0-255,2902,27302,64,239730
36295,0.000161,172.31.40.0-255,66,27368,64,239730
36296,0.000187,74.125.68.0-255,3961,31329,64,239730
36297,0.00019,172.31.40.0-255,66,31395,64,239730
36298,0.000347,74.125.68.0-255,1484,32879,64,239730
36299,0.000353,172.31.40.0-255,66,32945,64,239730
36300,0.000364,74.125.68.0-255,1484,34429,64,239730
36301,0.000366,172.31.40.0-255,66,34495,64,239730
36302,0.000386,74.125.68.0-255,1484,35979,64,239730
36303,0.000388,172.31.40.0-255,66,36045,64,239730
36304,0.000404,74.125.68.0-255,5738,41783,64,239730
36305,0.000407,172.31.40.0-255,66,41849,64,239730
36306,0.000437,74.125.68.0-255,6797,48646,64,239730
36307,0.00044,172.31.40.0-255,66,48712,64,239730
36308,0.001025,74.125.68.0-255,1484,50196,64,239730
36309,0.001031,172.31.40.0-255,66,50262,64,239730
36310,0.001039,74.125.68.0-255,2902,53164,64,239730
36311,0.001041,172.31.40.0-255,66,53230,64,239730
36312,0.001061,74.125.68.0-255,2902,56132,64,239730
36313,0.001063,172.31.40.0-255,66,56198,64,239730
36314,0.001068,74.125.68.0-255,4320,60518,64,239730
36315,0.00107,172.31.40.0-255,66,60584,64,239730
36316,0.001119,74.125.68.0-255,2902,63486,64,239730
36317,0.001121,172.31.40.0-255,66,63552,64,239730
36318,0.001139,74.125.68.0-255,2543,66095,64,239730
36319,0.001141,172.31.40.0-255,66,66161,64,239730
36320,0.001677,74.125.68.0-255,1484,67645,64,239730
36321,0.001695,74.125.68.0-255,2902,70547,64,239730
36322,0.001699,172.31.40.0-255,66,70613,64,239730
36323,0.001703,74.125.68.0-255,1484,72097,64,239730
36324,0.001718,74.125.68.0-255,2902,74999,64,239730
36325,0.00172,172.31.40.0-255,66,75065,64,239730
36326,0.001742,74.125.68.0-255,5738,80803,64,239730
36327,0.001744,172.31.40.0-255,66,80869,64,239730
36328,0.001763,74.125.68.0-255,5738,86607,64,239730
36329,0.001765,172.31.40.0-255,66,86673,64,239730
36330,0.001779,74.125.68.0-255,2902,89575,64,239730
36331,0.00178,172.31.40.0-255,66,89641,64,239730
36332,0.001791,74.125.68.0-255,1484,91125,64,239730
36333,0.00181,172.31.40.0-255,66,91191,64,239730
36334,0.001812,74.125.68.0-255,766,91957,64,239730
36335,0.004085,74.125.68.0-255,4320,96277,64,239730
36336,0.00409,172.31.40.0-255,66,96343,64,239730
36337,0.006375,74.125.68.0-255,5738,102081,64,239730
36338,0.006384,172.31.40.0-255,66,102147,64,239730
36339,0.008658,74.125.68.0-255,5738,107885,64,239730
36340,0.008666,172.31.40.0-255,66,107951,64,239730
36341,0.010961,74.125.68.0-255,5738,113689,64,239730
36342,0.010973,172.31.40.0-255,66,113755,64,239730
36343,0.013266,74.125.68.0-255,5738,119493,64,239730
36344,0.013276,172.31.40.0-255,66,119559,64,239730
36345,0.015548,74.125.68.0-255,5738,125297,64,239730
36346,0.015557,172.31.40.0-255,66,125363,64,239730
36347,0.017843,74.125.68.0-255,5738,131101,64,239730
36348,0.01785,172.31.40.0-255,66,131167,64,239730
36349,0.020132,74.125.68.0-255,5738,136905,64,239730
36350,0.020139,172.31.40.0-255,66,136971,64,239730
36351,0.022417,74.125.68.0-255,5738,142709,64,239730
36352,0.022425,172.31.40.0-255,66,142775,64,239730
36353,0.024703,74.125.68.0-255,5738,148513,64,239730
36354,0.024711,172.31.40.0-255,66,148579,64,239730
36355,0.026984,74.125.68.0-255,5738,154317,64,239730
36356,0.02699,172.31.40.0-255,66,154383,64,239730
36357,0.027873,172.31.40.0-255,172,154555,64,239730
36358,0.027908,172.31.40.0-255,1111,155666,64,239730
36359,0.027965,172.31.40.0-255,1514,157180,64,239730
36360,0.027966,172.31.40.0-255,1514,158694,64,239730
36361,0.027991,172.31.40.0-255,694,159388,64,239730
36362,0.029259,74.125.68.0-255,5738,165126,64,239730
36363,0.029266,172.31.40.0-255,66,165192,64,239730
36364,0.029419,104.244.42.0-255,66,165258,64,239730
36365,0.029466,104.244.42.0-255,66,165324,64,239730
36366,0.029517,104.244.42.0-255,66,165390,64,239730
36367,0.029522,104.244.42.0-255,66,165456,64,239730
36368,0.030269,104.244.42.0-255,108,165564,64,239730
36369,0.030278,172.31.40.0-255,66,165630,64,239730
36370,0.031556,74.125.68.0-255,5738,171368,64,239730
36371,0.031561,172.31.40.0-255,66,171434,64,239730
36372,0.033865,74.125.68.0-255,5738,177172,64,239730
36373,0.033872,172.31.40.0-255,66,177238,64,239730
36374,0.03617,74.125.68.0-255,5738,182976,64,239730
36375,0.036177,172.31.40.0-255,66,183042,64,239730
36376,0.038475,74.125.68.0-255,5738,188780,64,239730
36377,0.038482,172.31.40.0-255,66,188846,64,239730
36378,0.04078,74.125.68.0-255,5738,194584,64,239730
36379,0.040786,172.31.40.0-255,66,194650,64,239730
36380,0.043078,74.125.68.0-255,5738,200388,64,239730
36381,0.043087,172.31.40.0-255,66,200454,64,239730
36382,0.045411,74.125.68.0-255,5738,206192,64,239730
36383,0.045417,172.31.40.0-255,66,206258,64,239730
36384,0.047706,74.125.68.0-255,5738,211996,64,239730
36385,0.047712,172.31.40.0-255,66,212062,64,239730
36386,0.050003,74.125.68.0-255,5738,217800,64,239730
36387,0.05001,172.31.40.0-255,66,217866,64,239730
36388,0.052278,74.125.68.0-255,4320,222186,64,239730
36389,0.052285,172.31.40.0-255,66,222252,64,239730
36390,0.052305,74.125.68.0-255,1484,223736,64,239730
36391,0.054566,74.125.68.0-255,4320,228056,64,239730
36392,0.054573,172.31.40.0-255,66,228122,64,239730
36393,0.056843,74.125.68.0-255,5738,233860,64,239730
36394,0.056849,172.31.40.0-255,66,233926,64,239730
36395,0.059168,74.125.68.0-255,5738,239664,64,239730
36396,0.059175,172.31.40.0-255,66,239730,64,239730
36397,0.0,172.217.194.0-255,152,152,64,234750
36398,2.4e-05,172.31.40.0-255,66,218,64,234750
36399,3.1e-05,172.217.194.0-255,1484,1702,64,234750
36400,3.6e-05,172.31.40.0-255,66,1768,64,234750
36401,5.1e-05,172.217.194.0-255,2902,4670,64,234750
36402,5.5e-05,172.31.40.0-255,66,4736,64,234750
36403,6.2e-05,172.217.194.0-255,5738,10474,64,234750
36404,6.5e-05,172.31.40.0-255,66,10540,64,234750
36405,7.2e-05,172.217.194.0-255,5738,16278,64,234750
36406,7.4e-05,172.31.40.0-255,66,16344,64,234750
36407,0.000114,172.31.40.0-255,66,16410,64,234750
36408,0.000122,172.217.194.0-255,6797,23207,64,234750
36409,0.000124,172.31.40.0-255,66,23273,64,234750
36410,0.000129,172.217.194.0-255,2902,26175,64,234750
36411,0.000132,172.31.40.0-255,66,26241,64,234750
36412,0.000171,172.217.194.0-255,5738,31979,64,234750
36413,0.000175,172.31.40.0-255,66,32045,64,234750
36414,0.000179,172.217.194.0-255,4320,36365,64,234750
36415,0.000182,172.31.40.0-255,66,36431,64,234750
36416,0.000212,172.217.194.0-255,3961,40392,64,234750
36417,0.000214,172.31.40.0-255,66,40458,64,234750
36418,0.000251,172.31.40.0-255,66,40524,64,234750
36419,0.000277,172.217.194.0-255,2902,43426,64,234750
36420,0.00028,172.31.40.0-255,66,43492,64,234750
36421,0.000308,172.217.194.0-255,5379,48871,64,234750
36422,0.00031,172.31.40.0-255,66,48937,64,234750
36423,0.000353,172.217.194.0-255,646,49583,64,234750
36424,0.000356,172.31.40.0-255,66,49649,64,234750
36425,0.000797,172.217.194.0-255,1484,51133,64,234750
36426,0.000803,172.31.40.0-255,66,51199,64,234750
36427,0.000809,172.217.194.0-255,2902,54101,64,234750
36428,0.000811,172.31.40.0-255,66,54167,64,234750
36429,0.000817,172.217.194.0-255,4320,58487,64,234750
36430,0.000824,172.31.40.0-255,66,58553,64,234750
36431,0.000836,172.217.194.0-255,1484,60037,64,234750
36432,0.000843,172.217.194.0-255,4320,64357,64,234750
36433,0.000845,172.31.40.0-255,66,64423,64,234750
36434,0.000874,172.217.194.0-255,2543,66966,64,234750
36435,0.000877,172.31.40.0-255,66,67032,64,234750
36436,0.000882,172.217.194.0-255,4320,71352,64,234750
36437,0.000884,172.31.40.0-255,66,71418,64,234750
36438,0.000925,172.31.40.0-255,66,71484,64,234750
36439,0.000929,172.217.194.0-255,1994,73478,64,234750
36440,0.00093,172.31.40.0-255,66,73544,64,234750
36441,0.001184,172.217.194.0-255,1484,75028,64,234750
36442,0.001191,172.217.194.0-255,2902,77930,64,234750
36443,0.001194,172.31.40.0-255,66,77996,64,234750
36444,0.001255,172.217.194.0-255,5738,83734,64,234750
36445,0.001258,172.31.40.0-255,66,83800,64,234750
36446,0.001272,172.31.40.0-255,66,83866,64,234750
36447,0.001289,172.31.40.0-255,66,83932,64,234750
36448,0.001292,172.217.194.0-255,766,84698,64,234750
36449,0.001668,172.217.194.0-255,1484,86182,64,234750
36450,0.001672,172.31.40.0-255,66,86248,64,234750
36451,0.001676,172.217.194.0-255,1484,87732,64,234750
36452,0.001727,172.217.194.0-255,1484,89216,64,234750
36453,0.00173,172.31.40.0-255,66,89282,64,234750
36454,0.001737,172.217.194.0-255,5738,95020,64,234750
36455,0.00174,172.31.40.0-255,66,95086,64,234750
36456,0.001754,172.31.40.0-255,66,95152,64,234750
36457,0.001757,172.217.194.0-255,1484,96636,64,234750
36458,0.001806,172.31.40.0-255,66,96702,64,234750
36459,0.002263,172.217.194.0-255,1484,98186,64,234750
36460,0.00227,172.217.194.0-255,2902,101088,64,234750
36461,0.002274,172.31.40.0-255,66,101154,64,234750
36462,0.002281,172.217.194.0-255,5738,106892,64,234750
36463,0.002283,172.31.40.0-255,66,106958,64,234750
36464,0.00232,172.31.40.0-255,66,107024,64,234750
36465,0.002331,172.217.194.0-255,1484,108508,64,234750
36466,0.002348,172.31.40.0-255,66,108574,64,234750
36467,0.004932,172.217.194.0-255,5738,114312,64,234750
36468,0.004944,172.31.40.0-255,66,114378,64,234750
36469,0.007531,172.217.194.0-255,5738,120116,64,234750
36470,0.007538,172.31.40.0-255,66,120182,64,234750
36471,0.010151,172.217.194.0-255,5738,125920,64,234750
36472,0.010163,172.31.40.0-255,66,125986,64,234750
36473,0.012746,172.217.194.0-255,5738,131724,64,234750
36474,0.012761,172.31.40.0-255,66,131790,64,234750
36475,0.015357,172.217.194.0-255,5738,137528,64,234750
36476,0.015374,172.31.40.0-255,66,137594,64,234750
36477,0.017985,172.217.194.0-255,5738,143332,64,234750
36478,0.018032,172.31.40.0-255,66,143398,64,234750
36479,0.020641,172.217.194.0-255,5738,149136,64,234750
36480,0.020657,172.31.40.0-255,66,149202,64,234750
36481,0.023261,172.217.194.0-255,5738,154940,64,234750
36482,0.023273,172.31.40.0-255,66,155006,64,234750
36483,0.025897,172.217.194.0-255,5738,160744,64,234750
36484,0.025909,172.31.40.0-255,66,160810,64,234750
36485,0.028514,172.217.194.0-255,5738,166548,64,234750
36486,0.028534,172.31.40.0-255,66,166614,64,234750
36487,0.031153,172.217.194.0-255,5738,172352,64,234750
36488,0.031172,172.31.40.0-255,66,172418,64,234750
36489,0.033807,172.217.194.0-255,5738,178156,64,234750
36490,0.033824,172.31.40.0-255,66,178222,64,234750
36491,0.036423,172.217.194.0-255,5738,183960,64,234750
36492,0.036441,172.31.40.0-255,66,184026,64,234750
36493,0.039056,172.217.194.0-255,5738,189764,64,234750
36494,0.039082,172.31.40.0-255,66,189830,64,234750
36495,0.04172,172.217.194.0-255,5738,195568,64,234750
36496,0.04173,172.31.40.0-255,66,195634,64,234750
36497,0.044308,172.217.194.0-255,5738,201372,64,234750
36498,0.044323,172.31.40.0-255,66,201438,64,234750
36499,0.046947,172.217.194.0-255,5738,207176,64,234750
36500,0.046966,172.31.40.0-255,66,207242,64,234750
36501,0.048552,172.31.40.0-255,172,207414,64,234750
36502,0.048583,172.31.40.0-255,1113,208527,64,234750
36503,0.048646,172.31.40.0-255,1514,210041,64,234750
36504,0.048667,172.31.40.0-255,1295,211336,64,234750
36505,0.049585,172.217.194.0-255,5738,217074,64,234750
36506,0.049594,172.31.40.0-255,66,217140,64,234750
36507,0.050111,104.244.42.0-255,66,217206,64,234750
36508,0.050162,104.244.42.0-255,66,217272,64,234750
36509,0.050218,104.244.42.0-255,66,217338,64,234750
36510,0.052184,172.217.194.0-255,5738,223076,64,234750
36511,0.0522,172.31.40.0-255,66,223142,64,234750
36512,0.05485,172.217.194.0-255,5738,228880,64,234750
36513,0.05487,172.31.40.0-255,66,228946,64,234750
36514,0.057463,172.217.194.0-255,5738,234684,64,234750
36515,0.057481,172.31.40.0-255,66,234750,64,234750
36516,0.0,74.125.200.0-255,152,152,64,294765
36517,2e-05,172.31.40.0-255,66,218,64,294765
36518,2.6e-05,74.125.200.0-255,1484,1702,64,294765
36519,3e-05,172.31.40.0-255,66,1768,64,294765
36520,4.5e-05,74.125.200.0-255,2902,4670,64,294765
36521,4.9e-05,172.31.40.0-255,66,4736,64,294765
36522,5.6e-05,74.125.200.0-255,7156,11892,64,294765
36523,6e-05,172.31.40.0-255,66,11958,64,294765
36524,6.5e-05,74.125.200.0-255,3429,15387,64,294765
36525,6.9e-05,172.31.40.0-255,66,15453,64,294765
36526,7.5e-05,74.125.200.0-255,4320,19773,64,294765
36527,7.8e-05,172.31.40.0-255,66,19839,64,294765
36528,0.000131,172.31.40.0-255,66,19905,64,294765
36529,0.000134,74.125.200.0-255,1125,21030,64,294765
36530,0.000136,172.31.40.0-255,66,21096,64,294765
36531,0.000248,74.125.200.0-255,1484,22580,64,294765
36532,0.000251,172.31.40.0-255,66,22646,64,294765
36533,0.000256,74.125.200.0-255,1484,24130,64,294765
36534,0.000258,172.31.40.0-255,66,24196,64,294765
36535,0.000287,74.125.200.0-255,2902,27098,64,294765
36536,0.000291,172.31.40.0-255,66,27164,64,294765
36537,0.000297,74.125.200.0-255,5738,32902,64,294765
36538,0.000299,172.31.40.0-255,66,32968,64,294765
36539,0.000327,74.125.200.0-255,6797,39765,64,294765
36540,0.00033,172.31.40.0-255,66,39831,64,294765
36541,0.000369,74.125.200.0-255,7156,46987,64,294765
36542,0.000372,172.31.40.0-255,66,47053,64,294765
36543,0.000379,74.125.200.0-255,5738,52791,64,294765
36544,0.000381,172.31.40.0-255,66,52857,64,294765
36545,0.000405,74.125.200.0-255,1484,54341,64,294765
36546,0.000407,172.31.40.0-255,66,54407,64,294765
36547,0.000438,74.125.200.0-255,1434,55841,64,294765
36548,0.000442,74.125.200.0-255,110,55951,64,294765
36549,0.000445,74.125.200.0-255,333,56284,64,294765
36550,0.000447,172.31.40.0-255,66,56350,64,294765
36551,0.000669,74.125.200.0-255,1484,57834,64,294765
36552,0.000673,74.125.200.0-255,1484,59318,64,294765
36553,0.000678,172.31.40.0-255,66,59384,64,294765
36554,0.000706,74.125.200.0-255,1484,60868,64,294765
36555,0.000714,74.125.200.0-255,5738,66606,64,294765
36556,0.000717,172.31.40.0-255,66,66672,64,294765
36557,0.00072,74.125.200.0-255,1484,68156,64,294765
36558,0.000751,172.31.40.0-255,66,68222,64,294765
36559,0.000783,74.125.200.0-255,4320,72542,64,294765
36560,0.000787,172.31.40.0-255,66,72608,64,294765
36561,0.000809,74.125.200.0-255,7156,79764,64,294765
36562,0.000812,172.31.40.0-255,66,79830,64,294765
36563,0.000816,74.125.200.0-255,2184,82014,64,294765
36564,0.000818,172.31.40.0-255,66,82080,64,294765
36565,0.000853,172.31.40.0-255,101,82181,64,294765
36566,0.001667,74.125.200.0-255,1484,83665,64,294765
36567,0.001677,74.125.200.0-255,2902,86567,64,294765
36568,0.001681,172.31.40.0-255,66,86633,64,294765
36569,0.001709,74.125.200.0-255,5738,92371,64,294765
36570,0.001712,172.31.40.0-255,66,92437,64,294765
36571,0.001717,74.125.200.0-255,2902,95339,64,294765
36572,0.001718,172.31.40.0-255,66,95405,64,294765
36573,0.001747,74.125.200.0-255,5738,101143,64,294765
36574,0.00175,172.31.40.0-255,66,101209,64,294765
36575,0.001765,172.31.40.0-255,66,101275,64,294765
36576,0.001771,74.125.200.0-255,5020,106295,64,294765
36577,0.001774,172.31.40.0-255,66,106361,64,294765
36578,0.001892,74.125.200.0-255,1484,107845,64,294765
36579,0.0019,74.125.200.0-255,2902,110747,64,294765
36580,0.001903,172.31.40.0-255,66,110813,64,294765
36581,0.001932,74.125.200.0-255,5738,116551,64,294765
36582,0.001935,172.31.40.0-255,66,116617,64,294765
36583,0.001942,74.125.200.0-255,7156,123773,64,294765
36584,0.001944,172.31.40.0-255,66,123839,64,294765
36585,0.001967,74.125.200.0-255,1484,125323,64,294765
36586,0.002,172.31.40.0-255,66,125389,64,294765
36587,0.002004,74.125.200.0-255,2184,127573,64,294765
36588,0.002006,172.31.40.0-255,66,127639,64,294765
36589,0.0028,74.125.200.0-255,66,127705,64,294765
36590,0.003972,74.125.200.0-255,2902,130607,64,294765
36591,0.003977,172.31.40.0-255,66,130673,64,294765
36592,0.004024,74.125.200.0-255,2902,133575,64,294765
36593,0.004026,172.31.40.0-255,66,133641,64,294765
36594,0.005958,74.125.200.0-255,2902,136543,64,294765
36595,0.005964,172.31.40.0-255,66,136609,64,294765
36596,0.006004,74.125.200.0-255,2902,139511,64,294765
36597,0.006007,172.31.40.0-255,66,139577,64,294765
36598,0.007947,74.125.200.0-255,2902,142479,64,294765
36599,0.007951,172.31.40.0-255,66,142545,64,294765
36600,0.007976,74.125.200.0-255,2902,145447,64,294765
36601,0.007979,172.31.40.0-255,66,145513,64,294765
36602,0.009928,74.125.200.0-255,2902,148415,64,294765
36603,0.009935,172.31.40.0-255,66,148481,64,294765
36604,0.009967,74.125.200.0-255,2902,151383,64,294765
36605,0.009969,172.31.40.0-255,66,151449,64,294765
36606,0.011911,74.125.200.0-255,2902,154351,64,294765
36607,0.011918,172.31.40.0-255,66,154417,64,294765
36608,0.011948,74.125.200.0-255,2902,157319,64,294765
36609,0.011951,172.31.40.0-255,66,157385,64,294765
36610,0.013902,74.125.200.0-255,2902,160287,64,294765
36611,0.013909,172.31.40.0-255,66,160353,64,294765
36612,0.01394,74.125.200.0-255,2902,163255,64,294765
36613,0.013944,172.31.40.0-255,66,163321,64,294765
36614,0.015803,172.31.40.0-255,105,163426,64,294765
36615,0.015896,74.125.200.0-255,2902,166328,64,294765
36616,0.015901,172.31.40.0-255,66,166394,64,294765
36617,0.015931,74.125.200.0-255,2902,169296,64,294765
36618,0.015934,172.31.40.0-255,66,169362,64,294765
36619,0.015987,172.31.40.0-255,90,169452,64,294765
36620,0.015996,172.31.40.0-255,66,169518,64,294765
36621,0.017888,74.125.200.0-255,2902,172420,64,294765
36622,0.017896,172.31.40.0-255,66,172486,64,294765
36623,0.017927,74.125.200.0-255,2902,175388,64,294765
36624,0.017929,172.31.40.0-255,66,175454,64,294765
36625,0.018312,74.125.68.0-255,66,175520,64,294765
36626,0.018332,74.125.68.0-255,66,175586,64,294765
36627,0.018337,172.31.40.0-255,66,175652,64,294765
36628,0.01989,74.125.200.0-255,2902,178554,64,294765
36629,0.019897,172.31.40.0-255,66,178620,64,294765
36630,0.019925,74.125.200.0-255,2902,181522,64,294765
36631,0.019928,172.31.40.0-255,66,181588,64,294765
36632,0.021897,74.125.200.0-255,2902,184490,64,294765
36633,0.021904,172.31.40.0-255,66,184556,64,294765
36634,0.021934,74.125.200.0-255,2902,187458,64,294765
36635,0.021937,172.31.40.0-255,66,187524,64,294765
36636,0.023889,74.125.200.0-255,2902,190426,64,294765
36637,0.023895,172.31.40.0-255,66,190492,64,294765
36638,0.023923,74.125.200.0-255,2902,193394,64,294765
36639,0.023927,172.31.40.0-255,66,193460,64,294765
36640,0.025351,172.31.40.0-255,172,193632,64,294765
36641,0.025383,172.31.40.0-255,1108,194740,64,294765
36642,0.025443,172.31.40.0-255,1514,196254,64,294765
36643,0.025445,172.31.40.0-255,337,196591,64,294765
36644,0.025876,74.125.200.0-255,2902,199493,64,294765
36645,0.025883,172.31.40.0-255,66,199559,64,294765
36646,0.025916,74.125.200.0-255,2902,202461,64,294765
36647,0.02592,172.31.40.0-255,66,202527,64,294765
36648,0.026952,104.244.42.0-255,66,202593,64,294765
36649,0.026981,104.244.42.0-255,66,202659,64,294765
36650,0.027024,104.244.42.0-255,66,202725,64,294765
36651,0.027879,74.125.200.0-255,2902,205627,64,294765
36652,0.027885,172.31.40.0-255,66,205693,64,294765
36653,0.027915,74.125.200.0-255,2902,208595,64,294765
36654,0.027918,172.31.40.0-255,66,208661,64,294765
36655,0.029863,74.125.200.0-255,2902,211563,64,294765
36656,0.029878,172.31.40.0-255,66,211629,64,294765
36657,0.029913,74.125.200.0-255,2902,214531,64,294765
36658,0.029918,172.31.40.0-255,66,214597,64,294765
36659,0.031879,74.125.200.0-255,2902,217499,64,294765
36660,0.031893,172.31.40.0-255,66,217565,64,294765
36661,0.031925,74.125.200.0-255,2902,220467,64,294765
36662,0.031928,172.31.40.0-255,66,220533,64,294765
36663,0.033886,74.125.200.0-255,2902,223435,64,294765
36664,0.0339,172.31.40.0-255,66,223501,64,294765
36665,0.03393,74.125.200.0-255,2902,226403,64,294765
36666,0.033934,172.31.40.0-255,66,226469,64,294765
36667,0.035908,74.125.200.0-255,4320,230789,64,294765
36668,0.035925,172.31.40.0-255,66,230855,64,294765
36669,0.035957,74.125.200.0-255,1484,232339,64,294765
36670,0.037942,74.125.200.0-255,4320,236659,64,294765
36671,0.037957,172.31.40.0-255,66,236725,64,294765
36672,0.039974,74.125.200.0-255,5738,242463,64,294765
36673,0.039988,172.31.40.0-255,66,242529,64,294765
36674,0.041993,74.125.200.0-255,5738,248267,64,294765
36675,0.042008,172.31.40.0-255,66,248333,64,294765
36676,0.044028,74.125.200.0-255,5738,254071,64,294765
36677,0.044045,172.31.40.0-255,66,254137,64,294765
36678,0.04605,74.125.200.0-255,5738,259875,64,294765
36679,0.046067,172.31.40.0-255,66,259941,64,294765
36680,0.048073,74.125.200.0-255,5738,265679,64,294765
36681,0.048089,172.31.40.0-255,66,265745,64,294765
36682,0.050085,74.125.200.0-255,5738,271483,64,294765
36683,0.0501,172.31.40.0-255,66,271549,64,294765
36684,0.052085,74.125.200.0-255,5738,277287,64,294765
36685,0.052095,172.31.40.0-255,66,277353,64,294765
36686,0.054112,74.125.200.0-255,5738,283091,64,294765
36687,0.054128,172.31.40.0-255,66,283157,64,294765
36688,0.056141,74.125.200.0-255,5738,288895,64,294765
36689,0.056156,172.31.40.0-255,66,288961,64,294765
36690,0.058158,74.125.200.0-255,5738,294699,64,294765
36691,0.058173,172.31.40.0-255,66,294765,64,294765
36692,0.0,74.125.24.0-255,146,146,64,265048
36693,1.4e-05,172.31.40.0-255,66,212,64,265048
36694,2e-05,74.125.24.0-255,1484,1696,64,265048
36695,2.4e-05,172.31.40.0-255,66,1762,64,265048
36696,3e-05,74.125.24.0-255,2902,4664,64,265048
36697,3.3e-05,172.31.40.0-255,66,4730,64,265048
36698,3.9e-05,74.125.24.0-255,4320,9050,64,265048
36699,4.2e-05,172.31.40.0-255,66,9116,64,265048
36700,6.7e-05,74.125.24.0-255,2902,12018,64,265048
36701,6.9e-05,172.31.40.0-255,66,12084,64,265048
36702,8.1e-05,172.31.40.0-255,66,12150,64,265048
36703,0.000114,74.125.24.0-255,2902,15052,64,265048
36704,0.000116,172.31.40.0-255,66,15118,64,265048
36705,0.000129,74.125.24.0-255,5379,20497,64,265048
36706,0.000131,172.31.40.0-255,66,20563,64,265048
36707,0.000165,74.125.24.0-255,4320,24883,64,265048
36708,0.000168,172.31.40.0-255,66,24949,64,265048
36709,0.000189,74.125.24.0-255,5738,30687,64,265048
36710,0.000191,172.31.40.0-255,66,30753,64,265048
36711,0.0002,172.31.40.0-255,66,30819,64,265048
36712,0.000214,74.125.24.0-255,2902,33721,64,265048
36713,0.000216,172.31.40.0-255,66,33787,64,265048
36714,0.000239,74.125.24.0-255,4320,38107,64,265048
36715,0.000241,172.31.40.0-255,66,38173,64,265048
36716,0.000263,172.31.40.0-255,66,38239,64,265048
36717,0.000265,74.125.24.0-255,401,38640,64,265048
36718,0.000267,172.31.40.0-255,66,38706,64,265048
36719,0.000285,74.125.24.0-255,374,39080,64,265048
36720,0.000287,172.31.40.0-255,66,39146,64,265048
36721,0.000645,74.125.24.0-255,1484,40630,64,265048
36722,0.000661,74.125.24.0-255,2902,43532,64,265048
36723,0.000664,172.31.40.0-255,66,43598,64,265048
36724,0.000669,74.125.24.0-255,2902,46500,64,265048
36725,0.000671,172.31.40.0-255,66,46566,64,265048
36726,0.000682,74.125.24.0-255,1484,48050,64,265048
36727,0.000708,74.125.24.0-255,5738,53788,64,265048
36728,0.000711,172.31.40.0-255,66,53854,64,265048
36729,0.000715,74.125.24.0-255,2902,56756,64,265048
36730,0.000717,172.31.40.0-255,66,56822,64,265048
36731,0.000737,172.31.40.0-255,66,56888,64,265048
36732,0.000761,74.125.24.0-255,2902,59790,64,265048
36733,0.000764,172.31.40.0-255,66,59856,64,265048
36734,0.000768,74.125.24.0-255,3602,63458,64,265048
36735,0.000771,172.31.40.0-255,66,63524,64,265048
36736,0.000951,74.125.24.0-255,1484,65008,64,265048
36737,0.000964,74.125.24.0-255,2902,67910,64,265048
36738,0.000968,172.31.40.0-255,66,67976,64,265048
36739,0.00099,74.125.24.0-255,5738,73714,64,265048
36740,0.000992,172.31.40.0-255,66,73780,64,265048
36741,0.000996,74.125.24.0-255,2902,76682,64,265048
36742,0.000998,172.31.40.0-255,66,76748,64,265048
36743,0.001024,172.31.40.0-255,66,76814,64,265048
36744,0.001028,74.125.24.0-255,4320,81134,64,265048
36745,0.00103,172.31.40.0-255,66,81200,64,265048
36746,0.001052,74.125.24.0-255,6438,87638,64,265048
36747,0.001055,172.31.40.0-255,66,87704,64,265048
36748,0.00113,74.125.24.0-255,1484,89188,64,265048
36749,0.001134,74.125.24.0-255,1484,90672,64,265048
36750,0.001136,172.31.40.0-255,66,90738,64,265048
36751,0.001154,74.125.24.0-255,1484,92222,64,265048
36752,0.00116,74.125.24.0-255,5738,97960,64,265048
36753,0.001162,172.31.40.0-255,66,98026,64,265048
36754,0.001199,172.31.40.0-255,66,98092,64,265048
36755,0.001201,74.125.24.0-255,1484,99576,64,265048
36756,0.001232,74.125.24.0-255,2902,102478,64,265048
36757,0.001235,172.31.40.0-255,66,102544,64,265048
36758,0.001252,74.125.24.0-255,6438,108982,64,265048
36759,0.001256,172.31.40.0-255,66,109048,64,265048
36760,0.001294,74.125.24.0-255,1484,110532,64,265048
36761,0.001315,74.125.24.0-255,2902,113434,64,265048
36762,0.001319,172.31.40.0-255,66,113500,64,265048
36763,0.001326,74.125.24.0-255,5738,119238,64,265048
36764,0.001329,172.31.40.0-255,66,119304,64,265048
36765,0.001331,74.125.24.0-255,1484,120788,64,265048
36766,0.001357,74.125.24.0-255,4320,125108,64,265048
36767,0.00136,172.31.40.0-255,66,125174,64,265048
36768,0.001367,74.125.24.0-255,7156,132330,64,265048
36769,0.00137,172.31.40.0-255,66,132396,64,265048
36770,0.001384,74.125.24.0-255,1484,133880,64,265048
36771,0.001422,172.31.40.0-255,66,133946,64,265048
36772,0.001469,74.125.24.0-255,1484,135430,64,265048
36773,0.001473,74.125.24.0-255,1484,136914,64,265048
36774,0.001475,172.31.40.0-255,66,136980,64,265048
36775,0.001495,74.125.24.0-255,1484,138464,64,265048
36776,0.0015,74.125.24.0-255,5738,144202,64,265048
36777,0.001504,172.31.40.0-255,66,144268,64,265048
36778,0.001518,74.125.24.0-255,7156,151424,64,265048
36779,0.001522,172.31.40.0-255,66,151490,64,265048
36780,0.001542,74.125.24.0-255,5738,157228,64,265048
36781,0.001562,172.31.40.0-255,66,157294,64,265048
36782,0.001573,74.125.24.0-255,766,158060,64,265048
36783,0.001617,74.125.24.0-255,1484,159544,64,265048
36784,0.001656,172.31.40.0-255,66,159610,64,265048
36785,0.001679,74.125.24.0-255,4320,163930,64,265048
36786,0.00169,74.125.24.0-255,1484,165414,64,265048
36787,0.001719,172.31.40.0-255,66,165480,64,265048
36788,0.001737,74.125.24.0-255,1484,166964,64,265048
36789,0.001761,74.125.24.0-255,6438,173402,64,265048
36790,0.001767,172.31.40.0-255,66,173468,64,265048
36791,0.001876,74.125.24.0-255,1484,174952,64,265048
36792,0.001883,74.125.24.0-255,2902,177854,64,265048
36793,0.0019,74.125.24.0-255,2902,180756,64,265048
36794,0.001918,74.125.24.0-255,2902,183658,64,265048
36795,0.001924,74.125.24.0-255,5738,189396,64,265048
36796,0.001947,74.125.24.0-255,7156,196552,64,265048
36797,0.002053,74.125.24.0-255,1484,198036,64,265048
36798,0.002068,74.125.24.0-255,1484,199520,64,265048
36799,0.002094,74.125.24.0-255,1484,201004,64,265048
36800,0.002101,74.125.24.0-255,5738,206742,64,265048
36801,0.002104,74.125.24.0-255,1484,208226,64,265048
36802,0.002108,74.125.24.0-255,2902,211128,64,265048
36803,0.002133,74.125.24.0-255,5738,216866,64,265048
36804,0.002175,74.125.24.0-255,3602,220468,64,265048
36805,0.002177,74.125.24.0-255,1484,221952,64,265048
36806,0.002191,74.125.24.0-255,1484,223436,64,265048
36807,0.002194,74.125.24.0-255,1484,224920,64,265048
36808,0.002227,74.125.24.0-255,2902,227822,64,265048
36809,0.002229,74.125.24.0-255,1484,229306,64,265048
36810,0.002249,74.125.24.0-255,3602,232908,64,265048
36811,0.002267,74.125.24.0-255,2902,235810,64,265048
36812,0.002289,74.125.24.0-255,1484,237294,64,265048
36813,0.002302,74.125.24.0-255,1484,238778,64,265048
36814,0.002305,74.125.24.0-255,1484,240262,64,265048
36815,0.002326,74.125.24.0-255,7156,247418,64,265048
36816,0.002348,74.125.24.0-255,5738,253156,64,265048
36817,0.002355,74.125.24.0-255,5020,258176,64,265048
36818,0.002399,74.125.24.0-255,3206,261382,64,265048
36819,0.002451,74.125.24.0-255,105,261487,64,265048
36820,0.005435,172.31.40.0-255,66,261553,64,265048
36821,0.007947,172.31.40.0-255,105,261658,64,265048
36822,0.009984,74.125.24.0-255,66,261724,64,265048
36823,0.052391,172.31.40.0-255,167,261891,64,265048
36824,0.052426,172.31.40.0-255,1108,262999,64,265048
36825,0.052487,172.31.40.0-255,1514,264513,64,265048
36826,0.052489,172.31.40.0-255,337,264850,64,265048
36827,0.053988,104.244.42.0-255,66,264916,64,265048
36828,0.054024,104.244.42.0-255,66,264982,64,265048
36829,0.054091,104.244.42.0-255,66,265048,64,265048
36830,0.0,74.125.200.0-255,153,153,64,269056
36831,2.2e-05,172.31.40.0-255,66,219,64,269056
36832,2.8e-05,74.125.200.0-255,1484,1703,64,269056
36833,3.3e-05,172.31.40.0-255,66,1769,64,269056
36834,3.9e-05,74.125.200.0-255,2902,4671,64,269056
36835,4.2e-05,172.31.40.0-255,66,4737,64,269056
36836,5e-05,74.125.200.0-255,7156,11893,64,269056
36837,5.4e-05,172.31.40.0-255,66,11959,64,269056
36838,8.1e-05,74.125.200.0-255,1938,13897,64,269056
36839,8.4e-05,172.31.40.0-255,66,13963,64,269056
36840,9.7e-05,74.125.200.0-255,1484,15447,64,269056
36841,0.0001,172.31.40.0-255,66,15513,64,269056
36842,0.000126,74.125.200.0-255,2902,18415,64,269056
36843,0.000129,172.31.40.0-255,66,18481,64,269056
36844,0.000135,74.125.200.0-255,5738,24219,64,269056
36845,0.000137,172.31.40.0-255,66,24285,64,269056
36846,0.000142,74.125.200.0-255,2902,27187,64,269056
36847,0.000144,172.31.40.0-255,66,27253,64,269056
36848,0.000168,74.125.200.0-255,3961,31214,64,269056
36849,0.00017,172.31.40.0-255,66,31280,64,269056
36850,0.000413,74.125.200.0-255,1484,32764,64,269056
36851,0.000419,172.31.40.0-255,66,32830,64,269056
36852,0.00044,74.125.200.0-255,1484,34314,64,269056
36853,0.000443,172.31.40.0-255,66,34380,64,269056
36854,0.00046,74.125.200.0-255,1484,35864,64,269056
36855,0.000462,172.31.40.0-255,66,35930,64,269056
36856,0.000465,74.125.200.0-255,1484,37414,64,269056
36857,0.000468,172.31.40.0-255,66,37480,64,269056
36858,0.000472,74.125.200.0-255,2902,40382,64,269056
36859,0.000474,172.31.40.0-255,66,40448,64,269056
36860,0.000479,74.125.200.0-255,2902,43350,64,269056
36861,0.000482,172.31.40.0-255,66,43416,64,269056
36862,0.000516,74.125.200.0-255,2902,46318,64,269056
36863,0.00052,172.31.40.0-255,66,46384,64,269056
36864,0.000525,74.125.200.0-255,3961,50345,64,269056
36865,0.000527,172.31.40.0-255,66,50411,64,269056
36866,0.000532,74.125.200.0-255,4320,54731,64,269056
36867,0.000535,172.31.40.0-255,66,54797,64,269056
36868,0.000564,172.31.40.0-255,66,54863,64,269056
36869,0.000567,74.125.200.0-255,1125,55988,64,269056
36870,0.000603,74.125.200.0-255,414,56402,64,269056
36871,0.000639,74.125.200.0-255,329,56731,64,269056
36872,0.000642,172.31.40.0-255,66,56797,64,269056
36873,0.000995,74.125.200.0-255,1484,58281,64,269056
36874,0.001001,74.125.200.0-255,2902,61183,64,269056
36875,0.001004,172.31.40.0-255,66,61249,64,269056
36876,0.00103,74.125.200.0-255,4320,65569,64,269056
36877,0.001032,172.31.40.0-255,66,65635,64,269056
36878,0.001061,172.31.40.0-255,66,65701,64,269056
36879,0.001067,74.125.200.0-255,4320,70021,64,269056
36880,0.001069,172.31.40.0-255,66,70087,64,269056
36881,0.001096,74.125.200.0-255,4320,74407,64,269056
36882,0.001099,172.31.40.0-255,66,74473,64,269056
36883,0.001126,74.125.200.0-255,4320,78793,64,269056
36884,0.001129,172.31.40.0-255,66,78859,64,269056
36885,0.001155,74.125.200.0-255,3602,82461,64,269056
36886,0.001159,172.31.40.0-255,66,82527,64,269056
36887,0.00133,74.125.200.0-255,1484,84011,64,269056
36888,0.001345,74.125.200.0-255,2902,86913,64,269056
36889,0.001348,172.31.40.0-255,66,86979,64,269056
36890,0.001367,74.125.200.0-255,4320,91299,64,269056
36891,0.00137,172.31.40.0-255,66,91365,64,269056
36892,0.001393,74.125.200.0-255,1484,92849,64,269056
36893,0.001416,74.125.200.0-255,4320,97169,64,269056
36894,0.001419,172.31.40.0-255,66,97235,64,269056
36895,0.001423,74.125.200.0-255,1484,98719,64,269056
36896,0.001449,74.125.200.0-255,4320,103039,64,269056
36897,0.001452,172.31.40.0-255,66,103105,64,269056
36898,0.001459,74.125.200.0-255,7156,110261,64,269056
36899,0.001462,172.31.40.0-255,66,110327,64,269056
36900,0.001491,74.125.200.0-255,2902,113229,64,269056
36901,0.001494,172.31.40.0-255,66,113295,64,269056
36902,0.001507,74.125.200.0-255,3602,116897,64,269056
36903,0.00151,172.31.40.0-255,66,116963,64,269056
36904,0.003755,74.125.200.0-255,1484,118447,64,269056
36905,0.003781,74.125.200.0-255,4320,122767,64,269056
36906,0.003785,172.31.40.0-255,66,122833,64,269056
36907,0.006053,74.125.200.0-255,5738,128571,64,269056
36908,0.006057,172.31.40.0-255,66,128637,64,269056
36909,0.008334,74.125.200.0-255,5738,134375,64,269056
36910,0.008341,172.31.40.0-255,66,134441,64,269056
36911,0.010624,74.125.200.0-255,4320,138761,64,269056
36912,0.010632,172.31.40.0-255,66,138827,64,269056
36913,0.010654,74.125.200.0-255,1484,140311,64,269056
36914,0.012922,74.125.200.0-255,4320,144631,64,269056
36915,0.012934,172.31.40.0-255,66,144697,64,269056
36916,0.01521,74.125.200.0-255,5738,150435,64,269056
36917,0.015216,172.31.40.0-255,66,150501,64,269056
36918,0.017495,74.125.200.0-255,5738,156239,64,269056
36919,0.017504,172.31.40.0-255,66,156305,64,269056
36920,0.019785,74.125.200.0-255,5738,162043,64,269056
36921,0.019792,172.31.40.0-255,66,162109,64,269056
36922,0.022071,74.125.200.0-255,5738,167847,64,269056
36923,0.022081,172.31.40.0-255,66,167913,64,269056
36924,0.024364,74.125.200.0-255,5738,173651,64,269056
36925,0.02437,172.31.40.0-255,66,173717,64,269056
36926,0.025853,172.31.40.0-255,172,173889,64,269056
36927,0.025885,172.31.40.0-255,1111,175000,64,269056
36928,0.02595,172.31.40.0-255,1514,176514,64,269056
36929,0.025952,172.31.40.0-255,1514,178028,64,269056
36930,0.025959,172.31.40.0-255,1514,179542,64,269056
36931,0.02596,172.31.40.0-255,1514,181056,64,269056
36932,0.026082,172.31.40.0-255,478,181534,64,269056
36933,0.026641,74.125.200.0-255,2902,184436,64,269056
36934,0.026648,172.31.40.0-255,66,184502,64,269056
36935,0.026667,74.125.200.0-255,2902,187404,64,269056
36936,0.02667,172.31.40.0-255,66,187470,64,269056
36937,0.027451,104.244.42.0-255,66,187536,64,269056
36938,0.027475,104.244.42.0-255,66,187602,64,269056
36939,0.027611,104.244.42.0-255,66,187668,64,269056
36940,0.027623,104.244.42.0-255,66,187734,64,269056
36941,0.02892,74.125.200.0-255,1484,189218,64,269056
36942,0.028946,74.125.200.0-255,4320,193538,64,269056
36943,0.028951,172.31.40.0-255,66,193604,64,269056
36944,0.031243,74.125.200.0-255,5738,199342,64,269056
36945,0.031249,172.31.40.0-255,66,199408,64,269056
36946,0.033528,74.125.200.0-255,5738,205146,64,269056
36947,0.033534,172.31.40.0-255,66,205212,64,269056
36948,0.035808,74.125.200.0-255,5738,210950,64,269056
36949,0.035813,172.31.40.0-255,66,211016,64,269056
36950,0.038101,74.125.200.0-255,5738,216754,64,269056
36951,0.038107,172.31.40.0-255,66,216820,64,269056
36952,0.040388,74.125.200.0-255,5738,222558,64,269056
36953,0.040395,172.31.40.0-255,66,222624,64,269056
36954,0.042683,74.125.200.0-255,5738,228362,64,269056
36955,0.04269,172.31.40.0-255,66,228428,64,269056
36956,0.044981,74.125.200.0-255,5738,234166,64,269056
36957,0.044987,172.31.40.0-255,66,234232,64,269056
36958,0.047298,74.125.200.0-255,5738,239970,64,269056
36959,0.047316,172.31.40.0-255,66,240036,64,269056
36960,0.049623,74.125.200.0-255,5738,245774,64,269056
36961,0.049638,172.31.40.0-255,66,245840,64,269056
36962,0.051934,74.125.200.0-255,5738,251578,64,269056
36963,0.05195,172.31.40.0-255,66,251644,64,269056
36964,0.054239,74.125.200.0-255,5738,257382,64,269056
36965,0.054248,172.31.40.0-255,66,257448,64,269056
36966,0.056548,74.125.200.0-255,5738,263186,64,269056
36967,0.056564,172.31.40.0-255,66,263252,64,269056
36968,0.058866,74.125.200.0-255,5738,268990,64,269056
36969,0.058883,172.31.40.0-255,66,269056,64,269056
36970,0.0,74.125.200.0-255,153,153,64,203419
36971,2.3e-05,172.31.40.0-255,66,219,64,203419
36972,3.1e-05,74.125.200.0-255,1484,1703,64,203419
36973,3.5e-05,172.31.40.0-255,66,1769,64,203419
36974,4.1e-05,74.125.200.0-255,2902,4671,64,203419
36975,4.3e-05,172.31.40.0-255,66,4737,64,203419
36976,4.9e-05,74.125.200.0-255,4320,9057,64,203419
36977,5.3e-05,172.31.40.0-255,66,9123,64,203419
36978,0.000127,74.125.200.0-255,1484,10607,64,203419
36979,0.00013,172.31.40.0-255,66,10673,64,203419
36980,0.000154,74.125.200.0-255,3485,14158,64,203419
36981,0.000157,172.31.40.0-255,66,14224,64,203419
36982,0.000163,74.125.200.0-255,5738,19962,64,203419
36983,0.000166,172.31.40.0-255,66,20028,64,203419
36984,0.000173,74.125.200.0-255,7156,27184,64,203419
36985,0.000175,172.31.40.0-255,66,27250,64,203419
36986,0.000193,74.125.200.0-255,3961,31211,64,203419
36987,0.000195,172.31.40.0-255,66,31277,64,203419
36988,0.000211,74.125.200.0-255,1484,32761,64,203419
36989,0.000213,172.31.40.0-255,66,32827,64,203419
36990,0.00023,74.125.200.0-255,2902,35729,64,203419
36991,0.000233,172.31.40.0-255,66,35795,64,203419
36992,0.000239,74.125.200.0-255,5738,41533,64,203419
36993,0.000241,172.31.40.0-255,66,41599,64,203419
36994,0.000246,74.125.200.0-255,4320,45919,64,203419
36995,0.000249,172.31.40.0-255,66,45985,64,203419
36996,0.000267,74.125.200.0-255,2543,48528,64,203419
36997,0.000269,172.31.40.0-255,66,48594,64,203419
36998,0.000327,74.125.200.0-255,1484,50078,64,203419
36999,0.00033,172.31.40.0-255,66,50144,64,203419
37000,0.000333,74.125.200.0-255,1484,51628,64,203419
37001,0.000335,172.31.40.0-255,66,51694,64,203419
37002,0.000349,74.125.200.0-255,1484,53178,64,203419
37003,0.000354,74.125.200.0-255,2902,56080,64,203419
37004,0.000357,172.31.40.0-255,66,56146,64,203419
37005,0.000371,74.125.200.0-255,1484,57630,64,203419
37006,0.000378,74.125.200.0-255,4320,61950,64,203419
37007,0.000381,172.31.40.0-255,66,62016,64,203419
37008,0.000402,74.125.200.0-255,4256,66272,64,203419
37009,0.000405,172.31.40.0-255,66,66338,64,203419
37010,0.001181,74.125.200.0-255,128,66466,64,203419
37011,0.001189,74.125.200.0-255,350,66816,64,203419
37012,0.002959,74.125.200.0-255,2902,69718,64,203419
37013,0.002966,172.31.40.0-255,66,69784,64,203419
37014,0.005532,74.125.200.0-255,4320,74104,64,203419
37015,0.005535,172.31.40.0-255,66,74170,64,203419
37016,0.00555,74.125.200.0-255,1484,75654,64,203419
37017,0.008103,74.125.200.0-255,4320,79974,64,203419
37018,0.008111,172.31.40.0-255,66,80040,64,203419
37019,0.010698,74.125.200.0-255,5738,85778,64,203419
37020,0.010706,172.31.40.0-255,66,85844,64,203419
37021,0.013281,74.125.200.0-255,5738,91582,64,203419
37022,0.013292,172.31.40.0-255,66,91648,64,203419
37023,0.015858,74.125.200.0-255,5738,97386,64,203419
37024,0.015866,172.31.40.0-255,66,97452,64,203419
37025,0.018447,74.125.200.0-255,5738,103190,64,203419
37026,0.018456,172.31.40.0-255,66,103256,64,203419
37027,0.021033,74.125.200.0-255,5738,108994,64,203419
37028,0.021042,172.31.40.0-255,66,109060,64,203419
37029,0.023615,74.125.200.0-255,5738,114798,64,203419
37030,0.023624,172.31.40.0-255,66,114864,64,203419
37031,0.024543,172.31.40.0-255,172,115036,64,203419
37032,0.024575,172.31.40.0-255,1112,116148,64,203419
37033,0.024638,172.31.40.0-255,1514,117662,64,203419
37034,0.02464,172.31.40.0-255,1514,119176,64,203419
37035,0.024641,172.31.40.0-255,1514,120690,64,203419
37036,0.024668,172.31.40.0-255,1077,121767,64,203419
37037,0.026107,104.244.42.0-255,66,121833,64,203419
37038,0.026149,104.244.42.0-255,66,121899,64,203419
37039,0.026171,74.125.200.0-255,1484,123383,64,203419
37040,0.026189,104.244.42.0-255,66,123449,64,203419
37041,0.026193,104.244.42.0-255,66,123515,64,203419
37042,0.026199,74.125.200.0-255,4320,127835,64,203419
37043,0.026205,172.31.40.0-255,66,127901,64,203419
37044,0.028771,74.125.200.0-255,5738,133639,64,203419
37045,0.028778,172.31.40.0-255,66,133705,64,203419
37046,0.031337,74.125.200.0-255,5738,139443,64,203419
37047,0.031342,172.31.40.0-255,66,139509,64,203419
37048,0.033903,74.125.200.0-255,1484,140993,64,203419
37049,0.033922,74.125.200.0-255,4320,145313,64,203419
37050,0.033927,172.31.40.0-255,66,145379,64,203419
37051,0.036486,74.125.200.0-255,5738,151117,64,203419
37052,0.036491,172.31.40.0-255,66,151183,64,203419
37053,0.039063,74.125.200.0-255,5738,156921,64,203419
37054,0.03907,172.31.40.0-255,66,156987,64,203419
37055,0.041639,74.125.200.0-255,5738,162725,64,203419
37056,0.041644,172.31.40.0-255,66,162791,64,203419
37057,0.044213,74.125.200.0-255,5738,168529,64,203419
37058,0.04422,172.31.40.0-255,66,168595,64,203419
37059,0.046794,74.125.200.0-255,5738,174333,64,203419
37060,0.0468,172.31.40.0-255,66,174399,64,203419
37061,0.049375,74.125.200.0-255,5738,180137,64,203419
37062,0.049381,172.31.40.0-255,66,180203,64,203419
37063,0.051948,74.125.200.0-255,5738,185941,64,203419
37064,0.051955,172.31.40.0-255,66,186007,64,203419
37065,0.054515,74.125.200.0-255,5738,191745,64,203419
37066,0.05452,172.31.40.0-255,66,191811,64,203419
37067,0.057122,74.125.200.0-255,5738,197549,64,203419
37068,0.057128,172.31.40.0-255,66,197615,64,203419
37069,0.059689,74.125.200.0-255,5738,203353,64,203419
37070,0.059696,172.31.40.0-255,66,203419,64,203419
37071,0.0,18.236.49.0-255,66,66,64,5144
37072,0.001893,18.236.49.0-255,3551,3617,64,5144
37073,0.001909,172.31.40.0-255,66,3683,64,5144
37074,0.005631,172.31.40.0-255,192,3875,64,5144
37075,0.011546,172.31.40.0-255,1269,5144,64,5144
37076,0.0,74.125.24.0-255,146,146,64,294885
37077,1.6e-05,172.31.40.0-255,66,212,64,294885
37078,2.2e-05,74.125.24.0-255,1484,1696,64,294885
37079,2.6e-05,172.31.40.0-255,66,1762,64,294885
37080,3.2e-05,74.125.24.0-255,2902,4664,64,294885
37081,3.4e-05,172.31.40.0-255,66,4730,64,294885
37082,3.8e-05,74.125.24.0-255,2902,7632,64,294885
37083,4.7e-05,172.31.40.0-255,66,7698,64,294885
37084,5.2e-05,74.125.24.0-255,4320,12018,64,294885
37085,5.5e-05,172.31.40.0-255,66,12084,64,294885
37086,0.000106,172.31.40.0-255,66,12150,64,294885
37087,0.00011,74.125.24.0-255,4320,16470,64,294885
37088,0.000113,172.31.40.0-255,66,16536,64,294885
37089,0.00014,74.125.24.0-255,5379,21915,64,294885
37090,0.000143,172.31.40.0-255,66,21981,64,294885
37091,0.0002,74.125.24.0-255,1484,23465,64,294885
37092,0.000202,172.31.40.0-255,66,23531,64,294885
37093,0.000206,74.125.24.0-255,1484,25015,64,294885
37094,0.000208,172.31.40.0-255,66,25081,64,294885
37095,0.000233,74.125.24.0-255,1484,26565,64,294885
37096,0.000236,172.31.40.0-255,66,26631,64,294885
37097,0.000242,74.125.24.0-255,5738,32369,64,294885
37098,0.000244,172.31.40.0-255,66,32435,64,294885
37099,0.000253,74.125.24.0-255,5738,38173,64,294885
37100,0.000255,172.31.40.0-255,66,38239,64,294885
37101,0.000299,172.31.40.0-255,66,38305,64,294885
37102,0.000305,74.125.24.0-255,4237,42542,64,294885
37103,0.000307,172.31.40.0-255,66,42608,64,294885
37104,0.000993,74.125.24.0-255,131,42739,64,294885
37105,0.000999,172.31.40.0-255,66,42805,64,294885
37106,0.001004,74.125.24.0-255,346,43151,64,294885
37107,0.001309,172.31.40.0-255,66,43217,64,294885
37108,0.001337,74.125.24.0-255,1484,44701,64,294885
37109,0.001341,74.125.24.0-255,1484,46185,64,294885
37110,0.001352,74.125.24.0-255,1484,47669,64,294885
37111,0.001357,172.31.40.0-255,66,47735,64,294885
37112,0.00139,74.125.24.0-255,5738,53473,64,294885
37113,0.001413,74.125.24.0-255,5738,59211,64,294885
37114,0.001419,172.31.40.0-255,66,59277,64,294885
37115,0.00143,74.125.24.0-255,4320,63597,64,294885
37116,0.001435,172.31.40.0-255,66,63663,64,294885
37117,0.00148,74.125.24.0-255,5020,68683,64,294885
37118,0.001494,172.31.40.0-255,66,68749,64,294885
37119,0.001512,74.125.24.0-255,5738,74487,64,294885
37120,0.001521,74.125.24.0-255,2902,77389,64,294885
37121,0.001543,172.31.40.0-255,66,77455,64,294885
37122,0.001606,74.125.24.0-255,2902,80357,64,294885
37123,0.001615,172.31.40.0-255,66,80423,64,294885
37124,0.001639,74.125.24.0-255,1484,81907,64,294885
37125,0.001683,172.31.40.0-255,66,81973,64,294885
37126,0.001719,74.125.24.0-255,7156,89129,64,294885
37127,0.001726,74.125.24.0-255,4320,93449,64,294885
37128,0.001746,74.125.24.0-255,4320,97769,64,294885
37129,0.001755,74.125.24.0-255,7156,104925,64,294885
37130,0.001767,172.31.40.0-255,66,104991,64,294885
37131,0.001774,74.125.24.0-255,7156,112147,64,294885
37132,0.00178,172.31.40.0-255,66,112213,64,294885
37133,0.001811,74.125.24.0-255,3602,115815,64,294885
37134,0.001817,74.125.24.0-255,4320,120135,64,294885
37135,0.001825,172.31.40.0-255,66,120201,64,294885
37136,0.001839,74.125.24.0-255,5738,125939,64,294885
37137,0.001863,74.125.24.0-255,4320,130259,64,294885
37138,0.001866,74.125.24.0-255,1484,131743,64,294885
37139,0.001869,172.31.40.0-255,66,131809,64,294885
37140,0.001875,172.31.40.0-255,66,131875,64,294885
37141,0.001884,74.125.24.0-255,1484,133359,64,294885
37142,0.001912,74.125.24.0-255,5020,138379,64,294885
37143,0.001939,172.31.40.0-255,66,138445,64,294885
37144,0.002282,74.125.24.0-255,1484,139929,64,294885
37145,0.002288,74.125.24.0-255,2902,142831,64,294885
37146,0.002313,74.125.24.0-255,5738,148569,64,294885
37147,0.002316,172.31.40.0-255,66,148635,64,294885
37148,0.002321,172.31.40.0-255,66,148701,64,294885
37149,0.002328,74.125.24.0-255,1484,150185,64,294885
37150,0.002405,172.31.40.0-255,66,150251,64,294885
37151,0.002476,74.125.24.0-255,1484,151735,64,294885
37152,0.002482,74.125.24.0-255,2902,154637,64,294885
37153,0.002501,74.125.24.0-255,5738,160375,64,294885
37154,0.002504,74.125.24.0-255,1484,161859,64,294885
37155,0.002507,172.31.40.0-255,66,161925,64,294885
37156,0.002512,172.31.40.0-255,66,161991,64,294885
37157,0.002537,74.125.24.0-255,4320,166311,64,294885
37158,0.002544,74.125.24.0-255,7156,173467,64,294885
37159,0.002554,172.31.40.0-255,66,173533,64,294885
37160,0.005065,74.125.24.0-255,5738,179271,64,294885
37161,0.005075,172.31.40.0-255,66,179337,64,294885
37162,0.007609,74.125.24.0-255,5738,185075,64,294885
37163,0.012043,172.31.40.0-255,66,185141,64,294885
37164,0.014587,74.125.24.0-255,5738,190879,64,294885
37165,0.014605,172.31.40.0-255,66,190945,64,294885
37166,0.017165,74.125.24.0-255,5738,196683,64,294885
37167,0.017172,172.31.40.0-255,66,196749,64,294885
37168,0.019684,74.125.24.0-255,5738,202487,64,294885
37169,0.019691,172.31.40.0-255,66,202553,64,294885
37170,0.02218,74.125.24.0-255,5738,208291,64,294885
37171,0.022189,172.31.40.0-255,66,208357,64,294885
37172,0.024682,74.125.24.0-255,5738,214095,64,294885
37173,0.024694,172.31.40.0-255,66,214161,64,294885
37174,0.027203,74.125.24.0-255,5738,219899,64,294885
37175,0.027211,172.31.40.0-255,66,219965,64,294885
37176,0.029743,74.125.24.0-255,5738,225703,64,294885
37177,0.029762,172.31.40.0-255,66,225769,64,294885
37178,0.03228,74.125.24.0-255,5738,231507,64,294885
37179,0.032289,172.31.40.0-255,66,231573,64,294885
37180,0.034822,74.125.24.0-255,5738,237311,64,294885
37181,0.034838,172.31.40.0-255,66,237377,64,294885
37182,0.037344,74.125.24.0-255,5738,243115,64,294885
37183,0.037352,172.31.40.0-255,66,243181,64,294885
37184,0.039865,74.125.24.0-255,5738,248919,64,294885
37185,0.039882,172.31.40.0-255,66,248985,64,294885
37186,0.042412,74.125.24.0-255,5738,254723,64,294885
37187,0.042423,172.31.40.0-255,66,254789,64,294885
37188,0.044934,74.125.24.0-255,5738,260527,64,294885
37189,0.04495,172.31.40.0-255,66,260593,64,294885
37190,0.046366,172.31.40.0-255,172,260765,64,294885
37191,0.046398,172.31.40.0-255,1112,261877,64,294885
37192,0.046471,172.31.40.0-255,1514,263391,64,294885
37193,0.046473,172.31.40.0-255,1514,264905,64,294885
37194,0.046474,172.31.40.0-255,696,265601,64,294885
37195,0.047472,74.125.24.0-255,5738,271339,64,294885
37196,0.047479,172.31.40.0-255,66,271405,64,294885
37197,0.047889,104.244.42.0-255,66,271471,64,294885
37198,0.048,104.244.42.0-255,66,271537,64,294885
37199,0.048053,104.244.42.0-255,66,271603,64,294885
37200,0.048057,104.244.42.0-255,66,271669,64,294885
37201,0.050017,74.125.24.0-255,5738,277407,64,294885
37202,0.050034,172.31.40.0-255,66,277473,64,294885
37203,0.052545,74.125.24.0-255,5738,283211,64,294885
37204,0.052558,172.31.40.0-255,66,283277,64,294885
37205,0.055148,74.125.24.0-255,5738,289015,64,294885
37206,0.055167,172.31.40.0-255,66,289081,64,294885
37207,0.057709,74.125.24.0-255,5738,294819,64,294885
37208,0.057727,172.31.40.0-255,66,294885,64,294885
37209,0.0,172.217.27.0-255,146,146,64,267809
37210,2e-05,172.31.40.0-255,66,212,64,267809
37211,2.6e-05,172.217.27.0-255,1484,1696,64,267809
37212,3.2e-05,172.31.40.0-255,66,1762,64,267809
37213,4e-05,172.217.27.0-255,2902,4664,64,267809
37214,4.4e-05,172.31.40.0-255,66,4730,64,267809
37215,9.7e-05,172.217.27.0-255,5738,10468,64,267809
37216,0.000101,172.31.40.0-255,66,10534,64,267809
37217,0.000114,172.217.27.0-255,1484,12018,64,267809
37218,0.000117,172.31.40.0-255,66,12084,64,267809
37219,0.000279,172.217.27.0-255,1484,13568,64,267809
37220,0.000284,172.31.40.0-255,66,13634,64,267809
37221,0.000302,172.217.27.0-255,719,14353,64,267809
37222,0.000304,172.31.40.0-255,66,14419,64,267809
37223,0.000332,172.217.27.0-255,2902,17321,64,267809
37224,0.000336,172.31.40.0-255,66,17387,64,267809
37225,0.000365,172.31.40.0-255,66,17453,64,267809
37226,0.000659,172.217.27.0-255,3961,21414,64,267809
37227,0.000664,172.31.40.0-255,66,21480,64,267809
37228,0.000765,172.217.27.0-255,4320,25800,64,267809
37229,0.00077,172.31.40.0-255,66,25866,64,267809
37230,0.00089,172.31.40.0-255,66,25932,64,267809
37231,0.000908,172.217.27.0-255,1484,27416,64,267809
37232,0.000911,172.31.40.0-255,66,27482,64,267809
37233,0.00114,172.217.27.0-255,7156,34638,64,267809
37234,0.001147,172.31.40.0-255,66,34704,64,267809
37235,0.001175,172.31.40.0-255,66,34770,64,267809
37236,0.00165,172.217.27.0-255,7156,41926,64,267809
37237,0.001657,172.31.40.0-255,66,41992,64,267809
37238,0.001681,172.217.27.0-255,4396,46388,64,267809
37239,0.001685,172.31.40.0-255,66,46454,64,267809
37240,0.001948,172.217.27.0-255,5738,52192,64,267809
37241,0.001956,172.31.40.0-255,66,52258,64,267809
37242,0.001969,172.217.27.0-255,6797,59055,64,267809
37243,0.001972,172.31.40.0-255,66,59121,64,267809
37244,0.002266,172.217.27.0-255,4320,63441,64,267809
37245,0.002271,172.31.40.0-255,66,63507,64,267809
37246,0.002313,172.31.40.0-255,66,63573,64,267809
37247,0.003942,172.217.27.0-255,5738,69311,64,267809
37248,0.003947,172.31.40.0-255,66,69377,64,267809
37249,0.005579,172.217.27.0-255,4320,73697,64,267809
37250,0.005584,172.31.40.0-255,66,73763,64,267809
37251,0.005605,172.217.27.0-255,1484,75247,64,267809
37252,0.005608,172.31.40.0-255,66,75313,64,267809
37253,0.007218,172.217.27.0-255,4320,79633,64,267809
37254,0.007224,172.31.40.0-255,66,79699,64,267809
37255,0.007263,172.217.27.0-255,1484,81183,64,267809
37256,0.007266,172.31.40.0-255,66,81249,64,267809
37257,0.008859,172.217.27.0-255,4320,85569,64,267809
37258,0.008864,172.31.40.0-255,66,85635,64,267809
37259,0.008893,172.217.27.0-255,1484,87119,64,267809
37260,0.008896,172.31.40.0-255,66,87185,64,267809
37261,0.010502,172.217.27.0-255,4320,91505,64,267809
37262,0.01051,172.31.40.0-255,66,91571,64,267809
37263,0.010539,172.217.27.0-255,1484,93055,64,267809
37264,0.010542,172.31.40.0-255,66,93121,64,267809
37265,0.012148,172.217.27.0-255,4320,97441,64,267809
37266,0.012156,172.31.40.0-255,66,97507,64,267809
37267,0.012187,172.217.27.0-255,1484,98991,64,267809
37268,0.01219,172.31.40.0-255,66,99057,64,267809
37269,0.013802,172.217.27.0-255,4320,103377,64,267809
37270,0.013809,172.31.40.0-255,66,103443,64,267809
37271,0.013829,172.217.27.0-255,1484,104927,64,267809
37272,0.013832,172.31.40.0-255,66,104993,64,267809
37273,0.015453,172.217.27.0-255,4320,109313,64,267809
37274,0.015461,172.31.40.0-255,66,109379,64,267809
37275,0.015483,172.217.27.0-255,1484,110863,64,267809
37276,0.015486,172.31.40.0-255,66,110929,64,267809
37277,0.017153,172.217.27.0-255,4320,115249,64,267809
37278,0.017163,172.31.40.0-255,66,115315,64,267809
37279,0.01719,172.217.27.0-255,1484,116799,64,267809
37280,0.017193,172.31.40.0-255,66,116865,64,267809
37281,0.018827,172.217.27.0-255,4320,121185,64,267809
37282,0.018836,172.31.40.0-255,66,121251,64,267809
37283,0.01886,172.217.27.0-255,1484,122735,64,267809
37284,0.018863,172.31.40.0-255,66,122801,64,267809
37285,0.020478,172.217.27.0-255,4320,127121,64,267809
37286,0.020487,172.31.40.0-255,66,127187,64,267809
37287,0.020508,172.217.27.0-255,1484,128671,64,267809
37288,0.02051,172.31.40.0-255,66,128737,64,267809
37289,0.022124,172.217.27.0-255,4320,133057,64,267809
37290,0.022132,172.31.40.0-255,66,133123,64,267809
37291,0.022165,172.217.27.0-255,1484,134607,64,267809
37292,0.022168,172.31.40.0-255,66,134673,64,267809
37293,0.023776,172.217.27.0-255,4320,138993,64,267809
37294,0.023785,172.31.40.0-255,66,139059,64,267809
37295,0.023805,172.217.27.0-255,1484,140543,64,267809
37296,0.023808,172.31.40.0-255,66,140609,64,267809
37297,0.025415,172.217.27.0-255,4320,144929,64,267809
37298,0.025423,172.31.40.0-255,66,144995,64,267809
37299,0.025457,172.217.27.0-255,1484,146479,64,267809
37300,0.02546,172.31.40.0-255,66,146545,64,267809
37301,0.026528,172.31.40.0-255,172,146717,64,267809
37302,0.026561,172.31.40.0-255,1113,147830,64,267809
37303,0.026614,172.31.40.0-255,1514,149344,64,267809
37304,0.026616,172.31.40.0-255,1295,150639,64,267809
37305,0.027059,172.217.27.0-255,4320,154959,64,267809
37306,0.027066,172.31.40.0-255,66,155025,64,267809
37307,0.027084,172.217.27.0-255,1484,156509,64,267809
37308,0.027087,172.31.40.0-255,66,156575,64,267809
37309,0.0281,104.244.42.0-255,66,156641,64,267809
37310,0.028139,104.244.42.0-255,66,156707,64,267809
37311,0.0282,104.244.42.0-255,66,156773,64,267809
37312,0.028738,172.217.27.0-255,4320,161093,64,267809
37313,0.028746,172.31.40.0-255,66,161159,64,267809
37314,0.028771,172.217.27.0-255,1484,162643,64,267809
37315,0.028774,172.31.40.0-255,66,162709,64,267809
37316,0.030458,172.217.27.0-255,4320,167029,64,267809
37317,0.030465,172.31.40.0-255,66,167095,64,267809
37318,0.030487,172.217.27.0-255,1484,168579,64,267809
37319,0.030489,172.31.40.0-255,66,168645,64,267809
37320,0.032113,172.217.27.0-255,4320,172965,64,267809
37321,0.032121,172.31.40.0-255,66,173031,64,267809
37322,0.032143,172.217.27.0-255,1484,174515,64,267809
37323,0.032146,172.31.40.0-255,66,174581,64,267809
37324,0.033765,172.217.27.0-255,4320,178901,64,267809
37325,0.033772,172.31.40.0-255,66,178967,64,267809
37326,0.033792,172.217.27.0-255,1484,180451,64,267809
37327,0.033794,172.31.40.0-255,66,180517,64,267809
37328,0.035411,172.217.27.0-255,4320,184837,64,267809
37329,0.035418,172.31.40.0-255,66,184903,64,267809
37330,0.035439,172.217.27.0-255,1484,186387,64,267809
37331,0.035442,172.31.40.0-255,66,186453,64,267809
37332,0.037072,172.217.27.0-255,4320,190773,64,267809
37333,0.037078,172.31.40.0-255,66,190839,64,267809
37334,0.037101,172.217.27.0-255,1484,192323,64,267809
37335,0.037104,172.31.40.0-255,66,192389,64,267809
37336,0.038723,172.217.27.0-255,4320,196709,64,267809
37337,0.03873,172.31.40.0-255,66,196775,64,267809
37338,0.03875,172.217.27.0-255,1484,198259,64,267809
37339,0.038756,172.31.40.0-255,66,198325,64,267809
37340,0.040405,172.217.27.0-255,4320,202645,64,267809
37341,0.040419,172.31.40.0-255,66,202711,64,267809
37342,0.040442,172.217.27.0-255,1484,204195,64,267809
37343,0.040445,172.31.40.0-255,66,204261,64,267809
37344,0.042083,172.217.27.0-255,4320,208581,64,267809
37345,0.042096,172.31.40.0-255,66,208647,64,267809
37346,0.042116,172.217.27.0-255,1484,210131,64,267809
37347,0.042119,172.31.40.0-255,66,210197,64,267809
37348,0.043743,172.217.27.0-255,4320,214517,64,267809
37349,0.043753,172.31.40.0-255,66,214583,64,267809
37350,0.043768,172.217.27.0-255,1484,216067,64,267809
37351,0.043771,172.31.40.0-255,66,216133,64,267809
37352,0.045395,172.217.27.0-255,4320,220453,64,267809
37353,0.045405,172.31.40.0-255,66,220519,64,267809
37354,0.045442,172.217.27.0-255,1484,222003,64,267809
37355,0.045444,172.31.40.0-255,66,222069,64,267809
37356,0.047053,172.217.27.0-255,4320,226389,64,267809
37357,0.047065,172.31.40.0-255,66,226455,64,267809
37358,0.047086,172.217.27.0-255,1484,227939,64,267809
37359,0.047089,172.31.40.0-255,66,228005,64,267809
37360,0.048716,172.217.27.0-255,4320,232325,64,267809
37361,0.048728,172.31.40.0-255,66,232391,64,267809
37362,0.048748,172.217.27.0-255,1484,233875,64,267809
37363,0.04875,172.31.40.0-255,66,233941,64,267809
37364,0.050382,172.217.27.0-255,4320,238261,64,267809
37365,0.050394,172.31.40.0-255,66,238327,64,267809
37366,0.050416,172.217.27.0-255,1484,239811,64,267809
37367,0.050418,172.31.40.0-255,66,239877,64,267809
37368,0.052028,172.217.27.0-255,4320,244197,64,267809
37369,0.052036,172.31.40.0-255,66,244263,64,267809
37370,0.052056,172.217.27.0-255,1484,245747,64,267809
37371,0.052059,172.31.40.0-255,66,245813,64,267809
37372,0.053686,172.217.27.0-255,4320,250133,64,267809
37373,0.053698,172.31.40.0-255,66,250199,64,267809
37374,0.053721,172.217.27.0-255,1484,251683,64,267809
37375,0.053724,172.31.40.0-255,66,251749,64,267809
37376,0.055386,172.217.27.0-255,4320,256069,64,267809
37377,0.055398,172.31.40.0-255,66,256135,64,267809
37378,0.055418,172.217.27.0-255,1484,257619,64,267809
37379,0.057053,172.217.27.0-255,4320,261939,64,267809
37380,0.057065,172.31.40.0-255,66,262005,64,267809
37381,0.058726,172.217.27.0-255,5738,267743,64,267809
37382,0.058737,172.31.40.0-255,66,267809,64,267809
37383,0.0,172.31.40.0-255,105,105,64,459
37384,0.00016,172.31.40.0-255,90,195,64,459
37385,0.000171,172.31.40.0-255,66,261,64,459
37386,0.0022,172.217.194.0-255,66,327,64,459
37387,0.002232,172.217.194.0-255,66,393,64,459
37388,0.002255,172.31.40.0-255,66,459,64,459
37389,0.0,172.217.194.0-255,153,153,64,267144
37390,2.4e-05,172.31.40.0-255,66,219,64,267144
37391,3.1e-05,172.217.194.0-255,1484,1703,64,267144
37392,3.6e-05,172.31.40.0-255,66,1769,64,267144
37393,4.9e-05,172.217.194.0-255,2902,4671,64,267144
37394,5.2e-05,172.31.40.0-255,66,4737,64,267144
37395,6e-05,172.217.194.0-255,7156,11893,64,267144
37396,6.3e-05,172.31.40.0-255,66,11959,64,267144
37397,6.7e-05,172.217.194.0-255,2108,14067,64,267144
37398,6.9e-05,172.31.40.0-255,66,14133,64,267144
37399,0.000112,172.217.194.0-255,1484,15617,64,267144
37400,0.000114,172.31.40.0-255,66,15683,64,267144
37401,0.00012,172.217.194.0-255,2902,18585,64,267144
37402,0.000122,172.31.40.0-255,66,18651,64,267144
37403,0.000129,172.217.194.0-255,5738,24389,64,267144
37404,0.000131,172.31.40.0-255,66,24455,64,267144
37405,0.000165,172.217.194.0-255,6797,31252,64,267144
37406,0.000167,172.31.40.0-255,66,31318,64,267144
37407,0.000268,172.217.194.0-255,1484,32802,64,267144
37408,0.000272,172.31.40.0-255,66,32868,64,267144
37409,0.000292,172.217.194.0-255,2902,35770,64,267144
37410,0.000294,172.31.40.0-255,66,35836,64,267144
37411,0.0003,172.217.194.0-255,4320,40156,64,267144
37412,0.000302,172.31.40.0-255,66,40222,64,267144
37413,0.000324,172.217.194.0-255,1484,41706,64,267144
37414,0.000326,172.31.40.0-255,66,41772,64,267144
37415,0.000329,172.217.194.0-255,1484,43256,64,267144
37416,0.000331,172.31.40.0-255,66,43322,64,267144
37417,0.000371,172.31.40.0-255,66,43388,64,267144
37418,0.000415,172.217.194.0-255,7156,50544,64,267144
37419,0.000418,172.31.40.0-255,66,50610,64,267144
37420,0.000443,172.217.194.0-255,1125,51735,64,267144
37421,0.000739,172.217.194.0-255,647,52382,64,267144
37422,0.000744,172.31.40.0-255,66,52448,64,267144
37423,0.00098,172.217.194.0-255,1484,53932,64,267144
37424,0.000986,172.217.194.0-255,2902,56834,64,267144
37425,0.000989,172.31.40.0-255,66,56900,64,267144
37426,0.001019,172.217.194.0-255,5738,62638,64,267144
37427,0.001021,172.31.40.0-255,66,62704,64,267144
37428,0.001052,172.217.194.0-255,7156,69860,64,267144
37429,0.001055,172.31.40.0-255,66,69926,64,267144
37430,0.00106,172.217.194.0-255,2902,72828,64,267144
37431,0.001062,172.31.40.0-255,66,72894,64,267144
37432,0.001096,172.31.40.0-255,66,72960,64,267144
37433,0.0011,172.217.194.0-255,2184,75144,64,267144
37434,0.001102,172.31.40.0-255,66,75210,64,267144
37435,0.001501,172.217.194.0-255,1484,76694,64,267144
37436,0.001509,172.217.194.0-255,2902,79596,64,267144
37437,0.001513,172.31.40.0-255,66,79662,64,267144
37438,0.001518,172.217.194.0-255,2902,82564,64,267144
37439,0.00152,172.31.40.0-255,66,82630,64,267144
37440,0.001538,172.217.194.0-255,2902,85532,64,267144
37441,0.00154,172.31.40.0-255,66,85598,64,267144
37442,0.001552,172.217.194.0-255,7156,92754,64,267144
37443,0.001554,172.31.40.0-255,66,92820,64,267144
37444,0.001565,172.217.194.0-255,1484,94304,64,267144
37445,0.001601,172.31.40.0-255,66,94370,64,267144
37446,0.001605,172.217.194.0-255,2184,96554,64,267144
37447,0.001607,172.31.40.0-255,66,96620,64,267144
37448,0.001921,172.217.194.0-255,1484,98104,64,267144
37449,0.001929,172.217.194.0-255,2902,101006,64,267144
37450,0.001932,172.31.40.0-255,66,101072,64,267144
37451,0.001938,172.217.194.0-255,4320,105392,64,267144
37452,0.00194,172.31.40.0-255,66,105458,64,267144
37453,0.00196,172.217.194.0-255,1484,106942,64,267144
37454,0.001963,172.217.194.0-255,1484,108426,64,267144
37455,0.001969,172.31.40.0-255,66,108492,64,267144
37456,0.002007,172.31.40.0-255,66,108558,64,267144
37457,0.002012,172.217.194.0-255,2902,111460,64,267144
37458,0.002014,172.31.40.0-255,66,111526,64,267144
37459,0.002047,172.31.40.0-255,66,111592,64,267144
37460,0.002246,172.217.194.0-255,1484,113076,64,267144
37461,0.002255,172.217.194.0-255,2902,115978,64,267144
37462,0.002259,172.31.40.0-255,66,116044,64,267144
37463,0.002264,172.217.194.0-255,2902,118946,64,267144
37464,0.002266,172.31.40.0-255,66,119012,64,267144
37465,0.002306,172.31.40.0-255,66,119078,64,267144
37466,0.002318,172.31.40.0-255,66,119144,64,267144
37467,0.002322,172.217.194.0-255,2902,122046,64,267144
37468,0.002324,172.31.40.0-255,66,122112,64,267144
37469,0.002346,172.217.194.0-255,3602,125714,64,267144
37470,0.002349,172.31.40.0-255,66,125780,64,267144
37471,0.002354,172.217.194.0-255,5738,131518,64,267144
37472,0.002357,172.31.40.0-255,66,131584,64,267144
37473,0.002404,172.31.40.0-255,66,131650,64,267144
37474,0.002408,172.217.194.0-255,2902,134552,64,267144
37475,0.00241,172.31.40.0-255,66,134618,64,267144
37476,0.002417,172.217.194.0-255,5738,140356,64,267144
37477,0.00242,172.31.40.0-255,66,140422,64,267144
37478,0.002426,172.217.194.0-255,5020,145442,64,267144
37479,0.002428,172.31.40.0-255,66,145508,64,267144
37480,0.00259,172.217.194.0-255,1484,146992,64,267144
37481,0.002598,172.217.194.0-255,2902,149894,64,267144
37482,0.002601,172.31.40.0-255,66,149960,64,267144
37483,0.002608,172.217.194.0-255,4320,154280,64,267144
37484,0.002632,172.217.194.0-255,1484,155764,64,267144
37485,0.002636,172.217.194.0-255,2902,158666,64,267144
37486,0.002689,172.217.194.0-255,766,159432,64,267144
37487,0.00276,172.217.194.0-255,1484,160916,64,267144
37488,0.002778,172.217.194.0-255,2902,163818,64,267144
37489,0.002785,172.217.194.0-255,5738,169556,64,267144
37490,0.00281,172.217.194.0-255,5738,175294,64,267144
37491,0.002855,172.217.194.0-255,2902,178196,64,267144
37492,0.002861,172.217.194.0-255,5020,183216,64,267144
37493,0.002959,172.217.194.0-255,1484,184700,64,267144
37494,0.002963,172.217.194.0-255,1484,186184,64,267144
37495,0.002979,172.217.194.0-255,1484,187668,64,267144
37496,0.002985,172.217.194.0-255,5738,193406,64,267144
37497,0.002996,172.217.194.0-255,1484,194890,64,267144
37498,0.003018,172.217.194.0-255,1484,196374,64,267144
37499,0.003293,172.217.194.0-255,1484,197858,64,267144
37500,0.003298,172.217.194.0-255,1484,199342,64,267144
37501,0.003315,172.217.194.0-255,1484,200826,64,267144
37502,0.003322,172.217.194.0-255,5738,206564,64,267144
37503,0.003348,172.217.194.0-255,4320,210884,64,267144
37504,0.003364,172.217.194.0-255,2902,213786,64,267144
37505,0.003371,172.217.194.0-255,6438,220224,64,267144
37506,0.003412,172.217.194.0-255,2902,223126,64,267144
37507,0.003428,172.217.194.0-255,5738,228864,64,267144
37508,0.003452,172.217.194.0-255,7156,236020,64,267144
37509,0.003457,172.217.194.0-255,4320,240340,64,267144
37510,0.003473,172.217.194.0-255,5738,246078,64,267144
37511,0.00349,172.217.194.0-255,5738,251816,64,267144
37512,0.003506,172.217.194.0-255,5612,257428,64,267144
37513,0.003509,172.217.194.0-255,105,257533,64,267144
37514,0.00692,172.31.40.0-255,66,257599,64,267144
37515,0.01903,172.31.40.0-255,105,257704,64,267144
37516,0.021298,172.217.194.0-255,66,257770,64,267144
37517,0.047389,172.31.40.0-255,172,257942,64,267144
37518,0.047424,172.31.40.0-255,1112,259054,64,267144
37519,0.047505,172.31.40.0-255,1514,260568,64,267144
37520,0.047507,172.31.40.0-255,1514,262082,64,267144
37521,0.047508,172.31.40.0-255,1514,263596,64,267144
37522,0.047514,172.31.40.0-255,1514,265110,64,267144
37523,0.047515,172.31.40.0-255,1514,266624,64,267144
37524,0.047516,172.31.40.0-255,82,266706,64,267144
37525,0.048948,104.244.42.0-255,66,266772,64,267144
37526,0.049011,104.244.42.0-255,66,266838,64,267144
37527,0.049094,104.244.42.0-255,66,266904,64,267144
37528,0.049101,104.244.42.0-255,66,266970,64,267144
37529,0.05011,104.244.42.0-255,108,267078,64,267144
37530,0.050117,172.31.40.0-255,66,267144,64,267144
37531,0.0,74.125.24.0-255,150,150,64,225828
37532,1.8e-05,172.31.40.0-255,66,216,64,225828
37533,2.5e-05,74.125.24.0-255,1484,1700,64,225828
37534,3e-05,172.31.40.0-255,66,1766,64,225828
37535,3.6e-05,74.125.24.0-255,2902,4668,64,225828
37536,3.9e-05,172.31.40.0-255,66,4734,64,225828
37537,4.6e-05,74.125.24.0-255,7156,11890,64,225828
37538,4.9e-05,172.31.40.0-255,66,11956,64,225828
37539,5.2e-05,74.125.24.0-255,1484,13440,64,225828
37540,5.4e-05,172.31.40.0-255,66,13506,64,225828
37541,5.7e-05,74.125.24.0-255,602,14108,64,225828
37542,6e-05,172.31.40.0-255,66,14174,64,225828
37543,0.000699,74.125.24.0-255,1484,15658,64,225828
37544,0.000706,172.31.40.0-255,66,15724,64,225828
37545,0.000716,74.125.24.0-255,2902,18626,64,225828
37546,0.000718,172.31.40.0-255,66,18692,64,225828
37547,0.000726,74.125.24.0-255,5738,24430,64,225828
37548,0.000728,172.31.40.0-255,66,24496,64,225828
37549,0.000746,74.125.24.0-255,6797,31293,64,225828
37550,0.000749,172.31.40.0-255,66,31359,64,225828
37551,0.000861,74.125.24.0-255,1484,32843,64,225828
37552,0.000865,172.31.40.0-255,66,32909,64,225828
37553,0.000886,74.125.24.0-255,2902,35811,64,225828
37554,0.000889,172.31.40.0-255,66,35877,64,225828
37555,0.000894,74.125.24.0-255,4320,40197,64,225828
37556,0.000897,172.31.40.0-255,66,40263,64,225828
37557,0.000912,74.125.24.0-255,1484,41747,64,225828
37558,0.000914,172.31.40.0-255,66,41813,64,225828
37559,0.000917,74.125.24.0-255,1484,43297,64,225828
37560,0.000919,172.31.40.0-255,66,43363,64,225828
37561,0.000946,74.125.24.0-255,4320,47683,64,225828
37562,0.000948,172.31.40.0-255,66,47749,64,225828
37563,0.000965,74.125.24.0-255,1125,48874,64,225828
37564,0.001119,74.125.24.0-255,1484,50358,64,225828
37565,0.001124,172.31.40.0-255,66,50424,64,225828
37566,0.001129,74.125.24.0-255,2902,53326,64,225828
37567,0.001133,172.31.40.0-255,66,53392,64,225828
37568,0.001138,74.125.24.0-255,4320,57712,64,225828
37569,0.001141,172.31.40.0-255,66,57778,64,225828
37570,0.001164,74.125.24.0-255,1484,59262,64,225828
37571,0.001171,74.125.24.0-255,5738,65000,64,225828
37572,0.001174,172.31.40.0-255,66,65066,64,225828
37573,0.001199,74.125.24.0-255,1704,66770,64,225828
37574,0.001202,172.31.40.0-255,66,66836,64,225828
37575,0.001915,74.125.24.0-255,1484,68320,64,225828
37576,0.001936,74.125.24.0-255,2902,71222,64,225828
37577,0.001939,172.31.40.0-255,66,71288,64,225828
37578,0.001945,74.125.24.0-255,5738,77026,64,225828
37579,0.001947,172.31.40.0-255,66,77092,64,225828
37580,0.00196,74.125.24.0-255,1484,78576,64,225828
37581,0.001985,172.31.40.0-255,66,78642,64,225828
37582,0.001996,172.31.40.0-255,66,78708,64,225828
37583,0.002042,74.125.24.0-255,2184,80892,64,225828
37584,0.002045,172.31.40.0-255,66,80958,64,225828
37585,0.004349,74.125.24.0-255,2902,83860,64,225828
37586,0.004355,172.31.40.0-255,66,83926,64,225828
37587,0.004419,74.125.24.0-255,2902,86828,64,225828
37588,0.004423,172.31.40.0-255,66,86894,64,225828
37589,0.006751,74.125.24.0-255,5738,92632,64,225828
37590,0.006759,172.31.40.0-255,66,92698,64,225828
37591,0.009088,74.125.24.0-255,5738,98436,64,225828
37592,0.009096,172.31.40.0-255,66,98502,64,225828
37593,0.011435,74.125.24.0-255,5738,104240,64,225828
37594,0.011442,172.31.40.0-255,66,104306,64,225828
37595,0.013815,74.125.24.0-255,5738,110044,64,225828
37596,0.013822,172.31.40.0-255,66,110110,64,225828
37597,0.016156,74.125.24.0-255,5738,115848,64,225828
37598,0.016164,172.31.40.0-255,66,115914,64,225828
37599,0.018565,74.125.24.0-255,5738,121652,64,225828
37600,0.018573,172.31.40.0-255,66,121718,64,225828
37601,0.020905,74.125.24.0-255,5738,127456,64,225828
37602,0.020916,172.31.40.0-255,66,127522,64,225828
37603,0.023283,74.125.24.0-255,5738,133260,64,225828
37604,0.023292,172.31.40.0-255,66,133326,64,225828
37605,0.025388,172.31.40.0-255,171,133497,64,225828
37606,0.025421,172.31.40.0-255,1135,134632,64,225828
37607,0.025477,172.31.40.0-255,1514,136146,64,225828
37608,0.025479,172.31.40.0-255,1514,137660,64,225828
37609,0.02548,172.31.40.0-255,670,138330,64,225828
37610,0.025654,74.125.24.0-255,5738,144068,64,225828
37611,0.025661,172.31.40.0-255,66,144134,64,225828
37612,0.026907,104.244.42.0-255,66,144200,64,225828
37613,0.026992,104.244.42.0-255,66,144266,64,225828
37614,0.027029,104.244.42.0-255,66,144332,64,225828
37615,0.027034,104.244.42.0-255,66,144398,64,225828
37616,0.027642,104.244.42.0-255,108,144506,64,225828
37617,0.027651,172.31.40.0-255,66,144572,64,225828
37618,0.028007,74.125.24.0-255,5738,150310,64,225828
37619,0.028012,172.31.40.0-255,66,150376,64,225828
37620,0.030372,74.125.24.0-255,5738,156114,64,225828
37621,0.030379,172.31.40.0-255,66,156180,64,225828
37622,0.032706,74.125.24.0-255,5738,161918,64,225828
37623,0.032714,172.31.40.0-255,66,161984,64,225828
37624,0.035052,74.125.24.0-255,5738,167722,64,225828
37625,0.035059,172.31.40.0-255,66,167788,64,225828
37626,0.037411,74.125.24.0-255,5738,173526,64,225828
37627,0.037418,172.31.40.0-255,66,173592,64,225828
37628,0.039771,74.125.24.0-255,5738,179330,64,225828
37629,0.03978,172.31.40.0-255,66,179396,64,225828
37630,0.042167,74.125.24.0-255,5738,185134,64,225828
37631,0.042173,172.31.40.0-255,66,185200,64,225828
37632,0.044513,74.125.24.0-255,5738,190938,64,225828
37633,0.044518,172.31.40.0-255,66,191004,64,225828
37634,0.046853,74.125.24.0-255,5738,196742,64,225828
37635,0.04686,172.31.40.0-255,66,196808,64,225828
37636,0.049183,74.125.24.0-255,5738,202546,64,225828
37637,0.049191,172.31.40.0-255,66,202612,64,225828
37638,0.051573,74.125.24.0-255,5738,208350,64,225828
37639,0.05158,172.31.40.0-255,66,208416,64,225828
37640,0.053903,74.125.24.0-255,5738,214154,64,225828
37641,0.05391,172.31.40.0-255,66,214220,64,225828
37642,0.056289,74.125.24.0-255,5738,219958,64,225828
37643,0.056296,172.31.40.0-255,66,220024,64,225828
37644,0.0587,74.125.24.0-255,5738,225762,64,225828
37645,0.058707,172.31.40.0-255,66,225828,64,225828
37646,0.0,74.125.24.0-255,146,146,64,196060
37647,2.3e-05,172.31.40.0-255,66,212,64,196060
37648,3e-05,74.125.24.0-255,1484,1696,64,196060
37649,3.6e-05,172.31.40.0-255,66,1762,64,196060
37650,4.2e-05,74.125.24.0-255,2902,4664,64,196060
37651,4.5e-05,172.31.40.0-255,66,4730,64,196060
37652,5.4e-05,74.125.24.0-255,7156,11886,64,196060
37653,5.6e-05,172.31.40.0-255,66,11952,64,196060
37654,6.1e-05,74.125.24.0-255,2902,14854,64,196060
37655,6.4e-05,172.31.40.0-255,66,14920,64,196060
37656,0.000104,172.31.40.0-255,66,14986,64,196060
37657,0.000109,74.125.24.0-255,2543,17529,64,196060
37658,0.000111,172.31.40.0-255,66,17595,64,196060
37659,0.000157,74.125.24.0-255,1484,19079,64,196060
37660,0.00016,172.31.40.0-255,66,19145,64,196060
37661,0.000165,74.125.24.0-255,2902,22047,64,196060
37662,0.000167,172.31.40.0-255,66,22113,64,196060
37663,0.000174,74.125.24.0-255,5738,27851,64,196060
37664,0.000176,172.31.40.0-255,66,27917,64,196060
37665,0.000228,172.31.40.0-255,66,27983,64,196060
37666,0.00024,172.31.40.0-255,66,28049,64,196060
37667,0.000255,74.125.24.0-255,112,28161,64,196060
37668,0.000258,172.31.40.0-255,66,28227,64,196060
37669,0.000282,74.125.24.0-255,329,28556,64,196060
37670,0.000285,172.31.40.0-255,66,28622,64,196060
37671,0.000489,74.125.24.0-255,1484,30106,64,196060
37672,0.000495,172.31.40.0-255,66,30172,64,196060
37673,0.000501,74.125.24.0-255,2902,33074,64,196060
37674,0.000503,172.31.40.0-255,66,33140,64,196060
37675,0.00051,74.125.24.0-255,5738,38878,64,196060
37676,0.000513,172.31.40.0-255,66,38944,64,196060
37677,0.000552,172.31.40.0-255,66,39010,64,196060
37678,0.000565,172.31.40.0-255,66,39076,64,196060
37679,0.000997,74.125.24.0-255,1484,40560,64,196060
37680,0.001004,74.125.24.0-255,2902,43462,64,196060
37681,0.001008,172.31.40.0-255,66,43528,64,196060
37682,0.001014,74.125.24.0-255,4320,47848,64,196060
37683,0.001016,172.31.40.0-255,66,47914,64,196060
37684,0.001043,74.125.24.0-255,1484,49398,64,196060
37685,0.001051,74.125.24.0-255,7156,56554,64,196060
37686,0.001054,172.31.40.0-255,66,56620,64,196060
37687,0.001061,74.125.24.0-255,7156,63776,64,196060
37688,0.001063,172.31.40.0-255,66,63842,64,196060
37689,0.001085,74.125.24.0-255,7156,70998,64,196060
37690,0.001088,172.31.40.0-255,66,71064,64,196060
37691,0.001092,74.125.24.0-255,2184,73248,64,196060
37692,0.001094,172.31.40.0-255,66,73314,64,196060
37693,0.001098,74.125.24.0-255,2902,76216,64,196060
37694,0.001101,172.31.40.0-255,66,76282,64,196060
37695,0.001128,74.125.24.0-255,7156,83438,64,196060
37696,0.001132,172.31.40.0-255,66,83504,64,196060
37697,0.001143,172.31.40.0-255,66,83570,64,196060
37698,0.001188,172.31.40.0-255,66,83636,64,196060
37699,0.001236,172.31.40.0-255,66,83702,64,196060
37700,0.001264,74.125.24.0-255,7156,90858,64,196060
37701,0.001281,74.125.24.0-255,4320,95178,64,196060
37702,0.00129,172.31.40.0-255,66,95244,64,196060
37703,0.001293,172.31.40.0-255,66,95310,64,196060
37704,0.001296,172.31.40.0-255,66,95376,64,196060
37705,0.0013,74.125.24.0-255,2902,98278,64,196060
37706,0.001303,172.31.40.0-255,66,98344,64,196060
37707,0.001313,172.31.40.0-255,66,98410,64,196060
37708,0.001353,172.31.40.0-255,66,98476,64,196060
37709,0.001355,74.125.24.0-255,766,99242,64,196060
37710,0.001387,74.125.24.0-255,5738,104980,64,196060
37711,0.00139,172.31.40.0-255,66,105046,64,196060
37712,0.001423,172.31.40.0-255,66,105112,64,196060
37713,0.001444,172.31.40.0-255,66,105178,64,196060
37714,0.001447,74.125.24.0-255,766,105944,64,196060
37715,0.00145,74.125.24.0-255,1484,107428,64,196060
37716,0.001451,172.31.40.0-255,66,107494,64,196060
37717,0.001473,74.125.24.0-255,4320,111814,64,196060
37718,0.001476,172.31.40.0-255,66,111880,64,196060
37719,0.001487,172.31.40.0-255,66,111946,64,196060
37720,0.001493,74.125.24.0-255,5738,117684,64,196060
37721,0.001496,172.31.40.0-255,66,117750,64,196060
37722,0.001544,74.125.24.0-255,7156,124906,64,196060
37723,0.001547,172.31.40.0-255,66,124972,64,196060
37724,0.001572,74.125.24.0-255,5020,129992,64,196060
37725,0.001574,172.31.40.0-255,66,130058,64,196060
37726,0.001588,172.31.40.0-255,66,130124,64,196060
37727,0.001592,74.125.24.0-255,2902,133026,64,196060
37728,0.001594,172.31.40.0-255,66,133092,64,196060
37729,0.001638,172.31.40.0-255,66,133158,64,196060
37730,0.001704,74.125.24.0-255,1484,134642,64,196060
37731,0.001708,74.125.24.0-255,2902,137544,64,196060
37732,0.001713,172.31.40.0-255,66,137610,64,196060
37733,0.001737,74.125.24.0-255,5738,143348,64,196060
37734,0.001739,172.31.40.0-255,66,143414,64,196060
37735,0.001746,74.125.24.0-255,5738,149152,64,196060
37736,0.001748,172.31.40.0-255,66,149218,64,196060
37737,0.001767,74.125.24.0-255,7156,156374,64,196060
37738,0.00177,172.31.40.0-255,66,156440,64,196060
37739,0.001824,74.125.24.0-255,4320,160760,64,196060
37740,0.001828,172.31.40.0-255,66,160826,64,196060
37741,0.00185,74.125.24.0-255,6438,167264,64,196060
37742,0.001857,74.125.24.0-255,7156,174420,64,196060
37743,0.001863,74.125.24.0-255,5738,180158,64,196060
37744,0.001867,172.31.40.0-255,66,180224,64,196060
37745,0.001875,172.31.40.0-255,66,180290,64,196060
37746,0.001878,172.31.40.0-255,66,180356,64,196060
37747,0.001882,74.125.24.0-255,2902,183258,64,196060
37748,0.001884,172.31.40.0-255,66,183324,64,196060
37749,0.001894,172.31.40.0-255,66,183390,64,196060
37750,0.001937,172.31.40.0-255,66,183456,64,196060
37751,0.00194,74.125.24.0-255,766,184222,64,196060
37752,0.001945,74.125.24.0-255,4320,188542,64,196060
37753,0.001948,172.31.40.0-255,66,188608,64,196060
37754,0.001968,74.125.24.0-255,1100,189708,64,196060
37755,0.001983,74.125.24.0-255,105,189813,64,196060
37756,0.004414,172.31.40.0-255,66,189879,64,196060
37757,0.004451,172.31.40.0-255,105,189984,64,196060
37758,0.006666,74.125.24.0-255,66,190050,64,196060
37759,0.037022,172.31.40.0-255,171,190221,64,196060
37760,0.037053,172.31.40.0-255,1131,191352,64,196060
37761,0.037111,172.31.40.0-255,1514,192866,64,196060
37762,0.037113,172.31.40.0-255,1514,194380,64,196060
37763,0.037114,172.31.40.0-255,1514,195894,64,196060
37764,0.037115,172.31.40.0-255,100,195994,64,196060
37765,0.039161,104.244.42.0-255,66,196060,64,196060
37766,0.0,172.217.27.0-255,150,150,64,326869
37767,1.9e-05,172.31.40.0-255,66,216,64,326869
37768,2.6e-05,172.217.27.0-255,1484,1700,64,326869
37769,3e-05,172.31.40.0-255,66,1766,64,326869
37770,3.4e-05,172.217.27.0-255,1484,3250,64,326869
37771,4.5e-05,172.31.40.0-255,66,3316,64,326869
37772,8.4e-05,172.217.27.0-255,1484,4800,64,326869
37773,8.7e-05,172.31.40.0-255,66,4866,64,326869
37774,9.4e-05,172.217.27.0-255,4320,9186,64,326869
37775,9.7e-05,172.31.40.0-255,66,9252,64,326869
37776,0.000107,172.217.27.0-255,4886,14138,64,326869
37777,0.00011,172.31.40.0-255,66,14204,64,326869
37778,0.000137,172.217.27.0-255,1484,15688,64,326869
37779,0.00014,172.31.40.0-255,66,15754,64,326869
37780,0.000144,172.217.27.0-255,2902,18656,64,326869
37781,0.000146,172.31.40.0-255,66,18722,64,326869
37782,0.00015,172.217.27.0-255,2902,21624,64,326869
37783,0.000156,172.31.40.0-255,66,21690,64,326869
37784,0.000162,172.217.27.0-255,4320,26010,64,326869
37785,0.000165,172.31.40.0-255,66,26076,64,326869
37786,0.000169,172.217.27.0-255,2902,28978,64,326869
37787,0.000172,172.31.40.0-255,66,29044,64,326869
37788,0.000184,172.31.40.0-255,66,29110,64,326869
37789,0.000191,172.217.27.0-255,5738,34848,64,326869
37790,0.000194,172.31.40.0-255,66,34914,64,326869
37791,0.000226,172.217.27.0-255,1484,36398,64,326869
37792,0.000228,172.31.40.0-255,66,36464,64,326869
37793,0.000231,172.217.27.0-255,1484,37948,64,326869
37794,0.000233,172.31.40.0-255,66,38014,64,326869
37795,0.000255,172.217.27.0-255,2184,40198,64,326869
37796,0.000258,172.31.40.0-255,66,40264,64,326869
37797,0.000267,172.217.27.0-255,4320,44584,64,326869
37798,0.00027,172.31.40.0-255,66,44650,64,326869
37799,0.000273,172.217.27.0-255,1484,46134,64,326869
37800,0.000315,172.31.40.0-255,66,46200,64,326869
37801,0.000317,172.217.27.0-255,1484,47684,64,326869
37802,0.00034,172.217.27.0-255,1415,49099,64,326869
37803,0.000342,172.31.40.0-255,66,49165,64,326869
37804,0.000734,172.217.27.0-255,136,49301,64,326869
37805,0.000962,172.217.27.0-255,1484,50785,64,326869
37806,0.000967,172.31.40.0-255,66,50851,64,326869
37807,0.000973,172.217.27.0-255,2902,53753,64,326869
37808,0.000975,172.31.40.0-255,66,53819,64,326869
37809,0.00101,172.217.27.0-255,4320,58139,64,326869
37810,0.001016,172.217.27.0-255,5738,63877,64,326869
37811,0.001018,172.217.27.0-255,1484,65361,64,326869
37812,0.001022,172.31.40.0-255,66,65427,64,326869
37813,0.001025,172.31.40.0-255,66,65493,64,326869
37814,0.001072,172.217.27.0-255,6797,72290,64,326869
37815,0.001073,172.217.27.0-255,349,72639,64,326869
37816,0.001078,172.31.40.0-255,66,72705,64,326869
37817,0.001081,172.31.40.0-255,66,72771,64,326869
37818,0.001205,172.217.27.0-255,1484,74255,64,326869
37819,0.00121,172.31.40.0-255,66,74321,64,326869
37820,0.001216,172.217.27.0-255,2902,77223,64,326869
37821,0.001218,172.31.40.0-255,66,77289,64,326869
37822,0.001222,172.217.27.0-255,2902,80191,64,326869
37823,0.001224,172.31.40.0-255,66,80257,64,326869
37824,0.001253,172.217.27.0-255,2902,83159,64,326869
37825,0.001256,172.31.40.0-255,66,83225,64,326869
37826,0.001267,172.217.27.0-255,7156,90381,64,326869
37827,0.001269,172.31.40.0-255,66,90447,64,326869
37828,0.00128,172.31.40.0-255,66,90513,64,326869
37829,0.001316,172.31.40.0-255,66,90579,64,326869
37830,0.00157,172.217.27.0-255,1484,92063,64,326869
37831,0.001576,172.217.27.0-255,1484,93547,64,326869
37832,0.00158,172.31.40.0-255,66,93613,64,326869
37833,0.001609,172.217.27.0-255,1484,95097,64,326869
37834,0.001616,172.217.27.0-255,5738,100835,64,326869
37835,0.001618,172.31.40.0-255,66,100901,64,326869
37836,0.001626,172.217.27.0-255,7156,108057,64,326869
37837,0.001628,172.31.40.0-255,66,108123,64,326869
37838,0.001691,172.217.27.0-255,7156,115279,64,326869
37839,0.001696,172.31.40.0-255,66,115345,64,326869
37840,0.001722,172.217.27.0-255,7156,122501,64,326869
37841,0.001726,172.31.40.0-255,66,122567,64,326869
37842,0.00173,172.217.27.0-255,2184,124751,64,326869
37843,0.001731,172.31.40.0-255,66,124817,64,326869
37844,0.003351,172.217.27.0-255,5738,130555,64,326869
37845,0.003359,172.31.40.0-255,66,130621,64,326869
37846,0.005014,172.217.27.0-255,5738,136359,64,326869
37847,0.005018,172.31.40.0-255,66,136425,64,326869
37848,0.006639,172.217.27.0-255,2902,139327,64,326869
37849,0.006643,172.31.40.0-255,66,139393,64,326869
37850,0.006668,172.217.27.0-255,2902,142295,64,326869
37851,0.00667,172.31.40.0-255,66,142361,64,326869
37852,0.008267,172.217.27.0-255,2902,145263,64,326869
37853,0.008274,172.31.40.0-255,66,145329,64,326869
37854,0.008294,172.217.27.0-255,2902,148231,64,326869
37855,0.008297,172.31.40.0-255,66,148297,64,326869
37856,0.009912,172.217.27.0-255,4320,152617,64,326869
37857,0.009919,172.31.40.0-255,66,152683,64,326869
37858,0.009964,172.217.27.0-255,1484,154167,64,326869
37859,0.011554,172.217.27.0-255,4320,158487,64,326869
37860,0.011562,172.31.40.0-255,66,158553,64,326869
37861,0.013199,172.217.27.0-255,5738,164291,64,326869
37862,0.013206,172.31.40.0-255,66,164357,64,326869
37863,0.014853,172.217.27.0-255,5738,170095,64,326869
37864,0.014861,172.31.40.0-255,66,170161,64,326869
37865,0.016493,172.217.27.0-255,5738,175899,64,326869
37866,0.0165,172.31.40.0-255,66,175965,64,326869
37867,0.018128,172.217.27.0-255,5738,181703,64,326869
37868,0.018134,172.31.40.0-255,66,181769,64,326869
37869,0.019774,172.217.27.0-255,5738,187507,64,326869
37870,0.01978,172.31.40.0-255,66,187573,64,326869
37871,0.021407,172.217.27.0-255,5738,193311,64,326869
37872,0.021413,172.31.40.0-255,66,193377,64,326869
37873,0.023048,172.217.27.0-255,5738,199115,64,326869
37874,0.023056,172.31.40.0-255,66,199181,64,326869
37875,0.02469,172.217.27.0-255,5738,204919,64,326869
37876,0.024697,172.31.40.0-255,66,204985,64,326869
37877,0.026346,172.217.27.0-255,5738,210723,64,326869
37878,0.026354,172.31.40.0-255,66,210789,64,326869
37879,0.028007,172.217.27.0-255,5738,216527,64,326869
37880,0.028022,172.31.40.0-255,66,216593,64,326869
37881,0.029666,172.217.27.0-255,5738,222331,64,326869
37882,0.029679,172.31.40.0-255,66,222397,64,326869
37883,0.031324,172.217.27.0-255,5738,228135,64,326869
37884,0.031335,172.31.40.0-255,66,228201,64,326869
37885,0.03298,172.217.27.0-255,5738,233939,64,326869
37886,0.032994,172.31.40.0-255,66,234005,64,326869
37887,0.03463,172.217.27.0-255,5738,239743,64,326869
37888,0.034641,172.31.40.0-255,66,239809,64,326869
37889,0.036298,172.217.27.0-255,5738,245547,64,326869
37890,0.036305,172.31.40.0-255,66,245613,64,326869
37891,0.037946,172.217.27.0-255,5738,251351,64,326869
37892,0.037959,172.31.40.0-255,66,251417,64,326869
37893,0.039594,172.217.27.0-255,5738,257155,64,326869
37894,0.039602,172.31.40.0-255,66,257221,64,326869
37895,0.041239,172.217.27.0-255,5738,262959,64,326869
37896,0.041247,172.31.40.0-255,66,263025,64,326869
37897,0.042889,172.217.27.0-255,5738,268763,64,326869
37898,0.042899,172.31.40.0-255,66,268829,64,326869
37899,0.044539,172.217.27.0-255,5738,274567,64,326869
37900,0.044549,172.31.40.0-255,66,274633,64,326869
37901,0.046189,172.217.27.0-255,5738,280371,64,326869
37902,0.046197,172.31.40.0-255,66,280437,64,326869
37903,0.047837,172.217.27.0-255,5738,286175,64,326869
37904,0.04785,172.31.40.0-255,66,286241,64,326869
37905,0.049482,172.217.27.0-255,5738,291979,64,326869
37906,0.049493,172.31.40.0-255,66,292045,64,326869
37907,0.051118,172.217.27.0-255,5738,297783,64,326869
37908,0.051125,172.31.40.0-255,66,297849,64,326869
37909,0.052795,172.217.27.0-255,5738,303587,64,326869
37910,0.052803,172.31.40.0-255,66,303653,64,326869
37911,0.054448,172.217.27.0-255,5738,309391,64,326869
37912,0.054455,172.31.40.0-255,66,309457,64,326869
37913,0.056099,172.217.27.0-255,5738,315195,64,326869
37914,0.05611,172.31.40.0-255,66,315261,64,326869
37915,0.05775,172.217.27.0-255,5738,320999,64,326869
37916,0.057762,172.31.40.0-255,66,321065,64,326869
37917,0.059401,172.217.27.0-255,5738,326803,64,326869
37918,0.059409,172.31.40.0-255,66,326869,64,326869
37919,0.0,172.217.194.0-255,152,152,64,227821
37920,2.6e-05,172.31.40.0-255,66,218,64,227821
37921,3.3e-05,172.217.194.0-255,1484,1702,64,227821
37922,3.8e-05,172.31.40.0-255,66,1768,64,227821
37923,4.5e-05,172.217.194.0-255,2902,4670,64,227821
37924,4.8e-05,172.31.40.0-255,66,4736,64,227821
37925,5.7e-05,172.217.194.0-255,7156,11892,64,227821
37926,6e-05,172.31.40.0-255,66,11958,64,227821
37927,8.7e-05,172.217.194.0-255,2129,14087,64,227821
37928,8.9e-05,172.31.40.0-255,66,14153,64,227821
37929,9.4e-05,172.217.194.0-255,2902,17055,64,227821
37930,9.7e-05,172.31.40.0-255,66,17121,64,227821
37931,0.000103,172.217.194.0-255,7156,24277,64,227821
37932,0.000106,172.31.40.0-255,66,24343,64,227821
37933,0.00012,172.31.40.0-255,66,24409,64,227821
37934,0.000163,172.217.194.0-255,4320,28729,64,227821
37935,0.000165,172.31.40.0-255,66,28795,64,227821
37936,0.000189,172.217.194.0-255,6438,35233,64,227821
37937,0.000191,172.31.40.0-255,66,35299,64,227821
37938,0.000204,172.31.40.0-255,66,35365,64,227821
37939,0.000231,172.217.194.0-255,5738,41103,64,227821
37940,0.000234,172.31.40.0-255,66,41169,64,227821
37941,0.000248,172.217.194.0-255,296,41465,64,227821
37942,0.00025,172.31.40.0-255,66,41531,64,227821
37943,0.000378,172.217.194.0-255,1484,43015,64,227821
37944,0.000382,172.31.40.0-255,66,43081,64,227821
37945,0.000399,172.217.194.0-255,2902,45983,64,227821
37946,0.000401,172.31.40.0-255,66,46049,64,227821
37947,0.000407,172.217.194.0-255,5738,51787,64,227821
37948,0.00041,172.31.40.0-255,66,51853,64,227821
37949,0.000441,172.31.40.0-255,66,51919,64,227821
37950,0.000453,172.31.40.0-255,66,51985,64,227821
37951,0.000477,172.217.194.0-255,1484,53469,64,227821
37952,0.000484,172.217.194.0-255,5020,58489,64,227821
37953,0.000487,172.31.40.0-255,66,58555,64,227821
37954,0.000501,172.217.194.0-255,5738,64293,64,227821
37955,0.000504,172.31.40.0-255,66,64359,64,227821
37956,0.000529,172.217.194.0-255,2902,67261,64,227821
37957,0.000531,172.31.40.0-255,66,67327,64,227821
37958,0.000553,172.217.194.0-255,5738,73065,64,227821
37959,0.000556,172.31.40.0-255,66,73131,64,227821
37960,0.000571,172.31.40.0-255,66,73197,64,227821
37961,0.000577,172.217.194.0-255,3602,76799,64,227821
37962,0.000579,172.31.40.0-255,66,76865,64,227821
37963,0.000696,172.217.194.0-255,1484,78349,64,227821
37964,0.000704,172.217.194.0-255,2902,81251,64,227821
37965,0.000708,172.31.40.0-255,66,81317,64,227821
37966,0.000715,172.217.194.0-255,5738,87055,64,227821
37967,0.000718,172.31.40.0-255,66,87121,64,227821
37968,0.00072,172.217.194.0-255,1484,88605,64,227821
37969,0.000745,172.217.194.0-255,7156,95761,64,227821
37970,0.000748,172.31.40.0-255,66,95827,64,227821
37971,0.000771,172.217.194.0-255,5738,101565,64,227821
37972,0.000774,172.31.40.0-255,66,101631,64,227821
37973,0.00078,172.217.194.0-255,5738,107369,64,227821
37974,0.000782,172.31.40.0-255,66,107435,64,227821
37975,0.0008,172.217.194.0-255,3602,111037,64,227821
37976,0.000803,172.31.40.0-255,66,111103,64,227821
37977,0.001337,172.217.194.0-255,1484,112587,64,227821
37978,0.001342,172.217.194.0-255,2902,115489,64,227821
37979,0.001345,172.217.194.0-255,1484,116973,64,227821
37980,0.001351,172.31.40.0-255,66,117039,64,227821
37981,0.001368,172.217.194.0-255,4320,121359,64,227821
37982,0.001371,172.31.40.0-255,66,121425,64,227821
37983,0.001374,172.217.194.0-255,1484,122909,64,227821
37984,0.001399,172.31.40.0-255,66,122975,64,227821
37985,0.001402,172.217.194.0-255,1484,124459,64,227821
37986,0.001447,172.217.194.0-255,5738,130197,64,227821
37987,0.001451,172.31.40.0-255,66,130263,64,227821
37988,0.001467,172.217.194.0-255,3602,133865,64,227821
37989,0.001469,172.31.40.0-255,66,133931,64,227821
37990,0.001635,172.217.194.0-255,1484,135415,64,227821
37991,0.001653,172.217.194.0-255,2902,138317,64,227821
37992,0.001658,172.31.40.0-255,66,138383,64,227821
37993,0.001694,172.217.194.0-255,5738,144121,64,227821
37994,0.001697,172.31.40.0-255,66,144187,64,227821
37995,0.001701,172.217.194.0-255,1484,145671,64,227821
37996,0.001704,172.217.194.0-255,1484,147155,64,227821
37997,0.001705,172.31.40.0-255,66,147221,64,227821
37998,0.001723,172.217.194.0-255,7156,154377,64,227821
37999,0.001725,172.31.40.0-255,66,154443,64,227821
38000,0.001728,172.217.194.0-255,1484,155927,64,227821
38001,0.001754,172.31.40.0-255,66,155993,64,227821
38002,0.001783,172.217.194.0-255,2184,158177,64,227821
38003,0.001785,172.31.40.0-255,66,158243,64,227821
38004,0.001913,172.217.194.0-255,1484,159727,64,227821
38005,0.001918,172.217.194.0-255,2902,162629,64,227821
38006,0.001921,172.31.40.0-255,66,162695,64,227821
38007,0.001934,172.217.194.0-255,2902,165597,64,227821
38008,0.001936,172.31.40.0-255,66,165663,64,227821
38009,0.001962,172.217.194.0-255,2902,168565,64,227821
38010,0.001964,172.31.40.0-255,66,168631,64,227821
38011,0.001977,172.217.194.0-255,7156,175787,64,227821
38012,0.001979,172.31.40.0-255,66,175853,64,227821
38013,0.001994,172.31.40.0-255,66,175919,64,227821
38014,0.001998,172.217.194.0-255,2184,178103,64,227821
38015,0.002,172.31.40.0-255,66,178169,64,227821
38016,0.002049,172.217.194.0-255,1484,179653,64,227821
38017,0.002053,172.217.194.0-255,2902,182555,64,227821
38018,0.002055,172.31.40.0-255,66,182621,64,227821
38019,0.002073,172.217.194.0-255,5738,188359,64,227821
38020,0.002079,172.31.40.0-255,66,188425,64,227821
38021,0.002101,172.217.194.0-255,5738,194163,64,227821
38022,0.002104,172.31.40.0-255,66,194229,64,227821
38023,0.00211,172.217.194.0-255,4320,198549,64,227821
38024,0.002112,172.31.40.0-255,66,198615,64,227821
38025,0.002133,172.31.40.0-255,66,198681,64,227821
38026,0.002139,172.217.194.0-255,4320,203001,64,227821
38027,0.002142,172.31.40.0-255,66,203067,64,227821
38028,0.002169,172.217.194.0-255,3602,206669,64,227821
38029,0.002173,172.31.40.0-255,66,206735,64,227821
38030,0.002183,172.31.40.0-255,66,206801,64,227821
38031,0.002186,172.217.194.0-255,1484,208285,64,227821
38032,0.002207,172.31.40.0-255,66,208351,64,227821
38033,0.002227,172.31.40.0-255,66,208417,64,227821
38034,0.002237,172.31.40.0-255,66,208483,64,227821
38035,0.002253,172.217.194.0-255,4320,212803,64,227821
38036,0.002255,172.31.40.0-255,66,212869,64,227821
38037,0.002296,172.31.40.0-255,66,212935,64,227821
38038,0.002302,172.217.194.0-255,6438,219373,64,227821
38039,0.002305,172.31.40.0-255,66,219439,64,227821
38040,0.002342,172.217.194.0-255,4320,223759,64,227821
38041,0.002345,172.31.40.0-255,66,223825,64,227821
38042,0.002376,172.31.40.0-255,66,223891,64,227821
38043,0.002405,172.31.40.0-255,66,223957,64,227821
38044,0.002408,172.217.194.0-255,97,224054,64,227821
38045,0.002411,172.217.194.0-255,105,224159,64,227821
38046,0.003404,172.31.40.0-255,101,224260,64,227821
38047,0.005998,172.217.194.0-255,66,224326,64,227821
38048,0.013594,172.31.40.0-255,105,224431,64,227821
38049,0.016212,172.217.194.0-255,66,224497,64,227821
38050,0.033843,172.31.40.0-255,167,224664,64,227821
38051,0.033875,172.31.40.0-255,1107,225771,64,227821
38052,0.033935,172.31.40.0-255,1514,227285,64,227821
38053,0.033937,172.31.40.0-255,338,227623,64,227821
38054,0.03542,104.244.42.0-255,66,227689,64,227821
38055,0.035446,104.244.42.0-255,66,227755,64,227821
38056,0.035493,104.244.42.0-255,66,227821,64,227821
38057,0.0,74.125.24.0-255,152,152,64,223391
38058,2.2e-05,172.31.40.0-255,66,218,64,223391
38059,2.9e-05,74.125.24.0-255,1484,1702,64,223391
38060,3.3e-05,172.31.40.0-255,66,1768,64,223391
38061,4.9e-05,74.125.24.0-255,2902,4670,64,223391
38062,5.3e-05,172.31.40.0-255,66,4736,64,223391
38063,6.2e-05,74.125.24.0-255,7156,11892,64,223391
38064,6.6e-05,172.31.40.0-255,66,11958,64,223391
38065,8e-05,172.31.40.0-255,66,12024,64,223391
38066,8.7e-05,74.125.24.0-255,6797,18821,64,223391
38067,9.1e-05,172.31.40.0-255,66,18887,64,223391
38068,0.000158,74.125.24.0-255,1484,20371,64,223391
38069,0.000161,172.31.40.0-255,66,20437,64,223391
38070,0.000166,74.125.24.0-255,2902,23339,64,223391
38071,0.000168,172.31.40.0-255,66,23405,64,223391
38072,0.000205,74.125.24.0-255,5738,29143,64,223391
38073,0.000208,172.31.40.0-255,66,29209,64,223391
38074,0.000233,74.125.24.0-255,4320,33529,64,223391
38075,0.000235,172.31.40.0-255,66,33595,64,223391
38076,0.000273,172.31.40.0-255,66,33661,64,223391
38077,0.000286,172.31.40.0-255,66,33727,64,223391
38078,0.000289,74.125.24.0-255,646,34373,64,223391
38079,0.000291,172.31.40.0-255,66,34439,64,223391
38080,0.00036,74.125.24.0-255,1484,35923,64,223391
38081,0.000363,172.31.40.0-255,66,35989,64,223391
38082,0.000368,74.125.24.0-255,2902,38891,64,223391
38083,0.00037,172.31.40.0-255,66,38957,64,223391
38084,0.000373,74.125.24.0-255,1484,40441,64,223391
38085,0.00038,172.31.40.0-255,66,40507,64,223391
38086,0.000403,74.125.24.0-255,4320,44827,64,223391
38087,0.000406,172.31.40.0-255,66,44893,64,223391
38088,0.000444,74.125.24.0-255,6248,51141,64,223391
38089,0.000447,172.31.40.0-255,66,51207,64,223391
38090,0.00055,74.125.24.0-255,1484,52691,64,223391
38091,0.000557,74.125.24.0-255,2902,55593,64,223391
38092,0.00056,172.31.40.0-255,66,55659,64,223391
38093,0.000564,74.125.24.0-255,1484,57143,64,223391
38094,0.000587,74.125.24.0-255,4320,61463,64,223391
38095,0.000589,172.31.40.0-255,66,61529,64,223391
38096,0.000597,74.125.24.0-255,6797,68326,64,223391
38097,0.000599,172.31.40.0-255,66,68392,64,223391
38098,0.000635,172.31.40.0-255,66,68458,64,223391
38099,0.000639,74.125.24.0-255,2543,71001,64,223391
38100,0.000642,172.31.40.0-255,66,71067,64,223391
38101,0.000792,74.125.24.0-255,1484,72551,64,223391
38102,0.000798,74.125.24.0-255,1484,74035,64,223391
38103,0.000801,172.31.40.0-255,66,74101,64,223391
38104,0.000827,74.125.24.0-255,1484,75585,64,223391
38105,0.000834,74.125.24.0-255,5738,81323,64,223391
38106,0.000837,172.31.40.0-255,66,81389,64,223391
38107,0.000841,74.125.24.0-255,2902,84291,64,223391
38108,0.000843,172.31.40.0-255,66,84357,64,223391
38109,0.000887,172.31.40.0-255,66,84423,64,223391
38110,0.000925,172.31.40.0-255,66,84489,64,223391
38111,0.001197,74.125.24.0-255,1484,85973,64,223391
38112,0.001201,74.125.24.0-255,2902,88875,64,223391
38113,0.001212,172.31.40.0-255,66,88941,64,223391
38114,0.00122,74.125.24.0-255,5738,94679,64,223391
38115,0.001222,172.31.40.0-255,66,94745,64,223391
38116,0.00126,172.31.40.0-255,66,94811,64,223391
38117,0.001272,172.31.40.0-255,66,94877,64,223391
38118,0.001301,74.125.24.0-255,2184,97061,64,223391
38119,0.001303,172.31.40.0-255,66,97127,64,223391
38120,0.001376,74.125.24.0-255,1484,98611,64,223391
38121,0.001398,74.125.24.0-255,2902,101513,64,223391
38122,0.001402,172.31.40.0-255,66,101579,64,223391
38123,0.001408,74.125.24.0-255,4320,105899,64,223391
38124,0.001411,172.31.40.0-255,66,105965,64,223391
38125,0.001426,172.31.40.0-255,66,106031,64,223391
38126,0.001486,172.31.40.0-255,66,106097,64,223391
38127,0.001639,74.125.24.0-255,1484,107581,64,223391
38128,0.001644,74.125.24.0-255,1484,109065,64,223391
38129,0.001649,172.31.40.0-255,66,109131,64,223391
38130,0.001673,74.125.24.0-255,1484,110615,64,223391
38131,0.00168,74.125.24.0-255,5738,116353,64,223391
38132,0.001682,172.31.40.0-255,66,116419,64,223391
38133,0.001728,74.125.24.0-255,7156,123575,64,223391
38134,0.00173,172.31.40.0-255,66,123641,64,223391
38135,0.001754,74.125.24.0-255,5738,129379,64,223391
38136,0.001756,172.31.40.0-255,66,129445,64,223391
38137,0.00177,172.31.40.0-255,66,129511,64,223391
38138,0.001778,74.125.24.0-255,1484,130995,64,223391
38139,0.001783,74.125.24.0-255,2902,133897,64,223391
38140,0.001786,172.31.40.0-255,66,133963,64,223391
38141,0.001793,74.125.24.0-255,5738,139701,64,223391
38142,0.001796,172.31.40.0-255,66,139767,64,223391
38143,0.001835,172.31.40.0-255,66,139833,64,223391
38144,0.001846,172.31.40.0-255,66,139899,64,223391
38145,0.001871,74.125.24.0-255,3602,143501,64,223391
38146,0.001873,172.31.40.0-255,66,143567,64,223391
38147,0.001917,74.125.24.0-255,1484,145051,64,223391
38148,0.00193,74.125.24.0-255,2902,147953,64,223391
38149,0.001933,172.31.40.0-255,66,148019,64,223391
38150,0.001964,74.125.24.0-255,5738,153757,64,223391
38151,0.001967,172.31.40.0-255,66,153823,64,223391
38152,0.002003,172.31.40.0-255,66,153889,64,223391
38153,0.002006,74.125.24.0-255,1484,155373,64,223391
38154,0.002045,172.31.40.0-255,66,155439,64,223391
38155,0.002089,74.125.24.0-255,1484,156923,64,223391
38156,0.002106,74.125.24.0-255,2902,159825,64,223391
38157,0.002109,172.31.40.0-255,66,159891,64,223391
38158,0.002116,74.125.24.0-255,5738,165629,64,223391
38159,0.002119,172.31.40.0-255,66,165695,64,223391
38160,0.002131,74.125.24.0-255,7156,172851,64,223391
38161,0.002134,172.31.40.0-255,66,172917,64,223391
38162,0.002166,74.125.24.0-255,1484,174401,64,223391
38163,0.002181,172.31.40.0-255,66,174467,64,223391
38164,0.002187,74.125.24.0-255,5020,179487,64,223391
38165,0.002189,172.31.40.0-255,66,179553,64,223391
38166,0.002211,74.125.24.0-255,2902,182455,64,223391
38167,0.002213,172.31.40.0-255,66,182521,64,223391
38168,0.002244,74.125.24.0-255,7156,189677,64,223391
38169,0.002248,172.31.40.0-255,66,189743,64,223391
38170,0.002261,172.31.40.0-255,66,189809,64,223391
38171,0.002266,74.125.24.0-255,4320,194129,64,223391
38172,0.002268,172.31.40.0-255,66,194195,64,223391
38173,0.002295,172.31.40.0-255,66,194261,64,223391
38174,0.004547,74.125.24.0-255,5738,199999,64,223391
38175,0.004567,172.31.40.0-255,66,200065,64,223391
38176,0.006851,74.125.24.0-255,5738,205803,64,223391
38177,0.006869,172.31.40.0-255,66,205869,64,223391
38178,0.009112,74.125.24.0-255,5738,211607,64,223391
38179,0.009121,172.31.40.0-255,66,211673,64,223391
38180,0.011383,74.125.24.0-255,5738,217411,64,223391
38181,0.011389,172.31.40.0-255,66,217477,64,223391
38182,0.013637,74.125.24.0-255,1379,218856,64,223391
38183,0.017617,172.31.40.0-255,66,218922,64,223391
38184,0.017667,172.31.40.0-255,105,219027,64,223391
38185,0.019882,74.125.24.0-255,66,219093,64,223391
38186,0.047384,172.31.40.0-255,176,219269,64,223391
38187,0.047418,172.31.40.0-255,1112,220381,64,223391
38188,0.047474,172.31.40.0-255,1514,221895,64,223391
38189,0.047476,172.31.40.0-255,1298,223193,64,223391
38190,0.04888,104.244.42.0-255,66,223259,64,223391
38191,0.048905,104.244.42.0-255,66,223325,64,223391
38192,0.049,104.244.42.0-255,66,223391,64,223391
38193,0.0,172.217.194.0-255,297,297,64,207591
38194,1.8e-05,172.31.40.0-255,66,363,64,207591
38195,2.4e-05,172.217.194.0-255,1484,1847,64,207591
38196,2.9e-05,172.31.40.0-255,66,1913,64,207591
38197,3.5e-05,172.217.194.0-255,4320,6233,64,207591
38198,3.8e-05,172.31.40.0-255,66,6299,64,207591
38199,6.1e-05,172.31.40.0-255,66,6365,64,207591
38200,0.000111,172.217.194.0-255,1484,7849,64,207591
38201,0.000113,172.31.40.0-255,66,7915,64,207591
38202,0.000117,172.217.194.0-255,2902,10817,64,207591
38203,0.000119,172.31.40.0-255,66,10883,64,207591
38204,0.000131,172.217.194.0-255,2902,13785,64,207591
38205,0.000133,172.31.40.0-255,66,13851,64,207591
38206,0.000151,172.217.194.0-255,2902,16753,64,207591
38207,0.000153,172.31.40.0-255,66,16819,64,207591
38208,0.00018,172.217.194.0-255,6797,23616,64,207591
38209,0.000182,172.31.40.0-255,66,23682,64,207591
38210,0.00022,172.217.194.0-255,1484,25166,64,207591
38211,0.000223,172.31.40.0-255,66,25232,64,207591
38212,0.000226,172.217.194.0-255,1484,26716,64,207591
38213,0.000228,172.31.40.0-255,66,26782,64,207591
38214,0.000243,172.217.194.0-255,1484,28266,64,207591
38215,0.000245,172.31.40.0-255,66,28332,64,207591
38216,0.000251,172.217.194.0-255,5738,34070,64,207591
38217,0.000253,172.31.40.0-255,66,34136,64,207591
38218,0.000293,172.217.194.0-255,1484,35620,64,207591
38219,0.000295,172.31.40.0-255,66,35686,64,207591
38220,0.000308,172.217.194.0-255,1484,37170,64,207591
38221,0.00031,172.31.40.0-255,66,37236,64,207591
38222,0.000325,172.217.194.0-255,3961,41197,64,207591
38223,0.000327,172.31.40.0-255,66,41263,64,207591
38224,0.000342,172.217.194.0-255,1484,42747,64,207591
38225,0.000356,172.217.194.0-255,2902,45649,64,207591
38226,0.000378,172.217.194.0-255,2902,48551,64,207591
38227,0.000396,172.217.194.0-255,7156,55707,64,207591
38228,0.000421,172.217.194.0-255,2835,58542,64,207591
38229,0.000455,172.217.194.0-255,385,58927,64,207591
38230,0.000484,172.31.40.0-255,66,58993,64,207591
38231,0.000523,172.31.40.0-255,101,59094,64,207591
38232,0.000813,172.217.194.0-255,1484,60578,64,207591
38233,0.000849,172.217.194.0-255,2902,63480,64,207591
38234,0.000852,172.31.40.0-255,66,63546,64,207591
38235,0.000856,172.217.194.0-255,2902,66448,64,207591
38236,0.000864,172.31.40.0-255,66,66514,64,207591
38237,0.000876,172.217.194.0-255,2902,69416,64,207591
38238,0.000881,172.217.194.0-255,4320,73736,64,207591
38239,0.000888,172.217.194.0-255,7156,80892,64,207591
38240,0.000903,172.217.194.0-255,4320,85212,64,207591
38241,0.000908,172.31.40.0-255,66,85278,64,207591
38242,0.000982,172.217.194.0-255,4320,89598,64,207591
38243,0.000991,172.31.40.0-255,66,89664,64,207591
38244,0.001,172.217.194.0-255,3602,93266,64,207591
38245,0.001053,172.31.40.0-255,66,93332,64,207591
38246,0.001068,172.217.194.0-255,1484,94816,64,207591
38247,0.001075,172.217.194.0-255,5738,100554,64,207591
38248,0.00108,172.31.40.0-255,66,100620,64,207591
38249,0.0011,172.217.194.0-255,5738,106358,64,207591
38250,0.001108,172.31.40.0-255,66,106424,64,207591
38251,0.001152,172.217.194.0-255,4320,110744,64,207591
38252,0.001157,172.31.40.0-255,66,110810,64,207591
38253,0.001192,172.217.194.0-255,4471,115281,64,207591
38254,0.001196,172.31.40.0-255,66,115347,64,207591
38255,0.001281,172.217.194.0-255,2902,118249,64,207591
38256,0.001288,172.31.40.0-255,66,118315,64,207591
38257,0.001307,172.31.40.0-255,66,118381,64,207591
38258,0.001336,172.31.40.0-255,66,118447,64,207591
38259,0.001442,172.217.194.0-255,1484,119931,64,207591
38260,0.001456,172.217.194.0-255,2902,122833,64,207591
38261,0.001458,172.31.40.0-255,66,122899,64,207591
38262,0.001489,172.217.194.0-255,1484,124383,64,207591
38263,0.001503,172.217.194.0-255,4320,128703,64,207591
38264,0.001516,172.217.194.0-255,5738,134441,64,207591
38265,0.001521,172.31.40.0-255,66,134507,64,207591
38266,0.001539,172.217.194.0-255,7156,141663,64,207591
38267,0.001544,172.31.40.0-255,66,141729,64,207591
38268,0.001598,172.217.194.0-255,2902,144631,64,207591
38269,0.001613,172.31.40.0-255,66,144697,64,207591
38270,0.001674,172.217.194.0-255,3602,148299,64,207591
38271,0.0018,172.217.194.0-255,4320,152619,64,207591
38272,0.00194,172.217.194.0-255,4320,156939,64,207591
38273,0.002112,172.217.194.0-255,5738,162677,64,207591
38274,0.002245,172.217.194.0-255,7156,169833,64,207591
38275,0.002302,172.217.194.0-255,4320,174153,64,207591
38276,0.002566,172.217.194.0-255,7156,181309,64,207591
38277,0.00266,172.217.194.0-255,2902,184211,64,207591
38278,0.002904,172.217.194.0-255,66,184277,64,207591
38279,0.006771,172.31.40.0-255,66,184343,64,207591
38280,0.008731,172.217.194.0-255,5738,190081,64,207591
38281,0.008739,172.31.40.0-255,66,190147,64,207591
38282,0.010676,172.217.194.0-255,5738,195885,64,207591
38283,0.010683,172.31.40.0-255,66,195951,64,207591
38284,0.012632,172.217.194.0-255,3325,199276,64,207591
38285,0.012639,172.31.40.0-255,66,199342,64,207591
38286,0.012799,172.31.40.0-255,105,199447,64,207591
38287,0.018438,172.217.194.0-255,66,199513,64,207591
38288,0.035537,172.31.40.0-255,172,199685,64,207591
38289,0.03557,172.31.40.0-255,1111,200796,64,207591
38290,0.035636,172.31.40.0-255,1514,202310,64,207591
38291,0.035638,172.31.40.0-255,1514,203824,64,207591
38292,0.035644,172.31.40.0-255,1514,205338,64,207591
38293,0.035645,172.31.40.0-255,1514,206852,64,207591
38294,0.035669,172.31.40.0-255,475,207327,64,207591
38295,0.037091,104.244.42.0-255,66,207393,64,207591
38296,0.037122,104.244.42.0-255,66,207459,64,207591
38297,0.037223,104.244.42.0-255,66,207525,64,207591
38298,0.037236,104.244.42.0-255,66,207591,64,207591
38299,0.0,74.125.68.0-255,146,146,64,325202
38300,1.4e-05,172.31.40.0-255,66,212,64,325202
38301,3.5e-05,74.125.68.0-255,1484,1696,64,325202
38302,3.9e-05,172.31.40.0-255,66,1762,64,325202
38303,4.5e-05,74.125.68.0-255,2902,4664,64,325202
38304,4.7e-05,172.31.40.0-255,66,4730,64,325202
38305,7.2e-05,74.125.68.0-255,1484,6214,64,325202
38306,7.4e-05,172.31.40.0-255,66,6280,64,325202
38307,9.3e-05,74.125.68.0-255,5738,12018,64,325202
38308,9.6e-05,172.31.40.0-255,66,12084,64,325202
38309,0.0001,74.125.68.0-255,1983,14067,64,325202
38310,0.000101,172.31.40.0-255,66,14133,64,325202
38311,0.000117,74.125.68.0-255,1484,15617,64,325202
38312,0.00012,172.31.40.0-255,66,15683,64,325202
38313,0.000143,74.125.68.0-255,2902,18585,64,325202
38314,0.000145,172.31.40.0-255,66,18651,64,325202
38315,0.000151,74.125.68.0-255,5738,24389,64,325202
38316,0.000153,172.31.40.0-255,66,24455,64,325202
38317,0.000158,74.125.68.0-255,2902,27357,64,325202
38318,0.000159,172.31.40.0-255,66,27423,64,325202
38319,0.000173,74.125.68.0-255,1484,28907,64,325202
38320,0.000175,172.31.40.0-255,66,28973,64,325202
38321,0.000218,74.125.68.0-255,2543,31516,64,325202
38322,0.000221,172.31.40.0-255,66,31582,64,325202
38323,0.000265,74.125.68.0-255,1484,33066,64,325202
38324,0.000268,172.31.40.0-255,66,33132,64,325202
38325,0.000273,74.125.68.0-255,2902,36034,64,325202
38326,0.000275,172.31.40.0-255,66,36100,64,325202
38327,0.000288,74.125.68.0-255,1484,37584,64,325202
38328,0.00029,172.31.40.0-255,66,37650,64,325202
38329,0.000317,74.125.68.0-255,4320,41970,64,325202
38330,0.00032,172.31.40.0-255,66,42036,64,325202
38331,0.000327,74.125.68.0-255,6797,48833,64,325202
38332,0.000329,172.31.40.0-255,66,48899,64,325202
38333,0.000348,74.125.68.0-255,7156,56055,64,325202
38334,0.00035,172.31.40.0-255,66,56121,64,325202
38335,0.000363,74.125.68.0-255,2902,59023,64,325202
38336,0.000365,172.31.40.0-255,66,59089,64,325202
38337,0.000387,74.125.68.0-255,6797,65886,64,325202
38338,0.000389,172.31.40.0-255,66,65952,64,325202
38339,0.000433,74.125.68.0-255,413,66365,64,325202
38340,0.000477,74.125.68.0-255,330,66695,64,325202
38341,0.000706,74.125.68.0-255,1484,68179,64,325202
38342,0.000712,172.31.40.0-255,66,68245,64,325202
38343,0.000725,74.125.68.0-255,2902,71147,64,325202
38344,0.000727,172.31.40.0-255,66,71213,64,325202
38345,0.000758,74.125.68.0-255,5738,76951,64,325202
38346,0.000761,172.31.40.0-255,66,77017,64,325202
38347,0.000765,74.125.68.0-255,2902,79919,64,325202
38348,0.000767,172.31.40.0-255,66,79985,64,325202
38349,0.000817,74.125.68.0-255,5738,85723,64,325202
38350,0.00082,172.31.40.0-255,66,85789,64,325202
38351,0.000843,74.125.68.0-255,2902,88691,64,325202
38352,0.000845,172.31.40.0-255,66,88757,64,325202
38353,0.000857,172.31.40.0-255,66,88823,64,325202
38354,0.000861,74.125.68.0-255,2184,91007,64,325202
38355,0.000863,172.31.40.0-255,66,91073,64,325202
38356,0.001045,74.125.68.0-255,1484,92557,64,325202
38357,0.001074,74.125.68.0-255,2902,95459,64,325202
38358,0.001078,172.31.40.0-255,66,95525,64,325202
38359,0.001081,74.125.68.0-255,1484,97009,64,325202
38360,0.001101,74.125.68.0-255,4320,101329,64,325202
38361,0.001103,172.31.40.0-255,66,101395,64,325202
38362,0.001107,74.125.68.0-255,2902,104297,64,325202
38363,0.001109,172.31.40.0-255,66,104363,64,325202
38364,0.001125,74.125.68.0-255,2902,107265,64,325202
38365,0.001128,172.31.40.0-255,66,107331,64,325202
38366,0.001135,74.125.68.0-255,7156,114487,64,325202
38367,0.001137,172.31.40.0-255,66,114553,64,325202
38368,0.001179,74.125.68.0-255,4320,118873,64,325202
38369,0.001182,172.31.40.0-255,66,118939,64,325202
38370,0.001206,74.125.68.0-255,5738,124677,64,325202
38371,0.001208,74.125.68.0-255,766,125443,64,325202
38372,0.001213,172.31.40.0-255,66,125509,64,325202
38373,0.001638,74.125.68.0-255,1484,126993,64,325202
38374,0.001642,172.31.40.0-255,66,127059,64,325202
38375,0.001648,74.125.68.0-255,2902,129961,64,325202
38376,0.00165,172.31.40.0-255,66,130027,64,325202
38377,0.001673,74.125.68.0-255,4320,134347,64,325202
38378,0.001676,172.31.40.0-255,66,134413,64,325202
38379,0.001704,74.125.68.0-255,5738,140151,64,325202
38380,0.001707,172.31.40.0-255,66,140217,64,325202
38381,0.00174,172.31.40.0-255,66,140283,64,325202
38382,0.001766,74.125.68.0-255,1484,141767,64,325202
38383,0.001781,74.125.68.0-255,7156,148923,64,325202
38384,0.001784,172.31.40.0-255,66,148989,64,325202
38385,0.0018,74.125.68.0-255,766,149755,64,325202
38386,0.002006,74.125.68.0-255,1484,151239,64,325202
38387,0.002009,74.125.68.0-255,1484,152723,64,325202
38388,0.002014,172.31.40.0-255,66,152789,64,325202
38389,0.002025,74.125.68.0-255,1484,154273,64,325202
38390,0.002027,172.31.40.0-255,66,154339,64,325202
38391,0.002032,74.125.68.0-255,2902,157241,64,325202
38392,0.002034,172.31.40.0-255,66,157307,64,325202
38393,0.002057,74.125.68.0-255,2902,160209,64,325202
38394,0.002059,172.31.40.0-255,66,160275,64,325202
38395,0.002098,172.31.40.0-255,66,160341,64,325202
38396,0.002121,74.125.68.0-255,4320,164661,64,325202
38397,0.002127,74.125.68.0-255,4320,168981,64,325202
38398,0.002132,74.125.68.0-255,4320,173301,64,325202
38399,0.002135,172.31.40.0-255,66,173367,64,325202
38400,0.002138,172.31.40.0-255,66,173433,64,325202
38401,0.00214,172.31.40.0-255,66,173499,64,325202
38402,0.00215,74.125.68.0-255,2184,175683,64,325202
38403,0.002152,172.31.40.0-255,66,175749,64,325202
38404,0.004419,74.125.68.0-255,5738,181487,64,325202
38405,0.004427,172.31.40.0-255,66,181553,64,325202
38406,0.006696,74.125.68.0-255,5738,187291,64,325202
38407,0.0067,172.31.40.0-255,66,187357,64,325202
38408,0.008971,74.125.68.0-255,5738,193095,64,325202
38409,0.008977,172.31.40.0-255,66,193161,64,325202
38410,0.011258,74.125.68.0-255,5738,198899,64,325202
38411,0.011266,172.31.40.0-255,66,198965,64,325202
38412,0.013555,74.125.68.0-255,5738,204703,64,325202
38413,0.013563,172.31.40.0-255,66,204769,64,325202
38414,0.015831,74.125.68.0-255,5738,210507,64,325202
38415,0.015841,172.31.40.0-255,66,210573,64,325202
38416,0.018137,74.125.68.0-255,5738,216311,64,325202
38417,0.018146,172.31.40.0-255,66,216377,64,325202
38418,0.020425,74.125.68.0-255,5738,222115,64,325202
38419,0.020434,172.31.40.0-255,66,222181,64,325202
38420,0.022719,74.125.68.0-255,5738,227919,64,325202
38421,0.022727,172.31.40.0-255,66,227985,64,325202
38422,0.02502,74.125.68.0-255,5738,233723,64,325202
38423,0.025028,172.31.40.0-255,66,233789,64,325202
38424,0.02731,74.125.68.0-255,5738,239527,64,325202
38425,0.027319,172.31.40.0-255,66,239593,64,325202
38426,0.02961,74.125.68.0-255,5738,245331,64,325202
38427,0.029618,172.31.40.0-255,66,245397,64,325202
38428,0.031006,172.31.40.0-255,167,245564,64,325202
38429,0.031035,172.31.40.0-255,1111,246675,64,325202
38430,0.031095,172.31.40.0-255,1514,248189,64,325202
38431,0.031097,172.31.40.0-255,1297,249486,64,325202
38432,0.031911,74.125.68.0-255,5738,255224,64,325202
38433,0.031918,172.31.40.0-255,66,255290,64,325202
38434,0.032524,104.244.42.0-255,66,255356,64,325202
38435,0.032578,104.244.42.0-255,66,255422,64,325202
38436,0.032609,104.244.42.0-255,66,255488,64,325202
38437,0.034202,74.125.68.0-255,5738,261226,64,325202
38438,0.034209,172.31.40.0-255,66,261292,64,325202
38439,0.036499,74.125.68.0-255,5738,267030,64,325202
38440,0.036506,172.31.40.0-255,66,267096,64,325202
38441,0.038796,74.125.68.0-255,5738,272834,64,325202
38442,0.038803,172.31.40.0-255,66,272900,64,325202
38443,0.041075,74.125.68.0-255,5738,278638,64,325202
38444,0.041084,172.31.40.0-255,66,278704,64,325202
38445,0.04337,74.125.68.0-255,5738,284442,64,325202
38446,0.043377,172.31.40.0-255,66,284508,64,325202
38447,0.045658,74.125.68.0-255,5738,290246,64,325202
38448,0.045664,172.31.40.0-255,66,290312,64,325202
38449,0.047939,74.125.68.0-255,5738,296050,64,325202
38450,0.047945,172.31.40.0-255,66,296116,64,325202
38451,0.050231,74.125.68.0-255,5738,301854,64,325202
38452,0.050241,172.31.40.0-255,66,301920,64,325202
38453,0.05253,74.125.68.0-255,5738,307658,64,325202
38454,0.052537,172.31.40.0-255,66,307724,64,325202
38455,0.054815,74.125.68.0-255,5738,313462,64,325202
38456,0.054822,172.31.40.0-255,66,313528,64,325202
38457,0.057127,74.125.68.0-255,5738,319266,64,325202
38458,0.057133,172.31.40.0-255,66,319332,64,325202
38459,0.059407,74.125.68.0-255,4320,323652,64,325202
38460,0.059413,172.31.40.0-255,66,323718,64,325202
38461,0.059429,74.125.68.0-255,1484,325202,64,325202
38462,0.0,172.217.24.0-255,153,153,64,274585
38463,2.2e-05,172.31.40.0-255,66,219,64,274585
38464,2.9e-05,172.217.24.0-255,1484,1703,64,274585
38465,3.4e-05,172.31.40.0-255,66,1769,64,274585
38466,4e-05,172.217.24.0-255,2902,4671,64,274585
38467,4.4e-05,172.31.40.0-255,66,4737,64,274585
38468,5.1e-05,172.217.24.0-255,7156,11893,64,274585
38469,5.5e-05,172.31.40.0-255,66,11959,64,274585
38470,5.8e-05,172.217.24.0-255,2073,14032,64,274585
38471,6.2e-05,172.31.40.0-255,66,14098,64,274585
38472,0.000176,172.217.24.0-255,1484,15582,64,274585
38473,0.00018,172.31.40.0-255,66,15648,64,274585
38474,0.000186,172.217.24.0-255,2902,18550,64,274585
38475,0.000188,172.31.40.0-255,66,18616,64,274585
38476,0.000195,172.217.24.0-255,5738,24354,64,274585
38477,0.000197,172.31.40.0-255,66,24420,64,274585
38478,0.000246,172.217.24.0-255,2902,27322,64,274585
38479,0.000248,172.31.40.0-255,66,27388,64,274585
38480,0.000267,172.217.24.0-255,3961,31349,64,274585
38481,0.000269,172.31.40.0-255,66,31415,64,274585
38482,0.000284,172.217.24.0-255,4320,35735,64,274585
38483,0.000287,172.31.40.0-255,66,35801,64,274585
38484,0.000322,172.217.24.0-255,2902,38703,64,274585
38485,0.000324,172.31.40.0-255,66,38769,64,274585
38486,0.000336,172.31.40.0-255,66,38835,64,274585
38487,0.000338,172.217.24.0-255,1125,39960,64,274585
38488,0.000341,172.31.40.0-255,66,40026,64,274585
38489,0.00077,172.217.24.0-255,1484,41510,64,274585
38490,0.000777,172.217.24.0-255,2902,44412,64,274585
38491,0.000782,172.31.40.0-255,66,44478,64,274585
38492,0.000785,172.31.40.0-255,66,44544,64,274585
38493,0.000799,172.217.24.0-255,5738,50282,64,274585
38494,0.000802,172.31.40.0-255,66,50348,64,274585
38495,0.000808,172.217.24.0-255,2902,53250,64,274585
38496,0.000811,172.31.40.0-255,66,53316,64,274585
38497,0.000829,172.217.24.0-255,3961,57277,64,274585
38498,0.000833,172.31.40.0-255,66,57343,64,274585
38499,0.000835,172.217.24.0-255,395,57738,64,274585
38500,0.000989,172.31.40.0-255,66,57804,64,274585
38501,0.001183,172.217.24.0-255,113,57917,64,274585
38502,0.001317,172.217.24.0-255,1484,59401,64,274585
38503,0.001321,172.31.40.0-255,66,59467,64,274585
38504,0.001328,172.217.24.0-255,2902,62369,64,274585
38505,0.00133,172.31.40.0-255,66,62435,64,274585
38506,0.001336,172.217.24.0-255,4320,66755,64,274585
38507,0.001339,172.31.40.0-255,66,66821,64,274585
38508,0.001357,172.217.24.0-255,1484,68305,64,274585
38509,0.001365,172.217.24.0-255,6797,75102,64,274585
38510,0.001368,172.31.40.0-255,66,75168,64,274585
38511,0.001402,172.217.24.0-255,2902,78070,64,274585
38512,0.001404,172.31.40.0-255,66,78136,64,274585
38513,0.001408,172.217.24.0-255,1484,79620,64,274585
38514,0.001426,172.217.24.0-255,2902,82522,64,274585
38515,0.001428,172.31.40.0-255,66,82588,64,274585
38516,0.001436,172.217.24.0-255,7156,89744,64,274585
38517,0.001438,172.31.40.0-255,66,89810,64,274585
38518,0.001453,172.217.24.0-255,1484,91294,64,274585
38519,0.001457,172.217.24.0-255,1125,92419,64,274585
38520,0.001459,172.31.40.0-255,66,92485,64,274585
38521,0.003462,172.217.24.0-255,1484,93969,64,274585
38522,0.003479,172.217.24.0-255,2902,96871,64,274585
38523,0.003483,172.31.40.0-255,66,96937,64,274585
38524,0.003488,172.217.24.0-255,1484,98421,64,274585
38525,0.00538,172.217.24.0-255,4320,102741,64,274585
38526,0.005385,172.31.40.0-255,66,102807,64,274585
38527,0.007278,172.217.24.0-255,5738,108545,64,274585
38528,0.007284,172.31.40.0-255,66,108611,64,274585
38529,0.009188,172.217.24.0-255,5738,114349,64,274585
38530,0.009196,172.31.40.0-255,66,114415,64,274585
38531,0.0111,172.217.24.0-255,5738,120153,64,274585
38532,0.011109,172.31.40.0-255,66,120219,64,274585
38533,0.013002,172.217.24.0-255,5738,125957,64,274585
38534,0.013009,172.31.40.0-255,66,126023,64,274585
38535,0.014893,172.217.24.0-255,1484,127507,64,274585
38536,0.014917,172.217.24.0-255,4320,131827,64,274585
38537,0.014922,172.31.40.0-255,66,131893,64,274585
38538,0.016816,172.217.24.0-255,5738,137631,64,274585
38539,0.016824,172.31.40.0-255,66,137697,64,274585
38540,0.018731,172.217.24.0-255,5738,143435,64,274585
38541,0.018744,172.31.40.0-255,66,143501,64,274585
38542,0.020674,172.217.24.0-255,5738,149239,64,274585
38543,0.020682,172.31.40.0-255,66,149305,64,274585
38544,0.022575,172.217.24.0-255,5738,155043,64,274585
38545,0.022582,172.31.40.0-255,66,155109,64,274585
38546,0.024476,172.217.24.0-255,5738,160847,64,274585
38547,0.024483,172.31.40.0-255,66,160913,64,274585
38548,0.026367,172.217.24.0-255,5738,166651,64,274585
38549,0.026376,172.31.40.0-255,66,166717,64,274585
38550,0.028274,172.217.24.0-255,5738,172455,64,274585
38551,0.028282,172.31.40.0-255,66,172521,64,274585
38552,0.030191,172.217.24.0-255,5738,178259,64,274585
38553,0.030199,172.31.40.0-255,66,178325,64,274585
38554,0.032099,172.217.24.0-255,5738,184063,64,274585
38555,0.032108,172.31.40.0-255,66,184129,64,274585
38556,0.034002,172.217.24.0-255,5738,189867,64,274585
38557,0.034011,172.31.40.0-255,66,189933,64,274585
38558,0.035326,172.31.40.0-255,172,190105,64,274585
38559,0.035358,172.31.40.0-255,1112,191217,64,274585
38560,0.035422,172.31.40.0-255,1514,192731,64,274585
38561,0.035425,172.31.40.0-255,1514,194245,64,274585
38562,0.035431,172.31.40.0-255,1514,195759,64,274585
38563,0.035432,172.31.40.0-255,1514,197273,64,274585
38564,0.035449,172.31.40.0-255,1514,198787,64,274585
38565,0.03545,172.31.40.0-255,82,198869,64,274585
38566,0.035904,172.217.24.0-255,5738,204607,64,274585
38567,0.035911,172.31.40.0-255,66,204673,64,274585
38568,0.036892,104.244.42.0-255,66,204739,64,274585
38569,0.036932,104.244.42.0-255,66,204805,64,274585
38570,0.037024,104.244.42.0-255,66,204871,64,274585
38571,0.03703,104.244.42.0-255,66,204937,64,274585
38572,0.037809,172.217.24.0-255,5738,210675,64,274585
38573,0.037817,172.31.40.0-255,66,210741,64,274585
38574,0.039715,172.217.24.0-255,5738,216479,64,274585
38575,0.039723,172.31.40.0-255,66,216545,64,274585
38576,0.041627,172.217.24.0-255,5738,222283,64,274585
38577,0.041633,172.31.40.0-255,66,222349,64,274585
38578,0.043532,172.217.24.0-255,5738,228087,64,274585
38579,0.043539,172.31.40.0-255,66,228153,64,274585
38580,0.04544,172.217.24.0-255,5738,233891,64,274585
38581,0.045447,172.31.40.0-255,66,233957,64,274585
38582,0.04735,172.217.24.0-255,5738,239695,64,274585
38583,0.047357,172.31.40.0-255,66,239761,64,274585
38584,0.049262,172.217.24.0-255,5738,245499,64,274585
38585,0.049268,172.31.40.0-255,66,245565,64,274585
38586,0.051182,172.217.24.0-255,5738,251303,64,274585
38587,0.051197,172.31.40.0-255,66,251369,64,274585
38588,0.05311,172.217.24.0-255,5738,257107,64,274585
38589,0.053123,172.31.40.0-255,66,257173,64,274585
38590,0.055028,172.217.24.0-255,5738,262911,64,274585
38591,0.055041,172.31.40.0-255,66,262977,64,274585
38592,0.056938,172.217.24.0-255,5738,268715,64,274585
38593,0.056948,172.31.40.0-255,66,268781,64,274585
38594,0.05885,172.217.24.0-255,5738,274519,64,274585
38595,0.058865,172.31.40.0-255,66,274585,64,274585
38596,0.0,74.125.24.0-255,146,146,64,286027
38597,2.3e-05,172.31.40.0-255,66,212,64,286027
38598,3.1e-05,74.125.24.0-255,1484,1696,64,286027
38599,3.5e-05,172.31.40.0-255,66,1762,64,286027
38600,4.1e-05,74.125.24.0-255,2902,4664,64,286027
38601,4.5e-05,172.31.40.0-255,66,4730,64,286027
38602,5.2e-05,74.125.24.0-255,7156,11886,64,286027
38603,5.5e-05,172.31.40.0-255,66,11952,64,286027
38604,7.8e-05,74.125.24.0-255,2075,14027,64,286027
38605,8.1e-05,172.31.40.0-255,66,14093,64,286027
38606,8.6e-05,74.125.24.0-255,2902,16995,64,286027
38607,8.9e-05,172.31.40.0-255,66,17061,64,286027
38608,0.00012,74.125.24.0-255,7156,24217,64,286027
38609,0.000123,172.31.40.0-255,66,24283,64,286027
38610,0.000147,74.125.24.0-255,6797,31080,64,286027
38611,0.00015,172.31.40.0-255,66,31146,64,286027
38612,0.000213,74.125.24.0-255,1484,32630,64,286027
38613,0.000216,172.31.40.0-255,66,32696,64,286027
38614,0.000231,74.125.24.0-255,2902,35598,64,286027
38615,0.000233,172.31.40.0-255,66,35664,64,286027
38616,0.000238,74.125.24.0-255,2902,38566,64,286027
38617,0.000241,172.31.40.0-255,66,38632,64,286027
38618,0.000265,74.125.24.0-255,2902,41534,64,286027
38619,0.000268,172.31.40.0-255,66,41600,64,286027
38620,0.000271,74.125.24.0-255,1484,43084,64,286027
38621,0.000273,172.31.40.0-255,66,43150,64,286027
38622,0.000307,172.31.40.0-255,66,43216,64,286027
38623,0.000327,74.125.24.0-255,2902,46118,64,286027
38624,0.000329,172.31.40.0-255,66,46184,64,286027
38625,0.000354,74.125.24.0-255,7072,53256,64,286027
38626,0.000357,172.31.40.0-255,66,53322,64,286027
38627,0.000359,74.125.24.0-255,127,53449,64,286027
38628,0.000362,172.31.40.0-255,66,53515,64,286027
38629,0.000374,74.125.24.0-255,350,53865,64,286027
38630,0.000376,172.31.40.0-255,66,53931,64,286027
38631,0.000729,74.125.24.0-255,1484,55415,64,286027
38632,0.000734,172.31.40.0-255,66,55481,64,286027
38633,0.000757,74.125.24.0-255,2902,58383,64,286027
38634,0.00076,172.31.40.0-255,66,58449,64,286027
38635,0.000766,74.125.24.0-255,5738,64187,64,286027
38636,0.000769,172.31.40.0-255,66,64253,64,286027
38637,0.000804,172.31.40.0-255,66,64319,64,286027
38638,0.000808,74.125.24.0-255,2902,67221,64,286027
38639,0.00081,172.31.40.0-255,66,67287,64,286027
38640,0.000828,74.125.24.0-255,5738,73025,64,286027
38641,0.00083,172.31.40.0-255,66,73091,64,286027
38642,0.000846,74.125.24.0-255,2184,75275,64,286027
38643,0.000849,172.31.40.0-255,66,75341,64,286027
38644,0.001006,74.125.24.0-255,1484,76825,64,286027
38645,0.001011,172.31.40.0-255,66,76891,64,286027
38646,0.001016,74.125.24.0-255,2902,79793,64,286027
38647,0.001019,172.31.40.0-255,66,79859,64,286027
38648,0.001025,74.125.24.0-255,5738,85597,64,286027
38649,0.001028,172.31.40.0-255,66,85663,64,286027
38650,0.001065,172.31.40.0-255,66,85729,64,286027
38651,0.001136,172.31.40.0-255,66,85795,64,286027
38652,0.001551,74.125.24.0-255,1484,87279,64,286027
38653,0.001557,172.31.40.0-255,66,87345,64,286027
38654,0.001562,74.125.24.0-255,2902,90247,64,286027
38655,0.001564,172.31.40.0-255,66,90313,64,286027
38656,0.001571,74.125.24.0-255,5738,96051,64,286027
38657,0.001573,172.31.40.0-255,66,96117,64,286027
38658,0.001598,74.125.24.0-255,4320,100437,64,286027
38659,0.001603,172.31.40.0-255,66,100503,64,286027
38660,0.001612,74.125.24.0-255,4320,104823,64,286027
38661,0.001614,172.31.40.0-255,66,104889,64,286027
38662,0.00164,74.125.24.0-255,4320,109209,64,286027
38663,0.001643,172.31.40.0-255,66,109275,64,286027
38664,0.001653,172.31.40.0-255,66,109341,64,286027
38665,0.001657,74.125.24.0-255,2184,111525,64,286027
38666,0.001674,172.31.40.0-255,66,111591,64,286027
38667,0.001687,74.125.24.0-255,2902,114493,64,286027
38668,0.001704,172.31.40.0-255,66,114559,64,286027
38669,0.001721,74.125.24.0-255,7156,121715,64,286027
38670,0.001728,74.125.24.0-255,5738,127453,64,286027
38671,0.001735,74.125.24.0-255,7156,134609,64,286027
38672,0.001763,74.125.24.0-255,7156,141765,64,286027
38673,0.001768,74.125.24.0-255,3602,145367,64,286027
38674,0.00177,172.31.40.0-255,66,145433,64,286027
38675,0.001782,172.31.40.0-255,66,145499,64,286027
38676,0.001829,74.125.24.0-255,1484,146983,64,286027
38677,0.001834,74.125.24.0-255,2902,149885,64,286027
38678,0.001852,74.125.24.0-255,2902,152787,64,286027
38679,0.001855,172.31.40.0-255,66,152853,64,286027
38680,0.001865,172.31.40.0-255,66,152919,64,286027
38681,0.001875,74.125.24.0-255,1484,154403,64,286027
38682,0.001895,74.125.24.0-255,2902,157305,64,286027
38683,0.001908,74.125.24.0-255,2902,160207,64,286027
38684,0.001927,74.125.24.0-255,7156,167363,64,286027
38685,0.001943,172.31.40.0-255,66,167429,64,286027
38686,0.001959,74.125.24.0-255,1484,168913,64,286027
38687,0.001981,74.125.24.0-255,2184,171097,64,286027
38688,0.001987,172.31.40.0-255,66,171163,64,286027
38689,0.002059,74.125.24.0-255,1484,172647,64,286027
38690,0.002064,74.125.24.0-255,2902,175549,64,286027
38691,0.002067,74.125.24.0-255,1484,177033,64,286027
38692,0.002077,172.31.40.0-255,66,177099,64,286027
38693,0.002088,74.125.24.0-255,4320,181419,64,286027
38694,0.002106,172.31.40.0-255,66,181485,64,286027
38695,0.00216,74.125.24.0-255,1484,182969,64,286027
38696,0.002169,172.31.40.0-255,66,183035,64,286027
38697,0.002179,74.125.24.0-255,2902,185937,64,286027
38698,0.002195,74.125.24.0-255,5738,191675,64,286027
38699,0.002212,74.125.24.0-255,4320,195995,64,286027
38700,0.002242,172.31.40.0-255,66,196061,64,286027
38701,0.002302,74.125.24.0-255,2184,198245,64,286027
38702,0.002324,172.31.40.0-255,66,198311,64,286027
38703,0.002345,74.125.24.0-255,5738,204049,64,286027
38704,0.002354,172.31.40.0-255,66,204115,64,286027
38705,0.004611,74.125.24.0-255,5738,209853,64,286027
38706,0.004618,172.31.40.0-255,66,209919,64,286027
38707,0.006879,74.125.24.0-255,5738,215657,64,286027
38708,0.006886,172.31.40.0-255,66,215723,64,286027
38709,0.009146,74.125.24.0-255,5738,221461,64,286027
38710,0.009154,172.31.40.0-255,66,221527,64,286027
38711,0.011428,74.125.24.0-255,5738,227265,64,286027
38712,0.011435,172.31.40.0-255,66,227331,64,286027
38713,0.013702,74.125.24.0-255,5738,233069,64,286027
38714,0.013711,172.31.40.0-255,66,233135,64,286027
38715,0.015988,74.125.24.0-255,5738,238873,64,286027
38716,0.015998,172.31.40.0-255,66,238939,64,286027
38717,0.018277,74.125.24.0-255,5738,244677,64,286027
38718,0.018285,172.31.40.0-255,66,244743,64,286027
38719,0.020536,74.125.24.0-255,5738,250481,64,286027
38720,0.020544,172.31.40.0-255,66,250547,64,286027
38721,0.022827,74.125.24.0-255,5738,256285,64,286027
38722,0.022838,172.31.40.0-255,66,256351,64,286027
38723,0.025103,74.125.24.0-255,5738,262089,64,286027
38724,0.025114,172.31.40.0-255,66,262155,64,286027
38725,0.02739,74.125.24.0-255,5738,267893,64,286027
38726,0.027398,172.31.40.0-255,66,267959,64,286027
38727,0.029642,74.125.24.0-255,5738,273697,64,286027
38728,0.029649,172.31.40.0-255,66,273763,64,286027
38729,0.031938,74.125.24.0-255,5738,279501,64,286027
38730,0.031948,172.31.40.0-255,66,279567,64,286027
38731,0.034213,74.125.24.0-255,1929,281496,64,286027
38732,0.034223,172.31.40.0-255,66,281562,64,286027
38733,0.034446,172.31.40.0-255,105,281667,64,286027
38734,0.036683,74.125.24.0-255,66,281733,64,286027
38735,0.052391,172.31.40.0-255,172,281905,64,286027
38736,0.052424,172.31.40.0-255,1112,283017,64,286027
38737,0.052481,172.31.40.0-255,1514,284531,64,286027
38738,0.052483,172.31.40.0-255,1298,285829,64,286027
38739,0.053887,104.244.42.0-255,66,285895,64,286027
38740,0.053925,104.244.42.0-255,66,285961,64,286027
38741,0.05398,104.244.42.0-255,66,286027,64,286027
38742,0.0,172.217.194.0-255,146,146,64,243815
38743,2.5e-05,172.31.40.0-255,66,212,64,243815
38744,3.2e-05,172.217.194.0-255,1484,1696,64,243815
38745,3.7e-05,172.31.40.0-255,66,1762,64,243815
38746,5.9e-05,172.217.194.0-255,2902,4664,64,243815
38747,6.3e-05,172.31.40.0-255,66,4730,64,243815
38748,7.1e-05,172.217.194.0-255,7156,11886,64,243815
38749,7.5e-05,172.31.40.0-255,66,11952,64,243815
38750,7.9e-05,172.217.194.0-255,2100,14052,64,243815
38751,8.2e-05,172.31.40.0-255,66,14118,64,243815
38752,0.000164,172.217.194.0-255,1484,15602,64,243815
38753,0.000167,172.31.40.0-255,66,15668,64,243815
38754,0.000173,172.217.194.0-255,2902,18570,64,243815
38755,0.000175,172.31.40.0-255,66,18636,64,243815
38756,0.000198,172.217.194.0-255,5738,24374,64,243815
38757,0.000205,172.31.40.0-255,66,24440,64,243815
38758,0.000212,172.217.194.0-255,6797,31237,64,243815
38759,0.000214,172.31.40.0-255,66,31303,64,243815
38760,0.000596,172.217.194.0-255,1484,32787,64,243815
38761,0.000602,172.31.40.0-255,66,32853,64,243815
38762,0.000609,172.217.194.0-255,2902,35755,64,243815
38763,0.000611,172.31.40.0-255,66,35821,64,243815
38764,0.000622,172.217.194.0-255,5738,41559,64,243815
38765,0.000625,172.31.40.0-255,66,41625,64,243815
38766,0.000674,172.31.40.0-255,66,41691,64,243815
38767,0.000693,172.31.40.0-255,66,41757,64,243815
38768,0.000948,172.217.194.0-255,379,42136,64,243815
38769,0.000952,172.31.40.0-255,66,42202,64,243815
38770,0.000998,172.217.194.0-255,365,42567,64,243815
38771,0.001002,172.31.40.0-255,66,42633,64,243815
38772,0.001273,172.217.194.0-255,1484,44117,64,243815
38773,0.001278,172.31.40.0-255,66,44183,64,243815
38774,0.001286,172.217.194.0-255,2902,47085,64,243815
38775,0.001288,172.31.40.0-255,66,47151,64,243815
38776,0.0013,172.217.194.0-255,5738,52889,64,243815
38777,0.001302,172.31.40.0-255,66,52955,64,243815
38778,0.001341,172.31.40.0-255,66,53021,64,243815
38779,0.001357,172.31.40.0-255,66,53087,64,243815
38780,0.00136,172.217.194.0-255,766,53853,64,243815
38781,0.001362,172.31.40.0-255,66,53919,64,243815
38782,0.001844,172.217.194.0-255,1484,55403,64,243815
38783,0.00185,172.31.40.0-255,66,55469,64,243815
38784,0.001857,172.217.194.0-255,2902,58371,64,243815
38785,0.001859,172.31.40.0-255,66,58437,64,243815
38786,0.001863,172.217.194.0-255,1484,59921,64,243815
38787,0.00187,172.31.40.0-255,66,59987,64,243815
38788,0.001913,172.217.194.0-255,4320,64307,64,243815
38789,0.001916,172.31.40.0-255,66,64373,64,243815
38790,0.001927,172.31.40.0-255,66,64439,64,243815
38791,0.001935,172.217.194.0-255,1484,65923,64,243815
38792,0.001937,172.31.40.0-255,66,65989,64,243815
38793,0.002028,172.217.194.0-255,1484,67473,64,243815
38794,0.002034,172.217.194.0-255,2902,70375,64,243815
38795,0.002052,172.217.194.0-255,5738,76113,64,243815
38796,0.00207,172.217.194.0-255,2902,79015,64,243815
38797,0.002101,172.217.194.0-255,7156,86171,64,243815
38798,0.002122,172.217.194.0-255,3602,89773,64,243815
38799,0.002226,172.217.194.0-255,1484,91257,64,243815
38800,0.002244,172.217.194.0-255,2902,94159,64,243815
38801,0.002248,172.217.194.0-255,2902,97061,64,243815
38802,0.00226,172.217.194.0-255,2902,99963,64,243815
38803,0.002293,172.217.194.0-255,2902,102865,64,243815
38804,0.002312,172.217.194.0-255,4320,107185,64,243815
38805,0.005304,172.31.40.0-255,66,107251,64,243815
38806,0.007604,172.217.194.0-255,5738,112989,64,243815
38807,0.007611,172.31.40.0-255,66,113055,64,243815
38808,0.009834,172.217.194.0-255,4320,117375,64,243815
38809,0.009845,172.31.40.0-255,66,117441,64,243815
38810,0.009876,172.217.194.0-255,1484,118925,64,243815
38811,0.009879,172.31.40.0-255,66,118991,64,243815
38812,0.012111,172.217.194.0-255,4320,123311,64,243815
38813,0.01212,172.31.40.0-255,66,123377,64,243815
38814,0.012184,172.217.194.0-255,1484,124861,64,243815
38815,0.014375,172.217.194.0-255,4320,129181,64,243815
38816,0.014383,172.31.40.0-255,66,129247,64,243815
38817,0.016617,172.217.194.0-255,5738,134985,64,243815
38818,0.016674,172.31.40.0-255,66,135051,64,243815
38819,0.018924,172.217.194.0-255,5738,140789,64,243815
38820,0.01893,172.31.40.0-255,66,140855,64,243815
38821,0.021171,172.217.194.0-255,5738,146593,64,243815
38822,0.02118,172.31.40.0-255,66,146659,64,243815
38823,0.023412,172.217.194.0-255,5738,152397,64,243815
38824,0.023419,172.31.40.0-255,66,152463,64,243815
38825,0.025688,172.217.194.0-255,5738,158201,64,243815
38826,0.025698,172.31.40.0-255,66,158267,64,243815
38827,0.027945,172.217.194.0-255,5738,164005,64,243815
38828,0.027954,172.31.40.0-255,66,164071,64,243815
38829,0.030235,172.217.194.0-255,5738,169809,64,243815
38830,0.030252,172.31.40.0-255,66,169875,64,243815
38831,0.032545,172.217.194.0-255,5738,175613,64,243815
38832,0.033314,172.31.40.0-255,66,175679,64,243815
38833,0.035612,172.217.194.0-255,5738,181417,64,243815
38834,0.035629,172.31.40.0-255,66,181483,64,243815
38835,0.037855,172.217.194.0-255,5738,187221,64,243815
38836,0.037866,172.31.40.0-255,66,187287,64,243815
38837,0.040172,172.217.194.0-255,5738,193025,64,243815
38838,0.040191,172.31.40.0-255,66,193091,64,243815
38839,0.042152,172.31.40.0-255,172,193263,64,243815
38840,0.042181,172.31.40.0-255,1113,194376,64,243815
38841,0.042242,172.31.40.0-255,1514,195890,64,243815
38842,0.042244,172.31.40.0-255,1295,197185,64,243815
38843,0.042467,172.217.194.0-255,5738,202923,64,243815
38844,0.042474,172.31.40.0-255,66,202989,64,243815
38845,0.043733,104.244.42.0-255,66,203055,64,243815
38846,0.043778,104.244.42.0-255,66,203121,64,243815
38847,0.043841,104.244.42.0-255,66,203187,64,243815
38848,0.044724,172.217.194.0-255,5738,208925,64,243815
38849,0.044733,172.31.40.0-255,66,208991,64,243815
38850,0.047039,172.217.194.0-255,5738,214729,64,243815
38851,0.047056,172.31.40.0-255,66,214795,64,243815
38852,0.049351,172.217.194.0-255,5738,220533,64,243815
38853,0.049369,172.31.40.0-255,66,220599,64,243815
38854,0.051659,172.217.194.0-255,5738,226337,64,243815
38855,0.051676,172.31.40.0-255,66,226403,64,243815
38856,0.0539,172.217.194.0-255,5738,232141,64,243815
38857,0.053908,172.31.40.0-255,66,232207,64,243815
38858,0.056185,172.217.194.0-255,5738,237945,64,243815
38859,0.056203,172.31.40.0-255,66,238011,64,243815
38860,0.058492,172.217.194.0-255,5738,243749,64,243815
38861,0.058505,172.31.40.0-255,66,243815,64,243815
38862,0.0,74.125.24.0-255,146,146,64,288157
38863,2.3e-05,172.31.40.0-255,66,212,64,288157
38864,3.2e-05,74.125.24.0-255,1484,1696,64,288157
38865,3.7e-05,172.31.40.0-255,66,1762,64,288157
38866,5e-05,74.125.24.0-255,2902,4664,64,288157
38867,5.4e-05,172.31.40.0-255,66,4730,64,288157
38868,6.1e-05,74.125.24.0-255,5738,10468,64,288157
38869,6.4e-05,172.31.40.0-255,66,10534,64,288157
38870,7.1e-05,74.125.24.0-255,6295,16829,64,288157
38871,7.5e-05,172.31.40.0-255,66,16895,64,288157
38872,8.8e-05,172.31.40.0-255,66,16961,64,288157
38873,0.00012,74.125.24.0-255,5379,22340,64,288157
38874,0.000123,172.31.40.0-255,66,22406,64,288157
38875,0.000393,74.125.24.0-255,1484,23890,64,288157
38876,0.000396,172.31.40.0-255,66,23956,64,288157
38877,0.00042,74.125.24.0-255,2902,26858,64,288157
38878,0.000423,172.31.40.0-255,66,26924,64,288157
38879,0.00043,74.125.24.0-255,5738,32662,64,288157
38880,0.000432,172.31.40.0-255,66,32728,64,288157
38881,0.000469,172.31.40.0-255,66,32794,64,288157
38882,0.000523,172.31.40.0-255,66,32860,64,288157
38883,0.000546,74.125.24.0-255,2816,35676,64,288157
38884,0.000549,172.31.40.0-255,66,35742,64,288157
38885,0.000552,74.125.24.0-255,382,36124,64,288157
38886,0.000553,172.31.40.0-255,66,36190,64,288157
38887,0.000735,74.125.24.0-255,1484,37674,64,288157
38888,0.000738,172.31.40.0-255,66,37740,64,288157
38889,0.000743,74.125.24.0-255,2902,40642,64,288157
38890,0.000745,172.31.40.0-255,66,40708,64,288157
38891,0.000753,74.125.24.0-255,2902,43610,64,288157
38892,0.000783,74.125.24.0-255,2902,46512,64,288157
38893,0.000791,74.125.24.0-255,6797,53309,64,288157
38894,0.000794,74.125.24.0-255,1484,54793,64,288157
38895,0.000826,74.125.24.0-255,2543,57336,64,288157
38896,0.001032,74.125.24.0-255,1484,58820,64,288157
38897,0.001047,74.125.24.0-255,2902,61722,64,288157
38898,0.001065,74.125.24.0-255,5738,67460,64,288157
38899,0.001093,74.125.24.0-255,4320,71780,64,288157
38900,0.001118,74.125.24.0-255,2902,74682,64,288157
38901,0.001131,74.125.24.0-255,1484,76166,64,288157
38902,0.001153,74.125.24.0-255,4320,80486,64,288157
38903,0.001167,74.125.24.0-255,2184,82670,64,288157
38904,0.001215,74.125.24.0-255,1484,84154,64,288157
38905,0.001234,74.125.24.0-255,2902,87056,64,288157
38906,0.001256,74.125.24.0-255,2902,89958,64,288157
38907,0.001267,74.125.24.0-255,1484,91442,64,288157
38908,0.001274,74.125.24.0-255,5738,97180,64,288157
38909,0.001307,74.125.24.0-255,4320,101500,64,288157
38910,0.001352,74.125.24.0-255,5738,107238,64,288157
38911,0.001391,74.125.24.0-255,1484,108722,64,288157
38912,0.001411,74.125.24.0-255,5738,114460,64,288157
38913,0.001415,74.125.24.0-255,2184,116644,64,288157
38914,0.001632,74.125.24.0-255,1484,118128,64,288157
38915,0.001655,74.125.24.0-255,2902,121030,64,288157
38916,0.001658,74.125.24.0-255,1484,122514,64,288157
38917,0.001683,74.125.24.0-255,1484,123998,64,288157
38918,0.001712,74.125.24.0-255,4320,128318,64,288157
38919,0.001729,74.125.24.0-255,4320,132638,64,288157
38920,0.001789,74.125.24.0-255,5020,137658,64,288157
38921,0.00186,172.31.40.0-255,66,137724,64,288157
38922,0.003934,74.125.24.0-255,5738,143462,64,288157
38923,0.003942,172.31.40.0-255,66,143528,64,288157
38924,0.005993,74.125.24.0-255,4320,147848,64,288157
38925,0.006015,74.125.24.0-255,1484,149332,64,288157
38926,0.009354,172.31.40.0-255,66,149398,64,288157
38927,0.01141,74.125.24.0-255,5738,155136,64,288157
38928,0.011418,172.31.40.0-255,66,155202,64,288157
38929,0.013467,74.125.24.0-255,5738,160940,64,288157
38930,0.013902,172.31.40.0-255,66,161006,64,288157
38931,0.015972,74.125.24.0-255,5738,166744,64,288157
38932,0.015983,172.31.40.0-255,66,166810,64,288157
38933,0.018051,74.125.24.0-255,5738,172548,64,288157
38934,0.018059,172.31.40.0-255,66,172614,64,288157
38935,0.020109,74.125.24.0-255,5738,178352,64,288157
38936,0.020116,172.31.40.0-255,66,178418,64,288157
38937,0.022183,74.125.24.0-255,5738,184156,64,288157
38938,0.02219,172.31.40.0-255,66,184222,64,288157
38939,0.024244,74.125.24.0-255,5738,189960,64,288157
38940,0.024252,172.31.40.0-255,66,190026,64,288157
38941,0.026294,74.125.24.0-255,5738,195764,64,288157
38942,0.026301,172.31.40.0-255,66,195830,64,288157
38943,0.028361,74.125.24.0-255,5738,201568,64,288157
38944,0.029886,172.31.40.0-255,66,201634,64,288157
38945,0.03196,74.125.24.0-255,5738,207372,64,288157
38946,0.031976,172.31.40.0-255,66,207438,64,288157
38947,0.034026,74.125.24.0-255,5738,213176,64,288157
38948,0.03404,172.31.40.0-255,66,213242,64,288157
38949,0.036107,74.125.24.0-255,5738,218980,64,288157
38950,0.036122,172.31.40.0-255,66,219046,64,288157
38951,0.038168,74.125.24.0-255,5738,224784,64,288157
38952,0.038175,172.31.40.0-255,66,224850,64,288157
38953,0.039337,172.31.40.0-255,167,225017,64,288157
38954,0.039369,172.31.40.0-255,1112,226129,64,288157
38955,0.039426,172.31.40.0-255,1514,227643,64,288157
38956,0.039428,172.31.40.0-255,1514,229157,64,288157
38957,0.039453,172.31.40.0-255,696,229853,64,288157
38958,0.040234,74.125.24.0-255,5738,235591,64,288157
38959,0.040242,172.31.40.0-255,66,235657,64,288157
38960,0.040875,104.244.42.0-255,66,235723,64,288157
38961,0.041053,104.244.42.0-255,66,235789,64,288157
38962,0.041092,104.244.42.0-255,66,235855,64,288157
38963,0.041096,104.244.42.0-255,66,235921,64,288157
38964,0.042272,74.125.24.0-255,5738,241659,64,288157
38965,0.042282,172.31.40.0-255,66,241725,64,288157
38966,0.044322,74.125.24.0-255,5738,247463,64,288157
38967,0.044338,172.31.40.0-255,66,247529,64,288157
38968,0.046399,74.125.24.0-255,5738,253267,64,288157
38969,0.046414,172.31.40.0-255,66,253333,64,288157
38970,0.048492,74.125.24.0-255,5738,259071,64,288157
38971,0.048505,172.31.40.0-255,66,259137,64,288157
38972,0.050581,74.125.24.0-255,5738,264875,64,288157
38973,0.05059,172.31.40.0-255,66,264941,64,288157
38974,0.052623,74.125.24.0-255,5738,270679,64,288157
38975,0.052637,172.31.40.0-255,66,270745,64,288157
38976,0.05465,74.125.24.0-255,5738,276483,64,288157
38977,0.054661,172.31.40.0-255,66,276549,64,288157
38978,0.05671,74.125.24.0-255,5738,282287,64,288157
38979,0.056718,172.31.40.0-255,66,282353,64,288157
38980,0.058833,74.125.24.0-255,5738,288091,64,288157
38981,0.058848,172.31.40.0-255,66,288157,64,288157
38982,0.0,172.217.194.0-255,153,153,64,219969
38983,2.1e-05,172.31.40.0-255,66,219,64,219969
38984,2.8e-05,172.217.194.0-255,1484,1703,64,219969
38985,3.2e-05,172.31.40.0-255,66,1769,64,219969
38986,3.7e-05,172.217.194.0-255,2902,4671,64,219969
38987,3.9e-05,172.31.40.0-255,66,4737,64,219969
38988,4.6e-05,172.217.194.0-255,7156,11893,64,219969
38989,4.8e-05,172.31.40.0-255,66,11959,64,219969
38990,5.2e-05,172.217.194.0-255,2028,13987,64,219969
38991,5.4e-05,172.31.40.0-255,66,14053,64,219969
38992,8e-05,172.217.194.0-255,2902,16955,64,219969
38993,8.3e-05,172.31.40.0-255,66,17021,64,219969
38994,8.5e-05,172.217.194.0-255,1484,18505,64,219969
38995,8.7e-05,172.31.40.0-255,66,18571,64,219969
38996,0.000107,172.217.194.0-255,5738,24309,64,219969
38997,0.00011,172.31.40.0-255,66,24375,64,219969
38998,0.000116,172.217.194.0-255,5738,30113,64,219969
38999,0.000118,172.31.40.0-255,66,30179,64,219969
39000,0.000164,172.217.194.0-255,1484,31663,64,219969
39001,0.000166,172.31.40.0-255,66,31729,64,219969
39002,0.000197,172.31.40.0-255,66,31795,64,219969
39003,0.000201,172.217.194.0-255,2543,34338,64,219969
39004,0.000203,172.31.40.0-255,66,34404,64,219969
39005,0.000493,172.217.194.0-255,1484,35888,64,219969
39006,0.000498,172.31.40.0-255,66,35954,64,219969
39007,0.000518,172.217.194.0-255,2902,38856,64,219969
39008,0.000521,172.31.40.0-255,66,38922,64,219969
39009,0.000527,172.217.194.0-255,5738,44660,64,219969
39010,0.000528,172.31.40.0-255,66,44726,64,219969
39011,0.000569,172.217.194.0-255,7156,51882,64,219969
39012,0.000573,172.31.40.0-255,66,51948,64,219969
39013,0.00059,172.217.194.0-255,286,52234,64,219969
39014,0.000632,172.217.194.0-255,5738,57972,64,219969
39015,0.000635,172.31.40.0-255,66,58038,64,219969
39016,0.000641,172.217.194.0-255,5738,63776,64,219969
39017,0.000643,172.31.40.0-255,66,63842,64,219969
39018,0.000654,172.217.194.0-255,1484,65326,64,219969
39019,0.000668,172.217.194.0-255,7156,72482,64,219969
39020,0.00067,172.31.40.0-255,66,72548,64,219969
39021,0.000705,172.31.40.0-255,66,72614,64,219969
39022,0.000711,172.217.194.0-255,5379,77993,64,219969
39023,0.000713,172.31.40.0-255,66,78059,64,219969
39024,0.000743,172.217.194.0-255,2902,80961,64,219969
39025,0.000745,172.31.40.0-255,66,81027,64,219969
39026,0.000766,172.31.40.0-255,66,81093,64,219969
39027,0.000793,172.217.194.0-255,4716,85809,64,219969
39028,0.000795,172.31.40.0-255,66,85875,64,219969
39029,0.000798,172.217.194.0-255,212,86087,64,219969
39030,0.001036,172.217.194.0-255,1484,87571,64,219969
39031,0.00104,172.31.40.0-255,66,87637,64,219969
39032,0.001045,172.217.194.0-255,2902,90539,64,219969
39033,0.001046,172.31.40.0-255,66,90605,64,219969
39034,0.001049,172.217.194.0-255,1484,92089,64,219969
39035,0.001066,172.217.194.0-255,4320,96409,64,219969
39036,0.001068,172.31.40.0-255,66,96475,64,219969
39037,0.00107,172.217.194.0-255,1484,97959,64,219969
39038,0.001092,172.31.40.0-255,66,98025,64,219969
39039,0.00111,172.217.194.0-255,2902,100927,64,219969
39040,0.001112,172.31.40.0-255,66,100993,64,219969
39041,0.001124,172.31.40.0-255,66,101059,64,219969
39042,0.001408,172.217.194.0-255,1484,102543,64,219969
39043,0.001413,172.217.194.0-255,2902,105445,64,219969
39044,0.001416,172.31.40.0-255,66,105511,64,219969
39045,0.001421,172.217.194.0-255,4320,109831,64,219969
39046,0.001423,172.31.40.0-255,66,109897,64,219969
39047,0.00145,172.217.194.0-255,1484,111381,64,219969
39048,0.001461,172.31.40.0-255,66,111447,64,219969
39049,0.001477,172.217.194.0-255,2902,114349,64,219969
39050,0.001479,172.31.40.0-255,66,114415,64,219969
39051,0.001481,172.217.194.0-255,1484,115899,64,219969
39052,0.001534,172.217.194.0-255,7156,123055,64,219969
39053,0.001537,172.31.40.0-255,66,123121,64,219969
39054,0.001556,172.217.194.0-255,2184,125305,64,219969
39055,0.001558,172.31.40.0-255,66,125371,64,219969
39056,0.00158,172.217.194.0-255,7156,132527,64,219969
39057,0.001582,172.31.40.0-255,66,132593,64,219969
39058,0.001594,172.217.194.0-255,2902,135495,64,219969
39059,0.001596,172.31.40.0-255,66,135561,64,219969
39060,0.001628,172.31.40.0-255,66,135627,64,219969
39061,0.001647,172.217.194.0-255,4320,139947,64,219969
39062,0.001649,172.31.40.0-255,66,140013,64,219969
39063,0.001699,172.217.194.0-255,4320,144333,64,219969
39064,0.001702,172.31.40.0-255,66,144399,64,219969
39065,0.001729,172.217.194.0-255,6438,150837,64,219969
39066,0.001732,172.31.40.0-255,66,150903,64,219969
39067,0.001776,172.217.194.0-255,1484,152387,64,219969
39068,0.001781,172.217.194.0-255,2902,155289,64,219969
39069,0.001784,172.31.40.0-255,66,155355,64,219969
39070,0.001791,172.217.194.0-255,5738,161093,64,219969
39071,0.001793,172.31.40.0-255,66,161159,64,219969
39072,0.00185,172.31.40.0-255,66,161225,64,219969
39073,0.001868,172.217.194.0-255,2902,164127,64,219969
39074,0.00187,172.31.40.0-255,66,164193,64,219969
39075,0.001887,172.31.40.0-255,66,164259,64,219969
39076,0.0019,172.31.40.0-255,66,164325,64,219969
39077,0.001919,172.31.40.0-255,66,164391,64,219969
39078,0.001923,172.217.194.0-255,2184,166575,64,219969
39079,0.001925,172.31.40.0-255,66,166641,64,219969
39080,0.001945,172.217.194.0-255,2902,169543,64,219969
39081,0.001948,172.31.40.0-255,66,169609,64,219969
39082,0.001951,172.217.194.0-255,1484,171093,64,219969
39083,0.001969,172.217.194.0-255,5738,176831,64,219969
39084,0.001972,172.31.40.0-255,66,176897,64,219969
39085,0.002001,172.31.40.0-255,66,176963,64,219969
39086,0.002026,172.217.194.0-255,4320,181283,64,219969
39087,0.002029,172.31.40.0-255,66,181349,64,219969
39088,0.002043,172.31.40.0-255,66,181415,64,219969
39089,0.002079,172.31.40.0-255,66,181481,64,219969
39090,0.002085,172.217.194.0-255,4320,185801,64,219969
39091,0.002087,172.31.40.0-255,66,185867,64,219969
39092,0.002105,172.217.194.0-255,5738,191605,64,219969
39093,0.002107,172.31.40.0-255,66,191671,64,219969
39094,0.002115,172.217.194.0-255,7156,198827,64,219969
39095,0.002117,172.31.40.0-255,66,198893,64,219969
39096,0.002151,172.31.40.0-255,66,198959,64,219969
39097,0.002171,172.217.194.0-255,4320,203279,64,219969
39098,0.00218,172.31.40.0-255,66,203345,64,219969
39099,0.002193,172.31.40.0-255,66,203411,64,219969
39100,0.0022,172.217.194.0-255,5738,209149,64,219969
39101,0.002202,172.31.40.0-255,66,209215,64,219969
39102,0.002236,172.31.40.0-255,66,209281,64,219969
39103,0.002246,172.31.40.0-255,66,209347,64,219969
39104,0.002258,172.31.40.0-255,66,209413,64,219969
39105,0.002263,172.217.194.0-255,4320,213733,64,219969
39106,0.002266,172.31.40.0-255,66,213799,64,219969
39107,0.002283,172.217.194.0-255,1419,215218,64,219969
39108,0.002298,172.217.194.0-255,105,215323,64,219969
39109,0.01297,172.217.194.0-255,105,215428,64,219969
39110,0.01299,172.31.40.0-255,78,215506,64,219969
39111,0.020451,172.31.40.0-255,105,215611,64,219969
39112,0.022993,172.217.194.0-255,66,215677,64,219969
39113,0.046623,172.31.40.0-255,172,215849,64,219969
39114,0.046652,172.31.40.0-255,1112,216961,64,219969
39115,0.046704,172.31.40.0-255,1514,218475,64,219969
39116,0.046706,172.31.40.0-255,1296,219771,64,219969
39117,0.048183,104.244.42.0-255,66,219837,64,219969
39118,0.048194,104.244.42.0-255,66,219903,64,219969
39119,0.048306,104.244.42.0-255,66,219969,64,219969
39120,0.0,172.31.40.0-255,105,105,64,459
39121,0.00015,172.31.40.0-255,90,195,64,459
39122,0.000159,172.31.40.0-255,66,261,64,459
39123,0.002303,74.125.68.0-255,66,327,64,459
39124,0.002313,74.125.68.0-255,66,393,64,459
39125,0.00232,172.31.40.0-255,66,459,64,459
39126,0.0,74.125.24.0-255,152,152,64,290743
39127,1.6e-05,172.31.40.0-255,66,218,64,290743
39128,2.3e-05,74.125.24.0-255,1484,1702,64,290743
39129,2.6e-05,172.31.40.0-255,66,1768,64,290743
39130,3.1e-05,74.125.24.0-255,2902,4670,64,290743
39131,4.2e-05,172.31.40.0-255,66,4736,64,290743
39132,4.9e-05,74.125.24.0-255,5738,10474,64,290743
39133,5.2e-05,172.31.40.0-255,66,10540,64,290743
39134,7.1e-05,74.125.24.0-255,1484,12024,64,290743
39135,7.4e-05,172.31.40.0-255,66,12090,64,290743
39136,8.8e-05,172.31.40.0-255,66,12156,64,290743
39137,0.000117,74.125.24.0-255,3400,15556,64,290743
39138,0.000119,172.31.40.0-255,66,15622,64,290743
39139,0.000127,74.125.24.0-255,6797,22419,64,290743
39140,0.00013,172.31.40.0-255,66,22485,64,290743
39141,0.000204,74.125.24.0-255,1484,23969,64,290743
39142,0.000207,172.31.40.0-255,66,24035,64,290743
39143,0.000211,74.125.24.0-255,1484,25519,64,290743
39144,0.000213,172.31.40.0-255,66,25585,64,290743
39145,0.000237,74.125.24.0-255,1484,27069,64,290743
39146,0.000239,172.31.40.0-255,66,27135,64,290743
39147,0.000247,74.125.24.0-255,5738,32873,64,290743
39148,0.000249,172.31.40.0-255,66,32939,64,290743
39149,0.000255,74.125.24.0-255,5738,38677,64,290743
39150,0.000258,172.31.40.0-255,66,38743,64,290743
39151,0.000304,172.31.40.0-255,66,38809,64,290743
39152,0.000337,74.125.24.0-255,5355,44164,64,290743
39153,0.00034,172.31.40.0-255,66,44230,64,290743
39154,0.000343,74.125.24.0-255,109,44339,64,290743
39155,0.000346,172.31.40.0-255,66,44405,64,290743
39156,0.00062,74.125.24.0-255,1484,45889,64,290743
39157,0.000628,74.125.24.0-255,2902,48791,64,290743
39158,0.000632,172.31.40.0-255,66,48857,64,290743
39159,0.000639,74.125.24.0-255,5738,54595,64,290743
39160,0.000642,172.31.40.0-255,66,54661,64,290743
39161,0.000674,172.31.40.0-255,66,54727,64,290743
39162,0.000703,74.125.24.0-255,1484,56211,64,290743
39163,0.000716,172.31.40.0-255,66,56277,64,290743
39164,0.000719,74.125.24.0-255,766,57043,64,290743
39165,0.001316,172.31.40.0-255,66,57109,64,290743
39166,0.001656,74.125.24.0-255,329,57438,64,290743
39167,0.001692,74.125.24.0-255,1484,58922,64,290743
39168,0.001696,172.31.40.0-255,66,58988,64,290743
39169,0.001702,74.125.24.0-255,4320,63308,64,290743
39170,0.001704,172.31.40.0-255,66,63374,64,290743
39171,0.001741,74.125.24.0-255,5738,69112,64,290743
39172,0.001744,172.31.40.0-255,66,69178,64,290743
39173,0.001747,74.125.24.0-255,1484,70662,64,290743
39174,0.001773,74.125.24.0-255,5738,76400,64,290743
39175,0.001775,172.31.40.0-255,66,76466,64,290743
39176,0.001787,74.125.24.0-255,4320,80786,64,290743
39177,0.001789,172.31.40.0-255,66,80852,64,290743
39178,0.001823,172.31.40.0-255,66,80918,64,290743
39179,0.001826,74.125.24.0-255,766,81684,64,290743
39180,0.002047,74.125.24.0-255,1484,83168,64,290743
39181,0.002052,172.31.40.0-255,66,83234,64,290743
39182,0.002058,74.125.24.0-255,2902,86136,64,290743
39183,0.002059,172.31.40.0-255,66,86202,64,290743
39184,0.002104,74.125.24.0-255,5738,91940,64,290743
39185,0.002107,172.31.40.0-255,66,92006,64,290743
39186,0.002133,74.125.24.0-255,7156,99162,64,290743
39187,0.002135,172.31.40.0-255,66,99228,64,290743
39188,0.00216,74.125.24.0-255,4320,103548,64,290743
39189,0.002162,172.31.40.0-255,66,103614,64,290743
39190,0.002199,172.31.40.0-255,66,103680,64,290743
39191,0.002219,74.125.24.0-255,2184,105864,64,290743
39192,0.002221,172.31.40.0-255,66,105930,64,290743
39193,0.002353,74.125.24.0-255,1484,107414,64,290743
39194,0.002358,74.125.24.0-255,2902,110316,64,290743
39195,0.00236,172.31.40.0-255,66,110382,64,290743
39196,0.002388,74.125.24.0-255,2902,113284,64,290743
39197,0.00239,172.31.40.0-255,66,113350,64,290743
39198,0.002413,74.125.24.0-255,4320,117670,64,290743
39199,0.002415,172.31.40.0-255,66,117736,64,290743
39200,0.00244,74.125.24.0-255,1484,119220,64,290743
39201,0.002445,74.125.24.0-255,2902,122122,64,290743
39202,0.002447,172.31.40.0-255,66,122188,64,290743
39203,0.002477,74.125.24.0-255,5738,127926,64,290743
39204,0.002479,172.31.40.0-255,66,127992,64,290743
39205,0.002502,74.125.24.0-255,4320,132312,64,290743
39206,0.002504,172.31.40.0-255,66,132378,64,290743
39207,0.002533,74.125.24.0-255,7156,139534,64,290743
39208,0.002536,172.31.40.0-255,66,139600,64,290743
39209,0.002543,74.125.24.0-255,6438,146038,64,290743
39210,0.002546,172.31.40.0-255,66,146104,64,290743
39211,0.002554,74.125.24.0-255,7156,153260,64,290743
39212,0.002556,172.31.40.0-255,66,153326,64,290743
39213,0.0026,172.31.40.0-255,66,153392,64,290743
39214,0.002604,74.125.24.0-255,2902,156294,64,290743
39215,0.002607,172.31.40.0-255,66,156360,64,290743
39216,0.002636,74.125.24.0-255,2184,158544,64,290743
39217,0.002639,172.31.40.0-255,66,158610,64,290743
39218,0.005202,74.125.24.0-255,2902,161512,64,290743
39219,0.005205,172.31.40.0-255,66,161578,64,290743
39220,0.005232,74.125.24.0-255,2902,164480,64,290743
39221,0.005234,172.31.40.0-255,66,164546,64,290743
39222,0.007809,74.125.24.0-255,2902,167448,64,290743
39223,0.007816,172.31.40.0-255,66,167514,64,290743
39224,0.007836,74.125.24.0-255,2902,170416,64,290743
39225,0.007841,172.31.40.0-255,66,170482,64,290743
39226,0.01041,74.125.24.0-255,2902,173384,64,290743
39227,0.010417,172.31.40.0-255,66,173450,64,290743
39228,0.010451,74.125.24.0-255,2902,176352,64,290743
39229,0.010454,172.31.40.0-255,66,176418,64,290743
39230,0.013001,74.125.24.0-255,2902,179320,64,290743
39231,0.013011,172.31.40.0-255,66,179386,64,290743
39232,0.013033,74.125.24.0-255,2902,182288,64,290743
39233,0.013036,172.31.40.0-255,66,182354,64,290743
39234,0.015636,74.125.24.0-255,5738,188092,64,290743
39235,0.015645,172.31.40.0-255,66,188158,64,290743
39236,0.018245,74.125.24.0-255,5738,193896,64,290743
39237,0.018252,172.31.40.0-255,66,193962,64,290743
39238,0.020848,74.125.24.0-255,5738,199700,64,290743
39239,0.020857,172.31.40.0-255,66,199766,64,290743
39240,0.023474,74.125.24.0-255,5738,205504,64,290743
39241,0.023483,172.31.40.0-255,66,205570,64,290743
39242,0.026093,74.125.24.0-255,5738,211308,64,290743
39243,0.026101,172.31.40.0-255,66,211374,64,290743
39244,0.02847,172.31.40.0-255,172,211546,64,290743
39245,0.0285,172.31.40.0-255,1111,212657,64,290743
39246,0.028555,172.31.40.0-255,1514,214171,64,290743
39247,0.028557,172.31.40.0-255,1514,215685,64,290743
39248,0.028558,172.31.40.0-255,694,216379,64,290743
39249,0.028685,74.125.24.0-255,5738,222117,64,290743
39250,0.028691,172.31.40.0-255,66,222183,64,290743
39251,0.030023,104.244.42.0-255,66,222249,64,290743
39252,0.030071,104.244.42.0-255,66,222315,64,290743
39253,0.030119,104.244.42.0-255,66,222381,64,290743
39254,0.030161,104.244.42.0-255,66,222447,64,290743
39255,0.031313,74.125.24.0-255,5738,228185,64,290743
39256,0.03132,172.31.40.0-255,66,228251,64,290743
39257,0.0339,74.125.24.0-255,5738,233989,64,290743
39258,0.033907,172.31.40.0-255,66,234055,64,290743
39259,0.036507,74.125.24.0-255,5738,239793,64,290743
39260,0.036515,172.31.40.0-255,66,239859,64,290743
39261,0.039091,74.125.24.0-255,5738,245597,64,290743
39262,0.039097,172.31.40.0-255,66,245663,64,290743
39263,0.041681,74.125.24.0-255,5738,251401,64,290743
39264,0.04169,172.31.40.0-255,66,251467,64,290743
39265,0.04427,74.125.24.0-255,4320,255787,64,290743
39266,0.044277,172.31.40.0-255,66,255853,64,290743
39267,0.044309,74.125.24.0-255,1484,257337,64,290743
39268,0.046855,74.125.24.0-255,4320,261657,64,290743
39269,0.046862,172.31.40.0-255,66,261723,64,290743
39270,0.049444,74.125.24.0-255,5738,267461,64,290743
39271,0.04945,172.31.40.0-255,66,267527,64,290743
39272,0.052068,74.125.24.0-255,5738,273265,64,290743
39273,0.052073,172.31.40.0-255,66,273331,64,290743
39274,0.054669,74.125.24.0-255,5738,279069,64,290743
39275,0.054675,172.31.40.0-255,66,279135,64,290743
39276,0.057298,74.125.24.0-255,5738,284873,64,290743
39277,0.057304,172.31.40.0-255,66,284939,64,290743
39278,0.059921,74.125.24.0-255,5738,290677,64,290743
39279,0.059926,172.31.40.0-255,66,290743,64,290743
39280,0.0,172.217.194.0-255,154,154,64,235784
39281,1.9e-05,172.31.40.0-255,66,220,64,235784
39282,2.6e-05,172.217.194.0-255,1484,1704,64,235784
39283,3e-05,172.31.40.0-255,66,1770,64,235784
39284,3.6e-05,172.217.194.0-255,2902,4672,64,235784
39285,4e-05,172.31.40.0-255,66,4738,64,235784
39286,4.8e-05,172.217.194.0-255,7156,11894,64,235784
39287,5.1e-05,172.31.40.0-255,66,11960,64,235784
39288,7.6e-05,172.217.194.0-255,7156,19116,64,235784
39289,7.9e-05,172.31.40.0-255,66,19182,64,235784
39290,0.000106,172.31.40.0-255,66,19248,64,235784
39291,0.000109,172.217.194.0-255,2543,21791,64,235784
39292,0.000112,172.31.40.0-255,66,21857,64,235784
39293,0.000115,172.217.194.0-255,1484,23341,64,235784
39294,0.000117,172.31.40.0-255,66,23407,64,235784
39295,0.000161,172.31.40.0-255,66,23473,64,235784
39296,0.001041,172.217.194.0-255,1484,24957,64,235784
39297,0.001047,172.31.40.0-255,66,25023,64,235784
39298,0.001058,172.217.194.0-255,2902,27925,64,235784
39299,0.001061,172.31.40.0-255,66,27991,64,235784
39300,0.001068,172.217.194.0-255,5738,33729,64,235784
39301,0.00107,172.31.40.0-255,66,33795,64,235784
39302,0.001134,172.31.40.0-255,66,33861,64,235784
39303,0.001146,172.31.40.0-255,66,33927,64,235784
39304,0.001159,172.31.40.0-255,66,33993,64,235784
39305,0.001204,172.217.194.0-255,6797,40790,64,235784
39306,0.001209,172.31.40.0-255,66,40856,64,235784
39307,0.001405,172.217.194.0-255,1484,42340,64,235784
39308,0.001424,172.217.194.0-255,2902,45242,64,235784
39309,0.001428,172.31.40.0-255,66,45308,64,235784
39310,0.001434,172.217.194.0-255,5738,51046,64,235784
39311,0.001436,172.31.40.0-255,66,51112,64,235784
39312,0.001493,172.217.194.0-255,6234,57346,64,235784
39313,0.001496,172.31.40.0-255,66,57412,64,235784
39314,0.002,172.217.194.0-255,1484,58896,64,235784
39315,0.00201,172.217.194.0-255,2902,61798,64,235784
39316,0.002027,172.31.40.0-255,66,61864,64,235784
39317,0.002035,172.217.194.0-255,5738,67602,64,235784
39318,0.002037,172.31.40.0-255,66,67668,64,235784
39319,0.002044,172.217.194.0-255,5738,73406,64,235784
39320,0.002046,172.31.40.0-255,66,73472,64,235784
39321,0.002077,172.217.194.0-255,7156,80628,64,235784
39322,0.00208,172.31.40.0-255,66,80694,64,235784
39323,0.002092,172.31.40.0-255,66,80760,64,235784
39324,0.002182,172.217.194.0-255,1484,82244,64,235784
39325,0.002188,172.217.194.0-255,2902,85146,64,235784
39326,0.002191,172.31.40.0-255,66,85212,64,235784
39327,0.002215,172.217.194.0-255,5738,90950,64,235784
39328,0.002217,172.31.40.0-255,66,91016,64,235784
39329,0.002221,172.217.194.0-255,1484,92500,64,235784
39330,0.002245,172.31.40.0-255,66,92566,64,235784
39331,0.002266,172.217.194.0-255,2902,95468,64,235784
39332,0.002268,172.31.40.0-255,66,95534,64,235784
39333,0.002281,172.31.40.0-255,66,95600,64,235784
39334,0.002485,172.217.194.0-255,1484,97084,64,235784
39335,0.002491,172.217.194.0-255,2902,99986,64,235784
39336,0.002494,172.31.40.0-255,66,100052,64,235784
39337,0.002514,172.217.194.0-255,2902,102954,64,235784
39338,0.002517,172.31.40.0-255,66,103020,64,235784
39339,0.002527,172.217.194.0-255,2902,105922,64,235784
39340,0.002529,172.31.40.0-255,66,105988,64,235784
39341,0.002534,172.217.194.0-255,2902,108890,64,235784
39342,0.002536,172.31.40.0-255,66,108956,64,235784
39343,0.00256,172.31.40.0-255,66,109022,64,235784
39344,0.002596,172.217.194.0-255,1484,110506,64,235784
39345,0.002622,172.31.40.0-255,66,110572,64,235784
39346,0.005227,172.217.194.0-255,5738,116310,64,235784
39347,0.005234,172.31.40.0-255,66,116376,64,235784
39348,0.007842,172.217.194.0-255,5738,122114,64,235784
39349,0.007848,172.31.40.0-255,66,122180,64,235784
39350,0.010457,172.217.194.0-255,5738,127918,64,235784
39351,0.010464,172.31.40.0-255,66,127984,64,235784
39352,0.013104,172.217.194.0-255,5738,133722,64,235784
39353,0.013112,172.31.40.0-255,66,133788,64,235784
39354,0.015717,172.217.194.0-255,5738,139526,64,235784
39355,0.015725,172.31.40.0-255,66,139592,64,235784
39356,0.018328,172.217.194.0-255,5738,145330,64,235784
39357,0.018335,172.31.40.0-255,66,145396,64,235784
39358,0.020961,172.217.194.0-255,5738,151134,64,235784
39359,0.02097,172.31.40.0-255,66,151200,64,235784
39360,0.023592,172.217.194.0-255,5738,156938,64,235784
39361,0.023609,172.31.40.0-255,66,157004,64,235784
39362,0.026216,172.217.194.0-255,5738,162742,64,235784
39363,0.02623,172.31.40.0-255,66,162808,64,235784
39364,0.028863,172.217.194.0-255,5738,168546,64,235784
39365,0.02888,172.31.40.0-255,66,168612,64,235784
39366,0.031484,172.217.194.0-255,5738,174350,64,235784
39367,0.031492,172.31.40.0-255,66,174416,64,235784
39368,0.034138,172.217.194.0-255,5738,180154,64,235784
39369,0.034158,172.31.40.0-255,66,180220,64,235784
39370,0.036751,172.217.194.0-255,5738,185958,64,235784
39371,0.036758,172.31.40.0-255,66,186024,64,235784
39372,0.037974,172.31.40.0-255,172,186196,64,235784
39373,0.038005,172.31.40.0-255,1113,187309,64,235784
39374,0.038061,172.31.40.0-255,1514,188823,64,235784
39375,0.038063,172.31.40.0-255,331,189154,64,235784
39376,0.039347,172.217.194.0-255,5738,194892,64,235784
39377,0.039358,172.31.40.0-255,66,194958,64,235784
39378,0.039536,104.244.42.0-255,66,195024,64,235784
39379,0.039572,104.244.42.0-255,66,195090,64,235784
39380,0.039617,104.244.42.0-255,66,195156,64,235784
39381,0.041974,172.217.194.0-255,5738,200894,64,235784
39382,0.041989,172.31.40.0-255,66,200960,64,235784
39383,0.044617,172.217.194.0-255,5738,206698,64,235784
39384,0.044635,172.31.40.0-255,66,206764,64,235784
39385,0.047228,172.217.194.0-255,5738,212502,64,235784
39386,0.047246,172.31.40.0-255,66,212568,64,235784
39387,0.049876,172.217.194.0-255,5738,218306,64,235784
39388,0.049895,172.31.40.0-255,66,218372,64,235784
39389,0.05251,172.217.194.0-255,5738,224110,64,235784
39390,0.052528,172.31.40.0-255,66,224176,64,235784
39391,0.055153,172.217.194.0-255,5738,229914,64,235784
39392,0.055172,172.31.40.0-255,66,229980,64,235784
39393,0.057802,172.217.194.0-255,5738,235718,64,235784
39394,0.057812,172.31.40.0-255,66,235784,64,235784
39395,0.0,74.125.68.0-255,152,152,64,347225
39396,1.6e-05,172.31.40.0-255,66,218,64,347225
39397,2.3e-05,74.125.68.0-255,1484,1702,64,347225
39398,2.8e-05,172.31.40.0-255,66,1768,64,347225
39399,6.8e-05,74.125.68.0-255,2902,4670,64,347225
39400,7.6e-05,172.31.40.0-255,66,4736,64,347225
39401,8.4e-05,74.125.68.0-255,5738,10474,64,347225
39402,8.7e-05,172.31.40.0-255,66,10540,64,347225
39403,0.000123,74.125.68.0-255,3429,13969,64,347225
39404,0.000126,172.31.40.0-255,66,14035,64,347225
39405,0.000259,74.125.68.0-255,1484,15519,64,347225
39406,0.000264,172.31.40.0-255,66,15585,64,347225
39407,0.00027,74.125.68.0-255,2902,18487,64,347225
39408,0.000272,172.31.40.0-255,66,18553,64,347225
39409,0.000277,74.125.68.0-255,2902,21455,64,347225
39410,0.000285,172.31.40.0-255,66,21521,64,347225
39411,0.000291,74.125.68.0-255,4320,25841,64,347225
39412,0.000293,172.31.40.0-255,66,25907,64,347225
39413,0.000316,74.125.68.0-255,1484,27391,64,347225
39414,0.000318,172.31.40.0-255,66,27457,64,347225
39415,0.000352,172.31.40.0-255,66,27523,64,347225
39416,0.000358,74.125.68.0-255,4320,31843,64,347225
39417,0.00036,172.31.40.0-255,66,31909,64,347225
39418,0.000395,74.125.68.0-255,5738,37647,64,347225
39419,0.000397,172.31.40.0-255,66,37713,64,347225
39420,0.000402,74.125.68.0-255,2902,40615,64,347225
39421,0.000403,172.31.40.0-255,66,40681,64,347225
39422,0.000408,74.125.68.0-255,2902,43583,64,347225
39423,0.00041,172.31.40.0-255,66,43649,64,347225
39424,0.000454,172.31.40.0-255,66,43715,64,347225
39425,0.000458,74.125.68.0-255,2184,45899,64,347225
39426,0.000478,74.125.68.0-255,402,46301,64,347225
39427,0.00053,74.125.68.0-255,111,46412,64,347225
39428,0.000583,172.31.40.0-255,66,46478,64,347225
39429,0.000738,74.125.68.0-255,1484,47962,64,347225
39430,0.000755,74.125.68.0-255,2902,50864,64,347225
39431,0.000779,74.125.68.0-255,1484,52348,64,347225
39432,0.000783,172.31.40.0-255,66,52414,64,347225
39433,0.000794,74.125.68.0-255,2902,55316,64,347225
39434,0.000804,172.31.40.0-255,66,55382,64,347225
39435,0.000843,74.125.68.0-255,5738,61120,64,347225
39436,0.000847,74.125.68.0-255,1484,62604,64,347225
39437,0.00085,74.125.68.0-255,2902,65506,64,347225
39438,0.000863,172.31.40.0-255,66,65572,64,347225
39439,0.000873,74.125.68.0-255,5738,71310,64,347225
39440,0.000882,74.125.68.0-255,2902,74212,64,347225
39441,0.000887,172.31.40.0-255,66,74278,64,347225
39442,0.000915,74.125.68.0-255,4320,78598,64,347225
39443,0.000923,172.31.40.0-255,66,78664,64,347225
39444,0.000942,74.125.68.0-255,2184,80848,64,347225
39445,0.00096,172.31.40.0-255,66,80914,64,347225
39446,0.001006,74.125.68.0-255,1484,82398,64,347225
39447,0.00102,74.125.68.0-255,2902,85300,64,347225
39448,0.001023,74.125.68.0-255,1484,86784,64,347225
39449,0.001032,172.31.40.0-255,66,86850,64,347225
39450,0.001049,74.125.68.0-255,2902,89752,64,347225
39451,0.001056,74.125.68.0-255,5738,95490,64,347225
39452,0.001076,172.31.40.0-255,66,95556,64,347225
39453,0.001086,74.125.68.0-255,2902,98458,64,347225
39454,0.001171,172.31.40.0-255,66,98524,64,347225
39455,0.001199,74.125.68.0-255,2902,101426,64,347225
39456,0.001212,74.125.68.0-255,4320,105746,64,347225
39457,0.001216,172.31.40.0-255,66,105812,64,347225
39458,0.001256,74.125.68.0-255,2902,108714,64,347225
39459,0.001267,74.125.68.0-255,1484,110198,64,347225
39460,0.001291,172.31.40.0-255,66,110264,64,347225
39461,0.001296,172.31.40.0-255,66,110330,64,347225
39462,0.001303,74.125.68.0-255,1484,111814,64,347225
39463,0.001311,74.125.68.0-255,2184,113998,64,347225
39464,0.001341,172.31.40.0-255,66,114064,64,347225
39465,0.001498,74.125.68.0-255,1484,115548,64,347225
39466,0.001512,74.125.68.0-255,1484,117032,64,347225
39467,0.001523,172.31.40.0-255,66,117098,64,347225
39468,0.001527,74.125.68.0-255,1484,118582,64,347225
39469,0.001555,74.125.68.0-255,5738,124320,64,347225
39470,0.001566,172.31.40.0-255,66,124386,64,347225
39471,0.001601,74.125.68.0-255,7156,131542,64,347225
39472,0.001609,172.31.40.0-255,66,131608,64,347225
39473,0.001631,74.125.68.0-255,5738,137346,64,347225
39474,0.001643,74.125.68.0-255,2902,140248,64,347225
39475,0.001648,74.125.68.0-255,4320,144568,64,347225
39476,0.001662,74.125.68.0-255,1484,146052,64,347225
39477,0.001665,172.31.40.0-255,66,146118,64,347225
39478,0.001697,74.125.68.0-255,2184,148302,64,347225
39479,0.001707,172.31.40.0-255,66,148368,64,347225
39480,0.001783,74.125.68.0-255,1484,149852,64,347225
39481,0.001799,74.125.68.0-255,1484,151336,64,347225
39482,0.001816,172.31.40.0-255,66,151402,64,347225
39483,0.001821,74.125.68.0-255,2902,154304,64,347225
39484,0.001827,172.31.40.0-255,66,154370,64,347225
39485,0.001849,74.125.68.0-255,5738,160108,64,347225
39486,0.001868,172.31.40.0-255,66,160174,64,347225
39487,0.001897,74.125.68.0-255,7156,167330,64,347225
39488,0.001903,74.125.68.0-255,5738,173068,64,347225
39489,0.001915,74.125.68.0-255,1484,174552,64,347225
39490,0.001918,172.31.40.0-255,66,174618,64,347225
39491,0.001951,74.125.68.0-255,5738,180356,64,347225
39492,0.001954,74.125.68.0-255,2184,182540,64,347225
39493,0.001976,172.31.40.0-255,66,182606,64,347225
39494,0.002072,74.125.68.0-255,1484,184090,64,347225
39495,0.002078,74.125.68.0-255,2902,186992,64,347225
39496,0.002084,172.31.40.0-255,66,187058,64,347225
39497,0.002095,74.125.68.0-255,2902,189960,64,347225
39498,0.002111,74.125.68.0-255,2902,192862,64,347225
39499,0.002138,74.125.68.0-255,7156,200018,64,347225
39500,0.002141,172.31.40.0-255,66,200084,64,347225
39501,0.00221,74.125.68.0-255,6438,206522,64,347225
39502,0.002342,74.125.68.0-255,1484,208006,64,347225
39503,0.002358,74.125.68.0-255,1484,209490,64,347225
39504,0.002361,74.125.68.0-255,1484,210974,64,347225
39505,0.002377,74.125.68.0-255,1484,212458,64,347225
39506,0.002401,74.125.68.0-255,5738,218196,64,347225
39507,0.002404,74.125.68.0-255,1484,219680,64,347225
39508,0.002416,74.125.68.0-255,2902,222582,64,347225
39509,0.002435,74.125.68.0-255,2902,225484,64,347225
39510,0.002445,74.125.68.0-255,1484,226968,64,347225
39511,0.002461,74.125.68.0-255,7156,234124,64,347225
39512,0.002479,74.125.68.0-255,6438,240562,64,347225
39513,0.002496,74.125.68.0-255,2902,243464,64,347225
39514,0.011201,172.31.40.0-255,66,243530,64,347225
39515,0.01375,74.125.68.0-255,5738,249268,64,347225
39516,0.013762,172.31.40.0-255,66,249334,64,347225
39517,0.016255,74.125.68.0-255,5738,255072,64,347225
39518,0.019587,172.31.40.0-255,66,255138,64,347225
39519,0.022072,74.125.68.0-255,5738,260876,64,347225
39520,0.022086,172.31.40.0-255,66,260942,64,347225
39521,0.024574,74.125.68.0-255,5738,266680,64,347225
39522,0.026936,172.31.40.0-255,66,266746,64,347225
39523,0.029425,74.125.68.0-255,5738,272484,64,347225
39524,0.029437,172.31.40.0-255,66,272550,64,347225
39525,0.031924,74.125.68.0-255,5738,278288,64,347225
39526,0.031933,172.31.40.0-255,66,278354,64,347225
39527,0.034428,74.125.68.0-255,4320,282674,64,347225
39528,0.034437,172.31.40.0-255,66,282740,64,347225
39529,0.03447,74.125.68.0-255,1484,284224,64,347225
39530,0.036961,74.125.68.0-255,4320,288544,64,347225
39531,0.036982,172.31.40.0-255,66,288610,64,347225
39532,0.039462,74.125.68.0-255,5738,294348,64,347225
39533,0.039505,172.31.40.0-255,66,294414,64,347225
39534,0.040262,172.31.40.0-255,172,294586,64,347225
39535,0.040292,172.31.40.0-255,1108,295694,64,347225
39536,0.040354,172.31.40.0-255,1514,297208,64,347225
39537,0.040355,172.31.40.0-255,1514,298722,64,347225
39538,0.040356,172.31.40.0-255,1514,300236,64,347225
39539,0.040358,172.31.40.0-255,119,300355,64,347225
39540,0.041834,104.244.42.0-255,66,300421,64,347225
39541,0.041975,74.125.68.0-255,5738,306159,64,347225
39542,0.041983,172.31.40.0-255,66,306225,64,347225
39543,0.042035,104.244.42.0-255,66,306291,64,347225
39544,0.042039,104.244.42.0-255,66,306357,64,347225
39545,0.042042,104.244.42.0-255,66,306423,64,347225
39546,0.042752,104.244.42.0-255,108,306531,64,347225
39547,0.042763,172.31.40.0-255,66,306597,64,347225
39548,0.044462,74.125.68.0-255,5738,312335,64,347225
39549,0.044473,172.31.40.0-255,66,312401,64,347225
39550,0.046967,74.125.68.0-255,5738,318139,64,347225
39551,0.046985,172.31.40.0-255,66,318205,64,347225
39552,0.049487,74.125.68.0-255,5738,323943,64,347225
39553,0.049506,172.31.40.0-255,66,324009,64,347225
39554,0.052018,74.125.68.0-255,5738,329747,64,347225
39555,0.052037,172.31.40.0-255,66,329813,64,347225
39556,0.05454,74.125.68.0-255,5738,335551,64,347225
39557,0.054557,172.31.40.0-255,66,335617,64,347225
39558,0.057044,74.125.68.0-255,5738,341355,64,347225
39559,0.05705,172.31.40.0-255,66,341421,64,347225
39560,0.05953,74.125.68.0-255,5738,347159,64,347225
39561,0.059537,172.31.40.0-255,66,347225,64,347225
39562,0.0,172.253.118.0-255,152,152,64,293850
39563,2.8e-05,172.31.40.0-255,66,218,64,293850
39564,3.5e-05,172.253.118.0-255,1484,1702,64,293850
39565,4e-05,172.31.40.0-255,66,1768,64,293850
39566,5.4e-05,172.253.118.0-255,2902,4670,64,293850
39567,5.8e-05,172.31.40.0-255,66,4736,64,293850
39568,6.7e-05,172.253.118.0-255,7156,11892,64,293850
39569,6.9e-05,172.31.40.0-255,66,11958,64,293850
39570,9.6e-05,172.253.118.0-255,1484,13442,64,293850
39571,9.9e-05,172.31.40.0-255,66,13508,64,293850
39572,0.000135,172.253.118.0-255,6361,19869,64,293850
39573,0.000139,172.31.40.0-255,66,19935,64,293850
39574,0.000145,172.253.118.0-255,5738,25673,64,293850
39575,0.000148,172.31.40.0-255,66,25739,64,293850
39576,0.000154,172.253.118.0-255,5379,31118,64,293850
39577,0.000156,172.31.40.0-255,66,31184,64,293850
39578,0.000305,172.253.118.0-255,1484,32668,64,293850
39579,0.00031,172.31.40.0-255,66,32734,64,293850
39580,0.000329,172.253.118.0-255,2902,35636,64,293850
39581,0.000332,172.31.40.0-255,66,35702,64,293850
39582,0.000366,172.253.118.0-255,5738,41440,64,293850
39583,0.000369,172.31.40.0-255,66,41506,64,293850
39584,0.000385,172.253.118.0-255,1484,42990,64,293850
39585,0.000387,172.31.40.0-255,66,43056,64,293850
39586,0.00041,172.253.118.0-255,1484,44540,64,293850
39587,0.000412,172.31.40.0-255,66,44606,64,293850
39588,0.000453,172.31.40.0-255,66,44672,64,293850
39589,0.000461,172.253.118.0-255,7156,51828,64,293850
39590,0.000463,172.31.40.0-255,66,51894,64,293850
39591,0.000471,172.253.118.0-255,2883,54777,64,293850
39592,0.000473,172.31.40.0-255,66,54843,64,293850
39593,0.000584,172.253.118.0-255,1484,56327,64,293850
39594,0.000591,172.253.118.0-255,2902,59229,64,293850
39595,0.000595,172.31.40.0-255,66,59295,64,293850
39596,0.000599,172.253.118.0-255,1484,60779,64,293850
39597,0.000617,172.253.118.0-255,4320,65099,64,293850
39598,0.000619,172.31.40.0-255,66,65165,64,293850
39599,0.000677,172.31.40.0-255,66,65231,64,293850
39600,0.000708,172.253.118.0-255,4320,69551,64,293850
39601,0.000711,172.31.40.0-255,66,69617,64,293850
39602,0.000736,172.253.118.0-255,5637,75254,64,293850
39603,0.000745,172.31.40.0-255,66,75320,64,293850
39604,0.000873,172.253.118.0-255,1484,76804,64,293850
39605,0.000888,172.253.118.0-255,2902,79706,64,293850
39606,0.000892,172.31.40.0-255,66,79772,64,293850
39607,0.000922,172.253.118.0-255,5738,85510,64,293850
39608,0.000925,172.31.40.0-255,66,85576,64,293850
39609,0.000931,172.253.118.0-255,4320,89896,64,293850
39610,0.000933,172.31.40.0-255,66,89962,64,293850
39611,0.000961,172.253.118.0-255,2902,92864,64,293850
39612,0.000964,172.31.40.0-255,66,92930,64,293850
39613,0.000977,172.31.40.0-255,66,92996,64,293850
39614,0.001004,172.253.118.0-255,1484,94480,64,293850
39615,0.001026,172.253.118.0-255,5020,99500,64,293850
39616,0.001029,172.31.40.0-255,66,99566,64,293850
39617,0.001305,172.253.118.0-255,1484,101050,64,293850
39618,0.00132,172.253.118.0-255,2902,103952,64,293850
39619,0.001324,172.31.40.0-255,66,104018,64,293850
39620,0.001353,172.253.118.0-255,5738,109756,64,293850
39621,0.001355,172.31.40.0-255,66,109822,64,293850
39622,0.001374,172.253.118.0-255,4320,114142,64,293850
39623,0.001376,172.31.40.0-255,66,114208,64,293850
39624,0.001415,172.253.118.0-255,5738,119946,64,293850
39625,0.001418,172.31.40.0-255,66,120012,64,293850
39626,0.001431,172.31.40.0-255,66,120078,64,293850
39627,0.001435,172.253.118.0-255,2184,122262,64,293850
39628,0.001438,172.31.40.0-255,66,122328,64,293850
39629,0.001496,172.253.118.0-255,1484,123812,64,293850
39630,0.001512,172.253.118.0-255,2902,126714,64,293850
39631,0.001515,172.31.40.0-255,66,126780,64,293850
39632,0.001547,172.253.118.0-255,5738,132518,64,293850
39633,0.00155,172.31.40.0-255,66,132584,64,293850
39634,0.001553,172.253.118.0-255,1484,134068,64,293850
39635,0.001591,172.31.40.0-255,66,134134,64,293850
39636,0.001593,172.253.118.0-255,1484,135618,64,293850
39637,0.001664,172.253.118.0-255,5738,141356,64,293850
39638,0.001667,172.31.40.0-255,66,141422,64,293850
39639,0.001691,172.253.118.0-255,3602,145024,64,293850
39640,0.001694,172.31.40.0-255,66,145090,64,293850
39641,0.002508,172.253.118.0-255,1484,146574,64,293850
39642,0.002517,172.253.118.0-255,2902,149476,64,293850
39643,0.002523,172.31.40.0-255,66,149542,64,293850
39644,0.002527,172.253.118.0-255,1484,151026,64,293850
39645,0.002556,172.253.118.0-255,2902,153928,64,293850
39646,0.002559,172.31.40.0-255,66,153994,64,293850
39647,0.002563,172.253.118.0-255,2902,156896,64,293850
39648,0.002565,172.31.40.0-255,66,156962,64,293850
39649,0.005073,172.253.118.0-255,5738,162700,64,293850
39650,0.005079,172.31.40.0-255,66,162766,64,293850
39651,0.007597,172.253.118.0-255,5738,168504,64,293850
39652,0.007604,172.31.40.0-255,66,168570,64,293850
39653,0.010147,172.253.118.0-255,5738,174308,64,293850
39654,0.010156,172.31.40.0-255,66,174374,64,293850
39655,0.012681,172.253.118.0-255,5738,180112,64,293850
39656,0.012694,172.31.40.0-255,66,180178,64,293850
39657,0.015226,172.253.118.0-255,5738,185916,64,293850
39658,0.015257,172.31.40.0-255,66,185982,64,293850
39659,0.017808,172.253.118.0-255,5738,191720,64,293850
39660,0.017826,172.31.40.0-255,66,191786,64,293850
39661,0.020371,172.253.118.0-255,5738,197524,64,293850
39662,0.020389,172.31.40.0-255,66,197590,64,293850
39663,0.022935,172.253.118.0-255,5738,203328,64,293850
39664,0.022956,172.31.40.0-255,66,203394,64,293850
39665,0.025489,172.253.118.0-255,5738,209132,64,293850
39666,0.025509,172.31.40.0-255,66,209198,64,293850
39667,0.028056,172.253.118.0-255,5738,214936,64,293850
39668,0.028074,172.31.40.0-255,66,215002,64,293850
39669,0.0306,172.253.118.0-255,5738,220740,64,293850
39670,0.030609,172.31.40.0-255,66,220806,64,293850
39671,0.033184,172.253.118.0-255,5738,226544,64,293850
39672,0.033203,172.31.40.0-255,66,226610,64,293850
39673,0.03574,172.253.118.0-255,5738,232348,64,293850
39674,0.035747,172.31.40.0-255,66,232414,64,293850
39675,0.038283,172.253.118.0-255,5738,238152,64,293850
39676,0.038294,172.31.40.0-255,66,238218,64,293850
39677,0.040844,172.253.118.0-255,5738,243956,64,293850
39678,0.040863,172.31.40.0-255,66,244022,64,293850
39679,0.043387,172.253.118.0-255,5738,249760,64,293850
39680,0.0434,172.31.40.0-255,66,249826,64,293850
39681,0.045944,172.253.118.0-255,5738,255564,64,293850
39682,0.045964,172.31.40.0-255,66,255630,64,293850
39683,0.048495,172.253.118.0-255,5738,261368,64,293850
39684,0.04851,172.31.40.0-255,66,261434,64,293850
39685,0.051049,172.253.118.0-255,5738,267172,64,293850
39686,0.051065,172.31.40.0-255,66,267238,64,293850
39687,0.052718,172.31.40.0-255,172,267410,64,293850
39688,0.052752,172.31.40.0-255,1112,268522,64,293850
39689,0.052813,172.31.40.0-255,1514,270036,64,293850
39690,0.052815,172.31.40.0-255,1514,271550,64,293850
39691,0.05282,172.31.40.0-255,1514,273064,64,293850
39692,0.052821,172.31.40.0-255,1514,274578,64,293850
39693,0.052842,172.31.40.0-255,1514,276092,64,293850
39694,0.052843,172.31.40.0-255,82,276174,64,293850
39695,0.05359,172.253.118.0-255,5738,281912,64,293850
39696,0.053597,172.31.40.0-255,66,281978,64,293850
39697,0.054289,104.244.42.0-255,66,282044,64,293850
39698,0.054336,104.244.42.0-255,66,282110,64,293850
39699,0.054392,104.244.42.0-255,66,282176,64,293850
39700,0.054397,104.244.42.0-255,66,282242,64,293850
39701,0.056124,172.253.118.0-255,5738,287980,64,293850
39702,0.056134,172.31.40.0-255,66,288046,64,293850
39703,0.058648,172.253.118.0-255,5738,293784,64,293850
39704,0.058655,172.31.40.0-255,66,293850,64,293850
39705,0.0,172.31.40.0-255,66,66,64,66
39706,0.0,74.125.200.0-255,146,146,64,388046
39707,2.6e-05,172.31.40.0-255,66,212,64,388046
39708,3.4e-05,74.125.200.0-255,1484,1696,64,388046
39709,3.9e-05,172.31.40.0-255,66,1762,64,388046
39710,4.4e-05,74.125.200.0-255,2902,4664,64,388046
39711,4.7e-05,172.31.40.0-255,66,4730,64,388046
39712,5.3e-05,74.125.200.0-255,4320,9050,64,388046
39713,5.5e-05,172.31.40.0-255,66,9116,64,388046
39714,8e-05,74.125.200.0-255,2902,12018,64,388046
39715,8.2e-05,172.31.40.0-255,66,12084,64,388046
39716,0.0001,74.125.200.0-255,2117,14201,64,388046
39717,0.000103,172.31.40.0-255,66,14267,64,388046
39718,0.000135,74.125.200.0-255,1484,15751,64,388046
39719,0.000137,172.31.40.0-255,66,15817,64,388046
39720,0.000141,74.125.200.0-255,1484,17301,64,388046
39721,0.000143,172.31.40.0-255,66,17367,64,388046
39722,0.000157,74.125.200.0-255,1484,18851,64,388046
39723,0.000159,172.31.40.0-255,66,18917,64,388046
39724,0.000164,74.125.200.0-255,2902,21819,64,388046
39725,0.000166,172.31.40.0-255,66,21885,64,388046
39726,0.000192,74.125.200.0-255,2902,24787,64,388046
39727,0.000194,172.31.40.0-255,66,24853,64,388046
39728,0.000201,74.125.200.0-255,5738,30591,64,388046
39729,0.000204,172.31.40.0-255,66,30657,64,388046
39730,0.000222,74.125.200.0-255,6797,37454,64,388046
39731,0.000224,172.31.40.0-255,66,37520,64,388046
39732,0.000229,74.125.200.0-255,2902,40422,64,388046
39733,0.000231,172.31.40.0-255,66,40488,64,388046
39734,0.000236,74.125.200.0-255,1484,41972,64,388046
39735,0.000238,172.31.40.0-255,66,42038,64,388046
39736,0.000251,74.125.200.0-255,2902,44940,64,388046
39737,0.000253,172.31.40.0-255,66,45006,64,388046
39738,0.000285,74.125.200.0-255,3961,48967,64,388046
39739,0.000289,172.31.40.0-255,66,49033,64,388046
39740,0.00038,74.125.200.0-255,1484,50517,64,388046
39741,0.000404,74.125.200.0-255,2902,53419,64,388046
39742,0.000407,172.31.40.0-255,66,53485,64,388046
39743,0.00044,74.125.200.0-255,5738,59223,64,388046
39744,0.000443,172.31.40.0-255,66,59289,64,388046
39745,0.000447,74.125.200.0-255,2902,62191,64,388046
39746,0.00045,172.31.40.0-255,66,62257,64,388046
39747,0.000455,74.125.200.0-255,3961,66218,64,388046
39748,0.000457,172.31.40.0-255,66,66284,64,388046
39749,0.000488,74.125.200.0-255,647,66931,64,388046
39750,0.000627,74.125.200.0-255,1484,68415,64,388046
39751,0.000631,172.31.40.0-255,66,68481,64,388046
39752,0.000639,74.125.200.0-255,2902,71383,64,388046
39753,0.000642,172.31.40.0-255,66,71449,64,388046
39754,0.000672,74.125.200.0-255,5738,77187,64,388046
39755,0.000675,172.31.40.0-255,66,77253,64,388046
39756,0.000688,74.125.200.0-255,4320,81573,64,388046
39757,0.000691,172.31.40.0-255,66,81639,64,388046
39758,0.000722,172.31.40.0-255,66,81705,64,388046
39759,0.000741,74.125.200.0-255,4320,86025,64,388046
39760,0.000743,172.31.40.0-255,66,86091,64,388046
39761,0.000771,74.125.200.0-255,6438,92529,64,388046
39762,0.000774,172.31.40.0-255,66,92595,64,388046
39763,0.001257,74.125.200.0-255,1484,94079,64,388046
39764,0.001262,74.125.200.0-255,1484,95563,64,388046
39765,0.001266,172.31.40.0-255,66,95629,64,388046
39766,0.001284,74.125.200.0-255,1484,97113,64,388046
39767,0.001291,74.125.200.0-255,5738,102851,64,388046
39768,0.001293,172.31.40.0-255,66,102917,64,388046
39769,0.001297,74.125.200.0-255,2902,105819,64,388046
39770,0.0013,172.31.40.0-255,66,105885,64,388046
39771,0.001329,74.125.200.0-255,2902,108787,64,388046
39772,0.001332,172.31.40.0-255,66,108853,64,388046
39773,0.001357,74.125.200.0-255,7156,116009,64,388046
39774,0.001359,172.31.40.0-255,66,116075,64,388046
39775,0.001382,74.125.200.0-255,7156,123231,64,388046
39776,0.001385,172.31.40.0-255,66,123297,64,388046
39777,0.001406,74.125.200.0-255,3602,126899,64,388046
39778,0.001408,172.31.40.0-255,66,126965,64,388046
39779,0.001477,74.125.200.0-255,1484,128449,64,388046
39780,0.001482,74.125.200.0-255,2902,131351,64,388046
39781,0.001485,172.31.40.0-255,66,131417,64,388046
39782,0.001502,74.125.200.0-255,1484,132901,64,388046
39783,0.001513,74.125.200.0-255,1484,134385,64,388046
39784,0.001515,172.31.40.0-255,66,134451,64,388046
39785,0.001532,74.125.200.0-255,2902,137353,64,388046
39786,0.001535,172.31.40.0-255,66,137419,64,388046
39787,0.00154,74.125.200.0-255,4320,141739,64,388046
39788,0.001542,172.31.40.0-255,66,141805,64,388046
39789,0.001573,172.31.40.0-255,66,141871,64,388046
39790,0.001593,74.125.200.0-255,1484,143355,64,388046
39791,0.001611,74.125.200.0-255,4320,147675,64,388046
39792,0.001615,172.31.40.0-255,66,147741,64,388046
39793,0.001635,74.125.200.0-255,5020,152761,64,388046
39794,0.001638,172.31.40.0-255,66,152827,64,388046
39795,0.001641,74.125.200.0-255,1484,154311,64,388046
39796,0.001664,74.125.200.0-255,2902,157213,64,388046
39797,0.001669,172.31.40.0-255,66,157279,64,388046
39798,0.001693,74.125.200.0-255,5738,163017,64,388046
39799,0.001696,172.31.40.0-255,66,163083,64,388046
39800,0.001702,74.125.200.0-255,4320,167403,64,388046
39801,0.001704,172.31.40.0-255,66,167469,64,388046
39802,0.00171,74.125.200.0-255,5738,173207,64,388046
39803,0.001713,172.31.40.0-255,66,173273,64,388046
39804,0.001749,74.125.200.0-255,4320,177593,64,388046
39805,0.001759,172.31.40.0-255,66,177659,64,388046
39806,0.001765,74.125.200.0-255,4320,181979,64,388046
39807,0.001767,172.31.40.0-255,66,182045,64,388046
39808,0.001793,74.125.200.0-255,2902,184947,64,388046
39809,0.001795,172.31.40.0-255,66,185013,64,388046
39810,0.0018,74.125.200.0-255,2184,187197,64,388046
39811,0.001802,172.31.40.0-255,66,187263,64,388046
39812,0.001804,74.125.200.0-255,1484,188747,64,388046
39813,0.001808,74.125.200.0-255,1484,190231,64,388046
39814,0.00181,172.31.40.0-255,66,190297,64,388046
39815,0.001824,74.125.200.0-255,1484,191781,64,388046
39816,0.001831,74.125.200.0-255,5738,197519,64,388046
39817,0.001833,172.31.40.0-255,66,197585,64,388046
39818,0.001839,74.125.200.0-255,4320,201905,64,388046
39819,0.001841,172.31.40.0-255,66,201971,64,388046
39820,0.001847,74.125.200.0-255,5738,207709,64,388046
39821,0.001849,172.31.40.0-255,66,207775,64,388046
39822,0.001861,172.31.40.0-255,66,207841,64,388046
39823,0.001865,74.125.200.0-255,2184,210025,64,388046
39824,0.001869,172.31.40.0-255,66,210091,64,388046
39825,0.001994,74.125.200.0-255,1484,211575,64,388046
39826,0.002001,74.125.200.0-255,2902,214477,64,388046
39827,0.002005,172.31.40.0-255,66,214543,64,388046
39828,0.00201,74.125.200.0-255,2902,217445,64,388046
39829,0.002013,172.31.40.0-255,66,217511,64,388046
39830,0.002027,74.125.200.0-255,1484,218995,64,388046
39831,0.002032,74.125.200.0-255,2902,221897,64,388046
39832,0.002034,172.31.40.0-255,66,221963,64,388046
39833,0.004006,74.125.200.0-255,1484,223447,64,388046
39834,0.004028,74.125.200.0-255,4320,227767,64,388046
39835,0.004033,172.31.40.0-255,66,227833,64,388046
39836,0.006035,74.125.200.0-255,5738,233571,64,388046
39837,0.006042,172.31.40.0-255,66,233637,64,388046
39838,0.008048,74.125.200.0-255,5738,239375,64,388046
39839,0.008055,172.31.40.0-255,66,239441,64,388046
39840,0.010072,74.125.200.0-255,5738,245179,64,388046
39841,0.01009,172.31.40.0-255,66,245245,64,388046
39842,0.012101,74.125.200.0-255,5738,250983,64,388046
39843,0.012117,172.31.40.0-255,66,251049,64,388046
39844,0.014129,74.125.200.0-255,5738,256787,64,388046
39845,0.014142,172.31.40.0-255,66,256853,64,388046
39846,0.016194,74.125.200.0-255,5738,262591,64,388046
39847,0.016211,172.31.40.0-255,66,262657,64,388046
39848,0.01821,74.125.200.0-255,5738,268395,64,388046
39849,0.01822,172.31.40.0-255,66,268461,64,388046
39850,0.020232,74.125.200.0-255,5738,274199,64,388046
39851,0.02024,172.31.40.0-255,66,274265,64,388046
39852,0.022242,74.125.200.0-255,5738,280003,64,388046
39853,0.022253,172.31.40.0-255,66,280069,64,388046
39854,0.024254,74.125.200.0-255,5738,285807,64,388046
39855,0.024266,172.31.40.0-255,66,285873,64,388046
39856,0.026272,74.125.200.0-255,5738,291611,64,388046
39857,0.026282,172.31.40.0-255,66,291677,64,388046
39858,0.028286,74.125.200.0-255,5738,297415,64,388046
39859,0.028301,172.31.40.0-255,66,297481,64,388046
39860,0.030306,74.125.200.0-255,5738,303219,64,388046
39861,0.030315,172.31.40.0-255,66,303285,64,388046
39862,0.032322,74.125.200.0-255,5738,309023,64,388046
39863,0.032332,172.31.40.0-255,66,309089,64,388046
39864,0.034347,74.125.200.0-255,5738,314827,64,388046
39865,0.034366,172.31.40.0-255,66,314893,64,388046
39866,0.036367,74.125.200.0-255,5738,320631,64,388046
39867,0.036377,172.31.40.0-255,66,320697,64,388046
39868,0.03839,74.125.200.0-255,5738,326435,64,388046
39869,0.038406,172.31.40.0-255,66,326501,64,388046
39870,0.040412,74.125.200.0-255,5738,332239,64,388046
39871,0.04042,172.31.40.0-255,66,332305,64,388046
39872,0.042425,74.125.200.0-255,5738,338043,64,388046
39873,0.042434,172.31.40.0-255,66,338109,64,388046
39874,0.044456,74.125.200.0-255,5738,343847,64,388046
39875,0.044478,172.31.40.0-255,66,343913,64,388046
39876,0.046504,74.125.200.0-255,5738,349651,64,388046
39877,0.046517,172.31.40.0-255,66,349717,64,388046
39878,0.048524,74.125.200.0-255,5738,355455,64,388046
39879,0.048535,172.31.40.0-255,66,355521,64,388046
39880,0.050535,74.125.200.0-255,5738,361259,64,388046
39881,0.050544,172.31.40.0-255,66,361325,64,388046
39882,0.051608,172.31.40.0-255,172,361497,64,388046
39883,0.051646,172.31.40.0-255,1113,362610,64,388046
39884,0.051726,172.31.40.0-255,1514,364124,64,388046
39885,0.051728,172.31.40.0-255,334,364458,64,388046
39886,0.052544,74.125.200.0-255,5738,370196,64,388046
39887,0.052553,172.31.40.0-255,66,370262,64,388046
39888,0.053113,104.244.42.0-255,66,370328,64,388046
39889,0.053144,104.244.42.0-255,66,370394,64,388046
39890,0.053243,104.244.42.0-255,66,370460,64,388046
39891,0.054219,104.244.42.0-255,108,370568,64,388046
39892,0.054229,172.31.40.0-255,66,370634,64,388046
39893,0.054556,74.125.200.0-255,5738,376372,64,388046
39894,0.054563,172.31.40.0-255,66,376438,64,388046
39895,0.056574,74.125.200.0-255,5738,382176,64,388046
39896,0.056589,172.31.40.0-255,66,382242,64,388046
39897,0.05861,74.125.200.0-255,5738,387980,64,388046
39898,0.058627,172.31.40.0-255,66,388046,64,388046
39899,0.0,172.217.194.0-255,153,153,64,225388
39900,2.2e-05,172.31.40.0-255,66,219,64,225388
39901,2.9e-05,172.217.194.0-255,1484,1703,64,225388
39902,3.4e-05,172.31.40.0-255,66,1769,64,225388
39903,4.1e-05,172.217.194.0-255,2902,4671,64,225388
39904,4.5e-05,172.31.40.0-255,66,4737,64,225388
39905,5.3e-05,172.217.194.0-255,7156,11893,64,225388
39906,5.7e-05,172.31.40.0-255,66,11959,64,225388
39907,6.1e-05,172.217.194.0-255,2020,13979,64,225388
39908,6.4e-05,172.31.40.0-255,66,14045,64,225388
39909,8.7e-05,172.217.194.0-255,1484,15529,64,225388
39910,9e-05,172.31.40.0-255,66,15595,64,225388
39911,0.000114,172.217.194.0-255,2902,18497,64,225388
39912,0.000117,172.31.40.0-255,66,18563,64,225388
39913,0.000121,172.217.194.0-255,2902,21465,64,225388
39914,0.000123,172.31.40.0-255,66,21531,64,225388
39915,0.000138,172.217.194.0-255,2902,24433,64,225388
39916,0.00014,172.31.40.0-255,66,24499,64,225388
39917,0.000143,172.217.194.0-255,1484,25983,64,225388
39918,0.000145,172.31.40.0-255,66,26049,64,225388
39919,0.000175,172.217.194.0-255,5379,31428,64,225388
39920,0.000178,172.31.40.0-255,66,31494,64,225388
39921,0.000195,172.217.194.0-255,1484,32978,64,225388
39922,0.000197,172.31.40.0-255,66,33044,64,225388
39923,0.000202,172.217.194.0-255,2902,35946,64,225388
39924,0.000204,172.31.40.0-255,66,36012,64,225388
39925,0.000225,172.217.194.0-255,5738,41750,64,225388
39926,0.000228,172.31.40.0-255,66,41816,64,225388
39927,0.000242,172.217.194.0-255,1484,43300,64,225388
39928,0.000244,172.31.40.0-255,66,43366,64,225388
39929,0.000262,172.217.194.0-255,5379,48745,64,225388
39930,0.000265,172.31.40.0-255,66,48811,64,225388
39931,0.001578,172.217.194.0-255,1484,50295,64,225388
39932,0.00159,172.217.194.0-255,2902,53197,64,225388
39933,0.001595,172.31.40.0-255,66,53263,64,225388
39934,0.001604,172.217.194.0-255,5738,59001,64,225388
39935,0.001606,172.31.40.0-255,66,59067,64,225388
39936,0.001644,172.217.194.0-255,6797,65864,64,225388
39937,0.001646,172.31.40.0-255,66,65930,64,225388
39938,0.001661,172.217.194.0-255,2902,68832,64,225388
39939,0.001663,172.31.40.0-255,66,68898,64,225388
39940,0.001698,172.31.40.0-255,66,68964,64,225388
39941,0.001704,172.217.194.0-255,4320,73284,64,225388
39942,0.001706,172.31.40.0-255,66,73350,64,225388
39943,0.00172,172.217.194.0-255,4320,77670,64,225388
39944,0.001722,172.31.40.0-255,66,77736,64,225388
39945,0.001759,172.217.194.0-255,7156,84892,64,225388
39946,0.001762,172.31.40.0-255,66,84958,64,225388
39947,0.001782,172.217.194.0-255,3602,88560,64,225388
39948,0.001785,172.31.40.0-255,66,88626,64,225388
39949,0.002344,172.217.194.0-255,1484,90110,64,225388
39950,0.002358,172.217.194.0-255,2902,93012,64,225388
39951,0.002361,172.31.40.0-255,66,93078,64,225388
39952,0.002406,172.217.194.0-255,4320,97398,64,225388
39953,0.002409,172.31.40.0-255,66,97464,64,225388
39954,0.002423,172.217.194.0-255,1484,98948,64,225388
39955,0.002437,172.31.40.0-255,66,99014,64,225388
39956,0.00244,172.217.194.0-255,1484,100498,64,225388
39957,0.002474,172.31.40.0-255,66,100564,64,225388
39958,0.005062,172.217.194.0-255,4320,104884,64,225388
39959,0.005066,172.31.40.0-255,66,104950,64,225388
39960,0.005083,172.217.194.0-255,1484,106434,64,225388
39961,0.007682,172.217.194.0-255,4320,110754,64,225388
39962,0.007689,172.31.40.0-255,66,110820,64,225388
39963,0.010297,172.217.194.0-255,5738,116558,64,225388
39964,0.010305,172.31.40.0-255,66,116624,64,225388
39965,0.012907,172.217.194.0-255,5738,122362,64,225388
39966,0.012916,172.31.40.0-255,66,122428,64,225388
39967,0.015514,172.217.194.0-255,5738,128166,64,225388
39968,0.015526,172.31.40.0-255,66,128232,64,225388
39969,0.018125,172.217.194.0-255,5738,133970,64,225388
39970,0.018134,172.31.40.0-255,66,134036,64,225388
39971,0.020732,172.217.194.0-255,5738,139774,64,225388
39972,0.02074,172.31.40.0-255,66,139840,64,225388
39973,0.023335,172.217.194.0-255,5738,145578,64,225388
39974,0.023345,172.31.40.0-255,66,145644,64,225388
39975,0.025939,172.217.194.0-255,5738,151382,64,225388
39976,0.025946,172.31.40.0-255,66,151448,64,225388
39977,0.026958,172.31.40.0-255,172,151620,64,225388
39978,0.026997,172.31.40.0-255,1111,152731,64,225388
39979,0.027054,172.31.40.0-255,1514,154245,64,225388
39980,0.027056,172.31.40.0-255,1297,155542,64,225388
39981,0.028504,104.244.42.0-255,66,155608,64,225388
39982,0.02854,104.244.42.0-255,66,155674,64,225388
39983,0.028564,172.217.194.0-255,5738,161412,64,225388
39984,0.028568,172.31.40.0-255,66,161478,64,225388
39985,0.02859,104.244.42.0-255,66,161544,64,225388
39986,0.031178,172.217.194.0-255,5738,167282,64,225388
39987,0.031185,172.31.40.0-255,66,167348,64,225388
39988,0.033792,172.217.194.0-255,5738,173086,64,225388
39989,0.033799,172.31.40.0-255,66,173152,64,225388
39990,0.036451,172.217.194.0-255,5738,178890,64,225388
39991,0.036457,172.31.40.0-255,66,178956,64,225388
39992,0.039028,172.217.194.0-255,5738,184694,64,225388
39993,0.039035,172.31.40.0-255,66,184760,64,225388
39994,0.041662,172.217.194.0-255,5738,190498,64,225388
39995,0.041671,172.31.40.0-255,66,190564,64,225388
39996,0.044316,172.217.194.0-255,5738,196302,64,225388
39997,0.044323,172.31.40.0-255,66,196368,64,225388
39998,0.046952,172.217.194.0-255,5738,202106,64,225388
39999,0.046959,172.31.40.0-255,66,202172,64,225388
40000,0.049556,172.217.194.0-255,5738,207910,64,225388
40001,0.049563,172.31.40.0-255,66,207976,64,225388
40002,0.052177,172.217.194.0-255,5738,213714,64,225388
40003,0.052183,172.31.40.0-255,66,213780,64,225388
40004,0.054786,172.217.194.0-255,5738,219518,64,225388
40005,0.054792,172.31.40.0-255,66,219584,64,225388
40006,0.057442,172.217.194.0-255,5738,225322,64,225388
40007,0.057448,172.31.40.0-255,66,225388,64,225388
40008,0.0,74.125.24.0-255,146,146,64,248734
40009,2.1e-05,172.31.40.0-255,66,212,64,248734
40010,2.8e-05,74.125.24.0-255,1484,1696,64,248734
40011,3.2e-05,172.31.40.0-255,66,1762,64,248734
40012,3.7e-05,74.125.24.0-255,2902,4664,64,248734
40013,3.9e-05,172.31.40.0-255,66,4730,64,248734
40014,5.3e-05,74.125.24.0-255,7156,11886,64,248734
40015,5.6e-05,172.31.40.0-255,66,11952,64,248734
40016,6e-05,74.125.24.0-255,1984,13936,64,248734
40017,6.3e-05,172.31.40.0-255,66,14002,64,248734
40018,9.6e-05,172.31.40.0-255,66,14068,64,248734
40019,0.000114,74.125.24.0-255,1484,15552,64,248734
40020,0.000117,172.31.40.0-255,66,15618,64,248734
40021,0.000122,74.125.24.0-255,5379,20997,64,248734
40022,0.000124,172.31.40.0-255,66,21063,64,248734
40023,0.000158,74.125.24.0-255,1484,22547,64,248734
40024,0.00016,172.31.40.0-255,66,22613,64,248734
40025,0.000165,74.125.24.0-255,2902,25515,64,248734
40026,0.000167,172.31.40.0-255,66,25581,64,248734
40027,0.000202,74.125.24.0-255,5738,31319,64,248734
40028,0.000205,172.31.40.0-255,66,31385,64,248734
40029,0.000209,74.125.24.0-255,4320,35705,64,248734
40030,0.00021,172.31.40.0-255,66,35771,64,248734
40031,0.000213,74.125.24.0-255,1484,37255,64,248734
40032,0.000215,172.31.40.0-255,66,37321,64,248734
40033,0.000253,172.31.40.0-255,66,37387,64,248734
40034,0.00026,74.125.24.0-255,6797,44184,64,248734
40035,0.000262,172.31.40.0-255,66,44250,64,248734
40036,0.000264,74.125.24.0-255,435,44685,64,248734
40037,0.000266,172.31.40.0-255,66,44751,64,248734
40038,0.000368,74.125.24.0-255,1484,46235,64,248734
40039,0.000373,74.125.24.0-255,1484,47719,64,248734
40040,0.000375,172.31.40.0-255,66,47785,64,248734
40041,0.000401,74.125.24.0-255,1484,49269,64,248734
40042,0.000407,74.125.24.0-255,5738,55007,64,248734
40043,0.000409,172.31.40.0-255,66,55073,64,248734
40044,0.000411,74.125.24.0-255,1484,56557,64,248734
40045,0.000438,74.125.24.0-255,5072,61629,64,248734
40046,0.00044,172.31.40.0-255,66,61695,64,248734
40047,0.000559,74.125.24.0-255,1484,63179,64,248734
40048,0.000563,74.125.24.0-255,1484,64663,64,248734
40049,0.000566,172.31.40.0-255,66,64729,64,248734
40050,0.000592,74.125.24.0-255,1484,66213,64,248734
40051,0.000598,74.125.24.0-255,5738,71951,64,248734
40052,0.000601,172.31.40.0-255,66,72017,64,248734
40053,0.000603,74.125.24.0-255,1484,73501,64,248734
40054,0.000635,172.31.40.0-255,66,73567,64,248734
40055,0.000642,74.125.24.0-255,7156,80723,64,248734
40056,0.000644,172.31.40.0-255,66,80789,64,248734
40057,0.000665,74.125.24.0-255,2543,83332,64,248734
40058,0.000667,172.31.40.0-255,66,83398,64,248734
40059,0.000834,74.125.24.0-255,1484,84882,64,248734
40060,0.000856,74.125.24.0-255,2902,87784,64,248734
40061,0.00086,172.31.40.0-255,66,87850,64,248734
40062,0.000862,74.125.24.0-255,1484,89334,64,248734
40063,0.000886,74.125.24.0-255,1484,90818,64,248734
40064,0.000889,172.31.40.0-255,66,90884,64,248734
40065,0.000896,74.125.24.0-255,7156,98040,64,248734
40066,0.000898,172.31.40.0-255,66,98106,64,248734
40067,0.000936,74.125.24.0-255,2902,101008,64,248734
40068,0.000939,172.31.40.0-255,66,101074,64,248734
40069,0.000974,172.31.40.0-255,66,101140,64,248734
40070,0.000978,74.125.24.0-255,3602,104742,64,248734
40071,0.00098,172.31.40.0-255,66,104808,64,248734
40072,0.00104,74.125.24.0-255,1484,106292,64,248734
40073,0.001053,74.125.24.0-255,2902,109194,64,248734
40074,0.001056,172.31.40.0-255,66,109260,64,248734
40075,0.001088,74.125.24.0-255,5738,114998,64,248734
40076,0.001091,172.31.40.0-255,66,115064,64,248734
40077,0.001097,74.125.24.0-255,5738,120802,64,248734
40078,0.001098,172.31.40.0-255,66,120868,64,248734
40079,0.001133,74.125.24.0-255,7156,128024,64,248734
40080,0.001136,172.31.40.0-255,66,128090,64,248734
40081,0.00115,172.31.40.0-255,66,128156,64,248734
40082,0.001214,74.125.24.0-255,1484,129640,64,248734
40083,0.001218,74.125.24.0-255,1484,131124,64,248734
40084,0.00122,172.31.40.0-255,66,131190,64,248734
40085,0.00125,74.125.24.0-255,1484,132674,64,248734
40086,0.001256,74.125.24.0-255,5738,138412,64,248734
40087,0.001258,172.31.40.0-255,66,138478,64,248734
40088,0.001265,74.125.24.0-255,7156,145634,64,248734
40089,0.001267,172.31.40.0-255,66,145700,64,248734
40090,0.001284,74.125.24.0-255,5738,151438,64,248734
40091,0.001292,74.125.24.0-255,5738,157176,64,248734
40092,0.001329,172.31.40.0-255,66,157242,64,248734
40093,0.001333,172.31.40.0-255,66,157308,64,248734
40094,0.001366,74.125.24.0-255,5020,162328,64,248734
40095,0.001368,172.31.40.0-255,66,162394,64,248734
40096,0.001371,74.125.24.0-255,1484,163878,64,248734
40097,0.0014,74.125.24.0-255,2902,166780,64,248734
40098,0.001404,172.31.40.0-255,66,166846,64,248734
40099,0.00141,74.125.24.0-255,5738,172584,64,248734
40100,0.001412,172.31.40.0-255,66,172650,64,248734
40101,0.00145,172.31.40.0-255,66,172716,64,248734
40102,0.001457,74.125.24.0-255,5738,178454,64,248734
40103,0.001459,172.31.40.0-255,66,178520,64,248734
40104,0.001478,74.125.24.0-255,1484,180004,64,248734
40105,0.001519,74.125.24.0-255,6438,186442,64,248734
40106,0.001543,74.125.24.0-255,5020,191462,64,248734
40107,0.001546,172.31.40.0-255,66,191528,64,248734
40108,0.001551,172.31.40.0-255,66,191594,64,248734
40109,0.001558,74.125.24.0-255,1484,193078,64,248734
40110,0.001588,74.125.24.0-255,4320,197398,64,248734
40111,0.001606,74.125.24.0-255,5738,203136,64,248734
40112,0.001629,172.31.40.0-255,66,203202,64,248734
40113,0.001652,74.125.24.0-255,7156,210358,64,248734
40114,0.001663,172.31.40.0-255,66,210424,64,248734
40115,0.001673,74.125.24.0-255,2184,212608,64,248734
40116,0.001687,74.125.24.0-255,2902,215510,64,248734
40117,0.001702,172.31.40.0-255,66,215576,64,248734
40118,0.001714,74.125.24.0-255,7156,222732,64,248734
40119,0.001725,74.125.24.0-255,5738,228470,64,248734
40120,0.001741,172.31.40.0-255,66,228536,64,248734
40121,0.001772,74.125.24.0-255,7156,235692,64,248734
40122,0.001795,172.31.40.0-255,66,235758,64,248734
40123,0.001808,74.125.24.0-255,4320,240078,64,248734
40124,0.001826,172.31.40.0-255,66,240144,64,248734
40125,0.001889,74.125.24.0-255,97,240241,64,248734
40126,0.001933,172.31.40.0-255,66,240307,64,248734
40127,0.001944,74.125.24.0-255,105,240412,64,248734
40128,0.016257,172.31.40.0-255,66,240478,64,248734
40129,0.016305,172.31.40.0-255,105,240583,64,248734
40130,0.018537,74.125.24.0-255,66,240649,64,248734
40131,0.047751,172.31.40.0-255,172,240821,64,248734
40132,0.047786,172.31.40.0-255,1111,241932,64,248734
40133,0.047854,172.31.40.0-255,1514,243446,64,248734
40134,0.047856,172.31.40.0-255,1514,244960,64,248734
40135,0.047857,172.31.40.0-255,1514,246474,64,248734
40136,0.047884,172.31.40.0-255,1514,247988,64,248734
40137,0.047886,172.31.40.0-255,482,248470,64,248734
40138,0.049268,104.244.42.0-255,66,248536,64,248734
40139,0.049314,104.244.42.0-255,66,248602,64,248734
40140,0.049413,104.244.42.0-255,66,248668,64,248734
40141,0.049417,104.244.42.0-255,66,248734,64,248734
40142,0.0,172.217.194.0-255,291,291,64,162639
40143,1e-05,172.31.40.0-255,66,357,64,162639
40144,6.8e-05,172.217.194.0-255,1484,1841,64,162639
40145,7.4e-05,172.31.40.0-255,66,1907,64,162639
40146,0.000106,172.217.194.0-255,2902,4809,64,162639
40147,0.000109,172.31.40.0-255,66,4875,64,162639
40148,0.000116,172.217.194.0-255,5738,10613,64,162639
40149,0.000119,172.31.40.0-255,66,10679,64,162639
40150,0.000123,172.217.194.0-255,1484,12163,64,162639
40151,0.000125,172.31.40.0-255,66,12229,64,162639
40152,0.000154,172.217.194.0-255,1871,14100,64,162639
40153,0.000156,172.31.40.0-255,66,14166,64,162639
40154,0.000181,172.217.194.0-255,4320,18486,64,162639
40155,0.000184,172.31.40.0-255,66,18552,64,162639
40156,0.000199,172.217.194.0-255,7156,25708,64,162639
40157,0.000201,172.31.40.0-255,66,25774,64,162639
40158,0.000239,172.217.194.0-255,2902,28676,64,162639
40159,0.000242,172.31.40.0-255,66,28742,64,162639
40160,0.00027,172.217.194.0-255,2543,31285,64,162639
40161,0.000274,172.31.40.0-255,66,31351,64,162639
40162,0.004125,172.217.194.0-255,1484,32835,64,162639
40163,0.004134,172.31.40.0-255,66,32901,64,162639
40164,0.004142,172.217.194.0-255,2902,35803,64,162639
40165,0.004145,172.31.40.0-255,66,35869,64,162639
40166,0.004155,172.217.194.0-255,1484,37353,64,162639
40167,0.004158,172.31.40.0-255,66,37419,64,162639
40168,0.00667,172.217.194.0-255,2902,40321,64,162639
40169,0.006677,172.31.40.0-255,66,40387,64,162639
40170,0.006708,172.217.194.0-255,2902,43289,64,162639
40171,0.00671,172.31.40.0-255,66,43355,64,162639
40172,0.009219,172.217.194.0-255,2902,46257,64,162639
40173,0.009225,172.31.40.0-255,66,46323,64,162639
40174,0.009256,172.217.194.0-255,2902,49225,64,162639
40175,0.009259,172.31.40.0-255,66,49291,64,162639
40176,0.011795,172.217.194.0-255,2902,52193,64,162639
40177,0.011803,172.31.40.0-255,66,52259,64,162639
40178,0.011835,172.217.194.0-255,2902,55161,64,162639
40179,0.011854,172.31.40.0-255,66,55227,64,162639
40180,0.015412,172.217.194.0-255,4320,59547,64,162639
40181,0.015424,172.31.40.0-255,66,59613,64,162639
40182,0.015455,172.217.194.0-255,1484,61097,64,162639
40183,0.017975,172.217.194.0-255,4320,65417,64,162639
40184,0.017984,172.31.40.0-255,66,65483,64,162639
40185,0.020537,172.217.194.0-255,5738,71221,64,162639
40186,0.020577,172.31.40.0-255,66,71287,64,162639
40187,0.023027,172.31.40.0-255,172,71459,64,162639
40188,0.023055,172.31.40.0-255,1112,72571,64,162639
40189,0.023104,172.31.40.0-255,1514,74085,64,162639
40190,0.023105,172.31.40.0-255,1296,75381,64,162639
40191,0.023144,172.217.194.0-255,5738,81119,64,162639
40192,0.023148,172.31.40.0-255,66,81185,64,162639
40193,0.024606,104.244.42.0-255,66,81251,64,162639
40194,0.024614,104.244.42.0-255,66,81317,64,162639
40195,0.024674,104.244.42.0-255,66,81383,64,162639
40196,0.025697,172.217.194.0-255,5738,87121,64,162639
40197,0.025704,172.31.40.0-255,66,87187,64,162639
40198,0.028262,172.217.194.0-255,5738,92925,64,162639
40199,0.02827,172.31.40.0-255,66,92991,64,162639
40200,0.03083,172.217.194.0-255,5738,98729,64,162639
40201,0.030837,172.31.40.0-255,66,98795,64,162639
40202,0.033414,172.217.194.0-255,5738,104533,64,162639
40203,0.033421,172.31.40.0-255,66,104599,64,162639
40204,0.035971,172.217.194.0-255,5738,110337,64,162639
40205,0.035978,172.31.40.0-255,66,110403,64,162639
40206,0.038522,172.217.194.0-255,5738,116141,64,162639
40207,0.038528,172.31.40.0-255,66,116207,64,162639
40208,0.041082,172.217.194.0-255,5738,121945,64,162639
40209,0.041087,172.31.40.0-255,66,122011,64,162639
40210,0.043611,172.217.194.0-255,5738,127749,64,162639
40211,0.043617,172.31.40.0-255,66,127815,64,162639
40212,0.046178,172.217.194.0-255,5738,133553,64,162639
40213,0.046185,172.31.40.0-255,66,133619,64,162639
40214,0.048725,172.217.194.0-255,5738,139357,64,162639
40215,0.048729,172.31.40.0-255,66,139423,64,162639
40216,0.051277,172.217.194.0-255,5738,145161,64,162639
40217,0.051283,172.31.40.0-255,66,145227,64,162639
40218,0.053815,172.217.194.0-255,5738,150965,64,162639
40219,0.053821,172.31.40.0-255,66,151031,64,162639
40220,0.056405,172.217.194.0-255,5738,156769,64,162639
40221,0.056411,172.31.40.0-255,66,156835,64,162639
40222,0.058966,172.217.194.0-255,5738,162573,64,162639
40223,0.058975,172.31.40.0-255,66,162639,64,162639
40224,0.0,172.217.27.0-255,146,146,64,308052
40225,2e-05,172.31.40.0-255,66,212,64,308052
40226,2.7e-05,172.217.27.0-255,1484,1696,64,308052
40227,3.1e-05,172.31.40.0-255,66,1762,64,308052
40228,3.7e-05,172.217.27.0-255,2902,4664,64,308052
40229,4e-05,172.31.40.0-255,66,4730,64,308052
40230,4.7e-05,172.217.27.0-255,7156,11886,64,308052
40231,4.9e-05,172.31.40.0-255,66,11952,64,308052
40232,5.3e-05,172.217.27.0-255,1998,13950,64,308052
40233,5.6e-05,172.31.40.0-255,66,14016,64,308052
40234,9.2e-05,172.217.27.0-255,2902,16918,64,308052
40235,9.5e-05,172.31.40.0-255,66,16984,64,308052
40236,9.9e-05,172.217.27.0-255,2902,19886,64,308052
40237,0.000101,172.31.40.0-255,66,19952,64,308052
40238,0.000105,172.217.27.0-255,2902,22854,64,308052
40239,0.000108,172.31.40.0-255,66,22920,64,308052
40240,0.000124,172.217.27.0-255,1484,24404,64,308052
40241,0.000126,172.31.40.0-255,66,24470,64,308052
40242,0.000146,172.217.27.0-255,2902,27372,64,308052
40243,0.000148,172.31.40.0-255,66,27438,64,308052
40244,0.000161,172.217.27.0-255,3961,31399,64,308052
40245,0.000163,172.31.40.0-255,66,31465,64,308052
40246,0.000214,172.217.27.0-255,1484,32949,64,308052
40247,0.000217,172.31.40.0-255,66,33015,64,308052
40248,0.00022,172.217.27.0-255,1484,34499,64,308052
40249,0.000222,172.31.40.0-255,66,34565,64,308052
40250,0.000233,172.217.27.0-255,1484,36049,64,308052
40251,0.000235,172.31.40.0-255,66,36115,64,308052
40252,0.000241,172.217.27.0-255,5738,41853,64,308052
40253,0.000243,172.31.40.0-255,66,41919,64,308052
40254,0.000247,172.217.27.0-255,2902,44821,64,308052
40255,0.000249,172.31.40.0-255,66,44887,64,308052
40256,0.000274,172.217.27.0-255,2902,47789,64,308052
40257,0.000281,172.217.27.0-255,6797,54586,64,308052
40258,0.000331,172.217.27.0-255,395,54981,64,308052
40259,0.000434,172.31.40.0-255,66,55047,64,308052
40260,0.00062,172.217.27.0-255,116,55163,64,308052
40261,0.000625,172.217.27.0-255,329,55492,64,308052
40262,0.000856,172.217.27.0-255,1484,56976,64,308052
40263,0.00086,172.31.40.0-255,66,57042,64,308052
40264,0.000866,172.217.27.0-255,2902,59944,64,308052
40265,0.000878,172.31.40.0-255,66,60010,64,308052
40266,0.000885,172.217.27.0-255,5738,65748,64,308052
40267,0.000889,172.31.40.0-255,66,65814,64,308052
40268,0.000899,172.217.27.0-255,5738,71552,64,308052
40269,0.000913,172.217.27.0-255,7156,78708,64,308052
40270,0.00092,172.217.27.0-255,7156,85864,64,308052
40271,0.000936,172.31.40.0-255,66,85930,64,308052
40272,0.000957,172.217.27.0-255,3602,89532,64,308052
40273,0.000972,172.31.40.0-255,66,89598,64,308052
40274,0.001081,172.217.27.0-255,1484,91082,64,308052
40275,0.001098,172.217.27.0-255,2902,93984,64,308052
40276,0.001101,172.31.40.0-255,66,94050,64,308052
40277,0.001104,172.217.27.0-255,1484,95534,64,308052
40278,0.001125,172.217.27.0-255,4320,99854,64,308052
40279,0.00113,172.217.27.0-255,4320,104174,64,308052
40280,0.001134,172.217.27.0-255,5738,109912,64,308052
40281,0.001149,172.31.40.0-255,66,109978,64,308052
40282,0.001169,172.217.27.0-255,2184,112162,64,308052
40283,0.001184,172.31.40.0-255,66,112228,64,308052
40284,0.002801,172.217.27.0-255,5738,117966,64,308052
40285,0.002808,172.31.40.0-255,66,118032,64,308052
40286,0.004443,172.217.27.0-255,5738,123770,64,308052
40287,0.006809,172.31.40.0-255,66,123836,64,308052
40288,0.008429,172.217.27.0-255,5738,129574,64,308052
40289,0.008436,172.31.40.0-255,66,129640,64,308052
40290,0.010059,172.217.27.0-255,5738,135378,64,308052
40291,0.010067,172.31.40.0-255,66,135444,64,308052
40292,0.011711,172.217.27.0-255,5738,141182,64,308052
40293,0.012853,172.31.40.0-255,66,141248,64,308052
40294,0.014478,172.217.27.0-255,5738,146986,64,308052
40295,0.014486,172.31.40.0-255,66,147052,64,308052
40296,0.016112,172.217.27.0-255,5738,152790,64,308052
40297,0.016119,172.31.40.0-255,66,152856,64,308052
40298,0.017733,172.217.27.0-255,5738,158594,64,308052
40299,0.01774,172.31.40.0-255,66,158660,64,308052
40300,0.019364,172.217.27.0-255,5738,164398,64,308052
40301,0.019371,172.31.40.0-255,66,164464,64,308052
40302,0.020989,172.217.27.0-255,5738,170202,64,308052
40303,0.020996,172.31.40.0-255,66,170268,64,308052
40304,0.022617,172.217.27.0-255,5738,176006,64,308052
40305,0.022625,172.31.40.0-255,66,176072,64,308052
40306,0.024247,172.217.27.0-255,5738,181810,64,308052
40307,0.024253,172.31.40.0-255,66,181876,64,308052
40308,0.025872,172.217.27.0-255,5738,187614,64,308052
40309,0.025879,172.31.40.0-255,66,187680,64,308052
40310,0.027438,172.31.40.0-255,172,187852,64,308052
40311,0.02747,172.31.40.0-255,1111,188963,64,308052
40312,0.02749,172.217.27.0-255,5738,194701,64,308052
40313,0.027495,172.31.40.0-255,66,194767,64,308052
40314,0.027604,172.31.40.0-255,1514,196281,64,308052
40315,0.027606,172.31.40.0-255,1297,197578,64,308052
40316,0.028991,104.244.42.0-255,66,197644,64,308052
40317,0.029027,104.244.42.0-255,66,197710,64,308052
40318,0.029111,172.217.27.0-255,5738,203448,64,308052
40319,0.029116,172.31.40.0-255,66,203514,64,308052
40320,0.029163,104.244.42.0-255,66,203580,64,308052
40321,0.030755,172.217.27.0-255,5738,209318,64,308052
40322,0.030762,172.31.40.0-255,66,209384,64,308052
40323,0.032418,172.217.27.0-255,5738,215122,64,308052
40324,0.032423,172.31.40.0-255,66,215188,64,308052
40325,0.034067,172.217.27.0-255,5738,220926,64,308052
40326,0.034072,172.31.40.0-255,66,220992,64,308052
40327,0.035714,172.217.27.0-255,5738,226730,64,308052
40328,0.035721,172.31.40.0-255,66,226796,64,308052
40329,0.037343,172.217.27.0-255,5738,232534,64,308052
40330,0.037348,172.31.40.0-255,66,232600,64,308052
40331,0.038969,172.217.27.0-255,5738,238338,64,308052
40332,0.038975,172.31.40.0-255,66,238404,64,308052
40333,0.040597,172.217.27.0-255,5738,244142,64,308052
40334,0.040602,172.31.40.0-255,66,244208,64,308052
40335,0.04222,172.217.27.0-255,5738,249946,64,308052
40336,0.042225,172.31.40.0-255,66,250012,64,308052
40337,0.043866,172.217.27.0-255,5738,255750,64,308052
40338,0.043873,172.31.40.0-255,66,255816,64,308052
40339,0.045495,172.217.27.0-255,5738,261554,64,308052
40340,0.045502,172.31.40.0-255,66,261620,64,308052
40341,0.04712,172.217.27.0-255,5738,267358,64,308052
40342,0.047125,172.31.40.0-255,66,267424,64,308052
40343,0.048745,172.217.27.0-255,5738,273162,64,308052
40344,0.048751,172.31.40.0-255,66,273228,64,308052
40345,0.050382,172.217.27.0-255,5738,278966,64,308052
40346,0.050388,172.31.40.0-255,66,279032,64,308052
40347,0.052008,172.217.27.0-255,5738,284770,64,308052
40348,0.052017,172.31.40.0-255,66,284836,64,308052
40349,0.05364,172.217.27.0-255,5738,290574,64,308052
40350,0.053646,172.31.40.0-255,66,290640,64,308052
40351,0.055272,172.217.27.0-255,5738,296378,64,308052
40352,0.055279,172.31.40.0-255,66,296444,64,308052
40353,0.056898,172.217.27.0-255,5738,302182,64,308052
40354,0.056905,172.31.40.0-255,66,302248,64,308052
40355,0.058529,172.217.27.0-255,5738,307986,64,308052
40356,0.058536,172.31.40.0-255,66,308052,64,308052
40357,0.0,74.125.24.0-255,153,153,64,122479
40358,2.3e-05,172.31.40.0-255,66,219,64,122479
40359,3e-05,74.125.24.0-255,1484,1703,64,122479
40360,3.4e-05,172.31.40.0-255,66,1769,64,122479
40361,4e-05,74.125.24.0-255,2902,4671,64,122479
40362,5.1e-05,172.31.40.0-255,66,4737,64,122479
40363,5.7e-05,74.125.24.0-255,4320,9057,64,122479
40364,6e-05,172.31.40.0-255,66,9123,64,122479
40365,0.000104,74.125.24.0-255,4320,13443,64,122479
40366,0.000107,172.31.40.0-255,66,13509,64,122479
40367,0.000132,74.125.24.0-255,710,14219,64,122479
40368,0.000135,172.31.40.0-255,66,14285,64,122479
40369,0.000162,74.125.24.0-255,2902,17187,64,122479
40370,0.000164,172.31.40.0-255,66,17253,64,122479
40371,0.000188,74.125.24.0-255,2902,20155,64,122479
40372,0.00019,172.31.40.0-255,66,20221,64,122479
40373,0.000245,74.125.24.0-255,4320,24541,64,122479
40374,0.000248,172.31.40.0-255,66,24607,64,122479
40375,0.000278,74.125.24.0-255,6797,31404,64,122479
40376,0.00028,172.31.40.0-255,66,31470,64,122479
40377,0.00046,74.125.24.0-255,1484,32954,64,122479
40378,0.000466,172.31.40.0-255,66,33020,64,122479
40379,0.000472,74.125.24.0-255,2902,35922,64,122479
40380,0.000474,172.31.40.0-255,66,35988,64,122479
40381,0.000505,74.125.24.0-255,5738,41726,64,122479
40382,0.000508,172.31.40.0-255,66,41792,64,122479
40383,0.000578,74.125.24.0-255,4320,46112,64,122479
40384,0.000582,172.31.40.0-255,66,46178,64,122479
40385,0.00062,172.31.40.0-255,66,46244,64,122479
40386,0.000775,172.31.40.0-255,66,46310,64,122479
40387,0.000863,74.125.24.0-255,115,46425,64,122479
40388,0.0009,74.125.24.0-255,4320,50745,64,122479
40389,0.000915,172.31.40.0-255,66,50811,64,122479
40390,0.000927,74.125.24.0-255,7156,57967,64,122479
40391,0.000938,172.31.40.0-255,66,58033,64,122479
40392,0.001047,74.125.24.0-255,5379,63412,64,122479
40393,0.001051,172.31.40.0-255,66,63478,64,122479
40394,0.001121,74.125.24.0-255,5738,69216,64,122479
40395,0.001152,172.31.40.0-255,66,69282,64,122479
40396,0.001344,74.125.24.0-255,4320,73602,64,122479
40397,0.001349,172.31.40.0-255,66,73668,64,122479
40398,0.001393,172.31.40.0-255,66,73734,64,122479
40399,0.001594,74.125.24.0-255,7156,80890,64,122479
40400,0.001598,172.31.40.0-255,66,80956,64,122479
40401,0.001628,172.31.40.0-255,66,81022,64,122479
40402,0.001794,74.125.24.0-255,2902,83924,64,122479
40403,0.001797,172.31.40.0-255,66,83990,64,122479
40404,0.001905,172.31.40.0-255,66,84056,64,122479
40405,0.002241,172.31.40.0-255,66,84122,64,122479
40406,0.002308,172.31.40.0-255,66,84188,64,122479
40407,0.0027,172.31.40.0-255,66,84254,64,122479
40408,0.004043,74.125.24.0-255,4320,88574,64,122479
40409,0.004147,74.125.24.0-255,1484,90058,64,122479
40410,0.004722,74.125.24.0-255,1484,91542,64,122479
40411,0.004735,74.125.24.0-255,2902,94444,64,122479
40412,0.00477,74.125.24.0-255,4320,98764,64,122479
40413,0.004842,74.125.24.0-255,2902,101666,64,122479
40414,0.00505,74.125.24.0-255,2902,104568,64,122479
40415,0.005063,74.125.24.0-255,4320,108888,64,122479
40416,0.005088,74.125.24.0-255,6438,115326,64,122479
40417,0.005287,74.125.24.0-255,3619,118945,64,122479
40418,0.005316,74.125.24.0-255,105,119050,64,122479
40419,0.008695,172.31.40.0-255,66,119116,64,122479
40420,0.010374,172.31.40.0-255,105,119221,64,122479
40421,0.012677,74.125.24.0-255,66,119287,64,122479
40422,0.035521,172.31.40.0-255,167,119454,64,122479
40423,0.035556,172.31.40.0-255,1107,120561,64,122479
40424,0.035618,172.31.40.0-255,1514,122075,64,122479
40425,0.035619,172.31.40.0-255,338,122413,64,122479
40426,0.037266,104.244.42.0-255,66,122479,64,122479
40427,0.0,172.217.194.0-255,290,290,64,236958
40428,1.4e-05,172.31.40.0-255,66,356,64,236958
40429,2e-05,172.217.194.0-255,1484,1840,64,236958
40430,2.5e-05,172.31.40.0-255,66,1906,64,236958
40431,3.9e-05,172.217.194.0-255,4320,6226,64,236958
40432,4.2e-05,172.31.40.0-255,66,6292,64,236958
40433,4.9e-05,172.217.194.0-255,5738,12030,64,236958
40434,5.1e-05,172.31.40.0-255,66,12096,64,236958
40435,6.7e-05,172.217.194.0-255,2902,14998,64,236958
40436,7e-05,172.31.40.0-255,66,15064,64,236958
40437,0.000106,172.31.40.0-255,66,15130,64,236958
40438,0.000109,172.217.194.0-255,1484,16614,64,236958
40439,0.000111,172.31.40.0-255,66,16680,64,236958
40440,0.000115,172.217.194.0-255,1484,18164,64,236958
40441,0.000117,172.31.40.0-255,66,18230,64,236958
40442,0.000152,172.217.194.0-255,3961,22191,64,236958
40443,0.000155,172.31.40.0-255,66,22257,64,236958
40444,0.000412,172.217.194.0-255,1484,23741,64,236958
40445,0.000416,172.31.40.0-255,66,23807,64,236958
40446,0.000436,172.217.194.0-255,2902,26709,64,236958
40447,0.000439,172.31.40.0-255,66,26775,64,236958
40448,0.000446,172.217.194.0-255,5738,32513,64,236958
40449,0.000448,172.31.40.0-255,66,32579,64,236958
40450,0.000474,172.217.194.0-255,7156,39735,64,236958
40451,0.000477,172.31.40.0-255,66,39801,64,236958
40452,0.000506,172.217.194.0-255,6797,46598,64,236958
40453,0.000509,172.31.40.0-255,66,46664,64,236958
40454,0.00052,172.31.40.0-255,66,46730,64,236958
40455,0.000522,172.217.194.0-255,1379,48109,64,236958
40456,0.000524,172.31.40.0-255,66,48175,64,236958
40457,0.000596,172.217.194.0-255,118,48293,64,236958
40458,0.000684,172.217.194.0-255,1484,49777,64,236958
40459,0.000688,172.31.40.0-255,66,49843,64,236958
40460,0.000692,172.217.194.0-255,1484,51327,64,236958
40461,0.000713,172.217.194.0-255,1484,52811,64,236958
40462,0.000719,172.217.194.0-255,5738,58549,64,236958
40463,0.000723,172.31.40.0-255,66,58615,64,236958
40464,0.000727,172.31.40.0-255,66,58681,64,236958
40465,0.000757,172.31.40.0-255,66,58747,64,236958
40466,0.000767,172.31.40.0-255,66,58813,64,236958
40467,0.00081,172.217.194.0-255,1918,60731,64,236958
40468,0.000813,172.31.40.0-255,66,60797,64,236958
40469,0.000855,172.217.194.0-255,1484,62281,64,236958
40470,0.000873,172.217.194.0-255,2902,65183,64,236958
40471,0.000877,172.31.40.0-255,66,65249,64,236958
40472,0.000907,172.217.194.0-255,5738,70987,64,236958
40473,0.00091,172.31.40.0-255,66,71053,64,236958
40474,0.000915,172.217.194.0-255,4320,75373,64,236958
40475,0.000917,172.31.40.0-255,66,75439,64,236958
40476,0.000954,172.217.194.0-255,2543,77982,64,236958
40477,0.000957,172.31.40.0-255,66,78048,64,236958
40478,0.000961,172.217.194.0-255,2902,80950,64,236958
40479,0.000963,172.31.40.0-255,66,81016,64,236958
40480,0.000966,172.217.194.0-255,1484,82500,64,236958
40481,0.001002,172.217.194.0-255,5738,88238,64,236958
40482,0.001005,172.31.40.0-255,66,88304,64,236958
40483,0.001029,172.217.194.0-255,6797,95101,64,236958
40484,0.001032,172.31.40.0-255,66,95167,64,236958
40485,0.001167,172.217.194.0-255,1484,96651,64,236958
40486,0.001186,172.217.194.0-255,2902,99553,64,236958
40487,0.001189,172.31.40.0-255,66,99619,64,236958
40488,0.001193,172.217.194.0-255,2902,102521,64,236958
40489,0.001195,172.31.40.0-255,66,102587,64,236958
40490,0.001216,172.217.194.0-255,2902,105489,64,236958
40491,0.00122,172.217.194.0-255,4320,109809,64,236958
40492,0.001222,172.217.194.0-255,1484,111293,64,236958
40493,0.001226,172.31.40.0-255,66,111359,64,236958
40494,0.001228,172.31.40.0-255,66,111425,64,236958
40495,0.001258,172.31.40.0-255,66,111491,64,236958
40496,0.001267,172.31.40.0-255,66,111557,64,236958
40497,0.001299,172.217.194.0-255,1484,113041,64,236958
40498,0.001316,172.217.194.0-255,7156,120197,64,236958
40499,0.001319,172.31.40.0-255,66,120263,64,236958
40500,0.001325,172.217.194.0-255,5738,126001,64,236958
40501,0.001327,172.31.40.0-255,66,126067,64,236958
40502,0.001353,172.217.194.0-255,4320,130387,64,236958
40503,0.001355,172.31.40.0-255,66,130453,64,236958
40504,0.001359,172.217.194.0-255,2902,133355,64,236958
40505,0.001361,172.31.40.0-255,66,133421,64,236958
40506,0.001403,172.31.40.0-255,66,133487,64,236958
40507,0.00141,172.217.194.0-255,7156,140643,64,236958
40508,0.001411,172.31.40.0-255,66,140709,64,236958
40509,0.001446,172.31.40.0-255,66,140775,64,236958
40510,0.001449,172.217.194.0-255,1125,141900,64,236958
40511,0.001483,172.217.194.0-255,1484,143384,64,236958
40512,0.001485,172.31.40.0-255,66,143450,64,236958
40513,0.001489,172.217.194.0-255,1484,144934,64,236958
40514,0.001502,172.217.194.0-255,1484,146418,64,236958
40515,0.001504,172.217.194.0-255,1484,147902,64,236958
40516,0.001508,172.31.40.0-255,66,147968,64,236958
40517,0.001537,172.217.194.0-255,2902,150870,64,236958
40518,0.00154,172.31.40.0-255,66,150936,64,236958
40519,0.001546,172.217.194.0-255,5738,156674,64,236958
40520,0.001548,172.31.40.0-255,66,156740,64,236958
40521,0.001591,172.31.40.0-255,66,156806,64,236958
40522,0.001601,172.217.194.0-255,6438,163244,64,236958
40523,0.001603,172.31.40.0-255,66,163310,64,236958
40524,0.001633,172.217.194.0-255,5738,169048,64,236958
40525,0.001641,172.31.40.0-255,66,169114,64,236958
40526,0.001664,172.217.194.0-255,5738,174852,64,236958
40527,0.001667,172.31.40.0-255,66,174918,64,236958
40528,0.001679,172.31.40.0-255,66,174984,64,236958
40529,0.001689,172.31.40.0-255,66,175050,64,236958
40530,0.001757,172.31.40.0-255,66,175116,64,236958
40531,0.002022,172.217.194.0-255,1484,176600,64,236958
40532,0.002029,172.217.194.0-255,2902,179502,64,236958
40533,0.002033,172.31.40.0-255,66,179568,64,236958
40534,0.00204,172.217.194.0-255,5738,185306,64,236958
40535,0.002043,172.31.40.0-255,66,185372,64,236958
40536,0.002078,172.31.40.0-255,66,185438,64,236958
40537,0.002083,172.217.194.0-255,4320,189758,64,236958
40538,0.002085,172.31.40.0-255,66,189824,64,236958
40539,0.002107,172.217.194.0-255,4320,194144,64,236958
40540,0.00211,172.31.40.0-255,66,194210,64,236958
40541,0.002126,172.217.194.0-255,2184,196394,64,236958
40542,0.002133,172.31.40.0-255,66,196460,64,236958
40543,0.002138,172.217.194.0-255,2902,199362,64,236958
40544,0.00214,172.31.40.0-255,66,199428,64,236958
40545,0.002147,172.217.194.0-255,7156,206584,64,236958
40546,0.002149,172.31.40.0-255,66,206650,64,236958
40547,0.002198,172.31.40.0-255,66,206716,64,236958
40548,0.002204,172.217.194.0-255,7156,213872,64,236958
40549,0.002207,172.31.40.0-255,66,213938,64,236958
40550,0.00223,172.217.194.0-255,5020,218958,64,236958
40551,0.002233,172.31.40.0-255,66,219024,64,236958
40552,0.002239,172.217.194.0-255,5738,224762,64,236958
40553,0.002241,172.31.40.0-255,66,224828,64,236958
40554,0.002277,172.31.40.0-255,66,224894,64,236958
40555,0.002292,172.31.40.0-255,66,224960,64,236958
40556,0.002296,172.217.194.0-255,3602,228562,64,236958
40557,0.002298,172.31.40.0-255,66,228628,64,236958
40558,0.002342,172.217.194.0-255,4497,233125,64,236958
40559,0.002346,172.31.40.0-255,66,233191,64,236958
40560,0.004619,172.217.194.0-255,105,233296,64,236958
40561,0.011075,172.31.40.0-255,101,233397,64,236958
40562,0.013319,172.217.194.0-255,66,233463,64,236958
40563,0.013529,172.31.40.0-255,105,233568,64,236958
40564,0.015797,172.217.194.0-255,66,233634,64,236958
40565,0.032831,172.31.40.0-255,167,233801,64,236958
40566,0.032881,172.31.40.0-255,1107,234908,64,236958
40567,0.03294,172.31.40.0-255,1514,236422,64,236958
40568,0.032942,172.31.40.0-255,338,236760,64,236958
40569,0.03437,104.244.42.0-255,66,236826,64,236958
40570,0.034462,104.244.42.0-255,66,236892,64,236958
40571,0.03449,104.244.42.0-255,66,236958,64,236958
40572,0.0,172.217.194.0-255,153,153,64,253502
40573,2.5e-05,172.31.40.0-255,66,219,64,253502
40574,3.4e-05,172.217.194.0-255,1484,1703,64,253502
40575,3.8e-05,172.31.40.0-255,66,1769,64,253502
40576,4.3e-05,172.217.194.0-255,2902,4671,64,253502
40577,4.7e-05,172.31.40.0-255,66,4737,64,253502
40578,5.4e-05,172.217.194.0-255,5738,10475,64,253502
40579,5.8e-05,172.31.40.0-255,66,10541,64,253502
40580,9e-05,172.217.194.0-255,3464,14005,64,253502
40581,9.3e-05,172.31.40.0-255,66,14071,64,253502
40582,0.000139,172.217.194.0-255,1484,15555,64,253502
40583,0.000143,172.31.40.0-255,66,15621,64,253502
40584,0.000148,172.217.194.0-255,2902,18523,64,253502
40585,0.00015,172.31.40.0-255,66,18589,64,253502
40586,0.000173,172.217.194.0-255,5738,24327,64,253502
40587,0.000176,172.31.40.0-255,66,24393,64,253502
40588,0.000182,172.217.194.0-255,5738,30131,64,253502
40589,0.000185,172.31.40.0-255,66,30197,64,253502
40590,0.000239,172.217.194.0-255,5738,35935,64,253502
40591,0.000242,172.31.40.0-255,66,36001,64,253502
40592,0.000266,172.217.194.0-255,6797,42798,64,253502
40593,0.000269,172.31.40.0-255,66,42864,64,253502
40594,0.000276,172.217.194.0-255,5379,48243,64,253502
40595,0.000278,172.31.40.0-255,66,48309,64,253502
40596,0.001155,172.217.194.0-255,1484,49793,64,253502
40597,0.001162,172.31.40.0-255,66,49859,64,253502
40598,0.001171,172.217.194.0-255,2902,52761,64,253502
40599,0.001174,172.31.40.0-255,66,52827,64,253502
40600,0.001182,172.217.194.0-255,5738,58565,64,253502
40601,0.001184,172.31.40.0-255,66,58631,64,253502
40602,0.001188,172.217.194.0-255,1484,60115,64,253502
40603,0.00119,172.31.40.0-255,66,60181,64,253502
40604,0.00122,172.217.194.0-255,5379,65560,64,253502
40605,0.001223,172.31.40.0-255,66,65626,64,253502
40606,0.001226,172.217.194.0-255,647,66273,64,253502
40607,0.001577,172.217.194.0-255,1484,67757,64,253502
40608,0.001583,172.31.40.0-255,66,67823,64,253502
40609,0.001589,172.217.194.0-255,2902,70725,64,253502
40610,0.001591,172.31.40.0-255,66,70791,64,253502
40611,0.001598,172.217.194.0-255,5738,76529,64,253502
40612,0.001601,172.31.40.0-255,66,76595,64,253502
40613,0.001645,172.31.40.0-255,66,76661,64,253502
40614,0.001685,172.217.194.0-255,7156,83817,64,253502
40615,0.001687,172.31.40.0-255,66,83883,64,253502
40616,0.001705,172.217.194.0-255,1484,85367,64,253502
40617,0.001724,172.217.194.0-255,2184,87551,64,253502
40618,0.001727,172.31.40.0-255,66,87617,64,253502
40619,0.002242,172.217.194.0-255,1484,89101,64,253502
40620,0.00225,172.217.194.0-255,2902,92003,64,253502
40621,0.002255,172.31.40.0-255,66,92069,64,253502
40622,0.002263,172.217.194.0-255,5738,97807,64,253502
40623,0.002265,172.31.40.0-255,66,97873,64,253502
40624,0.002268,172.217.194.0-255,1484,99357,64,253502
40625,0.002303,172.31.40.0-255,66,99423,64,253502
40626,0.00231,172.217.194.0-255,5738,105161,64,253502
40627,0.002313,172.31.40.0-255,66,105227,64,253502
40628,0.002329,172.217.194.0-255,5020,110247,64,253502
40629,0.002332,172.31.40.0-255,66,110313,64,253502
40630,0.004652,172.217.194.0-255,5738,116051,64,253502
40631,0.004661,172.31.40.0-255,66,116117,64,253502
40632,0.007025,172.217.194.0-255,2902,119019,64,253502
40633,0.00703,172.31.40.0-255,66,119085,64,253502
40634,0.007051,172.217.194.0-255,2902,121987,64,253502
40635,0.007053,172.31.40.0-255,66,122053,64,253502
40636,0.009339,172.217.194.0-255,2902,124955,64,253502
40637,0.009351,172.31.40.0-255,66,125021,64,253502
40638,0.009382,172.217.194.0-255,2902,127923,64,253502
40639,0.009385,172.31.40.0-255,66,127989,64,253502
40640,0.011669,172.217.194.0-255,2902,130891,64,253502
40641,0.011682,172.31.40.0-255,66,130957,64,253502
40642,0.011704,172.217.194.0-255,2902,133859,64,253502
40643,0.011706,172.31.40.0-255,66,133925,64,253502
40644,0.014022,172.217.194.0-255,5738,139663,64,253502
40645,0.014033,172.31.40.0-255,66,139729,64,253502
40646,0.016381,172.217.194.0-255,5738,145467,64,253502
40647,0.016395,172.31.40.0-255,66,145533,64,253502
40648,0.018744,172.217.194.0-255,5738,151271,64,253502
40649,0.018761,172.31.40.0-255,66,151337,64,253502
40650,0.02112,172.217.194.0-255,5738,157075,64,253502
40651,0.021133,172.31.40.0-255,66,157141,64,253502
40652,0.023487,172.217.194.0-255,5738,162879,64,253502
40653,0.023497,172.31.40.0-255,66,162945,64,253502
40654,0.025869,172.217.194.0-255,5738,168683,64,253502
40655,0.02588,172.31.40.0-255,66,168749,64,253502
40656,0.026215,172.31.40.0-255,166,168915,64,253502
40657,0.026244,172.31.40.0-255,1132,170047,64,253502
40658,0.026304,172.31.40.0-255,1514,171561,64,253502
40659,0.026306,172.31.40.0-255,313,171874,64,253502
40660,0.027774,104.244.42.0-255,66,171940,64,253502
40661,0.027819,104.244.42.0-255,66,172006,64,253502
40662,0.027866,104.244.42.0-255,66,172072,64,253502
40663,0.0282,172.217.194.0-255,5738,177810,64,253502
40664,0.028206,172.31.40.0-255,66,177876,64,253502
40665,0.028597,104.244.42.0-255,108,177984,64,253502
40666,0.028606,172.31.40.0-255,66,178050,64,253502
40667,0.030531,172.217.194.0-255,5738,183788,64,253502
40668,0.030539,172.31.40.0-255,66,183854,64,253502
40669,0.032886,172.217.194.0-255,5738,189592,64,253502
40670,0.032893,172.31.40.0-255,66,189658,64,253502
40671,0.035216,172.217.194.0-255,5738,195396,64,253502
40672,0.035227,172.31.40.0-255,66,195462,64,253502
40673,0.037567,172.217.194.0-255,5738,201200,64,253502
40674,0.037585,172.31.40.0-255,66,201266,64,253502
40675,0.039959,172.217.194.0-255,5738,207004,64,253502
40676,0.039979,172.31.40.0-255,66,207070,64,253502
40677,0.042301,172.217.194.0-255,5738,212808,64,253502
40678,0.042325,172.31.40.0-255,66,212874,64,253502
40679,0.04468,172.217.194.0-255,5738,218612,64,253502
40680,0.044698,172.31.40.0-255,66,218678,64,253502
40681,0.047055,172.217.194.0-255,5738,224416,64,253502
40682,0.047071,172.31.40.0-255,66,224482,64,253502
40683,0.049431,172.217.194.0-255,5738,230220,64,253502
40684,0.049449,172.31.40.0-255,66,230286,64,253502
40685,0.051797,172.217.194.0-255,5738,236024,64,253502
40686,0.051813,172.31.40.0-255,66,236090,64,253502
40687,0.054175,172.217.194.0-255,5738,241828,64,253502
40688,0.054194,172.31.40.0-255,66,241894,64,253502
40689,0.056536,172.217.194.0-255,5738,247632,64,253502
40690,0.056555,172.31.40.0-255,66,247698,64,253502
40691,0.058883,172.217.194.0-255,5738,253436,64,253502
40692,0.058902,172.31.40.0-255,66,253502,64,253502
40693,0.0,74.125.24.0-255,153,153,64,264001
40694,1.2e-05,172.31.40.0-255,66,219,64,264001
40695,4.1e-05,74.125.24.0-255,1484,1703,64,264001
40696,4.6e-05,172.31.40.0-255,66,1769,64,264001
40697,5.1e-05,74.125.24.0-255,2902,4671,64,264001
40698,5.3e-05,172.31.40.0-255,66,4737,64,264001
40699,6e-05,74.125.24.0-255,7156,11893,64,264001
40700,6.1e-05,172.31.40.0-255,66,11959,64,264001
40701,9.5e-05,74.125.24.0-255,2068,14027,64,264001
40702,9.7e-05,172.31.40.0-255,66,14093,64,264001
40703,0.000148,172.31.40.0-255,66,14159,64,264001
40704,0.000191,74.125.24.0-255,5379,19538,64,264001
40705,0.000194,172.31.40.0-255,66,19604,64,264001
40706,0.000341,74.125.24.0-255,1484,21088,64,264001
40707,0.000344,172.31.40.0-255,66,21154,64,264001
40708,0.000349,74.125.24.0-255,2902,24056,64,264001
40709,0.000351,172.31.40.0-255,66,24122,64,264001
40710,0.000383,74.125.24.0-255,5738,29860,64,264001
40711,0.000386,172.31.40.0-255,66,29926,64,264001
40712,0.000413,172.31.40.0-255,66,29992,64,264001
40713,0.000439,74.125.24.0-255,5379,35371,64,264001
40714,0.000441,172.31.40.0-255,66,35437,64,264001
40715,0.000515,74.125.24.0-255,7156,42593,64,264001
40716,0.000518,172.31.40.0-255,66,42659,64,264001
40717,0.000543,74.125.24.0-255,2818,45477,64,264001
40718,0.000546,172.31.40.0-255,66,45543,64,264001
40719,0.000689,74.125.24.0-255,131,45674,64,264001
40720,0.000692,172.31.40.0-255,66,45740,64,264001
40721,0.000839,74.125.24.0-255,1484,47224,64,264001
40722,0.000843,172.31.40.0-255,66,47290,64,264001
40723,0.000848,74.125.24.0-255,2902,50192,64,264001
40724,0.000849,172.31.40.0-255,66,50258,64,264001
40725,0.000881,74.125.24.0-255,5738,55996,64,264001
40726,0.000883,172.31.40.0-255,66,56062,64,264001
40727,0.000911,74.125.24.0-255,4320,60382,64,264001
40728,0.000913,172.31.40.0-255,66,60448,64,264001
40729,0.000937,74.125.24.0-255,5738,66186,64,264001
40730,0.000939,172.31.40.0-255,66,66252,64,264001
40731,0.000969,74.125.24.0-255,6797,73049,64,264001
40732,0.000971,172.31.40.0-255,66,73115,64,264001
40733,0.00103,74.125.24.0-255,6797,79912,64,264001
40734,0.001033,172.31.40.0-255,66,79978,64,264001
40735,0.001851,74.125.24.0-255,1484,81462,64,264001
40736,0.001863,74.125.24.0-255,2902,84364,64,264001
40737,0.001868,172.31.40.0-255,66,84430,64,264001
40738,0.001875,74.125.24.0-255,4320,88750,64,264001
40739,0.001878,172.31.40.0-255,66,88816,64,264001
40740,0.001896,74.125.24.0-255,1484,90300,64,264001
40741,0.001916,74.125.24.0-255,4320,94620,64,264001
40742,0.001919,172.31.40.0-255,66,94686,64,264001
40743,0.001956,172.31.40.0-255,66,94752,64,264001
40744,0.002021,74.125.24.0-255,4320,99072,64,264001
40745,0.002025,172.31.40.0-255,66,99138,64,264001
40746,0.00205,74.125.24.0-255,3602,102740,64,264001
40747,0.002053,172.31.40.0-255,66,102806,64,264001
40748,0.004058,74.125.24.0-255,1484,104290,64,264001
40749,0.004109,74.125.24.0-255,4320,108610,64,264001
40750,0.004113,172.31.40.0-255,66,108676,64,264001
40751,0.006146,74.125.24.0-255,5738,114414,64,264001
40752,0.006151,172.31.40.0-255,66,114480,64,264001
40753,0.008207,74.125.24.0-255,5738,120218,64,264001
40754,0.008213,172.31.40.0-255,66,120284,64,264001
40755,0.01028,74.125.24.0-255,5738,126022,64,264001
40756,0.010287,172.31.40.0-255,66,126088,64,264001
40757,0.012381,74.125.24.0-255,5738,131826,64,264001
40758,0.012389,172.31.40.0-255,66,131892,64,264001
40759,0.014457,74.125.24.0-255,5738,137630,64,264001
40760,0.014465,172.31.40.0-255,66,137696,64,264001
40761,0.01653,74.125.24.0-255,5738,143434,64,264001
40762,0.016536,172.31.40.0-255,66,143500,64,264001
40763,0.018599,74.125.24.0-255,5738,149238,64,264001
40764,0.018607,172.31.40.0-255,66,149304,64,264001
40765,0.020675,74.125.24.0-255,5738,155042,64,264001
40766,0.020682,172.31.40.0-255,66,155108,64,264001
40767,0.022756,74.125.24.0-255,5738,160846,64,264001
40768,0.022763,172.31.40.0-255,66,160912,64,264001
40769,0.024844,74.125.24.0-255,5738,166650,64,264001
40770,0.02485,172.31.40.0-255,66,166716,64,264001
40771,0.026909,74.125.24.0-255,2902,169618,64,264001
40772,0.026915,172.31.40.0-255,66,169684,64,264001
40773,0.02694,74.125.24.0-255,2902,172586,64,264001
40774,0.026943,172.31.40.0-255,66,172652,64,264001
40775,0.028097,172.31.40.0-255,167,172819,64,264001
40776,0.028129,172.31.40.0-255,1112,173931,64,264001
40777,0.02822,172.31.40.0-255,1514,175445,64,264001
40778,0.028222,172.31.40.0-255,1298,176743,64,264001
40779,0.028972,74.125.24.0-255,5738,182481,64,264001
40780,0.028978,172.31.40.0-255,66,182547,64,264001
40781,0.029653,104.244.42.0-255,66,182613,64,264001
40782,0.029689,104.244.42.0-255,66,182679,64,264001
40783,0.029782,104.244.42.0-255,66,182745,64,264001
40784,0.031023,74.125.24.0-255,5738,188483,64,264001
40785,0.031027,172.31.40.0-255,66,188549,64,264001
40786,0.033097,74.125.24.0-255,5738,194287,64,264001
40787,0.033104,172.31.40.0-255,66,194353,64,264001
40788,0.035178,74.125.24.0-255,5738,200091,64,264001
40789,0.035184,172.31.40.0-255,66,200157,64,264001
40790,0.037283,74.125.24.0-255,5738,205895,64,264001
40791,0.037288,172.31.40.0-255,66,205961,64,264001
40792,0.039338,74.125.24.0-255,5738,211699,64,264001
40793,0.039343,172.31.40.0-255,66,211765,64,264001
40794,0.041407,74.125.24.0-255,5738,217503,64,264001
40795,0.041416,172.31.40.0-255,66,217569,64,264001
40796,0.043524,74.125.24.0-255,5738,223307,64,264001
40797,0.043531,172.31.40.0-255,66,223373,64,264001
40798,0.045572,74.125.24.0-255,5738,229111,64,264001
40799,0.045591,172.31.40.0-255,66,229177,64,264001
40800,0.047651,74.125.24.0-255,5738,234915,64,264001
40801,0.047667,172.31.40.0-255,66,234981,64,264001
40802,0.049768,74.125.24.0-255,5738,240719,64,264001
40803,0.049783,172.31.40.0-255,66,240785,64,264001
40804,0.051852,74.125.24.0-255,5738,246523,64,264001
40805,0.051865,172.31.40.0-255,66,246589,64,264001
40806,0.053903,74.125.24.0-255,5738,252327,64,264001
40807,0.053911,172.31.40.0-255,66,252393,64,264001
40808,0.056018,74.125.24.0-255,5738,258131,64,264001
40809,0.056034,172.31.40.0-255,66,258197,64,264001
40810,0.058135,74.125.24.0-255,5738,263935,64,264001
40811,0.058148,172.31.40.0-255,66,264001,64,264001
40812,0.0,172.217.194.0-255,153,153,64,193120
40813,2.3e-05,172.31.40.0-255,66,219,64,193120
40814,3.1e-05,172.217.194.0-255,1484,1703,64,193120
40815,3.5e-05,172.31.40.0-255,66,1769,64,193120
40816,4e-05,172.217.194.0-255,2902,4671,64,193120
40817,4.4e-05,172.31.40.0-255,66,4737,64,193120
40818,5.2e-05,172.217.194.0-255,7156,11893,64,193120
40819,5.5e-05,172.31.40.0-255,66,11959,64,193120
40820,8.3e-05,172.217.194.0-255,2138,14097,64,193120
40821,8.6e-05,172.31.40.0-255,66,14163,64,193120
40822,0.000126,172.217.194.0-255,2902,17065,64,193120
40823,0.000128,172.31.40.0-255,66,17131,64,193120
40824,0.000134,172.217.194.0-255,4320,21451,64,193120
40825,0.000136,172.31.40.0-255,66,21517,64,193120
40826,0.000164,172.31.40.0-255,66,21583,64,193120
40827,0.000203,172.31.40.0-255,66,21649,64,193120
40828,0.000217,172.31.40.0-255,66,21715,64,193120
40829,0.000245,172.31.40.0-255,66,21781,64,193120
40830,0.000321,172.217.194.0-255,648,22429,64,193120
40831,0.000325,172.31.40.0-255,66,22495,64,193120
40832,0.000558,172.217.194.0-255,1484,23979,64,193120
40833,0.000563,172.31.40.0-255,66,24045,64,193120
40834,0.000569,172.217.194.0-255,2902,26947,64,193120
40835,0.000571,172.31.40.0-255,66,27013,64,193120
40836,0.000601,172.217.194.0-255,5738,32751,64,193120
40837,0.000607,172.31.40.0-255,66,32817,64,193120
40838,0.000622,172.217.194.0-255,5738,38555,64,193120
40839,0.000625,172.31.40.0-255,66,38621,64,193120
40840,0.000645,172.217.194.0-255,5379,44000,64,193120
40841,0.000653,172.217.194.0-255,5738,49738,64,193120
40842,0.000692,172.31.40.0-255,66,49804,64,193120
40843,0.000707,172.217.194.0-255,6797,56601,64,193120
40844,0.00073,172.31.40.0-255,66,56667,64,193120
40845,0.000748,172.217.194.0-255,1484,58151,64,193120
40846,0.000764,172.217.194.0-255,2902,61053,64,193120
40847,0.000806,172.217.194.0-255,4320,65373,64,193120
40848,0.00081,172.217.194.0-255,1484,66857,64,193120
40849,0.000816,172.31.40.0-255,66,66923,64,193120
40850,0.000827,172.217.194.0-255,4320,71243,64,193120
40851,0.000831,172.31.40.0-255,66,71309,64,193120
40852,0.000848,172.217.194.0-255,1992,73301,64,193120
40853,0.000865,172.31.40.0-255,66,73367,64,193120
40854,0.000936,172.217.194.0-255,1484,74851,64,193120
40855,0.000949,172.217.194.0-255,2902,77753,64,193120
40856,0.000965,172.31.40.0-255,66,77819,64,193120
40857,0.000972,172.217.194.0-255,5738,83557,64,193120
40858,0.000981,172.31.40.0-255,66,83623,64,193120
40859,0.000996,172.217.194.0-255,4320,87943,64,193120
40860,0.001008,172.31.40.0-255,66,88009,64,193120
40861,0.001026,172.31.40.0-255,66,88075,64,193120
40862,0.001045,172.217.194.0-255,4320,92395,64,193120
40863,0.001068,172.217.194.0-255,6438,98833,64,193120
40864,0.001073,172.31.40.0-255,66,98899,64,193120
40865,0.001167,172.217.194.0-255,1484,100383,64,193120
40866,0.001171,172.217.194.0-255,2902,103285,64,193120
40867,0.001188,172.217.194.0-255,5738,109023,64,193120
40868,0.001194,172.217.194.0-255,5738,114761,64,193120
40869,0.001217,172.217.194.0-255,1484,116245,64,193120
40870,0.00122,172.31.40.0-255,66,116311,64,193120
40871,0.001257,172.217.194.0-255,5020,121331,64,193120
40872,0.001263,172.31.40.0-255,66,121397,64,193120
40873,0.001457,172.217.194.0-255,1484,122881,64,193120
40874,0.001462,172.217.194.0-255,2902,125783,64,193120
40875,0.001464,172.217.194.0-255,1484,127267,64,193120
40876,0.00147,172.31.40.0-255,66,127333,64,193120
40877,0.001482,172.217.194.0-255,4320,131653,64,193120
40878,0.001497,172.217.194.0-255,4320,135973,64,193120
40879,0.00151,172.31.40.0-255,66,136039,64,193120
40880,0.001528,172.31.40.0-255,66,136105,64,193120
40881,0.00157,172.31.40.0-255,66,136171,64,193120
40882,0.001623,172.217.194.0-255,1484,137655,64,193120
40883,0.001629,172.31.40.0-255,66,137721,64,193120
40884,0.001663,172.31.40.0-255,66,137787,64,193120
40885,0.001694,172.31.40.0-255,66,137853,64,193120
40886,0.001786,172.217.194.0-255,1484,139337,64,193120
40887,0.00182,172.217.194.0-255,2902,142239,64,193120
40888,0.001826,172.217.194.0-255,4320,146559,64,193120
40889,0.001836,172.31.40.0-255,66,146625,64,193120
40890,0.001855,172.31.40.0-255,66,146691,64,193120
40891,0.001928,172.31.40.0-255,66,146757,64,193120
40892,0.001939,172.217.194.0-255,5738,152495,64,193120
40893,0.001941,172.217.194.0-255,766,153261,64,193120
40894,0.001953,172.31.40.0-255,66,153327,64,193120
40895,0.001956,172.217.194.0-255,1484,154811,64,193120
40896,0.001961,172.217.194.0-255,4320,159131,64,193120
40897,0.001978,172.217.194.0-255,5738,164869,64,193120
40898,0.00199,172.217.194.0-255,1484,166353,64,193120
40899,0.002018,172.31.40.0-255,66,166419,64,193120
40900,0.002041,172.217.194.0-255,5738,172157,64,193120
40901,0.002047,172.217.194.0-255,5020,177177,64,193120
40902,0.002079,172.31.40.0-255,66,177243,64,193120
40903,0.002084,172.31.40.0-255,66,177309,64,193120
40904,0.002126,172.31.40.0-255,66,177375,64,193120
40905,0.00216,172.217.194.0-255,4320,181695,64,193120
40906,0.002193,172.31.40.0-255,66,181761,64,193120
40907,0.002199,172.31.40.0-255,66,181827,64,193120
40908,0.002249,172.31.40.0-255,66,181893,64,193120
40909,0.002267,172.217.194.0-255,6591,188484,64,193120
40910,0.00227,172.217.194.0-255,105,188589,64,193120
40911,0.002284,172.31.40.0-255,66,188655,64,193120
40912,0.004646,172.31.40.0-255,105,188760,64,193120
40913,0.006849,172.217.194.0-255,66,188826,64,193120
40914,0.05154,172.31.40.0-255,172,188998,64,193120
40915,0.051571,172.31.40.0-255,1113,190111,64,193120
40916,0.051635,172.31.40.0-255,1514,191625,64,193120
40917,0.051637,172.31.40.0-255,1297,192922,64,193120
40918,0.053034,104.244.42.0-255,66,192988,64,193120
40919,0.053052,104.244.42.0-255,66,193054,64,193120
40920,0.053137,104.244.42.0-255,66,193120,64,193120
40921,0.0,74.125.24.0-255,152,152,64,190947
40922,2.3e-05,172.31.40.0-255,66,218,64,190947
40923,2.9e-05,74.125.24.0-255,1484,1702,64,190947
40924,3.3e-05,172.31.40.0-255,66,1768,64,190947
40925,3.9e-05,74.125.24.0-255,2902,4670,64,190947
40926,4.3e-05,172.31.40.0-255,66,4736,64,190947
40927,5.1e-05,74.125.24.0-255,7156,11892,64,190947
40928,5.5e-05,172.31.40.0-255,66,11958,64,190947
40929,5.8e-05,74.125.24.0-255,1484,13442,64,190947
40930,6e-05,172.31.40.0-255,66,13508,64,190947
40931,7.3e-05,172.31.40.0-255,66,13574,64,190947
40932,9.8e-05,74.125.24.0-255,6797,20371,64,190947
40933,0.0001,172.31.40.0-255,66,20437,64,190947
40934,0.000155,74.125.24.0-255,1484,21921,64,190947
40935,0.000158,172.31.40.0-255,66,21987,64,190947
40936,0.000163,74.125.24.0-255,2902,24889,64,190947
40937,0.000164,172.31.40.0-255,66,24955,64,190947
40938,0.000167,74.125.24.0-255,1484,26439,64,190947
40939,0.000169,172.31.40.0-255,66,26505,64,190947
40940,0.000191,74.125.24.0-255,4320,30825,64,190947
40941,0.000193,172.31.40.0-255,66,30891,64,190947
40942,0.0002,74.125.24.0-255,6797,37688,64,190947
40943,0.000203,172.31.40.0-255,66,37754,64,190947
40944,0.000227,74.125.24.0-255,1484,39238,64,190947
40945,0.000229,172.31.40.0-255,66,39304,64,190947
40946,0.000243,74.125.24.0-255,5738,45042,64,190947
40947,0.000246,172.31.40.0-255,66,45108,64,190947
40948,0.000263,74.125.24.0-255,7156,52264,64,190947
40949,0.000266,172.31.40.0-255,66,52330,64,190947
40950,0.00027,74.125.24.0-255,2817,55147,64,190947
40951,0.000273,172.31.40.0-255,66,55213,64,190947
40952,0.000275,74.125.24.0-255,127,55340,64,190947
40953,0.00041,74.125.24.0-255,1484,56824,64,190947
40954,0.000416,172.31.40.0-255,66,56890,64,190947
40955,0.000421,74.125.24.0-255,2902,59792,64,190947
40956,0.000423,172.31.40.0-255,66,59858,64,190947
40957,0.000429,74.125.24.0-255,4320,64178,64,190947
40958,0.000431,172.31.40.0-255,66,64244,64,190947
40959,0.000453,74.125.24.0-255,1484,65728,64,190947
40960,0.000457,74.125.24.0-255,1484,67212,64,190947
40961,0.000458,172.31.40.0-255,66,67278,64,190947
40962,0.000463,74.125.24.0-255,2902,70180,64,190947
40963,0.000465,172.31.40.0-255,66,70246,64,190947
40964,0.000485,74.125.24.0-255,6797,77043,64,190947
40965,0.000487,172.31.40.0-255,66,77109,64,190947
40966,0.000515,74.125.24.0-255,2902,80011,64,190947
40967,0.000517,172.31.40.0-255,66,80077,64,190947
40968,0.000544,172.31.40.0-255,66,80143,64,190947
40969,0.000547,74.125.24.0-255,1125,81268,64,190947
40970,0.000551,74.125.24.0-255,1484,82752,64,190947
40971,0.000553,172.31.40.0-255,66,82818,64,190947
40972,0.000558,74.125.24.0-255,2902,85720,64,190947
40973,0.00056,172.31.40.0-255,66,85786,64,190947
40974,0.000582,74.125.24.0-255,1484,87270,64,190947
40975,0.000598,74.125.24.0-255,4320,91590,64,190947
40976,0.000602,172.31.40.0-255,66,91656,64,190947
40977,0.000625,74.125.24.0-255,2902,94558,64,190947
40978,0.000628,172.31.40.0-255,66,94624,64,190947
40979,0.000638,172.31.40.0-255,66,94690,64,190947
40980,0.000651,74.125.24.0-255,2902,97592,64,190947
40981,0.000654,172.31.40.0-255,66,97658,64,190947
40982,0.000688,172.31.40.0-255,66,97724,64,190947
40983,0.000702,74.125.24.0-255,3187,100911,64,190947
40984,0.000707,74.125.24.0-255,4320,105231,64,190947
40985,0.000711,172.31.40.0-255,66,105297,64,190947
40986,0.000714,172.31.40.0-255,66,105363,64,190947
40987,0.000744,172.31.40.0-255,66,105429,64,190947
40988,0.000747,74.125.24.0-255,1484,106913,64,190947
40989,0.000796,172.31.40.0-255,66,106979,64,190947
40990,0.000804,74.125.24.0-255,7156,114135,64,190947
40991,0.000807,172.31.40.0-255,66,114201,64,190947
40992,0.000839,172.31.40.0-255,66,114267,64,190947
40993,0.000844,74.125.24.0-255,2902,117169,64,190947
40994,0.000847,172.31.40.0-255,66,117235,64,190947
40995,0.000874,172.31.40.0-255,66,117301,64,190947
40996,0.000932,172.31.40.0-255,66,117367,64,190947
40997,0.000946,172.31.40.0-255,66,117433,64,190947
40998,0.000971,74.125.24.0-255,7156,124589,64,190947
40999,0.000974,172.31.40.0-255,66,124655,64,190947
41000,0.000991,74.125.24.0-255,5020,129675,64,190947
41001,0.000996,172.31.40.0-255,66,129741,64,190947
41002,0.001053,74.125.24.0-255,1484,131225,64,190947
41003,0.001058,74.125.24.0-255,1484,132709,64,190947
41004,0.001061,172.31.40.0-255,66,132775,64,190947
41005,0.001074,74.125.24.0-255,1484,134259,64,190947
41006,0.001081,74.125.24.0-255,5738,139997,64,190947
41007,0.001084,172.31.40.0-255,66,140063,64,190947
41008,0.001098,74.125.24.0-255,1484,141547,64,190947
41009,0.001127,172.31.40.0-255,66,141613,64,190947
41010,0.001131,74.125.24.0-255,2902,144515,64,190947
41011,0.001134,172.31.40.0-255,66,144581,64,190947
41012,0.001168,74.125.24.0-255,5738,150319,64,190947
41013,0.001171,172.31.40.0-255,66,150385,64,190947
41014,0.00119,74.125.24.0-255,2184,152569,64,190947
41015,0.001193,172.31.40.0-255,66,152635,64,190947
41016,0.001229,172.31.40.0-255,66,152701,64,190947
41017,0.001301,172.31.40.0-255,66,152767,64,190947
41018,0.001316,172.31.40.0-255,66,152833,64,190947
41019,0.00134,74.125.24.0-255,1484,154317,64,190947
41020,0.001361,74.125.24.0-255,2902,157219,64,190947
41021,0.001364,172.31.40.0-255,66,157285,64,190947
41022,0.001369,74.125.24.0-255,2902,160187,64,190947
41023,0.001371,172.31.40.0-255,66,160253,64,190947
41024,0.001382,74.125.24.0-255,1484,161737,64,190947
41025,0.001411,172.31.40.0-255,66,161803,64,190947
41026,0.001437,172.31.40.0-255,66,161869,64,190947
41027,0.001475,74.125.24.0-255,3602,165471,64,190947
41028,0.001484,172.31.40.0-255,66,165537,64,190947
41029,0.001518,74.125.24.0-255,4320,169857,64,190947
41030,0.001521,172.31.40.0-255,66,169923,64,190947
41031,0.001529,74.125.24.0-255,5738,175661,64,190947
41032,0.001531,172.31.40.0-255,66,175727,64,190947
41033,0.001534,74.125.24.0-255,1484,177211,64,190947
41034,0.001569,172.31.40.0-255,66,177277,64,190947
41035,0.001574,74.125.24.0-255,4320,181597,64,190947
41036,0.001577,172.31.40.0-255,66,181663,64,190947
41037,0.00162,172.31.40.0-255,66,181729,64,190947
41038,0.001633,172.31.40.0-255,66,181795,64,190947
41039,0.001645,172.31.40.0-255,66,181861,64,190947
41040,0.001683,74.125.24.0-255,4320,186181,64,190947
41041,0.001686,172.31.40.0-255,66,186247,64,190947
41042,0.001717,172.31.40.0-255,66,186313,64,190947
41043,0.00172,74.125.24.0-255,105,186418,64,190947
41044,0.004477,172.31.40.0-255,66,186484,64,190947
41045,0.004514,172.31.40.0-255,105,186589,64,190947
41046,0.006496,74.125.24.0-255,66,186655,64,190947
41047,0.032606,172.31.40.0-255,172,186827,64,190947
41048,0.032635,172.31.40.0-255,1111,187938,64,190947
41049,0.032688,172.31.40.0-255,1514,189452,64,190947
41050,0.03269,172.31.40.0-255,1297,190749,64,190947
41051,0.034132,104.244.42.0-255,66,190815,64,190947
41052,0.034171,104.244.42.0-255,66,190881,64,190947
41053,0.034211,104.244.42.0-255,66,190947,64,190947
41054,0.0,172.217.194.0-255,291,291,64,279352
41055,2.2e-05,172.31.40.0-255,66,357,64,279352
41056,2.8e-05,172.217.194.0-255,1484,1841,64,279352
41057,3.2e-05,172.31.40.0-255,66,1907,64,279352
41058,3.9e-05,172.217.194.0-255,2902,4809,64,279352
41059,4.3e-05,172.31.40.0-255,66,4875,64,279352
41060,6.4e-05,172.217.194.0-255,5738,10613,64,279352
41061,6.8e-05,172.31.40.0-255,66,10679,64,279352
41062,8.2e-05,172.31.40.0-255,66,10745,64,279352
41063,0.000106,172.217.194.0-255,3355,14100,64,279352
41064,0.000109,172.31.40.0-255,66,14166,64,279352
41065,0.000117,172.217.194.0-255,6797,20963,64,279352
41066,0.00012,172.31.40.0-255,66,21029,64,279352
41067,0.000184,172.217.194.0-255,1484,22513,64,279352
41068,0.000186,172.31.40.0-255,66,22579,64,279352
41069,0.000192,172.217.194.0-255,2902,25481,64,279352
41070,0.000194,172.31.40.0-255,66,25547,64,279352
41071,0.0002,172.217.194.0-255,4320,29867,64,279352
41072,0.000202,172.31.40.0-255,66,29933,64,279352
41073,0.000219,172.217.194.0-255,1484,31417,64,279352
41074,0.000222,172.31.40.0-255,66,31483,64,279352
41075,0.000241,172.217.194.0-255,5738,37221,64,279352
41076,0.000244,172.31.40.0-255,66,37287,64,279352
41077,0.000265,172.31.40.0-255,66,37353,64,279352
41078,0.000303,172.31.40.0-255,66,37419,64,279352
41079,0.000306,172.217.194.0-255,431,37850,64,279352
41080,0.000308,172.31.40.0-255,66,37916,64,279352
41081,0.00056,172.217.194.0-255,1484,39400,64,279352
41082,0.000566,172.31.40.0-255,66,39466,64,279352
41083,0.000572,172.217.194.0-255,2902,42368,64,279352
41084,0.000586,172.31.40.0-255,66,42434,64,279352
41085,0.000591,172.217.194.0-255,2902,45336,64,279352
41086,0.000597,172.31.40.0-255,66,45402,64,279352
41087,0.000607,172.217.194.0-255,2902,48304,64,279352
41088,0.000619,172.217.194.0-255,1484,49788,64,279352
41089,0.000637,172.217.194.0-255,5738,55526,64,279352
41090,0.000652,172.31.40.0-255,66,55592,64,279352
41091,0.000659,172.217.194.0-255,5738,61330,64,279352
41092,0.000669,172.31.40.0-255,66,61396,64,279352
41093,0.000697,172.217.194.0-255,4320,65716,64,279352
41094,0.000702,172.31.40.0-255,66,65782,64,279352
41095,0.000736,172.217.194.0-255,2902,68684,64,279352
41096,0.000741,172.31.40.0-255,66,68750,64,279352
41097,0.000751,172.217.194.0-255,3602,72352,64,279352
41098,0.000773,172.31.40.0-255,66,72418,64,279352
41099,0.000909,172.217.194.0-255,1484,73902,64,279352
41100,0.000916,172.217.194.0-255,2902,76804,64,279352
41101,0.000919,172.217.194.0-255,1484,78288,64,279352
41102,0.00094,172.217.194.0-255,4320,82608,64,279352
41103,0.000947,172.217.194.0-255,5738,88346,64,279352
41104,0.000954,172.31.40.0-255,66,88412,64,279352
41105,0.000965,172.217.194.0-255,5738,94150,64,279352
41106,0.000969,172.217.194.0-255,4320,98470,64,279352
41107,0.000976,172.31.40.0-255,66,98536,64,279352
41108,0.001004,172.217.194.0-255,1484,100020,64,279352
41109,0.001008,172.217.194.0-255,2902,102922,64,279352
41110,0.001013,172.31.40.0-255,66,102988,64,279352
41111,0.001027,172.217.194.0-255,5738,108726,64,279352
41112,0.001043,172.31.40.0-255,66,108792,64,279352
41113,0.001067,172.217.194.0-255,7156,115948,64,279352
41114,0.001072,172.31.40.0-255,66,116014,64,279352
41115,0.001083,172.217.194.0-255,3602,119616,64,279352
41116,0.001112,172.31.40.0-255,66,119682,64,279352
41117,0.001729,172.217.194.0-255,1484,121166,64,279352
41118,0.001738,172.217.194.0-255,2902,124068,64,279352
41119,0.001741,172.31.40.0-255,66,124134,64,279352
41120,0.001747,172.217.194.0-255,2902,127036,64,279352
41121,0.001765,172.217.194.0-255,2902,129938,64,279352
41122,0.001769,172.217.194.0-255,4320,134258,64,279352
41123,0.001786,172.217.194.0-255,2902,137160,64,279352
41124,0.001791,172.31.40.0-255,66,137226,64,279352
41125,0.001824,172.31.40.0-255,66,137292,64,279352
41126,0.00184,172.31.40.0-255,66,137358,64,279352
41127,0.002054,172.217.194.0-255,1484,138842,64,279352
41128,0.002059,172.217.194.0-255,1484,140326,64,279352
41129,0.002062,172.31.40.0-255,66,140392,64,279352
41130,0.002082,172.217.194.0-255,1484,141876,64,279352
41131,0.002089,172.217.194.0-255,5738,147614,64,279352
41132,0.002092,172.217.194.0-255,1484,149098,64,279352
41133,0.002123,172.217.194.0-255,2902,152000,64,279352
41134,0.002151,172.31.40.0-255,66,152066,64,279352
41135,0.002166,172.217.194.0-255,1484,153550,64,279352
41136,0.00219,172.217.194.0-255,5738,159288,64,279352
41137,0.002206,172.217.194.0-255,1484,160772,64,279352
41138,0.002237,172.217.194.0-255,766,161538,64,279352
41139,0.012091,172.217.194.0-255,1484,163022,64,279352
41140,0.012648,172.31.40.0-255,66,163088,64,279352
41141,0.014925,172.217.194.0-255,5738,168826,64,279352
41142,0.014937,172.31.40.0-255,66,168892,64,279352
41143,0.017262,172.217.194.0-255,5738,174630,64,279352
41144,0.017272,172.31.40.0-255,66,174696,64,279352
41145,0.019602,172.217.194.0-255,5738,180434,64,279352
41146,0.01961,172.31.40.0-255,66,180500,64,279352
41147,0.021885,172.217.194.0-255,5738,186238,64,279352
41148,0.024152,172.31.40.0-255,66,186304,64,279352
41149,0.026424,172.217.194.0-255,5738,192042,64,279352
41150,0.02644,172.31.40.0-255,66,192108,64,279352
41151,0.028702,172.217.194.0-255,5738,197846,64,279352
41152,0.028709,172.31.40.0-255,66,197912,64,279352
41153,0.030972,172.217.194.0-255,5738,203650,64,279352
41154,0.03098,172.31.40.0-255,66,203716,64,279352
41155,0.033276,172.217.194.0-255,5738,209454,64,279352
41156,0.033285,172.31.40.0-255,66,209520,64,279352
41157,0.035558,172.217.194.0-255,5738,215258,64,279352
41158,0.035565,172.31.40.0-255,66,215324,64,279352
41159,0.037866,172.217.194.0-255,5738,221062,64,279352
41160,0.037885,172.31.40.0-255,66,221128,64,279352
41161,0.040134,172.217.194.0-255,4320,225448,64,279352
41162,0.040142,172.31.40.0-255,66,225514,64,279352
41163,0.040163,172.217.194.0-255,1484,226998,64,279352
41164,0.04241,172.217.194.0-255,4320,231318,64,279352
41165,0.042422,172.31.40.0-255,66,231384,64,279352
41166,0.044708,172.217.194.0-255,5738,237122,64,279352
41167,0.044781,172.31.40.0-255,66,237188,64,279352
41168,0.047034,172.217.194.0-255,5738,242926,64,279352
41169,0.047042,172.31.40.0-255,66,242992,64,279352
41170,0.049321,172.217.194.0-255,5738,248730,64,279352
41171,0.049332,172.31.40.0-255,66,248796,64,279352
41172,0.051588,172.217.194.0-255,5738,254534,64,279352
41173,0.051599,172.31.40.0-255,66,254600,64,279352
41174,0.052671,172.31.40.0-255,171,254771,64,279352
41175,0.052703,172.31.40.0-255,1137,255908,64,279352
41176,0.052767,172.31.40.0-255,1514,257422,64,279352
41177,0.052769,172.31.40.0-255,1514,258936,64,279352
41178,0.052771,172.31.40.0-255,1514,260450,64,279352
41179,0.052796,172.31.40.0-255,1052,261502,64,279352
41180,0.053915,172.217.194.0-255,5738,267240,64,279352
41181,0.053923,172.31.40.0-255,66,267306,64,279352
41182,0.054257,104.244.42.0-255,66,267372,64,279352
41183,0.054275,104.244.42.0-255,66,267438,64,279352
41184,0.054368,104.244.42.0-255,66,267504,64,279352
41185,0.054409,104.244.42.0-255,66,267570,64,279352
41186,0.055023,104.244.42.0-255,108,267678,64,279352
41187,0.055033,172.31.40.0-255,66,267744,64,279352
41188,0.056177,172.217.194.0-255,5738,273482,64,279352
41189,0.056186,172.31.40.0-255,66,273548,64,279352
41190,0.058477,172.217.194.0-255,5738,279286,64,279352
41191,0.058493,172.31.40.0-255,66,279352,64,279352
41192,0.0,74.125.68.0-255,146,146,64,275599
41193,1.1e-05,172.31.40.0-255,66,212,64,275599
41194,1.7e-05,74.125.68.0-255,1484,1696,64,275599
41195,2.2e-05,172.31.40.0-255,66,1762,64,275599
41196,2.5e-05,74.125.68.0-255,1484,3246,64,275599
41197,2.7e-05,172.31.40.0-255,66,3312,64,275599
41198,3e-05,74.125.68.0-255,1484,4796,64,275599
41199,3.3e-05,172.31.40.0-255,66,4862,64,275599
41200,5.6e-05,74.125.68.0-255,1484,6346,64,275599
41201,5.8e-05,172.31.40.0-255,66,6412,64,275599
41202,6.6e-05,74.125.68.0-255,5738,12150,64,275599
41203,6.8e-05,172.31.40.0-255,66,12216,64,275599
41204,7.1e-05,74.125.68.0-255,1484,13700,64,275599
41205,7.3e-05,172.31.40.0-255,66,13766,64,275599
41206,8.8e-05,74.125.68.0-255,3384,17150,64,275599
41207,9.1e-05,172.31.40.0-255,66,17216,64,275599
41208,0.000102,74.125.68.0-255,1484,18700,64,275599
41209,0.000104,172.31.40.0-255,66,18766,64,275599
41210,0.000123,74.125.68.0-255,4320,23086,64,275599
41211,0.000126,172.31.40.0-255,66,23152,64,275599
41212,0.000136,172.31.40.0-255,66,23218,64,275599
41213,0.000257,74.125.68.0-255,1484,24702,64,275599
41214,0.000261,172.31.40.0-255,66,24768,64,275599
41215,0.000266,74.125.68.0-255,2902,27670,64,275599
41216,0.000269,172.31.40.0-255,66,27736,64,275599
41217,0.000275,74.125.68.0-255,5738,33474,64,275599
41218,0.000277,172.31.40.0-255,66,33540,64,275599
41219,0.000281,74.125.68.0-255,2902,36442,64,275599
41220,0.000284,172.31.40.0-255,66,36508,64,275599
41221,0.000314,74.125.68.0-255,4320,40828,64,275599
41222,0.000317,172.31.40.0-255,66,40894,64,275599
41223,0.000322,74.125.68.0-255,4320,45214,64,275599
41224,0.000324,172.31.40.0-255,66,45280,64,275599
41225,0.000338,74.125.68.0-255,4320,49600,64,275599
41226,0.00034,172.31.40.0-255,66,49666,64,275599
41227,0.000345,74.125.68.0-255,4320,53986,64,275599
41228,0.000347,172.31.40.0-255,66,54052,64,275599
41229,0.000399,74.125.68.0-255,3900,57952,64,275599
41230,0.000402,172.31.40.0-255,66,58018,64,275599
41231,0.000761,74.125.68.0-255,130,58148,64,275599
41232,0.000944,74.125.68.0-255,1484,59632,64,275599
41233,0.00095,172.31.40.0-255,66,59698,64,275599
41234,0.000954,74.125.68.0-255,1484,61182,64,275599
41235,0.00097,74.125.68.0-255,1484,62666,64,275599
41236,0.000972,172.31.40.0-255,66,62732,64,275599
41237,0.000979,74.125.68.0-255,5738,68470,64,275599
41238,0.000981,172.31.40.0-255,66,68536,64,275599
41239,0.000986,74.125.68.0-255,2902,71438,64,275599
41240,0.000988,172.31.40.0-255,66,71504,64,275599
41241,0.001004,74.125.68.0-255,1484,72988,64,275599
41242,0.001007,74.125.68.0-255,1484,74472,64,275599
41243,0.001009,172.31.40.0-255,66,74538,64,275599
41244,0.001033,74.125.68.0-255,4320,78858,64,275599
41245,0.001036,172.31.40.0-255,66,78924,64,275599
41246,0.001039,74.125.68.0-255,1484,80408,64,275599
41247,0.001068,172.31.40.0-255,66,80474,64,275599
41248,0.001094,74.125.68.0-255,2184,82658,64,275599
41249,0.001097,172.31.40.0-255,66,82724,64,275599
41250,0.001934,74.125.68.0-255,1484,84208,64,275599
41251,0.001941,74.125.68.0-255,1484,85692,64,275599
41252,0.001945,172.31.40.0-255,66,85758,64,275599
41253,0.001963,74.125.68.0-255,1484,87242,64,275599
41254,0.001967,74.125.68.0-255,2902,90144,64,275599
41255,0.001969,172.31.40.0-255,66,90210,64,275599
41256,0.001973,74.125.68.0-255,4320,94530,64,275599
41257,0.001975,172.31.40.0-255,66,94596,64,275599
41258,0.001989,74.125.68.0-255,1484,96080,64,275599
41259,0.002009,74.125.68.0-255,7156,103236,64,275599
41260,0.002011,172.31.40.0-255,66,103302,64,275599
41261,0.002017,74.125.68.0-255,5738,109040,64,275599
41262,0.002019,172.31.40.0-255,66,109106,64,275599
41263,0.002022,74.125.68.0-255,1484,110590,64,275599
41264,0.004025,74.125.68.0-255,4320,114910,64,275599
41265,0.004028,172.31.40.0-255,66,114976,64,275599
41266,0.006046,74.125.68.0-255,5738,120714,64,275599
41267,0.006053,172.31.40.0-255,66,120780,64,275599
41268,0.008068,74.125.68.0-255,5738,126518,64,275599
41269,0.008076,172.31.40.0-255,66,126584,64,275599
41270,0.010092,74.125.68.0-255,5738,132322,64,275599
41271,0.0101,172.31.40.0-255,66,132388,64,275599
41272,0.012116,74.125.68.0-255,5738,138126,64,275599
41273,0.012123,172.31.40.0-255,66,138192,64,275599
41274,0.014149,74.125.68.0-255,5738,143930,64,275599
41275,0.014158,172.31.40.0-255,66,143996,64,275599
41276,0.016177,74.125.68.0-255,5738,149734,64,275599
41277,0.016185,172.31.40.0-255,66,149800,64,275599
41278,0.0182,74.125.68.0-255,5738,155538,64,275599
41279,0.018208,172.31.40.0-255,66,155604,64,275599
41280,0.020231,74.125.68.0-255,5738,161342,64,275599
41281,0.020238,172.31.40.0-255,66,161408,64,275599
41282,0.022256,74.125.68.0-255,5738,167146,64,275599
41283,0.022263,172.31.40.0-255,66,167212,64,275599
41284,0.02429,74.125.68.0-255,5738,172950,64,275599
41285,0.024297,172.31.40.0-255,66,173016,64,275599
41286,0.02573,172.31.40.0-255,167,173183,64,275599
41287,0.025763,172.31.40.0-255,1111,174294,64,275599
41288,0.02582,172.31.40.0-255,1514,175808,64,275599
41289,0.025821,172.31.40.0-255,1514,177322,64,275599
41290,0.025846,172.31.40.0-255,697,178019,64,275599
41291,0.026289,74.125.68.0-255,4320,182339,64,275599
41292,0.026295,172.31.40.0-255,66,182405,64,275599
41293,0.026318,74.125.68.0-255,1484,183889,64,275599
41294,0.027251,104.244.42.0-255,66,183955,64,275599
41295,0.027306,104.244.42.0-255,66,184021,64,275599
41296,0.027358,104.244.42.0-255,66,184087,64,275599
41297,0.02743,104.244.42.0-255,66,184153,64,275599
41298,0.028312,74.125.68.0-255,4320,188473,64,275599
41299,0.028318,172.31.40.0-255,66,188539,64,275599
41300,0.030339,74.125.68.0-255,5738,194277,64,275599
41301,0.030345,172.31.40.0-255,66,194343,64,275599
41302,0.032355,74.125.68.0-255,5738,200081,64,275599
41303,0.03236,172.31.40.0-255,66,200147,64,275599
41304,0.034386,74.125.68.0-255,5738,205885,64,275599
41305,0.034392,172.31.40.0-255,66,205951,64,275599
41306,0.036418,74.125.68.0-255,5738,211689,64,275599
41307,0.036426,172.31.40.0-255,66,211755,64,275599
41308,0.03844,74.125.68.0-255,5738,217493,64,275599
41309,0.038446,172.31.40.0-255,66,217559,64,275599
41310,0.040471,74.125.68.0-255,5738,223297,64,275599
41311,0.040476,172.31.40.0-255,66,223363,64,275599
41312,0.042511,74.125.68.0-255,5738,229101,64,275599
41313,0.042517,172.31.40.0-255,66,229167,64,275599
41314,0.04454,74.125.68.0-255,5738,234905,64,275599
41315,0.044545,172.31.40.0-255,66,234971,64,275599
41316,0.046627,74.125.68.0-255,5738,240709,64,275599
41317,0.046645,172.31.40.0-255,66,240775,64,275599
41318,0.048671,74.125.68.0-255,5738,246513,64,275599
41319,0.048684,172.31.40.0-255,66,246579,64,275599
41320,0.050719,74.125.68.0-255,5738,252317,64,275599
41321,0.050733,172.31.40.0-255,66,252383,64,275599
41322,0.052782,74.125.68.0-255,5738,258121,64,275599
41323,0.052796,172.31.40.0-255,66,258187,64,275599
41324,0.054829,74.125.68.0-255,5738,263925,64,275599
41325,0.05484,172.31.40.0-255,66,263991,64,275599
41326,0.056866,74.125.68.0-255,5738,269729,64,275599
41327,0.056883,172.31.40.0-255,66,269795,64,275599
41328,0.058916,74.125.68.0-255,5738,275533,64,275599
41329,0.058933,172.31.40.0-255,66,275599,64,275599
41330,0.0,74.125.68.0-255,155,155,64,379432
41331,1.6e-05,172.31.40.0-255,66,221,64,379432
41332,2.3e-05,74.125.68.0-255,1484,1705,64,379432
41333,2.8e-05,172.31.40.0-255,66,1771,64,379432
41334,5.9e-05,74.125.68.0-255,2902,4673,64,379432
41335,6.2e-05,172.31.40.0-255,66,4739,64,379432
41336,6.8e-05,74.125.68.0-255,5738,10477,64,379432
41337,7.5e-05,172.31.40.0-255,66,10543,64,379432
41338,8e-05,74.125.68.0-255,2902,13445,64,379432
41339,8.3e-05,172.31.40.0-255,66,13511,64,379432
41340,0.000115,74.125.68.0-255,682,14193,64,379432
41341,0.000118,172.31.40.0-255,66,14259,64,379432
41342,0.000218,74.125.68.0-255,1484,15743,64,379432
41343,0.000222,172.31.40.0-255,66,15809,64,379432
41344,0.000227,74.125.68.0-255,2902,18711,64,379432
41345,0.00023,172.31.40.0-255,66,18777,64,379432
41346,0.000267,74.125.68.0-255,5738,24515,64,379432
41347,0.00027,172.31.40.0-255,66,24581,64,379432
41348,0.000278,74.125.68.0-255,6797,31378,64,379432
41349,0.00028,172.31.40.0-255,66,31444,64,379432
41350,0.000309,74.125.68.0-255,7156,38600,64,379432
41351,0.000312,172.31.40.0-255,66,38666,64,379432
41352,0.000346,74.125.68.0-255,5738,44404,64,379432
41353,0.000349,172.31.40.0-255,66,44470,64,379432
41354,0.000375,74.125.68.0-255,3961,48431,64,379432
41355,0.000378,172.31.40.0-255,66,48497,64,379432
41356,0.000416,74.125.68.0-255,4320,52817,64,379432
41357,0.000419,172.31.40.0-255,66,52883,64,379432
41358,0.000422,74.125.68.0-255,1484,54367,64,379432
41359,0.000424,172.31.40.0-255,66,54433,64,379432
41360,0.000446,74.125.68.0-255,2902,57335,64,379432
41361,0.000449,172.31.40.0-255,66,57401,64,379432
41362,0.000483,74.125.68.0-255,5738,63139,64,379432
41363,0.000486,172.31.40.0-255,66,63205,64,379432
41364,0.00049,74.125.68.0-255,2869,66074,64,379432
41365,0.000492,172.31.40.0-255,66,66140,64,379432
41366,0.000519,74.125.68.0-255,330,66470,64,379432
41367,0.00076,74.125.68.0-255,1484,67954,64,379432
41368,0.000765,172.31.40.0-255,66,68020,64,379432
41369,0.00077,74.125.68.0-255,2902,70922,64,379432
41370,0.000773,172.31.40.0-255,66,70988,64,379432
41371,0.000785,74.125.68.0-255,5738,76726,64,379432
41372,0.000788,172.31.40.0-255,66,76792,64,379432
41373,0.000817,74.125.68.0-255,2902,79694,64,379432
41374,0.000824,172.31.40.0-255,66,79760,64,379432
41375,0.00083,74.125.68.0-255,4320,84080,64,379432
41376,0.000832,74.125.68.0-255,1484,85564,64,379432
41377,0.000851,172.31.40.0-255,66,85630,64,379432
41378,0.000857,74.125.68.0-255,2902,88532,64,379432
41379,0.000877,74.125.68.0-255,5738,94270,64,379432
41380,0.000882,74.125.68.0-255,4320,98590,64,379432
41381,0.000885,172.31.40.0-255,66,98656,64,379432
41382,0.000918,172.31.40.0-255,66,98722,64,379432
41383,0.000937,74.125.68.0-255,2184,100906,64,379432
41384,0.000954,172.31.40.0-255,66,100972,64,379432
41385,0.001001,74.125.68.0-255,1484,102456,64,379432
41386,0.001021,74.125.68.0-255,2902,105358,64,379432
41387,0.001024,172.31.40.0-255,66,105424,64,379432
41388,0.00105,74.125.68.0-255,1484,106908,64,379432
41389,0.001078,74.125.68.0-255,2902,109810,64,379432
41390,0.001096,172.31.40.0-255,66,109876,64,379432
41391,0.0011,74.125.68.0-255,1484,111360,64,379432
41392,0.001104,74.125.68.0-255,2902,114262,64,379432
41393,0.001108,74.125.68.0-255,4320,118582,64,379432
41394,0.001122,74.125.68.0-255,1484,120066,64,379432
41395,0.001127,172.31.40.0-255,66,120132,64,379432
41396,0.001167,172.31.40.0-255,66,120198,64,379432
41397,0.001192,74.125.68.0-255,2902,123100,64,379432
41398,0.001201,172.31.40.0-255,66,123166,64,379432
41399,0.00121,74.125.68.0-255,2184,125350,64,379432
41400,0.001214,172.31.40.0-255,66,125416,64,379432
41401,0.00128,74.125.68.0-255,1484,126900,64,379432
41402,0.001305,74.125.68.0-255,1484,128384,64,379432
41403,0.001324,74.125.68.0-255,2902,131286,64,379432
41404,0.001329,74.125.68.0-255,2902,134188,64,379432
41405,0.001351,74.125.68.0-255,2902,137090,64,379432
41406,0.001356,74.125.68.0-255,2902,139992,64,379432
41407,0.001361,172.31.40.0-255,66,140058,64,379432
41408,0.001379,74.125.68.0-255,4320,144378,64,379432
41409,0.001397,74.125.68.0-255,5738,150116,64,379432
41410,0.0014,74.125.68.0-255,1484,151600,64,379432
41411,0.001409,172.31.40.0-255,66,151666,64,379432
41412,0.001425,74.125.68.0-255,7156,158822,64,379432
41413,0.001427,74.125.68.0-255,766,159588,64,379432
41414,0.001434,172.31.40.0-255,66,159654,64,379432
41415,0.001615,74.125.68.0-255,1484,161138,64,379432
41416,0.001622,74.125.68.0-255,2902,164040,64,379432
41417,0.001673,74.125.68.0-255,2902,166942,64,379432
41418,0.001678,74.125.68.0-255,4320,171262,64,379432
41419,0.001682,172.31.40.0-255,66,171328,64,379432
41420,0.001697,172.31.40.0-255,66,171394,64,379432
41421,0.001706,74.125.68.0-255,2902,174296,64,379432
41422,0.001721,74.125.68.0-255,2902,177198,64,379432
41423,0.001726,74.125.68.0-255,4320,181518,64,379432
41424,0.00174,74.125.68.0-255,2902,184420,64,379432
41425,0.001758,74.125.68.0-255,2902,187322,64,379432
41426,0.001769,172.31.40.0-255,66,187388,64,379432
41427,0.001801,74.125.68.0-255,4320,191708,64,379432
41428,0.001805,74.125.68.0-255,1484,193192,64,379432
41429,0.001827,74.125.68.0-255,2184,195376,64,379432
41430,0.00183,172.31.40.0-255,66,195442,64,379432
41431,0.001835,172.31.40.0-255,66,195508,64,379432
41432,0.001873,74.125.68.0-255,5738,201246,64,379432
41433,0.001878,74.125.68.0-255,4320,205566,64,379432
41434,0.00189,74.125.68.0-255,2902,208468,64,379432
41435,0.001897,172.31.40.0-255,66,208534,64,379432
41436,0.001905,74.125.68.0-255,1484,210018,64,379432
41437,0.001956,74.125.68.0-255,6438,216456,64,379432
41438,0.001973,172.31.40.0-255,66,216522,64,379432
41439,0.002039,74.125.68.0-255,1484,218006,64,379432
41440,0.002046,74.125.68.0-255,2902,220908,64,379432
41441,0.002052,172.31.40.0-255,66,220974,64,379432
41442,0.00208,74.125.68.0-255,5738,226712,64,379432
41443,0.002088,172.31.40.0-255,66,226778,64,379432
41444,0.002131,74.125.68.0-255,4320,231098,64,379432
41445,0.002159,74.125.68.0-255,5738,236836,64,379432
41446,0.002175,74.125.68.0-255,5020,241856,64,379432
41447,0.002208,74.125.68.0-255,1484,243340,64,379432
41448,0.002224,74.125.68.0-255,2902,246242,64,379432
41449,0.002247,74.125.68.0-255,5738,251980,64,379432
41450,0.002251,74.125.68.0-255,2902,254882,64,379432
41451,0.00227,74.125.68.0-255,2902,257784,64,379432
41452,0.002279,74.125.68.0-255,1484,259268,64,379432
41453,0.002301,74.125.68.0-255,4320,263588,64,379432
41454,0.00232,74.125.68.0-255,4320,267908,64,379432
41455,0.002325,74.125.68.0-255,2902,270810,64,379432
41456,0.002366,74.125.68.0-255,5738,276548,64,379432
41457,0.0128,74.125.68.0-255,1484,278032,64,379432
41458,0.014081,172.31.40.0-255,66,278098,64,379432
41459,0.016441,74.125.68.0-255,5738,283836,64,379432
41460,0.016451,172.31.40.0-255,66,283902,64,379432
41461,0.018818,74.125.68.0-255,5738,289640,64,379432
41462,0.018836,172.31.40.0-255,66,289706,64,379432
41463,0.021197,74.125.68.0-255,5738,295444,64,379432
41464,0.021204,172.31.40.0-255,66,295510,64,379432
41465,0.023559,74.125.68.0-255,5738,301248,64,379432
41466,0.023567,172.31.40.0-255,66,301314,64,379432
41467,0.025945,74.125.68.0-255,5738,307052,64,379432
41468,0.025961,172.31.40.0-255,66,307118,64,379432
41469,0.028325,74.125.68.0-255,5738,312856,64,379432
41470,0.028332,172.31.40.0-255,66,312922,64,379432
41471,0.030704,74.125.68.0-255,5738,318660,64,379432
41472,0.030716,172.31.40.0-255,66,318726,64,379432
41473,0.033116,74.125.68.0-255,5738,324464,64,379432
41474,0.033132,172.31.40.0-255,66,324530,64,379432
41475,0.035491,74.125.68.0-255,5738,330268,64,379432
41476,0.035499,172.31.40.0-255,66,330334,64,379432
41477,0.037868,74.125.68.0-255,5738,336072,64,379432
41478,0.03788,172.31.40.0-255,66,336138,64,379432
41479,0.040254,74.125.68.0-255,5738,341876,64,379432
41480,0.040273,172.31.40.0-255,66,341942,64,379432
41481,0.042651,74.125.68.0-255,5738,347680,64,379432
41482,0.042677,172.31.40.0-255,66,347746,64,379432
41483,0.045025,74.125.68.0-255,5738,353484,64,379432
41484,0.045035,172.31.40.0-255,66,353550,64,379432
41485,0.047403,74.125.68.0-255,5738,359288,64,379432
41486,0.047421,172.31.40.0-255,66,359354,64,379432
41487,0.049778,74.125.68.0-255,5738,365092,64,379432
41488,0.049785,172.31.40.0-255,66,365158,64,379432
41489,0.051292,172.31.40.0-255,172,365330,64,379432
41490,0.051324,172.31.40.0-255,1113,366443,64,379432
41491,0.051377,172.31.40.0-255,1514,367957,64,379432
41492,0.051379,172.31.40.0-255,1297,369254,64,379432
41493,0.052137,74.125.68.0-255,5738,374992,64,379432
41494,0.052145,172.31.40.0-255,66,375058,64,379432
41495,0.052874,104.244.42.0-255,66,375124,64,379432
41496,0.052901,104.244.42.0-255,66,375190,64,379432
41497,0.052976,104.244.42.0-255,66,375256,64,379432
41498,0.054508,74.125.68.0-255,3939,379195,64,379432
41499,0.054521,172.31.40.0-255,66,379261,64,379432
41500,0.05476,172.31.40.0-255,105,379366,64,379432
41501,0.057099,74.125.68.0-255,66,379432,64,379432
41502,0.0,74.125.68.0-255,153,153,64,329624
41503,1.3e-05,172.31.40.0-255,66,219,64,329624
41504,2e-05,74.125.68.0-255,1484,1703,64,329624
41505,2.4e-05,172.31.40.0-255,66,1769,64,329624
41506,2.9e-05,74.125.68.0-255,2902,4671,64,329624
41507,3.1e-05,172.31.40.0-255,66,4737,64,329624
41508,3.6e-05,74.125.68.0-255,4320,9057,64,329624
41509,3.8e-05,172.31.40.0-255,66,9123,64,329624
41510,6.8e-05,74.125.68.0-255,1484,10607,64,329624
41511,7e-05,172.31.40.0-255,66,10673,64,329624
41512,7.8e-05,74.125.68.0-255,6284,16957,64,329624
41513,8.1e-05,172.31.40.0-255,66,17023,64,329624
41514,8.7e-05,74.125.68.0-255,7156,24179,64,329624
41515,8.9e-05,172.31.40.0-255,66,24245,64,329624
41516,0.000122,74.125.68.0-255,1484,25729,64,329624
41517,0.000124,172.31.40.0-255,66,25795,64,329624
41518,0.000143,74.125.68.0-255,5379,31174,64,329624
41519,0.000146,172.31.40.0-255,66,31240,64,329624
41520,0.000318,74.125.68.0-255,1484,32724,64,329624
41521,0.000322,172.31.40.0-255,66,32790,64,329624
41522,0.000327,74.125.68.0-255,2902,35692,64,329624
41523,0.000329,172.31.40.0-255,66,35758,64,329624
41524,0.000343,74.125.68.0-255,5738,41496,64,329624
41525,0.000345,172.31.40.0-255,66,41562,64,329624
41526,0.000377,74.125.68.0-255,7156,48718,64,329624
41527,0.00038,172.31.40.0-255,66,48784,64,329624
41528,0.000387,74.125.68.0-255,5738,54522,64,329624
41529,0.000389,172.31.40.0-255,66,54588,64,329624
41530,0.000405,74.125.68.0-255,2902,57490,64,329624
41531,0.000407,172.31.40.0-255,66,57556,64,329624
41532,0.000423,74.125.68.0-255,5738,63294,64,329624
41533,0.000426,172.31.40.0-255,66,63360,64,329624
41534,0.000445,74.125.68.0-255,2184,65544,64,329624
41535,0.000449,172.31.40.0-255,66,65610,64,329624
41536,0.000461,74.125.68.0-255,392,66002,64,329624
41537,0.000481,74.125.68.0-255,117,66119,64,329624
41538,0.000631,74.125.68.0-255,1484,67603,64,329624
41539,0.000636,172.31.40.0-255,66,67669,64,329624
41540,0.000641,74.125.68.0-255,2902,70571,64,329624
41541,0.000644,172.31.40.0-255,66,70637,64,329624
41542,0.000664,74.125.68.0-255,5738,76375,64,329624
41543,0.000667,172.31.40.0-255,66,76441,64,329624
41544,0.000672,74.125.68.0-255,2902,79343,64,329624
41545,0.000674,172.31.40.0-255,66,79409,64,329624
41546,0.000679,74.125.68.0-255,2902,82311,64,329624
41547,0.000682,172.31.40.0-255,66,82377,64,329624
41548,0.000694,74.125.68.0-255,1367,83744,64,329624
41549,0.000725,74.125.68.0-255,2902,86646,64,329624
41550,0.000735,172.31.40.0-255,66,86712,64,329624
41551,0.000738,172.31.40.0-255,66,86778,64,329624
41552,0.00078,74.125.68.0-255,1484,88262,64,329624
41553,0.000794,74.125.68.0-255,3961,92223,64,329624
41554,0.000797,172.31.40.0-255,66,92289,64,329624
41555,0.001158,74.125.68.0-255,1484,93773,64,329624
41556,0.001176,74.125.68.0-255,2902,96675,64,329624
41557,0.00118,172.31.40.0-255,66,96741,64,329624
41558,0.001186,74.125.68.0-255,4320,101061,64,329624
41559,0.001188,172.31.40.0-255,66,101127,64,329624
41560,0.00123,172.31.40.0-255,66,101193,64,329624
41561,0.001236,74.125.68.0-255,4320,105513,64,329624
41562,0.001238,172.31.40.0-255,66,105579,64,329624
41563,0.001251,74.125.68.0-255,1484,107063,64,329624
41564,0.001274,74.125.68.0-255,4320,111383,64,329624
41565,0.001277,172.31.40.0-255,66,111449,64,329624
41566,0.001282,74.125.68.0-255,4320,115769,64,329624
41567,0.001284,172.31.40.0-255,66,115835,64,329624
41568,0.001298,74.125.68.0-255,2184,118019,64,329624
41569,0.001301,172.31.40.0-255,66,118085,64,329624
41570,0.0014,74.125.68.0-255,1484,119569,64,329624
41571,0.001417,74.125.68.0-255,2902,122471,64,329624
41572,0.001421,172.31.40.0-255,66,122537,64,329624
41573,0.001428,74.125.68.0-255,5738,128275,64,329624
41574,0.00143,172.31.40.0-255,66,128341,64,329624
41575,0.00148,74.125.68.0-255,7156,135497,64,329624
41576,0.001483,172.31.40.0-255,66,135563,64,329624
41577,0.001497,172.31.40.0-255,66,135629,64,329624
41578,0.001522,74.125.68.0-255,2902,138531,64,329624
41579,0.001525,172.31.40.0-255,66,138597,64,329624
41580,0.001528,74.125.68.0-255,1484,140081,64,329624
41581,0.001545,74.125.68.0-255,766,140847,64,329624
41582,0.001548,172.31.40.0-255,66,140913,64,329624
41583,0.001644,74.125.68.0-255,1484,142397,64,329624
41584,0.001649,74.125.68.0-255,2902,145299,64,329624
41585,0.001652,172.31.40.0-255,66,145365,64,329624
41586,0.001672,74.125.68.0-255,2902,148267,64,329624
41587,0.001675,172.31.40.0-255,66,148333,64,329624
41588,0.001686,74.125.68.0-255,2902,151235,64,329624
41589,0.001689,172.31.40.0-255,66,151301,64,329624
41590,0.001696,74.125.68.0-255,7156,158457,64,329624
41591,0.001698,172.31.40.0-255,66,158523,64,329624
41592,0.001729,74.125.68.0-255,1484,160007,64,329624
41593,0.001767,172.31.40.0-255,66,160073,64,329624
41594,0.001772,74.125.68.0-255,3602,163675,64,329624
41595,0.001774,172.31.40.0-255,66,163741,64,329624
41596,0.002309,74.125.68.0-255,1484,165225,64,329624
41597,0.002326,74.125.68.0-255,2902,168127,64,329624
41598,0.00233,172.31.40.0-255,66,168193,64,329624
41599,0.002336,74.125.68.0-255,4320,172513,64,329624
41600,0.002338,172.31.40.0-255,66,172579,64,329624
41601,0.00236,74.125.68.0-255,1484,174063,64,329624
41602,0.002384,74.125.68.0-255,7156,181219,64,329624
41603,0.002386,172.31.40.0-255,66,181285,64,329624
41604,0.002392,74.125.68.0-255,5738,187023,64,329624
41605,0.002394,172.31.40.0-255,66,187089,64,329624
41606,0.004736,74.125.68.0-255,2902,189991,64,329624
41607,0.004742,172.31.40.0-255,66,190057,64,329624
41608,0.00476,74.125.68.0-255,2902,192959,64,329624
41609,0.004763,172.31.40.0-255,66,193025,64,329624
41610,0.007105,74.125.68.0-255,5738,198763,64,329624
41611,0.007112,172.31.40.0-255,66,198829,64,329624
41612,0.009464,74.125.68.0-255,5738,204567,64,329624
41613,0.00947,172.31.40.0-255,66,204633,64,329624
41614,0.011842,74.125.68.0-255,5738,210371,64,329624
41615,0.011849,172.31.40.0-255,66,210437,64,329624
41616,0.014234,74.125.68.0-255,5738,216175,64,329624
41617,0.014245,172.31.40.0-255,66,216241,64,329624
41618,0.016627,74.125.68.0-255,5738,221979,64,329624
41619,0.016646,172.31.40.0-255,66,222045,64,329624
41620,0.019024,74.125.68.0-255,5738,227783,64,329624
41621,0.019042,172.31.40.0-255,66,227849,64,329624
41622,0.021434,74.125.68.0-255,5738,233587,64,329624
41623,0.021452,172.31.40.0-255,66,233653,64,329624
41624,0.023817,74.125.68.0-255,4320,237973,64,329624
41625,0.023825,172.31.40.0-255,66,238039,64,329624
41626,0.023841,74.125.68.0-255,1484,239523,64,329624
41627,0.026176,74.125.68.0-255,4320,243843,64,329624
41628,0.026183,172.31.40.0-255,66,243909,64,329624
41629,0.02857,74.125.68.0-255,5738,249647,64,329624
41630,0.028588,172.31.40.0-255,66,249713,64,329624
41631,0.028788,172.31.40.0-255,101,249814,64,329624
41632,0.030961,74.125.68.0-255,5738,255552,64,329624
41633,0.030968,172.31.40.0-255,66,255618,64,329624
41634,0.031124,74.125.68.0-255,66,255684,64,329624
41635,0.033328,74.125.68.0-255,5738,261422,64,329624
41636,0.033336,172.31.40.0-255,66,261488,64,329624
41637,0.035702,74.125.68.0-255,5738,267226,64,329624
41638,0.035717,172.31.40.0-255,66,267292,64,329624
41639,0.038085,74.125.68.0-255,5738,273030,64,329624
41640,0.038101,172.31.40.0-255,66,273096,64,329624
41641,0.040509,74.125.68.0-255,5738,278834,64,329624
41642,0.040515,172.31.40.0-255,66,278900,64,329624
41643,0.042397,172.31.40.0-255,172,279072,64,329624
41644,0.042425,172.31.40.0-255,1112,280184,64,329624
41645,0.042469,172.31.40.0-255,1514,281698,64,329624
41646,0.04247,172.31.40.0-255,1296,282994,64,329624
41647,0.04287,74.125.68.0-255,5738,288732,64,329624
41648,0.042875,172.31.40.0-255,66,288798,64,329624
41649,0.043945,104.244.42.0-255,66,288864,64,329624
41650,0.043993,104.244.42.0-255,66,288930,64,329624
41651,0.044047,104.244.42.0-255,66,288996,64,329624
41652,0.045284,74.125.68.0-255,5738,294734,64,329624
41653,0.045298,172.31.40.0-255,66,294800,64,329624
41654,0.047673,74.125.68.0-255,5738,300538,64,329624
41655,0.04769,172.31.40.0-255,66,300604,64,329624
41656,0.050057,74.125.68.0-255,5738,306342,64,329624
41657,0.050073,172.31.40.0-255,66,306408,64,329624
41658,0.052457,74.125.68.0-255,5738,312146,64,329624
41659,0.052471,172.31.40.0-255,66,312212,64,329624
41660,0.054847,74.125.68.0-255,5738,317950,64,329624
41661,0.054863,172.31.40.0-255,66,318016,64,329624
41662,0.05724,74.125.68.0-255,5738,323754,64,329624
41663,0.057259,172.31.40.0-255,66,323820,64,329624
41664,0.059645,74.125.68.0-255,5738,329558,64,329624
41665,0.059663,172.31.40.0-255,66,329624,64,329624
41666,0.0,172.217.194.0-255,153,153,64,252809
41667,3.4e-05,172.31.40.0-255,66,219,64,252809
41668,4.2e-05,172.217.194.0-255,1484,1703,64,252809
41669,4.6e-05,172.31.40.0-255,66,1769,64,252809
41670,5.1e-05,172.217.194.0-255,2902,4671,64,252809
41671,5.4e-05,172.31.40.0-255,66,4737,64,252809
41672,7.4e-05,172.217.194.0-255,7156,11893,64,252809
41673,7.8e-05,172.31.40.0-255,66,11959,64,252809
41674,8.1e-05,172.217.194.0-255,2011,13970,64,252809
41675,8.4e-05,172.31.40.0-255,66,14036,64,252809
41676,0.000121,172.217.194.0-255,5738,19774,64,252809
41677,0.000127,172.31.40.0-255,66,19840,64,252809
41678,0.000148,172.217.194.0-255,1484,21324,64,252809
41679,0.00015,172.31.40.0-255,66,21390,64,252809
41680,0.000161,172.31.40.0-255,66,21456,64,252809
41681,0.000163,172.217.194.0-255,1125,22581,64,252809
41682,0.000165,172.31.40.0-255,66,22647,64,252809
41683,0.000252,172.217.194.0-255,1484,24131,64,252809
41684,0.000257,172.31.40.0-255,66,24197,64,252809
41685,0.000261,172.217.194.0-255,2902,27099,64,252809
41686,0.000264,172.31.40.0-255,66,27165,64,252809
41687,0.000281,172.217.194.0-255,5738,32903,64,252809
41688,0.000284,172.31.40.0-255,66,32969,64,252809
41689,0.000321,172.31.40.0-255,66,33035,64,252809
41690,0.000342,172.217.194.0-255,1125,34160,64,252809
41691,0.000344,172.31.40.0-255,66,34226,64,252809
41692,0.000355,172.31.40.0-255,66,34292,64,252809
41693,0.000358,172.217.194.0-255,1125,35417,64,252809
41694,0.00036,172.31.40.0-255,66,35483,64,252809
41695,0.000726,172.217.194.0-255,377,35860,64,252809
41696,0.000774,172.217.194.0-255,1484,37344,64,252809
41697,0.000778,172.31.40.0-255,66,37410,64,252809
41698,0.000796,172.217.194.0-255,1484,38894,64,252809
41699,0.000816,172.217.194.0-255,1484,40378,64,252809
41700,0.000819,172.31.40.0-255,66,40444,64,252809
41701,0.000826,172.217.194.0-255,5738,46182,64,252809
41702,0.000829,172.217.194.0-255,1484,47666,64,252809
41703,0.000841,172.31.40.0-255,66,47732,64,252809
41704,0.000854,172.217.194.0-255,5379,53111,64,252809
41705,0.000858,172.31.40.0-255,66,53177,64,252809
41706,0.000885,172.217.194.0-255,5738,58915,64,252809
41707,0.000889,172.31.40.0-255,66,58981,64,252809
41708,0.000915,172.217.194.0-255,2844,61825,64,252809
41709,0.000916,172.31.40.0-255,66,61891,64,252809
41710,0.00092,172.31.40.0-255,66,61957,64,252809
41711,0.001055,172.217.194.0-255,1484,63441,64,252809
41712,0.001061,172.217.194.0-255,2902,66343,64,252809
41713,0.001064,172.31.40.0-255,66,66409,64,252809
41714,0.001085,172.217.194.0-255,5738,72147,64,252809
41715,0.00109,172.31.40.0-255,66,72213,64,252809
41716,0.001112,172.217.194.0-255,5738,77951,64,252809
41717,0.001115,172.217.194.0-255,1484,79435,64,252809
41718,0.001116,172.31.40.0-255,66,79501,64,252809
41719,0.001139,172.217.194.0-255,5738,85239,64,252809
41720,0.001145,172.31.40.0-255,66,85305,64,252809
41721,0.001146,172.217.194.0-255,5738,91043,64,252809
41722,0.001148,172.31.40.0-255,66,91109,64,252809
41723,0.00116,172.217.194.0-255,5020,96129,64,252809
41724,0.001166,172.31.40.0-255,66,96195,64,252809
41725,0.00137,172.217.194.0-255,1484,97679,64,252809
41726,0.001376,172.217.194.0-255,2902,100581,64,252809
41727,0.001379,172.31.40.0-255,66,100647,64,252809
41728,0.001385,172.217.194.0-255,2902,103549,64,252809
41729,0.001402,172.217.194.0-255,2902,106451,64,252809
41730,0.001408,172.217.194.0-255,5738,112189,64,252809
41731,0.001421,172.217.194.0-255,1484,113673,64,252809
41732,0.001422,172.31.40.0-255,66,113739,64,252809
41733,0.001436,172.217.194.0-255,4320,118059,64,252809
41734,0.001443,172.31.40.0-255,66,118125,64,252809
41735,0.001464,172.217.194.0-255,766,118891,64,252809
41736,0.001466,172.31.40.0-255,66,118957,64,252809
41737,0.001685,172.31.40.0-255,66,119023,64,252809
41738,0.001908,172.217.194.0-255,1484,120507,64,252809
41739,0.001919,172.217.194.0-255,2902,123409,64,252809
41740,0.001929,172.217.194.0-255,5738,129147,64,252809
41741,0.001957,172.217.194.0-255,4320,133467,64,252809
41742,0.006114,172.31.40.0-255,66,133533,64,252809
41743,0.008475,172.217.194.0-255,5738,139271,64,252809
41744,0.008486,172.31.40.0-255,66,139337,64,252809
41745,0.010859,172.217.194.0-255,5738,145075,64,252809
41746,0.010872,172.31.40.0-255,66,145141,64,252809
41747,0.013222,172.217.194.0-255,5738,150879,64,252809
41748,0.015742,172.31.40.0-255,66,150945,64,252809
41749,0.018089,172.217.194.0-255,5738,156683,64,252809
41750,0.018101,172.31.40.0-255,66,156749,64,252809
41751,0.020476,172.217.194.0-255,5738,162487,64,252809
41752,0.020488,172.31.40.0-255,66,162553,64,252809
41753,0.02286,172.217.194.0-255,5738,168291,64,252809
41754,0.022871,172.31.40.0-255,66,168357,64,252809
41755,0.024983,172.31.40.0-255,172,168529,64,252809
41756,0.025013,172.31.40.0-255,1108,169637,64,252809
41757,0.025054,172.31.40.0-255,1514,171151,64,252809
41758,0.025056,172.31.40.0-255,336,171487,64,252809
41759,0.025216,172.217.194.0-255,5738,177225,64,252809
41760,0.025224,172.31.40.0-255,66,177291,64,252809
41761,0.027192,104.244.42.0-255,66,177357,64,252809
41762,0.027606,172.217.194.0-255,5738,183095,64,252809
41763,0.027611,172.31.40.0-255,66,183161,64,252809
41764,0.029988,172.217.194.0-255,5738,188899,64,252809
41765,0.029996,172.31.40.0-255,66,188965,64,252809
41766,0.03237,172.217.194.0-255,5738,194703,64,252809
41767,0.032389,172.31.40.0-255,66,194769,64,252809
41768,0.034751,172.217.194.0-255,5738,200507,64,252809
41769,0.036204,172.31.40.0-255,66,200573,64,252809
41770,0.038584,172.217.194.0-255,5738,206311,64,252809
41771,0.038605,172.31.40.0-255,66,206377,64,252809
41772,0.040988,172.217.194.0-255,5738,212115,64,252809
41773,0.041006,172.31.40.0-255,66,212181,64,252809
41774,0.043407,172.217.194.0-255,5738,217919,64,252809
41775,0.043428,172.31.40.0-255,66,217985,64,252809
41776,0.04582,172.217.194.0-255,5738,223723,64,252809
41777,0.045843,172.31.40.0-255,66,223789,64,252809
41778,0.048222,172.217.194.0-255,5738,229527,64,252809
41779,0.048243,172.31.40.0-255,66,229593,64,252809
41780,0.050637,172.217.194.0-255,5738,235331,64,252809
41781,0.050657,172.31.40.0-255,66,235397,64,252809
41782,0.053188,172.217.194.0-255,5738,241135,64,252809
41783,0.053206,172.31.40.0-255,66,241201,64,252809
41784,0.055606,172.217.194.0-255,5738,246939,64,252809
41785,0.055628,172.31.40.0-255,66,247005,64,252809
41786,0.058005,172.217.194.0-255,5738,252743,64,252809
41787,0.058028,172.31.40.0-255,66,252809,64,252809
41788,0.0,74.125.200.0-255,299,299,64,300291
41789,2.1e-05,172.31.40.0-255,66,365,64,300291
41790,2.8e-05,74.125.200.0-255,1484,1849,64,300291
41791,3.2e-05,172.31.40.0-255,66,1915,64,300291
41792,3.8e-05,74.125.200.0-255,4320,6235,64,300291
41793,4.2e-05,172.31.40.0-255,66,6301,64,300291
41794,5.5e-05,74.125.200.0-255,2902,9203,64,300291
41795,5.8e-05,172.31.40.0-255,66,9269,64,300291
41796,6.4e-05,74.125.200.0-255,4320,13589,64,300291
41797,6.7e-05,172.31.40.0-255,66,13655,64,300291
41798,0.00011,172.31.40.0-255,66,13721,64,300291
41799,0.000135,74.125.200.0-255,360,14081,64,300291
41800,0.000137,172.31.40.0-255,66,14147,64,300291
41801,0.000143,74.125.200.0-255,4320,18467,64,300291
41802,0.000145,172.31.40.0-255,66,18533,64,300291
41803,0.000192,74.125.200.0-255,3961,22494,64,300291
41804,0.000195,172.31.40.0-255,66,22560,64,300291
41805,0.000233,74.125.200.0-255,1484,24044,64,300291
41806,0.000236,172.31.40.0-255,66,24110,64,300291
41807,0.000252,74.125.200.0-255,2902,27012,64,300291
41808,0.000254,172.31.40.0-255,66,27078,64,300291
41809,0.000258,74.125.200.0-255,1484,28562,64,300291
41810,0.00026,172.31.40.0-255,66,28628,64,300291
41811,0.000263,74.125.200.0-255,1484,30112,64,300291
41812,0.000265,172.31.40.0-255,66,30178,64,300291
41813,0.000295,74.125.200.0-255,1484,31662,64,300291
41814,0.000298,172.31.40.0-255,66,31728,64,300291
41815,0.000305,74.125.200.0-255,5738,37466,64,300291
41816,0.000307,172.31.40.0-255,66,37532,64,300291
41817,0.000311,74.125.200.0-255,2543,40075,64,300291
41818,0.000313,172.31.40.0-255,66,40141,64,300291
41819,0.000337,74.125.200.0-255,2902,43043,64,300291
41820,0.00034,172.31.40.0-255,66,43109,64,300291
41821,0.000377,74.125.200.0-255,7156,50265,64,300291
41822,0.00038,172.31.40.0-255,66,50331,64,300291
41823,0.000384,74.125.200.0-255,2902,53233,64,300291
41824,0.000386,172.31.40.0-255,66,53299,64,300291
41825,0.000421,74.125.200.0-255,4236,57535,64,300291
41826,0.000424,172.31.40.0-255,66,57601,64,300291
41827,0.000458,74.125.200.0-255,132,57733,64,300291
41828,0.000813,74.125.200.0-255,1484,59217,64,300291
41829,0.000818,74.125.200.0-255,2902,62119,64,300291
41830,0.000829,172.31.40.0-255,66,62185,64,300291
41831,0.000832,172.31.40.0-255,66,62251,64,300291
41832,0.000858,74.125.200.0-255,4320,66571,64,300291
41833,0.000861,172.31.40.0-255,66,66637,64,300291
41834,0.0009,172.31.40.0-255,66,66703,64,300291
41835,0.000905,74.125.200.0-255,4320,71023,64,300291
41836,0.000908,172.31.40.0-255,66,71089,64,300291
41837,0.000946,74.125.200.0-255,4320,75409,64,300291
41838,0.000949,172.31.40.0-255,66,75475,64,300291
41839,0.000969,74.125.200.0-255,6797,82272,64,300291
41840,0.000972,172.31.40.0-255,66,82338,64,300291
41841,0.001578,74.125.200.0-255,1484,83822,64,300291
41842,0.001586,74.125.200.0-255,2902,86724,64,300291
41843,0.001591,172.31.40.0-255,66,86790,64,300291
41844,0.001596,74.125.200.0-255,2902,89692,64,300291
41845,0.001599,172.31.40.0-255,66,89758,64,300291
41846,0.001603,74.125.200.0-255,2902,92660,64,300291
41847,0.001605,172.31.40.0-255,66,92726,64,300291
41848,0.001639,74.125.200.0-255,1484,94210,64,300291
41849,0.001651,172.31.40.0-255,66,94276,64,300291
41850,0.001658,74.125.200.0-255,7156,101432,64,300291
41851,0.00166,172.31.40.0-255,66,101498,64,300291
41852,0.001697,74.125.200.0-255,2902,104400,64,300291
41853,0.0017,172.31.40.0-255,66,104466,64,300291
41854,0.001717,74.125.200.0-255,3602,108068,64,300291
41855,0.001719,172.31.40.0-255,66,108134,64,300291
41856,0.001878,74.125.200.0-255,1484,109618,64,300291
41857,0.001884,74.125.200.0-255,2902,112520,64,300291
41858,0.001888,172.31.40.0-255,66,112586,64,300291
41859,0.001895,74.125.200.0-255,5738,118324,64,300291
41860,0.001898,172.31.40.0-255,66,118390,64,300291
41861,0.001931,74.125.200.0-255,7156,125546,64,300291
41862,0.001934,172.31.40.0-255,66,125612,64,300291
41863,0.001977,172.31.40.0-255,66,125678,64,300291
41864,0.002001,74.125.200.0-255,2184,127862,64,300291
41865,0.002005,172.31.40.0-255,66,127928,64,300291
41866,0.002196,74.125.200.0-255,1484,129412,64,300291
41867,0.002201,74.125.200.0-255,1484,130896,64,300291
41868,0.002205,172.31.40.0-255,66,130962,64,300291
41869,0.002219,74.125.200.0-255,1484,132446,64,300291
41870,0.00223,74.125.200.0-255,5738,138184,64,300291
41871,0.002232,172.31.40.0-255,66,138250,64,300291
41872,0.002272,74.125.200.0-255,4320,142570,64,300291
41873,0.002275,172.31.40.0-255,66,142636,64,300291
41874,0.002297,74.125.200.0-255,7156,149792,64,300291
41875,0.0023,172.31.40.0-255,66,149858,64,300291
41876,0.002303,74.125.200.0-255,1484,151342,64,300291
41877,0.004543,74.125.200.0-255,4320,155662,64,300291
41878,0.004551,172.31.40.0-255,66,155728,64,300291
41879,0.006801,74.125.200.0-255,5738,161466,64,300291
41880,0.006809,172.31.40.0-255,66,161532,64,300291
41881,0.009084,74.125.200.0-255,5738,167270,64,300291
41882,0.009093,172.31.40.0-255,66,167336,64,300291
41883,0.011374,74.125.200.0-255,5738,173074,64,300291
41884,0.011382,172.31.40.0-255,66,173140,64,300291
41885,0.013641,74.125.200.0-255,5738,178878,64,300291
41886,0.013653,172.31.40.0-255,66,178944,64,300291
41887,0.015905,74.125.200.0-255,5738,184682,64,300291
41888,0.015913,172.31.40.0-255,66,184748,64,300291
41889,0.018166,74.125.200.0-255,5738,190486,64,300291
41890,0.018174,172.31.40.0-255,66,190552,64,300291
41891,0.020436,74.125.200.0-255,5738,196290,64,300291
41892,0.020444,172.31.40.0-255,66,196356,64,300291
41893,0.022692,74.125.200.0-255,5738,202094,64,300291
41894,0.022699,172.31.40.0-255,66,202160,64,300291
41895,0.024946,74.125.200.0-255,5738,207898,64,300291
41896,0.024952,172.31.40.0-255,66,207964,64,300291
41897,0.025752,172.31.40.0-255,167,208131,64,300291
41898,0.025801,172.31.40.0-255,1111,209242,64,300291
41899,0.025864,172.31.40.0-255,1514,210756,64,300291
41900,0.025869,172.31.40.0-255,1514,212270,64,300291
41901,0.025894,172.31.40.0-255,697,212967,64,300291
41902,0.027216,74.125.200.0-255,5738,218705,64,300291
41903,0.027228,172.31.40.0-255,66,218771,64,300291
41904,0.027275,104.244.42.0-255,66,218837,64,300291
41905,0.027364,104.244.42.0-255,66,218903,64,300291
41906,0.027412,104.244.42.0-255,66,218969,64,300291
41907,0.027417,104.244.42.0-255,66,219035,64,300291
41908,0.029484,74.125.200.0-255,5738,224773,64,300291
41909,0.029498,172.31.40.0-255,66,224839,64,300291
41910,0.031767,74.125.200.0-255,5738,230577,64,300291
41911,0.031782,172.31.40.0-255,66,230643,64,300291
41912,0.034031,74.125.200.0-255,5738,236381,64,300291
41913,0.034044,172.31.40.0-255,66,236447,64,300291
41914,0.036318,74.125.200.0-255,5738,242185,64,300291
41915,0.036336,172.31.40.0-255,66,242251,64,300291
41916,0.03859,74.125.200.0-255,5738,247989,64,300291
41917,0.038598,172.31.40.0-255,66,248055,64,300291
41918,0.040877,74.125.200.0-255,5738,253793,64,300291
41919,0.040894,172.31.40.0-255,66,253859,64,300291
41920,0.04317,74.125.200.0-255,5738,259597,64,300291
41921,0.043188,172.31.40.0-255,66,259663,64,300291
41922,0.04545,74.125.200.0-255,5738,265401,64,300291
41923,0.045464,172.31.40.0-255,66,265467,64,300291
41924,0.047718,74.125.200.0-255,5738,271205,64,300291
41925,0.047733,172.31.40.0-255,66,271271,64,300291
41926,0.049996,74.125.200.0-255,5738,277009,64,300291
41927,0.050012,172.31.40.0-255,66,277075,64,300291
41928,0.052286,74.125.200.0-255,5738,282813,64,300291
41929,0.052302,172.31.40.0-255,66,282879,64,300291
41930,0.054565,74.125.200.0-255,5738,288617,64,300291
41931,0.054582,172.31.40.0-255,66,288683,64,300291
41932,0.056872,74.125.200.0-255,5738,294421,64,300291
41933,0.05689,172.31.40.0-255,66,294487,64,300291
41934,0.059153,74.125.200.0-255,5738,300225,64,300291
41935,0.059168,172.31.40.0-255,66,300291,64,300291
41936,0.0,172.217.27.0-255,153,153,64,263695
41937,2.3e-05,172.31.40.0-255,66,219,64,263695
41938,3e-05,172.217.27.0-255,1484,1703,64,263695
41939,3.5e-05,172.31.40.0-255,66,1769,64,263695
41940,3.8e-05,172.217.27.0-255,1484,3253,64,263695
41941,4.8e-05,172.31.40.0-255,66,3319,64,263695
41942,5.5e-05,172.217.27.0-255,2902,6221,64,263695
41943,5.8e-05,172.31.40.0-255,66,6287,64,263695
41944,6.4e-05,172.217.27.0-255,5738,12025,64,263695
41945,6.7e-05,172.31.40.0-255,66,12091,64,263695
41946,7.2e-05,172.217.27.0-255,2119,14210,64,263695
41947,7.5e-05,172.31.40.0-255,66,14276,64,263695
41948,0.000286,172.217.27.0-255,1484,15760,64,263695
41949,0.000293,172.31.40.0-255,66,15826,64,263695
41950,0.000299,172.217.27.0-255,2902,18728,64,263695
41951,0.000301,172.31.40.0-255,66,18794,64,263695
41952,0.000329,172.217.27.0-255,1484,20278,64,263695
41953,0.000331,172.31.40.0-255,66,20344,64,263695
41954,0.000336,172.217.27.0-255,2902,23246,64,263695
41955,0.000339,172.31.40.0-255,66,23312,64,263695
41956,0.000348,172.217.27.0-255,4320,27632,64,263695
41957,0.00035,172.31.40.0-255,66,27698,64,263695
41958,0.000382,172.217.27.0-255,3961,31659,64,263695
41959,0.000385,172.31.40.0-255,66,31725,64,263695
41960,0.000721,172.217.27.0-255,1484,33209,64,263695
41961,0.000726,172.31.40.0-255,66,33275,64,263695
41962,0.00073,172.217.27.0-255,1484,34759,64,263695
41963,0.000732,172.31.40.0-255,66,34825,64,263695
41964,0.000754,172.217.27.0-255,2902,37727,64,263695
41965,0.000756,172.31.40.0-255,66,37793,64,263695
41966,0.000767,172.217.27.0-255,5738,43531,64,263695
41967,0.000769,172.31.40.0-255,66,43597,64,263695
41968,0.000788,172.217.27.0-255,1484,45081,64,263695
41969,0.000819,172.217.27.0-255,3961,49042,64,263695
41970,0.000822,172.31.40.0-255,66,49108,64,263695
41971,0.000828,172.217.27.0-255,5738,54846,64,263695
41972,0.00083,172.31.40.0-255,66,54912,64,263695
41973,0.00084,172.217.27.0-255,2902,57814,64,263695
41974,0.000842,172.31.40.0-255,66,57880,64,263695
41975,0.000882,172.31.40.0-255,66,57946,64,263695
41976,0.000884,172.217.27.0-255,394,58340,64,263695
41977,0.001185,172.31.40.0-255,66,58406,64,263695
41978,0.002522,172.217.27.0-255,4320,62726,64,263695
41979,0.00253,172.31.40.0-255,66,62792,64,263695
41980,0.002816,172.217.27.0-255,1484,64276,64,263695
41981,0.004163,172.217.27.0-255,2902,67178,64,263695
41982,0.004166,172.31.40.0-255,66,67244,64,263695
41983,0.004192,172.217.27.0-255,1484,68728,64,263695
41984,0.00579,172.217.27.0-255,2902,71630,64,263695
41985,0.005793,172.31.40.0-255,66,71696,64,263695
41986,0.005817,172.217.27.0-255,1484,73180,64,263695
41987,0.00744,172.217.27.0-255,4320,77500,64,263695
41988,0.007447,172.31.40.0-255,66,77566,64,263695
41989,0.009096,172.217.27.0-255,5738,83304,64,263695
41990,0.009103,172.31.40.0-255,66,83370,64,263695
41991,0.010743,172.217.27.0-255,5738,89108,64,263695
41992,0.01075,172.31.40.0-255,66,89174,64,263695
41993,0.012413,172.217.27.0-255,5738,94912,64,263695
41994,0.01242,172.31.40.0-255,66,94978,64,263695
41995,0.014056,172.217.27.0-255,5738,100716,64,263695
41996,0.014064,172.31.40.0-255,66,100782,64,263695
41997,0.015714,172.217.27.0-255,5738,106520,64,263695
41998,0.01572,172.31.40.0-255,66,106586,64,263695
41999,0.017364,172.217.27.0-255,5738,112324,64,263695
42000,0.017371,172.31.40.0-255,66,112390,64,263695
42001,0.019015,172.217.27.0-255,5738,118128,64,263695
42002,0.019023,172.31.40.0-255,66,118194,64,263695
42003,0.020663,172.217.27.0-255,5738,123932,64,263695
42004,0.02067,172.31.40.0-255,66,123998,64,263695
42005,0.02231,172.217.27.0-255,5738,129736,64,263695
42006,0.022316,172.31.40.0-255,66,129802,64,263695
42007,0.023289,172.31.40.0-255,172,129974,64,263695
42008,0.023321,172.31.40.0-255,1107,131081,64,263695
42009,0.02338,172.31.40.0-255,1514,132595,64,263695
42010,0.023381,172.31.40.0-255,1514,134109,64,263695
42011,0.023383,172.31.40.0-255,1514,135623,64,263695
42012,0.023384,172.31.40.0-255,120,135743,64,263695
42013,0.023973,172.217.27.0-255,5738,141481,64,263695
42014,0.023979,172.31.40.0-255,66,141547,64,263695
42015,0.024838,104.244.42.0-255,66,141613,64,263695
42016,0.024879,104.244.42.0-255,66,141679,64,263695
42017,0.024992,104.244.42.0-255,66,141745,64,263695
42018,0.024996,104.244.42.0-255,66,141811,64,263695
42019,0.025625,172.217.27.0-255,5738,147549,64,263695
42020,0.02563,172.31.40.0-255,66,147615,64,263695
42021,0.027283,172.217.27.0-255,5738,153353,64,263695
42022,0.027289,172.31.40.0-255,66,153419,64,263695
42023,0.028956,172.217.27.0-255,5738,159157,64,263695
42024,0.028966,172.31.40.0-255,66,159223,64,263695
42025,0.03061,172.217.27.0-255,5738,164961,64,263695
42026,0.030616,172.31.40.0-255,66,165027,64,263695
42027,0.032266,172.217.27.0-255,5738,170765,64,263695
42028,0.032274,172.31.40.0-255,66,170831,64,263695
42029,0.033938,172.217.27.0-255,5738,176569,64,263695
42030,0.033946,172.31.40.0-255,66,176635,64,263695
42031,0.035611,172.217.27.0-255,5738,182373,64,263695
42032,0.035616,172.31.40.0-255,66,182439,64,263695
42033,0.03726,172.217.27.0-255,5738,188177,64,263695
42034,0.037267,172.31.40.0-255,66,188243,64,263695
42035,0.038937,172.217.27.0-255,5738,193981,64,263695
42036,0.038943,172.31.40.0-255,66,194047,64,263695
42037,0.040596,172.217.27.0-255,5738,199785,64,263695
42038,0.040603,172.31.40.0-255,66,199851,64,263695
42039,0.042259,172.217.27.0-255,5738,205589,64,263695
42040,0.042266,172.31.40.0-255,66,205655,64,263695
42041,0.043919,172.217.27.0-255,5738,211393,64,263695
42042,0.043926,172.31.40.0-255,66,211459,64,263695
42043,0.045572,172.217.27.0-255,5738,217197,64,263695
42044,0.045582,172.31.40.0-255,66,217263,64,263695
42045,0.04723,172.217.27.0-255,5738,223001,64,263695
42046,0.047236,172.31.40.0-255,66,223067,64,263695
42047,0.048922,172.217.27.0-255,5738,228805,64,263695
42048,0.048928,172.31.40.0-255,66,228871,64,263695
42049,0.050579,172.217.27.0-255,5738,234609,64,263695
42050,0.050586,172.31.40.0-255,66,234675,64,263695
42051,0.052232,172.217.27.0-255,5738,240413,64,263695
42052,0.052239,172.31.40.0-255,66,240479,64,263695
42053,0.053885,172.217.27.0-255,5738,246217,64,263695
42054,0.053891,172.31.40.0-255,66,246283,64,263695
42055,0.055539,172.217.27.0-255,5738,252021,64,263695
42056,0.055557,172.31.40.0-255,66,252087,64,263695
42057,0.057207,172.217.27.0-255,5738,257825,64,263695
42058,0.057222,172.31.40.0-255,66,257891,64,263695
42059,0.058882,172.217.27.0-255,5738,263629,64,263695
42060,0.058896,172.31.40.0-255,66,263695,64,263695
42061,0.0,172.217.194.0-255,152,152,64,222839
42062,2.4e-05,172.31.40.0-255,66,218,64,222839
42063,3.1e-05,172.217.194.0-255,1484,1702,64,222839
42064,3.6e-05,172.31.40.0-255,66,1768,64,222839
42065,4.2e-05,172.217.194.0-255,2902,4670,64,222839
42066,4.6e-05,172.31.40.0-255,66,4736,64,222839
42067,6.1e-05,172.217.194.0-255,7156,11892,64,222839
42068,6.4e-05,172.31.40.0-255,66,11958,64,222839
42069,7.7e-05,172.31.40.0-255,66,12024,64,222839
42070,0.000125,172.31.40.0-255,66,12090,64,222839
42071,0.000161,172.217.194.0-255,2902,14992,64,222839
42072,0.000164,172.31.40.0-255,66,15058,64,222839
42073,0.000169,172.217.194.0-255,4320,19378,64,222839
42074,0.000171,172.31.40.0-255,66,19444,64,222839
42075,0.000177,172.217.194.0-255,4320,23764,64,222839
42076,0.000186,172.31.40.0-255,66,23830,64,222839
42077,0.000218,172.217.194.0-255,4320,28150,64,222839
42078,0.000221,172.31.40.0-255,66,28216,64,222839
42079,0.000235,172.31.40.0-255,66,28282,64,222839
42080,0.00026,172.217.194.0-255,5379,33661,64,222839
42081,0.000263,172.31.40.0-255,66,33727,64,222839
42082,0.000267,172.217.194.0-255,1713,35440,64,222839
42083,0.000269,172.31.40.0-255,66,35506,64,222839
42084,0.00045,172.217.194.0-255,1484,36990,64,222839
42085,0.000454,172.31.40.0-255,66,37056,64,222839
42086,0.00046,172.217.194.0-255,2902,39958,64,222839
42087,0.000464,172.31.40.0-255,66,40024,64,222839
42088,0.000468,172.217.194.0-255,2902,42926,64,222839
42089,0.000475,172.31.40.0-255,66,42992,64,222839
42090,0.000506,172.217.194.0-255,2902,45894,64,222839
42091,0.000509,172.31.40.0-255,66,45960,64,222839
42092,0.00052,172.31.40.0-255,66,46026,64,222839
42093,0.000567,172.31.40.0-255,66,46092,64,222839
42094,0.000587,172.217.194.0-255,3602,49694,64,222839
42095,0.000591,172.31.40.0-255,66,49760,64,222839
42096,0.000647,172.217.194.0-255,1484,51244,64,222839
42097,0.000654,172.217.194.0-255,2902,54146,64,222839
42098,0.000657,172.31.40.0-255,66,54212,64,222839
42099,0.000661,172.217.194.0-255,1484,55696,64,222839
42100,0.000693,172.217.194.0-255,4320,60016,64,222839
42101,0.000696,172.31.40.0-255,66,60082,64,222839
42102,0.000708,172.31.40.0-255,66,60148,64,222839
42103,0.000717,172.217.194.0-255,2902,63050,64,222839
42104,0.000721,172.31.40.0-255,66,63116,64,222839
42105,0.000777,172.31.40.0-255,66,63182,64,222839
42106,0.000781,172.217.194.0-255,1636,64818,64,222839
42107,0.000784,172.31.40.0-255,66,64884,64,222839
42108,0.000789,172.217.194.0-255,2902,67786,64,222839
42109,0.000791,172.31.40.0-255,66,67852,64,222839
42110,0.000795,172.217.194.0-255,2902,70754,64,222839
42111,0.000798,172.31.40.0-255,66,70820,64,222839
42112,0.000816,172.31.40.0-255,101,70921,64,222839
42113,0.000836,172.217.194.0-255,7156,78077,64,222839
42114,0.000838,172.217.194.0-255,1484,79561,64,222839
42115,0.000845,172.31.40.0-255,66,79627,64,222839
42116,0.000888,172.31.40.0-255,66,79693,64,222839
42117,0.000895,172.217.194.0-255,5020,84713,64,222839
42118,0.000897,172.31.40.0-255,66,84779,64,222839
42119,0.000934,172.217.194.0-255,1484,86263,64,222839
42120,0.000939,172.217.194.0-255,2902,89165,64,222839
42121,0.000941,172.31.40.0-255,66,89231,64,222839
42122,0.000976,172.217.194.0-255,5738,94969,64,222839
42123,0.000981,172.31.40.0-255,66,95035,64,222839
42124,0.001024,172.217.194.0-255,2902,97937,64,222839
42125,0.001027,172.31.40.0-255,66,98003,64,222839
42126,0.001055,172.217.194.0-255,2902,100905,64,222839
42127,0.001057,172.31.40.0-255,66,100971,64,222839
42128,0.001071,172.31.40.0-255,66,101037,64,222839
42129,0.001077,172.217.194.0-255,5020,106057,64,222839
42130,0.00108,172.31.40.0-255,66,106123,64,222839
42131,0.001083,172.217.194.0-255,1484,107607,64,222839
42132,0.001087,172.217.194.0-255,2902,110509,64,222839
42133,0.00109,172.31.40.0-255,66,110575,64,222839
42134,0.001092,172.217.194.0-255,1484,112059,64,222839
42135,0.001107,172.217.194.0-255,4320,116379,64,222839
42136,0.00111,172.31.40.0-255,66,116445,64,222839
42137,0.001117,172.217.194.0-255,5738,122183,64,222839
42138,0.00112,172.31.40.0-255,66,122249,64,222839
42139,0.001126,172.217.194.0-255,1484,123733,64,222839
42140,0.001173,172.31.40.0-255,66,123799,64,222839
42141,0.001179,172.217.194.0-255,5020,128819,64,222839
42142,0.001182,172.31.40.0-255,66,128885,64,222839
42143,0.001217,172.217.194.0-255,1484,130369,64,222839
42144,0.001247,172.217.194.0-255,2902,133271,64,222839
42145,0.00125,172.31.40.0-255,66,133337,64,222839
42146,0.001257,172.217.194.0-255,5738,139075,64,222839
42147,0.00126,172.31.40.0-255,66,139141,64,222839
42148,0.001265,172.217.194.0-255,4320,143461,64,222839
42149,0.001296,172.217.194.0-255,2902,146363,64,222839
42150,0.0013,172.217.194.0-255,1484,147847,64,222839
42151,0.00131,172.31.40.0-255,66,147913,64,222839
42152,0.00134,172.217.194.0-255,2184,150097,64,222839
42153,0.001361,172.31.40.0-255,66,150163,64,222839
42154,0.001457,172.217.194.0-255,1484,151647,64,222839
42155,0.001463,172.217.194.0-255,2902,154549,64,222839
42156,0.001469,172.217.194.0-255,2902,157451,64,222839
42157,0.001478,172.31.40.0-255,66,157517,64,222839
42158,0.001488,172.217.194.0-255,2902,160419,64,222839
42159,0.001526,172.31.40.0-255,66,160485,64,222839
42160,0.001552,172.31.40.0-255,66,160551,64,222839
42161,0.001582,172.31.40.0-255,66,160617,64,222839
42162,0.001593,172.217.194.0-255,2902,163519,64,222839
42163,0.001668,172.217.194.0-255,6438,169957,64,222839
42164,0.001701,172.217.194.0-255,5738,175695,64,222839
42165,0.001756,172.217.194.0-255,7156,182851,64,222839
42166,0.001782,172.217.194.0-255,766,183617,64,222839
42167,0.00183,172.217.194.0-255,1484,185101,64,222839
42168,0.001834,172.217.194.0-255,2902,188003,64,222839
42169,0.00184,172.217.194.0-255,4320,192323,64,222839
42170,0.001852,172.217.194.0-255,1484,193807,64,222839
42171,0.001867,172.217.194.0-255,2902,196709,64,222839
42172,0.001883,172.217.194.0-255,4320,201029,64,222839
42173,0.001975,172.217.194.0-255,5738,206767,64,222839
42174,0.001979,172.217.194.0-255,2184,208951,64,222839
42175,0.001992,172.217.194.0-255,2902,211853,64,222839
42176,0.002016,172.217.194.0-255,6286,218139,64,222839
42177,0.002019,172.217.194.0-255,105,218244,64,222839
42178,0.002446,172.31.40.0-255,66,218310,64,222839
42179,0.00303,172.217.194.0-255,66,218376,64,222839
42180,0.004931,172.31.40.0-255,105,218481,64,222839
42181,0.007158,172.217.194.0-255,66,218547,64,222839
42182,0.030478,172.31.40.0-255,172,218719,64,222839
42183,0.030511,172.31.40.0-255,1112,219831,64,222839
42184,0.030572,172.31.40.0-255,1514,221345,64,222839
42185,0.030573,172.31.40.0-255,1296,222641,64,222839
42186,0.032059,104.244.42.0-255,66,222707,64,222839
42187,0.032097,104.244.42.0-255,66,222773,64,222839
42188,0.032165,104.244.42.0-255,66,222839,64,222839
42189,0.0,74.125.200.0-255,143,143,64,275466
42190,2.3e-05,172.31.40.0-255,66,209,64,275466
42191,3.1e-05,74.125.200.0-255,1484,1693,64,275466
42192,3.6e-05,172.31.40.0-255,66,1759,64,275466
42193,4.2e-05,74.125.200.0-255,2902,4661,64,275466
42194,4.6e-05,172.31.40.0-255,66,4727,64,275466
42195,5.3e-05,74.125.200.0-255,7156,11883,64,275466
42196,6.3e-05,172.31.40.0-255,66,11949,64,275466
42197,6.8e-05,74.125.200.0-255,1992,13941,64,275466
42198,7.1e-05,172.31.40.0-255,66,14007,64,275466
42199,0.000128,74.125.200.0-255,1484,15491,64,275466
42200,0.000131,172.31.40.0-255,66,15557,64,275466
42201,0.000136,74.125.200.0-255,2902,18459,64,275466
42202,0.000139,172.31.40.0-255,66,18525,64,275466
42203,0.000142,74.125.200.0-255,1484,20009,64,275466
42204,0.000144,172.31.40.0-255,66,20075,64,275466
42205,0.000179,74.125.200.0-255,4320,24395,64,275466
42206,0.000182,172.31.40.0-255,66,24461,64,275466
42207,0.000195,74.125.200.0-255,5738,30199,64,275466
42208,0.000197,172.31.40.0-255,66,30265,64,275466
42209,0.0002,74.125.200.0-255,1125,31390,64,275466
42210,0.000202,172.31.40.0-255,66,31456,64,275466
42211,0.000283,74.125.200.0-255,1484,32940,64,275466
42212,0.000286,172.31.40.0-255,66,33006,64,275466
42213,0.000308,74.125.200.0-255,2902,35908,64,275466
42214,0.000311,172.31.40.0-255,66,35974,64,275466
42215,0.000317,74.125.200.0-255,4320,40294,64,275466
42216,0.000319,172.31.40.0-255,66,40360,64,275466
42217,0.000322,74.125.200.0-255,1484,41844,64,275466
42218,0.000324,172.31.40.0-255,66,41910,64,275466
42219,0.00035,74.125.200.0-255,4320,46230,64,275466
42220,0.000353,172.31.40.0-255,66,46296,64,275466
42221,0.000356,74.125.200.0-255,1484,47780,64,275466
42222,0.000398,172.31.40.0-255,66,47846,64,275466
42223,0.000425,74.125.200.0-255,5738,53584,64,275466
42224,0.000429,172.31.40.0-255,66,53650,64,275466
42225,0.000457,74.125.200.0-255,1125,54775,64,275466
42226,0.00046,74.125.200.0-255,411,55186,64,275466
42227,0.000692,74.125.200.0-255,332,55518,64,275466
42228,0.000697,172.31.40.0-255,66,55584,64,275466
42229,0.001125,74.125.200.0-255,1484,57068,64,275466
42230,0.001132,74.125.200.0-255,2902,59970,64,275466
42231,0.001136,172.31.40.0-255,66,60036,64,275466
42232,0.001171,74.125.200.0-255,5738,65774,64,275466
42233,0.001174,172.31.40.0-255,66,65840,64,275466
42234,0.001177,74.125.200.0-255,1484,67324,64,275466
42235,0.001202,74.125.200.0-255,5738,73062,64,275466
42236,0.001205,172.31.40.0-255,66,73128,64,275466
42237,0.001208,74.125.200.0-255,1484,74612,64,275466
42238,0.00124,74.125.200.0-255,7156,81768,64,275466
42239,0.001243,172.31.40.0-255,66,81834,64,275466
42240,0.001249,74.125.200.0-255,7156,88990,64,275466
42241,0.001252,172.31.40.0-255,66,89056,64,275466
42242,0.001254,74.125.200.0-255,766,89822,64,275466
42243,0.001524,172.31.40.0-255,66,89888,64,275466
42244,0.001825,74.125.200.0-255,1484,91372,64,275466
42245,0.001834,74.125.200.0-255,1484,92856,64,275466
42246,0.001838,172.31.40.0-255,66,92922,64,275466
42247,0.001875,74.125.200.0-255,1484,94406,64,275466
42248,0.001881,74.125.200.0-255,4320,98726,64,275466
42249,0.001884,172.31.40.0-255,66,98792,64,275466
42250,0.001891,74.125.200.0-255,5738,104530,64,275466
42251,0.001893,172.31.40.0-255,66,104596,64,275466
42252,0.001912,74.125.200.0-255,2902,107498,64,275466
42253,0.001915,172.31.40.0-255,66,107564,64,275466
42254,0.001918,74.125.200.0-255,1484,109048,64,275466
42255,0.001932,74.125.200.0-255,2902,111950,64,275466
42256,0.001938,172.31.40.0-255,66,112016,64,275466
42257,0.001975,172.31.40.0-255,66,112082,64,275466
42258,0.001982,74.125.200.0-255,3602,115684,64,275466
42259,0.001984,172.31.40.0-255,66,115750,64,275466
42260,0.004038,74.125.200.0-255,1484,117234,64,275466
42261,0.004056,74.125.200.0-255,4320,121554,64,275466
42262,0.00406,172.31.40.0-255,66,121620,64,275466
42263,0.006142,74.125.200.0-255,5738,127358,64,275466
42264,0.006146,172.31.40.0-255,66,127424,64,275466
42265,0.008235,74.125.200.0-255,5738,133162,64,275466
42266,0.008244,172.31.40.0-255,66,133228,64,275466
42267,0.01033,74.125.200.0-255,5738,138966,64,275466
42268,0.010344,172.31.40.0-255,66,139032,64,275466
42269,0.012438,74.125.200.0-255,5738,144770,64,275466
42270,0.01245,172.31.40.0-255,66,144836,64,275466
42271,0.014533,74.125.200.0-255,5738,150574,64,275466
42272,0.014543,172.31.40.0-255,66,150640,64,275466
42273,0.016641,74.125.200.0-255,5738,156378,64,275466
42274,0.016653,172.31.40.0-255,66,156444,64,275466
42275,0.018731,74.125.200.0-255,5738,162182,64,275466
42276,0.01874,172.31.40.0-255,66,162248,64,275466
42277,0.020859,74.125.200.0-255,5738,167986,64,275466
42278,0.02087,172.31.40.0-255,66,168052,64,275466
42279,0.022944,74.125.200.0-255,5738,173790,64,275466
42280,0.022953,172.31.40.0-255,66,173856,64,275466
42281,0.02507,74.125.200.0-255,5738,179594,64,275466
42282,0.025078,172.31.40.0-255,66,179660,64,275466
42283,0.027163,74.125.200.0-255,5738,185398,64,275466
42284,0.02717,172.31.40.0-255,66,185464,64,275466
42285,0.027251,172.31.40.0-255,172,185636,64,275466
42286,0.027277,172.31.40.0-255,1112,186748,64,275466
42287,0.027326,172.31.40.0-255,1514,188262,64,275466
42288,0.027327,172.31.40.0-255,1298,189560,64,275466
42289,0.028785,104.244.42.0-255,66,189626,64,275466
42290,0.028836,104.244.42.0-255,66,189692,64,275466
42291,0.028885,104.244.42.0-255,66,189758,64,275466
42292,0.02925,74.125.200.0-255,5738,195496,64,275466
42293,0.029257,172.31.40.0-255,66,195562,64,275466
42294,0.031339,74.125.200.0-255,5738,201300,64,275466
42295,0.031347,172.31.40.0-255,66,201366,64,275466
42296,0.033436,74.125.200.0-255,5738,207104,64,275466
42297,0.033442,172.31.40.0-255,66,207170,64,275466
42298,0.035538,74.125.200.0-255,5738,212908,64,275466
42299,0.035545,172.31.40.0-255,66,212974,64,275466
42300,0.037627,74.125.200.0-255,5738,218712,64,275466
42301,0.037634,172.31.40.0-255,66,218778,64,275466
42302,0.039724,74.125.200.0-255,5738,224516,64,275466
42303,0.039731,172.31.40.0-255,66,224582,64,275466
42304,0.041817,74.125.200.0-255,5738,230320,64,275466
42305,0.041827,172.31.40.0-255,66,230386,64,275466
42306,0.043925,74.125.200.0-255,5738,236124,64,275466
42307,0.043932,172.31.40.0-255,66,236190,64,275466
42308,0.046002,74.125.200.0-255,4320,240510,64,275466
42309,0.046011,172.31.40.0-255,66,240576,64,275466
42310,0.046038,74.125.200.0-255,1484,242060,64,275466
42311,0.048102,74.125.200.0-255,4320,246380,64,275466
42312,0.04811,172.31.40.0-255,66,246446,64,275466
42313,0.050207,74.125.200.0-255,5738,252184,64,275466
42314,0.050214,172.31.40.0-255,66,252250,64,275466
42315,0.0523,74.125.200.0-255,5738,257988,64,275466
42316,0.052307,172.31.40.0-255,66,258054,64,275466
42317,0.054394,74.125.200.0-255,5738,263792,64,275466
42318,0.0544,172.31.40.0-255,66,263858,64,275466
42319,0.056497,74.125.200.0-255,5738,269596,64,275466
42320,0.056504,172.31.40.0-255,66,269662,64,275466
42321,0.058595,74.125.200.0-255,5738,275400,64,275466
42322,0.058602,172.31.40.0-255,66,275466,64,275466
42323,0.0,172.217.24.0-255,153,153,64,291378
42324,2.2e-05,172.31.40.0-255,66,219,64,291378
42325,2.9e-05,172.217.24.0-255,1484,1703,64,291378
42326,3.4e-05,172.31.40.0-255,66,1769,64,291378
42327,3.9e-05,172.217.24.0-255,2902,4671,64,291378
42328,4.1e-05,172.31.40.0-255,66,4737,64,291378
42329,4.5e-05,172.217.24.0-255,2902,7639,64,291378
42330,4.7e-05,172.31.40.0-255,66,7705,64,291378
42331,8.1e-05,172.217.24.0-255,4320,12025,64,291378
42332,8.3e-05,172.31.40.0-255,66,12091,64,291378
42333,0.000105,172.217.24.0-255,2001,14092,64,291378
42334,0.000107,172.31.40.0-255,66,14158,64,291378
42335,0.000324,172.217.24.0-255,1484,15642,64,291378
42336,0.000329,172.31.40.0-255,66,15708,64,291378
42337,0.000335,172.217.24.0-255,2902,18610,64,291378
42338,0.000337,172.31.40.0-255,66,18676,64,291378
42339,0.000355,172.217.24.0-255,4320,22996,64,291378
42340,0.000358,172.31.40.0-255,66,23062,64,291378
42341,0.000387,172.217.24.0-255,4320,27382,64,291378
42342,0.00039,172.31.40.0-255,66,27448,64,291378
42343,0.000417,172.217.24.0-255,3961,31409,64,291378
42344,0.00042,172.31.40.0-255,66,31475,64,291378
42345,0.000502,172.217.24.0-255,1484,32959,64,291378
42346,0.000505,172.31.40.0-255,66,33025,64,291378
42347,0.00051,172.217.24.0-255,2902,35927,64,291378
42348,0.000512,172.31.40.0-255,66,35993,64,291378
42349,0.000543,172.217.24.0-255,5738,41731,64,291378
42350,0.000546,172.31.40.0-255,66,41797,64,291378
42351,0.000552,172.217.24.0-255,6797,48594,64,291378
42352,0.000554,172.31.40.0-255,66,48660,64,291378
42353,0.000902,172.217.24.0-255,1484,50144,64,291378
42354,0.000909,172.31.40.0-255,66,50210,64,291378
42355,0.000918,172.217.24.0-255,2902,53112,64,291378
42356,0.00093,172.217.24.0-255,5738,58850,64,291378
42357,0.000963,172.217.24.0-255,4320,63170,64,291378
42358,0.000976,172.217.24.0-255,2543,65713,64,291378
42359,0.000991,172.217.24.0-255,393,66106,64,291378
42360,0.001323,172.217.24.0-255,1484,67590,64,291378
42361,0.001331,172.217.24.0-255,2902,70492,64,291378
42362,0.001337,172.217.24.0-255,4320,74812,64,291378
42363,0.001352,172.217.24.0-255,1484,76296,64,291378
42364,0.001376,172.217.24.0-255,4320,80616,64,291378
42365,0.001392,172.217.24.0-255,3961,84577,64,291378
42366,0.00141,172.217.24.0-255,1484,86061,64,291378
42367,0.001425,172.217.24.0-255,5083,91144,64,291378
42368,0.00144,172.217.24.0-255,645,91789,64,291378
42369,0.001469,172.217.24.0-255,1484,93273,64,291378
42370,0.001487,172.217.24.0-255,4320,97593,64,291378
42371,0.001503,172.217.24.0-255,2902,100495,64,291378
42372,0.001519,172.217.24.0-255,7156,107651,64,291378
42373,0.001522,172.217.24.0-255,460,108111,64,291378
42374,0.001878,172.217.24.0-255,1484,109595,64,291378
42375,0.001887,172.217.24.0-255,2902,112497,64,291378
42376,0.001893,172.217.24.0-255,4320,116817,64,291378
42377,0.001909,172.217.24.0-255,1484,118301,64,291378
42378,0.001916,172.217.24.0-255,2902,121203,64,291378
42379,0.001928,172.217.24.0-255,4657,125860,64,291378
42380,0.003776,172.31.40.0-255,66,125926,64,291378
42381,0.005734,172.217.24.0-255,4320,130246,64,291378
42382,0.00574,172.31.40.0-255,66,130312,64,291378
42383,0.00577,172.217.24.0-255,1484,131796,64,291378
42384,0.007679,172.217.24.0-255,4320,136116,64,291378
42385,0.007686,172.31.40.0-255,66,136182,64,291378
42386,0.009629,172.217.24.0-255,5738,141920,64,291378
42387,0.010248,172.31.40.0-255,66,141986,64,291378
42388,0.012189,172.217.24.0-255,5738,147724,64,291378
42389,0.012197,172.31.40.0-255,66,147790,64,291378
42390,0.014143,172.217.24.0-255,5738,153528,64,291378
42391,0.014152,172.31.40.0-255,66,153594,64,291378
42392,0.016138,172.217.24.0-255,5738,159332,64,291378
42393,0.016146,172.31.40.0-255,66,159398,64,291378
42394,0.018086,172.217.24.0-255,5738,165136,64,291378
42395,0.018092,172.31.40.0-255,66,165202,64,291378
42396,0.020034,172.217.24.0-255,5738,170940,64,291378
42397,0.020041,172.31.40.0-255,66,171006,64,291378
42398,0.021987,172.217.24.0-255,5738,176744,64,291378
42399,0.021995,172.31.40.0-255,66,176810,64,291378
42400,0.023941,172.217.24.0-255,5738,182548,64,291378
42401,0.023949,172.31.40.0-255,66,182614,64,291378
42402,0.025897,172.217.24.0-255,5738,188352,64,291378
42403,0.025904,172.31.40.0-255,66,188418,64,291378
42404,0.027846,172.217.24.0-255,5738,194156,64,291378
42405,0.027853,172.31.40.0-255,66,194222,64,291378
42406,0.028419,172.31.40.0-255,172,194394,64,291378
42407,0.028451,172.31.40.0-255,1111,195505,64,291378
42408,0.02851,172.31.40.0-255,1514,197019,64,291378
42409,0.028512,172.31.40.0-255,1297,198316,64,291378
42410,0.029801,172.217.24.0-255,5738,204054,64,291378
42411,0.029807,172.31.40.0-255,66,204120,64,291378
42412,0.029942,104.244.42.0-255,66,204186,64,291378
42413,0.029994,104.244.42.0-255,66,204252,64,291378
42414,0.030046,104.244.42.0-255,66,204318,64,291378
42415,0.031762,172.217.24.0-255,5738,210056,64,291378
42416,0.031768,172.31.40.0-255,66,210122,64,291378
42417,0.033713,172.217.24.0-255,5738,215860,64,291378
42418,0.033722,172.31.40.0-255,66,215926,64,291378
42419,0.035692,172.217.24.0-255,5738,221664,64,291378
42420,0.035698,172.31.40.0-255,66,221730,64,291378
42421,0.03766,172.217.24.0-255,5738,227468,64,291378
42422,0.037666,172.31.40.0-255,66,227534,64,291378
42423,0.039611,172.217.24.0-255,5738,233272,64,291378
42424,0.039616,172.31.40.0-255,66,233338,64,291378
42425,0.041559,172.217.24.0-255,5738,239076,64,291378
42426,0.041566,172.31.40.0-255,66,239142,64,291378
42427,0.043522,172.217.24.0-255,5738,244880,64,291378
42428,0.043529,172.31.40.0-255,66,244946,64,291378
42429,0.045476,172.217.24.0-255,5738,250684,64,291378
42430,0.045481,172.31.40.0-255,66,250750,64,291378
42431,0.047423,172.217.24.0-255,5738,256488,64,291378
42432,0.04743,172.31.40.0-255,66,256554,64,291378
42433,0.049366,172.217.24.0-255,5738,262292,64,291378
42434,0.049373,172.31.40.0-255,66,262358,64,291378
42435,0.051354,172.217.24.0-255,5738,268096,64,291378
42436,0.051361,172.31.40.0-255,66,268162,64,291378
42437,0.053302,172.217.24.0-255,5738,273900,64,291378
42438,0.053309,172.31.40.0-255,66,273966,64,291378
42439,0.055278,172.217.24.0-255,5738,279704,64,291378
42440,0.055283,172.31.40.0-255,66,279770,64,291378
42441,0.057232,172.217.24.0-255,5738,285508,64,291378
42442,0.057238,172.31.40.0-255,66,285574,64,291378
42443,0.059192,172.217.24.0-255,5738,291312,64,291378
42444,0.059199,172.31.40.0-255,66,291378,64,291378
42445,0.0,74.125.68.0-255,153,153,64,267205
42446,2.3e-05,172.31.40.0-255,66,219,64,267205
42447,9.3e-05,74.125.68.0-255,1484,1703,64,267205
42448,9.8e-05,172.31.40.0-255,66,1769,64,267205
42449,0.000104,74.125.68.0-255,2902,4671,64,267205
42450,0.000108,172.31.40.0-255,66,4737,64,267205
42451,0.00012,74.125.68.0-255,5738,10475,64,267205
42452,0.000123,172.31.40.0-255,66,10541,64,267205
42453,0.000159,74.125.68.0-255,4880,15421,64,267205
42454,0.000162,172.31.40.0-255,66,15487,64,267205
42455,0.000168,74.125.68.0-255,4320,19807,64,267205
42456,0.00017,172.31.40.0-255,66,19873,64,267205
42457,0.000195,74.125.68.0-255,1484,21357,64,267205
42458,0.000197,172.31.40.0-255,66,21423,64,267205
42459,0.000213,172.31.40.0-255,66,21489,64,267205
42460,0.000232,74.125.68.0-255,1125,22614,64,267205
42461,0.000234,172.31.40.0-255,66,22680,64,267205
42462,0.000385,74.125.68.0-255,1484,24164,64,267205
42463,0.000391,172.31.40.0-255,66,24230,64,267205
42464,0.000396,74.125.68.0-255,2902,27132,64,267205
42465,0.000399,172.31.40.0-255,66,27198,64,267205
42466,0.000401,74.125.68.0-255,1484,28682,64,267205
42467,0.000403,172.31.40.0-255,66,28748,64,267205
42468,0.000437,74.125.68.0-255,2902,31650,64,267205
42469,0.00044,172.31.40.0-255,66,31716,64,267205
42470,0.000447,74.125.68.0-255,5738,37454,64,267205
42471,0.000449,172.31.40.0-255,66,37520,64,267205
42472,0.000473,74.125.68.0-255,3961,41481,64,267205
42473,0.000476,172.31.40.0-255,66,41547,64,267205
42474,0.000487,172.31.40.0-255,66,41613,64,267205
42475,0.00049,74.125.68.0-255,1484,43097,64,267205
42476,0.000514,74.125.68.0-255,3961,47058,64,267205
42477,0.000517,172.31.40.0-255,66,47124,64,267205
42478,0.00052,74.125.68.0-255,647,47771,64,267205
42479,0.001051,172.31.40.0-255,66,47837,64,267205
42480,0.001098,74.125.68.0-255,1484,49321,64,267205
42481,0.001113,74.125.68.0-255,2902,52223,64,267205
42482,0.001115,172.31.40.0-255,66,52289,64,267205
42483,0.001119,74.125.68.0-255,1484,53773,64,267205
42484,0.001142,74.125.68.0-255,4320,58093,64,267205
42485,0.001144,172.31.40.0-255,66,58159,64,267205
42486,0.001149,74.125.68.0-255,2902,61061,64,267205
42487,0.00115,172.31.40.0-255,66,61127,64,267205
42488,0.001171,74.125.68.0-255,4320,65447,64,267205
42489,0.001173,172.31.40.0-255,66,65513,64,267205
42490,0.001184,74.125.68.0-255,5738,71251,64,267205
42491,0.001186,172.31.40.0-255,66,71317,64,267205
42492,0.001212,74.125.68.0-255,2902,74219,64,267205
42493,0.001214,172.31.40.0-255,66,74285,64,267205
42494,0.001225,172.31.40.0-255,66,74351,64,267205
42495,0.001907,74.125.68.0-255,1484,75835,64,267205
42496,0.001918,74.125.68.0-255,2902,78737,64,267205
42497,0.001922,172.31.40.0-255,66,78803,64,267205
42498,0.001927,74.125.68.0-255,1484,80287,64,267205
42499,0.00193,74.125.68.0-255,1484,81771,64,267205
42500,0.001932,172.31.40.0-255,66,81837,64,267205
42501,0.001948,74.125.68.0-255,1484,83321,64,267205
42502,0.001951,74.125.68.0-255,1484,84805,64,267205
42503,0.001953,172.31.40.0-255,66,84871,64,267205
42504,0.001983,74.125.68.0-255,4320,89191,64,267205
42505,0.001985,172.31.40.0-255,66,89257,64,267205
42506,0.00199,74.125.68.0-255,2902,92159,64,267205
42507,0.001991,172.31.40.0-255,66,92225,64,267205
42508,0.001997,74.125.68.0-255,4320,96545,64,267205
42509,0.002005,172.31.40.0-255,66,96611,64,267205
42510,0.00204,172.31.40.0-255,66,96677,64,267205
42511,0.002085,74.125.68.0-255,3602,100279,64,267205
42512,0.002088,172.31.40.0-255,66,100345,64,267205
42513,0.002313,74.125.68.0-255,1484,101829,64,267205
42514,0.002327,74.125.68.0-255,2902,104731,64,267205
42515,0.00233,172.31.40.0-255,66,104797,64,267205
42516,0.002335,74.125.68.0-255,2902,107699,64,267205
42517,0.002337,172.31.40.0-255,66,107765,64,267205
42518,0.002355,74.125.68.0-255,1484,109249,64,267205
42519,0.002391,74.125.68.0-255,5738,114987,64,267205
42520,0.002393,172.31.40.0-255,66,115053,64,267205
42521,0.002412,74.125.68.0-255,2902,117955,64,267205
42522,0.002415,172.31.40.0-255,66,118021,64,267205
42523,0.004669,74.125.68.0-255,2902,120923,64,267205
42524,0.004673,172.31.40.0-255,66,120989,64,267205
42525,0.004698,74.125.68.0-255,2902,123891,64,267205
42526,0.004701,172.31.40.0-255,66,123957,64,267205
42527,0.006956,74.125.68.0-255,2902,126859,64,267205
42528,0.006963,172.31.40.0-255,66,126925,64,267205
42529,0.006989,74.125.68.0-255,2902,129827,64,267205
42530,0.006992,172.31.40.0-255,66,129893,64,267205
42531,0.009246,74.125.68.0-255,2902,132795,64,267205
42532,0.009253,172.31.40.0-255,66,132861,64,267205
42533,0.009281,74.125.68.0-255,2902,135763,64,267205
42534,0.009284,172.31.40.0-255,66,135829,64,267205
42535,0.011536,74.125.68.0-255,2902,138731,64,267205
42536,0.011544,172.31.40.0-255,66,138797,64,267205
42537,0.01158,74.125.68.0-255,2902,141699,64,267205
42538,0.011582,172.31.40.0-255,66,141765,64,267205
42539,0.01382,74.125.68.0-255,2902,144667,64,267205
42540,0.013827,172.31.40.0-255,66,144733,64,267205
42541,0.013855,74.125.68.0-255,2902,147635,64,267205
42542,0.013858,172.31.40.0-255,66,147701,64,267205
42543,0.016107,74.125.68.0-255,2902,150603,64,267205
42544,0.016115,172.31.40.0-255,66,150669,64,267205
42545,0.016143,74.125.68.0-255,2902,153571,64,267205
42546,0.016146,172.31.40.0-255,66,153637,64,267205
42547,0.01839,74.125.68.0-255,2902,156539,64,267205
42548,0.018397,172.31.40.0-255,66,156605,64,267205
42549,0.018427,74.125.68.0-255,2902,159507,64,267205
42550,0.01843,172.31.40.0-255,66,159573,64,267205
42551,0.020682,74.125.68.0-255,2902,162475,64,267205
42552,0.020689,172.31.40.0-255,66,162541,64,267205
42553,0.020726,74.125.68.0-255,2902,165443,64,267205
42554,0.020729,172.31.40.0-255,66,165509,64,267205
42555,0.022979,74.125.68.0-255,2902,168411,64,267205
42556,0.022986,172.31.40.0-255,66,168477,64,267205
42557,0.023017,74.125.68.0-255,2902,171379,64,267205
42558,0.023019,172.31.40.0-255,66,171445,64,267205
42559,0.025265,74.125.68.0-255,2902,174347,64,267205
42560,0.025272,172.31.40.0-255,66,174413,64,267205
42561,0.0253,74.125.68.0-255,2902,177315,64,267205
42562,0.025303,172.31.40.0-255,66,177381,64,267205
42563,0.026477,172.31.40.0-255,167,177548,64,267205
42564,0.026507,172.31.40.0-255,1108,178656,64,267205
42565,0.026564,172.31.40.0-255,1514,180170,64,267205
42566,0.026565,172.31.40.0-255,337,180507,64,267205
42567,0.027555,74.125.68.0-255,2902,183409,64,267205
42568,0.027562,172.31.40.0-255,66,183475,64,267205
42569,0.027593,74.125.68.0-255,2902,186377,64,267205
42570,0.027596,172.31.40.0-255,66,186443,64,267205
42571,0.028042,104.244.42.0-255,66,186509,64,267205
42572,0.02805,104.244.42.0-255,66,186575,64,267205
42573,0.028152,104.244.42.0-255,66,186641,64,267205
42574,0.029835,74.125.68.0-255,2902,189543,64,267205
42575,0.029841,172.31.40.0-255,66,189609,64,267205
42576,0.029866,74.125.68.0-255,2902,192511,64,267205
42577,0.029869,172.31.40.0-255,66,192577,64,267205
42578,0.032116,74.125.68.0-255,2902,195479,64,267205
42579,0.032124,172.31.40.0-255,66,195545,64,267205
42580,0.032148,74.125.68.0-255,2902,198447,64,267205
42581,0.032151,172.31.40.0-255,66,198513,64,267205
42582,0.034408,74.125.68.0-255,2902,201415,64,267205
42583,0.034416,172.31.40.0-255,66,201481,64,267205
42584,0.034445,74.125.68.0-255,2902,204383,64,267205
42585,0.034448,172.31.40.0-255,66,204449,64,267205
42586,0.0367,74.125.68.0-255,2902,207351,64,267205
42587,0.036707,172.31.40.0-255,66,207417,64,267205
42588,0.036741,74.125.68.0-255,2902,210319,64,267205
42589,0.036744,172.31.40.0-255,66,210385,64,267205
42590,0.038994,74.125.68.0-255,2902,213287,64,267205
42591,0.039004,172.31.40.0-255,66,213353,64,267205
42592,0.039034,74.125.68.0-255,2902,216255,64,267205
42593,0.039038,172.31.40.0-255,66,216321,64,267205
42594,0.041306,74.125.68.0-255,4320,220641,64,267205
42595,0.041321,172.31.40.0-255,66,220707,64,267205
42596,0.041353,74.125.68.0-255,1484,222191,64,267205
42597,0.04362,74.125.68.0-255,4320,226511,64,267205
42598,0.043634,172.31.40.0-255,66,226577,64,267205
42599,0.045934,74.125.68.0-255,5738,232315,64,267205
42600,0.045952,172.31.40.0-255,66,232381,64,267205
42601,0.048251,74.125.68.0-255,5738,238119,64,267205
42602,0.048268,172.31.40.0-255,66,238185,64,267205
42603,0.050613,74.125.68.0-255,5738,243923,64,267205
42604,0.050621,172.31.40.0-255,66,243989,64,267205
42605,0.052918,74.125.68.0-255,5738,249727,64,267205
42606,0.052934,172.31.40.0-255,66,249793,64,267205
42607,0.055217,74.125.68.0-255,5738,255531,64,267205
42608,0.055234,172.31.40.0-255,66,255597,64,267205
42609,0.057537,74.125.68.0-255,5738,261335,64,267205
42610,0.057552,172.31.40.0-255,66,261401,64,267205
42611,0.059854,74.125.68.0-255,5738,267139,64,267205
42612,0.059871,172.31.40.0-255,66,267205,64,267205
42613,0.0,74.125.200.0-255,306,306,64,300656
42614,2.2e-05,172.31.40.0-255,66,372,64,300656
42615,2.8e-05,74.125.200.0-255,1484,1856,64,300656
42616,3.2e-05,172.31.40.0-255,66,1922,64,300656
42617,5.8e-05,74.125.200.0-255,4320,6242,64,300656
42618,6.6e-05,172.31.40.0-255,66,6308,64,300656
42619,7e-05,74.125.200.0-255,2902,9210,64,300656
42620,7.3e-05,172.31.40.0-255,66,9276,64,300656
42621,7.9e-05,74.125.200.0-255,4320,13596,64,300656
42622,8.1e-05,172.31.40.0-255,66,13662,64,300656
42623,8.4e-05,74.125.200.0-255,462,14124,64,300656
42624,8.6e-05,172.31.40.0-255,66,14190,64,300656
42625,0.000621,74.125.200.0-255,1484,15674,64,300656
42626,0.000629,172.31.40.0-255,66,15740,64,300656
42627,0.000635,74.125.200.0-255,2902,18642,64,300656
42628,0.000637,172.31.40.0-255,66,18708,64,300656
42629,0.000664,74.125.200.0-255,5738,24446,64,300656
42630,0.000667,172.31.40.0-255,66,24512,64,300656
42631,0.000675,74.125.200.0-255,1484,25996,64,300656
42632,0.000677,172.31.40.0-255,66,26062,64,300656
42633,0.000716,74.125.200.0-255,5379,31441,64,300656
42634,0.00072,172.31.40.0-255,66,31507,64,300656
42635,0.000839,74.125.200.0-255,1484,32991,64,300656
42636,0.000844,172.31.40.0-255,66,33057,64,300656
42637,0.00085,74.125.200.0-255,2902,35959,64,300656
42638,0.000852,172.31.40.0-255,66,36025,64,300656
42639,0.000876,74.125.200.0-255,4320,40345,64,300656
42640,0.000879,172.31.40.0-255,66,40411,64,300656
42641,0.000903,74.125.200.0-255,5738,46149,64,300656
42642,0.000906,172.31.40.0-255,66,46215,64,300656
42643,0.000914,74.125.200.0-255,1484,47699,64,300656
42644,0.000916,172.31.40.0-255,66,47765,64,300656
42645,0.000948,74.125.200.0-255,3961,51726,64,300656
42646,0.000951,172.31.40.0-255,66,51792,64,300656
42647,0.000958,74.125.200.0-255,5738,57530,64,300656
42648,0.00096,172.31.40.0-255,66,57596,64,300656
42649,0.000963,74.125.200.0-255,1484,59080,64,300656
42650,0.001001,74.125.200.0-255,5738,64818,64,300656
42651,0.001004,172.31.40.0-255,66,64884,64,300656
42652,0.001007,74.125.200.0-255,1125,66009,64,300656
42653,0.001739,74.125.200.0-255,645,66654,64,300656
42654,0.001746,172.31.40.0-255,66,66720,64,300656
42655,0.001834,74.125.200.0-255,1484,68204,64,300656
42656,0.001843,74.125.200.0-255,2902,71106,64,300656
42657,0.001846,172.31.40.0-255,66,71172,64,300656
42658,0.001881,74.125.200.0-255,1484,72656,64,300656
42659,0.001912,74.125.200.0-255,2902,75558,64,300656
42660,0.001916,172.31.40.0-255,66,75624,64,300656
42661,0.001946,74.125.200.0-255,5738,81362,64,300656
42662,0.001949,172.31.40.0-255,66,81428,64,300656
42663,0.001955,74.125.200.0-255,5738,87166,64,300656
42664,0.001957,172.31.40.0-255,66,87232,64,300656
42665,0.001961,74.125.200.0-255,1484,88716,64,300656
42666,0.001991,74.125.200.0-255,5738,94454,64,300656
42667,0.001994,172.31.40.0-255,66,94520,64,300656
42668,0.002002,74.125.200.0-255,6438,100958,64,300656
42669,0.002004,172.31.40.0-255,66,101024,64,300656
42670,0.002052,74.125.200.0-255,1484,102508,64,300656
42671,0.0021,74.125.200.0-255,2902,105410,64,300656
42672,0.002104,172.31.40.0-255,66,105476,64,300656
42673,0.002111,74.125.200.0-255,4320,109796,64,300656
42674,0.002114,172.31.40.0-255,66,109862,64,300656
42675,0.002117,74.125.200.0-255,1484,111346,64,300656
42676,0.002146,74.125.200.0-255,7156,118502,64,300656
42677,0.002149,172.31.40.0-255,66,118568,64,300656
42678,0.002156,74.125.200.0-255,7156,125724,64,300656
42679,0.002159,172.31.40.0-255,66,125790,64,300656
42680,0.002162,74.125.200.0-255,1484,127274,64,300656
42681,0.002196,74.125.200.0-255,7156,134430,64,300656
42682,0.0022,172.31.40.0-255,66,134496,64,300656
42683,0.002202,74.125.200.0-255,766,135262,64,300656
42684,0.002224,74.125.200.0-255,1484,136746,64,300656
42685,0.002226,172.31.40.0-255,66,136812,64,300656
42686,0.002247,74.125.200.0-255,4320,141132,64,300656
42687,0.00225,172.31.40.0-255,66,141198,64,300656
42688,0.002256,74.125.200.0-255,4320,145518,64,300656
42689,0.002258,172.31.40.0-255,66,145584,64,300656
42690,0.002281,74.125.200.0-255,1484,147068,64,300656
42691,0.002314,172.31.40.0-255,66,147134,64,300656
42692,0.00234,74.125.200.0-255,1484,148618,64,300656
42693,0.002346,74.125.200.0-255,5738,154356,64,300656
42694,0.002348,172.31.40.0-255,66,154422,64,300656
42695,0.002383,74.125.200.0-255,4320,158742,64,300656
42696,0.002385,172.31.40.0-255,66,158808,64,300656
42697,0.002413,74.125.200.0-255,766,159574,64,300656
42698,0.003821,172.31.40.0-255,66,159640,64,300656
42699,0.00471,74.125.200.0-255,4320,163960,64,300656
42700,0.004717,172.31.40.0-255,66,164026,64,300656
42701,0.006142,74.125.200.0-255,1484,165510,64,300656
42702,0.007045,74.125.200.0-255,4320,169830,64,300656
42703,0.007051,172.31.40.0-255,66,169896,64,300656
42704,0.009377,74.125.200.0-255,5738,175634,64,300656
42705,0.009381,172.31.40.0-255,66,175700,64,300656
42706,0.011708,74.125.200.0-255,5738,181438,64,300656
42707,0.011713,172.31.40.0-255,66,181504,64,300656
42708,0.01404,74.125.200.0-255,5738,187242,64,300656
42709,0.014046,172.31.40.0-255,66,187308,64,300656
42710,0.016373,74.125.200.0-255,5738,193046,64,300656
42711,0.01638,172.31.40.0-255,66,193112,64,300656
42712,0.018708,74.125.200.0-255,5738,198850,64,300656
42713,0.018715,172.31.40.0-255,66,198916,64,300656
42714,0.021049,74.125.200.0-255,5738,204654,64,300656
42715,0.021059,172.31.40.0-255,66,204720,64,300656
42716,0.023384,74.125.200.0-255,5738,210458,64,300656
42717,0.023393,172.31.40.0-255,66,210524,64,300656
42718,0.025737,74.125.200.0-255,5738,216262,64,300656
42719,0.025745,172.31.40.0-255,66,216328,64,300656
42720,0.028062,74.125.200.0-255,5738,222066,64,300656
42721,0.028068,172.31.40.0-255,66,222132,64,300656
42722,0.030394,74.125.200.0-255,5738,227870,64,300656
42723,0.030403,172.31.40.0-255,66,227936,64,300656
42724,0.032732,74.125.200.0-255,4320,232256,64,300656
42725,0.03274,172.31.40.0-255,66,232322,64,300656
42726,0.032772,74.125.200.0-255,1484,233806,64,300656
42727,0.035076,74.125.200.0-255,4320,238126,64,300656
42728,0.035084,172.31.40.0-255,66,238192,64,300656
42729,0.037461,74.125.200.0-255,5738,243930,64,300656
42730,0.037469,172.31.40.0-255,66,243996,64,300656
42731,0.03953,172.31.40.0-255,172,244168,64,300656
42732,0.039563,172.31.40.0-255,1112,245280,64,300656
42733,0.039621,172.31.40.0-255,1514,246794,64,300656
42734,0.039624,172.31.40.0-255,1296,248090,64,300656
42735,0.039788,74.125.200.0-255,5738,253828,64,300656
42736,0.039795,172.31.40.0-255,66,253894,64,300656
42737,0.041088,104.244.42.0-255,66,253960,64,300656
42738,0.041136,104.244.42.0-255,66,254026,64,300656
42739,0.041194,104.244.42.0-255,66,254092,64,300656
42740,0.042142,74.125.200.0-255,2902,256994,64,300656
42741,0.042148,172.31.40.0-255,66,257060,64,300656
42742,0.04218,74.125.200.0-255,2902,259962,64,300656
42743,0.042182,172.31.40.0-255,66,260028,64,300656
42744,0.044493,74.125.200.0-255,5738,265766,64,300656
42745,0.044502,172.31.40.0-255,66,265832,64,300656
42746,0.046838,74.125.200.0-255,5738,271570,64,300656
42747,0.046849,172.31.40.0-255,66,271636,64,300656
42748,0.04919,74.125.200.0-255,5738,277374,64,300656
42749,0.049197,172.31.40.0-255,66,277440,64,300656
42750,0.051531,74.125.200.0-255,5738,283178,64,300656
42751,0.051538,172.31.40.0-255,66,283244,64,300656
42752,0.053859,74.125.200.0-255,5738,288982,64,300656
42753,0.053865,172.31.40.0-255,66,289048,64,300656
42754,0.05621,74.125.200.0-255,5738,294786,64,300656
42755,0.056216,172.31.40.0-255,66,294852,64,300656
42756,0.058549,74.125.200.0-255,5738,300590,64,300656
42757,0.058558,172.31.40.0-255,66,300656,64,300656
42758,0.0,172.217.194.0-255,152,152,64,227892
42759,3e-05,172.31.40.0-255,66,218,64,227892
42760,3.7e-05,172.217.194.0-255,1484,1702,64,227892
42761,4.1e-05,172.31.40.0-255,66,1768,64,227892
42762,6.5e-05,172.217.194.0-255,2902,4670,64,227892
42763,6.9e-05,172.31.40.0-255,66,4736,64,227892
42764,7.7e-05,172.217.194.0-255,7156,11892,64,227892
42765,8e-05,172.31.40.0-255,66,11958,64,227892
42766,9e-05,172.31.40.0-255,66,12024,64,227892
42767,0.000139,172.31.40.0-255,66,12090,64,227892
42768,0.000241,172.217.194.0-255,1484,13574,64,227892
42769,0.000244,172.31.40.0-255,66,13640,64,227892
42770,0.000251,172.217.194.0-255,2902,16542,64,227892
42771,0.000253,172.31.40.0-255,66,16608,64,227892
42772,0.000257,172.217.194.0-255,2902,19510,64,227892
42773,0.000265,172.31.40.0-255,66,19576,64,227892
42774,0.00029,172.217.194.0-255,2902,22478,64,227892
42775,0.000293,172.31.40.0-255,66,22544,64,227892
42776,0.000304,172.31.40.0-255,66,22610,64,227892
42777,0.000334,172.217.194.0-255,5379,27989,64,227892
42778,0.000338,172.31.40.0-255,66,28055,64,227892
42779,0.00035,172.31.40.0-255,66,28121,64,227892
42780,0.000352,172.217.194.0-255,367,28488,64,227892
42781,0.000354,172.31.40.0-255,66,28554,64,227892
42782,0.000562,172.217.194.0-255,376,28930,64,227892
42783,0.000566,172.31.40.0-255,66,28996,64,227892
42784,0.000774,172.217.194.0-255,1484,30480,64,227892
42785,0.000779,172.31.40.0-255,66,30546,64,227892
42786,0.000784,172.217.194.0-255,2902,33448,64,227892
42787,0.00079,172.217.194.0-255,5738,39186,64,227892
42788,0.000793,172.31.40.0-255,66,39252,64,227892
42789,0.0008,172.31.40.0-255,66,39318,64,227892
42790,0.00085,172.31.40.0-255,66,39384,64,227892
42791,0.00087,172.31.40.0-255,66,39450,64,227892
42792,0.001836,172.217.194.0-255,1484,40934,64,227892
42793,0.001847,172.217.194.0-255,2902,43836,64,227892
42794,0.001852,172.31.40.0-255,66,43902,64,227892
42795,0.001859,172.217.194.0-255,5738,49640,64,227892
42796,0.001886,172.217.194.0-255,2902,52542,64,227892
42797,0.001904,172.217.194.0-255,7156,59698,64,227892
42798,0.001921,172.217.194.0-255,2902,62600,64,227892
42799,0.001939,172.217.194.0-255,2902,65502,64,227892
42800,0.00201,172.217.194.0-255,4320,69822,64,227892
42801,0.002016,172.217.194.0-255,4320,74142,64,227892
42802,0.002028,172.217.194.0-255,1484,75626,64,227892
42803,0.002053,172.217.194.0-255,1484,77110,64,227892
42804,0.007353,172.31.40.0-255,66,77176,64,227892
42805,0.009363,172.217.194.0-255,5738,82914,64,227892
42806,0.009374,172.31.40.0-255,66,82980,64,227892
42807,0.011362,172.217.194.0-255,5738,88718,64,227892
42808,0.012208,172.31.40.0-255,66,88784,64,227892
42809,0.014214,172.217.194.0-255,5738,94522,64,227892
42810,0.014221,172.31.40.0-255,66,94588,64,227892
42811,0.01621,172.217.194.0-255,5738,100326,64,227892
42812,0.016218,172.31.40.0-255,66,100392,64,227892
42813,0.018226,172.217.194.0-255,5738,106130,64,227892
42814,0.018232,172.31.40.0-255,66,106196,64,227892
42815,0.020239,172.217.194.0-255,5738,111934,64,227892
42816,0.020246,172.31.40.0-255,66,112000,64,227892
42817,0.02223,172.217.194.0-255,5738,117738,64,227892
42818,0.022237,172.31.40.0-255,66,117804,64,227892
42819,0.024258,172.217.194.0-255,5738,123542,64,227892
42820,0.024267,172.31.40.0-255,66,123608,64,227892
42821,0.026268,172.217.194.0-255,5738,129346,64,227892
42822,0.026275,172.31.40.0-255,66,129412,64,227892
42823,0.028257,172.217.194.0-255,5738,135150,64,227892
42824,0.028264,172.31.40.0-255,66,135216,64,227892
42825,0.028418,172.31.40.0-255,176,135392,64,227892
42826,0.028445,172.31.40.0-255,1112,136504,64,227892
42827,0.028549,172.31.40.0-255,1514,138018,64,227892
42828,0.028552,172.31.40.0-255,1296,139314,64,227892
42829,0.029944,104.244.42.0-255,66,139380,64,227892
42830,0.029995,104.244.42.0-255,66,139446,64,227892
42831,0.030093,104.244.42.0-255,66,139512,64,227892
42832,0.03025,172.217.194.0-255,5738,145250,64,227892
42833,0.030256,172.31.40.0-255,66,145316,64,227892
42834,0.032252,172.217.194.0-255,5738,151054,64,227892
42835,0.032258,172.31.40.0-255,66,151120,64,227892
42836,0.034237,172.217.194.0-255,5738,156858,64,227892
42837,0.034243,172.31.40.0-255,66,156924,64,227892
42838,0.036241,172.217.194.0-255,5738,162662,64,227892
42839,0.036246,172.31.40.0-255,66,162728,64,227892
42840,0.038258,172.217.194.0-255,5738,168466,64,227892
42841,0.038263,172.31.40.0-255,66,168532,64,227892
42842,0.040291,172.217.194.0-255,2902,171434,64,227892
42843,0.040296,172.31.40.0-255,66,171500,64,227892
42844,0.040325,172.217.194.0-255,2902,174402,64,227892
42845,0.04034,172.31.40.0-255,66,174468,64,227892
42846,0.042307,172.217.194.0-255,2902,177370,64,227892
42847,0.042313,172.31.40.0-255,66,177436,64,227892
42848,0.042345,172.217.194.0-255,2902,180338,64,227892
42849,0.042689,172.31.40.0-255,66,180404,64,227892
42850,0.044308,172.217.194.0-255,2902,183306,64,227892
42851,0.044314,172.31.40.0-255,66,183372,64,227892
42852,0.044661,172.217.194.0-255,2902,186274,64,227892
42853,0.044667,172.31.40.0-255,66,186340,64,227892
42854,0.046311,172.217.194.0-255,2902,189242,64,227892
42855,0.046317,172.31.40.0-255,66,189308,64,227892
42856,0.046666,172.217.194.0-255,2902,192210,64,227892
42857,0.046672,172.31.40.0-255,66,192276,64,227892
42858,0.048307,172.217.194.0-255,2902,195178,64,227892
42859,0.048312,172.31.40.0-255,66,195244,64,227892
42860,0.048658,172.217.194.0-255,2902,198146,64,227892
42861,0.048663,172.31.40.0-255,66,198212,64,227892
42862,0.050307,172.217.194.0-255,2902,201114,64,227892
42863,0.050312,172.31.40.0-255,66,201180,64,227892
42864,0.050671,172.217.194.0-255,2902,204082,64,227892
42865,0.050677,172.31.40.0-255,66,204148,64,227892
42866,0.052302,172.217.194.0-255,2902,207050,64,227892
42867,0.052307,172.31.40.0-255,66,207116,64,227892
42868,0.052668,172.217.194.0-255,2902,210018,64,227892
42869,0.052673,172.31.40.0-255,66,210084,64,227892
42870,0.054314,172.217.194.0-255,2902,212986,64,227892
42871,0.054319,172.31.40.0-255,66,213052,64,227892
42872,0.054685,172.217.194.0-255,2902,215954,64,227892
42873,0.054689,172.31.40.0-255,66,216020,64,227892
42874,0.056313,172.217.194.0-255,2902,218922,64,227892
42875,0.056319,172.31.40.0-255,66,218988,64,227892
42876,0.056684,172.217.194.0-255,2902,221890,64,227892
42877,0.056689,172.31.40.0-255,66,221956,64,227892
42878,0.058307,172.217.194.0-255,2902,224858,64,227892
42879,0.058313,172.31.40.0-255,66,224924,64,227892
42880,0.058675,172.217.194.0-255,2902,227826,64,227892
42881,0.05868,172.31.40.0-255,66,227892,64,227892
42882,0.0,172.217.194.0-255,146,146,64,326230
42883,1.5e-05,172.31.40.0-255,66,212,64,326230
42884,2.2e-05,172.217.194.0-255,1484,1696,64,326230
42885,2.6e-05,172.31.40.0-255,66,1762,64,326230
42886,3.2e-05,172.217.194.0-255,2902,4664,64,326230
42887,4.3e-05,172.31.40.0-255,66,4730,64,326230
42888,4.8e-05,172.217.194.0-255,4320,9050,64,326230
42889,5.1e-05,172.31.40.0-255,66,9116,64,326230
42890,9.7e-05,172.31.40.0-255,66,9182,64,326230
42891,0.000102,172.217.194.0-255,4320,13502,64,326230
42892,0.000104,172.31.40.0-255,66,13568,64,326230
42893,0.000138,172.217.194.0-255,5738,19306,64,326230
42894,0.000145,172.31.40.0-255,66,19372,64,326230
42895,0.00015,172.217.194.0-255,2543,21915,64,326230
42896,0.000152,172.31.40.0-255,66,21981,64,326230
42897,0.000194,172.217.194.0-255,1484,23465,64,326230
42898,0.000197,172.31.40.0-255,66,23531,64,326230
42899,0.000201,172.217.194.0-255,2902,26433,64,326230
42900,0.000203,172.31.40.0-255,66,26499,64,326230
42901,0.000206,172.217.194.0-255,1484,27983,64,326230
42902,0.000213,172.31.40.0-255,66,28049,64,326230
42903,0.000235,172.217.194.0-255,4320,32369,64,326230
42904,0.000237,172.31.40.0-255,66,32435,64,326230
42905,0.00025,172.217.194.0-255,6797,39232,64,326230
42906,0.000252,172.31.40.0-255,66,39298,64,326230
42907,0.00038,172.217.194.0-255,1484,40782,64,326230
42908,0.000386,172.31.40.0-255,66,40848,64,326230
42909,0.000416,172.217.194.0-255,2902,43750,64,326230
42910,0.000418,172.31.40.0-255,66,43816,64,326230
42911,0.000425,172.217.194.0-255,5738,49554,64,326230
42912,0.000428,172.31.40.0-255,66,49620,64,326230
42913,0.000451,172.217.194.0-255,7073,56693,64,326230
42914,0.000457,172.31.40.0-255,66,56759,64,326230
42915,0.000553,172.217.194.0-255,1484,58243,64,326230
42916,0.000558,172.217.194.0-255,1484,59727,64,326230
42917,0.000561,172.31.40.0-255,66,59793,64,326230
42918,0.000589,172.217.194.0-255,1484,61277,64,326230
42919,0.000596,172.217.194.0-255,5738,67015,64,326230
42920,0.000598,172.31.40.0-255,66,67081,64,326230
42921,0.000606,172.217.194.0-255,6552,73633,64,326230
42922,0.000608,172.31.40.0-255,66,73699,64,326230
42923,0.000663,172.217.194.0-255,1484,75183,64,326230
42924,0.000698,172.31.40.0-255,66,75249,64,326230
42925,0.000705,172.217.194.0-255,5379,80628,64,326230
42926,0.000708,172.31.40.0-255,66,80694,64,326230
42927,0.000892,172.217.194.0-255,1484,82178,64,326230
42928,0.000907,172.217.194.0-255,2902,85080,64,326230
42929,0.00091,172.31.40.0-255,66,85146,64,326230
42930,0.000944,172.217.194.0-255,5738,90884,64,326230
42931,0.000947,172.31.40.0-255,66,90950,64,326230
42932,0.000953,172.217.194.0-255,5738,96688,64,326230
42933,0.000956,172.31.40.0-255,66,96754,64,326230
42934,0.000986,172.217.194.0-255,1125,97879,64,326230
42935,0.001322,172.217.194.0-255,1484,99363,64,326230
42936,0.001326,172.31.40.0-255,66,99429,64,326230
42937,0.001332,172.217.194.0-255,2902,102331,64,326230
42938,0.001334,172.31.40.0-255,66,102397,64,326230
42939,0.001365,172.217.194.0-255,5738,108135,64,326230
42940,0.001367,172.31.40.0-255,66,108201,64,326230
42941,0.001373,172.217.194.0-255,4320,112521,64,326230
42942,0.001375,172.31.40.0-255,66,112587,64,326230
42943,0.001378,172.217.194.0-255,1484,114071,64,326230
42944,0.001421,172.31.40.0-255,66,114137,64,326230
42945,0.001431,172.31.40.0-255,66,114203,64,326230
42946,0.001735,172.217.194.0-255,1484,115687,64,326230
42947,0.001739,172.217.194.0-255,1484,117171,64,326230
42948,0.001742,172.31.40.0-255,66,117237,64,326230
42949,0.001754,172.217.194.0-255,1484,118721,64,326230
42950,0.001764,172.217.194.0-255,5738,124459,64,326230
42951,0.001767,172.31.40.0-255,66,124525,64,326230
42952,0.001795,172.217.194.0-255,1484,126009,64,326230
42953,0.00181,172.217.194.0-255,5738,131747,64,326230
42954,0.001812,172.31.40.0-255,66,131813,64,326230
42955,0.001844,172.217.194.0-255,5738,137551,64,326230
42956,0.001847,172.31.40.0-255,66,137617,64,326230
42957,0.001863,172.31.40.0-255,66,137683,64,326230
42958,0.001977,172.217.194.0-255,1484,139167,64,326230
42959,0.001981,172.217.194.0-255,2902,142069,64,326230
42960,0.00199,172.31.40.0-255,66,142135,64,326230
42961,0.001996,172.217.194.0-255,2902,145037,64,326230
42962,0.001998,172.31.40.0-255,66,145103,64,326230
42963,0.002024,172.217.194.0-255,2902,148005,64,326230
42964,0.002026,172.31.40.0-255,66,148071,64,326230
42965,0.002033,172.217.194.0-255,7156,155227,64,326230
42966,0.002035,172.31.40.0-255,66,155293,64,326230
42967,0.002066,172.217.194.0-255,5738,161031,64,326230
42968,0.002068,172.31.40.0-255,66,161097,64,326230
42969,0.002081,172.31.40.0-255,66,161163,64,326230
42970,0.002135,172.217.194.0-255,1484,162647,64,326230
42971,0.002149,172.217.194.0-255,2902,165549,64,326230
42972,0.002153,172.31.40.0-255,66,165615,64,326230
42973,0.002156,172.217.194.0-255,1484,167099,64,326230
42974,0.002176,172.217.194.0-255,4320,171419,64,326230
42975,0.002178,172.31.40.0-255,66,171485,64,326230
42976,0.0022,172.217.194.0-255,5738,177223,64,326230
42977,0.002203,172.31.40.0-255,66,177289,64,326230
42978,0.00223,172.217.194.0-255,2902,180191,64,326230
42979,0.002233,172.31.40.0-255,66,180257,64,326230
42980,0.002257,172.217.194.0-255,5738,185995,64,326230
42981,0.00226,172.31.40.0-255,66,186061,64,326230
42982,0.002297,172.31.40.0-255,66,186127,64,326230
42983,0.002458,172.217.194.0-255,1484,187611,64,326230
42984,0.002464,172.217.194.0-255,2902,190513,64,326230
42985,0.002468,172.31.40.0-255,66,190579,64,326230
42986,0.002473,172.217.194.0-255,2902,193481,64,326230
42987,0.002476,172.31.40.0-255,66,193547,64,326230
42988,0.002507,172.217.194.0-255,2902,196449,64,326230
42989,0.00251,172.31.40.0-255,66,196515,64,326230
42990,0.002525,172.31.40.0-255,66,196581,64,326230
42991,0.002595,172.31.40.0-255,66,196647,64,326230
42992,0.002606,172.217.194.0-255,766,197413,64,326230
42993,0.00514,172.217.194.0-255,4320,201733,64,326230
42994,0.00516,172.31.40.0-255,66,201799,64,326230
42995,0.007756,172.217.194.0-255,5738,207537,64,326230
42996,0.007771,172.31.40.0-255,66,207603,64,326230
42997,0.010324,172.217.194.0-255,5738,213341,64,326230
42998,0.010332,172.31.40.0-255,66,213407,64,326230
42999,0.012897,172.217.194.0-255,5738,219145,64,326230
43000,0.012907,172.31.40.0-255,66,219211,64,326230
43001,0.015554,172.217.194.0-255,5738,224949,64,326230
43002,0.015569,172.31.40.0-255,66,225015,64,326230
43003,0.018144,172.217.194.0-255,5738,230753,64,326230
43004,0.018153,172.31.40.0-255,66,230819,64,326230
43005,0.020739,172.217.194.0-255,5738,236557,64,326230
43006,0.020756,172.31.40.0-255,66,236623,64,326230
43007,0.023311,172.217.194.0-255,5738,242361,64,326230
43008,0.02332,172.31.40.0-255,66,242427,64,326230
43009,0.025908,172.217.194.0-255,5738,248165,64,326230
43010,0.025916,172.31.40.0-255,66,248231,64,326230
43011,0.028509,172.217.194.0-255,5738,253969,64,326230
43012,0.028518,172.31.40.0-255,66,254035,64,326230
43013,0.031107,172.217.194.0-255,5738,259773,64,326230
43014,0.031116,172.31.40.0-255,66,259839,64,326230
43015,0.033684,172.217.194.0-255,5738,265577,64,326230
43016,0.033704,172.31.40.0-255,66,265643,64,326230
43017,0.036248,172.217.194.0-255,5738,271381,64,326230
43018,0.036257,172.31.40.0-255,66,271447,64,326230
43019,0.038834,172.217.194.0-255,5738,277185,64,326230
43020,0.038843,172.31.40.0-255,66,277251,64,326230
43021,0.041447,172.217.194.0-255,5738,282989,64,326230
43022,0.041471,172.31.40.0-255,66,283055,64,326230
43023,0.044063,172.217.194.0-255,5738,288793,64,326230
43024,0.044081,172.31.40.0-255,66,288859,64,326230
43025,0.046677,172.217.194.0-255,5738,294597,64,326230
43026,0.046684,172.31.40.0-255,66,294663,64,326230
43027,0.048586,172.31.40.0-255,172,294835,64,326230
43028,0.048617,172.31.40.0-255,1108,295943,64,326230
43029,0.048678,172.31.40.0-255,1514,297457,64,326230
43030,0.04868,172.31.40.0-255,337,297794,64,326230
43031,0.049235,172.217.194.0-255,2902,300696,64,326230
43032,0.049242,172.31.40.0-255,66,300762,64,326230
43033,0.049272,172.217.194.0-255,2902,303664,64,326230
43034,0.049275,172.31.40.0-255,66,303730,64,326230
43035,0.049407,172.31.40.0-255,105,303835,64,326230
43036,0.049579,172.31.40.0-255,90,303925,64,326230
43037,0.049588,172.31.40.0-255,66,303991,64,326230
43038,0.0501,104.244.42.0-255,66,304057,64,326230
43039,0.050142,104.244.42.0-255,66,304123,64,326230
43040,0.050251,104.244.42.0-255,66,304189,64,326230
43041,0.051529,74.125.68.0-255,66,304255,64,326230
43042,0.051549,74.125.68.0-255,66,304321,64,326230
43043,0.051568,172.31.40.0-255,66,304387,64,326230
43044,0.051814,172.217.194.0-255,4320,308707,64,326230
43045,0.051821,172.31.40.0-255,66,308773,64,326230
43046,0.051854,172.217.194.0-255,1484,310257,64,326230
43047,0.054401,172.217.194.0-255,4320,314577,64,326230
43048,0.054416,172.31.40.0-255,66,314643,64,326230
43049,0.056982,172.217.194.0-255,5738,320381,64,326230
43050,0.05699,172.31.40.0-255,66,320447,64,326230
43051,0.05955,172.217.194.0-255,5612,326059,64,326230
43052,0.059558,172.31.40.0-255,66,326125,64,326230
43053,0.059776,172.31.40.0-255,105,326230,64,326230
43054,0.0,74.125.130.0-255,152,152,64,268879
43055,1.6e-05,172.31.40.0-255,66,218,64,268879
43056,2.2e-05,74.125.130.0-255,1484,1702,64,268879
43057,2.7e-05,172.31.40.0-255,66,1768,64,268879
43058,5.7e-05,74.125.130.0-255,2902,4670,64,268879
43059,6e-05,172.31.40.0-255,66,4736,64,268879
43060,7.1e-05,74.125.130.0-255,4320,9056,64,268879
43061,7.4e-05,172.31.40.0-255,66,9122,64,268879
43062,0.000108,74.125.130.0-255,4865,13987,64,268879
43063,0.000111,172.31.40.0-255,66,14053,64,268879
43064,0.000275,74.125.130.0-255,1484,15537,64,268879
43065,0.00028,172.31.40.0-255,66,15603,64,268879
43066,0.000298,74.125.130.0-255,1484,17087,64,268879
43067,0.000301,172.31.40.0-255,66,17153,64,268879
43068,0.000306,74.125.130.0-255,2902,20055,64,268879
43069,0.000308,172.31.40.0-255,66,20121,64,268879
43070,0.000343,74.125.130.0-255,5738,25859,64,268879
43071,0.000346,172.31.40.0-255,66,25925,64,268879
43072,0.000372,74.125.130.0-255,1484,27409,64,268879
43073,0.000374,172.31.40.0-255,66,27475,64,268879
43074,0.000379,74.125.130.0-255,2902,30377,64,268879
43075,0.000382,172.31.40.0-255,66,30443,64,268879
43076,0.000403,74.125.130.0-255,1125,31568,64,268879
43077,0.000409,172.31.40.0-255,66,31634,64,268879
43078,0.000434,74.125.130.0-255,1484,33118,64,268879
43079,0.000437,172.31.40.0-255,66,33184,64,268879
43080,0.000456,74.125.130.0-255,4320,37504,64,268879
43081,0.000459,172.31.40.0-255,66,37570,64,268879
43082,0.000488,74.125.130.0-255,5738,43308,64,268879
43083,0.00049,172.31.40.0-255,66,43374,64,268879
43084,0.000504,74.125.130.0-255,4320,47694,64,268879
43085,0.00051,172.31.40.0-255,66,47760,64,268879
43086,0.000535,74.125.130.0-255,1125,48885,64,268879
43087,0.000848,74.125.130.0-255,1484,50369,64,268879
43088,0.000852,172.31.40.0-255,66,50435,64,268879
43089,0.000857,74.125.130.0-255,1484,51919,64,268879
43090,0.000861,74.125.130.0-255,2902,54821,64,268879
43091,0.000863,172.31.40.0-255,66,54887,64,268879
43092,0.000894,74.125.130.0-255,5738,60625,64,268879
43093,0.000898,172.31.40.0-255,66,60691,64,268879
43094,0.000918,74.125.130.0-255,5379,66070,64,268879
43095,0.000921,172.31.40.0-255,66,66136,64,268879
43096,0.000946,74.125.130.0-255,645,66781,64,268879
43097,0.001067,74.125.130.0-255,1484,68265,64,268879
43098,0.001071,172.31.40.0-255,66,68331,64,268879
43099,0.001089,74.125.130.0-255,2902,71233,64,268879
43100,0.001094,172.31.40.0-255,66,71299,64,268879
43101,0.001109,74.125.130.0-255,5738,77037,64,268879
43102,0.001115,172.31.40.0-255,66,77103,64,268879
43103,0.001119,74.125.130.0-255,2902,80005,64,268879
43104,0.00112,172.31.40.0-255,66,80071,64,268879
43105,0.001126,74.125.130.0-255,3961,84032,64,268879
43106,0.001128,172.31.40.0-255,66,84098,64,268879
43107,0.001151,74.125.130.0-255,5738,89836,64,268879
43108,0.001158,172.31.40.0-255,66,89902,64,268879
43109,0.001183,74.125.130.0-255,2902,92804,64,268879
43110,0.001185,172.31.40.0-255,66,92870,64,268879
43111,0.00119,74.125.130.0-255,2902,95772,64,268879
43112,0.001193,172.31.40.0-255,66,95838,64,268879
43113,0.001228,74.125.130.0-255,2902,98740,64,268879
43114,0.001233,172.31.40.0-255,66,98806,64,268879
43115,0.001252,74.125.130.0-255,2543,101349,64,268879
43116,0.001255,172.31.40.0-255,66,101415,64,268879
43117,0.003296,74.125.130.0-255,2902,104317,64,268879
43118,0.003303,172.31.40.0-255,66,104383,64,268879
43119,0.003333,74.125.130.0-255,2902,107285,64,268879
43120,0.003336,172.31.40.0-255,66,107351,64,268879
43121,0.005367,74.125.130.0-255,2902,110253,64,268879
43122,0.005373,172.31.40.0-255,66,110319,64,268879
43123,0.0054,74.125.130.0-255,2902,113221,64,268879
43124,0.005403,172.31.40.0-255,66,113287,64,268879
43125,0.007443,74.125.130.0-255,2902,116189,64,268879
43126,0.007448,172.31.40.0-255,66,116255,64,268879
43127,0.007479,74.125.130.0-255,2902,119157,64,268879
43128,0.007482,172.31.40.0-255,66,119223,64,268879
43129,0.009522,74.125.130.0-255,2902,122125,64,268879
43130,0.009529,172.31.40.0-255,66,122191,64,268879
43131,0.009565,74.125.130.0-255,2902,125093,64,268879
43132,0.009567,172.31.40.0-255,66,125159,64,268879
43133,0.011607,74.125.130.0-255,5738,130897,64,268879
43134,0.011617,172.31.40.0-255,66,130963,64,268879
43135,0.013688,74.125.130.0-255,5738,136701,64,268879
43136,0.013696,172.31.40.0-255,66,136767,64,268879
43137,0.01577,74.125.130.0-255,5738,142505,64,268879
43138,0.01578,172.31.40.0-255,66,142571,64,268879
43139,0.01789,74.125.130.0-255,5738,148309,64,268879
43140,0.017898,172.31.40.0-255,66,148375,64,268879
43141,0.019977,74.125.130.0-255,5738,154113,64,268879
43142,0.019984,172.31.40.0-255,66,154179,64,268879
43143,0.02206,74.125.130.0-255,5738,159917,64,268879
43144,0.022067,172.31.40.0-255,66,159983,64,268879
43145,0.024148,74.125.130.0-255,5738,165721,64,268879
43146,0.024157,172.31.40.0-255,66,165787,64,268879
43147,0.026219,74.125.130.0-255,5738,171525,64,268879
43148,0.026226,172.31.40.0-255,66,171591,64,268879
43149,0.0283,74.125.130.0-255,5738,177329,64,268879
43150,0.028308,172.31.40.0-255,66,177395,64,268879
43151,0.028519,172.31.40.0-255,172,177567,64,268879
43152,0.028548,172.31.40.0-255,1112,178679,64,268879
43153,0.028606,172.31.40.0-255,1514,180193,64,268879
43154,0.028608,172.31.40.0-255,1296,181489,64,268879
43155,0.030082,104.244.42.0-255,66,181555,64,268879
43156,0.030122,104.244.42.0-255,66,181621,64,268879
43157,0.030155,104.244.42.0-255,66,181687,64,268879
43158,0.030365,74.125.130.0-255,2902,184589,64,268879
43159,0.030371,172.31.40.0-255,66,184655,64,268879
43160,0.030385,74.125.130.0-255,2902,187557,64,268879
43161,0.030391,172.31.40.0-255,66,187623,64,268879
43162,0.032459,74.125.130.0-255,5738,193361,64,268879
43163,0.032466,172.31.40.0-255,66,193427,64,268879
43164,0.034538,74.125.130.0-255,5738,199165,64,268879
43165,0.034545,172.31.40.0-255,66,199231,64,268879
43166,0.03662,74.125.130.0-255,5738,204969,64,268879
43167,0.036627,172.31.40.0-255,66,205035,64,268879
43168,0.038695,74.125.130.0-255,5738,210773,64,268879
43169,0.038704,172.31.40.0-255,66,210839,64,268879
43170,0.040783,74.125.130.0-255,5738,216577,64,268879
43171,0.04079,172.31.40.0-255,66,216643,64,268879
43172,0.042894,74.125.130.0-255,5738,222381,64,268879
43173,0.042901,172.31.40.0-255,66,222447,64,268879
43174,0.044962,74.125.130.0-255,5738,228185,64,268879
43175,0.044969,172.31.40.0-255,66,228251,64,268879
43176,0.047047,74.125.130.0-255,5738,233989,64,268879
43177,0.047054,172.31.40.0-255,66,234055,64,268879
43178,0.049122,74.125.130.0-255,5738,239793,64,268879
43179,0.049128,172.31.40.0-255,66,239859,64,268879
43180,0.05121,74.125.130.0-255,5738,245597,64,268879
43181,0.051215,172.31.40.0-255,66,245663,64,268879
43182,0.053311,74.125.130.0-255,5738,251401,64,268879
43183,0.053318,172.31.40.0-255,66,251467,64,268879
43184,0.055396,74.125.130.0-255,5738,257205,64,268879
43185,0.055403,172.31.40.0-255,66,257271,64,268879
43186,0.057494,74.125.130.0-255,5738,263009,64,268879
43187,0.0575,172.31.40.0-255,66,263075,64,268879
43188,0.059566,74.125.130.0-255,5738,268813,64,268879
43189,0.059571,172.31.40.0-255,66,268879,64,268879
43190,0.0,172.217.194.0-255,297,297,64,245460
43191,2.9e-05,172.31.40.0-255,66,363,64,245460
43192,3.6e-05,172.217.194.0-255,1484,1847,64,245460
43193,4e-05,172.31.40.0-255,66,1913,64,245460
43194,4.7e-05,172.217.194.0-255,4320,6233,64,245460
43195,4.9e-05,172.31.40.0-255,66,6299,64,245460
43196,6.1e-05,172.31.40.0-255,66,6365,64,245460
43197,0.000813,172.217.194.0-255,1484,7849,64,245460
43198,0.000819,172.31.40.0-255,66,7915,64,245460
43199,0.000828,172.217.194.0-255,2902,10817,64,245460
43200,0.00083,172.31.40.0-255,66,10883,64,245460
43201,0.000838,172.217.194.0-255,5738,16621,64,245460
43202,0.000841,172.31.40.0-255,66,16687,64,245460
43203,0.000882,172.31.40.0-255,66,16753,64,245460
43204,0.000893,172.31.40.0-255,66,16819,64,245460
43205,0.000932,172.217.194.0-255,2902,19721,64,245460
43206,0.000935,172.31.40.0-255,66,19787,64,245460
43207,0.000964,172.31.40.0-255,66,19853,64,245460
43208,0.000988,172.217.194.0-255,377,20230,64,245460
43209,0.000992,172.31.40.0-255,66,20296,64,245460
43210,0.001064,172.217.194.0-255,367,20663,64,245460
43211,0.001069,172.31.40.0-255,66,20729,64,245460
43212,0.001133,172.217.194.0-255,1484,22213,64,245460
43213,0.001136,172.31.40.0-255,66,22279,64,245460
43214,0.001142,172.217.194.0-255,2902,25181,64,245460
43215,0.001144,172.31.40.0-255,66,25247,64,245460
43216,0.001188,172.217.194.0-255,5738,30985,64,245460
43217,0.001191,172.31.40.0-255,66,31051,64,245460
43218,0.001205,172.31.40.0-255,66,31117,64,245460
43219,0.001218,172.31.40.0-255,66,31183,64,245460
43220,0.001305,172.217.194.0-255,1484,32667,64,245460
43221,0.001312,172.217.194.0-255,2902,35569,64,245460
43222,0.001315,172.31.40.0-255,66,35635,64,245460
43223,0.001321,172.217.194.0-255,4320,39955,64,245460
43224,0.001324,172.31.40.0-255,66,40021,64,245460
43225,0.001336,172.217.194.0-255,1484,41505,64,245460
43226,0.001353,172.217.194.0-255,5738,47243,64,245460
43227,0.001356,172.31.40.0-255,66,47309,64,245460
43228,0.001378,172.217.194.0-255,4320,51629,64,245460
43229,0.001381,172.31.40.0-255,66,51695,64,245460
43230,0.001394,172.31.40.0-255,66,51761,64,245460
43231,0.001398,172.217.194.0-255,2184,53945,64,245460
43232,0.0014,172.31.40.0-255,66,54011,64,245460
43233,0.001652,172.217.194.0-255,1484,55495,64,245460
43234,0.001659,172.217.194.0-255,2902,58397,64,245460
43235,0.001662,172.31.40.0-255,66,58463,64,245460
43236,0.001684,172.217.194.0-255,5738,64201,64,245460
43237,0.001686,172.31.40.0-255,66,64267,64,245460
43238,0.001717,172.31.40.0-255,66,64333,64,245460
43239,0.001738,172.217.194.0-255,1484,65817,64,245460
43240,0.001749,172.31.40.0-255,66,65883,64,245460
43241,0.001771,172.217.194.0-255,5020,70903,64,245460
43242,0.001774,172.31.40.0-255,66,70969,64,245460
43243,0.001897,172.217.194.0-255,1484,72453,64,245460
43244,0.001903,172.217.194.0-255,2902,75355,64,245460
43245,0.001906,172.31.40.0-255,66,75421,64,245460
43246,0.001913,172.217.194.0-255,4320,79741,64,245460
43247,0.001915,172.31.40.0-255,66,79807,64,245460
43248,0.001939,172.217.194.0-255,1484,81291,64,245460
43249,0.001944,172.217.194.0-255,4320,85611,64,245460
43250,0.001947,172.31.40.0-255,66,85677,64,245460
43251,0.001974,172.31.40.0-255,66,85743,64,245460
43252,0.001999,172.217.194.0-255,5738,91481,64,245460
43253,0.002002,172.31.40.0-255,66,91547,64,245460
43254,0.002025,172.217.194.0-255,5020,96567,64,245460
43255,0.002028,172.31.40.0-255,66,96633,64,245460
43256,0.00432,172.217.194.0-255,5738,102371,64,245460
43257,0.004327,172.31.40.0-255,66,102437,64,245460
43258,0.006614,172.217.194.0-255,5738,108175,64,245460
43259,0.006617,172.31.40.0-255,66,108241,64,245460
43260,0.008909,172.217.194.0-255,5738,113979,64,245460
43261,0.008915,172.31.40.0-255,66,114045,64,245460
43262,0.011251,172.217.194.0-255,5738,119783,64,245460
43263,0.011262,172.31.40.0-255,66,119849,64,245460
43264,0.013587,172.217.194.0-255,5738,125587,64,245460
43265,0.013597,172.31.40.0-255,66,125653,64,245460
43266,0.015907,172.217.194.0-255,5738,131391,64,245460
43267,0.015918,172.31.40.0-255,66,131457,64,245460
43268,0.018254,172.217.194.0-255,5738,137195,64,245460
43269,0.018265,172.31.40.0-255,66,137261,64,245460
43270,0.020549,172.217.194.0-255,5738,142999,64,245460
43271,0.020558,172.31.40.0-255,66,143065,64,245460
43272,0.022976,172.217.194.0-255,5738,148803,64,245460
43273,0.022983,172.31.40.0-255,66,148869,64,245460
43274,0.025322,172.217.194.0-255,5738,154607,64,245460
43275,0.02534,172.31.40.0-255,66,154673,64,245460
43276,0.027666,172.217.194.0-255,5738,160411,64,245460
43277,0.027677,172.31.40.0-255,66,160477,64,245460
43278,0.030012,172.217.194.0-255,5738,166215,64,245460
43279,0.030029,172.31.40.0-255,66,166281,64,245460
43280,0.032355,172.217.194.0-255,5738,172019,64,245460
43281,0.032369,172.31.40.0-255,66,172085,64,245460
43282,0.034691,172.217.194.0-255,5738,177823,64,245460
43283,0.034697,172.31.40.0-255,66,177889,64,245460
43284,0.037038,172.217.194.0-255,5738,183627,64,245460
43285,0.037049,172.31.40.0-255,66,183693,64,245460
43286,0.039374,172.217.194.0-255,5738,189431,64,245460
43287,0.039398,172.31.40.0-255,66,189497,64,245460
43288,0.041717,172.217.194.0-255,5738,195235,64,245460
43289,0.041726,172.31.40.0-255,66,195301,64,245460
43290,0.044064,172.217.194.0-255,5738,201039,64,245460
43291,0.044081,172.31.40.0-255,66,201105,64,245460
43292,0.046402,172.217.194.0-255,5738,206843,64,245460
43293,0.046411,172.31.40.0-255,66,206909,64,245460
43294,0.048753,172.217.194.0-255,5738,212647,64,245460
43295,0.048768,172.31.40.0-255,66,212713,64,245460
43296,0.051132,172.217.194.0-255,5738,218451,64,245460
43297,0.05114,172.31.40.0-255,66,218517,64,245460
43298,0.053465,172.217.194.0-255,5738,224255,64,245460
43299,0.053476,172.31.40.0-255,66,224321,64,245460
43300,0.055735,172.31.40.0-255,172,224493,64,245460
43301,0.055765,172.31.40.0-255,1112,225605,64,245460
43302,0.055788,172.217.194.0-255,2902,228507,64,245460
43303,0.055793,172.31.40.0-255,66,228573,64,245460
43304,0.055807,172.217.194.0-255,2902,231475,64,245460
43305,0.05581,172.31.40.0-255,66,231541,64,245460
43306,0.055919,172.31.40.0-255,1514,233055,64,245460
43307,0.055921,172.31.40.0-255,1514,234569,64,245460
43308,0.055926,172.31.40.0-255,1514,236083,64,245460
43309,0.055927,172.31.40.0-255,1514,237597,64,245460
43310,0.055946,172.31.40.0-255,1514,239111,64,245460
43311,0.055947,172.31.40.0-255,83,239194,64,245460
43312,0.057279,104.244.42.0-255,66,239260,64,245460
43313,0.057323,104.244.42.0-255,66,239326,64,245460
43314,0.057527,104.244.42.0-255,66,239392,64,245460
43315,0.057533,104.244.42.0-255,66,239458,64,245460
43316,0.057536,104.244.42.0-255,66,239524,64,245460
43317,0.058072,172.217.194.0-255,2902,242426,64,245460
43318,0.058079,172.31.40.0-255,66,242492,64,245460
43319,0.05811,172.217.194.0-255,2902,245394,64,245460
43320,0.058114,172.31.40.0-255,66,245460,64,245460
43321,0.0,172.217.194.0-255,146,146,64,301189
43322,2.7e-05,172.31.40.0-255,66,212,64,301189
43323,3.2e-05,172.217.194.0-255,1484,1696,64,301189
43324,3.7e-05,172.31.40.0-255,66,1762,64,301189
43325,4.1e-05,172.217.194.0-255,1484,3246,64,301189
43326,4.3e-05,172.31.40.0-255,66,3312,64,301189
43327,5.4e-05,172.217.194.0-255,2902,6214,64,301189
43328,5.7e-05,172.31.40.0-255,66,6280,64,301189
43329,6.3e-05,172.217.194.0-255,5738,12018,64,301189
43330,6.6e-05,172.31.40.0-255,66,12084,64,301189
43331,0.000109,172.31.40.0-255,66,12150,64,301189
43332,0.000115,172.217.194.0-255,5379,17529,64,301189
43333,0.000117,172.31.40.0-255,66,17595,64,301189
43334,0.000156,172.217.194.0-255,1484,19079,64,301189
43335,0.000159,172.31.40.0-255,66,19145,64,301189
43336,0.000165,172.217.194.0-255,2902,22047,64,301189
43337,0.000169,172.31.40.0-255,66,22113,64,301189
43338,0.000172,172.217.194.0-255,1484,23597,64,301189
43339,0.000173,172.31.40.0-255,66,23663,64,301189
43340,0.000211,172.217.194.0-255,4320,27983,64,301189
43341,0.000215,172.31.40.0-255,66,28049,64,301189
43342,0.000233,172.31.40.0-255,66,28115,64,301189
43343,0.000261,172.217.194.0-255,4320,32435,64,301189
43344,0.000265,172.31.40.0-255,66,32501,64,301189
43345,0.000306,172.31.40.0-255,66,32567,64,301189
43346,0.000309,172.217.194.0-255,123,32690,64,301189
43347,0.000311,172.31.40.0-255,66,32756,64,301189
43348,0.000364,172.217.194.0-255,1484,34240,64,301189
43349,0.000368,172.31.40.0-255,66,34306,64,301189
43350,0.000373,172.217.194.0-255,2902,37208,64,301189
43351,0.000375,172.31.40.0-255,66,37274,64,301189
43352,0.000379,172.217.194.0-255,1484,38758,64,301189
43353,0.000412,172.217.194.0-255,4320,43078,64,301189
43354,0.000416,172.31.40.0-255,66,43144,64,301189
43355,0.000423,172.217.194.0-255,5738,48882,64,301189
43356,0.000425,172.31.40.0-255,66,48948,64,301189
43357,0.000453,172.217.194.0-255,1434,50382,64,301189
43358,0.000581,172.217.194.0-255,1484,51866,64,301189
43359,0.000586,172.31.40.0-255,66,51932,64,301189
43360,0.00059,172.217.194.0-255,1484,53416,64,301189
43361,0.000613,172.217.194.0-255,1484,54900,64,301189
43362,0.000616,172.31.40.0-255,66,54966,64,301189
43363,0.000623,172.217.194.0-255,5738,60704,64,301189
43364,0.000626,172.31.40.0-255,66,60770,64,301189
43365,0.000661,172.217.194.0-255,4320,65090,64,301189
43366,0.000664,172.31.40.0-255,66,65156,64,301189
43367,0.000697,172.217.194.0-255,2902,68058,64,301189
43368,0.0007,172.31.40.0-255,66,68124,64,301189
43369,0.000719,172.31.40.0-255,66,68190,64,301189
43370,0.000723,172.217.194.0-255,1634,69824,64,301189
43371,0.000725,172.31.40.0-255,66,69890,64,301189
43372,0.00073,172.217.194.0-255,2902,72792,64,301189
43373,0.000732,172.31.40.0-255,66,72858,64,301189
43374,0.000737,172.217.194.0-255,4320,77178,64,301189
43375,0.000739,172.31.40.0-255,66,77244,64,301189
43376,0.000744,172.217.194.0-255,4320,81564,64,301189
43377,0.000749,172.31.40.0-255,66,81630,64,301189
43378,0.000768,172.217.194.0-255,4320,85950,64,301189
43379,0.000775,172.31.40.0-255,66,86016,64,301189
43380,0.000788,172.31.40.0-255,66,86082,64,301189
43381,0.000824,172.217.194.0-255,6438,92520,64,301189
43382,0.000828,172.31.40.0-255,66,92586,64,301189
43383,0.000832,172.217.194.0-255,4320,96906,64,301189
43384,0.000835,172.31.40.0-255,66,96972,64,301189
43385,0.000847,172.217.194.0-255,5738,102710,64,301189
43386,0.00085,172.31.40.0-255,66,102776,64,301189
43387,0.000885,172.217.194.0-255,6797,109573,64,301189
43388,0.000889,172.31.40.0-255,66,109639,64,301189
43389,0.000893,172.217.194.0-255,2902,112541,64,301189
43390,0.000896,172.31.40.0-255,66,112607,64,301189
43391,0.000917,172.217.194.0-255,4320,116927,64,301189
43392,0.00092,172.31.40.0-255,66,116993,64,301189
43393,0.000933,172.217.194.0-255,7156,124149,64,301189
43394,0.000936,172.31.40.0-255,66,124215,64,301189
43395,0.000964,172.217.194.0-255,2902,127117,64,301189
43396,0.000968,172.31.40.0-255,66,127183,64,301189
43397,0.000986,172.217.194.0-255,2902,130085,64,301189
43398,0.000989,172.31.40.0-255,66,130151,64,301189
43399,0.001029,172.31.40.0-255,66,130217,64,301189
43400,0.001194,172.217.194.0-255,1484,131701,64,301189
43401,0.001219,172.217.194.0-255,2902,134603,64,301189
43402,0.001223,172.31.40.0-255,66,134669,64,301189
43403,0.001226,172.217.194.0-255,1484,136153,64,301189
43404,0.001258,172.217.194.0-255,4320,140473,64,301189
43405,0.001261,172.31.40.0-255,66,140539,64,301189
43406,0.001265,172.217.194.0-255,2902,143441,64,301189
43407,0.001267,172.31.40.0-255,66,143507,64,301189
43408,0.00131,172.31.40.0-255,66,143573,64,301189
43409,0.001324,172.217.194.0-255,4320,147893,64,301189
43410,0.001331,172.31.40.0-255,66,147959,64,301189
43411,0.001353,172.217.194.0-255,6438,154397,64,301189
43412,0.001356,172.31.40.0-255,66,154463,64,301189
43413,0.002005,172.217.194.0-255,1484,155947,64,301189
43414,0.002011,172.217.194.0-255,2902,158849,64,301189
43415,0.002016,172.217.194.0-255,5738,164587,64,301189
43416,0.002016,172.31.40.0-255,66,164653,64,301189
43417,0.00202,172.31.40.0-255,66,164719,64,301189
43418,0.002041,172.31.40.0-255,66,164785,64,301189
43419,0.002054,172.31.40.0-255,66,164851,64,301189
43420,0.002059,172.217.194.0-255,2902,167753,64,301189
43421,0.002061,172.31.40.0-255,66,167819,64,301189
43422,0.002107,172.31.40.0-255,66,167885,64,301189
43423,0.00413,172.217.194.0-255,5738,173623,64,301189
43424,0.00414,172.31.40.0-255,66,173689,64,301189
43425,0.006161,172.217.194.0-255,5738,179427,64,301189
43426,0.006165,172.31.40.0-255,66,179493,64,301189
43427,0.008193,172.217.194.0-255,5738,185231,64,301189
43428,0.0082,172.31.40.0-255,66,185297,64,301189
43429,0.010215,172.217.194.0-255,5738,191035,64,301189
43430,0.010222,172.31.40.0-255,66,191101,64,301189
43431,0.012243,172.217.194.0-255,5738,196839,64,301189
43432,0.012251,172.31.40.0-255,66,196905,64,301189
43433,0.014274,172.217.194.0-255,5738,202643,64,301189
43434,0.014281,172.31.40.0-255,66,202709,64,301189
43435,0.016288,172.217.194.0-255,5738,208447,64,301189
43436,0.016294,172.31.40.0-255,66,208513,64,301189
43437,0.018304,172.217.194.0-255,5738,214251,64,301189
43438,0.018312,172.31.40.0-255,66,214317,64,301189
43439,0.02031,172.217.194.0-255,5738,220055,64,301189
43440,0.020317,172.31.40.0-255,66,220121,64,301189
43441,0.022345,172.217.194.0-255,5738,225859,64,301189
43442,0.022357,172.31.40.0-255,66,225925,64,301189
43443,0.024367,172.217.194.0-255,5738,231663,64,301189
43444,0.024373,172.31.40.0-255,66,231729,64,301189
43445,0.025312,172.31.40.0-255,167,231896,64,301189
43446,0.025342,172.31.40.0-255,1107,233003,64,301189
43447,0.02538,172.31.40.0-255,1514,234517,64,301189
43448,0.025381,172.31.40.0-255,338,234855,64,301189
43449,0.026371,172.217.194.0-255,5738,240593,64,301189
43450,0.026376,172.31.40.0-255,66,240659,64,301189
43451,0.026869,104.244.42.0-255,66,240725,64,301189
43452,0.026914,104.244.42.0-255,66,240791,64,301189
43453,0.026956,104.244.42.0-255,66,240857,64,301189
43454,0.028384,172.217.194.0-255,5738,246595,64,301189
43455,0.028388,172.31.40.0-255,66,246661,64,301189
43456,0.030407,172.217.194.0-255,5738,252399,64,301189
43457,0.030412,172.31.40.0-255,66,252465,64,301189
43458,0.032449,172.217.194.0-255,5738,258203,64,301189
43459,0.032454,172.31.40.0-255,66,258269,64,301189
43460,0.034456,172.217.194.0-255,5738,264007,64,301189
43461,0.034462,172.31.40.0-255,66,264073,64,301189
43462,0.036514,172.217.194.0-255,5738,269811,64,301189
43463,0.03652,172.31.40.0-255,66,269877,64,301189
43464,0.038544,172.217.194.0-255,4320,274197,64,301189
43465,0.038549,172.31.40.0-255,66,274263,64,301189
43466,0.038582,172.217.194.0-255,1484,275747,64,301189
43467,0.040553,172.217.194.0-255,4320,280067,64,301189
43468,0.040558,172.31.40.0-255,66,280133,64,301189
43469,0.04258,172.217.194.0-255,5738,285871,64,301189
43470,0.042586,172.31.40.0-255,66,285937,64,301189
43471,0.044614,172.217.194.0-255,5738,291675,64,301189
43472,0.044619,172.31.40.0-255,66,291741,64,301189
43473,0.046631,172.217.194.0-255,4320,296061,64,301189
43474,0.046637,172.31.40.0-255,66,296127,64,301189
43475,0.046672,172.217.194.0-255,1484,297611,64,301189
43476,0.048669,172.217.194.0-255,3341,300952,64,301189
43477,0.048675,172.31.40.0-255,66,301018,64,301189
43478,0.049451,172.31.40.0-255,105,301123,64,301189
43479,0.051468,172.217.194.0-255,66,301189,64,301189
43480,0.0,74.125.68.0-255,153,153,64,348570
43481,2.1e-05,172.31.40.0-255,66,219,64,348570
43482,2.8e-05,74.125.68.0-255,1484,1703,64,348570
43483,3.2e-05,172.31.40.0-255,66,1769,64,348570
43484,3.9e-05,74.125.68.0-255,2902,4671,64,348570
43485,5e-05,172.31.40.0-255,66,4737,64,348570
43486,5.7e-05,74.125.68.0-255,5738,10475,64,348570
43487,6e-05,172.31.40.0-255,66,10541,64,348570
43488,6.5e-05,74.125.68.0-255,3420,13961,64,348570
43489,6.8e-05,172.31.40.0-255,66,14027,64,348570
43490,7.3e-05,74.125.68.0-255,2902,16929,64,348570
43491,7.6e-05,172.31.40.0-255,66,16995,64,348570
43492,9.4e-05,74.125.68.0-255,1484,18479,64,348570
43493,9.6e-05,172.31.40.0-255,66,18545,64,348570
43494,9.9e-05,74.125.68.0-255,1484,20029,64,348570
43495,0.000102,172.31.40.0-255,66,20095,64,348570
43496,0.000138,172.31.40.0-255,66,20161,64,348570
43497,0.000142,74.125.68.0-255,2543,22704,64,348570
43498,0.000144,172.31.40.0-255,66,22770,64,348570
43499,0.000211,74.125.68.0-255,1484,24254,64,348570
43500,0.000215,172.31.40.0-255,66,24320,64,348570
43501,0.000225,74.125.68.0-255,2902,27222,64,348570
43502,0.000228,172.31.40.0-255,66,27288,64,348570
43503,0.000237,74.125.68.0-255,4320,31608,64,348570
43504,0.000252,172.31.40.0-255,66,31674,64,348570
43505,0.000277,74.125.68.0-255,1484,33158,64,348570
43506,0.00028,172.31.40.0-255,66,33224,64,348570
43507,0.000291,172.31.40.0-255,66,33290,64,348570
43508,0.000297,74.125.68.0-255,5738,39028,64,348570
43509,0.0003,172.31.40.0-255,66,39094,64,348570
43510,0.000325,74.125.68.0-255,2902,41996,64,348570
43511,0.000327,172.31.40.0-255,66,42062,64,348570
43512,0.000334,74.125.68.0-255,6797,48859,64,348570
43513,0.000337,172.31.40.0-255,66,48925,64,348570
43514,0.000375,74.125.68.0-255,647,49572,64,348570
43515,0.000502,74.125.68.0-255,1484,51056,64,348570
43516,0.000506,172.31.40.0-255,66,51122,64,348570
43517,0.000531,74.125.68.0-255,2902,54024,64,348570
43518,0.000533,172.31.40.0-255,66,54090,64,348570
43519,0.000538,74.125.68.0-255,4320,58410,64,348570
43520,0.00054,172.31.40.0-255,66,58476,64,348570
43521,0.000572,74.125.68.0-255,2902,61378,64,348570
43522,0.000575,172.31.40.0-255,66,61444,64,348570
43523,0.000595,74.125.68.0-255,5379,66823,64,348570
43524,0.000597,172.31.40.0-255,66,66889,64,348570
43525,0.000638,74.125.68.0-255,1484,68373,64,348570
43526,0.000652,74.125.68.0-255,2902,71275,64,348570
43527,0.000655,172.31.40.0-255,66,71341,64,348570
43528,0.000701,74.125.68.0-255,5738,77079,64,348570
43529,0.000704,172.31.40.0-255,66,77145,64,348570
43530,0.00071,74.125.68.0-255,6247,83392,64,348570
43531,0.000712,172.31.40.0-255,66,83458,64,348570
43532,0.000896,74.125.68.0-255,1484,84942,64,348570
43533,0.000914,74.125.68.0-255,2902,87844,64,348570
43534,0.000917,172.31.40.0-255,66,87910,64,348570
43535,0.000923,74.125.68.0-255,4320,92230,64,348570
43536,0.000925,172.31.40.0-255,66,92296,64,348570
43537,0.000953,74.125.68.0-255,1484,93780,64,348570
43538,0.000959,74.125.68.0-255,7156,100936,64,348570
43539,0.000964,172.31.40.0-255,66,101002,64,348570
43540,0.000999,172.31.40.0-255,66,101068,64,348570
43541,0.001029,74.125.68.0-255,4320,105388,64,348570
43542,0.001033,172.31.40.0-255,66,105454,64,348570
43543,0.001058,74.125.68.0-255,2184,107638,64,348570
43544,0.001061,172.31.40.0-255,66,107704,64,348570
43545,0.001161,74.125.68.0-255,1484,109188,64,348570
43546,0.001165,74.125.68.0-255,1484,110672,64,348570
43547,0.001168,172.31.40.0-255,66,110738,64,348570
43548,0.001194,74.125.68.0-255,1484,112222,64,348570
43549,0.0012,74.125.68.0-255,4320,116542,64,348570
43550,0.001202,172.31.40.0-255,66,116608,64,348570
43551,0.001205,74.125.68.0-255,1484,118092,64,348570
43552,0.001231,74.125.68.0-255,7156,125248,64,348570
43553,0.001235,172.31.40.0-255,66,125314,64,348570
43554,0.001242,74.125.68.0-255,7156,132470,64,348570
43555,0.001245,172.31.40.0-255,66,132536,64,348570
43556,0.001269,74.125.68.0-255,1484,134020,64,348570
43557,0.001289,74.125.68.0-255,2902,136922,64,348570
43558,0.001292,172.31.40.0-255,66,136988,64,348570
43559,0.001312,74.125.68.0-255,5020,142008,64,348570
43560,0.001315,172.31.40.0-255,66,142074,64,348570
43561,0.001428,74.125.68.0-255,1484,143558,64,348570
43562,0.001435,74.125.68.0-255,2902,146460,64,348570
43563,0.001437,172.31.40.0-255,66,146526,64,348570
43564,0.001441,74.125.68.0-255,1484,148010,64,348570
43565,0.001469,74.125.68.0-255,4320,152330,64,348570
43566,0.001472,172.31.40.0-255,66,152396,64,348570
43567,0.001477,74.125.68.0-255,2902,155298,64,348570
43568,0.00148,172.31.40.0-255,66,155364,64,348570
43569,0.001541,172.31.40.0-255,66,155430,64,348570
43570,0.001547,74.125.68.0-255,5738,161168,64,348570
43571,0.00155,172.31.40.0-255,66,161234,64,348570
43572,0.001556,74.125.68.0-255,5020,166254,64,348570
43573,0.001566,172.31.40.0-255,66,166320,64,348570
43574,0.001668,74.125.68.0-255,1484,167804,64,348570
43575,0.001677,74.125.68.0-255,2902,170706,64,348570
43576,0.00168,172.31.40.0-255,66,170772,64,348570
43577,0.00171,74.125.68.0-255,5738,176510,64,348570
43578,0.001713,172.31.40.0-255,66,176576,64,348570
43579,0.001721,74.125.68.0-255,7156,183732,64,348570
43580,0.001723,172.31.40.0-255,66,183798,64,348570
43581,0.00178,172.31.40.0-255,66,183864,64,348570
43582,0.001799,74.125.68.0-255,2184,186048,64,348570
43583,0.001801,172.31.40.0-255,66,186114,64,348570
43584,0.00182,74.125.68.0-255,2902,189016,64,348570
43585,0.001823,172.31.40.0-255,66,189082,64,348570
43586,0.001851,74.125.68.0-255,7156,196238,64,348570
43587,0.001854,172.31.40.0-255,66,196304,64,348570
43588,0.001858,74.125.68.0-255,2902,199206,64,348570
43589,0.001861,172.31.40.0-255,66,199272,64,348570
43590,0.001906,172.31.40.0-255,66,199338,64,348570
43591,0.001917,172.31.40.0-255,66,199404,64,348570
43592,0.001945,74.125.68.0-255,766,200170,64,348570
43593,0.003986,74.125.68.0-255,4320,204490,64,348570
43594,0.003995,172.31.40.0-255,66,204556,64,348570
43595,0.006069,74.125.68.0-255,5738,210294,64,348570
43596,0.006081,172.31.40.0-255,66,210360,64,348570
43597,0.008153,74.125.68.0-255,5738,216098,64,348570
43598,0.008158,172.31.40.0-255,66,216164,64,348570
43599,0.010221,74.125.68.0-255,5738,221902,64,348570
43600,0.010228,172.31.40.0-255,66,221968,64,348570
43601,0.012294,74.125.68.0-255,5738,227706,64,348570
43602,0.012301,172.31.40.0-255,66,227772,64,348570
43603,0.01437,74.125.68.0-255,5738,233510,64,348570
43604,0.014378,172.31.40.0-255,66,233576,64,348570
43605,0.016464,74.125.68.0-255,5738,239314,64,348570
43606,0.016473,172.31.40.0-255,66,239380,64,348570
43607,0.018549,74.125.68.0-255,5738,245118,64,348570
43608,0.018558,172.31.40.0-255,66,245184,64,348570
43609,0.020642,74.125.68.0-255,5738,250922,64,348570
43610,0.020651,172.31.40.0-255,66,250988,64,348570
43611,0.022715,74.125.68.0-255,5738,256726,64,348570
43612,0.022721,172.31.40.0-255,66,256792,64,348570
43613,0.024789,74.125.68.0-255,5738,262530,64,348570
43614,0.024796,172.31.40.0-255,66,262596,64,348570
43615,0.026869,74.125.68.0-255,5738,268334,64,348570
43616,0.026877,172.31.40.0-255,66,268400,64,348570
43617,0.028953,74.125.68.0-255,5738,274138,64,348570
43618,0.02896,172.31.40.0-255,66,274204,64,348570
43619,0.031032,74.125.68.0-255,5738,279942,64,348570
43620,0.031038,172.31.40.0-255,66,280008,64,348570
43621,0.031929,172.31.40.0-255,172,280180,64,348570
43622,0.031956,172.31.40.0-255,1111,281291,64,348570
43623,0.032006,172.31.40.0-255,1514,282805,64,348570
43624,0.032026,172.31.40.0-255,1297,284102,64,348570
43625,0.033122,74.125.68.0-255,5738,289840,64,348570
43626,0.033128,172.31.40.0-255,66,289906,64,348570
43627,0.033466,104.244.42.0-255,66,289972,64,348570
43628,0.033509,104.244.42.0-255,66,290038,64,348570
43629,0.03356,104.244.42.0-255,66,290104,64,348570
43630,0.035205,74.125.68.0-255,5738,295842,64,348570
43631,0.035212,172.31.40.0-255,66,295908,64,348570
43632,0.037269,74.125.68.0-255,1484,297392,64,348570
43633,0.03729,74.125.68.0-255,4320,301712,64,348570
43634,0.037294,172.31.40.0-255,66,301778,64,348570
43635,0.039367,74.125.68.0-255,5738,307516,64,348570
43636,0.039374,172.31.40.0-255,66,307582,64,348570
43637,0.041444,74.125.68.0-255,5738,313320,64,348570
43638,0.04145,172.31.40.0-255,66,313386,64,348570
43639,0.041509,172.31.40.0-255,101,313487,64,348570
43640,0.04352,74.125.68.0-255,5738,319225,64,348570
43641,0.043526,172.31.40.0-255,66,319291,64,348570
43642,0.043543,74.125.68.0-255,66,319357,64,348570
43643,0.045596,74.125.68.0-255,5738,325095,64,348570
43644,0.045602,172.31.40.0-255,66,325161,64,348570
43645,0.047683,74.125.68.0-255,5738,330899,64,348570
43646,0.047689,172.31.40.0-255,66,330965,64,348570
43647,0.049759,74.125.68.0-255,5738,336703,64,348570
43648,0.049766,172.31.40.0-255,66,336769,64,348570
43649,0.051831,74.125.68.0-255,5738,342507,64,348570
43650,0.051837,172.31.40.0-255,66,342573,64,348570
43651,0.053899,74.125.68.0-255,5738,348311,64,348570
43652,0.053905,172.31.40.0-255,66,348377,64,348570
43653,0.055945,74.125.68.0-255,88,348465,64,348570
43654,0.056011,172.31.40.0-255,105,348570,64,348570
43655,0.0,172.217.27.0-255,147,147,64,288165
43656,2.3e-05,172.31.40.0-255,66,213,64,288165
43657,3.1e-05,172.217.27.0-255,1484,1697,64,288165
43658,3.5e-05,172.31.40.0-255,66,1763,64,288165
43659,4e-05,172.217.27.0-255,2902,4665,64,288165
43660,5.3e-05,172.31.40.0-255,66,4731,64,288165
43661,6.1e-05,172.217.27.0-255,5738,10469,64,288165
43662,6.4e-05,172.31.40.0-255,66,10535,64,288165
43663,7.8e-05,172.31.40.0-255,66,10601,64,288165
43664,0.000102,172.217.27.0-255,2151,12752,64,288165
43665,0.000106,172.31.40.0-255,66,12818,64,288165
43666,0.000118,172.217.27.0-255,5738,18556,64,288165
43667,0.00012,172.31.40.0-255,66,18622,64,288165
43668,0.000141,172.217.27.0-255,1125,19747,64,288165
43669,0.000143,172.31.40.0-255,66,19813,64,288165
43670,0.000165,172.217.27.0-255,4320,24133,64,288165
43671,0.000168,172.31.40.0-255,66,24199,64,288165
43672,0.00018,172.217.27.0-255,2902,27101,64,288165
43673,0.000182,172.31.40.0-255,66,27167,64,288165
43674,0.000197,172.31.40.0-255,66,27233,64,288165
43675,0.0002,172.217.27.0-255,1125,28358,64,288165
43676,0.000202,172.31.40.0-255,66,28424,64,288165
43677,0.000486,172.217.27.0-255,1484,29908,64,288165
43678,0.000491,172.217.27.0-255,2902,32810,64,288165
43679,0.000497,172.31.40.0-255,66,32876,64,288165
43680,0.000501,172.31.40.0-255,66,32942,64,288165
43681,0.000533,172.217.27.0-255,5738,38680,64,288165
43682,0.000536,172.31.40.0-255,66,38746,64,288165
43683,0.000548,172.217.27.0-255,6797,45543,64,288165
43684,0.000551,172.31.40.0-255,66,45609,64,288165
43685,0.000553,172.217.27.0-255,360,45969,64,288165
43686,0.000804,172.217.27.0-255,1484,47453,64,288165
43687,0.000808,172.31.40.0-255,66,47519,64,288165
43688,0.000814,172.217.27.0-255,2902,50421,64,288165
43689,0.000816,172.31.40.0-255,66,50487,64,288165
43690,0.000821,172.217.27.0-255,4320,54807,64,288165
43691,0.000827,172.31.40.0-255,66,54873,64,288165
43692,0.000878,172.31.40.0-255,66,54939,64,288165
43693,0.001219,172.217.27.0-255,1484,56423,64,288165
43694,0.001225,172.217.27.0-255,2902,59325,64,288165
43695,0.001229,172.31.40.0-255,66,59391,64,288165
43696,0.001232,172.217.27.0-255,1484,60875,64,288165
43697,0.001257,172.217.27.0-255,1484,62359,64,288165
43698,0.001259,172.31.40.0-255,66,62425,64,288165
43699,0.001265,172.217.27.0-255,4320,66745,64,288165
43700,0.001267,172.31.40.0-255,66,66811,64,288165
43701,0.001282,172.31.40.0-255,66,66877,64,288165
43702,0.001323,172.31.40.0-255,66,66943,64,288165
43703,0.001517,172.217.27.0-255,1484,68427,64,288165
43704,0.001521,172.217.27.0-255,1484,69911,64,288165
43705,0.001524,172.31.40.0-255,66,69977,64,288165
43706,0.001552,172.217.27.0-255,1484,71461,64,288165
43707,0.001559,172.217.27.0-255,5738,77199,64,288165
43708,0.001561,172.31.40.0-255,66,77265,64,288165
43709,0.001566,172.217.27.0-255,4320,81585,64,288165
43710,0.001568,172.31.40.0-255,66,81651,64,288165
43711,0.001579,172.217.27.0-255,5738,87389,64,288165
43712,0.001581,172.31.40.0-255,66,87455,64,288165
43713,0.001593,172.31.40.0-255,66,87521,64,288165
43714,0.001596,172.217.27.0-255,1138,88659,64,288165
43715,0.001936,172.31.40.0-255,66,88725,64,288165
43716,0.003258,172.217.27.0-255,4320,93045,64,288165
43717,0.003263,172.31.40.0-255,66,93111,64,288165
43718,0.003596,172.217.27.0-255,1484,94595,64,288165
43719,0.004919,172.217.27.0-255,1484,96079,64,288165
43720,0.004922,172.31.40.0-255,66,96145,64,288165
43721,0.004938,172.217.27.0-255,2902,99047,64,288165
43722,0.00494,172.31.40.0-255,66,99113,64,288165
43723,0.006586,172.217.27.0-255,5738,104851,64,288165
43724,0.006592,172.31.40.0-255,66,104917,64,288165
43725,0.008249,172.217.27.0-255,5738,110655,64,288165
43726,0.008257,172.31.40.0-255,66,110721,64,288165
43727,0.009916,172.217.27.0-255,5738,116459,64,288165
43728,0.009923,172.31.40.0-255,66,116525,64,288165
43729,0.011577,172.217.27.0-255,5738,122263,64,288165
43730,0.011584,172.31.40.0-255,66,122329,64,288165
43731,0.013271,172.217.27.0-255,5738,128067,64,288165
43732,0.013279,172.31.40.0-255,66,128133,64,288165
43733,0.014931,172.217.27.0-255,5738,133871,64,288165
43734,0.014939,172.31.40.0-255,66,133937,64,288165
43735,0.0166,172.217.27.0-255,5738,139675,64,288165
43736,0.016608,172.31.40.0-255,66,139741,64,288165
43737,0.018301,172.217.27.0-255,5738,145479,64,288165
43738,0.018308,172.31.40.0-255,66,145545,64,288165
43739,0.019962,172.217.27.0-255,5738,151283,64,288165
43740,0.019969,172.31.40.0-255,66,151349,64,288165
43741,0.021635,172.217.27.0-255,5738,157087,64,288165
43742,0.021645,172.31.40.0-255,66,157153,64,288165
43743,0.023298,172.217.27.0-255,5738,162891,64,288165
43744,0.023304,172.31.40.0-255,66,162957,64,288165
43745,0.024316,172.31.40.0-255,167,163124,64,288165
43746,0.024352,172.31.40.0-255,1107,164231,64,288165
43747,0.024409,172.31.40.0-255,1514,165745,64,288165
43748,0.02441,172.31.40.0-255,338,166083,64,288165
43749,0.024998,172.217.27.0-255,5738,171821,64,288165
43750,0.025005,172.31.40.0-255,66,171887,64,288165
43751,0.025866,104.244.42.0-255,66,171953,64,288165
43752,0.025874,104.244.42.0-255,66,172019,64,288165
43753,0.02598,104.244.42.0-255,66,172085,64,288165
43754,0.026657,172.217.27.0-255,5738,177823,64,288165
43755,0.026662,172.31.40.0-255,66,177889,64,288165
43756,0.02833,172.217.27.0-255,5738,183627,64,288165
43757,0.028336,172.31.40.0-255,66,183693,64,288165
43758,0.03001,172.217.27.0-255,5738,189431,64,288165
43759,0.030016,172.31.40.0-255,66,189497,64,288165
43760,0.031691,172.217.27.0-255,5738,195235,64,288165
43761,0.031698,172.31.40.0-255,66,195301,64,288165
43762,0.033363,172.217.27.0-255,5738,201039,64,288165
43763,0.033374,172.31.40.0-255,66,201105,64,288165
43764,0.035053,172.217.27.0-255,5738,206843,64,288165
43765,0.035062,172.31.40.0-255,66,206909,64,288165
43766,0.036726,172.217.27.0-255,5738,212647,64,288165
43767,0.036733,172.31.40.0-255,66,212713,64,288165
43768,0.038392,172.217.27.0-255,5738,218451,64,288165
43769,0.038399,172.31.40.0-255,66,218517,64,288165
43770,0.040063,172.217.27.0-255,5738,224255,64,288165
43771,0.04007,172.31.40.0-255,66,224321,64,288165
43772,0.041733,172.217.27.0-255,5738,230059,64,288165
43773,0.041742,172.31.40.0-255,66,230125,64,288165
43774,0.043412,172.217.27.0-255,5738,235863,64,288165
43775,0.043418,172.31.40.0-255,66,235929,64,288165
43776,0.045093,172.217.27.0-255,5738,241667,64,288165
43777,0.045099,172.31.40.0-255,66,241733,64,288165
43778,0.046863,172.217.27.0-255,5738,247471,64,288165
43779,0.046869,172.31.40.0-255,66,247537,64,288165
43780,0.048533,172.217.27.0-255,5738,253275,64,288165
43781,0.04854,172.31.40.0-255,66,253341,64,288165
43782,0.050208,172.217.27.0-255,5738,259079,64,288165
43783,0.050214,172.31.40.0-255,66,259145,64,288165
43784,0.05188,172.217.27.0-255,5738,264883,64,288165
43785,0.051887,172.31.40.0-255,66,264949,64,288165
43786,0.053551,172.217.27.0-255,5738,270687,64,288165
43787,0.053558,172.31.40.0-255,66,270753,64,288165
43788,0.055249,172.217.27.0-255,5738,276491,64,288165
43789,0.055256,172.31.40.0-255,66,276557,64,288165
43790,0.056952,172.217.27.0-255,5738,282295,64,288165
43791,0.056959,172.31.40.0-255,66,282361,64,288165
43792,0.058621,172.217.27.0-255,5738,288099,64,288165
43793,0.058627,172.31.40.0-255,66,288165,64,288165
43794,0.0,74.125.130.0-255,150,150,64,324082
43795,1.5e-05,172.31.40.0-255,66,216,64,324082
43796,2.2e-05,74.125.130.0-255,1484,1700,64,324082
43797,2.7e-05,172.31.40.0-255,66,1766,64,324082
43798,3e-05,74.125.130.0-255,1484,3250,64,324082
43799,3.4e-05,172.31.40.0-255,66,3316,64,324082
43800,4.7e-05,74.125.130.0-255,2902,6218,64,324082
43801,5.1e-05,172.31.40.0-255,66,6284,64,324082
43802,5.8e-05,74.125.130.0-255,5738,12022,64,324082
43803,6e-05,172.31.40.0-255,66,12088,64,324082
43804,0.000111,74.125.130.0-255,2041,14129,64,324082
43805,0.000118,172.31.40.0-255,66,14195,64,324082
43806,0.000185,74.125.130.0-255,1484,15679,64,324082
43807,0.000189,172.31.40.0-255,66,15745,64,324082
43808,0.000207,74.125.130.0-255,2902,18647,64,324082
43809,0.00021,172.31.40.0-255,66,18713,64,324082
43810,0.000236,74.125.130.0-255,2902,21615,64,324082
43811,0.000238,172.31.40.0-255,66,21681,64,324082
43812,0.000262,74.125.130.0-255,1484,23165,64,324082
43813,0.000264,172.31.40.0-255,66,23231,64,324082
43814,0.000271,74.125.130.0-255,5738,28969,64,324082
43815,0.000273,172.31.40.0-255,66,29035,64,324082
43816,0.000304,74.125.130.0-255,2543,31578,64,324082
43817,0.000306,172.31.40.0-255,66,31644,64,324082
43818,0.000333,74.125.130.0-255,1484,33128,64,324082
43819,0.000336,172.31.40.0-255,66,33194,64,324082
43820,0.000339,74.125.130.0-255,1484,34678,64,324082
43821,0.000341,172.31.40.0-255,66,34744,64,324082
43822,0.000361,74.125.130.0-255,1484,36228,64,324082
43823,0.000364,172.31.40.0-255,66,36294,64,324082
43824,0.000371,74.125.130.0-255,5738,42032,64,324082
43825,0.000373,172.31.40.0-255,66,42098,64,324082
43826,0.000376,74.125.130.0-255,1484,43582,64,324082
43827,0.000406,74.125.130.0-255,2902,46484,64,324082
43828,0.000409,172.31.40.0-255,66,46550,64,324082
43829,0.000435,74.125.130.0-255,2543,49093,64,324082
43830,0.000438,172.31.40.0-255,66,49159,64,324082
43831,0.000587,74.125.130.0-255,1484,50643,64,324082
43832,0.000593,74.125.130.0-255,1484,52127,64,324082
43833,0.000596,172.31.40.0-255,66,52193,64,324082
43834,0.0006,74.125.130.0-255,1484,53677,64,324082
43835,0.000617,74.125.130.0-255,1484,55161,64,324082
43836,0.000619,172.31.40.0-255,66,55227,64,324082
43837,0.00065,74.125.130.0-255,5738,60965,64,324082
43838,0.000652,172.31.40.0-255,66,61031,64,324082
43839,0.000688,74.125.130.0-255,5379,66410,64,324082
43840,0.000691,172.31.40.0-255,66,66476,64,324082
43841,0.000837,74.125.130.0-255,648,67124,64,324082
43842,0.000881,74.125.130.0-255,1484,68608,64,324082
43843,0.000884,172.31.40.0-255,66,68674,64,324082
43844,0.000913,74.125.130.0-255,2902,71576,64,324082
43845,0.000916,172.31.40.0-255,66,71642,64,324082
43846,0.000935,74.125.130.0-255,5738,77380,64,324082
43847,0.000938,172.31.40.0-255,66,77446,64,324082
43848,0.000967,74.125.130.0-255,7156,84602,64,324082
43849,0.00097,172.31.40.0-255,66,84668,64,324082
43850,0.001001,172.31.40.0-255,66,84734,64,324082
43851,0.001024,74.125.130.0-255,1484,86218,64,324082
43852,0.001036,74.125.130.0-255,1484,87702,64,324082
43853,0.001039,172.31.40.0-255,66,87768,64,324082
43854,0.001068,74.125.130.0-255,3602,91370,64,324082
43855,0.00107,172.31.40.0-255,66,91436,64,324082
43856,0.001111,74.125.130.0-255,1484,92920,64,324082
43857,0.001127,74.125.130.0-255,2902,95822,64,324082
43858,0.001129,172.31.40.0-255,66,95888,64,324082
43859,0.001133,74.125.130.0-255,1484,97372,64,324082
43860,0.001138,74.125.130.0-255,2902,100274,64,324082
43861,0.00114,172.31.40.0-255,66,100340,64,324082
43862,0.001167,74.125.130.0-255,5738,106078,64,324082
43863,0.00117,172.31.40.0-255,66,106144,64,324082
43864,0.001198,74.125.130.0-255,7156,113300,64,324082
43865,0.001201,172.31.40.0-255,66,113366,64,324082
43866,0.001236,172.31.40.0-255,66,113432,64,324082
43867,0.001242,74.125.130.0-255,3602,117034,64,324082
43868,0.001244,172.31.40.0-255,66,117100,64,324082
43869,0.00144,74.125.130.0-255,1484,118584,64,324082
43870,0.001445,74.125.130.0-255,1484,120068,64,324082
43871,0.001448,172.31.40.0-255,66,120134,64,324082
43872,0.001478,74.125.130.0-255,1484,121618,64,324082
43873,0.001485,74.125.130.0-255,5738,127356,64,324082
43874,0.001487,172.31.40.0-255,66,127422,64,324082
43875,0.001492,74.125.130.0-255,2902,130324,64,324082
43876,0.001493,172.31.40.0-255,66,130390,64,324082
43877,0.001498,74.125.130.0-255,2902,133292,64,324082
43878,0.0015,172.31.40.0-255,66,133358,64,324082
43879,0.001525,74.125.130.0-255,1484,134842,64,324082
43880,0.001541,172.31.40.0-255,66,134908,64,324082
43881,0.001546,74.125.130.0-255,2902,137810,64,324082
43882,0.001548,172.31.40.0-255,66,137876,64,324082
43883,0.001577,74.125.130.0-255,4320,142196,64,324082
43884,0.00158,172.31.40.0-255,66,142262,64,324082
43885,0.001583,74.125.130.0-255,766,143028,64,324082
43886,0.00176,74.125.130.0-255,1484,144512,64,324082
43887,0.001764,172.31.40.0-255,66,144578,64,324082
43888,0.001784,74.125.130.0-255,2902,147480,64,324082
43889,0.001787,172.31.40.0-255,66,147546,64,324082
43890,0.001811,74.125.130.0-255,2902,150448,64,324082
43891,0.001813,172.31.40.0-255,66,150514,64,324082
43892,0.001838,74.125.130.0-255,4320,154834,64,324082
43893,0.00184,172.31.40.0-255,66,154900,64,324082
43894,0.001882,74.125.130.0-255,5738,160638,64,324082
43895,0.001886,172.31.40.0-255,66,160704,64,324082
43896,0.001914,74.125.130.0-255,2902,163606,64,324082
43897,0.001916,172.31.40.0-255,66,163672,64,324082
43898,0.001946,74.125.130.0-255,4320,167992,64,324082
43899,0.001949,172.31.40.0-255,66,168058,64,324082
43900,0.001954,74.125.130.0-255,2902,170960,64,324082
43901,0.001956,172.31.40.0-255,66,171026,64,324082
43902,0.001961,74.125.130.0-255,4320,175346,64,324082
43903,0.001968,172.31.40.0-255,66,175412,64,324082
43904,0.002022,74.125.130.0-255,2184,177596,64,324082
43905,0.002026,172.31.40.0-255,66,177662,64,324082
43906,0.004194,74.125.130.0-255,2902,180564,64,324082
43907,0.004201,172.31.40.0-255,66,180630,64,324082
43908,0.004247,74.125.130.0-255,2902,183532,64,324082
43909,0.004249,172.31.40.0-255,66,183598,64,324082
43910,0.006436,74.125.130.0-255,2902,186500,64,324082
43911,0.006443,172.31.40.0-255,66,186566,64,324082
43912,0.00647,74.125.130.0-255,2902,189468,64,324082
43913,0.006472,172.31.40.0-255,66,189534,64,324082
43914,0.008672,74.125.130.0-255,2902,192436,64,324082
43915,0.008679,172.31.40.0-255,66,192502,64,324082
43916,0.008708,74.125.130.0-255,2902,195404,64,324082
43917,0.008711,172.31.40.0-255,66,195470,64,324082
43918,0.010908,74.125.130.0-255,2902,198372,64,324082
43919,0.010914,172.31.40.0-255,66,198438,64,324082
43920,0.010944,74.125.130.0-255,2902,201340,64,324082
43921,0.010946,172.31.40.0-255,66,201406,64,324082
43922,0.013143,74.125.130.0-255,2902,204308,64,324082
43923,0.01315,172.31.40.0-255,66,204374,64,324082
43924,0.013176,74.125.130.0-255,2902,207276,64,324082
43925,0.01318,172.31.40.0-255,66,207342,64,324082
43926,0.015386,74.125.130.0-255,2902,210244,64,324082
43927,0.015392,172.31.40.0-255,66,210310,64,324082
43928,0.015419,74.125.130.0-255,2902,213212,64,324082
43929,0.015421,172.31.40.0-255,66,213278,64,324082
43930,0.017629,74.125.130.0-255,2902,216180,64,324082
43931,0.017636,172.31.40.0-255,66,216246,64,324082
43932,0.017667,74.125.130.0-255,2902,219148,64,324082
43933,0.017669,172.31.40.0-255,66,219214,64,324082
43934,0.019868,74.125.130.0-255,2902,222116,64,324082
43935,0.01988,172.31.40.0-255,66,222182,64,324082
43936,0.019918,74.125.130.0-255,2902,225084,64,324082
43937,0.019922,172.31.40.0-255,66,225150,64,324082
43938,0.022131,74.125.130.0-255,2902,228052,64,324082
43939,0.022147,172.31.40.0-255,66,228118,64,324082
43940,0.022187,74.125.130.0-255,2902,231020,64,324082
43941,0.022189,172.31.40.0-255,66,231086,64,324082
43942,0.024392,74.125.130.0-255,2902,233988,64,324082
43943,0.024408,172.31.40.0-255,66,234054,64,324082
43944,0.024439,74.125.130.0-255,2902,236956,64,324082
43945,0.024441,172.31.40.0-255,66,237022,64,324082
43946,0.02666,74.125.130.0-255,5738,242760,64,324082
43947,0.026676,172.31.40.0-255,66,242826,64,324082
43948,0.028927,74.125.130.0-255,5738,248564,64,324082
43949,0.02894,172.31.40.0-255,66,248630,64,324082
43950,0.031187,74.125.130.0-255,5738,254368,64,324082
43951,0.031195,172.31.40.0-255,66,254434,64,324082
43952,0.033436,74.125.130.0-255,5738,260172,64,324082
43953,0.033449,172.31.40.0-255,66,260238,64,324082
43954,0.035699,74.125.130.0-255,5738,265976,64,324082
43955,0.035707,172.31.40.0-255,66,266042,64,324082
43956,0.037964,74.125.130.0-255,5738,271780,64,324082
43957,0.037982,172.31.40.0-255,66,271846,64,324082
43958,0.040222,74.125.130.0-255,5738,277584,64,324082
43959,0.040231,172.31.40.0-255,66,277650,64,324082
43960,0.042484,74.125.130.0-255,5738,283388,64,324082
43961,0.042498,172.31.40.0-255,66,283454,64,324082
43962,0.044745,74.125.130.0-255,5738,289192,64,324082
43963,0.044762,172.31.40.0-255,66,289258,64,324082
43964,0.047021,74.125.130.0-255,5738,294996,64,324082
43965,0.047029,172.31.40.0-255,66,295062,64,324082
43966,0.049288,74.125.130.0-255,5738,300800,64,324082
43967,0.049305,172.31.40.0-255,66,300866,64,324082
43968,0.051547,74.125.130.0-255,5738,306604,64,324082
43969,0.051554,172.31.40.0-255,66,306670,64,324082
43970,0.053803,74.125.130.0-255,5738,312408,64,324082
43971,0.05381,172.31.40.0-255,66,312474,64,324082
43972,0.056047,74.125.130.0-255,5738,318212,64,324082
43973,0.056057,172.31.40.0-255,66,318278,64,324082
43974,0.058321,74.125.130.0-255,5738,324016,64,324082
43975,0.058338,172.31.40.0-255,66,324082,64,324082
43976,0.0,74.125.68.0-255,290,290,64,260867
43977,2.3e-05,172.31.40.0-255,66,356,64,260867
43978,2.9e-05,74.125.68.0-255,1484,1840,64,260867
43979,3.3e-05,172.31.40.0-255,66,1906,64,260867
43980,3.9e-05,74.125.68.0-255,2902,4808,64,260867
43981,4.2e-05,172.31.40.0-255,66,4874,64,260867
43982,4.6e-05,74.125.68.0-255,1484,6358,64,260867
43983,4.8e-05,172.31.40.0-255,66,6424,64,260867
43984,7.4e-05,74.125.68.0-255,4320,10744,64,260867
43985,7.7e-05,172.31.40.0-255,66,10810,64,260867
43986,8e-05,74.125.68.0-255,1484,12294,64,260867
43987,8.2e-05,172.31.40.0-255,66,12360,64,260867
43988,0.000118,74.125.68.0-255,4320,16680,64,260867
43989,0.000121,172.31.40.0-255,66,16746,64,260867
43990,0.00014,74.125.68.0-255,3269,20015,64,260867
43991,0.000143,172.31.40.0-255,66,20081,64,260867
43992,0.000175,172.31.40.0-255,66,20147,64,260867
43993,0.00018,74.125.68.0-255,2543,22690,64,260867
43994,0.000182,172.31.40.0-255,66,22756,64,260867
43995,0.000313,74.125.68.0-255,1484,24240,64,260867
43996,0.000318,172.31.40.0-255,66,24306,64,260867
43997,0.000323,74.125.68.0-255,2902,27208,64,260867
43998,0.000326,172.31.40.0-255,66,27274,64,260867
43999,0.00036,74.125.68.0-255,5738,33012,64,260867
44000,0.000362,172.31.40.0-255,66,33078,64,260867
44001,0.000394,74.125.68.0-255,1484,34562,64,260867
44002,0.000396,172.31.40.0-255,66,34628,64,260867
44003,0.00042,74.125.68.0-255,6797,41425,64,260867
44004,0.000423,172.31.40.0-255,66,41491,64,260867
44005,0.000433,172.31.40.0-255,66,41557,64,260867
44006,0.00044,74.125.68.0-255,6797,48354,64,260867
44007,0.000443,172.31.40.0-255,66,48420,64,260867
44008,0.001208,74.125.68.0-255,648,49068,64,260867
44009,0.001215,172.31.40.0-255,66,49134,64,260867
44010,0.001436,74.125.68.0-255,1484,50618,64,260867
44011,0.001442,172.31.40.0-255,66,50684,64,260867
44012,0.001452,74.125.68.0-255,2902,53586,64,260867
44013,0.001454,172.31.40.0-255,66,53652,64,260867
44014,0.001457,74.125.68.0-255,1484,55136,64,260867
44015,0.001459,172.31.40.0-255,66,55202,64,260867
44016,0.001486,74.125.68.0-255,4320,59522,64,260867
44017,0.001489,172.31.40.0-255,66,59588,64,260867
44018,0.001492,74.125.68.0-255,1484,61072,64,260867
44019,0.001493,172.31.40.0-255,66,61138,64,260867
44020,0.001517,74.125.68.0-255,1484,62622,64,260867
44021,0.001519,172.31.40.0-255,66,62688,64,260867
44022,0.00154,74.125.68.0-255,3410,66098,64,260867
44023,0.001542,172.31.40.0-255,66,66164,64,260867
44024,0.001985,74.125.68.0-255,1484,67648,64,260867
44025,0.001991,172.31.40.0-255,66,67714,64,260867
44026,0.002001,74.125.68.0-255,2902,70616,64,260867
44027,0.002003,172.31.40.0-255,66,70682,64,260867
44028,0.002006,74.125.68.0-255,1484,72166,64,260867
44029,0.002008,172.31.40.0-255,66,72232,64,260867
44030,0.002037,74.125.68.0-255,4320,76552,64,260867
44031,0.002039,172.31.40.0-255,66,76618,64,260867
44032,0.002043,74.125.68.0-255,2902,79520,64,260867
44033,0.002045,172.31.40.0-255,66,79586,64,260867
44034,0.002051,74.125.68.0-255,3961,83547,64,260867
44035,0.002053,172.31.40.0-255,66,83613,64,260867
44036,0.002082,74.125.68.0-255,5738,89351,64,260867
44037,0.002085,172.31.40.0-255,66,89417,64,260867
44038,0.002103,74.125.68.0-255,2902,92319,64,260867
44039,0.002106,172.31.40.0-255,66,92385,64,260867
44040,0.002112,74.125.68.0-255,4320,96705,64,260867
44041,0.002114,172.31.40.0-255,66,96771,64,260867
44042,0.002134,74.125.68.0-255,5738,102509,64,260867
44043,0.002136,172.31.40.0-255,66,102575,64,260867
44044,0.002143,74.125.68.0-255,5738,108313,64,260867
44045,0.002145,172.31.40.0-255,66,108379,64,260867
44046,0.002153,74.125.68.0-255,7156,115535,64,260867
44047,0.002155,172.31.40.0-255,66,115601,64,260867
44048,0.002181,74.125.68.0-255,2184,117785,64,260867
44049,0.002183,172.31.40.0-255,66,117851,64,260867
44050,0.004465,74.125.68.0-255,2902,120753,64,260867
44051,0.004472,172.31.40.0-255,66,120819,64,260867
44052,0.004493,74.125.68.0-255,2902,123721,64,260867
44053,0.004496,172.31.40.0-255,66,123787,64,260867
44054,0.006773,74.125.68.0-255,2902,126689,64,260867
44055,0.006779,172.31.40.0-255,66,126755,64,260867
44056,0.006803,74.125.68.0-255,2902,129657,64,260867
44057,0.006806,172.31.40.0-255,66,129723,64,260867
44058,0.009089,74.125.68.0-255,2902,132625,64,260867
44059,0.009095,172.31.40.0-255,66,132691,64,260867
44060,0.009117,74.125.68.0-255,2902,135593,64,260867
44061,0.00912,172.31.40.0-255,66,135659,64,260867
44062,0.011409,74.125.68.0-255,4320,139979,64,260867
44063,0.011418,172.31.40.0-255,66,140045,64,260867
44064,0.011437,74.125.68.0-255,1484,141529,64,260867
44065,0.01144,172.31.40.0-255,66,141595,64,260867
44066,0.01374,74.125.68.0-255,5738,147333,64,260867
44067,0.013748,172.31.40.0-255,66,147399,64,260867
44068,0.016064,74.125.68.0-255,5738,153137,64,260867
44069,0.016072,172.31.40.0-255,66,153203,64,260867
44070,0.0184,74.125.68.0-255,5738,158941,64,260867
44071,0.01841,172.31.40.0-255,66,159007,64,260867
44072,0.020726,74.125.68.0-255,5738,164745,64,260867
44073,0.020733,172.31.40.0-255,66,164811,64,260867
44074,0.023051,74.125.68.0-255,5738,170549,64,260867
44075,0.023059,172.31.40.0-255,66,170615,64,260867
44076,0.02471,172.31.40.0-255,167,170782,64,260867
44077,0.024742,172.31.40.0-255,1108,171890,64,260867
44078,0.0248,172.31.40.0-255,1514,173404,64,260867
44079,0.024802,172.31.40.0-255,337,173741,64,260867
44080,0.025406,74.125.68.0-255,5738,179479,64,260867
44081,0.025413,172.31.40.0-255,66,179545,64,260867
44082,0.027289,104.244.42.0-255,66,179611,64,260867
44083,0.027716,74.125.68.0-255,5738,185349,64,260867
44084,0.027721,172.31.40.0-255,66,185415,64,260867
44085,0.030043,74.125.68.0-255,5738,191153,64,260867
44086,0.03005,172.31.40.0-255,66,191219,64,260867
44087,0.032356,74.125.68.0-255,5738,196957,64,260867
44088,0.032375,172.31.40.0-255,66,197023,64,260867
44089,0.034688,74.125.68.0-255,5738,202761,64,260867
44090,0.034694,172.31.40.0-255,66,202827,64,260867
44091,0.037011,74.125.68.0-255,5738,208565,64,260867
44092,0.037018,172.31.40.0-255,66,208631,64,260867
44093,0.039473,74.125.68.0-255,5738,214369,64,260867
44094,0.03948,172.31.40.0-255,66,214435,64,260867
44095,0.041846,74.125.68.0-255,5738,220173,64,260867
44096,0.041852,172.31.40.0-255,66,220239,64,260867
44097,0.044176,74.125.68.0-255,5738,225977,64,260867
44098,0.044182,172.31.40.0-255,66,226043,64,260867
44099,0.046532,74.125.68.0-255,5738,231781,64,260867
44100,0.046539,172.31.40.0-255,66,231847,64,260867
44101,0.048858,74.125.68.0-255,5738,237585,64,260867
44102,0.048866,172.31.40.0-255,66,237651,64,260867
44103,0.051208,74.125.68.0-255,5738,243389,64,260867
44104,0.051225,172.31.40.0-255,66,243455,64,260867
44105,0.053559,74.125.68.0-255,5738,249193,64,260867
44106,0.053573,172.31.40.0-255,66,249259,64,260867
44107,0.055894,74.125.68.0-255,5738,254997,64,260867
44108,0.055903,172.31.40.0-255,66,255063,64,260867
44109,0.058241,74.125.68.0-255,5738,260801,64,260867
44110,0.058258,172.31.40.0-255,66,260867,64,260867
44111,0.0,74.125.24.0-255,146,146,64,223787
44112,1.8e-05,172.31.40.0-255,66,212,64,223787
44113,2.5e-05,74.125.24.0-255,1484,1696,64,223787
44114,3e-05,172.31.40.0-255,66,1762,64,223787
44115,3.6e-05,74.125.24.0-255,2902,4664,64,223787
44116,4e-05,172.31.40.0-255,66,4730,64,223787
44117,4.5e-05,74.125.24.0-255,2902,7632,64,223787
44118,4.8e-05,172.31.40.0-255,66,7698,64,223787
44119,8e-05,74.125.24.0-255,2902,10600,64,223787
44120,8.3e-05,172.31.40.0-255,66,10666,64,223787
44121,0.000103,74.125.24.0-255,3401,14067,64,223787
44122,0.000105,172.31.40.0-255,66,14133,64,223787
44123,0.000149,74.125.24.0-255,1484,15617,64,223787
44124,0.000153,172.31.40.0-255,66,15683,64,223787
44125,0.000157,74.125.24.0-255,2902,18585,64,223787
44126,0.00016,172.31.40.0-255,66,18651,64,223787
44127,0.000163,74.125.24.0-255,2902,21553,64,223787
44128,0.000165,172.31.40.0-255,66,21619,64,223787
44129,0.000192,74.125.24.0-255,2902,24521,64,223787
44130,0.000195,172.31.40.0-255,66,24587,64,223787
44131,0.0002,74.125.24.0-255,4320,28907,64,223787
44132,0.000202,172.31.40.0-255,66,28973,64,223787
44133,0.000217,74.125.24.0-255,2902,31875,64,223787
44134,0.000219,172.31.40.0-255,66,31941,64,223787
44135,0.000252,172.31.40.0-255,66,32007,64,223787
44136,0.000259,74.125.24.0-255,7156,39163,64,223787
44137,0.000262,172.31.40.0-255,66,39229,64,223787
44138,0.000285,74.125.24.0-255,2902,42131,64,223787
44139,0.000287,172.31.40.0-255,66,42197,64,223787
44140,0.000321,172.31.40.0-255,66,42263,64,223787
44141,0.000324,74.125.24.0-255,398,42661,64,223787
44142,0.000326,172.31.40.0-255,66,42727,64,223787
44143,0.000377,74.125.24.0-255,108,42835,64,223787
44144,0.00038,172.31.40.0-255,66,42901,64,223787
44145,0.000396,74.125.24.0-255,334,43235,64,223787
44146,0.000399,172.31.40.0-255,66,43301,64,223787
44147,0.000884,74.125.24.0-255,1484,44785,64,223787
44148,0.000889,172.31.40.0-255,66,44851,64,223787
44149,0.000895,74.125.24.0-255,2902,47753,64,223787
44150,0.000897,172.31.40.0-255,66,47819,64,223787
44151,0.000903,74.125.24.0-255,5738,53557,64,223787
44152,0.000905,172.31.40.0-255,66,53623,64,223787
44153,0.000941,172.31.40.0-255,66,53689,64,223787
44154,0.000946,74.125.24.0-255,4320,58009,64,223787
44155,0.000948,172.31.40.0-255,66,58075,64,223787
44156,0.000967,74.125.24.0-255,6438,64513,64,223787
44157,0.00097,172.31.40.0-255,66,64579,64,223787
44158,0.002049,74.125.24.0-255,1484,66063,64,223787
44159,0.002056,172.31.40.0-255,66,66129,64,223787
44160,0.002064,74.125.24.0-255,1484,67613,64,223787
44161,0.002067,172.31.40.0-255,66,67679,64,223787
44162,0.00209,74.125.24.0-255,1484,69163,64,223787
44163,0.002093,172.31.40.0-255,66,69229,64,223787
44164,0.0021,74.125.24.0-255,5738,74967,64,223787
44165,0.002102,172.31.40.0-255,66,75033,64,223787
44166,0.002113,172.31.40.0-255,66,75099,64,223787
44167,0.002135,74.125.24.0-255,4320,79419,64,223787
44168,0.002137,172.31.40.0-255,66,79485,64,223787
44169,0.002156,74.125.24.0-255,2902,82387,64,223787
44170,0.002158,172.31.40.0-255,66,82453,64,223787
44171,0.002186,172.31.40.0-255,66,82519,64,223787
44172,0.004474,74.125.24.0-255,5738,88257,64,223787
44173,0.004477,172.31.40.0-255,66,88323,64,223787
44174,0.006783,74.125.24.0-255,5738,94061,64,223787
44175,0.00679,172.31.40.0-255,66,94127,64,223787
44176,0.009093,74.125.24.0-255,5738,99865,64,223787
44177,0.009101,172.31.40.0-255,66,99931,64,223787
44178,0.011394,74.125.24.0-255,5738,105669,64,223787
44179,0.011404,172.31.40.0-255,66,105735,64,223787
44180,0.013703,74.125.24.0-255,5738,111473,64,223787
44181,0.013712,172.31.40.0-255,66,111539,64,223787
44182,0.016043,74.125.24.0-255,5738,117277,64,223787
44183,0.016055,172.31.40.0-255,66,117343,64,223787
44184,0.01836,74.125.24.0-255,5738,123081,64,223787
44185,0.018368,172.31.40.0-255,66,123147,64,223787
44186,0.020675,74.125.24.0-255,5738,128885,64,223787
44187,0.020682,172.31.40.0-255,66,128951,64,223787
44188,0.023001,74.125.24.0-255,5738,134689,64,223787
44189,0.023009,172.31.40.0-255,66,134755,64,223787
44190,0.024049,172.31.40.0-255,167,134922,64,223787
44191,0.02408,172.31.40.0-255,1108,136030,64,223787
44192,0.024141,172.31.40.0-255,1514,137544,64,223787
44193,0.024143,172.31.40.0-255,337,137881,64,223787
44194,0.025305,74.125.24.0-255,5738,143619,64,223787
44195,0.025313,172.31.40.0-255,66,143685,64,223787
44196,0.025564,104.244.42.0-255,66,143751,64,223787
44197,0.025613,104.244.42.0-255,66,143817,64,223787
44198,0.025715,104.244.42.0-255,66,143883,64,223787
44199,0.027615,74.125.24.0-255,5738,149621,64,223787
44200,0.02762,172.31.40.0-255,66,149687,64,223787
44201,0.029934,74.125.24.0-255,4320,154007,64,223787
44202,0.029941,172.31.40.0-255,66,154073,64,223787
44203,0.029961,74.125.24.0-255,1484,155557,64,223787
44204,0.032249,74.125.24.0-255,4320,159877,64,223787
44205,0.032255,172.31.40.0-255,66,159943,64,223787
44206,0.034564,74.125.24.0-255,5738,165681,64,223787
44207,0.034615,172.31.40.0-255,66,165747,64,223787
44208,0.036928,74.125.24.0-255,5738,171485,64,223787
44209,0.036935,172.31.40.0-255,66,171551,64,223787
44210,0.039249,74.125.24.0-255,5738,177289,64,223787
44211,0.039256,172.31.40.0-255,66,177355,64,223787
44212,0.041564,74.125.24.0-255,5738,183093,64,223787
44213,0.041571,172.31.40.0-255,66,183159,64,223787
44214,0.043868,74.125.24.0-255,5738,188897,64,223787
44215,0.043874,172.31.40.0-255,66,188963,64,223787
44216,0.046164,74.125.24.0-255,5738,194701,64,223787
44217,0.046171,172.31.40.0-255,66,194767,64,223787
44218,0.048488,74.125.24.0-255,5738,200505,64,223787
44219,0.048495,172.31.40.0-255,66,200571,64,223787
44220,0.050821,74.125.24.0-255,5738,206309,64,223787
44221,0.05084,172.31.40.0-255,66,206375,64,223787
44222,0.05316,74.125.24.0-255,5738,212113,64,223787
44223,0.054172,172.31.40.0-255,66,212179,64,223787
44224,0.056504,74.125.24.0-255,5738,217917,64,223787
44225,0.056522,172.31.40.0-255,66,217983,64,223787
44226,0.05884,74.125.24.0-255,5738,223721,64,223787
44227,0.058854,172.31.40.0-255,66,223787,64,223787
44228,0.0,74.125.130.0-255,146,146,64,320398
44229,2e-05,172.31.40.0-255,66,212,64,320398
44230,2.7e-05,74.125.130.0-255,1484,1696,64,320398
44231,3.2e-05,172.31.40.0-255,66,1762,64,320398
44232,3.8e-05,74.125.130.0-255,2902,4664,64,320398
44233,4e-05,172.31.40.0-255,66,4730,64,320398
44234,6.1e-05,74.125.130.0-255,4320,9050,64,320398
44235,6.4e-05,172.31.40.0-255,66,9116,64,320398
44236,8.5e-05,74.125.130.0-255,2902,12018,64,320398
44237,8.8e-05,172.31.40.0-255,66,12084,64,320398
44238,0.000138,74.125.130.0-255,2038,14122,64,320398
44239,0.000141,172.31.40.0-255,66,14188,64,320398
44240,0.000344,74.125.130.0-255,1484,15672,64,320398
44241,0.000349,172.31.40.0-255,66,15738,64,320398
44242,0.000356,74.125.130.0-255,2902,18640,64,320398
44243,0.000359,172.31.40.0-255,66,18706,64,320398
44244,0.000396,74.125.130.0-255,5738,24444,64,320398
44245,0.000399,172.31.40.0-255,66,24510,64,320398
44246,0.000417,74.125.130.0-255,2902,27412,64,320398
44247,0.00042,172.31.40.0-255,66,27478,64,320398
44248,0.000438,74.125.130.0-255,3961,31439,64,320398
44249,0.000441,172.31.40.0-255,66,31505,64,320398
44250,0.000454,74.125.130.0-255,1484,32989,64,320398
44251,0.000456,172.31.40.0-255,66,33055,64,320398
44252,0.000459,74.125.130.0-255,1484,34539,64,320398
44253,0.000461,172.31.40.0-255,66,34605,64,320398
44254,0.000492,74.125.130.0-255,1484,36089,64,320398
44255,0.000495,172.31.40.0-255,66,36155,64,320398
44256,0.000501,74.125.130.0-255,5738,41893,64,320398
44257,0.000504,172.31.40.0-255,66,41959,64,320398
44258,0.000507,74.125.130.0-255,2902,44861,64,320398
44259,0.000509,172.31.40.0-255,66,44927,64,320398
44260,0.000514,74.125.130.0-255,4320,49247,64,320398
44261,0.000516,172.31.40.0-255,66,49313,64,320398
44262,0.000544,172.31.40.0-255,66,49379,64,320398
44263,0.000549,74.125.130.0-255,2902,52281,64,320398
44264,0.000551,172.31.40.0-255,66,52347,64,320398
44265,0.000614,74.125.130.0-255,5020,57367,64,320398
44266,0.000618,172.31.40.0-255,66,57433,64,320398
44267,0.000621,74.125.130.0-255,341,57774,64,320398
44268,0.000865,74.125.130.0-255,119,57893,64,320398
44269,0.000915,74.125.130.0-255,1484,59377,64,320398
44270,0.000918,172.31.40.0-255,66,59443,64,320398
44271,0.000936,74.125.130.0-255,2902,62345,64,320398
44272,0.000939,172.31.40.0-255,66,62411,64,320398
44273,0.000942,74.125.130.0-255,1484,63895,64,320398
44274,0.000966,74.125.130.0-255,2902,66797,64,320398
44275,0.000969,172.31.40.0-255,66,66863,64,320398
44276,0.000998,74.125.130.0-255,1484,68347,64,320398
44277,0.001023,74.125.130.0-255,2902,71249,64,320398
44278,0.001026,172.31.40.0-255,66,71315,64,320398
44279,0.001069,74.125.130.0-255,5738,77053,64,320398
44280,0.001071,172.31.40.0-255,66,77119,64,320398
44281,0.001079,74.125.130.0-255,7156,84275,64,320398
44282,0.001081,172.31.40.0-255,66,84341,64,320398
44283,0.001107,172.31.40.0-255,66,84407,64,320398
44284,0.001234,74.125.130.0-255,1484,85891,64,320398
44285,0.001253,74.125.130.0-255,1484,87375,64,320398
44286,0.001257,172.31.40.0-255,66,87441,64,320398
44287,0.001262,74.125.130.0-255,2902,90343,64,320398
44288,0.001264,172.31.40.0-255,66,90409,64,320398
44289,0.001267,74.125.130.0-255,1484,91893,64,320398
44290,0.001285,74.125.130.0-255,4320,96213,64,320398
44291,0.001288,172.31.40.0-255,66,96279,64,320398
44292,0.001291,74.125.130.0-255,1484,97763,64,320398
44293,0.001309,74.125.130.0-255,7156,104919,64,320398
44294,0.001312,172.31.40.0-255,66,104985,64,320398
44295,0.001342,172.31.40.0-255,66,105051,64,320398
44296,0.001348,74.125.130.0-255,3602,108653,64,320398
44297,0.00135,172.31.40.0-255,66,108719,64,320398
44298,0.001414,74.125.130.0-255,1484,110203,64,320398
44299,0.001432,74.125.130.0-255,2902,113105,64,320398
44300,0.001435,172.31.40.0-255,66,113171,64,320398
44301,0.001454,74.125.130.0-255,4320,117491,64,320398
44302,0.001457,172.31.40.0-255,66,117557,64,320398
44303,0.00148,74.125.130.0-255,2902,120459,64,320398
44304,0.001484,172.31.40.0-255,66,120525,64,320398
44305,0.001492,74.125.130.0-255,2902,123427,64,320398
44306,0.001495,172.31.40.0-255,66,123493,64,320398
44307,0.001498,74.125.130.0-255,1484,124977,64,320398
44308,0.001522,74.125.130.0-255,2902,127879,64,320398
44309,0.001525,172.31.40.0-255,66,127945,64,320398
44310,0.001566,74.125.130.0-255,5738,133683,64,320398
44311,0.001571,172.31.40.0-255,66,133749,64,320398
44312,0.001598,74.125.130.0-255,1484,135233,64,320398
44313,0.001645,74.125.130.0-255,2902,138135,64,320398
44314,0.001649,172.31.40.0-255,66,138201,64,320398
44315,0.001652,74.125.130.0-255,1484,139685,64,320398
44316,0.00167,74.125.130.0-255,2902,142587,64,320398
44317,0.001673,172.31.40.0-255,66,142653,64,320398
44318,0.001688,74.125.130.0-255,766,143419,64,320398
44319,0.001868,74.125.130.0-255,1484,144903,64,320398
44320,0.001874,172.31.40.0-255,66,144969,64,320398
44321,0.001904,74.125.130.0-255,2902,147871,64,320398
44322,0.001908,172.31.40.0-255,66,147937,64,320398
44323,0.001927,74.125.130.0-255,1484,149421,64,320398
44324,0.00194,74.125.130.0-255,2902,152323,64,320398
44325,0.001942,172.31.40.0-255,66,152389,64,320398
44326,0.001945,74.125.130.0-255,1484,153873,64,320398
44327,0.001965,74.125.130.0-255,4320,158193,64,320398
44328,0.001968,172.31.40.0-255,66,158259,64,320398
44329,0.002007,74.125.130.0-255,4320,162579,64,320398
44330,0.00201,172.31.40.0-255,66,162645,64,320398
44331,0.002028,74.125.130.0-255,2902,165547,64,320398
44332,0.002031,172.31.40.0-255,66,165613,64,320398
44333,0.002062,172.31.40.0-255,66,165679,64,320398
44334,0.00208,74.125.130.0-255,1484,167163,64,320398
44335,0.002096,74.125.130.0-255,2184,169347,64,320398
44336,0.002099,172.31.40.0-255,66,169413,64,320398
44337,0.004344,74.125.130.0-255,1484,170897,64,320398
44338,0.004379,74.125.130.0-255,4320,175217,64,320398
44339,0.004383,172.31.40.0-255,66,175283,64,320398
44340,0.006656,74.125.130.0-255,4320,179603,64,320398
44341,0.006659,172.31.40.0-255,66,179669,64,320398
44342,0.006676,74.125.130.0-255,1484,181153,64,320398
44343,0.00897,74.125.130.0-255,4320,185473,64,320398
44344,0.008978,172.31.40.0-255,66,185539,64,320398
44345,0.01128,74.125.130.0-255,5738,191277,64,320398
44346,0.011289,172.31.40.0-255,66,191343,64,320398
44347,0.013578,74.125.130.0-255,5738,197081,64,320398
44348,0.0136,172.31.40.0-255,66,197147,64,320398
44349,0.015896,74.125.130.0-255,5738,202885,64,320398
44350,0.015905,172.31.40.0-255,66,202951,64,320398
44351,0.018197,74.125.130.0-255,5738,208689,64,320398
44352,0.018208,172.31.40.0-255,66,208755,64,320398
44353,0.020499,74.125.130.0-255,5738,214493,64,320398
44354,0.020509,172.31.40.0-255,66,214559,64,320398
44355,0.022818,74.125.130.0-255,5738,220297,64,320398
44356,0.022826,172.31.40.0-255,66,220363,64,320398
44357,0.025125,74.125.130.0-255,5738,226101,64,320398
44358,0.025131,172.31.40.0-255,66,226167,64,320398
44359,0.027466,74.125.130.0-255,5738,231905,64,320398
44360,0.027474,172.31.40.0-255,66,231971,64,320398
44361,0.029764,74.125.130.0-255,5738,237709,64,320398
44362,0.029771,172.31.40.0-255,66,237775,64,320398
44363,0.031754,172.31.40.0-255,172,237947,64,320398
44364,0.031788,172.31.40.0-255,1111,239058,64,320398
44365,0.031849,172.31.40.0-255,1514,240572,64,320398
44366,0.03185,172.31.40.0-255,1514,242086,64,320398
44367,0.031852,172.31.40.0-255,1514,243600,64,320398
44368,0.031853,172.31.40.0-255,1082,244682,64,320398
44369,0.032064,74.125.130.0-255,5738,250420,64,320398
44370,0.03207,172.31.40.0-255,66,250486,64,320398
44371,0.033238,104.244.42.0-255,66,250552,64,320398
44372,0.033267,104.244.42.0-255,66,250618,64,320398
44373,0.033339,104.244.42.0-255,66,250684,64,320398
44374,0.033352,104.244.42.0-255,66,250750,64,320398
44375,0.034379,74.125.130.0-255,5738,256488,64,320398
44376,0.034384,172.31.40.0-255,66,256554,64,320398
44377,0.036667,74.125.130.0-255,5738,262292,64,320398
44378,0.036673,172.31.40.0-255,66,262358,64,320398
44379,0.038973,74.125.130.0-255,5738,268096,64,320398
44380,0.03898,172.31.40.0-255,66,268162,64,320398
44381,0.041269,74.125.130.0-255,5738,273900,64,320398
44382,0.041275,172.31.40.0-255,66,273966,64,320398
44383,0.043573,74.125.130.0-255,5738,279704,64,320398
44384,0.043578,172.31.40.0-255,66,279770,64,320398
44385,0.045861,74.125.130.0-255,5738,285508,64,320398
44386,0.04587,172.31.40.0-255,66,285574,64,320398
44387,0.048173,74.125.130.0-255,5738,291312,64,320398
44388,0.048179,172.31.40.0-255,66,291378,64,320398
44389,0.050483,74.125.130.0-255,5738,297116,64,320398
44390,0.050489,172.31.40.0-255,66,297182,64,320398
44391,0.052784,74.125.130.0-255,5738,302920,64,320398
44392,0.052789,172.31.40.0-255,66,302986,64,320398
44393,0.055087,74.125.130.0-255,5738,308724,64,320398
44394,0.055093,172.31.40.0-255,66,308790,64,320398
44395,0.057386,74.125.130.0-255,5738,314528,64,320398
44396,0.057392,172.31.40.0-255,66,314594,64,320398
44397,0.059682,74.125.130.0-255,5738,320332,64,320398
44398,0.059688,172.31.40.0-255,66,320398,64,320398
44399,0.0,74.125.130.0-255,153,153,64,261957
44400,1.3e-05,172.31.40.0-255,66,219,64,261957
44401,1.9e-05,74.125.130.0-255,1484,1703,64,261957
44402,2.2e-05,172.31.40.0-255,66,1769,64,261957
44403,2.9e-05,74.125.130.0-255,2902,4671,64,261957
44404,4.3e-05,172.31.40.0-255,66,4737,64,261957
44405,5.1e-05,74.125.130.0-255,7156,11893,64,261957
44406,5.4e-05,172.31.40.0-255,66,11959,64,261957
44407,5.8e-05,74.125.130.0-255,2001,13960,64,261957
44408,6e-05,172.31.40.0-255,66,14026,64,261957
44409,0.000131,74.125.130.0-255,1484,15510,64,261957
44410,0.000134,172.31.40.0-255,66,15576,64,261957
44411,0.000139,74.125.130.0-255,2902,18478,64,261957
44412,0.000142,172.31.40.0-255,66,18544,64,261957
44413,0.000145,74.125.130.0-255,1484,20028,64,261957
44414,0.000151,172.31.40.0-255,66,20094,64,261957
44415,0.000177,74.125.130.0-255,1484,21578,64,261957
44416,0.00018,172.31.40.0-255,66,21644,64,261957
44417,0.000186,74.125.130.0-255,4320,25964,64,261957
44418,0.000188,172.31.40.0-255,66,26030,64,261957
44419,0.000217,74.125.130.0-255,5379,31409,64,261957
44420,0.000219,172.31.40.0-255,66,31475,64,261957
44421,0.000258,74.125.130.0-255,1484,32959,64,261957
44422,0.000261,172.31.40.0-255,66,33025,64,261957
44423,0.000266,74.125.130.0-255,2902,35927,64,261957
44424,0.000268,172.31.40.0-255,66,35993,64,261957
44425,0.000299,74.125.130.0-255,5738,41731,64,261957
44426,0.000302,172.31.40.0-255,66,41797,64,261957
44427,0.000309,74.125.130.0-255,6797,48594,64,261957
44428,0.000312,172.31.40.0-255,66,48660,64,261957
44429,0.000369,74.125.130.0-255,1484,50144,64,261957
44430,0.000372,172.31.40.0-255,66,50210,64,261957
44431,0.000377,74.125.130.0-255,2902,53112,64,261957
44432,0.00038,172.31.40.0-255,66,53178,64,261957
44433,0.000383,74.125.130.0-255,1484,54662,64,261957
44434,0.000415,74.125.130.0-255,4320,58982,64,261957
44435,0.000418,172.31.40.0-255,66,59048,64,261957
44436,0.000424,74.125.130.0-255,4320,63368,64,261957
44437,0.000426,172.31.40.0-255,66,63434,64,261957
44438,0.000456,74.125.130.0-255,2543,65977,64,261957
44439,0.000459,172.31.40.0-255,66,66043,64,261957
44440,0.000514,74.125.130.0-255,645,66688,64,261957
44441,0.000777,74.125.130.0-255,1484,68172,64,261957
44442,0.000782,172.31.40.0-255,66,68238,64,261957
44443,0.000788,74.125.130.0-255,2902,71140,64,261957
44444,0.000791,172.31.40.0-255,66,71206,64,261957
44445,0.000798,74.125.130.0-255,5738,76944,64,261957
44446,0.000806,172.31.40.0-255,66,77010,64,261957
44447,0.000812,74.125.130.0-255,5738,82748,64,261957
44448,0.000814,172.31.40.0-255,66,82814,64,261957
44449,0.000817,74.125.130.0-255,1484,84298,64,261957
44450,0.000848,74.125.130.0-255,5738,90036,64,261957
44451,0.000852,172.31.40.0-255,66,90102,64,261957
44452,0.000878,172.31.40.0-255,66,90168,64,261957
44453,0.000906,74.125.130.0-255,2184,92352,64,261957
44454,0.000909,172.31.40.0-255,66,92418,64,261957
44455,0.000912,74.125.130.0-255,1484,93902,64,261957
44456,0.000937,74.125.130.0-255,2902,96804,64,261957
44457,0.00094,172.31.40.0-255,66,96870,64,261957
44458,0.000946,74.125.130.0-255,5738,102608,64,261957
44459,0.000948,172.31.40.0-255,66,102674,64,261957
44460,0.000988,172.31.40.0-255,66,102740,64,261957
44461,0.000991,74.125.130.0-255,1484,104224,64,261957
44462,0.001036,172.31.40.0-255,66,104290,64,261957
44463,0.001072,172.31.40.0-255,66,104356,64,261957
44464,0.001085,172.31.40.0-255,66,104422,64,261957
44465,0.001097,172.31.40.0-255,66,104488,64,261957
44466,0.001121,74.125.130.0-255,6438,110926,64,261957
44467,0.001125,172.31.40.0-255,66,110992,64,261957
44468,0.001145,74.125.130.0-255,1484,112476,64,261957
44469,0.00115,74.125.130.0-255,2902,115378,64,261957
44470,0.001152,172.31.40.0-255,66,115444,64,261957
44471,0.001155,74.125.130.0-255,1484,116928,64,261957
44472,0.001186,74.125.130.0-255,4320,121248,64,261957
44473,0.001189,172.31.40.0-255,66,121314,64,261957
44474,0.001196,74.125.130.0-255,5738,127052,64,261957
44475,0.001198,172.31.40.0-255,66,127118,64,261957
44476,0.001205,74.125.130.0-255,7156,134274,64,261957
44477,0.001208,172.31.40.0-255,66,134340,64,261957
44478,0.001245,172.31.40.0-255,66,134406,64,261957
44479,0.001271,74.125.130.0-255,2184,136590,64,261957
44480,0.001274,172.31.40.0-255,66,136656,64,261957
44481,0.001277,74.125.130.0-255,1484,138140,64,261957
44482,0.001299,74.125.130.0-255,2902,141042,64,261957
44483,0.001302,172.31.40.0-255,66,141108,64,261957
44484,0.001308,74.125.130.0-255,5738,146846,64,261957
44485,0.00131,172.31.40.0-255,66,146912,64,261957
44486,0.001344,172.31.40.0-255,66,146978,64,261957
44487,0.001393,74.125.130.0-255,4320,151298,64,261957
44488,0.001396,172.31.40.0-255,66,151364,64,261957
44489,0.001427,74.125.130.0-255,6438,157802,64,261957
44490,0.00143,172.31.40.0-255,66,157868,64,261957
44491,0.001433,74.125.130.0-255,1484,159352,64,261957
44492,0.001463,74.125.130.0-255,2902,162254,64,261957
44493,0.001466,172.31.40.0-255,66,162320,64,261957
44494,0.001472,74.125.130.0-255,5738,168058,64,261957
44495,0.001475,172.31.40.0-255,66,168124,64,261957
44496,0.001522,74.125.130.0-255,5738,173862,64,261957
44497,0.001525,172.31.40.0-255,66,173928,64,261957
44498,0.00155,74.125.130.0-255,5738,179666,64,261957
44499,0.001553,172.31.40.0-255,66,179732,64,261957
44500,0.001564,172.31.40.0-255,66,179798,64,261957
44501,0.001569,74.125.130.0-255,3602,183400,64,261957
44502,0.001572,172.31.40.0-255,66,183466,64,261957
44503,0.001598,74.125.130.0-255,1484,184950,64,261957
44504,0.001601,74.125.130.0-255,1484,186434,64,261957
44505,0.001604,172.31.40.0-255,66,186500,64,261957
44506,0.001629,74.125.130.0-255,1484,187984,64,261957
44507,0.001635,74.125.130.0-255,5738,193722,64,261957
44508,0.001638,172.31.40.0-255,66,193788,64,261957
44509,0.001644,74.125.130.0-255,5738,199526,64,261957
44510,0.001647,172.31.40.0-255,66,199592,64,261957
44511,0.001649,74.125.130.0-255,1484,201076,64,261957
44512,0.001676,74.125.130.0-255,5738,206814,64,261957
44513,0.001679,172.31.40.0-255,66,206880,64,261957
44514,0.001726,172.31.40.0-255,66,206946,64,261957
44515,0.001871,74.125.130.0-255,1484,208430,64,261957
44516,0.001893,74.125.130.0-255,2902,211332,64,261957
44517,0.001896,172.31.40.0-255,66,211398,64,261957
44518,0.001903,74.125.130.0-255,5738,217136,64,261957
44519,0.001905,172.31.40.0-255,66,217202,64,261957
44520,0.001932,74.125.130.0-255,4320,221522,64,261957
44521,0.001935,172.31.40.0-255,66,221588,64,261957
44522,0.00197,172.31.40.0-255,66,221654,64,261957
44523,0.001977,74.125.130.0-255,7156,228810,64,261957
44524,0.00198,172.31.40.0-255,66,228876,64,261957
44525,0.002015,74.125.130.0-255,3602,232478,64,261957
44526,0.002018,172.31.40.0-255,66,232544,64,261957
44527,0.002021,74.125.130.0-255,1484,234028,64,261957
44528,0.002039,74.125.130.0-255,2902,236930,64,261957
44529,0.002042,172.31.40.0-255,66,236996,64,261957
44530,0.002048,74.125.130.0-255,5738,242734,64,261957
44531,0.00205,172.31.40.0-255,66,242800,64,261957
44532,0.002064,172.31.40.0-255,66,242866,64,261957
44533,0.002115,172.31.40.0-255,66,242932,64,261957
44534,0.002152,74.125.130.0-255,4320,247252,64,261957
44535,0.002171,74.125.130.0-255,7156,254408,64,261957
44536,0.00218,172.31.40.0-255,66,254474,64,261957
44537,0.002221,74.125.130.0-255,2818,257292,64,261957
44538,0.002223,74.125.130.0-255,105,257397,64,261957
44539,0.002229,172.31.40.0-255,66,257463,64,261957
44540,0.009865,172.31.40.0-255,105,257568,64,261957
44541,0.012195,74.125.130.0-255,66,257634,64,261957
44542,0.031347,172.31.40.0-255,203,257837,64,261957
44543,0.031379,172.31.40.0-255,1111,258948,64,261957
44544,0.031572,172.31.40.0-255,1514,260462,64,261957
44545,0.031574,172.31.40.0-255,1297,261759,64,261957
44546,0.032904,104.244.42.0-255,66,261825,64,261957
44547,0.032934,104.244.42.0-255,66,261891,64,261957
44548,0.033129,104.244.42.0-255,66,261957,64,261957
44549,0.0,74.125.68.0-255,146,146,64,163890
44550,1.4e-05,172.31.40.0-255,66,212,64,163890
44551,3.4e-05,74.125.68.0-255,1484,1696,64,163890
44552,3.8e-05,172.31.40.0-255,66,1762,64,163890
44553,5.9e-05,74.125.68.0-255,2902,4664,64,163890
44554,6.2e-05,172.31.40.0-255,66,4730,64,163890
44555,0.000108,74.125.68.0-255,2902,7632,64,163890
44556,0.000112,172.31.40.0-255,66,7698,64,163890
44557,0.000131,74.125.68.0-255,2902,10600,64,163890
44558,0.000133,172.31.40.0-255,66,10666,64,163890
44559,0.000248,74.125.68.0-255,2902,13568,64,163890
44560,0.000253,172.31.40.0-255,66,13634,64,163890
44561,0.000324,74.125.68.0-255,4320,17954,64,163890
44562,0.00033,172.31.40.0-255,66,18020,64,163890
44563,0.000346,74.125.68.0-255,6282,24302,64,163890
44564,0.000349,172.31.40.0-255,66,24368,64,163890
44565,0.000581,74.125.68.0-255,4320,28688,64,163890
44566,0.000585,172.31.40.0-255,66,28754,64,163890
44567,0.000682,172.31.40.0-255,66,28820,64,163890
44568,0.000707,172.31.40.0-255,66,28886,64,163890
44569,0.001105,172.31.40.0-255,66,28952,64,163890
44570,0.00113,172.31.40.0-255,66,29018,64,163890
44571,0.001553,74.125.68.0-255,376,29394,64,163890
44572,0.001558,172.31.40.0-255,66,29460,64,163890
44573,0.001566,74.125.68.0-255,5738,35198,64,163890
44574,0.001569,172.31.40.0-255,66,35264,64,163890
44575,0.001595,172.31.40.0-255,66,35330,64,163890
44576,0.002377,74.125.68.0-255,2902,38232,64,163890
44577,0.002439,74.125.68.0-255,766,38998,64,163890
44578,0.003187,74.125.68.0-255,4320,43318,64,163890
44579,0.004027,74.125.68.0-255,1484,44802,64,163890
44580,0.004071,74.125.68.0-255,7156,51958,64,163890
44581,0.00463,172.31.40.0-255,66,52024,64,163890
44582,0.007183,74.125.68.0-255,4320,56344,64,163890
44583,0.00719,172.31.40.0-255,66,56410,64,163890
44584,0.007213,74.125.68.0-255,1484,57894,64,163890
44585,0.009736,74.125.68.0-255,4320,62214,64,163890
44586,0.009742,172.31.40.0-255,66,62280,64,163890
44587,0.012297,74.125.68.0-255,5738,68018,64,163890
44588,0.018649,172.31.40.0-255,66,68084,64,163890
44589,0.021199,74.125.68.0-255,5738,73822,64,163890
44590,0.021211,172.31.40.0-255,66,73888,64,163890
44591,0.023778,74.125.68.0-255,5738,79626,64,163890
44592,0.02379,172.31.40.0-255,66,79692,64,163890
44593,0.026162,172.31.40.0-255,172,79864,64,163890
44594,0.026191,172.31.40.0-255,1112,80976,64,163890
44595,0.026222,172.31.40.0-255,1514,82490,64,163890
44596,0.026224,172.31.40.0-255,1298,83788,64,163890
44597,0.026333,74.125.68.0-255,5738,89526,64,163890
44598,0.026338,172.31.40.0-255,66,89592,64,163890
44599,0.027744,104.244.42.0-255,66,89658,64,163890
44600,0.02775,104.244.42.0-255,66,89724,64,163890
44601,0.027778,104.244.42.0-255,66,89790,64,163890
44602,0.028881,74.125.68.0-255,4320,94110,64,163890
44603,0.028886,172.31.40.0-255,66,94176,64,163890
44604,0.028913,74.125.68.0-255,1484,95660,64,163890
44605,0.031435,74.125.68.0-255,4320,99980,64,163890
44606,0.03144,172.31.40.0-255,66,100046,64,163890
44607,0.033993,74.125.68.0-255,5738,105784,64,163890
44608,0.034086,172.31.40.0-255,66,105850,64,163890
44609,0.036648,74.125.68.0-255,5738,111588,64,163890
44610,0.036668,172.31.40.0-255,66,111654,64,163890
44611,0.039224,74.125.68.0-255,5738,117392,64,163890
44612,0.039243,172.31.40.0-255,66,117458,64,163890
44613,0.041803,74.125.68.0-255,5738,123196,64,163890
44614,0.041821,172.31.40.0-255,66,123262,64,163890
44615,0.04439,74.125.68.0-255,5738,129000,64,163890
44616,0.044408,172.31.40.0-255,66,129066,64,163890
44617,0.046972,74.125.68.0-255,5738,134804,64,163890
44618,0.046989,172.31.40.0-255,66,134870,64,163890
44619,0.04955,74.125.68.0-255,5738,140608,64,163890
44620,0.049569,172.31.40.0-255,66,140674,64,163890
44621,0.05214,74.125.68.0-255,5738,146412,64,163890
44622,0.052159,172.31.40.0-255,66,146478,64,163890
44623,0.054722,74.125.68.0-255,5738,152216,64,163890
44624,0.054739,172.31.40.0-255,66,152282,64,163890
44625,0.0573,74.125.68.0-255,5738,158020,64,163890
44626,0.05732,172.31.40.0-255,66,158086,64,163890
44627,0.059882,74.125.68.0-255,5738,163824,64,163890
44628,0.059904,172.31.40.0-255,66,163890,64,163890
44629,0.0,74.125.200.0-255,146,146,64,279555
44630,1.6e-05,172.31.40.0-255,66,212,64,279555
44631,2.3e-05,74.125.200.0-255,1484,1696,64,279555
44632,2.8e-05,172.31.40.0-255,66,1762,64,279555
44633,3.1e-05,74.125.200.0-255,1484,3246,64,279555
44634,3.4e-05,172.31.40.0-255,66,3312,64,279555
44635,6.2e-05,74.125.200.0-255,2902,6214,64,279555
44636,6.5e-05,172.31.40.0-255,66,6280,64,279555
44637,8.4e-05,74.125.200.0-255,5738,12018,64,279555
44638,8.6e-05,172.31.40.0-255,66,12084,64,279555
44639,0.000116,74.125.200.0-255,2902,14986,64,279555
44640,0.000118,172.31.40.0-255,66,15052,64,279555
44641,0.000141,74.125.200.0-255,3447,18499,64,279555
44642,0.000144,172.31.40.0-255,66,18565,64,279555
44643,0.000146,74.125.200.0-255,1484,20049,64,279555
44644,0.000148,172.31.40.0-255,66,20115,64,279555
44645,0.000198,74.125.200.0-255,1484,21599,64,279555
44646,0.000202,172.31.40.0-255,66,21665,64,279555
44647,0.000225,74.125.200.0-255,7156,28821,64,279555
44648,0.000227,172.31.40.0-255,66,28887,64,279555
44649,0.000243,74.125.200.0-255,1484,30371,64,279555
44650,0.000246,172.31.40.0-255,66,30437,64,279555
44651,0.000249,74.125.200.0-255,1125,31562,64,279555
44652,0.000251,172.31.40.0-255,66,31628,64,279555
44653,0.000395,74.125.200.0-255,1484,33112,64,279555
44654,0.000399,172.31.40.0-255,66,33178,64,279555
44655,0.000413,74.125.200.0-255,2902,36080,64,279555
44656,0.000416,172.31.40.0-255,66,36146,64,279555
44657,0.000422,74.125.200.0-255,4320,40466,64,279555
44658,0.000424,172.31.40.0-255,66,40532,64,279555
44659,0.000456,74.125.200.0-255,1484,42016,64,279555
44660,0.000459,172.31.40.0-255,66,42082,64,279555
44661,0.000466,74.125.200.0-255,5738,47820,64,279555
44662,0.000468,172.31.40.0-255,66,47886,64,279555
44663,0.000475,74.125.200.0-255,7156,55042,64,279555
44664,0.000478,172.31.40.0-255,66,55108,64,279555
44665,0.000498,74.125.200.0-255,5738,60846,64,279555
44666,0.000502,172.31.40.0-255,66,60912,64,279555
44667,0.000528,74.125.200.0-255,5020,65932,64,279555
44668,0.000531,172.31.40.0-255,66,65998,64,279555
44669,0.000534,74.125.200.0-255,401,66399,64,279555
44670,0.000536,172.31.40.0-255,66,66465,64,279555
44671,0.00055,74.125.200.0-255,343,66808,64,279555
44672,0.000552,172.31.40.0-255,66,66874,64,279555
44673,0.000712,74.125.200.0-255,1484,68358,64,279555
44674,0.000715,74.125.200.0-255,1484,69842,64,279555
44675,0.000722,172.31.40.0-255,66,69908,64,279555
44676,0.00073,172.31.40.0-255,66,69974,64,279555
44677,0.000735,74.125.200.0-255,2902,72876,64,279555
44678,0.000738,172.31.40.0-255,66,72942,64,279555
44679,0.000761,74.125.200.0-255,5738,78680,64,279555
44680,0.000764,172.31.40.0-255,66,78746,64,279555
44681,0.000799,172.31.40.0-255,66,78812,64,279555
44682,0.000834,74.125.200.0-255,4320,83132,64,279555
44683,0.000837,172.31.40.0-255,66,83198,64,279555
44684,0.000875,172.31.40.0-255,66,83264,64,279555
44685,0.000889,172.31.40.0-255,66,83330,64,279555
44686,0.0009,172.31.40.0-255,66,83396,64,279555
44687,0.000905,74.125.200.0-255,4320,87716,64,279555
44688,0.000907,172.31.40.0-255,66,87782,64,279555
44689,0.000939,74.125.200.0-255,5738,93520,64,279555
44690,0.000942,172.31.40.0-255,66,93586,64,279555
44691,0.000949,74.125.200.0-255,5020,98606,64,279555
44692,0.000951,172.31.40.0-255,66,98672,64,279555
44693,0.000957,74.125.200.0-255,5738,104410,64,279555
44694,0.000959,172.31.40.0-255,66,104476,64,279555
44695,0.001013,74.125.200.0-255,6247,110723,64,279555
44696,0.001016,172.31.40.0-255,66,110789,64,279555
44697,0.001874,74.125.200.0-255,1484,112273,64,279555
44698,0.00188,172.31.40.0-255,66,112339,64,279555
44699,0.001886,74.125.200.0-255,2902,115241,64,279555
44700,0.001888,172.31.40.0-255,66,115307,64,279555
44701,0.001891,74.125.200.0-255,1484,116791,64,279555
44702,0.001893,172.31.40.0-255,66,116857,64,279555
44703,0.001898,74.125.200.0-255,2902,119759,64,279555
44704,0.0019,172.31.40.0-255,66,119825,64,279555
44705,0.00193,74.125.200.0-255,5738,125563,64,279555
44706,0.001933,172.31.40.0-255,66,125629,64,279555
44707,0.001938,74.125.200.0-255,2902,128531,64,279555
44708,0.00194,172.31.40.0-255,66,128597,64,279555
44709,0.001956,74.125.200.0-255,1484,130081,64,279555
44710,0.001959,172.31.40.0-255,66,130147,64,279555
44711,0.001965,74.125.200.0-255,4320,134467,64,279555
44712,0.001966,172.31.40.0-255,66,134533,64,279555
44713,0.001991,74.125.200.0-255,1484,136017,64,279555
44714,0.001995,74.125.200.0-255,1484,137501,64,279555
44715,0.001999,172.31.40.0-255,66,137567,64,279555
44716,0.002031,172.31.40.0-255,66,137633,64,279555
44717,0.002082,74.125.200.0-255,1484,139117,64,279555
44718,0.002099,74.125.200.0-255,2902,142019,64,279555
44719,0.002105,172.31.40.0-255,66,142085,64,279555
44720,0.002127,74.125.200.0-255,5738,147823,64,279555
44721,0.002141,74.125.200.0-255,4320,152143,64,279555
44722,0.002146,172.31.40.0-255,66,152209,64,279555
44723,0.002181,172.31.40.0-255,66,152275,64,279555
44724,0.002213,74.125.200.0-255,4320,156595,64,279555
44725,0.002235,74.125.200.0-255,5738,162333,64,279555
44726,0.00224,172.31.40.0-255,66,162399,64,279555
44727,0.002256,74.125.200.0-255,766,163165,64,279555
44728,0.002327,74.125.200.0-255,1484,164649,64,279555
44729,0.002331,74.125.200.0-255,1484,166133,64,279555
44730,0.002343,74.125.200.0-255,1484,167617,64,279555
44731,0.00235,172.31.40.0-255,66,167683,64,279555
44732,0.002368,74.125.200.0-255,4320,172003,64,279555
44733,0.002371,172.31.40.0-255,66,172069,64,279555
44734,0.0024,74.125.200.0-255,2902,174971,64,279555
44735,0.002416,172.31.40.0-255,66,175037,64,279555
44736,0.002425,74.125.200.0-255,2902,177939,64,279555
44737,0.002429,172.31.40.0-255,66,178005,64,279555
44738,0.002456,74.125.200.0-255,766,178771,64,279555
44739,0.012235,172.31.40.0-255,66,178837,64,279555
44740,0.013989,74.125.200.0-255,1484,180321,64,279555
44741,0.014001,172.31.40.0-255,66,180387,64,279555
44742,0.014849,74.125.200.0-255,4320,184707,64,279555
44743,0.014855,172.31.40.0-255,66,184773,64,279555
44744,0.016597,74.125.200.0-255,1484,186257,64,279555
44745,0.016609,172.31.40.0-255,66,186323,64,279555
44746,0.017459,74.125.200.0-255,4320,190643,64,279555
44747,0.017464,172.31.40.0-255,66,190709,64,279555
44748,0.019211,74.125.200.0-255,1484,192193,64,279555
44749,0.019219,172.31.40.0-255,66,192259,64,279555
44750,0.020073,74.125.200.0-255,4320,196579,64,279555
44751,0.020081,172.31.40.0-255,66,196645,64,279555
44752,0.021821,74.125.200.0-255,1484,198129,64,279555
44753,0.02271,74.125.200.0-255,4320,202449,64,279555
44754,0.023589,172.31.40.0-255,66,202515,64,279555
44755,0.026209,74.125.200.0-255,5738,208253,64,279555
44756,0.026222,172.31.40.0-255,66,208319,64,279555
44757,0.028837,74.125.200.0-255,5738,214057,64,279555
44758,0.028847,172.31.40.0-255,66,214123,64,279555
44759,0.031451,74.125.200.0-255,5738,219861,64,279555
44760,0.031459,172.31.40.0-255,66,219927,64,279555
44761,0.034078,74.125.200.0-255,5738,225665,64,279555
44762,0.034092,172.31.40.0-255,66,225731,64,279555
44763,0.0367,74.125.200.0-255,5738,231469,64,279555
44764,0.036708,172.31.40.0-255,66,231535,64,279555
44765,0.039335,74.125.200.0-255,5738,237273,64,279555
44766,0.039353,172.31.40.0-255,66,237339,64,279555
44767,0.041968,74.125.200.0-255,4320,241659,64,279555
44768,0.041974,172.31.40.0-255,66,241725,64,279555
44769,0.041993,74.125.200.0-255,1484,243209,64,279555
44770,0.044598,74.125.200.0-255,4320,247529,64,279555
44771,0.044606,172.31.40.0-255,66,247595,64,279555
44772,0.04722,74.125.200.0-255,5738,253333,64,279555
44773,0.047227,172.31.40.0-255,66,253399,64,279555
44774,0.049885,74.125.200.0-255,5738,259137,64,279555
44775,0.049893,172.31.40.0-255,66,259203,64,279555
44776,0.050888,172.31.40.0-255,172,259375,64,279555
44777,0.050922,172.31.40.0-255,1112,260487,64,279555
44778,0.05098,172.31.40.0-255,1514,262001,64,279555
44779,0.050982,172.31.40.0-255,1296,263297,64,279555
44780,0.052448,104.244.42.0-255,66,263363,64,279555
44781,0.052482,104.244.42.0-255,66,263429,64,279555
44782,0.052506,74.125.200.0-255,4320,267749,64,279555
44783,0.052511,172.31.40.0-255,66,267815,64,279555
44784,0.052538,74.125.200.0-255,1484,269299,64,279555
44785,0.052543,104.244.42.0-255,66,269365,64,279555
44786,0.055145,74.125.200.0-255,4320,273685,64,279555
44787,0.055163,172.31.40.0-255,66,273751,64,279555
44788,0.0578,74.125.200.0-255,5738,279489,64,279555
44789,0.057819,172.31.40.0-255,66,279555,64,279555
44790,0.0,74.125.24.0-255,153,153,64,297005
44791,2.5e-05,172.31.40.0-255,66,219,64,297005
44792,3.2e-05,74.125.24.0-255,1484,1703,64,297005
44793,3.6e-05,172.31.40.0-255,66,1769,64,297005
44794,4.9e-05,74.125.24.0-255,2902,4671,64,297005
44795,5.5e-05,172.31.40.0-255,66,4737,64,297005
44796,6e-05,74.125.24.0-255,2902,7639,64,297005
44797,6.3e-05,172.31.40.0-255,66,7705,64,297005
44798,7e-05,74.125.24.0-255,5738,13443,64,297005
44799,7.3e-05,172.31.40.0-255,66,13509,64,297005
44800,0.000113,74.125.24.0-255,4936,18445,64,297005
44801,0.000116,172.31.40.0-255,66,18511,64,297005
44802,0.000124,74.125.24.0-255,7156,25667,64,297005
44803,0.000126,172.31.40.0-255,66,25733,64,297005
44804,0.000157,74.125.24.0-255,5379,31112,64,297005
44805,0.00016,172.31.40.0-255,66,31178,64,297005
44806,0.000231,74.125.24.0-255,1484,32662,64,297005
44807,0.000234,172.31.40.0-255,66,32728,64,297005
44808,0.000241,74.125.24.0-255,2902,35630,64,297005
44809,0.000243,172.31.40.0-255,66,35696,64,297005
44810,0.000254,74.125.24.0-255,5738,41434,64,297005
44811,0.000257,172.31.40.0-255,66,41500,64,297005
44812,0.000263,74.125.24.0-255,6797,48297,64,297005
44813,0.000266,172.31.40.0-255,66,48363,64,297005
44814,0.0003,172.31.40.0-255,66,48429,64,297005
44815,0.000332,74.125.24.0-255,4320,52749,64,297005
44816,0.000334,172.31.40.0-255,66,52815,64,297005
44817,0.000339,74.125.24.0-255,2543,55358,64,297005
44818,0.000341,172.31.40.0-255,66,55424,64,297005
44819,0.000344,74.125.24.0-255,395,55819,64,297005
44820,0.00035,172.31.40.0-255,66,55885,64,297005
44821,0.00037,74.125.24.0-255,348,56233,64,297005
44822,0.000621,74.125.24.0-255,1484,57717,64,297005
44823,0.000627,172.31.40.0-255,66,57783,64,297005
44824,0.000633,74.125.24.0-255,2902,60685,64,297005
44825,0.000635,172.31.40.0-255,66,60751,64,297005
44826,0.00064,74.125.24.0-255,2902,63653,64,297005
44827,0.000647,172.31.40.0-255,66,63719,64,297005
44828,0.000678,74.125.24.0-255,2902,66621,64,297005
44829,0.000681,172.31.40.0-255,66,66687,64,297005
44830,0.000684,74.125.24.0-255,1484,68171,64,297005
44831,0.000698,172.31.40.0-255,66,68237,64,297005
44832,0.000705,74.125.24.0-255,5738,73975,64,297005
44833,0.000707,172.31.40.0-255,66,74041,64,297005
44834,0.00074,74.125.24.0-255,3602,77643,64,297005
44835,0.000743,172.31.40.0-255,66,77709,64,297005
44836,0.001263,74.125.24.0-255,1484,79193,64,297005
44837,0.001279,74.125.24.0-255,2902,82095,64,297005
44838,0.001283,172.31.40.0-255,66,82161,64,297005
44839,0.001303,74.125.24.0-255,2902,85063,64,297005
44840,0.001305,172.31.40.0-255,66,85129,64,297005
44841,0.001313,74.125.24.0-255,7156,92285,64,297005
44842,0.001315,172.31.40.0-255,66,92351,64,297005
44843,0.001344,74.125.24.0-255,2902,95253,64,297005
44844,0.001347,172.31.40.0-255,66,95319,64,297005
44845,0.00136,74.125.24.0-255,4320,99639,64,297005
44846,0.001366,172.31.40.0-255,66,99705,64,297005
44847,0.001396,172.31.40.0-255,66,99771,64,297005
44848,0.001421,74.125.24.0-255,3602,103373,64,297005
44849,0.001423,172.31.40.0-255,66,103439,64,297005
44850,0.001831,74.125.24.0-255,1484,104923,64,297005
44851,0.001836,74.125.24.0-255,1484,106407,64,297005
44852,0.001839,172.31.40.0-255,66,106473,64,297005
44853,0.001866,74.125.24.0-255,1484,107957,64,297005
44854,0.001873,74.125.24.0-255,5738,113695,64,297005
44855,0.001875,172.31.40.0-255,66,113761,64,297005
44856,0.00188,74.125.24.0-255,4320,118081,64,297005
44857,0.001882,172.31.40.0-255,66,118147,64,297005
44858,0.001918,172.31.40.0-255,66,118213,64,297005
44859,0.001926,74.125.24.0-255,7156,125369,64,297005
44860,0.001928,172.31.40.0-255,66,125435,64,297005
44861,0.00195,74.125.24.0-255,2902,128337,64,297005
44862,0.001953,172.31.40.0-255,66,128403,64,297005
44863,0.001978,74.125.24.0-255,766,129169,64,297005
44864,0.001994,74.125.24.0-255,1484,130653,64,297005
44865,0.001997,172.31.40.0-255,66,130719,64,297005
44866,0.002,74.125.24.0-255,1484,132203,64,297005
44867,0.002038,74.125.24.0-255,2902,135105,64,297005
44868,0.002041,172.31.40.0-255,66,135171,64,297005
44869,0.002048,74.125.24.0-255,7156,142327,64,297005
44870,0.00205,172.31.40.0-255,66,142393,64,297005
44871,0.002071,172.31.40.0-255,66,142459,64,297005
44872,0.002077,74.125.24.0-255,5020,147479,64,297005
44873,0.002116,172.31.40.0-255,66,147545,64,297005
44874,0.002142,74.125.24.0-255,1484,149029,64,297005
44875,0.002147,74.125.24.0-255,2902,151931,64,297005
44876,0.00215,172.31.40.0-255,66,151997,64,297005
44877,0.002157,74.125.24.0-255,5738,157735,64,297005
44878,0.002159,172.31.40.0-255,66,157801,64,297005
44879,0.002162,74.125.24.0-255,1484,159285,64,297005
44880,0.002169,74.125.24.0-255,7156,166441,64,297005
44881,0.002171,172.31.40.0-255,66,166507,64,297005
44882,0.002196,74.125.24.0-255,1484,167991,64,297005
44883,0.0022,74.125.24.0-255,1484,169475,64,297005
44884,0.002202,172.31.40.0-255,66,169541,64,297005
44885,0.002241,172.31.40.0-255,66,169607,64,297005
44886,0.002275,74.125.24.0-255,5738,175345,64,297005
44887,0.002278,172.31.40.0-255,66,175411,64,297005
44888,0.002285,74.125.24.0-255,7156,182567,64,297005
44889,0.002288,172.31.40.0-255,66,182633,64,297005
44890,0.002311,172.31.40.0-255,66,182699,64,297005
44891,0.002343,74.125.24.0-255,2902,185601,64,297005
44892,0.002346,172.31.40.0-255,66,185667,64,297005
44893,0.002357,172.31.40.0-255,66,185733,64,297005
44894,0.00237,172.31.40.0-255,66,185799,64,297005
44895,0.002409,172.31.40.0-255,66,185865,64,297005
44896,0.002419,172.31.40.0-255,66,185931,64,297005
44897,0.004816,74.125.24.0-255,5738,191669,64,297005
44898,0.004838,172.31.40.0-255,66,191735,64,297005
44899,0.007243,74.125.24.0-255,5738,197473,64,297005
44900,0.007261,172.31.40.0-255,66,197539,64,297005
44901,0.009646,74.125.24.0-255,5738,203277,64,297005
44902,0.009661,172.31.40.0-255,66,203343,64,297005
44903,0.012002,74.125.24.0-255,5738,209081,64,297005
44904,0.013501,172.31.40.0-255,66,209147,64,297005
44905,0.015881,74.125.24.0-255,5738,214885,64,297005
44906,0.015891,172.31.40.0-255,66,214951,64,297005
44907,0.018254,74.125.24.0-255,5738,220689,64,297005
44908,0.018267,172.31.40.0-255,66,220755,64,297005
44909,0.02061,74.125.24.0-255,5738,226493,64,297005
44910,0.02062,172.31.40.0-255,66,226559,64,297005
44911,0.023013,74.125.24.0-255,5738,232297,64,297005
44912,0.023022,172.31.40.0-255,66,232363,64,297005
44913,0.02538,74.125.24.0-255,5738,238101,64,297005
44914,0.025393,172.31.40.0-255,66,238167,64,297005
44915,0.027923,74.125.24.0-255,5738,243905,64,297005
44916,0.027933,172.31.40.0-255,66,243971,64,297005
44917,0.030387,74.125.24.0-255,5738,249709,64,297005
44918,0.030404,172.31.40.0-255,66,249775,64,297005
44919,0.032749,74.125.24.0-255,5738,255513,64,297005
44920,0.032761,172.31.40.0-255,66,255579,64,297005
44921,0.035095,74.125.24.0-255,5738,261317,64,297005
44922,0.035103,172.31.40.0-255,66,261383,64,297005
44923,0.037496,74.125.24.0-255,5738,267121,64,297005
44924,0.037504,172.31.40.0-255,66,267187,64,297005
44925,0.039943,74.125.24.0-255,5738,272925,64,297005
44926,0.039952,172.31.40.0-255,66,272991,64,297005
44927,0.042357,74.125.24.0-255,5738,278729,64,297005
44928,0.042375,172.31.40.0-255,66,278795,64,297005
44929,0.044728,74.125.24.0-255,5738,284533,64,297005
44930,0.044738,172.31.40.0-255,66,284599,64,297005
44931,0.047319,74.125.24.0-255,5738,290337,64,297005
44932,0.047359,172.31.40.0-255,66,290403,64,297005
44933,0.049449,172.31.40.0-255,171,290574,64,297005
44934,0.049483,172.31.40.0-255,1137,291711,64,297005
44935,0.049541,172.31.40.0-255,1514,293225,64,297005
44936,0.049562,172.31.40.0-255,1271,294496,64,297005
44937,0.04972,74.125.24.0-255,2074,296570,64,297005
44938,0.049727,172.31.40.0-255,66,296636,64,297005
44939,0.049877,172.31.40.0-255,105,296741,64,297005
44940,0.051003,104.244.42.0-255,66,296807,64,297005
44941,0.051041,104.244.42.0-255,66,296873,64,297005
44942,0.051099,104.244.42.0-255,66,296939,64,297005
44943,0.052193,74.125.24.0-255,66,297005,64,297005
44944,0.0,172.217.194.0-255,153,153,64,259004
44945,1.7e-05,172.31.40.0-255,66,219,64,259004
44946,2.3e-05,172.217.194.0-255,1484,1703,64,259004
44947,2.7e-05,172.31.40.0-255,66,1769,64,259004
44948,3.3e-05,172.217.194.0-255,2902,4671,64,259004
44949,3.6e-05,172.31.40.0-255,66,4737,64,259004
44950,4.2e-05,172.217.194.0-255,4320,9057,64,259004
44951,4.5e-05,172.31.40.0-255,66,9123,64,259004
44952,6.7e-05,172.217.194.0-255,2902,12025,64,259004
44953,7e-05,172.31.40.0-255,66,12091,64,259004
44954,7.4e-05,172.217.194.0-255,2039,14130,64,259004
44955,7.7e-05,172.31.40.0-255,66,14196,64,259004
44956,0.000154,172.217.194.0-255,1484,15680,64,259004
44957,0.000157,172.31.40.0-255,66,15746,64,259004
44958,0.000162,172.217.194.0-255,2902,18648,64,259004
44959,0.000165,172.31.40.0-255,66,18714,64,259004
44960,0.000207,172.217.194.0-255,5738,24452,64,259004
44961,0.000211,172.31.40.0-255,66,24518,64,259004
44962,0.000237,172.217.194.0-255,6797,31315,64,259004
44963,0.00024,172.31.40.0-255,66,31381,64,259004
44964,0.000403,172.217.194.0-255,1484,32865,64,259004
44965,0.000408,172.31.40.0-255,66,32931,64,259004
44966,0.000414,172.217.194.0-255,2902,35833,64,259004
44967,0.000416,172.31.40.0-255,66,35899,64,259004
44968,0.000421,172.217.194.0-255,2902,38801,64,259004
44969,0.000423,172.31.40.0-255,66,38867,64,259004
44970,0.000437,172.217.194.0-255,2902,41769,64,259004
44971,0.000439,172.31.40.0-255,66,41835,64,259004
44972,0.00046,172.217.194.0-255,4320,46155,64,259004
44973,0.000464,172.31.40.0-255,66,46221,64,259004
44974,0.000485,172.217.194.0-255,6797,53018,64,259004
44975,0.000489,172.31.40.0-255,66,53084,64,259004
44976,0.0005,172.31.40.0-255,66,53150,64,259004
44977,0.000517,172.217.194.0-255,2543,55693,64,259004
44978,0.000521,172.31.40.0-255,66,55759,64,259004
44979,0.00066,172.217.194.0-255,645,56404,64,259004
44980,0.000914,172.217.194.0-255,1484,57888,64,259004
44981,0.000919,172.31.40.0-255,66,57954,64,259004
44982,0.000923,172.217.194.0-255,1484,59438,64,259004
44983,0.00094,172.217.194.0-255,1484,60922,64,259004
44984,0.000942,172.31.40.0-255,66,60988,64,259004
44985,0.00095,172.217.194.0-255,5738,66726,64,259004
44986,0.000952,172.31.40.0-255,66,66792,64,259004
44987,0.000975,172.217.194.0-255,1484,68276,64,259004
44988,0.001008,172.31.40.0-255,66,68342,64,259004
44989,0.001015,172.217.194.0-255,5738,74080,64,259004
44990,0.001017,172.31.40.0-255,66,74146,64,259004
44991,0.001029,172.217.194.0-255,1484,75630,64,259004
44992,0.001042,172.217.194.0-255,3602,79232,64,259004
44993,0.001044,172.31.40.0-255,66,79298,64,259004
44994,0.001321,172.217.194.0-255,1484,80782,64,259004
44995,0.001327,172.217.194.0-255,2902,83684,64,259004
44996,0.00133,172.31.40.0-255,66,83750,64,259004
44997,0.001334,172.217.194.0-255,1484,85234,64,259004
44998,0.001348,172.217.194.0-255,4320,89554,64,259004
44999,0.00135,172.31.40.0-255,66,89620,64,259004
45000,0.001382,172.31.40.0-255,66,89686,64,259004
45001,0.001399,172.217.194.0-255,2902,92588,64,259004
45002,0.001401,172.31.40.0-255,66,92654,64,259004
45003,0.001406,172.217.194.0-255,4320,96974,64,259004
45004,0.001409,172.31.40.0-255,66,97040,64,259004
45005,0.001433,172.217.194.0-255,6438,103478,64,259004
45006,0.001436,172.31.40.0-255,66,103544,64,259004
45007,0.002281,172.217.194.0-255,1484,105028,64,259004
45008,0.002293,172.217.194.0-255,2902,107930,64,259004
45009,0.002298,172.31.40.0-255,66,107996,64,259004
45010,0.002306,172.217.194.0-255,5738,113734,64,259004
45011,0.002308,172.31.40.0-255,66,113800,64,259004
45012,0.002324,172.217.194.0-255,4320,118120,64,259004
45013,0.002327,172.31.40.0-255,66,118186,64,259004
45014,0.002353,172.217.194.0-255,4320,122506,64,259004
45015,0.002356,172.31.40.0-255,66,122572,64,259004
45016,0.002362,172.217.194.0-255,4320,126892,64,259004
45017,0.002364,172.31.40.0-255,66,126958,64,259004
45018,0.002387,172.31.40.0-255,66,127024,64,259004
45019,0.004973,172.217.194.0-255,5738,132762,64,259004
45020,0.004981,172.31.40.0-255,66,132828,64,259004
45021,0.007572,172.217.194.0-255,5738,138566,64,259004
45022,0.007578,172.31.40.0-255,66,138632,64,259004
45023,0.010156,172.217.194.0-255,5738,144370,64,259004
45024,0.010164,172.31.40.0-255,66,144436,64,259004
45025,0.012782,172.217.194.0-255,5738,150174,64,259004
45026,0.012789,172.31.40.0-255,66,150240,64,259004
45027,0.015404,172.217.194.0-255,5738,155978,64,259004
45028,0.015415,172.31.40.0-255,66,156044,64,259004
45029,0.018049,172.217.194.0-255,5738,161782,64,259004
45030,0.018058,172.31.40.0-255,66,161848,64,259004
45031,0.020671,172.217.194.0-255,5738,167586,64,259004
45032,0.02068,172.31.40.0-255,66,167652,64,259004
45033,0.023268,172.217.194.0-255,5738,173390,64,259004
45034,0.023277,172.31.40.0-255,66,173456,64,259004
45035,0.025878,172.217.194.0-255,5738,179194,64,259004
45036,0.025885,172.31.40.0-255,66,179260,64,259004
45037,0.026886,172.31.40.0-255,172,179432,64,259004
45038,0.026925,172.31.40.0-255,1111,180543,64,259004
45039,0.026984,172.31.40.0-255,1514,182057,64,259004
45040,0.026986,172.31.40.0-255,1297,183354,64,259004
45041,0.028451,104.244.42.0-255,66,183420,64,259004
45042,0.02849,172.217.194.0-255,5738,189158,64,259004
45043,0.028495,172.31.40.0-255,66,189224,64,259004
45044,0.02864,104.244.42.0-255,66,189290,64,259004
45045,0.028646,104.244.42.0-255,66,189356,64,259004
45046,0.031098,172.217.194.0-255,5738,195094,64,259004
45047,0.031105,172.31.40.0-255,66,195160,64,259004
45048,0.033703,172.217.194.0-255,5738,200898,64,259004
45049,0.03371,172.31.40.0-255,66,200964,64,259004
45050,0.036322,172.217.194.0-255,5738,206702,64,259004
45051,0.036329,172.31.40.0-255,66,206768,64,259004
45052,0.038923,172.217.194.0-255,5738,212506,64,259004
45053,0.03893,172.31.40.0-255,66,212572,64,259004
45054,0.041526,172.217.194.0-255,5738,218310,64,259004
45055,0.041533,172.31.40.0-255,66,218376,64,259004
45056,0.044195,172.217.194.0-255,5738,224114,64,259004
45057,0.044206,172.31.40.0-255,66,224180,64,259004
45058,0.046784,172.217.194.0-255,5738,229918,64,259004
45059,0.046791,172.31.40.0-255,66,229984,64,259004
45060,0.049383,172.217.194.0-255,5738,235722,64,259004
45061,0.049391,172.31.40.0-255,66,235788,64,259004
45062,0.051965,172.217.194.0-255,5738,241526,64,259004
45063,0.051971,172.31.40.0-255,66,241592,64,259004
45064,0.054556,172.217.194.0-255,5738,247330,64,259004
45065,0.054563,172.31.40.0-255,66,247396,64,259004
45066,0.057145,172.217.194.0-255,5738,253134,64,259004
45067,0.057152,172.31.40.0-255,66,253200,64,259004
45068,0.059778,172.217.194.0-255,5738,258938,64,259004
45069,0.059785,172.31.40.0-255,66,259004,64,259004
45070,0.0,74.125.200.0-255,153,153,64,288644
45071,2.4e-05,172.31.40.0-255,66,219,64,288644
45072,3.1e-05,74.125.200.0-255,1484,1703,64,288644
45073,3.5e-05,172.31.40.0-255,66,1769,64,288644
45074,3.9e-05,74.125.200.0-255,1484,3253,64,288644
45075,5e-05,172.31.40.0-255,66,3319,64,288644
45076,5.8e-05,74.125.200.0-255,2902,6221,64,288644
45077,6e-05,172.31.40.0-255,66,6287,64,288644
45078,6.7e-05,74.125.200.0-255,5738,12025,64,288644
45079,6.9e-05,172.31.40.0-255,66,12091,64,288644
45080,0.000103,74.125.200.0-255,2102,14193,64,288644
45081,0.000107,172.31.40.0-255,66,14259,64,288644
45082,0.000245,74.125.200.0-255,1484,15743,64,288644
45083,0.00025,172.31.40.0-255,66,15809,64,288644
45084,0.000255,74.125.200.0-255,2902,18711,64,288644
45085,0.000257,172.31.40.0-255,66,18777,64,288644
45086,0.00029,74.125.200.0-255,5738,24515,64,288644
45087,0.000293,172.31.40.0-255,66,24581,64,288644
45088,0.000323,74.125.200.0-255,6797,31378,64,288644
45089,0.000326,172.31.40.0-255,66,31444,64,288644
45090,0.000369,74.125.200.0-255,7156,38600,64,288644
45091,0.000372,172.31.40.0-255,66,38666,64,288644
45092,0.000379,74.125.200.0-255,7156,45822,64,288644
45093,0.000381,172.31.40.0-255,66,45888,64,288644
45094,0.000397,172.31.40.0-255,66,45954,64,288644
45095,0.00041,172.31.40.0-255,66,46020,64,288644
45096,0.000481,74.125.200.0-255,395,46415,64,288644
45097,0.000484,172.31.40.0-255,66,46481,64,288644
45098,0.000505,74.125.200.0-255,111,46592,64,288644
45099,0.000508,172.31.40.0-255,66,46658,64,288644
45100,0.000631,74.125.200.0-255,1484,48142,64,288644
45101,0.000635,74.125.200.0-255,1484,49626,64,288644
45102,0.000646,172.31.40.0-255,66,49692,64,288644
45103,0.00065,74.125.200.0-255,1484,51176,64,288644
45104,0.000657,74.125.200.0-255,5738,56914,64,288644
45105,0.000663,172.31.40.0-255,66,56980,64,288644
45106,0.000692,74.125.200.0-255,7156,64136,64,288644
45107,0.000695,172.31.40.0-255,66,64202,64,288644
45108,0.000724,74.125.200.0-255,5738,69940,64,288644
45109,0.00073,74.125.200.0-255,5738,75678,64,288644
45110,0.000735,172.31.40.0-255,66,75744,64,288644
45111,0.000738,172.31.40.0-255,66,75810,64,288644
45112,0.000749,74.125.200.0-255,5020,80830,64,288644
45113,0.000756,172.31.40.0-255,66,80896,64,288644
45114,0.000783,74.125.200.0-255,334,81230,64,288644
45115,0.000917,74.125.200.0-255,1484,82714,64,288644
45116,0.000922,172.31.40.0-255,66,82780,64,288644
45117,0.000948,74.125.200.0-255,1484,84264,64,288644
45118,0.000959,74.125.200.0-255,1484,85748,64,288644
45119,0.000962,172.31.40.0-255,66,85814,64,288644
45120,0.000989,74.125.200.0-255,4320,90134,64,288644
45121,0.000991,172.31.40.0-255,66,90200,64,288644
45122,0.000995,74.125.200.0-255,1484,91684,64,288644
45123,0.001019,74.125.200.0-255,4320,96004,64,288644
45124,0.001022,172.31.40.0-255,66,96070,64,288644
45125,0.001026,74.125.200.0-255,2902,98972,64,288644
45126,0.001028,172.31.40.0-255,66,99038,64,288644
45127,0.001064,172.31.40.0-255,66,99104,64,288644
45128,0.001069,74.125.200.0-255,4320,103424,64,288644
45129,0.001071,172.31.40.0-255,66,103490,64,288644
45130,0.001133,74.125.200.0-255,3602,107092,64,288644
45131,0.001137,172.31.40.0-255,66,107158,64,288644
45132,0.001143,74.125.200.0-255,4320,111478,64,288644
45133,0.001145,172.31.40.0-255,66,111544,64,288644
45134,0.001198,74.125.200.0-255,2902,114446,64,288644
45135,0.001202,172.31.40.0-255,66,114512,64,288644
45136,0.001232,74.125.200.0-255,7156,121668,64,288644
45137,0.001235,172.31.40.0-255,66,121734,64,288644
45138,0.001238,74.125.200.0-255,1484,123218,64,288644
45139,0.001251,172.31.40.0-255,66,123284,64,288644
45140,0.00131,172.31.40.0-255,66,123350,64,288644
45141,0.001348,172.31.40.0-255,66,123416,64,288644
45142,0.001361,172.31.40.0-255,66,123482,64,288644
45143,0.001364,74.125.200.0-255,1484,124966,64,288644
45144,0.001369,74.125.200.0-255,2902,127868,64,288644
45145,0.001371,172.31.40.0-255,66,127934,64,288644
45146,0.001377,74.125.200.0-255,4320,132254,64,288644
45147,0.001379,172.31.40.0-255,66,132320,64,288644
45148,0.00139,172.31.40.0-255,66,132386,64,288644
45149,0.001427,74.125.200.0-255,5738,138124,64,288644
45150,0.001431,172.31.40.0-255,66,138190,64,288644
45151,0.001438,74.125.200.0-255,7156,145346,64,288644
45152,0.001441,172.31.40.0-255,66,145412,64,288644
45153,0.001446,74.125.200.0-255,2902,148314,64,288644
45154,0.001448,172.31.40.0-255,66,148380,64,288644
45155,0.001469,74.125.200.0-255,766,149146,64,288644
45156,0.001475,74.125.200.0-255,4320,153466,64,288644
45157,0.001478,172.31.40.0-255,66,153532,64,288644
45158,0.001506,74.125.200.0-255,7156,160688,64,288644
45159,0.001509,172.31.40.0-255,66,160754,64,288644
45160,0.001546,74.125.200.0-255,1484,162238,64,288644
45161,0.001564,172.31.40.0-255,66,162304,64,288644
45162,0.001576,172.31.40.0-255,66,162370,64,288644
45163,0.001707,74.125.200.0-255,1484,163854,64,288644
45164,0.001711,74.125.200.0-255,1484,165338,64,288644
45165,0.001714,172.31.40.0-255,66,165404,64,288644
45166,0.001741,74.125.200.0-255,1484,166888,64,288644
45167,0.001747,74.125.200.0-255,5738,172626,64,288644
45168,0.00175,172.31.40.0-255,66,172692,64,288644
45169,0.001775,74.125.200.0-255,7156,179848,64,288644
45170,0.001777,172.31.40.0-255,66,179914,64,288644
45171,0.001783,74.125.200.0-255,4320,184234,64,288644
45172,0.001785,172.31.40.0-255,66,184300,64,288644
45173,0.001819,74.125.200.0-255,4320,188620,64,288644
45174,0.001822,172.31.40.0-255,66,188686,64,288644
45175,0.00183,74.125.200.0-255,7156,195842,64,288644
45176,0.001832,172.31.40.0-255,66,195908,64,288644
45177,0.001858,74.125.200.0-255,766,196674,64,288644
45178,0.001949,74.125.200.0-255,1484,198158,64,288644
45179,0.001954,172.31.40.0-255,66,198224,64,288644
45180,0.00196,74.125.200.0-255,2902,201126,64,288644
45181,0.001963,172.31.40.0-255,66,201192,64,288644
45182,0.001997,74.125.200.0-255,5738,206930,64,288644
45183,0.002,172.31.40.0-255,66,206996,64,288644
45184,0.002012,74.125.200.0-255,2902,209898,64,288644
45185,0.002019,172.31.40.0-255,66,209964,64,288644
45186,0.002047,74.125.200.0-255,7156,217120,64,288644
45187,0.002053,74.125.200.0-255,5738,222858,64,288644
45188,0.002057,172.31.40.0-255,66,222924,64,288644
45189,0.00206,172.31.40.0-255,66,222990,64,288644
45190,0.002071,74.125.200.0-255,5738,228728,64,288644
45191,0.002074,172.31.40.0-255,66,228794,64,288644
45192,0.002078,74.125.200.0-255,2184,230978,64,288644
45193,0.00208,172.31.40.0-255,66,231044,64,288644
45194,0.002089,74.125.200.0-255,2902,233946,64,288644
45195,0.002092,172.31.40.0-255,66,234012,64,288644
45196,0.002099,74.125.200.0-255,7156,241168,64,288644
45197,0.002102,172.31.40.0-255,66,241234,64,288644
45198,0.002105,74.125.200.0-255,1484,242718,64,288644
45199,0.002148,172.31.40.0-255,66,242784,64,288644
45200,0.002161,172.31.40.0-255,66,242850,64,288644
45201,0.002165,74.125.200.0-255,2184,245034,64,288644
45202,0.002167,172.31.40.0-255,66,245100,64,288644
45203,0.002171,74.125.200.0-255,2902,248002,64,288644
45204,0.002173,172.31.40.0-255,66,248068,64,288644
45205,0.002235,74.125.200.0-255,7156,255224,64,288644
45206,0.002238,172.31.40.0-255,66,255290,64,288644
45207,0.002243,74.125.200.0-255,4320,259610,64,288644
45208,0.002246,172.31.40.0-255,66,259676,64,288644
45209,0.002252,74.125.200.0-255,5738,265414,64,288644
45210,0.002254,172.31.40.0-255,66,265480,64,288644
45211,0.002258,74.125.200.0-255,2902,268382,64,288644
45212,0.00226,172.31.40.0-255,66,268448,64,288644
45213,0.002294,74.125.200.0-255,4320,272768,64,288644
45214,0.002298,172.31.40.0-255,66,272834,64,288644
45215,0.004493,74.125.200.0-255,1484,274318,64,288644
45216,0.004536,74.125.200.0-255,4320,278638,64,288644
45217,0.004546,172.31.40.0-255,66,278704,64,288644
45218,0.006812,74.125.200.0-255,5411,284115,64,288644
45219,0.006819,172.31.40.0-255,66,284181,64,288644
45220,0.017847,172.31.40.0-255,105,284286,64,288644
45221,0.020065,74.125.200.0-255,66,284352,64,288644
45222,0.050692,172.31.40.0-255,172,284524,64,288644
45223,0.050726,172.31.40.0-255,1113,285637,64,288644
45224,0.050788,172.31.40.0-255,1514,287151,64,288644
45225,0.050789,172.31.40.0-255,1295,288446,64,288644
45226,0.052238,104.244.42.0-255,66,288512,64,288644
45227,0.052417,104.244.42.0-255,66,288578,64,288644
45228,0.052421,104.244.42.0-255,66,288644,64,288644
45229,0.0,172.217.194.0-255,153,153,64,199490
45230,1.9e-05,172.31.40.0-255,66,219,64,199490
45231,2.6e-05,172.217.194.0-255,1484,1703,64,199490
45232,3e-05,172.31.40.0-255,66,1769,64,199490
45233,3.5e-05,172.217.194.0-255,2902,4671,64,199490
45234,3.7e-05,172.31.40.0-255,66,4737,64,199490
45235,4.4e-05,172.217.194.0-255,7156,11893,64,199490
45236,4.8e-05,172.31.40.0-255,66,11959,64,199490
45237,5.4e-05,172.217.194.0-255,3400,15359,64,199490
45238,5.6e-05,172.31.40.0-255,66,15425,64,199490
45239,0.0001,172.31.40.0-255,66,15491,64,199490
45240,0.00011,172.31.40.0-255,66,15557,64,199490
45241,0.000139,172.31.40.0-255,66,15623,64,199490
45242,0.000142,172.217.194.0-255,1484,17107,64,199490
45243,0.000144,172.31.40.0-255,66,17173,64,199490
45244,0.000183,172.31.40.0-255,66,17239,64,199490
45245,0.000252,172.217.194.0-255,1484,18723,64,199490
45246,0.000255,172.31.40.0-255,66,18789,64,199490
45247,0.000258,172.217.194.0-255,1484,20273,64,199490
45248,0.00026,172.31.40.0-255,66,20339,64,199490
45249,0.000283,172.217.194.0-255,1484,21823,64,199490
45250,0.000287,172.31.40.0-255,66,21889,64,199490
45251,0.000293,172.217.194.0-255,5738,27627,64,199490
45252,0.000295,172.31.40.0-255,66,27693,64,199490
45253,0.00032,172.31.40.0-255,66,27759,64,199490
45254,0.000343,172.217.194.0-255,4320,32079,64,199490
45255,0.000345,172.31.40.0-255,66,32145,64,199490
45256,0.000351,172.217.194.0-255,5738,37883,64,199490
45257,0.000354,172.31.40.0-255,66,37949,64,199490
45258,0.000368,172.217.194.0-255,5020,42969,64,199490
45259,0.000371,172.31.40.0-255,66,43035,64,199490
45260,0.000395,172.217.194.0-255,1484,44519,64,199490
45261,0.0004,172.217.194.0-255,2902,47421,64,199490
45262,0.000403,172.31.40.0-255,66,47487,64,199490
45263,0.000417,172.217.194.0-255,2902,50389,64,199490
45264,0.00042,172.31.40.0-255,66,50455,64,199490
45265,0.000432,172.217.194.0-255,2902,53357,64,199490
45266,0.000435,172.31.40.0-255,66,53423,64,199490
45267,0.000438,172.217.194.0-255,1484,54907,64,199490
45268,0.000475,172.31.40.0-255,66,54973,64,199490
45269,0.000486,172.31.40.0-255,66,55039,64,199490
45270,0.000503,172.217.194.0-255,1484,56523,64,199490
45271,0.000506,172.217.194.0-255,1484,58007,64,199490
45272,0.000508,172.31.40.0-255,66,58073,64,199490
45273,0.000531,172.217.194.0-255,1484,59557,64,199490
45274,0.000536,172.217.194.0-255,5738,65295,64,199490
45275,0.000539,172.31.40.0-255,66,65361,64,199490
45276,0.000566,172.31.40.0-255,66,65427,64,199490
45277,0.000596,172.217.194.0-255,1994,67421,64,199490
45278,0.000598,172.31.40.0-255,66,67487,64,199490
45279,0.00061,172.31.40.0-255,66,67553,64,199490
45280,0.000655,172.217.194.0-255,5738,73291,64,199490
45281,0.000657,172.31.40.0-255,66,73357,64,199490
45282,0.000685,172.31.40.0-255,66,73423,64,199490
45283,0.000688,172.217.194.0-255,1484,74907,64,199490
45284,0.000692,172.217.194.0-255,2902,77809,64,199490
45285,0.000694,172.31.40.0-255,66,77875,64,199490
45286,0.0007,172.217.194.0-255,5738,83613,64,199490
45287,0.000702,172.31.40.0-255,66,83679,64,199490
45288,0.000706,172.217.194.0-255,2902,86581,64,199490
45289,0.000709,172.31.40.0-255,66,86647,64,199490
45290,0.000742,172.31.40.0-255,66,86713,64,199490
45291,0.000791,172.31.40.0-255,66,86779,64,199490
45292,0.001008,172.217.194.0-255,1484,88263,64,199490
45293,0.001014,172.217.194.0-255,2902,91165,64,199490
45294,0.001017,172.31.40.0-255,66,91231,64,199490
45295,0.001042,172.217.194.0-255,5738,96969,64,199490
45296,0.001046,172.31.40.0-255,66,97035,64,199490
45297,0.001065,172.217.194.0-255,2902,99937,64,199490
45298,0.001067,172.31.40.0-255,66,100003,64,199490
45299,0.001087,172.217.194.0-255,7156,107159,64,199490
45300,0.001089,172.31.40.0-255,66,107225,64,199490
45301,0.001117,172.217.194.0-255,2902,110127,64,199490
45302,0.00112,172.31.40.0-255,66,110193,64,199490
45303,0.00113,172.31.40.0-255,66,110259,64,199490
45304,0.001134,172.217.194.0-255,2184,112443,64,199490
45305,0.001136,172.31.40.0-255,66,112509,64,199490
45306,0.001145,172.217.194.0-255,2902,115411,64,199490
45307,0.001148,172.31.40.0-255,66,115477,64,199490
45308,0.001153,172.217.194.0-255,5738,121215,64,199490
45309,0.001156,172.31.40.0-255,66,121281,64,199490
45310,0.00117,172.217.194.0-255,1484,122765,64,199490
45311,0.001176,172.217.194.0-255,7156,129921,64,199490
45312,0.001181,172.31.40.0-255,66,129987,64,199490
45313,0.001192,172.217.194.0-255,5738,135725,64,199490
45314,0.001194,172.31.40.0-255,66,135791,64,199490
45315,0.001233,172.31.40.0-255,66,135857,64,199490
45316,0.001244,172.31.40.0-255,66,135923,64,199490
45317,0.001292,172.217.194.0-255,4320,140243,64,199490
45318,0.001295,172.31.40.0-255,66,140309,64,199490
45319,0.001319,172.31.40.0-255,66,140375,64,199490
45320,0.001331,172.217.194.0-255,5020,145395,64,199490
45321,0.001334,172.31.40.0-255,66,145461,64,199490
45322,0.001338,172.217.194.0-255,2902,148363,64,199490
45323,0.001341,172.31.40.0-255,66,148429,64,199490
45324,0.001346,172.217.194.0-255,4320,152749,64,199490
45325,0.001349,172.31.40.0-255,66,152815,64,199490
45326,0.001353,172.217.194.0-255,4320,157135,64,199490
45327,0.001356,172.31.40.0-255,66,157201,64,199490
45328,0.00138,172.217.194.0-255,4320,161521,64,199490
45329,0.001399,172.31.40.0-255,66,161587,64,199490
45330,0.001453,172.217.194.0-255,5020,166607,64,199490
45331,0.001456,172.31.40.0-255,66,166673,64,199490
45332,0.001568,172.217.194.0-255,1484,168157,64,199490
45333,0.001573,172.217.194.0-255,2902,171059,64,199490
45334,0.001582,172.31.40.0-255,66,171125,64,199490
45335,0.001586,172.217.194.0-255,2902,174027,64,199490
45336,0.001591,172.31.40.0-255,66,174093,64,199490
45337,0.001599,172.217.194.0-255,2902,176995,64,199490
45338,0.001601,172.217.194.0-255,1484,178479,64,199490
45339,0.001622,172.217.194.0-255,7156,185635,64,199490
45340,0.00163,172.31.40.0-255,66,185701,64,199490
45341,0.001647,172.217.194.0-255,4320,190021,64,199490
45342,0.001673,172.31.40.0-255,66,190087,64,199490
45343,0.001709,172.217.194.0-255,5738,195825,64,199490
45344,0.001737,172.217.194.0-255,105,195930,64,199490
45345,0.001743,172.31.40.0-255,66,195996,64,199490
45346,0.013234,172.31.40.0-255,105,196101,64,199490
45347,0.015529,172.217.194.0-255,66,196167,64,199490
45348,0.046948,172.31.40.0-255,166,196333,64,199490
45349,0.046986,172.31.40.0-255,1132,197465,64,199490
45350,0.047048,172.31.40.0-255,1514,198979,64,199490
45351,0.04705,172.31.40.0-255,313,199292,64,199490
45352,0.048504,104.244.42.0-255,66,199358,64,199490
45353,0.048546,104.244.42.0-255,66,199424,64,199490
45354,0.048582,104.244.42.0-255,66,199490,64,199490
45355,0.0,172.31.40.0-255,105,105,64,459
45356,0.000276,172.31.40.0-255,90,195,64,459
45357,0.000285,172.31.40.0-255,66,261,64,459
45358,0.002591,172.217.194.0-255,66,327,64,459
45359,0.002628,172.217.194.0-255,66,393,64,459
45360,0.002642,172.31.40.0-255,66,459,64,459
45361,0.0,172.217.160.0-255,155,155,64,250942
45362,2.3e-05,172.31.40.0-255,66,221,64,250942
45363,3e-05,172.217.160.0-255,1484,1705,64,250942
45364,3.6e-05,172.31.40.0-255,66,1771,64,250942
45365,4.1e-05,172.217.160.0-255,2902,4673,64,250942
45366,4.4e-05,172.31.40.0-255,66,4739,64,250942
45367,5.1e-05,172.217.160.0-255,7156,11895,64,250942
45368,5.4e-05,172.31.40.0-255,66,11961,64,250942
45369,5.9e-05,172.217.160.0-255,2902,14863,64,250942
45370,6.2e-05,172.31.40.0-255,66,14929,64,250942
45371,9.3e-05,172.31.40.0-255,66,14995,64,250942
45372,9.7e-05,172.217.160.0-255,2543,17538,64,250942
45373,9.9e-05,172.31.40.0-255,66,17604,64,250942
45374,0.000126,172.217.160.0-255,5738,23342,64,250942
45375,0.000128,172.31.40.0-255,66,23408,64,250942
45376,0.000157,172.31.40.0-255,66,23474,64,250942
45377,0.00039,172.217.160.0-255,1484,24958,64,250942
45378,0.000396,172.31.40.0-255,66,25024,64,250942
45379,0.000402,172.217.160.0-255,2902,27926,64,250942
45380,0.000405,172.31.40.0-255,66,27992,64,250942
45381,0.000411,172.217.160.0-255,5738,33730,64,250942
45382,0.000414,172.31.40.0-255,66,33796,64,250942
45383,0.00044,172.217.160.0-255,7104,40900,64,250942
45384,0.000443,172.31.40.0-255,66,40966,64,250942
45385,0.000479,172.217.160.0-255,369,41335,64,250942
45386,0.000482,172.31.40.0-255,66,41401,64,250942
45387,0.000553,172.217.160.0-255,1484,42885,64,250942
45388,0.000557,172.31.40.0-255,66,42951,64,250942
45389,0.000591,172.217.160.0-255,2902,45853,64,250942
45390,0.000594,172.31.40.0-255,66,45919,64,250942
45391,0.000599,172.217.160.0-255,4320,50239,64,250942
45392,0.000602,172.31.40.0-255,66,50305,64,250942
45393,0.000618,172.217.160.0-255,1484,51789,64,250942
45394,0.000641,172.31.40.0-255,66,51855,64,250942
45395,0.000646,172.217.160.0-255,5738,57593,64,250942
45396,0.000649,172.31.40.0-255,66,57659,64,250942
45397,0.000682,172.217.160.0-255,4320,61979,64,250942
45398,0.000684,172.31.40.0-255,66,62045,64,250942
45399,0.000706,172.217.160.0-255,5379,67424,64,250942
45400,0.000709,172.31.40.0-255,66,67490,64,250942
45401,0.000728,172.31.40.0-255,66,67556,64,250942
45402,0.000744,172.217.160.0-255,1484,69040,64,250942
45403,0.000751,172.217.160.0-255,6131,75171,64,250942
45404,0.000784,172.217.160.0-255,201,75372,64,250942
45405,0.000892,172.217.160.0-255,1484,76856,64,250942
45406,0.000899,172.217.160.0-255,2902,79758,64,250942
45407,0.000922,172.217.160.0-255,5738,85496,64,250942
45408,0.000938,172.217.160.0-255,2902,88398,64,250942
45409,0.000957,172.217.160.0-255,7156,95554,64,250942
45410,0.000981,172.217.160.0-255,2902,98456,64,250942
45411,0.000989,172.217.160.0-255,7156,105612,64,250942
45412,0.001041,172.217.160.0-255,2570,108182,64,250942
45413,0.001055,172.217.160.0-255,1484,109666,64,250942
45414,0.001058,172.217.160.0-255,1484,111150,64,250942
45415,0.001082,172.217.160.0-255,1484,112634,64,250942
45416,0.001089,172.217.160.0-255,5738,118372,64,250942
45417,0.001145,172.217.160.0-255,5738,124110,64,250942
45418,0.001188,172.31.40.0-255,66,124176,64,250942
45419,0.001242,172.217.160.0-255,1484,125660,64,250942
45420,0.001247,172.217.160.0-255,2902,128562,64,250942
45421,0.001268,172.217.160.0-255,5738,134300,64,250942
45422,0.001271,172.217.160.0-255,1484,135784,64,250942
45423,0.001349,172.217.160.0-255,5738,141522,64,250942
45424,0.001399,172.217.160.0-255,1484,143006,64,250942
45425,0.001402,172.217.160.0-255,766,143772,64,250942
45426,0.001472,172.217.160.0-255,1484,145256,64,250942
45427,0.001477,172.217.160.0-255,2902,148158,64,250942
45428,0.001487,172.217.160.0-255,5738,153896,64,250942
45429,0.001492,172.217.160.0-255,4320,158216,64,250942
45430,0.001513,172.217.160.0-255,2902,161118,64,250942
45431,0.001535,172.31.40.0-255,66,161184,64,250942
45432,0.001551,172.217.160.0-255,3602,164786,64,250942
45433,0.001562,172.31.40.0-255,66,164852,64,250942
45434,0.001652,172.217.160.0-255,1484,166336,64,250942
45435,0.001656,172.217.160.0-255,1484,167820,64,250942
45436,0.001669,172.217.160.0-255,1484,169304,64,250942
45437,0.001674,172.217.160.0-255,4320,173624,64,250942
45438,0.001676,172.31.40.0-255,66,173690,64,250942
45439,0.001682,172.31.40.0-255,66,173756,64,250942
45440,0.001689,172.217.160.0-255,1484,175240,64,250942
45441,0.001725,172.217.160.0-255,5738,180978,64,250942
45442,0.001727,172.217.160.0-255,1484,182462,64,250942
45443,0.00173,172.217.160.0-255,1484,183946,64,250942
45444,0.001751,172.217.160.0-255,2184,186130,64,250942
45445,0.001761,172.31.40.0-255,66,186196,64,250942
45446,0.001878,172.217.160.0-255,1484,187680,64,250942
45447,0.001903,172.217.160.0-255,2902,190582,64,250942
45448,0.001907,172.217.160.0-255,1484,192066,64,250942
45449,0.001959,172.217.160.0-255,4320,196386,64,250942
45450,0.001968,172.31.40.0-255,66,196452,64,250942
45451,0.001984,172.217.160.0-255,1484,197936,64,250942
45452,0.002001,172.217.160.0-255,5738,203674,64,250942
45453,0.002016,172.217.160.0-255,3602,207276,64,250942
45454,0.002023,172.31.40.0-255,66,207342,64,250942
45455,0.002062,172.217.160.0-255,4320,211662,64,250942
45456,0.002073,172.217.160.0-255,1484,213146,64,250942
45457,0.002078,172.31.40.0-255,66,213212,64,250942
45458,0.002089,172.217.160.0-255,4320,217532,64,250942
45459,0.002117,172.217.160.0-255,2902,220434,64,250942
45460,0.002121,172.31.40.0-255,66,220500,64,250942
45461,0.002126,172.31.40.0-255,66,220566,64,250942
45462,0.00214,172.217.160.0-255,2902,223468,64,250942
45463,0.002148,172.217.160.0-255,7156,230624,64,250942
45464,0.002157,172.31.40.0-255,66,230690,64,250942
45465,0.002165,172.217.160.0-255,1484,232174,64,250942
45466,0.002186,172.217.160.0-255,1484,233658,64,250942
45467,0.00222,172.217.160.0-255,4320,237978,64,250942
45468,0.002245,172.217.160.0-255,6483,244461,64,250942
45469,0.00225,172.31.40.0-255,66,244527,64,250942
45470,0.002263,172.217.160.0-255,105,244632,64,250942
45471,0.002265,172.31.40.0-255,66,244698,64,250942
45472,0.016293,172.31.40.0-255,66,244764,64,250942
45473,0.016342,172.31.40.0-255,105,244869,64,250942
45474,0.017954,172.217.160.0-255,66,244935,64,250942
45475,0.040771,172.31.40.0-255,172,245107,64,250942
45476,0.040806,172.31.40.0-255,1107,246214,64,250942
45477,0.04089,172.31.40.0-255,1514,247728,64,250942
45478,0.040892,172.31.40.0-255,1514,249242,64,250942
45479,0.040894,172.31.40.0-255,1514,250756,64,250942
45480,0.040894,172.31.40.0-255,120,250876,64,250942
45481,0.042973,104.244.42.0-255,66,250942,64,250942
45482,0.0,74.125.24.0-255,153,153,64,202123
45483,2.6e-05,172.31.40.0-255,66,219,64,202123
45484,3.4e-05,74.125.24.0-255,1484,1703,64,202123
45485,3.8e-05,172.31.40.0-255,66,1769,64,202123
45486,4.5e-05,74.125.24.0-255,2902,4671,64,202123
45487,4.9e-05,172.31.40.0-255,66,4737,64,202123
45488,5.6e-05,74.125.24.0-255,7156,11893,64,202123
45489,5.9e-05,172.31.40.0-255,66,11959,64,202123
45490,6.5e-05,74.125.24.0-255,3444,15403,64,202123
45491,6.8e-05,172.31.40.0-255,66,15469,64,202123
45492,9.1e-05,74.125.24.0-255,2902,18371,64,202123
45493,9.4e-05,172.31.40.0-255,66,18437,64,202123
45494,0.000116,172.31.40.0-255,66,18503,64,202123
45495,0.00012,74.125.24.0-255,2543,21046,64,202123
45496,0.000122,172.31.40.0-255,66,21112,64,202123
45497,0.000295,74.125.24.0-255,1484,22596,64,202123
45498,0.000301,172.31.40.0-255,66,22662,64,202123
45499,0.000314,74.125.24.0-255,2902,25564,64,202123
45500,0.000317,172.31.40.0-255,66,25630,64,202123
45501,0.000346,74.125.24.0-255,4320,29950,64,202123
45502,0.000348,172.31.40.0-255,66,30016,64,202123
45503,0.000367,74.125.24.0-255,5738,35754,64,202123
45504,0.00037,172.31.40.0-255,66,35820,64,202123
45505,0.000399,74.125.24.0-255,2543,38363,64,202123
45506,0.000402,172.31.40.0-255,66,38429,64,202123
45507,0.000414,172.31.40.0-255,66,38495,64,202123
45508,0.000424,172.31.40.0-255,66,38561,64,202123
45509,0.000452,74.125.24.0-255,132,38693,64,202123
45510,0.000455,172.31.40.0-255,66,38759,64,202123
45511,0.000548,74.125.24.0-255,1484,40243,64,202123
45512,0.000554,74.125.24.0-255,2902,43145,64,202123
45513,0.000557,172.31.40.0-255,66,43211,64,202123
45514,0.000563,74.125.24.0-255,4320,47531,64,202123
45515,0.000566,172.31.40.0-255,66,47597,64,202123
45516,0.000581,74.125.24.0-255,1484,49081,64,202123
45517,0.000593,74.125.24.0-255,1484,50565,64,202123
45518,0.000596,172.31.40.0-255,66,50631,64,202123
45519,0.000641,172.31.40.0-255,66,50697,64,202123
45520,0.000654,172.31.40.0-255,66,50763,64,202123
45521,0.00097,74.125.24.0-255,1484,52247,64,202123
45522,0.000977,74.125.24.0-255,2902,55149,64,202123
45523,0.00098,172.31.40.0-255,66,55215,64,202123
45524,0.000985,74.125.24.0-255,2902,58117,64,202123
45525,0.000987,172.31.40.0-255,66,58183,64,202123
45526,0.001003,74.125.24.0-255,2902,61085,64,202123
45527,0.001008,74.125.24.0-255,4320,65405,64,202123
45528,0.001011,172.31.40.0-255,66,65471,64,202123
45529,0.001014,172.31.40.0-255,66,65537,64,202123
45530,0.001044,172.31.40.0-255,66,65603,64,202123
45531,0.001058,172.31.40.0-255,66,65669,64,202123
45532,0.001532,74.125.24.0-255,1484,67153,64,202123
45533,0.001551,74.125.24.0-255,2902,70055,64,202123
45534,0.001555,172.31.40.0-255,66,70121,64,202123
45535,0.001559,74.125.24.0-255,1484,71605,64,202123
45536,0.001581,74.125.24.0-255,4320,75925,64,202123
45537,0.001584,172.31.40.0-255,66,75991,64,202123
45538,0.001587,74.125.24.0-255,1484,77475,64,202123
45539,0.00159,74.125.24.0-255,1484,78959,64,202123
45540,0.001591,172.31.40.0-255,66,79025,64,202123
45541,0.001615,74.125.24.0-255,1484,80509,64,202123
45542,0.001621,74.125.24.0-255,4320,84829,64,202123
45543,0.001623,172.31.40.0-255,66,84895,64,202123
45544,0.001642,74.125.24.0-255,1484,86379,64,202123
45545,0.001655,172.31.40.0-255,66,86445,64,202123
45546,0.001674,74.125.24.0-255,2902,89347,64,202123
45547,0.001676,172.31.40.0-255,66,89413,64,202123
45548,0.001679,74.125.24.0-255,766,90179,64,202123
45549,0.001871,74.125.24.0-255,1484,91663,64,202123
45550,0.001875,172.31.40.0-255,66,91729,64,202123
45551,0.001881,74.125.24.0-255,2902,94631,64,202123
45552,0.001884,172.31.40.0-255,66,94697,64,202123
45553,0.001887,74.125.24.0-255,1484,96181,64,202123
45554,0.001905,74.125.24.0-255,4320,100501,64,202123
45555,0.00191,172.31.40.0-255,66,100567,64,202123
45556,0.001946,172.31.40.0-255,66,100633,64,202123
45557,0.001953,74.125.24.0-255,7156,107789,64,202123
45558,0.001955,172.31.40.0-255,66,107855,64,202123
45559,0.001985,74.125.24.0-255,1484,109339,64,202123
45560,0.002002,74.125.24.0-255,2184,111523,64,202123
45561,0.002005,172.31.40.0-255,66,111589,64,202123
45562,0.00208,74.125.24.0-255,1484,113073,64,202123
45563,0.002084,74.125.24.0-255,1484,114557,64,202123
45564,0.002087,172.31.40.0-255,66,114623,64,202123
45565,0.002099,74.125.24.0-255,1484,116107,64,202123
45566,0.002105,74.125.24.0-255,5738,121845,64,202123
45567,0.002108,172.31.40.0-255,66,121911,64,202123
45568,0.002126,74.125.24.0-255,2902,124813,64,202123
45569,0.002128,172.31.40.0-255,66,124879,64,202123
45570,0.002154,172.31.40.0-255,66,124945,64,202123
45571,0.002158,74.125.24.0-255,2902,127847,64,202123
45572,0.00216,172.31.40.0-255,66,127913,64,202123
45573,0.002199,172.31.40.0-255,66,127979,64,202123
45574,0.002233,74.125.24.0-255,1484,129463,64,202123
45575,0.002238,74.125.24.0-255,2902,132365,64,202123
45576,0.002242,172.31.40.0-255,66,132431,64,202123
45577,0.002264,74.125.24.0-255,5738,138169,64,202123
45578,0.002267,172.31.40.0-255,66,138235,64,202123
45579,0.002301,172.31.40.0-255,66,138301,64,202123
45580,0.002321,74.125.24.0-255,2902,141203,64,202123
45581,0.002324,172.31.40.0-255,66,141269,64,202123
45582,0.002335,172.31.40.0-255,66,141335,64,202123
45583,0.002361,74.125.24.0-255,5020,146355,64,202123
45584,0.002364,172.31.40.0-255,66,146421,64,202123
45585,0.002367,74.125.24.0-255,1484,147905,64,202123
45586,0.002388,74.125.24.0-255,5738,153643,64,202123
45587,0.002391,172.31.40.0-255,66,153709,64,202123
45588,0.002398,74.125.24.0-255,7156,160865,64,202123
45589,0.0024,172.31.40.0-255,66,160931,64,202123
45590,0.002481,74.125.24.0-255,1484,162415,64,202123
45591,0.002487,74.125.24.0-255,4320,166735,64,202123
45592,0.002501,74.125.24.0-255,2902,169637,64,202123
45593,0.002515,74.125.24.0-255,4320,173957,64,202123
45594,0.002589,74.125.24.0-255,5738,179695,64,202123
45595,0.00262,74.125.24.0-255,4320,184015,64,202123
45596,0.002668,74.125.24.0-255,6438,190453,64,202123
45597,0.002944,74.125.24.0-255,1484,191937,64,202123
45598,0.002949,74.125.24.0-255,1484,193421,64,202123
45599,0.00297,74.125.24.0-255,1484,194905,64,202123
45600,0.002974,74.125.24.0-255,2584,197489,64,202123
45601,0.003013,74.125.24.0-255,105,197594,64,202123
45602,0.008663,172.31.40.0-255,66,197660,64,202123
45603,0.010828,172.31.40.0-255,105,197765,64,202123
45604,0.013074,74.125.24.0-255,66,197831,64,202123
45605,0.039285,172.31.40.0-255,172,198003,64,202123
45606,0.03933,172.31.40.0-255,1112,199115,64,202123
45607,0.039395,172.31.40.0-255,1514,200629,64,202123
45608,0.039397,172.31.40.0-255,1296,201925,64,202123
45609,0.040855,104.244.42.0-255,66,201991,64,202123
45610,0.04091,104.244.42.0-255,66,202057,64,202123
45611,0.041011,104.244.42.0-255,66,202123,64,202123
45612,0.0,172.217.194.0-255,153,153,64,200565
45613,2.2e-05,172.31.40.0-255,66,219,64,200565
45614,3e-05,172.217.194.0-255,1484,1703,64,200565
45615,3.4e-05,172.31.40.0-255,66,1769,64,200565
45616,3.9e-05,172.217.194.0-255,2902,4671,64,200565
45617,5e-05,172.31.40.0-255,66,4737,64,200565
45618,5.8e-05,172.217.194.0-255,7156,11893,64,200565
45619,6e-05,172.31.40.0-255,66,11959,64,200565
45620,7.9e-05,172.31.40.0-255,66,12025,64,200565
45621,8.3e-05,172.217.194.0-255,2543,14568,64,200565
45622,8.7e-05,172.31.40.0-255,66,14634,64,200565
45623,0.000122,172.217.194.0-255,1484,16118,64,200565
45624,0.000124,172.31.40.0-255,66,16184,64,200565
45625,0.000129,172.217.194.0-255,2902,19086,64,200565
45626,0.000132,172.31.40.0-255,66,19152,64,200565
45627,0.00014,172.217.194.0-255,5738,24890,64,200565
45628,0.000148,172.31.40.0-255,66,24956,64,200565
45629,0.000213,172.31.40.0-255,66,25022,64,200565
45630,0.00023,172.31.40.0-255,66,25088,64,200565
45631,0.000234,172.217.194.0-255,1715,26803,64,200565
45632,0.000236,172.31.40.0-255,66,26869,64,200565
45633,0.000347,172.217.194.0-255,1484,28353,64,200565
45634,0.000351,172.31.40.0-255,66,28419,64,200565
45635,0.000356,172.217.194.0-255,2902,31321,64,200565
45636,0.000359,172.31.40.0-255,66,31387,64,200565
45637,0.000371,172.217.194.0-255,5738,37125,64,200565
45638,0.000373,172.31.40.0-255,66,37191,64,200565
45639,0.000437,172.31.40.0-255,66,37257,64,200565
45640,0.000449,172.31.40.0-255,66,37323,64,200565
45641,0.000456,172.217.194.0-255,766,38089,64,200565
45642,0.000839,172.217.194.0-255,1484,39573,64,200565
45643,0.000845,172.31.40.0-255,66,39639,64,200565
45644,0.000851,172.217.194.0-255,2902,42541,64,200565
45645,0.000853,172.31.40.0-255,66,42607,64,200565
45646,0.00086,172.217.194.0-255,5738,48345,64,200565
45647,0.000867,172.31.40.0-255,66,48411,64,200565
45648,0.000871,172.217.194.0-255,1484,49895,64,200565
45649,0.000913,172.31.40.0-255,66,49961,64,200565
45650,0.00092,172.217.194.0-255,7156,57117,64,200565
45651,0.000922,172.31.40.0-255,66,57183,64,200565
45652,0.000948,172.217.194.0-255,3602,60785,64,200565
45653,0.000951,172.31.40.0-255,66,60851,64,200565
45654,0.000958,172.217.194.0-255,1484,62335,64,200565
45655,0.000986,172.217.194.0-255,2902,65237,64,200565
45656,0.000991,172.217.194.0-255,5738,70975,64,200565
45657,0.000998,172.217.194.0-255,7156,78131,64,200565
45658,0.001003,172.31.40.0-255,66,78197,64,200565
45659,0.001011,172.31.40.0-255,66,78263,64,200565
45660,0.001013,172.31.40.0-255,66,78329,64,200565
45661,0.001023,172.217.194.0-255,4320,82649,64,200565
45662,0.001026,172.31.40.0-255,66,82715,64,200565
45663,0.001039,172.31.40.0-255,66,82781,64,200565
45664,0.001089,172.217.194.0-255,1484,84265,64,200565
45665,0.001095,172.217.194.0-255,2902,87167,64,200565
45666,0.001098,172.31.40.0-255,66,87233,64,200565
45667,0.001125,172.217.194.0-255,4320,91553,64,200565
45668,0.001128,172.31.40.0-255,66,91619,64,200565
45669,0.001135,172.217.194.0-255,5738,97357,64,200565
45670,0.001137,172.31.40.0-255,66,97423,64,200565
45671,0.001147,172.217.194.0-255,5738,103161,64,200565
45672,0.001149,172.31.40.0-255,66,103227,64,200565
45673,0.001184,172.217.194.0-255,5738,108965,64,200565
45674,0.001188,172.31.40.0-255,66,109031,64,200565
45675,0.001199,172.31.40.0-255,66,109097,64,200565
45676,0.001228,172.217.194.0-255,1484,110581,64,200565
45677,0.001244,172.217.194.0-255,2902,113483,64,200565
45678,0.001247,172.31.40.0-255,66,113549,64,200565
45679,0.001253,172.217.194.0-255,4320,117869,64,200565
45680,0.001255,172.31.40.0-255,66,117935,64,200565
45681,0.001286,172.217.194.0-255,1484,119419,64,200565
45682,0.001294,172.217.194.0-255,7156,126575,64,200565
45683,0.001296,172.31.40.0-255,66,126641,64,200565
45684,0.00135,172.31.40.0-255,66,126707,64,200565
45685,0.00137,172.217.194.0-255,2902,129609,64,200565
45686,0.001372,172.31.40.0-255,66,129675,64,200565
45687,0.001376,172.217.194.0-255,2184,131859,64,200565
45688,0.001378,172.31.40.0-255,66,131925,64,200565
45689,0.001382,172.217.194.0-255,2902,134827,64,200565
45690,0.001385,172.31.40.0-255,66,134893,64,200565
45691,0.001392,172.217.194.0-255,7156,142049,64,200565
45692,0.001394,172.31.40.0-255,66,142115,64,200565
45693,0.001401,172.217.194.0-255,7156,149271,64,200565
45694,0.001403,172.31.40.0-255,66,149337,64,200565
45695,0.001423,172.31.40.0-255,66,149403,64,200565
45696,0.001426,172.217.194.0-255,766,150169,64,200565
45697,0.001466,172.217.194.0-255,1484,151653,64,200565
45698,0.001468,172.31.40.0-255,66,151719,64,200565
45699,0.001473,172.217.194.0-255,2902,154621,64,200565
45700,0.001476,172.31.40.0-255,66,154687,64,200565
45701,0.001486,172.217.194.0-255,5738,160425,64,200565
45702,0.001489,172.31.40.0-255,66,160491,64,200565
45703,0.001531,172.31.40.0-255,66,160557,64,200565
45704,0.001542,172.31.40.0-255,66,160623,64,200565
45705,0.001573,172.217.194.0-255,2184,162807,64,200565
45706,0.001575,172.31.40.0-255,66,162873,64,200565
45707,0.00158,172.217.194.0-255,2902,165775,64,200565
45708,0.001582,172.31.40.0-255,66,165841,64,200565
45709,0.001621,172.217.194.0-255,7156,172997,64,200565
45710,0.001624,172.31.40.0-255,66,173063,64,200565
45711,0.001631,172.217.194.0-255,5738,178801,64,200565
45712,0.001633,172.31.40.0-255,66,178867,64,200565
45713,0.001647,172.217.194.0-255,7156,186023,64,200565
45714,0.00165,172.31.40.0-255,66,186089,64,200565
45715,0.001695,172.31.40.0-255,66,186155,64,200565
45716,0.001711,172.31.40.0-255,66,186221,64,200565
45717,0.001822,172.31.40.0-255,66,186287,64,200565
45718,0.001846,172.217.194.0-255,5855,192142,64,200565
45719,0.001892,172.217.194.0-255,105,192247,64,200565
45720,0.001904,172.31.40.0-255,66,192313,64,200565
45721,0.004471,172.31.40.0-255,105,192418,64,200565
45722,0.006777,172.217.194.0-255,66,192484,64,200565
45723,0.052121,172.31.40.0-255,172,192656,64,200565
45724,0.052153,172.31.40.0-255,1111,193767,64,200565
45725,0.052215,172.31.40.0-255,1514,195281,64,200565
45726,0.052217,172.31.40.0-255,1514,196795,64,200565
45727,0.052222,172.31.40.0-255,1514,198309,64,200565
45728,0.052223,172.31.40.0-255,1514,199823,64,200565
45729,0.052258,172.31.40.0-255,478,200301,64,200565
45730,0.053661,104.244.42.0-255,66,200367,64,200565
45731,0.053703,104.244.42.0-255,66,200433,64,200565
45732,0.053786,104.244.42.0-255,66,200499,64,200565
45733,0.053805,104.244.42.0-255,66,200565,64,200565
45734,0.0,74.125.24.0-255,146,146,64,210037
45735,2.4e-05,172.31.40.0-255,66,212,64,210037
45736,3.1e-05,74.125.24.0-255,1484,1696,64,210037
45737,3.5e-05,172.31.40.0-255,66,1762,64,210037
45738,3.8e-05,74.125.24.0-255,1484,3246,64,210037
45739,5.5e-05,172.31.40.0-255,66,3312,64,210037
45740,6.2e-05,74.125.24.0-255,4320,7632,64,210037
45741,6.5e-05,172.31.40.0-255,66,7698,64,210037
45742,7.8e-05,172.31.40.0-255,66,7764,64,210037
45743,0.000116,172.31.40.0-255,66,7830,64,210037
45744,0.000137,74.125.24.0-255,5738,13568,64,210037
45745,0.000144,172.31.40.0-255,66,13634,64,210037
45746,0.000182,172.31.40.0-255,66,13700,64,210037
45747,0.000224,172.31.40.0-255,66,13766,64,210037
45748,0.000236,74.125.24.0-255,110,13876,64,210037
45749,0.000245,172.31.40.0-255,66,13942,64,210037
45750,0.000248,74.125.24.0-255,329,14271,64,210037
45751,0.00025,172.31.40.0-255,66,14337,64,210037
45752,0.000545,74.125.24.0-255,1484,15821,64,210037
45753,0.00055,172.31.40.0-255,66,15887,64,210037
45754,0.000557,74.125.24.0-255,2902,18789,64,210037
45755,0.00056,172.31.40.0-255,66,18855,64,210037
45756,0.000587,74.125.24.0-255,5738,24593,64,210037
45757,0.00059,172.31.40.0-255,66,24659,64,210037
45758,0.000597,74.125.24.0-255,5738,30397,64,210037
45759,0.000602,172.31.40.0-255,66,30463,64,210037
45760,0.000628,74.125.24.0-255,5738,36201,64,210037
45761,0.000631,172.31.40.0-255,66,36267,64,210037
45762,0.000636,74.125.24.0-255,2902,39169,64,210037
45763,0.000641,172.31.40.0-255,66,39235,64,210037
45764,0.000669,172.31.40.0-255,66,39301,64,210037
45765,0.001622,74.125.24.0-255,1484,40785,64,210037
45766,0.001633,74.125.24.0-255,2902,43687,64,210037
45767,0.001637,172.31.40.0-255,66,43753,64,210037
45768,0.001645,74.125.24.0-255,5738,49491,64,210037
45769,0.001647,172.31.40.0-255,66,49557,64,210037
45770,0.001652,74.125.24.0-255,4320,53877,64,210037
45771,0.00166,172.31.40.0-255,66,53943,64,210037
45772,0.001684,74.125.24.0-255,1484,55427,64,210037
45773,0.001698,172.31.40.0-255,66,55493,64,210037
45774,0.001705,74.125.24.0-255,5020,60513,64,210037
45775,0.001707,172.31.40.0-255,66,60579,64,210037
45776,0.002328,74.125.24.0-255,1484,62063,64,210037
45777,0.004036,74.125.24.0-255,4320,66383,64,210037
45778,0.004042,172.31.40.0-255,66,66449,64,210037
45779,0.00633,74.125.24.0-255,5738,72187,64,210037
45780,0.006334,172.31.40.0-255,66,72253,64,210037
45781,0.008634,74.125.24.0-255,5738,77991,64,210037
45782,0.008641,172.31.40.0-255,66,78057,64,210037
45783,0.010939,74.125.24.0-255,5738,83795,64,210037
45784,0.010947,172.31.40.0-255,66,83861,64,210037
45785,0.013242,74.125.24.0-255,5738,89599,64,210037
45786,0.013249,172.31.40.0-255,66,89665,64,210037
45787,0.015541,74.125.24.0-255,5738,95403,64,210037
45788,0.015549,172.31.40.0-255,66,95469,64,210037
45789,0.017846,74.125.24.0-255,5738,101207,64,210037
45790,0.017853,172.31.40.0-255,66,101273,64,210037
45791,0.020147,74.125.24.0-255,5738,107011,64,210037
45792,0.020157,172.31.40.0-255,66,107077,64,210037
45793,0.022468,74.125.24.0-255,5738,112815,64,210037
45794,0.022477,172.31.40.0-255,66,112881,64,210037
45795,0.024793,74.125.24.0-255,5738,118619,64,210037
45796,0.024801,172.31.40.0-255,66,118685,64,210037
45797,0.027101,74.125.24.0-255,5738,124423,64,210037
45798,0.027108,172.31.40.0-255,66,124489,64,210037
45799,0.029391,74.125.24.0-255,5738,130227,64,210037
45800,0.029397,172.31.40.0-255,66,130293,64,210037
45801,0.031686,74.125.24.0-255,5738,136031,64,210037
45802,0.031693,172.31.40.0-255,66,136097,64,210037
45803,0.033695,172.31.40.0-255,172,136269,64,210037
45804,0.033727,172.31.40.0-255,1112,137381,64,210037
45805,0.033779,172.31.40.0-255,1514,138895,64,210037
45806,0.033781,172.31.40.0-255,1296,140191,64,210037
45807,0.033989,74.125.24.0-255,5738,145929,64,210037
45808,0.033996,172.31.40.0-255,66,145995,64,210037
45809,0.035242,104.244.42.0-255,66,146061,64,210037
45810,0.03525,104.244.42.0-255,66,146127,64,210037
45811,0.035364,104.244.42.0-255,66,146193,64,210037
45812,0.036285,74.125.24.0-255,5738,151931,64,210037
45813,0.036291,172.31.40.0-255,66,151997,64,210037
45814,0.038601,74.125.24.0-255,5738,157735,64,210037
45815,0.03861,172.31.40.0-255,66,157801,64,210037
45816,0.040914,74.125.24.0-255,5738,163539,64,210037
45817,0.040924,172.31.40.0-255,66,163605,64,210037
45818,0.043217,74.125.24.0-255,5738,169343,64,210037
45819,0.043224,172.31.40.0-255,66,169409,64,210037
45820,0.045527,74.125.24.0-255,5738,175147,64,210037
45821,0.045534,172.31.40.0-255,66,175213,64,210037
45822,0.047825,74.125.24.0-255,5738,180951,64,210037
45823,0.047831,172.31.40.0-255,66,181017,64,210037
45824,0.050128,74.125.24.0-255,5738,186755,64,210037
45825,0.050135,172.31.40.0-255,66,186821,64,210037
45826,0.052454,74.125.24.0-255,5738,192559,64,210037
45827,0.05246,172.31.40.0-255,66,192625,64,210037
45828,0.054757,74.125.24.0-255,5738,198363,64,210037
45829,0.054766,172.31.40.0-255,66,198429,64,210037
45830,0.057051,74.125.24.0-255,5738,204167,64,210037
45831,0.057058,172.31.40.0-255,66,204233,64,210037
45832,0.059351,74.125.24.0-255,5738,209971,64,210037
45833,0.059357,172.31.40.0-255,66,210037,64,210037
45834,0.0,172.31.40.0-255,105,105,64,459
45835,0.000235,172.31.40.0-255,90,195,64,459
45836,0.000246,172.31.40.0-255,66,261,64,459
45837,0.002276,172.217.194.0-255,66,327,64,459
45838,0.002306,172.217.194.0-255,66,393,64,459
45839,0.002332,172.31.40.0-255,66,459,64,459
45840,0.0,172.217.194.0-255,152,152,64,248075
45841,3.4e-05,172.31.40.0-255,66,218,64,248075
45842,4.2e-05,172.217.194.0-255,1484,1702,64,248075
45843,4.6e-05,172.31.40.0-255,66,1768,64,248075
45844,5.2e-05,172.217.194.0-255,2902,4670,64,248075
45845,5.4e-05,172.31.40.0-255,66,4736,64,248075
45846,6.1e-05,172.217.194.0-255,5738,10474,64,248075
45847,6.4e-05,172.31.40.0-255,66,10540,64,248075
45848,6.9e-05,172.217.194.0-255,3392,13932,64,248075
45849,7.1e-05,172.31.40.0-255,66,13998,64,248075
45850,0.000402,172.217.194.0-255,1484,15482,64,248075
45851,0.000409,172.31.40.0-255,66,15548,64,248075
45852,0.000414,172.217.194.0-255,2902,18450,64,248075
45853,0.000417,172.31.40.0-255,66,18516,64,248075
45854,0.000419,172.217.194.0-255,1484,20000,64,248075
45855,0.000421,172.31.40.0-255,66,20066,64,248075
45856,0.00044,172.217.194.0-255,4320,24386,64,248075
45857,0.000443,172.31.40.0-255,66,24452,64,248075
45858,0.000455,172.217.194.0-255,1484,25936,64,248075
45859,0.000458,172.31.40.0-255,66,26002,64,248075
45860,0.00048,172.217.194.0-255,5379,31381,64,248075
45861,0.000483,172.31.40.0-255,66,31447,64,248075
45862,0.000814,172.217.194.0-255,1484,32931,64,248075
45863,0.000819,172.31.40.0-255,66,32997,64,248075
45864,0.000827,172.217.194.0-255,2902,35899,64,248075
45865,0.000829,172.31.40.0-255,66,35965,64,248075
45866,0.000835,172.217.194.0-255,5738,41703,64,248075
45867,0.000837,172.31.40.0-255,66,41769,64,248075
45868,0.000889,172.31.40.0-255,66,41835,64,248075
45869,0.000899,172.31.40.0-255,66,41901,64,248075
45870,0.00092,172.217.194.0-255,1381,43282,64,248075
45871,0.001075,172.217.194.0-255,120,43402,64,248075
45872,0.00125,172.217.194.0-255,1484,44886,64,248075
45873,0.001257,172.31.40.0-255,66,44952,64,248075
45874,0.001262,172.217.194.0-255,2902,47854,64,248075
45875,0.001265,172.31.40.0-255,66,47920,64,248075
45876,0.001271,172.217.194.0-255,5738,53658,64,248075
45877,0.001274,172.31.40.0-255,66,53724,64,248075
45878,0.001317,172.31.40.0-255,66,53790,64,248075
45879,0.001375,172.31.40.0-255,66,53856,64,248075
45880,0.001829,172.217.194.0-255,1484,55340,64,248075
45881,0.001836,172.217.194.0-255,2902,58242,64,248075
45882,0.00184,172.31.40.0-255,66,58308,64,248075
45883,0.001847,172.217.194.0-255,5738,64046,64,248075
45884,0.00185,172.31.40.0-255,66,64112,64,248075
45885,0.001888,172.31.40.0-255,66,64178,64,248075
45886,0.00191,172.31.40.0-255,66,64244,64,248075
45887,0.00193,172.217.194.0-255,2184,66428,64,248075
45888,0.001932,172.31.40.0-255,66,66494,64,248075
45889,0.001993,172.217.194.0-255,1484,67978,64,248075
45890,0.001997,172.217.194.0-255,2902,70880,64,248075
45891,0.002,172.31.40.0-255,66,70946,64,248075
45892,0.002004,172.217.194.0-255,2902,73848,64,248075
45893,0.002006,172.31.40.0-255,66,73914,64,248075
45894,0.002022,172.217.194.0-255,2902,76816,64,248075
45895,0.002024,172.31.40.0-255,66,76882,64,248075
45896,0.002029,172.217.194.0-255,4320,81202,64,248075
45897,0.002031,172.31.40.0-255,66,81268,64,248075
45898,0.00206,172.31.40.0-255,66,81334,64,248075
45899,0.00207,172.31.40.0-255,66,81400,64,248075
45900,0.002097,172.217.194.0-255,2184,83584,64,248075
45901,0.0021,172.31.40.0-255,66,83650,64,248075
45902,0.00212,172.217.194.0-255,2902,86552,64,248075
45903,0.002122,172.31.40.0-255,66,86618,64,248075
45904,0.002127,172.217.194.0-255,2902,89520,64,248075
45905,0.002129,172.31.40.0-255,66,89586,64,248075
45906,0.002145,172.217.194.0-255,4320,93906,64,248075
45907,0.002147,172.31.40.0-255,66,93972,64,248075
45908,0.002163,172.31.40.0-255,66,94038,64,248075
45909,0.0022,172.217.194.0-255,1484,95522,64,248075
45910,0.002228,172.31.40.0-255,66,95588,64,248075
45911,0.002239,172.31.40.0-255,66,95654,64,248075
45912,0.002272,172.31.40.0-255,66,95720,64,248075
45913,0.002307,172.217.194.0-255,7156,102876,64,248075
45914,0.00231,172.31.40.0-255,66,102942,64,248075
45915,0.002329,172.217.194.0-255,3602,106544,64,248075
45916,0.002331,172.31.40.0-255,66,106610,64,248075
45917,0.00235,172.217.194.0-255,7156,113766,64,248075
45918,0.002352,172.31.40.0-255,66,113832,64,248075
45919,0.002372,172.217.194.0-255,4320,118152,64,248075
45920,0.002375,172.31.40.0-255,66,118218,64,248075
45921,0.002395,172.31.40.0-255,66,118284,64,248075
45922,0.002469,172.31.40.0-255,66,118350,64,248075
45923,0.002498,172.31.40.0-255,66,118416,64,248075
45924,0.002501,172.217.194.0-255,2902,121318,64,248075
45925,0.002503,172.31.40.0-255,66,121384,64,248075
45926,0.004839,172.217.194.0-255,5738,127122,64,248075
45927,0.004844,172.31.40.0-255,66,127188,64,248075
45928,0.007202,172.217.194.0-255,5738,132926,64,248075
45929,0.00721,172.31.40.0-255,66,132992,64,248075
45930,0.009576,172.217.194.0-255,5738,138730,64,248075
45931,0.009595,172.31.40.0-255,66,138796,64,248075
45932,0.011942,172.217.194.0-255,5738,144534,64,248075
45933,0.01195,172.31.40.0-255,66,144600,64,248075
45934,0.014293,172.217.194.0-255,5738,150338,64,248075
45935,0.014305,172.31.40.0-255,66,150404,64,248075
45936,0.016648,172.217.194.0-255,5738,156142,64,248075
45937,0.016664,172.31.40.0-255,66,156208,64,248075
45938,0.019017,172.217.194.0-255,5738,161946,64,248075
45939,0.019027,172.31.40.0-255,66,162012,64,248075
45940,0.021348,172.217.194.0-255,5738,167750,64,248075
45941,0.021357,172.31.40.0-255,66,167816,64,248075
45942,0.023705,172.217.194.0-255,5738,173554,64,248075
45943,0.023714,172.31.40.0-255,66,173620,64,248075
45944,0.026061,172.217.194.0-255,5738,179358,64,248075
45945,0.026069,172.31.40.0-255,66,179424,64,248075
45946,0.028419,172.217.194.0-255,5738,185162,64,248075
45947,0.028429,172.31.40.0-255,66,185228,64,248075
45948,0.030783,172.217.194.0-255,5738,190966,64,248075
45949,0.030791,172.31.40.0-255,66,191032,64,248075
45950,0.033122,172.217.194.0-255,5738,196770,64,248075
45951,0.033129,172.31.40.0-255,66,196836,64,248075
45952,0.035517,172.217.194.0-255,5738,202574,64,248075
45953,0.035526,172.31.40.0-255,66,202640,64,248075
45954,0.037874,172.217.194.0-255,5738,208378,64,248075
45955,0.037891,172.31.40.0-255,66,208444,64,248075
45956,0.04024,172.217.194.0-255,5738,214182,64,248075
45957,0.040252,172.31.40.0-255,66,214248,64,248075
45958,0.042625,172.217.194.0-255,5738,219986,64,248075
45959,0.042636,172.31.40.0-255,66,220052,64,248075
45960,0.045,172.217.194.0-255,5738,225790,64,248075
45961,0.045012,172.31.40.0-255,66,225856,64,248075
45962,0.047381,172.217.194.0-255,5738,231594,64,248075
45963,0.047396,172.31.40.0-255,66,231660,64,248075
45964,0.048984,172.31.40.0-255,167,231827,64,248075
45965,0.049018,172.31.40.0-255,1111,232938,64,248075
45966,0.049079,172.31.40.0-255,1514,234452,64,248075
45967,0.049082,172.31.40.0-255,1514,235966,64,248075
45968,0.049106,172.31.40.0-255,697,236663,64,248075
45969,0.049739,172.217.194.0-255,5738,242401,64,248075
45970,0.049745,172.31.40.0-255,66,242467,64,248075
45971,0.050529,104.244.42.0-255,66,242533,64,248075
45972,0.050627,104.244.42.0-255,66,242599,64,248075
45973,0.050678,104.244.42.0-255,66,242665,64,248075
45974,0.050723,104.244.42.0-255,66,242731,64,248075
45975,0.052079,172.217.194.0-255,5107,247838,64,248075
45976,0.052091,172.31.40.0-255,66,247904,64,248075
45977,0.052342,172.31.40.0-255,105,248009,64,248075
45978,0.054638,172.217.194.0-255,66,248075,64,248075
45979,0.0,74.125.24.0-255,152,152,64,232445
45980,2.4e-05,172.31.40.0-255,66,218,64,232445
45981,3.1e-05,74.125.24.0-255,1484,1702,64,232445
45982,3.5e-05,172.31.40.0-255,66,1768,64,232445
45983,4.1e-05,74.125.24.0-255,2902,4670,64,232445
45984,4.4e-05,172.31.40.0-255,66,4736,64,232445
45985,5.3e-05,74.125.24.0-255,7156,11892,64,232445
45986,5.6e-05,172.31.40.0-255,66,11958,64,232445
45987,6.2e-05,74.125.24.0-255,4320,16278,64,232445
45988,6.5e-05,172.31.40.0-255,66,16344,64,232445
45989,0.000111,172.31.40.0-255,66,16410,64,232445
45990,0.000117,74.125.24.0-255,5379,21789,64,232445
45991,0.000119,172.31.40.0-255,66,21855,64,232445
45992,0.000241,74.125.24.0-255,1484,23339,64,232445
45993,0.000245,172.31.40.0-255,66,23405,64,232445
45994,0.000252,74.125.24.0-255,2902,26307,64,232445
45995,0.000254,172.31.40.0-255,66,26373,64,232445
45996,0.00026,74.125.24.0-255,5738,32111,64,232445
45997,0.000263,172.31.40.0-255,66,32177,64,232445
45998,0.000311,74.125.24.0-255,4320,36497,64,232445
45999,0.000314,172.31.40.0-255,66,36563,64,232445
46000,0.000347,172.31.40.0-255,66,36629,64,232445
46001,0.000351,74.125.24.0-255,2902,39531,64,232445
46002,0.000354,172.31.40.0-255,66,39597,64,232445
46003,0.000379,74.125.24.0-255,4320,43917,64,232445
46004,0.000382,172.31.40.0-255,66,43983,64,232445
46005,0.000394,74.125.24.0-255,2543,46526,64,232445
46006,0.000396,172.31.40.0-255,66,46592,64,232445
46007,0.000399,74.125.24.0-255,413,47005,64,232445
46008,0.000401,172.31.40.0-255,66,47071,64,232445
46009,0.000422,74.125.24.0-255,1484,48555,64,232445
46010,0.000427,74.125.24.0-255,1484,50039,64,232445
46011,0.000429,172.31.40.0-255,66,50105,64,232445
46012,0.000453,74.125.24.0-255,2902,53007,64,232445
46013,0.000456,172.31.40.0-255,66,53073,64,232445
46014,0.00046,74.125.24.0-255,2902,55975,64,232445
46015,0.000462,172.31.40.0-255,66,56041,64,232445
46016,0.000485,74.125.24.0-255,7156,63197,64,232445
46017,0.000489,172.31.40.0-255,66,63263,64,232445
46018,0.0005,172.31.40.0-255,66,63329,64,232445
46019,0.000512,172.31.40.0-255,66,63395,64,232445
46020,0.000514,74.125.24.0-255,1484,64879,64,232445
46021,0.000518,74.125.24.0-255,1484,66363,64,232445
46022,0.00052,172.31.40.0-255,66,66429,64,232445
46023,0.000545,74.125.24.0-255,1484,67913,64,232445
46024,0.000553,74.125.24.0-255,5738,73651,64,232445
46025,0.000555,172.31.40.0-255,66,73717,64,232445
46026,0.000584,74.125.24.0-255,6783,80500,64,232445
46027,0.000587,172.31.40.0-255,66,80566,64,232445
46028,0.000898,74.125.24.0-255,1484,82050,64,232445
46029,0.000904,74.125.24.0-255,2902,84952,64,232445
46030,0.000908,172.31.40.0-255,66,85018,64,232445
46031,0.000938,74.125.24.0-255,5738,90756,64,232445
46032,0.000941,172.31.40.0-255,66,90822,64,232445
46033,0.000982,172.31.40.0-255,66,90888,64,232445
46034,0.001013,74.125.24.0-255,4320,95208,64,232445
46035,0.001016,172.31.40.0-255,66,95274,64,232445
46036,0.001028,172.31.40.0-255,66,95340,64,232445
46037,0.001299,74.125.24.0-255,1484,96824,64,232445
46038,0.001306,74.125.24.0-255,2902,99726,64,232445
46039,0.00131,172.31.40.0-255,66,99792,64,232445
46040,0.001316,74.125.24.0-255,4320,104112,64,232445
46041,0.001318,172.31.40.0-255,66,104178,64,232445
46042,0.001331,74.125.24.0-255,1484,105662,64,232445
46043,0.001352,172.31.40.0-255,66,105728,64,232445
46044,0.001376,74.125.24.0-255,4320,110048,64,232445
46045,0.001379,172.31.40.0-255,66,110114,64,232445
46046,0.0014,74.125.24.0-255,5738,115852,64,232445
46047,0.001403,172.31.40.0-255,66,115918,64,232445
46048,0.001432,74.125.24.0-255,5020,120938,64,232445
46049,0.001435,172.31.40.0-255,66,121004,64,232445
46050,0.001623,74.125.24.0-255,1484,122488,64,232445
46051,0.001678,74.125.24.0-255,2902,125390,64,232445
46052,0.001682,172.31.40.0-255,66,125456,64,232445
46053,0.001689,74.125.24.0-255,4320,129776,64,232445
46054,0.001691,172.31.40.0-255,66,129842,64,232445
46055,0.001703,74.125.24.0-255,1484,131326,64,232445
46056,0.001716,74.125.24.0-255,2902,134228,64,232445
46057,0.001718,172.31.40.0-255,66,134294,64,232445
46058,0.001744,74.125.24.0-255,7156,141450,64,232445
46059,0.001747,172.31.40.0-255,66,141516,64,232445
46060,0.001754,74.125.24.0-255,7156,148672,64,232445
46061,0.001756,172.31.40.0-255,66,148738,64,232445
46062,0.001774,74.125.24.0-255,5738,154476,64,232445
46063,0.001776,172.31.40.0-255,66,154542,64,232445
46064,0.001781,74.125.24.0-255,2902,157444,64,232445
46065,0.001783,172.31.40.0-255,66,157510,64,232445
46066,0.001824,172.31.40.0-255,66,157576,64,232445
46067,0.001836,172.31.40.0-255,66,157642,64,232445
46068,0.001861,74.125.24.0-255,2902,160544,64,232445
46069,0.001864,172.31.40.0-255,66,160610,64,232445
46070,0.001915,172.31.40.0-255,66,160676,64,232445
46071,0.001934,172.31.40.0-255,66,160742,64,232445
46072,0.001937,74.125.24.0-255,1484,162226,64,232445
46073,0.001955,74.125.24.0-255,1484,163710,64,232445
46074,0.001957,172.31.40.0-255,66,163776,64,232445
46075,0.001963,74.125.24.0-255,4320,168096,64,232445
46076,0.001965,172.31.40.0-255,66,168162,64,232445
46077,0.001969,74.125.24.0-255,2902,171064,64,232445
46078,0.001971,172.31.40.0-255,66,171130,64,232445
46079,0.001988,74.125.24.0-255,5738,176868,64,232445
46080,0.00199,172.31.40.0-255,66,176934,64,232445
46081,0.00202,172.31.40.0-255,66,177000,64,232445
46082,0.002052,172.31.40.0-255,66,177066,64,232445
46083,0.002055,74.125.24.0-255,766,177832,64,232445
46084,0.0021,74.125.24.0-255,1484,179316,64,232445
46085,0.002102,172.31.40.0-255,66,179382,64,232445
46086,0.002108,74.125.24.0-255,4320,183702,64,232445
46087,0.00211,172.31.40.0-255,66,183768,64,232445
46088,0.00212,172.31.40.0-255,66,183834,64,232445
46089,0.00213,172.31.40.0-255,66,183900,64,232445
46090,0.002145,74.125.24.0-255,1484,185384,64,232445
46091,0.00215,74.125.24.0-255,2902,188286,64,232445
46092,0.002152,172.31.40.0-255,66,188352,64,232445
46093,0.002172,74.125.24.0-255,6438,194790,64,232445
46094,0.002175,172.31.40.0-255,66,194856,64,232445
46095,0.002206,74.125.24.0-255,2902,197758,64,232445
46096,0.002209,172.31.40.0-255,66,197824,64,232445
46097,0.002215,74.125.24.0-255,4320,202144,64,232445
46098,0.002218,172.31.40.0-255,66,202210,64,232445
46099,0.002222,74.125.24.0-255,4320,206530,64,232445
46100,0.002225,172.31.40.0-255,66,206596,64,232445
46101,0.002251,74.125.24.0-255,4320,210916,64,232445
46102,0.002255,74.125.24.0-255,2902,213818,64,232445
46103,0.002259,172.31.40.0-255,66,213884,64,232445
46104,0.002266,172.31.40.0-255,66,213950,64,232445
46105,0.002271,74.125.24.0-255,4320,218270,64,232445
46106,0.002274,172.31.40.0-255,66,218336,64,232445
46107,0.002332,172.31.40.0-255,66,218402,64,232445
46108,0.002345,172.31.40.0-255,66,218468,64,232445
46109,0.002351,74.125.24.0-255,7156,225624,64,232445
46110,0.002353,172.31.40.0-255,66,225690,64,232445
46111,0.004683,74.125.24.0-255,5738,231428,64,232445
46112,0.00469,172.31.40.0-255,66,231494,64,232445
46113,0.006979,74.125.24.0-255,714,232208,64,232445
46114,0.014218,172.31.40.0-255,66,232274,64,232445
46115,0.014266,172.31.40.0-255,105,232379,64,232445
46116,0.016533,74.125.24.0-255,66,232445,64,232445
46117,0.0,74.125.24.0-255,152,152,64,140434
46118,2.4e-05,172.31.40.0-255,66,218,64,140434
46119,3.1e-05,74.125.24.0-255,1484,1702,64,140434
46120,3.6e-05,172.31.40.0-255,66,1768,64,140434
46121,4.9e-05,74.125.24.0-255,2902,4670,64,140434
46122,5.3e-05,172.31.40.0-255,66,4736,64,140434
46123,5.6e-05,74.125.24.0-255,1484,6220,64,140434
46124,5.8e-05,172.31.40.0-255,66,6286,64,140434
46125,0.000101,172.31.40.0-255,66,6352,64,140434
46126,0.00013,172.31.40.0-255,66,6418,64,140434
46127,0.000136,74.125.24.0-255,5738,12156,64,140434
46128,0.000139,172.31.40.0-255,66,12222,64,140434
46129,0.000164,74.125.24.0-255,2543,14765,64,140434
46130,0.00017,172.31.40.0-255,66,14831,64,140434
46131,0.000221,74.125.24.0-255,1484,16315,64,140434
46132,0.000223,172.31.40.0-255,66,16381,64,140434
46133,0.000228,74.125.24.0-255,2902,19283,64,140434
46134,0.00023,172.31.40.0-255,66,19349,64,140434
46135,0.000234,74.125.24.0-255,2902,22251,64,140434
46136,0.000237,172.31.40.0-255,66,22317,64,140434
46137,0.000272,74.125.24.0-255,2902,25219,64,140434
46138,0.000275,172.31.40.0-255,66,25285,64,140434
46139,0.00029,172.31.40.0-255,66,25351,64,140434
46140,0.000306,172.31.40.0-255,66,25417,64,140434
46141,0.000346,74.125.24.0-255,1454,26871,64,140434
46142,0.000349,172.31.40.0-255,66,26937,64,140434
46143,0.000366,74.125.24.0-255,114,27051,64,140434
46144,0.000368,172.31.40.0-255,66,27117,64,140434
46145,0.000475,74.125.24.0-255,331,27448,64,140434
46146,0.000798,74.125.24.0-255,1484,28932,64,140434
46147,0.000803,172.31.40.0-255,66,28998,64,140434
46148,0.000809,74.125.24.0-255,2902,31900,64,140434
46149,0.000811,172.31.40.0-255,66,31966,64,140434
46150,0.000814,74.125.24.0-255,1484,33450,64,140434
46151,0.00084,74.125.24.0-255,4320,37770,64,140434
46152,0.000843,172.31.40.0-255,66,37836,64,140434
46153,0.000862,172.31.40.0-255,66,37902,64,140434
46154,0.000865,74.125.24.0-255,1484,39386,64,140434
46155,0.000896,74.125.24.0-255,4320,43706,64,140434
46156,0.000899,172.31.40.0-255,66,43772,64,140434
46157,0.000927,74.125.24.0-255,5020,48792,64,140434
46158,0.000929,172.31.40.0-255,66,48858,64,140434
46159,0.001285,74.125.24.0-255,1484,50342,64,140434
46160,0.00129,74.125.24.0-255,2902,53244,64,140434
46161,0.001293,172.31.40.0-255,66,53310,64,140434
46162,0.001324,74.125.24.0-255,5738,59048,64,140434
46163,0.001327,172.31.40.0-255,66,59114,64,140434
46164,0.001337,172.31.40.0-255,66,59180,64,140434
46165,0.001362,74.125.24.0-255,2902,62082,64,140434
46166,0.001364,172.31.40.0-255,66,62148,64,140434
46167,0.001378,172.31.40.0-255,66,62214,64,140434
46168,0.001514,74.125.24.0-255,1484,63698,64,140434
46169,0.001519,74.125.24.0-255,2902,66600,64,140434
46170,0.001522,172.31.40.0-255,66,66666,64,140434
46171,0.001525,74.125.24.0-255,1484,68150,64,140434
46172,0.001555,74.125.24.0-255,4320,72470,64,140434
46173,0.001558,172.31.40.0-255,66,72536,64,140434
46174,0.001567,172.31.40.0-255,66,72602,64,140434
46175,0.001601,74.125.24.0-255,2902,75504,64,140434
46176,0.001604,172.31.40.0-255,66,75570,64,140434
46177,0.00164,172.31.40.0-255,66,75636,64,140434
46178,0.001673,172.31.40.0-255,66,75702,64,140434
46179,0.00171,74.125.24.0-255,2902,78604,64,140434
46180,0.001713,172.31.40.0-255,66,78670,64,140434
46181,0.001732,172.31.40.0-255,66,78736,64,140434
46182,0.001735,74.125.24.0-255,766,79502,64,140434
46183,0.001765,172.31.40.0-255,66,79568,64,140434
46184,0.001769,74.125.24.0-255,2902,82470,64,140434
46185,0.001771,172.31.40.0-255,66,82536,64,140434
46186,0.001804,172.31.40.0-255,66,82602,64,140434
46187,0.001807,74.125.24.0-255,1484,84086,64,140434
46188,0.001841,172.31.40.0-255,66,84152,64,140434
46189,0.001843,74.125.24.0-255,1484,85636,64,140434
46190,0.001874,172.31.40.0-255,66,85702,64,140434
46191,0.001895,172.31.40.0-255,66,85768,64,140434
46192,0.001962,172.31.40.0-255,66,85834,64,140434
46193,0.001969,74.125.24.0-255,1484,87318,64,140434
46194,0.001973,74.125.24.0-255,2902,90220,64,140434
46195,0.001978,172.31.40.0-255,66,90286,64,140434
46196,0.001984,74.125.24.0-255,5738,96024,64,140434
46197,0.001987,172.31.40.0-255,66,96090,64,140434
46198,0.002024,172.31.40.0-255,66,96156,64,140434
46199,0.002052,172.31.40.0-255,66,96222,64,140434
46200,0.002056,74.125.24.0-255,2184,98406,64,140434
46201,0.002058,172.31.40.0-255,66,98472,64,140434
46202,0.002113,74.125.24.0-255,1484,99956,64,140434
46203,0.002119,74.125.24.0-255,2902,102858,64,140434
46204,0.002121,172.31.40.0-255,66,102924,64,140434
46205,0.002153,74.125.24.0-255,5738,108662,64,140434
46206,0.002156,172.31.40.0-255,66,108728,64,140434
46207,0.002165,172.31.40.0-255,66,108794,64,140434
46208,0.00219,74.125.24.0-255,2902,111696,64,140434
46209,0.002192,172.31.40.0-255,66,111762,64,140434
46210,0.002252,74.125.24.0-255,5738,117500,64,140434
46211,0.002284,74.125.24.0-255,7156,124656,64,140434
46212,0.002291,74.125.24.0-255,7156,131812,64,140434
46213,0.002301,74.125.24.0-255,1484,133296,64,140434
46214,0.002347,74.125.24.0-255,3602,136898,64,140434
46215,0.002406,74.125.24.0-255,105,137003,64,140434
46216,0.009652,172.31.40.0-255,66,137069,64,140434
46217,0.012137,172.31.40.0-255,105,137174,64,140434
46218,0.014706,74.125.24.0-255,66,137240,64,140434
46219,0.033463,172.31.40.0-255,167,137407,64,140434
46220,0.033497,172.31.40.0-255,1107,138514,64,140434
46221,0.033557,172.31.40.0-255,1514,140028,64,140434
46222,0.033559,172.31.40.0-255,340,140368,64,140434
46223,0.035077,104.244.42.0-255,66,140434,64,140434
46224,0.0,172.217.194.0-255,146,146,64,258157
46225,2.2e-05,172.31.40.0-255,66,212,64,258157
46226,3e-05,172.217.194.0-255,1484,1696,64,258157
46227,3.4e-05,172.31.40.0-255,66,1762,64,258157
46228,4.1e-05,172.217.194.0-255,2902,4664,64,258157
46229,4.5e-05,172.31.40.0-255,66,4730,64,258157
46230,6e-05,172.217.194.0-255,7156,11886,64,258157
46231,6.2e-05,172.31.40.0-255,66,11952,64,258157
46232,6.6e-05,172.217.194.0-255,1984,13936,64,258157
46233,6.8e-05,172.31.40.0-255,66,14002,64,258157
46234,0.000111,172.217.194.0-255,7156,21158,64,258157
46235,0.000114,172.31.40.0-255,66,21224,64,258157
46236,0.000116,172.217.194.0-255,1484,22708,64,258157
46237,0.000118,172.31.40.0-255,66,22774,64,258157
46238,0.000147,172.217.194.0-255,7156,29930,64,258157
46239,0.000149,172.31.40.0-255,66,29996,64,258157
46240,0.000163,172.217.194.0-255,4320,34316,64,258157
46241,0.000168,172.31.40.0-255,66,34382,64,258157
46242,0.000197,172.217.194.0-255,6797,41179,64,258157
46243,0.0002,172.31.40.0-255,66,41245,64,258157
46244,0.000202,172.217.194.0-255,1484,42729,64,258157
46245,0.000204,172.31.40.0-255,66,42795,64,258157
46246,0.000247,172.31.40.0-255,66,42861,64,258157
46247,0.000269,172.217.194.0-255,2902,45763,64,258157
46248,0.000271,172.31.40.0-255,66,45829,64,258157
46249,0.000308,172.31.40.0-255,66,45895,64,258157
46250,0.000311,172.217.194.0-255,362,46257,64,258157
46251,0.000313,172.31.40.0-255,66,46323,64,258157
46252,0.000403,172.217.194.0-255,1484,47807,64,258157
46253,0.000407,172.31.40.0-255,66,47873,64,258157
46254,0.000413,172.217.194.0-255,2902,50775,64,258157
46255,0.000415,172.31.40.0-255,66,50841,64,258157
46256,0.000421,172.217.194.0-255,5738,56579,64,258157
46257,0.000428,172.31.40.0-255,66,56645,64,258157
46258,0.000451,172.217.194.0-255,1484,58129,64,258157
46259,0.000493,172.31.40.0-255,66,58195,64,258157
46260,0.000505,172.31.40.0-255,66,58261,64,258157
46261,0.000622,172.217.194.0-255,1484,59745,64,258157
46262,0.000628,172.217.194.0-255,2902,62647,64,258157
46263,0.00063,172.31.40.0-255,66,62713,64,258157
46264,0.000637,172.217.194.0-255,5738,68451,64,258157
46265,0.000639,172.31.40.0-255,66,68517,64,258157
46266,0.000679,172.31.40.0-255,66,68583,64,258157
46267,0.000691,172.31.40.0-255,66,68649,64,258157
46268,0.001181,172.217.194.0-255,1484,70133,64,258157
46269,0.001188,172.217.194.0-255,2902,73035,64,258157
46270,0.001192,172.31.40.0-255,66,73101,64,258157
46271,0.0012,172.217.194.0-255,5738,78839,64,258157
46272,0.001202,172.31.40.0-255,66,78905,64,258157
46273,0.001241,172.31.40.0-255,66,78971,64,258157
46274,0.001253,172.31.40.0-255,66,79037,64,258157
46275,0.0021,172.217.194.0-255,1484,80521,64,258157
46276,0.002113,172.217.194.0-255,2902,83423,64,258157
46277,0.002116,172.31.40.0-255,66,83489,64,258157
46278,0.00212,172.217.194.0-255,1484,84973,64,258157
46279,0.002143,172.217.194.0-255,4320,89293,64,258157
46280,0.002145,172.31.40.0-255,66,89359,64,258157
46281,0.002156,172.31.40.0-255,66,89425,64,258157
46282,0.002175,172.217.194.0-255,1484,90909,64,258157
46283,0.002184,172.31.40.0-255,66,90975,64,258157
46284,0.002202,172.217.194.0-255,1484,92459,64,258157
46285,0.002206,172.217.194.0-255,766,93225,64,258157
46286,0.002208,172.31.40.0-255,66,93291,64,258157
46287,0.00226,172.217.194.0-255,1484,94775,64,258157
46288,0.002281,172.217.194.0-255,2902,97677,64,258157
46289,0.002283,172.31.40.0-255,66,97743,64,258157
46290,0.002289,172.217.194.0-255,5738,103481,64,258157
46291,0.002291,172.31.40.0-255,66,103547,64,258157
46292,0.002316,172.217.194.0-255,5738,109285,64,258157
46293,0.002319,172.31.40.0-255,66,109351,64,258157
46294,0.002358,172.31.40.0-255,66,109417,64,258157
46295,0.002361,172.217.194.0-255,1484,110901,64,258157
46296,0.002384,172.217.194.0-255,3602,114503,64,258157
46297,0.002386,172.31.40.0-255,66,114569,64,258157
46298,0.004767,172.217.194.0-255,5738,120307,64,258157
46299,0.004774,172.31.40.0-255,66,120373,64,258157
46300,0.007112,172.217.194.0-255,5738,126111,64,258157
46301,0.007116,172.31.40.0-255,66,126177,64,258157
46302,0.009478,172.217.194.0-255,5738,131915,64,258157
46303,0.009485,172.31.40.0-255,66,131981,64,258157
46304,0.011855,172.217.194.0-255,5738,137719,64,258157
46305,0.011864,172.31.40.0-255,66,137785,64,258157
46306,0.014233,172.217.194.0-255,5738,143523,64,258157
46307,0.014241,172.31.40.0-255,66,143589,64,258157
46308,0.016616,172.217.194.0-255,5738,149327,64,258157
46309,0.016627,172.31.40.0-255,66,149393,64,258157
46310,0.019033,172.217.194.0-255,5738,155131,64,258157
46311,0.01904,172.31.40.0-255,66,155197,64,258157
46312,0.021413,172.217.194.0-255,5738,160935,64,258157
46313,0.02142,172.31.40.0-255,66,161001,64,258157
46314,0.023796,172.217.194.0-255,5738,166739,64,258157
46315,0.023803,172.31.40.0-255,66,166805,64,258157
46316,0.02617,172.217.194.0-255,5738,172543,64,258157
46317,0.026184,172.31.40.0-255,66,172609,64,258157
46318,0.028596,172.217.194.0-255,5738,178347,64,258157
46319,0.028603,172.31.40.0-255,66,178413,64,258157
46320,0.030205,172.31.40.0-255,172,178585,64,258157
46321,0.030231,172.31.40.0-255,1112,179697,64,258157
46322,0.03028,172.31.40.0-255,1514,181211,64,258157
46323,0.030281,172.31.40.0-255,1296,182507,64,258157
46324,0.030956,172.217.194.0-255,5738,188245,64,258157
46325,0.030964,172.31.40.0-255,66,188311,64,258157
46326,0.031727,104.244.42.0-255,66,188377,64,258157
46327,0.031787,104.244.42.0-255,66,188443,64,258157
46328,0.031874,104.244.42.0-255,66,188509,64,258157
46329,0.03334,172.217.194.0-255,5738,194247,64,258157
46330,0.033348,172.31.40.0-255,66,194313,64,258157
46331,0.03575,172.217.194.0-255,5738,200051,64,258157
46332,0.035756,172.31.40.0-255,66,200117,64,258157
46333,0.03813,172.217.194.0-255,5738,205855,64,258157
46334,0.038135,172.31.40.0-255,66,205921,64,258157
46335,0.040516,172.217.194.0-255,5738,211659,64,258157
46336,0.040522,172.31.40.0-255,66,211725,64,258157
46337,0.042911,172.217.194.0-255,5738,217463,64,258157
46338,0.04292,172.31.40.0-255,66,217529,64,258157
46339,0.045294,172.217.194.0-255,5738,223267,64,258157
46340,0.045301,172.31.40.0-255,66,223333,64,258157
46341,0.047658,172.217.194.0-255,5738,229071,64,258157
46342,0.047665,172.31.40.0-255,66,229137,64,258157
46343,0.050018,172.217.194.0-255,5738,234875,64,258157
46344,0.050029,172.31.40.0-255,66,234941,64,258157
46345,0.052394,172.217.194.0-255,5738,240679,64,258157
46346,0.052401,172.31.40.0-255,66,240745,64,258157
46347,0.054796,172.217.194.0-255,5738,246483,64,258157
46348,0.054803,172.31.40.0-255,66,246549,64,258157
46349,0.057184,172.217.194.0-255,5738,252287,64,258157
46350,0.057195,172.31.40.0-255,66,252353,64,258157
46351,0.059579,172.217.194.0-255,5738,258091,64,258157
46352,0.059586,172.31.40.0-255,66,258157,64,258157
46353,0.0,172.31.40.0-255,105,105,64,459
46354,0.000206,172.31.40.0-255,90,195,64,459
46355,0.000217,172.31.40.0-255,66,261,64,459
46356,0.002784,74.125.68.0-255,66,327,64,459
46357,0.002817,74.125.68.0-255,66,393,64,459
46358,0.002839,172.31.40.0-255,66,459,64,459
46359,0.0,74.125.24.0-255,153,153,64,263325
46360,2.4e-05,172.31.40.0-255,66,219,64,263325
46361,3.1e-05,74.125.24.0-255,1484,1703,64,263325
46362,3.5e-05,172.31.40.0-255,66,1769,64,263325
46363,4.1e-05,74.125.24.0-255,2902,4671,64,263325
46364,4.3e-05,172.31.40.0-255,66,4737,64,263325
46365,5.9e-05,74.125.24.0-255,5738,10475,64,263325
46366,6.1e-05,172.31.40.0-255,66,10541,64,263325
46367,6.7e-05,74.125.24.0-255,3419,13960,64,263325
46368,7.1e-05,172.31.40.0-255,66,14026,64,263325
46369,0.000112,74.125.24.0-255,4320,18346,64,263325
46370,0.000116,172.31.40.0-255,66,18412,64,263325
46371,0.000147,74.125.24.0-255,7156,25568,64,263325
46372,0.00015,172.31.40.0-255,66,25634,64,263325
46373,0.000164,172.31.40.0-255,66,25700,64,263325
46374,0.00017,74.125.24.0-255,4320,30020,64,263325
46375,0.000172,172.31.40.0-255,66,30086,64,263325
46376,0.0002,74.125.24.0-255,5020,35106,64,263325
46377,0.000202,172.31.40.0-255,66,35172,64,263325
46378,0.000631,74.125.24.0-255,1484,36656,64,263325
46379,0.000637,172.31.40.0-255,66,36722,64,263325
46380,0.000643,74.125.24.0-255,2902,39624,64,263325
46381,0.000645,172.31.40.0-255,66,39690,64,263325
46382,0.000653,74.125.24.0-255,5738,45428,64,263325
46383,0.000659,172.31.40.0-255,66,45494,64,263325
46384,0.000693,74.125.24.0-255,6797,52291,64,263325
46385,0.000696,172.31.40.0-255,66,52357,64,263325
46386,0.001072,74.125.24.0-255,1484,53841,64,263325
46387,0.001077,172.31.40.0-255,66,53907,64,263325
46388,0.001081,74.125.24.0-255,1484,55391,64,263325
46389,0.001083,172.31.40.0-255,66,55457,64,263325
46390,0.001115,74.125.24.0-255,1484,56941,64,263325
46391,0.001123,74.125.24.0-255,5738,62679,64,263325
46392,0.001125,172.31.40.0-255,66,62745,64,263325
46393,0.001131,74.125.24.0-255,4320,67065,64,263325
46394,0.001133,172.31.40.0-255,66,67131,64,263325
46395,0.001168,172.31.40.0-255,66,67197,64,263325
46396,0.001179,172.31.40.0-255,66,67263,64,263325
46397,0.001205,74.125.24.0-255,2184,69447,64,263325
46398,0.001207,172.31.40.0-255,66,69513,64,263325
46399,0.001241,172.31.40.0-255,66,69579,64,263325
46400,0.00129,172.31.40.0-255,66,69645,64,263325
46401,0.001303,172.31.40.0-255,66,69711,64,263325
46402,0.001318,172.31.40.0-255,66,69777,64,263325
46403,0.001419,74.125.24.0-255,1484,71261,64,263325
46404,0.001434,74.125.24.0-255,2902,74163,64,263325
46405,0.001437,172.31.40.0-255,66,74229,64,263325
46406,0.001443,74.125.24.0-255,4320,78549,64,263325
46407,0.001446,172.31.40.0-255,66,78615,64,263325
46408,0.001464,74.125.24.0-255,1484,80099,64,263325
46409,0.001467,74.125.24.0-255,1484,81583,64,263325
46410,0.001469,172.31.40.0-255,66,81649,64,263325
46411,0.001502,172.31.40.0-255,66,81715,64,263325
46412,0.001529,74.125.24.0-255,5738,87453,64,263325
46413,0.001532,172.31.40.0-255,66,87519,64,263325
46414,0.001555,74.125.24.0-255,5020,92539,64,263325
46415,0.001558,172.31.40.0-255,66,92605,64,263325
46416,0.001588,74.125.24.0-255,1484,94089,64,263325
46417,0.001601,74.125.24.0-255,2902,96991,64,263325
46418,0.001604,172.31.40.0-255,66,97057,64,263325
46419,0.001632,74.125.24.0-255,5738,102795,64,263325
46420,0.001635,172.31.40.0-255,66,102861,64,263325
46421,0.00164,74.125.24.0-255,2902,105763,64,263325
46422,0.001642,172.31.40.0-255,66,105829,64,263325
46423,0.001681,74.125.24.0-255,7156,112985,64,263325
46424,0.001689,172.31.40.0-255,66,113051,64,263325
46425,0.001703,172.31.40.0-255,66,113117,64,263325
46426,0.001705,74.125.24.0-255,766,113883,64,263325
46427,0.001782,74.125.24.0-255,1484,115367,64,263325
46428,0.001786,172.31.40.0-255,66,115433,64,263325
46429,0.001815,74.125.24.0-255,2902,118335,64,263325
46430,0.001819,172.31.40.0-255,66,118401,64,263325
46431,0.001823,74.125.24.0-255,2902,121303,64,263325
46432,0.001825,172.31.40.0-255,66,121369,64,263325
46433,0.001858,74.125.24.0-255,7156,128525,64,263325
46434,0.001864,172.31.40.0-255,66,128591,64,263325
46435,0.001878,74.125.24.0-255,1484,130075,64,263325
46436,0.001919,172.31.40.0-255,66,130141,64,263325
46437,0.001923,74.125.24.0-255,2902,133043,64,263325
46438,0.001925,172.31.40.0-255,66,133109,64,263325
46439,0.001951,74.125.24.0-255,2184,135293,64,263325
46440,0.001957,172.31.40.0-255,66,135359,64,263325
46441,0.002138,74.125.24.0-255,1484,136843,64,263325
46442,0.002142,74.125.24.0-255,1484,138327,64,263325
46443,0.002145,172.31.40.0-255,66,138393,64,263325
46444,0.002176,74.125.24.0-255,1484,139877,64,263325
46445,0.002183,74.125.24.0-255,5738,145615,64,263325
46446,0.002186,172.31.40.0-255,66,145681,64,263325
46447,0.00219,74.125.24.0-255,2902,148583,64,263325
46448,0.002192,172.31.40.0-255,66,148649,64,263325
46449,0.002198,74.125.24.0-255,4320,152969,64,263325
46450,0.0022,172.31.40.0-255,66,153035,64,263325
46451,0.002236,172.31.40.0-255,66,153101,64,263325
46452,0.002242,74.125.24.0-255,5738,158839,64,263325
46453,0.002244,172.31.40.0-255,66,158905,64,263325
46454,0.002266,74.125.24.0-255,4320,163225,64,263325
46455,0.002269,172.31.40.0-255,66,163291,64,263325
46456,0.00231,172.31.40.0-255,66,163357,64,263325
46457,0.002323,172.31.40.0-255,66,163423,64,263325
46458,0.002334,172.31.40.0-255,66,163489,64,263325
46459,0.004629,74.125.24.0-255,5738,169227,64,263325
46460,0.004637,172.31.40.0-255,66,169293,64,263325
46461,0.006935,74.125.24.0-255,5738,175031,64,263325
46462,0.006942,172.31.40.0-255,66,175097,64,263325
46463,0.008084,172.31.40.0-255,101,175198,64,263325
46464,0.009277,74.125.24.0-255,5738,180936,64,263325
46465,0.009282,172.31.40.0-255,66,181002,64,263325
46466,0.010352,74.125.24.0-255,66,181068,64,263325
46467,0.011578,74.125.24.0-255,5738,186806,64,263325
46468,0.011584,172.31.40.0-255,66,186872,64,263325
46469,0.013903,74.125.24.0-255,5738,192610,64,263325
46470,0.013912,172.31.40.0-255,66,192676,64,263325
46471,0.016234,74.125.24.0-255,5738,198414,64,263325
46472,0.016244,172.31.40.0-255,66,198480,64,263325
46473,0.018544,74.125.24.0-255,5738,204218,64,263325
46474,0.018553,172.31.40.0-255,66,204284,64,263325
46475,0.020854,74.125.24.0-255,5738,210022,64,263325
46476,0.020863,172.31.40.0-255,66,210088,64,263325
46477,0.023179,74.125.24.0-255,5738,215826,64,263325
46478,0.023186,172.31.40.0-255,66,215892,64,263325
46479,0.025471,74.125.24.0-255,5738,221630,64,263325
46480,0.025481,172.31.40.0-255,66,221696,64,263325
46481,0.027764,74.125.24.0-255,5738,227434,64,263325
46482,0.027771,172.31.40.0-255,66,227500,64,263325
46483,0.030059,74.125.24.0-255,5738,233238,64,263325
46484,0.030068,172.31.40.0-255,66,233304,64,263325
46485,0.032342,74.125.24.0-255,5738,239042,64,263325
46486,0.03235,172.31.40.0-255,66,239108,64,263325
46487,0.034626,74.125.24.0-255,5738,244846,64,263325
46488,0.034634,172.31.40.0-255,66,244912,64,263325
46489,0.035053,172.31.40.0-255,172,245084,64,263325
46490,0.035084,172.31.40.0-255,1111,246195,64,263325
46491,0.035141,172.31.40.0-255,1514,247709,64,263325
46492,0.035143,172.31.40.0-255,1514,249223,64,263325
46493,0.035167,172.31.40.0-255,694,249917,64,263325
46494,0.036625,104.244.42.0-255,66,249983,64,263325
46495,0.03666,104.244.42.0-255,66,250049,64,263325
46496,0.036717,104.244.42.0-255,66,250115,64,263325
46497,0.036721,104.244.42.0-255,66,250181,64,263325
46498,0.036935,74.125.24.0-255,5738,255919,64,263325
46499,0.036941,172.31.40.0-255,66,255985,64,263325
46500,0.039311,74.125.24.0-255,5738,261723,64,263325
46501,0.03932,172.31.40.0-255,66,261789,64,263325
46502,0.041644,74.125.24.0-255,1365,263154,64,263325
46503,0.041827,172.31.40.0-255,105,263259,64,263325
46504,0.049739,74.125.24.0-255,66,263325,64,263325
46505,0.0,172.31.40.0-255,105,105,64,459
46506,0.000175,172.31.40.0-255,90,195,64,459
46507,0.000187,172.31.40.0-255,66,261,64,459
46508,0.00276,172.217.194.0-255,66,327,64,459
46509,0.002781,172.217.194.0-255,66,393,64,459
46510,0.002797,172.31.40.0-255,66,459,64,459
46511,0.0,74.125.130.0-255,146,146,64,288957
46512,1.9e-05,172.31.40.0-255,66,212,64,288957
46513,2.6e-05,74.125.130.0-255,1484,1696,64,288957
46514,3.1e-05,172.31.40.0-255,66,1762,64,288957
46515,3.6e-05,74.125.130.0-255,2902,4664,64,288957
46516,4.6e-05,172.31.40.0-255,66,4730,64,288957
46517,5e-05,74.125.130.0-255,1484,6214,64,288957
46518,5.2e-05,172.31.40.0-255,66,6280,64,288957
46519,9e-05,74.125.130.0-255,4320,10600,64,288957
46520,9.4e-05,172.31.40.0-255,66,10666,64,288957
46521,0.0001,74.125.130.0-255,2902,13568,64,288957
46522,0.000102,172.31.40.0-255,66,13634,64,288957
46523,0.000123,74.125.130.0-255,3401,17035,64,288957
46524,0.000127,172.31.40.0-255,66,17101,64,288957
46525,0.000135,74.125.130.0-255,2902,20003,64,288957
46526,0.000138,172.31.40.0-255,66,20069,64,288957
46527,0.000151,172.31.40.0-255,66,20135,64,288957
46528,0.000261,74.125.130.0-255,1484,21619,64,288957
46529,0.000265,172.31.40.0-255,66,21685,64,288957
46530,0.000285,74.125.130.0-255,2902,24587,64,288957
46531,0.000287,172.31.40.0-255,66,24653,64,288957
46532,0.00029,74.125.130.0-255,1484,26137,64,288957
46533,0.000293,172.31.40.0-255,66,26203,64,288957
46534,0.000328,74.125.130.0-255,2902,29105,64,288957
46535,0.000331,172.31.40.0-255,66,29171,64,288957
46536,0.000337,74.125.130.0-255,5738,34909,64,288957
46537,0.000339,172.31.40.0-255,66,34975,64,288957
46538,0.000347,74.125.130.0-255,1484,36459,64,288957
46539,0.000349,172.31.40.0-255,66,36525,64,288957
46540,0.000393,74.125.130.0-255,4320,40845,64,288957
46541,0.000396,172.31.40.0-255,66,40911,64,288957
46542,0.000404,74.125.130.0-255,7156,48067,64,288957
46543,0.000418,74.125.130.0-255,6438,54505,64,288957
46544,0.000421,74.125.130.0-255,377,54882,64,288957
46545,0.000537,172.31.40.0-255,66,54948,64,288957
46546,0.000931,74.125.130.0-255,365,55313,64,288957
46547,0.000986,74.125.130.0-255,1484,56797,64,288957
46548,0.00099,172.31.40.0-255,66,56863,64,288957
46549,0.000996,74.125.130.0-255,2902,59765,64,288957
46550,0.00102,74.125.130.0-255,4320,64085,64,288957
46551,0.001028,172.31.40.0-255,66,64151,64,288957
46552,0.001048,74.125.130.0-255,1484,65635,64,288957
46553,0.001054,74.125.130.0-255,4320,69955,64,288957
46554,0.001068,172.31.40.0-255,66,70021,64,288957
46555,0.00109,74.125.130.0-255,2543,72564,64,288957
46556,0.001098,172.31.40.0-255,66,72630,64,288957
46557,0.001235,74.125.130.0-255,1484,74114,64,288957
46558,0.001251,74.125.130.0-255,2902,77016,64,288957
46559,0.001254,172.31.40.0-255,66,77082,64,288957
46560,0.001282,74.125.130.0-255,4320,81402,64,288957
46561,0.001285,74.125.130.0-255,1484,82886,64,288957
46562,0.001293,172.31.40.0-255,66,82952,64,288957
46563,0.001319,74.125.130.0-255,4320,87272,64,288957
46564,0.001323,74.125.130.0-255,1995,89267,64,288957
46565,0.001326,172.31.40.0-255,66,89333,64,288957
46566,0.001405,74.125.130.0-255,1484,90817,64,288957
46567,0.001417,74.125.130.0-255,1484,92301,64,288957
46568,0.001419,172.31.40.0-255,66,92367,64,288957
46569,0.001446,74.125.130.0-255,1484,93851,64,288957
46570,0.001451,74.125.130.0-255,4320,98171,64,288957
46571,0.001454,74.125.130.0-255,2902,101073,64,288957
46572,0.001461,172.31.40.0-255,66,101139,64,288957
46573,0.001492,74.125.130.0-255,5738,106877,64,288957
46574,0.0015,74.125.130.0-255,7156,114033,64,288957
46575,0.001506,74.125.130.0-255,7156,121189,64,288957
46576,0.001523,74.125.130.0-255,1484,122673,64,288957
46577,0.001526,74.125.130.0-255,766,123439,64,288957
46578,0.001561,172.31.40.0-255,66,123505,64,288957
46579,0.003597,74.125.130.0-255,5738,129243,64,288957
46580,0.003603,172.31.40.0-255,66,129309,64,288957
46581,0.005626,74.125.130.0-255,5738,135047,64,288957
46582,0.006971,172.31.40.0-255,66,135113,64,288957
46583,0.008999,74.125.130.0-255,5738,140851,64,288957
46584,0.009007,172.31.40.0-255,66,140917,64,288957
46585,0.011029,74.125.130.0-255,5738,146655,64,288957
46586,0.011036,172.31.40.0-255,66,146721,64,288957
46587,0.01306,74.125.130.0-255,5738,152459,64,288957
46588,0.013066,172.31.40.0-255,66,152525,64,288957
46589,0.015091,74.125.130.0-255,5738,158263,64,288957
46590,0.015098,172.31.40.0-255,66,158329,64,288957
46591,0.017124,74.125.130.0-255,5738,164067,64,288957
46592,0.017134,172.31.40.0-255,66,164133,64,288957
46593,0.019174,74.125.130.0-255,5738,169871,64,288957
46594,0.019186,172.31.40.0-255,66,169937,64,288957
46595,0.021237,74.125.130.0-255,5738,175675,64,288957
46596,0.021247,172.31.40.0-255,66,175741,64,288957
46597,0.023273,74.125.130.0-255,5738,181479,64,288957
46598,0.023281,172.31.40.0-255,66,181545,64,288957
46599,0.024762,172.31.40.0-255,172,181717,64,288957
46600,0.024793,172.31.40.0-255,1112,182829,64,288957
46601,0.02485,172.31.40.0-255,1514,184343,64,288957
46602,0.024852,172.31.40.0-255,1296,185639,64,288957
46603,0.025306,74.125.130.0-255,5738,191377,64,288957
46604,0.025313,172.31.40.0-255,66,191443,64,288957
46605,0.0263,104.244.42.0-255,66,191509,64,288957
46606,0.026371,104.244.42.0-255,66,191575,64,288957
46607,0.026418,104.244.42.0-255,66,191641,64,288957
46608,0.027342,74.125.130.0-255,5738,197379,64,288957
46609,0.02735,172.31.40.0-255,66,197445,64,288957
46610,0.029382,74.125.130.0-255,5738,203183,64,288957
46611,0.029389,172.31.40.0-255,66,203249,64,288957
46612,0.031417,74.125.130.0-255,5738,208987,64,288957
46613,0.031425,172.31.40.0-255,66,209053,64,288957
46614,0.033468,74.125.130.0-255,5738,214791,64,288957
46615,0.033476,172.31.40.0-255,66,214857,64,288957
46616,0.035514,74.125.130.0-255,5738,220595,64,288957
46617,0.035521,172.31.40.0-255,66,220661,64,288957
46618,0.037554,74.125.130.0-255,5738,226399,64,288957
46619,0.03756,172.31.40.0-255,66,226465,64,288957
46620,0.039597,74.125.130.0-255,5738,232203,64,288957
46621,0.039603,172.31.40.0-255,66,232269,64,288957
46622,0.041627,74.125.130.0-255,4320,236589,64,288957
46623,0.041633,172.31.40.0-255,66,236655,64,288957
46624,0.041663,74.125.130.0-255,1484,238139,64,288957
46625,0.043665,74.125.130.0-255,4320,242459,64,288957
46626,0.043671,172.31.40.0-255,66,242525,64,288957
46627,0.045698,74.125.130.0-255,5738,248263,64,288957
46628,0.045752,172.31.40.0-255,66,248329,64,288957
46629,0.047774,74.125.130.0-255,5738,254067,64,288957
46630,0.04778,172.31.40.0-255,66,254133,64,288957
46631,0.049795,74.125.130.0-255,5738,259871,64,288957
46632,0.049801,172.31.40.0-255,66,259937,64,288957
46633,0.051834,74.125.130.0-255,5738,265675,64,288957
46634,0.05184,172.31.40.0-255,66,265741,64,288957
46635,0.053879,74.125.130.0-255,5738,271479,64,288957
46636,0.053885,172.31.40.0-255,66,271545,64,288957
46637,0.055914,74.125.130.0-255,5738,277283,64,288957
46638,0.055919,172.31.40.0-255,66,277349,64,288957
46639,0.057956,74.125.130.0-255,5738,283087,64,288957
46640,0.057963,172.31.40.0-255,66,283153,64,288957
46641,0.059989,74.125.130.0-255,5738,288891,64,288957
46642,0.059995,172.31.40.0-255,66,288957,64,288957
46643,0.0,172.217.194.0-255,153,153,64,255719
46644,2e-05,172.31.40.0-255,66,219,64,255719
46645,2.7e-05,172.217.194.0-255,1484,1703,64,255719
46646,3.3e-05,172.31.40.0-255,66,1769,64,255719
46647,3.8e-05,172.217.194.0-255,2902,4671,64,255719
46648,5e-05,172.31.40.0-255,66,4737,64,255719
46649,5.6e-05,172.217.194.0-255,4320,9057,64,255719
46650,5.9e-05,172.31.40.0-255,66,9123,64,255719
46651,6.5e-05,172.217.194.0-255,4974,14097,64,255719
46652,6.7e-05,172.31.40.0-255,66,14163,64,255719
46653,0.000124,172.31.40.0-255,66,14229,64,255719
46654,0.000158,172.217.194.0-255,5379,19608,64,255719
46655,0.000161,172.31.40.0-255,66,19674,64,255719
46656,0.00019,172.217.194.0-255,1484,21158,64,255719
46657,0.000193,172.31.40.0-255,66,21224,64,255719
46658,0.000197,172.217.194.0-255,1484,22708,64,255719
46659,0.000199,172.31.40.0-255,66,22774,64,255719
46660,0.000232,172.217.194.0-255,1484,24258,64,255719
46661,0.000235,172.31.40.0-255,66,24324,64,255719
46662,0.000241,172.217.194.0-255,5738,30062,64,255719
46663,0.000243,172.31.40.0-255,66,30128,64,255719
46664,0.000247,172.217.194.0-255,2902,33030,64,255719
46665,0.00025,172.31.40.0-255,66,33096,64,255719
46666,0.000295,172.31.40.0-255,66,33162,64,255719
46667,0.0003,172.217.194.0-255,2902,36064,64,255719
46668,0.000301,172.31.40.0-255,66,36130,64,255719
46669,0.000338,172.31.40.0-255,66,36196,64,255719
46670,0.000341,172.217.194.0-255,677,36873,64,255719
46671,0.000343,172.31.40.0-255,66,36939,64,255719
46672,0.000726,172.217.194.0-255,1484,38423,64,255719
46673,0.000734,172.217.194.0-255,2902,41325,64,255719
46674,0.000738,172.31.40.0-255,66,41391,64,255719
46675,0.000772,172.217.194.0-255,5738,47129,64,255719
46676,0.000775,172.31.40.0-255,66,47195,64,255719
46677,0.000778,172.217.194.0-255,1484,48679,64,255719
46678,0.000793,172.31.40.0-255,66,48745,64,255719
46679,0.000836,172.31.40.0-255,66,48811,64,255719
46680,0.001727,172.217.194.0-255,1484,50295,64,255719
46681,0.001737,172.217.194.0-255,2902,53197,64,255719
46682,0.001742,172.31.40.0-255,66,53263,64,255719
46683,0.001749,172.217.194.0-255,5738,59001,64,255719
46684,0.001752,172.31.40.0-255,66,59067,64,255719
46685,0.001795,172.31.40.0-255,66,59133,64,255719
46686,0.001801,172.217.194.0-255,4320,63453,64,255719
46687,0.001803,172.31.40.0-255,66,63519,64,255719
46688,0.001833,172.217.194.0-255,6438,69957,64,255719
46689,0.00184,172.31.40.0-255,66,70023,64,255719
46690,0.001871,172.217.194.0-255,1484,71507,64,255719
46691,0.001876,172.217.194.0-255,2902,74409,64,255719
46692,0.001878,172.31.40.0-255,66,74475,64,255719
46693,0.001884,172.217.194.0-255,5738,80213,64,255719
46694,0.001886,172.31.40.0-255,66,80279,64,255719
46695,0.001922,172.31.40.0-255,66,80345,64,255719
46696,0.001928,172.217.194.0-255,5738,86083,64,255719
46697,0.00193,172.31.40.0-255,66,86149,64,255719
46698,0.001949,172.217.194.0-255,2902,89051,64,255719
46699,0.001956,172.31.40.0-255,66,89117,64,255719
46700,0.00196,172.217.194.0-255,2184,91301,64,255719
46701,0.001962,172.31.40.0-255,66,91367,64,255719
46702,0.003983,172.217.194.0-255,5738,97105,64,255719
46703,0.00399,172.31.40.0-255,66,97171,64,255719
46704,0.006015,172.217.194.0-255,5738,102909,64,255719
46705,0.00602,172.31.40.0-255,66,102975,64,255719
46706,0.008017,172.217.194.0-255,4320,107295,64,255719
46707,0.008023,172.31.40.0-255,66,107361,64,255719
46708,0.008051,172.217.194.0-255,1484,108845,64,255719
46709,0.010045,172.217.194.0-255,4320,113165,64,255719
46710,0.010053,172.31.40.0-255,66,113231,64,255719
46711,0.012073,172.217.194.0-255,5738,118969,64,255719
46712,0.012081,172.31.40.0-255,66,119035,64,255719
46713,0.014105,172.217.194.0-255,5738,124773,64,255719
46714,0.014113,172.31.40.0-255,66,124839,64,255719
46715,0.01613,172.217.194.0-255,5738,130577,64,255719
46716,0.016139,172.31.40.0-255,66,130643,64,255719
46717,0.018147,172.217.194.0-255,5738,136381,64,255719
46718,0.018155,172.31.40.0-255,66,136447,64,255719
46719,0.020166,172.217.194.0-255,5738,142185,64,255719
46720,0.020173,172.31.40.0-255,66,142251,64,255719
46721,0.02225,172.217.194.0-255,5738,147989,64,255719
46722,0.022257,172.31.40.0-255,66,148055,64,255719
46723,0.024035,172.31.40.0-255,167,148222,64,255719
46724,0.024065,172.31.40.0-255,1107,149329,64,255719
46725,0.024127,172.31.40.0-255,1514,150843,64,255719
46726,0.024128,172.31.40.0-255,338,151181,64,255719
46727,0.024292,172.217.194.0-255,5738,156919,64,255719
46728,0.024298,172.31.40.0-255,66,156985,64,255719
46729,0.0263,104.244.42.0-255,66,157051,64,255719
46730,0.026323,172.217.194.0-255,5738,162789,64,255719
46731,0.026328,172.31.40.0-255,66,162855,64,255719
46732,0.028357,172.217.194.0-255,5738,168593,64,255719
46733,0.028364,172.31.40.0-255,66,168659,64,255719
46734,0.030353,172.217.194.0-255,5738,174397,64,255719
46735,0.030358,172.31.40.0-255,66,174463,64,255719
46736,0.032366,172.217.194.0-255,5738,180201,64,255719
46737,0.032373,172.31.40.0-255,66,180267,64,255719
46738,0.034412,172.217.194.0-255,5738,186005,64,255719
46739,0.034431,172.31.40.0-255,66,186071,64,255719
46740,0.036495,172.217.194.0-255,5738,191809,64,255719
46741,0.036511,172.31.40.0-255,66,191875,64,255719
46742,0.038505,172.217.194.0-255,5738,197613,64,255719
46743,0.038516,172.31.40.0-255,66,197679,64,255719
46744,0.040542,172.217.194.0-255,5738,203417,64,255719
46745,0.040559,172.31.40.0-255,66,203483,64,255719
46746,0.0426,172.217.194.0-255,5738,209221,64,255719
46747,0.042616,172.31.40.0-255,66,209287,64,255719
46748,0.044637,172.217.194.0-255,5738,215025,64,255719
46749,0.044654,172.31.40.0-255,66,215091,64,255719
46750,0.046693,172.217.194.0-255,5738,220829,64,255719
46751,0.0467,172.31.40.0-255,66,220895,64,255719
46752,0.048713,172.217.194.0-255,5738,226633,64,255719
46753,0.04872,172.31.40.0-255,66,226699,64,255719
46754,0.050718,172.217.194.0-255,5738,232437,64,255719
46755,0.050725,172.31.40.0-255,66,232503,64,255719
46756,0.052764,172.217.194.0-255,5738,238241,64,255719
46757,0.052771,172.31.40.0-255,66,238307,64,255719
46758,0.054774,172.217.194.0-255,5738,244045,64,255719
46759,0.054781,172.31.40.0-255,66,244111,64,255719
46760,0.056808,172.217.194.0-255,5738,249849,64,255719
46761,0.056814,172.31.40.0-255,66,249915,64,255719
46762,0.058853,172.217.194.0-255,5738,255653,64,255719
46763,0.05886,172.31.40.0-255,66,255719,64,255719
