,TIME,SRC,PACKET_SIZE,CUMULATIVE_PACKET_SIZE,PAGE_NUMBER,TOTAL_PACKET_SIZE
0,0.0,172.217.194.0-255,146,146,90,128933
1,1.1e-05,172.31.47.0-255,66,212,90,128933
2,1.7e-05,172.217.194.0-255,1484,1696,90,128933
3,2.1e-05,172.31.47.0-255,66,1762,90,128933
4,2.5e-05,172.217.194.0-255,2902,4664,90,128933
5,3.3e-05,172.31.47.0-255,66,4730,90,128933
6,3.6e-05,172.217.194.0-255,1484,6214,90,128933
7,3.9e-05,172.31.47.0-255,66,6280,90,128933
8,4.3e-05,172.217.194.0-255,1484,7764,90,128933
9,4.5e-05,172.31.47.0-255,66,7830,90,128933
10,8e-05,172.217.194.0-255,4320,12150,90,128933
11,8.3e-05,172.31.47.0-255,66,12216,90,128933
12,8.7e-05,172.217.194.0-255,1982,14198,90,128933
13,8.9e-05,172.31.47.0-255,66,14264,90,128933
14,9.3e-05,172.217.194.0-255,2902,17166,90,128933
15,9.5e-05,172.31.47.0-255,66,17232,90,128933
16,0.000122,172.217.194.0-255,7156,24388,90,128933
17,0.000125,172.31.47.0-255,66,24454,90,128933
18,0.000147,172.217.194.0-255,6797,31251,90,128933
19,0.000153,172.31.47.0-255,66,31317,90,128933
20,0.000194,172.217.194.0-255,1484,32801,90,128933
21,0.000196,172.31.47.0-255,66,32867,90,128933
22,0.000221,172.217.194.0-255,2902,35769,90,128933
23,0.000223,172.31.47.0-255,66,35835,90,128933
24,0.000228,172.217.194.0-255,4320,40155,90,128933
25,0.00023,172.31.47.0-255,66,40221,90,128933
26,0.000244,172.217.194.0-255,1484,41705,90,128933
27,0.000246,172.31.47.0-255,66,41771,90,128933
28,0.000249,172.217.194.0-255,1484,43255,90,128933
29,0.00025,172.31.47.0-255,66,43321,90,128933
30,0.000278,172.217.194.0-255,5379,48700,90,128933
31,0.000281,172.31.47.0-255,66,48766,90,128933
32,0.000657,172.217.194.0-255,1484,50250,90,128933
33,0.000663,172.217.194.0-255,2902,53152,90,128933
34,0.000666,172.31.47.0-255,66,53218,90,128933
35,0.000672,172.217.194.0-255,5738,58956,90,128933
36,0.000674,172.31.47.0-255,66,59022,90,128933
37,0.000694,172.217.194.0-255,4320,63342,90,128933
38,0.000696,172.31.47.0-255,66,63408,90,128933
39,0.000717,172.217.194.0-255,5379,68787,90,128933
40,0.000722,172.31.47.0-255,66,68853,90,128933
41,0.000758,172.217.194.0-255,5738,74591,90,128933
42,0.00076,172.31.47.0-255,66,74657,90,128933
43,0.000794,172.217.194.0-255,8215,82872,90,128933
44,0.000798,172.31.47.0-255,66,82938,90,128933
45,0.0008,172.217.194.0-255,645,83583,90,128933
46,0.000863,172.217.194.0-255,1484,85067,90,128933
47,0.000866,172.31.47.0-255,66,85133,90,128933
48,0.000878,172.217.194.0-255,2902,88035,90,128933
49,0.000883,172.31.47.0-255,66,88101,90,128933
50,0.000919,172.217.194.0-255,5738,93839,90,128933
51,0.000922,172.31.47.0-255,66,93905,90,128933
52,0.000928,172.217.194.0-255,5738,99643,90,128933
53,0.000929,172.31.47.0-255,66,99709,90,128933
54,0.000982,172.217.194.0-255,1125,100834,90,128933
55,0.001084,172.31.47.0-255,101,100935,90,128933
56,0.00183,172.217.194.0-255,1484,102419,90,128933
57,0.001839,172.217.194.0-255,2902,105321,90,128933
58,0.001843,172.31.47.0-255,66,105387,90,128933
59,0.001849,172.217.194.0-255,2902,108289,90,128933
60,0.00185,172.31.47.0-255,66,108355,90,128933
61,0.001871,172.217.194.0-255,2902,111257,90,128933
62,0.001873,172.31.47.0-255,66,111323,90,128933
63,0.001925,172.31.47.0-255,66,111389,90,128933
64,0.001937,172.31.47.0-255,66,111455,90,128933
65,0.003605,172.217.194.0-255,66,111521,90,128933
66,0.004511,172.217.194.0-255,5738,117259,90,128933
67,0.004516,172.31.47.0-255,66,117325,90,128933
68,0.007092,172.217.194.0-255,5738,123063,90,128933
69,0.007099,172.31.47.0-255,66,123129,90,128933
70,0.009687,172.217.194.0-255,5738,128867,90,128933
71,0.009698,172.31.47.0-255,66,128933,90,128933
72,0.0,74.125.24.0-255,297,297,90,370186
73,2.2e-05,172.31.47.0-255,66,363,90,370186
74,2.8e-05,74.125.24.0-255,1484,1847,90,370186
75,3.1e-05,172.31.47.0-255,66,1913,90,370186
76,5.8e-05,74.125.24.0-255,4320,6233,90,370186
77,6.1e-05,172.31.47.0-255,66,6299,90,370186
78,9.3e-05,74.125.24.0-255,5738,12037,90,370186
79,9.6e-05,172.31.47.0-255,66,12103,90,370186
80,0.000115,74.125.24.0-255,7156,19259,90,370186
81,0.000118,172.31.47.0-255,66,19325,90,370186
82,0.000143,74.125.24.0-255,3266,22591,90,370186
83,0.000145,172.31.47.0-255,66,22657,90,370186
84,0.000165,74.125.24.0-255,8215,30872,90,370186
85,0.000167,172.31.47.0-255,66,30938,90,370186
86,0.00103,74.125.24.0-255,1484,32422,90,370186
87,0.001036,172.31.47.0-255,66,32488,90,370186
88,0.001062,74.125.24.0-255,2902,35390,90,370186
89,0.001065,172.31.47.0-255,66,35456,90,370186
90,0.001071,74.125.24.0-255,5738,41194,90,370186
91,0.001073,172.31.47.0-255,66,41260,90,370186
92,0.001106,74.125.24.0-255,7156,48416,90,370186
93,0.001109,172.31.47.0-255,66,48482,90,370186
94,0.001145,74.125.24.0-255,2902,51384,90,370186
95,0.00115,172.31.47.0-255,66,51450,90,370186
96,0.001173,74.125.24.0-255,7156,58606,90,370186
97,0.001175,172.31.47.0-255,66,58672,90,370186
98,0.001203,74.125.24.0-255,6438,65110,90,370186
99,0.001205,172.31.47.0-255,66,65176,90,370186
100,0.00173,74.125.24.0-255,411,65587,90,370186
101,0.001732,172.31.47.0-255,66,65653,90,370186
102,0.001768,74.125.24.0-255,1484,67137,90,370186
103,0.00177,172.31.47.0-255,66,67203,90,370186
104,0.001782,74.125.24.0-255,2902,70105,90,370186
105,0.001812,74.125.24.0-255,5738,75843,90,370186
106,0.001863,74.125.24.0-255,2902,78745,90,370186
107,0.001886,74.125.24.0-255,9992,88737,90,370186
108,0.001934,74.125.24.0-255,10692,99429,90,370186
109,0.002168,74.125.24.0-255,1484,100913,90,370186
110,0.002193,74.125.24.0-255,1484,102397,90,370186
111,0.002214,74.125.24.0-255,2902,105299,90,370186
112,0.002253,74.125.24.0-255,4320,109619,90,370186
113,0.002277,74.125.24.0-255,5738,115357,90,370186
114,0.002328,74.125.24.0-255,4320,119677,90,370186
115,0.002339,74.125.24.0-255,2902,122579,90,370186
116,0.002373,74.125.24.0-255,2902,125481,90,370186
117,0.002389,74.125.24.0-255,4320,129801,90,370186
118,0.002415,74.125.24.0-255,7856,137657,90,370186
119,0.00242,74.125.24.0-255,5738,143395,90,370186
120,0.002441,74.125.24.0-255,7156,150551,90,370186
121,0.00246,74.125.24.0-255,8574,159125,90,370186
122,0.002462,74.125.24.0-255,1484,160609,90,370186
123,0.002478,74.125.24.0-255,6438,167047,90,370186
124,0.002548,74.125.24.0-255,1484,168531,90,370186
125,0.002559,74.125.24.0-255,1484,170015,90,370186
126,0.002574,74.125.24.0-255,1484,171499,90,370186
127,0.002578,74.125.24.0-255,2902,174401,90,370186
128,0.00258,74.125.24.0-255,1484,175885,90,370186
129,0.002598,74.125.24.0-255,1484,177369,90,370186
130,0.00261,74.125.24.0-255,5738,183107,90,370186
131,0.002631,74.125.24.0-255,5738,188845,90,370186
132,0.002636,74.125.24.0-255,7156,196001,90,370186
133,0.002641,74.125.24.0-255,5020,201021,90,370186
134,0.002706,74.125.24.0-255,1484,202505,90,370186
135,0.002718,74.125.24.0-255,1484,203989,90,370186
136,0.002729,74.125.24.0-255,1484,205473,90,370186
137,0.002733,74.125.24.0-255,2902,208375,90,370186
138,0.002749,74.125.24.0-255,2902,211277,90,370186
139,0.002762,74.125.24.0-255,2902,214179,90,370186
140,0.002782,74.125.24.0-255,9992,224171,90,370186
141,0.002822,74.125.24.0-255,1484,225655,90,370186
142,0.002838,74.125.24.0-255,4320,229975,90,370186
143,0.002856,74.125.24.0-255,7856,237831,90,370186
144,0.002862,74.125.24.0-255,7156,244987,90,370186
145,0.002881,74.125.24.0-255,9992,254979,90,370186
146,0.002924,74.125.24.0-255,1484,256463,90,370186
147,0.002927,74.125.24.0-255,766,257229,90,370186
148,0.002929,74.125.24.0-255,1484,258713,90,370186
149,0.002932,74.125.24.0-255,2902,261615,90,370186
150,0.00298,74.125.24.0-255,5738,267353,90,370186
151,0.002987,74.125.24.0-255,9992,277345,90,370186
152,0.00303,74.125.24.0-255,5738,283083,90,370186
153,0.003049,74.125.24.0-255,7856,290939,90,370186
154,0.003062,74.125.24.0-255,4320,295259,90,370186
155,0.003084,74.125.24.0-255,9992,305251,90,370186
156,0.003091,74.125.24.0-255,7156,312407,90,370186
157,0.003145,74.125.24.0-255,7156,319563,90,370186
158,0.003188,74.125.24.0-255,8574,328137,90,370186
159,0.003212,74.125.24.0-255,3602,331739,90,370186
160,0.003247,74.125.24.0-255,1484,333223,90,370186
161,0.003251,74.125.24.0-255,2902,336125,90,370186
162,0.00328,74.125.24.0-255,5738,341863,90,370186
163,0.003305,74.125.24.0-255,5738,347601,90,370186
164,0.003321,74.125.24.0-255,4320,351921,90,370186
165,0.00334,74.125.24.0-255,7156,359077,90,370186
166,0.003363,74.125.24.0-255,1484,360561,90,370186
167,0.003369,74.125.24.0-255,5020,365581,90,370186
168,0.0034,74.125.24.0-255,3609,369190,90,370186
169,0.003434,74.125.24.0-255,105,369295,90,370186
170,0.00345,74.125.24.0-255,129,369424,90,370186
171,0.00386,172.31.47.0-255,66,369490,90,370186
172,0.006651,172.31.47.0-255,105,369595,90,370186
173,0.00668,172.31.47.0-255,105,369700,90,370186
174,0.006933,172.31.47.0-255,90,369790,90,370186
175,0.006943,172.31.47.0-255,66,369856,90,370186
176,0.009167,74.125.24.0-255,66,369922,90,370186
177,0.009209,74.125.24.0-255,66,369988,90,370186
178,0.009465,74.125.24.0-255,66,370054,90,370186
179,0.009494,74.125.24.0-255,66,370120,90,370186
180,0.0095,172.31.47.0-255,66,370186,90,370186
181,0.0,74.125.24.0-255,152,152,90,214412
182,3.5e-05,172.31.47.0-255,66,218,90,214412
183,4.2e-05,74.125.24.0-255,1484,1702,90,214412
184,4.6e-05,172.31.47.0-255,66,1768,90,214412
185,5.1e-05,74.125.24.0-255,2902,4670,90,214412
186,6e-05,172.31.47.0-255,66,4736,90,214412
187,6.7e-05,74.125.24.0-255,7156,11892,90,214412
188,7e-05,172.31.47.0-255,66,11958,90,214412
189,0.000129,172.31.47.0-255,66,12024,90,214412
190,0.000135,74.125.24.0-255,2543,14567,90,214412
191,0.000137,172.31.47.0-255,66,14633,90,214412
192,0.000183,74.125.24.0-255,1484,16117,90,214412
193,0.000186,172.31.47.0-255,66,16183,90,214412
194,0.00019,74.125.24.0-255,2902,19085,90,214412
195,0.000192,172.31.47.0-255,66,19151,90,214412
196,0.000219,74.125.24.0-255,5738,24889,90,214412
197,0.000221,172.31.47.0-255,66,24955,90,214412
198,0.000253,172.31.47.0-255,66,25021,90,214412
199,0.000307,74.125.24.0-255,7156,32177,90,214412
200,0.00031,172.31.47.0-255,66,32243,90,214412
201,0.000338,74.125.24.0-255,2900,35143,90,214412
202,0.00034,172.31.47.0-255,66,35209,90,214412
203,0.000343,74.125.24.0-255,329,35538,90,214412
204,0.000344,172.31.47.0-255,66,35604,90,214412
205,0.000687,74.125.24.0-255,1484,37088,90,214412
206,0.000691,172.31.47.0-255,66,37154,90,214412
207,0.000717,74.125.24.0-255,2902,40056,90,214412
208,0.00072,172.31.47.0-255,66,40122,90,214412
209,0.000725,74.125.24.0-255,5738,45860,90,214412
210,0.000727,172.31.47.0-255,66,45926,90,214412
211,0.000755,74.125.24.0-255,4320,50246,90,214412
212,0.000757,172.31.47.0-255,66,50312,90,214412
213,0.000784,74.125.24.0-255,7156,57468,90,214412
214,0.000787,172.31.47.0-255,66,57534,90,214412
215,0.000798,172.31.47.0-255,66,57600,90,214412
216,0.001551,74.125.24.0-255,1484,59084,90,214412
217,0.001575,74.125.24.0-255,2902,61986,90,214412
218,0.001578,172.31.47.0-255,66,62052,90,214412
219,0.001584,74.125.24.0-255,5738,67790,90,214412
220,0.001586,172.31.47.0-255,66,67856,90,214412
221,0.001613,74.125.24.0-255,9992,77848,90,214412
222,0.001615,172.31.47.0-255,66,77914,90,214412
223,0.001639,74.125.24.0-255,2902,80816,90,214412
224,0.001641,172.31.47.0-255,66,80882,90,214412
225,0.001648,74.125.24.0-255,9992,90874,90,214412
226,0.00165,172.31.47.0-255,66,90940,90,214412
227,0.001656,74.125.24.0-255,766,91706,90,214412
228,0.002092,74.125.24.0-255,1484,93190,90,214412
229,0.002093,172.31.47.0-255,66,93256,90,214412
230,0.002096,74.125.24.0-255,1484,94740,90,214412
231,0.002115,74.125.24.0-255,1484,96224,90,214412
232,0.002117,172.31.47.0-255,66,96290,90,214412
233,0.002122,74.125.24.0-255,5738,102028,90,214412
234,0.002124,172.31.47.0-255,66,102094,90,214412
235,0.002142,74.125.24.0-255,2902,104996,90,214412
236,0.002143,172.31.47.0-255,66,105062,90,214412
237,0.002177,74.125.24.0-255,9992,115054,90,214412
238,0.002179,172.31.47.0-255,66,115120,90,214412
239,0.002187,74.125.24.0-255,10692,125812,90,214412
240,0.002188,172.31.47.0-255,66,125878,90,214412
241,0.00228,74.125.24.0-255,1484,127362,90,214412
242,0.002293,74.125.24.0-255,2902,130264,90,214412
243,0.002296,172.31.47.0-255,66,130330,90,214412
244,0.002318,74.125.24.0-255,5738,136068,90,214412
245,0.00232,172.31.47.0-255,66,136134,90,214412
246,0.002322,74.125.24.0-255,1484,137618,90,214412
247,0.002344,74.125.24.0-255,4320,141938,90,214412
248,0.002346,172.31.47.0-255,66,142004,90,214412
249,0.002359,74.125.24.0-255,2902,144906,90,214412
250,0.002361,172.31.47.0-255,66,144972,90,214412
251,0.002389,74.125.24.0-255,9992,154964,90,214412
252,0.002391,172.31.47.0-255,66,155030,90,214412
253,0.002395,74.125.24.0-255,5020,160050,90,214412
254,0.002397,172.31.47.0-255,66,160116,90,214412
255,0.00243,74.125.24.0-255,1484,161600,90,214412
256,0.002464,172.31.47.0-255,66,161666,90,214412
257,0.00248,74.125.24.0-255,4320,165986,90,214412
258,0.002483,172.31.47.0-255,66,166052,90,214412
259,0.00249,74.125.24.0-255,7156,173208,90,214412
260,0.002492,172.31.47.0-255,66,173274,90,214412
261,0.002516,74.125.24.0-255,7856,181130,90,214412
262,0.002518,172.31.47.0-255,66,181196,90,214412
263,0.002529,74.125.24.0-255,1484,182680,90,214412
264,0.002536,74.125.24.0-255,2902,185582,90,214412
265,0.002538,172.31.47.0-255,66,185648,90,214412
266,0.002558,74.125.24.0-255,2902,188550,90,214412
267,0.00256,172.31.47.0-255,66,188616,90,214412
268,0.002585,74.125.24.0-255,2902,191518,90,214412
269,0.002587,172.31.47.0-255,66,191584,90,214412
270,0.002605,172.31.47.0-255,66,191650,90,214412
271,0.002612,74.125.24.0-255,8574,200224,90,214412
272,0.002614,172.31.47.0-255,66,200290,90,214412
273,0.002617,74.125.24.0-255,2184,202474,90,214412
274,0.002654,172.31.47.0-255,66,202540,90,214412
275,0.005196,74.125.24.0-255,2902,205442,90,214412
276,0.0052,172.31.47.0-255,66,205508,90,214412
277,0.005264,74.125.24.0-255,2902,208410,90,214412
278,0.005266,172.31.47.0-255,66,208476,90,214412
279,0.007786,74.125.24.0-255,2902,211378,90,214412
280,0.007793,172.31.47.0-255,66,211444,90,214412
281,0.007892,74.125.24.0-255,2902,214346,90,214412
282,0.007897,172.31.47.0-255,66,214412,90,214412
283,0.0,74.125.24.0-255,152,152,90,225864
284,1.4e-05,172.31.47.0-255,66,218,90,225864
285,2e-05,74.125.24.0-255,1484,1702,90,225864
286,2.4e-05,172.31.47.0-255,66,1768,90,225864
287,4.8e-05,74.125.24.0-255,2902,4670,90,225864
288,5.2e-05,172.31.47.0-255,66,4736,90,225864
289,5.9e-05,74.125.24.0-255,7156,11892,90,225864
290,6.1e-05,172.31.47.0-255,66,11958,90,225864
291,6.3e-05,74.125.24.0-255,1484,13442,90,225864
292,6.5e-05,172.31.47.0-255,66,13508,90,225864
293,0.000111,74.125.24.0-255,5738,19246,90,225864
294,0.000114,172.31.47.0-255,66,19312,90,225864
295,0.000137,74.125.24.0-255,4786,24098,90,225864
296,0.000139,172.31.47.0-255,66,24164,90,225864
297,0.000144,74.125.24.0-255,6797,30961,90,225864
298,0.000146,172.31.47.0-255,66,31027,90,225864
299,0.000213,74.125.24.0-255,1484,32511,90,225864
300,0.000216,172.31.47.0-255,66,32577,90,225864
301,0.00022,74.125.24.0-255,2902,35479,90,225864
302,0.000221,172.31.47.0-255,66,35545,90,225864
303,0.000244,74.125.24.0-255,5738,41283,90,225864
304,0.000248,172.31.47.0-255,66,41349,90,225864
305,0.00027,74.125.24.0-255,4320,45669,90,225864
306,0.000273,172.31.47.0-255,66,45735,90,225864
307,0.000297,74.125.24.0-255,9633,55368,90,225864
308,0.0003,172.31.47.0-255,66,55434,90,225864
309,0.000319,74.125.24.0-255,4320,59754,90,225864
310,0.000322,172.31.47.0-255,66,59820,90,225864
311,0.000343,74.125.24.0-255,5687,65507,90,225864
312,0.000346,172.31.47.0-255,66,65573,90,225864
313,0.000348,74.125.24.0-255,379,65952,90,225864
314,0.00035,172.31.47.0-255,66,66018,90,225864
315,0.000672,74.125.24.0-255,1484,67502,90,225864
316,0.000679,74.125.24.0-255,2902,70404,90,225864
317,0.000683,172.31.47.0-255,66,70470,90,225864
318,0.000686,74.125.24.0-255,1484,71954,90,225864
319,0.000707,74.125.24.0-255,4320,76274,90,225864
320,0.00071,172.31.47.0-255,66,76340,90,225864
321,0.00075,74.125.24.0-255,9992,86332,90,225864
322,0.000753,172.31.47.0-255,66,86398,90,225864
323,0.00077,74.125.24.0-255,2902,89300,90,225864
324,0.000775,74.125.24.0-255,5738,95038,90,225864
325,0.000779,172.31.47.0-255,66,95104,90,225864
326,0.000782,172.31.47.0-255,66,95170,90,225864
327,0.000791,74.125.24.0-255,5020,100190,90,225864
328,0.000794,172.31.47.0-255,66,100256,90,225864
329,0.001102,74.125.24.0-255,1484,101740,90,225864
330,0.001108,74.125.24.0-255,2902,104642,90,225864
331,0.001111,172.31.47.0-255,66,104708,90,225864
332,0.001115,74.125.24.0-255,1484,106192,90,225864
333,0.001134,74.125.24.0-255,4320,110512,90,225864
334,0.001136,172.31.47.0-255,66,110578,90,225864
335,0.001148,74.125.24.0-255,2902,113480,90,225864
336,0.00115,172.31.47.0-255,66,113546,90,225864
337,0.001177,74.125.24.0-255,7156,120702,90,225864
338,0.001179,172.31.47.0-255,66,120768,90,225864
339,0.00119,172.31.47.0-255,66,120834,90,225864
340,0.001193,74.125.24.0-255,1484,122318,90,225864
341,0.001218,74.125.24.0-255,2184,124502,90,225864
342,0.00122,172.31.47.0-255,66,124568,90,225864
343,0.001225,74.125.24.0-255,4320,128888,90,225864
344,0.001226,172.31.47.0-255,66,128954,90,225864
345,0.001233,74.125.24.0-255,9992,138946,90,225864
346,0.001235,172.31.47.0-255,66,139012,90,225864
347,0.001247,74.125.24.0-255,2902,141914,90,225864
348,0.00125,172.31.47.0-255,66,141980,90,225864
349,0.001278,172.31.47.0-255,66,142046,90,225864
350,0.001309,74.125.24.0-255,3602,145648,90,225864
351,0.001312,172.31.47.0-255,66,145714,90,225864
352,0.001316,74.125.24.0-255,4320,150034,90,225864
353,0.001317,172.31.47.0-255,66,150100,90,225864
354,0.001335,74.125.24.0-255,2902,153002,90,225864
355,0.001338,172.31.47.0-255,66,153068,90,225864
356,0.001361,74.125.24.0-255,7156,160224,90,225864
357,0.001363,172.31.47.0-255,66,160290,90,225864
358,0.001368,74.125.24.0-255,5738,166028,90,225864
359,0.00137,172.31.47.0-255,66,166094,90,225864
360,0.00142,74.125.24.0-255,4320,170414,90,225864
361,0.001423,172.31.47.0-255,66,170480,90,225864
362,0.001444,74.125.24.0-255,9274,179754,90,225864
363,0.001446,172.31.47.0-255,66,179820,90,225864
364,0.001857,74.125.24.0-255,1484,181304,90,225864
365,0.001862,74.125.24.0-255,2902,184206,90,225864
366,0.001864,172.31.47.0-255,66,184272,90,225864
367,0.001887,74.125.24.0-255,5738,190010,90,225864
368,0.001889,172.31.47.0-255,66,190076,90,225864
369,0.001922,172.31.47.0-255,66,190142,90,225864
370,0.001927,74.125.24.0-255,5738,195880,90,225864
371,0.001928,172.31.47.0-255,66,195946,90,225864
372,0.001962,74.125.24.0-255,5020,200966,90,225864
373,0.001965,172.31.47.0-255,66,201032,90,225864
374,0.002022,74.125.24.0-255,1484,202516,90,225864
375,0.002039,74.125.24.0-255,2902,205418,90,225864
376,0.002042,172.31.47.0-255,66,205484,90,225864
377,0.002045,74.125.24.0-255,2902,208386,90,225864
378,0.002047,172.31.47.0-255,66,208452,90,225864
379,0.004069,74.125.24.0-255,5738,214190,90,225864
380,0.004074,172.31.47.0-255,66,214256,90,225864
381,0.006134,74.125.24.0-255,5738,219994,90,225864
382,0.006142,172.31.47.0-255,66,220060,90,225864
383,0.008195,74.125.24.0-255,5738,225798,90,225864
384,0.008201,172.31.47.0-255,66,225864,90,225864
385,0.0,172.217.194.0-255,153,153,90,293068
386,1.5e-05,172.31.47.0-255,66,219,90,293068
387,2.2e-05,172.217.194.0-255,1484,1703,90,293068
388,2.6e-05,172.31.47.0-255,66,1769,90,293068
389,3.1e-05,172.217.194.0-255,2902,4671,90,293068
390,3.5e-05,172.31.47.0-255,66,4737,90,293068
391,3.8e-05,172.217.194.0-255,1484,6221,90,293068
392,4e-05,172.31.47.0-255,66,6287,90,293068
393,7e-05,172.217.194.0-255,5738,12025,90,293068
394,7.2e-05,172.31.47.0-255,66,12091,90,293068
395,0.0001,172.31.47.0-255,66,12157,90,293068
396,0.000116,172.217.194.0-255,660,12817,90,293068
397,0.000118,172.31.47.0-255,66,12883,90,293068
398,0.000122,172.217.194.0-255,3961,16844,90,293068
399,0.000125,172.31.47.0-255,66,16910,90,293068
400,0.000136,172.217.194.0-255,1484,18394,90,293068
401,0.000138,172.31.47.0-255,66,18460,90,293068
402,0.000142,172.217.194.0-255,2902,21362,90,293068
403,0.000144,172.31.47.0-255,66,21428,90,293068
404,0.000172,172.217.194.0-255,5738,27166,90,293068
405,0.000176,172.31.47.0-255,66,27232,90,293068
406,0.000194,172.217.194.0-255,5738,32970,90,293068
407,0.000197,172.31.47.0-255,66,33036,90,293068
408,0.000222,172.217.194.0-255,6797,39833,90,293068
409,0.000224,172.31.47.0-255,66,39899,90,293068
410,0.000256,172.217.194.0-255,4320,44219,90,293068
411,0.000258,172.31.47.0-255,66,44285,90,293068
412,0.00028,172.217.194.0-255,7105,51390,90,293068
413,0.000283,172.31.47.0-255,66,51456,90,293068
414,0.000638,172.217.194.0-255,377,51833,90,293068
415,0.000643,172.31.47.0-255,66,51899,90,293068
416,0.000808,172.217.194.0-255,1484,53383,90,293068
417,0.000813,172.217.194.0-255,1484,54867,90,293068
418,0.000816,172.31.47.0-255,66,54933,90,293068
419,0.000837,172.217.194.0-255,1484,56417,90,293068
420,0.000846,172.217.194.0-255,5738,62155,90,293068
421,0.000848,172.31.47.0-255,66,62221,90,293068
422,0.000854,172.217.194.0-255,4320,66541,90,293068
423,0.000856,172.31.47.0-255,66,66607,90,293068
424,0.000865,172.217.194.0-255,8574,75181,90,293068
425,0.000867,172.31.47.0-255,66,75247,90,293068
426,0.000885,172.217.194.0-255,2902,78149,90,293068
427,0.000887,172.31.47.0-255,66,78215,90,293068
428,0.000903,172.217.194.0-255,4320,82535,90,293068
429,0.000905,172.31.47.0-255,66,82601,90,293068
430,0.000963,172.217.194.0-255,3602,86203,90,293068
431,0.000967,172.31.47.0-255,66,86269,90,293068
432,0.001579,172.217.194.0-255,1484,87753,90,293068
433,0.001589,172.217.194.0-255,2902,90655,90,293068
434,0.001596,172.31.47.0-255,66,90721,90,293068
435,0.001603,172.217.194.0-255,5738,96459,90,293068
436,0.001606,172.31.47.0-255,66,96525,90,293068
437,0.001644,172.31.47.0-255,66,96591,90,293068
438,0.001648,172.217.194.0-255,2902,99493,90,293068
439,0.00165,172.31.47.0-255,66,99559,90,293068
440,0.00167,172.217.194.0-255,7856,107415,90,293068
441,0.001672,172.31.47.0-255,66,107481,90,293068
442,0.001817,172.217.194.0-255,1484,108965,90,293068
443,0.001825,172.217.194.0-255,2902,111867,90,293068
444,0.00183,172.31.47.0-255,66,111933,90,293068
445,0.001836,172.217.194.0-255,4320,116253,90,293068
446,0.001839,172.31.47.0-255,66,116319,90,293068
447,0.001867,172.217.194.0-255,1484,117803,90,293068
448,0.001876,172.217.194.0-255,8574,126377,90,293068
449,0.001879,172.31.47.0-255,66,126443,90,293068
450,0.001906,172.217.194.0-255,4320,130763,90,293068
451,0.001909,172.31.47.0-255,66,130829,90,293068
452,0.001935,172.217.194.0-255,10692,141521,90,293068
453,0.001938,172.31.47.0-255,66,141587,90,293068
454,0.001952,172.217.194.0-255,1484,143071,90,293068
455,0.001955,172.217.194.0-255,1484,144555,90,293068
456,0.001958,172.31.47.0-255,66,144621,90,293068
457,0.001977,172.217.194.0-255,1484,146105,90,293068
458,0.001982,172.217.194.0-255,4320,150425,90,293068
459,0.001985,172.31.47.0-255,66,150491,90,293068
460,0.001999,172.217.194.0-255,1484,151975,90,293068
461,0.002003,172.217.194.0-255,2902,154877,90,293068
462,0.002005,172.31.47.0-255,66,154943,90,293068
463,0.002037,172.217.194.0-255,9992,164935,90,293068
464,0.00204,172.31.47.0-255,66,165001,90,293068
465,0.002043,172.217.194.0-255,1484,166485,90,293068
466,0.00206,172.217.194.0-255,5738,172223,90,293068
467,0.002062,172.31.47.0-255,66,172289,90,293068
468,0.002082,172.217.194.0-255,3602,175891,90,293068
469,0.002085,172.31.47.0-255,66,175957,90,293068
470,0.002099,172.217.194.0-255,1484,177441,90,293068
471,0.002102,172.217.194.0-255,1484,178925,90,293068
472,0.002104,172.31.47.0-255,66,178991,90,293068
473,0.002121,172.217.194.0-255,1484,180475,90,293068
474,0.002167,172.217.194.0-255,1484,181959,90,293068
475,0.002169,172.31.47.0-255,66,182025,90,293068
476,0.002188,172.217.194.0-255,4320,186345,90,293068
477,0.00219,172.31.47.0-255,66,186411,90,293068
478,0.002204,172.31.47.0-255,66,186477,90,293068
479,0.002213,172.217.194.0-255,9992,196469,90,293068
480,0.002216,172.31.47.0-255,66,196535,90,293068
481,0.002219,172.217.194.0-255,766,197301,90,293068
482,0.002309,172.217.194.0-255,1484,198785,90,293068
483,0.002312,172.31.47.0-255,66,198851,90,293068
484,0.002317,172.217.194.0-255,2902,201753,90,293068
485,0.002319,172.31.47.0-255,66,201819,90,293068
486,0.002339,172.217.194.0-255,5738,207557,90,293068
487,0.002342,172.31.47.0-255,66,207623,90,293068
488,0.002373,172.217.194.0-255,9992,217615,90,293068
489,0.002376,172.31.47.0-255,66,217681,90,293068
490,0.002396,172.217.194.0-255,2902,220583,90,293068
491,0.002398,172.31.47.0-255,66,220649,90,293068
492,0.002408,172.217.194.0-255,10692,231341,90,293068
493,0.00241,172.31.47.0-255,66,231407,90,293068
494,0.002415,172.217.194.0-255,4320,235727,90,293068
495,0.002417,172.31.47.0-255,66,235793,90,293068
496,0.002434,172.217.194.0-255,4320,240113,90,293068
497,0.002437,172.31.47.0-255,66,240179,90,293068
498,0.002464,172.217.194.0-255,1484,241663,90,293068
499,0.002477,172.31.47.0-255,66,241729,90,293068
500,0.002491,172.31.47.0-255,66,241795,90,293068
501,0.002534,172.31.47.0-255,66,241861,90,293068
502,0.00256,172.217.194.0-255,9992,251853,90,293068
503,0.002568,172.217.194.0-255,7856,259709,90,293068
504,0.002594,172.217.194.0-255,5738,265447,90,293068
505,0.002659,172.217.194.0-255,1484,266931,90,293068
506,0.002668,172.217.194.0-255,10692,277623,90,293068
507,0.002671,172.217.194.0-255,1484,279107,90,293068
508,0.002674,172.217.194.0-255,1484,280591,90,293068
509,0.002694,172.217.194.0-255,9274,289865,90,293068
510,0.0027,172.217.194.0-255,2927,292792,90,293068
511,0.002766,172.217.194.0-255,105,292897,90,293068
512,0.005314,172.31.47.0-255,66,292963,90,293068
513,0.00769,172.31.47.0-255,105,293068,90,293068
514,0.0,74.125.200.0-255,146,146,90,289631
515,2.3e-05,172.31.47.0-255,66,212,90,289631
516,2.9e-05,74.125.200.0-255,1484,1696,90,289631
517,3.3e-05,172.31.47.0-255,66,1762,90,289631
518,6.7e-05,74.125.200.0-255,2902,4664,90,289631
519,7e-05,172.31.47.0-255,66,4730,90,289631
520,7.7e-05,74.125.200.0-255,7156,11886,90,289631
521,7.9e-05,172.31.47.0-255,66,11952,90,289631
522,0.00012,74.125.200.0-255,2045,13997,90,289631
523,0.000123,172.31.47.0-255,66,14063,90,289631
524,0.000128,74.125.200.0-255,2902,16965,90,289631
525,0.00013,172.31.47.0-255,66,17031,90,289631
526,0.000137,74.125.200.0-255,7156,24187,90,289631
527,0.000139,172.31.47.0-255,66,24253,90,289631
528,0.000171,74.125.200.0-255,4320,28573,90,289631
529,0.000174,172.31.47.0-255,66,28639,90,289631
530,0.000205,74.125.200.0-255,2543,31182,90,289631
531,0.000209,172.31.47.0-255,66,31248,90,289631
532,0.000314,74.125.200.0-255,1484,32732,90,289631
533,0.000318,172.31.47.0-255,66,32798,90,289631
534,0.000349,74.125.200.0-255,2902,35700,90,289631
535,0.000353,172.31.47.0-255,66,35766,90,289631
536,0.00036,74.125.200.0-255,5738,41504,90,289631
537,0.000363,172.31.47.0-255,66,41570,90,289631
538,0.000398,74.125.200.0-255,8215,49785,90,289631
539,0.000402,172.31.47.0-255,66,49851,90,289631
540,0.000429,74.125.200.0-255,8574,58425,90,289631
541,0.000434,172.31.47.0-255,66,58491,90,289631
542,0.00048,74.125.200.0-255,1484,59975,90,289631
543,0.000484,172.31.47.0-255,66,60041,90,289631
544,0.000513,74.125.200.0-255,4320,64361,90,289631
545,0.000516,172.31.47.0-255,66,64427,90,289631
546,0.00052,74.125.200.0-255,1125,65552,90,289631
547,0.000523,74.125.200.0-255,645,66197,90,289631
548,0.000564,172.31.47.0-255,66,66263,90,289631
549,0.000908,74.125.200.0-255,1484,67747,90,289631
550,0.000915,74.125.200.0-255,2902,70649,90,289631
551,0.000918,172.31.47.0-255,66,70715,90,289631
552,0.000922,74.125.200.0-255,1484,72199,90,289631
553,0.000955,74.125.200.0-255,4320,76519,90,289631
554,0.000958,172.31.47.0-255,66,76585,90,289631
555,0.000965,74.125.200.0-255,7156,83741,90,289631
556,0.000967,172.31.47.0-255,66,83807,90,289631
557,0.000992,74.125.200.0-255,1484,85291,90,289631
558,0.001011,74.125.200.0-255,7156,92447,90,289631
559,0.001014,172.31.47.0-255,66,92513,90,289631
560,0.001055,74.125.200.0-255,5738,98251,90,289631
561,0.001058,172.31.47.0-255,66,98317,90,289631
562,0.001083,74.125.200.0-255,2184,100501,90,289631
563,0.001086,172.31.47.0-255,66,100567,90,289631
564,0.001237,74.125.200.0-255,1484,102051,90,289631
565,0.001254,74.125.200.0-255,2902,104953,90,289631
566,0.001257,172.31.47.0-255,66,105019,90,289631
567,0.001284,74.125.200.0-255,5738,110757,90,289631
568,0.001287,172.31.47.0-255,66,110823,90,289631
569,0.001306,74.125.200.0-255,5738,116561,90,289631
570,0.00131,172.31.47.0-255,66,116627,90,289631
571,0.001331,74.125.200.0-255,1484,118111,90,289631
572,0.001366,74.125.200.0-255,2902,121013,90,289631
573,0.001369,172.31.47.0-255,66,121079,90,289631
574,0.001385,74.125.200.0-255,1484,122563,90,289631
575,0.001402,74.125.200.0-255,2902,125465,90,289631
576,0.001405,172.31.47.0-255,66,125531,90,289631
577,0.001409,74.125.200.0-255,2902,128433,90,289631
578,0.001411,172.31.47.0-255,66,128499,90,289631
579,0.001429,74.125.200.0-255,2902,131401,90,289631
580,0.001435,172.31.47.0-255,66,131467,90,289631
581,0.001437,74.125.200.0-255,1484,132951,90,289631
582,0.00146,74.125.200.0-255,2184,135135,90,289631
583,0.001463,172.31.47.0-255,66,135201,90,289631
584,0.001511,74.125.200.0-255,1484,136685,90,289631
585,0.001525,74.125.200.0-255,2902,139587,90,289631
586,0.001527,172.31.47.0-255,66,139653,90,289631
587,0.001553,74.125.200.0-255,4320,143973,90,289631
588,0.001556,172.31.47.0-255,66,144039,90,289631
589,0.001561,74.125.200.0-255,5738,149777,90,289631
590,0.001563,172.31.47.0-255,66,149843,90,289631
591,0.001595,74.125.200.0-255,7156,156999,90,289631
592,0.001598,172.31.47.0-255,66,157065,90,289631
593,0.001614,74.125.200.0-255,4320,161385,90,289631
594,0.001616,172.31.47.0-255,66,161451,90,289631
595,0.001666,74.125.200.0-255,2902,164353,90,289631
596,0.001669,172.31.47.0-255,66,164419,90,289631
597,0.001691,74.125.200.0-255,1484,165903,90,289631
598,0.001696,74.125.200.0-255,3602,169505,90,289631
599,0.0017,172.31.47.0-255,66,169571,90,289631
600,0.001723,74.125.200.0-255,4320,173891,90,289631
601,0.001726,172.31.47.0-255,66,173957,90,289631
602,0.001752,74.125.200.0-255,8574,182531,90,289631
603,0.001756,172.31.47.0-255,66,182597,90,289631
604,0.001796,74.125.200.0-255,4320,186917,90,289631
605,0.001799,172.31.47.0-255,66,186983,90,289631
606,0.001826,74.125.200.0-255,5738,192721,90,289631
607,0.001829,172.31.47.0-255,66,192787,90,289631
608,0.001895,74.125.200.0-255,5738,198525,90,289631
609,0.001898,172.31.47.0-255,66,198591,90,289631
610,0.001909,74.125.200.0-255,1484,200075,90,289631
611,0.001917,74.125.200.0-255,3602,203677,90,289631
612,0.001919,172.31.47.0-255,66,203743,90,289631
613,0.001942,74.125.200.0-255,2902,206645,90,289631
614,0.001945,172.31.47.0-255,66,206711,90,289631
615,0.001947,74.125.200.0-255,1484,208195,90,289631
616,0.001976,74.125.200.0-255,7156,215351,90,289631
617,0.001979,172.31.47.0-255,66,215417,90,289631
618,0.002009,74.125.200.0-255,2902,218319,90,289631
619,0.002012,172.31.47.0-255,66,218385,90,289631
620,0.002025,74.125.200.0-255,4320,222705,90,289631
621,0.002032,172.31.47.0-255,66,222771,90,289631
622,0.002059,74.125.200.0-255,8574,231345,90,289631
623,0.002062,172.31.47.0-255,66,231411,90,289631
624,0.002114,74.125.200.0-255,6438,237849,90,289631
625,0.002117,172.31.47.0-255,66,237915,90,289631
626,0.002192,74.125.200.0-255,1484,239399,90,289631
627,0.002208,74.125.200.0-255,2902,242301,90,289631
628,0.002211,172.31.47.0-255,66,242367,90,289631
629,0.002231,74.125.200.0-255,5738,248105,90,289631
630,0.002235,172.31.47.0-255,66,248171,90,289631
631,0.002277,74.125.200.0-255,5738,253909,90,289631
632,0.002281,172.31.47.0-255,66,253975,90,289631
633,0.002311,74.125.200.0-255,1484,255459,90,289631
634,0.00232,74.125.200.0-255,8574,264033,90,289631
635,0.002322,172.31.47.0-255,66,264099,90,289631
636,0.002349,74.125.200.0-255,4320,268419,90,289631
637,0.002351,172.31.47.0-255,66,268485,90,289631
638,0.002377,74.125.200.0-255,3602,272087,90,289631
639,0.00238,172.31.47.0-255,66,272153,90,289631
640,0.004643,74.125.200.0-255,1484,273637,90,289631
641,0.004669,74.125.200.0-255,4320,277957,90,289631
642,0.004673,172.31.47.0-255,66,278023,90,289631
643,0.006986,74.125.200.0-255,5738,283761,90,289631
644,0.006993,172.31.47.0-255,66,283827,90,289631
645,0.009293,74.125.200.0-255,5738,289565,90,289631
646,0.009299,172.31.47.0-255,66,289631,90,289631
647,0.0,74.125.130.0-255,153,153,90,192163
648,3.3e-05,172.31.47.0-255,66,219,90,192163
649,3.9e-05,74.125.130.0-255,1484,1703,90,192163
650,4.4e-05,172.31.47.0-255,66,1769,90,192163
651,4.9e-05,74.125.130.0-255,2902,4671,90,192163
652,5.7e-05,172.31.47.0-255,66,4737,90,192163
653,6.4e-05,74.125.130.0-255,5738,10475,90,192163
654,6.6e-05,172.31.47.0-255,66,10541,90,192163
655,8.5e-05,74.125.130.0-255,1484,12025,90,192163
656,8.7e-05,172.31.47.0-255,66,12091,90,192163
657,0.000115,74.125.130.0-255,5007,17098,90,192163
658,0.000118,172.31.47.0-255,66,17164,90,192163
659,0.000123,74.125.130.0-255,4320,21484,90,192163
660,0.000124,172.31.47.0-255,66,21550,90,192163
661,0.000149,74.125.130.0-255,2902,24452,90,192163
662,0.000152,172.31.47.0-255,66,24518,90,192163
663,0.000184,74.125.130.0-255,6797,31315,90,192163
664,0.000187,172.31.47.0-255,66,31381,90,192163
665,0.000253,74.125.130.0-255,1484,32865,90,192163
666,0.000256,172.31.47.0-255,66,32931,90,192163
667,0.000282,74.125.130.0-255,2902,35833,90,192163
668,0.000285,172.31.47.0-255,66,35899,90,192163
669,0.000307,74.125.130.0-255,1484,37383,90,192163
670,0.00031,172.31.47.0-255,66,37449,90,192163
671,0.000332,74.125.130.0-255,1484,38933,90,192163
672,0.000335,172.31.47.0-255,66,38999,90,192163
673,0.00034,74.125.130.0-255,4320,43319,90,192163
674,0.000342,172.31.47.0-255,66,43385,90,192163
675,0.000368,74.125.130.0-255,2902,46287,90,192163
676,0.000374,172.31.47.0-255,66,46353,90,192163
677,0.000417,74.125.130.0-255,2543,48896,90,192163
678,0.00042,172.31.47.0-255,66,48962,90,192163
679,0.000689,74.125.130.0-255,1484,50446,90,192163
680,0.000714,74.125.130.0-255,1484,51930,90,192163
681,0.000718,172.31.47.0-255,66,51996,90,192163
682,0.000722,74.125.130.0-255,1484,53480,90,192163
683,0.000743,74.125.130.0-255,1484,54964,90,192163
684,0.000747,172.31.47.0-255,66,55030,90,192163
685,0.000753,74.125.130.0-255,5738,60768,90,192163
686,0.000755,172.31.47.0-255,66,60834,90,192163
687,0.000787,74.125.130.0-255,5379,66213,90,192163
688,0.000791,172.31.47.0-255,66,66279,90,192163
689,0.000794,74.125.130.0-255,646,66925,90,192163
690,0.000899,74.125.130.0-255,1484,68409,90,192163
691,0.000903,172.31.47.0-255,66,68475,90,192163
692,0.000906,74.125.130.0-255,1484,69959,90,192163
693,0.000927,74.125.130.0-255,1484,71443,90,192163
694,0.000929,172.31.47.0-255,66,71509,90,192163
695,0.000936,74.125.130.0-255,4320,75829,90,192163
696,0.000938,172.31.47.0-255,66,75895,90,192163
697,0.000982,74.125.130.0-255,9633,85528,90,192163
698,0.000986,172.31.47.0-255,66,85594,90,192163
699,0.001022,74.125.130.0-255,2902,88496,90,192163
700,0.001025,172.31.47.0-255,66,88562,90,192163
701,0.001055,74.125.130.0-255,5738,94300,90,192163
702,0.001059,172.31.47.0-255,66,94366,90,192163
703,0.001063,74.125.130.0-255,2902,97268,90,192163
704,0.001065,172.31.47.0-255,66,97334,90,192163
705,0.001095,74.125.130.0-255,3961,101295,90,192163
706,0.001099,172.31.47.0-255,66,101361,90,192163
707,0.001134,74.125.130.0-255,1484,102845,90,192163
708,0.001146,74.125.130.0-255,2902,105747,90,192163
709,0.001148,172.31.47.0-255,66,105813,90,192163
710,0.001173,74.125.130.0-255,5738,111551,90,192163
711,0.001175,172.31.47.0-255,66,111617,90,192163
712,0.001203,74.125.130.0-255,7156,118773,90,192163
713,0.001205,172.31.47.0-255,66,118839,90,192163
714,0.001227,74.125.130.0-255,1484,120323,90,192163
715,0.00124,74.125.130.0-255,2902,123225,90,192163
716,0.001242,172.31.47.0-255,66,123291,90,192163
717,0.001265,74.125.130.0-255,4320,127611,90,192163
718,0.001267,172.31.47.0-255,66,127677,90,192163
719,0.001287,74.125.130.0-255,1484,129161,90,192163
720,0.00129,74.125.130.0-255,2902,132063,90,192163
721,0.001292,172.31.47.0-255,66,132129,90,192163
722,0.001296,74.125.130.0-255,2902,135031,90,192163
723,0.001298,172.31.47.0-255,66,135097,90,192163
724,0.001315,74.125.130.0-255,766,135863,90,192163
725,0.001377,74.125.130.0-255,1484,137347,90,192163
726,0.00138,172.31.47.0-255,66,137413,90,192163
727,0.001404,74.125.130.0-255,2902,140315,90,192163
728,0.001406,172.31.47.0-255,66,140381,90,192163
729,0.00141,74.125.130.0-255,2902,143283,90,192163
730,0.001412,172.31.47.0-255,66,143349,90,192163
731,0.001438,74.125.130.0-255,2902,146251,90,192163
732,0.00144,172.31.47.0-255,66,146317,90,192163
733,0.001444,74.125.130.0-255,2902,149219,90,192163
734,0.001446,172.31.47.0-255,66,149285,90,192163
735,0.001449,74.125.130.0-255,2902,152187,90,192163
736,0.001451,172.31.47.0-255,66,152253,90,192163
737,0.001479,74.125.130.0-255,1484,153737,90,192163
738,0.001486,74.125.130.0-255,8574,162311,90,192163
739,0.001487,172.31.47.0-255,66,162377,90,192163
740,0.001493,74.125.130.0-255,7156,169533,90,192163
741,0.001495,172.31.47.0-255,66,169599,90,192163
742,0.001516,74.125.130.0-255,766,170365,90,192163
743,0.003465,74.125.130.0-255,4320,174685,90,192163
744,0.003468,172.31.47.0-255,66,174751,90,192163
745,0.005451,74.125.130.0-255,5738,180489,90,192163
746,0.005457,172.31.47.0-255,66,180555,90,192163
747,0.007484,74.125.130.0-255,5738,186293,90,192163
748,0.007489,172.31.47.0-255,66,186359,90,192163
749,0.009637,74.125.130.0-255,5738,192097,90,192163
750,0.00969,172.31.47.0-255,66,192163,90,192163
751,0.0,172.31.47.0-255,66,66,90,66
752,0.0,74.125.24.0-255,153,153,90,299037
753,3.4e-05,172.31.47.0-255,66,219,90,299037
754,4.1e-05,74.125.24.0-255,1484,1703,90,299037
755,4.6e-05,172.31.47.0-255,66,1769,90,299037
756,5.1e-05,74.125.24.0-255,2902,4671,90,299037
757,5.3e-05,172.31.47.0-255,66,4737,90,299037
758,5.9e-05,74.125.24.0-255,7156,11893,90,299037
759,6.3e-05,172.31.47.0-255,66,11959,90,299037
760,6.6e-05,74.125.24.0-255,2055,14014,90,299037
761,6.8e-05,172.31.47.0-255,66,14080,90,299037
762,0.00038,74.125.24.0-255,1484,15564,90,299037
763,0.000386,172.31.47.0-255,66,15630,90,299037
764,0.000392,74.125.24.0-255,2902,18532,90,299037
765,0.000394,172.31.47.0-255,66,18598,90,299037
766,0.00042,74.125.24.0-255,5738,24336,90,299037
767,0.000423,172.31.47.0-255,66,24402,90,299037
768,0.000478,74.125.24.0-255,5738,30140,90,299037
769,0.000482,172.31.47.0-255,66,30206,90,299037
770,0.000501,74.125.24.0-255,1125,31331,90,299037
771,0.000503,172.31.47.0-255,66,31397,90,299037
772,0.000509,74.125.24.0-255,7156,38553,90,299037
773,0.000511,172.31.47.0-255,66,38619,90,299037
774,0.000523,74.125.24.0-255,1484,40103,90,299037
775,0.000526,172.31.47.0-255,66,40169,90,299037
776,0.000562,172.31.47.0-255,66,40235,90,299037
777,0.000593,74.125.24.0-255,10692,50927,90,299037
778,0.000596,172.31.47.0-255,66,50993,90,299037
779,0.000619,74.125.24.0-255,397,51390,90,299037
780,0.000622,172.31.47.0-255,66,51456,90,299037
781,0.000647,74.125.24.0-255,110,51566,90,299037
782,0.000649,172.31.47.0-255,66,51632,90,299037
783,0.000708,74.125.24.0-255,1484,53116,90,299037
784,0.000725,74.125.24.0-255,2902,56018,90,299037
785,0.000729,172.31.47.0-255,66,56084,90,299037
786,0.000735,74.125.24.0-255,4320,60404,90,299037
787,0.000737,172.31.47.0-255,66,60470,90,299037
788,0.000751,74.125.24.0-255,2902,63372,90,299037
789,0.000753,172.31.47.0-255,66,63438,90,299037
790,0.000771,74.125.24.0-255,5738,69176,90,299037
791,0.000774,172.31.47.0-255,66,69242,90,299037
792,0.000788,74.125.24.0-255,4320,73562,90,299037
793,0.000791,172.31.47.0-255,66,73628,90,299037
794,0.000822,172.31.47.0-255,66,73694,90,299037
795,0.000824,74.125.24.0-255,333,74027,90,299037
796,0.00095,74.125.24.0-255,1484,75511,90,299037
797,0.000954,172.31.47.0-255,66,75577,90,299037
798,0.000959,74.125.24.0-255,2902,78479,90,299037
799,0.000961,172.31.47.0-255,66,78545,90,299037
800,0.000973,74.125.24.0-255,1484,80029,90,299037
801,0.000986,74.125.24.0-255,4320,84349,90,299037
802,0.000989,172.31.47.0-255,66,84415,90,299037
803,0.000992,74.125.24.0-255,1484,85899,90,299037
804,0.001008,74.125.24.0-255,4320,90219,90,299037
805,0.001013,172.31.47.0-255,66,90285,90,299037
806,0.001014,74.125.24.0-255,7156,97441,90,299037
807,0.001017,172.31.47.0-255,66,97507,90,299037
808,0.001038,74.125.24.0-255,4320,101827,90,299037
809,0.00104,172.31.47.0-255,66,101893,90,299037
810,0.001066,74.125.24.0-255,6438,108331,90,299037
811,0.001069,172.31.47.0-255,66,108397,90,299037
812,0.001197,74.125.24.0-255,1484,109881,90,299037
813,0.001232,74.125.24.0-255,2902,112783,90,299037
814,0.001237,172.31.47.0-255,66,112849,90,299037
815,0.001244,74.125.24.0-255,5738,118587,90,299037
816,0.001246,172.31.47.0-255,66,118653,90,299037
817,0.001258,172.31.47.0-255,66,118719,90,299037
818,0.001296,74.125.24.0-255,7156,125875,90,299037
819,0.001299,172.31.47.0-255,66,125941,90,299037
820,0.001317,74.125.24.0-255,3602,129543,90,299037
821,0.001319,172.31.47.0-255,66,129609,90,299037
822,0.001326,74.125.24.0-255,7156,136765,90,299037
823,0.001328,172.31.47.0-255,66,136831,90,299037
824,0.00134,74.125.24.0-255,4320,141151,90,299037
825,0.001342,172.31.47.0-255,66,141217,90,299037
826,0.00135,74.125.24.0-255,9992,151209,90,299037
827,0.001352,172.31.47.0-255,66,151275,90,299037
828,0.001385,74.125.24.0-255,9992,161267,90,299037
829,0.001388,172.31.47.0-255,66,161333,90,299037
830,0.001405,172.31.47.0-255,66,161399,90,299037
831,0.001409,74.125.24.0-255,4320,165719,90,299037
832,0.001411,172.31.47.0-255,66,165785,90,299037
833,0.001442,74.125.24.0-255,10692,176477,90,299037
834,0.001445,172.31.47.0-255,66,176543,90,299037
835,0.001449,74.125.24.0-255,4320,180863,90,299037
836,0.001451,172.31.47.0-255,66,180929,90,299037
837,0.001456,74.125.24.0-255,5738,186667,90,299037
838,0.001458,172.31.47.0-255,66,186733,90,299037
839,0.001498,172.31.47.0-255,66,186799,90,299037
840,0.001505,74.125.24.0-255,9992,196791,90,299037
841,0.001507,172.31.47.0-255,66,196857,90,299037
842,0.001526,74.125.24.0-255,2184,199041,90,299037
843,0.001531,172.31.47.0-255,66,199107,90,299037
844,0.001542,74.125.24.0-255,1484,200591,90,299037
845,0.001557,74.125.24.0-255,2902,203493,90,299037
846,0.001559,172.31.47.0-255,66,203559,90,299037
847,0.001565,74.125.24.0-255,5738,209297,90,299037
848,0.001567,172.31.47.0-255,66,209363,90,299037
849,0.001635,172.31.47.0-255,66,209429,90,299037
850,0.001653,74.125.24.0-255,1484,210913,90,299037
851,0.00166,74.125.24.0-255,10692,221605,90,299037
852,0.001663,172.31.47.0-255,66,221671,90,299037
853,0.001694,74.125.24.0-255,1484,223155,90,299037
854,0.001713,74.125.24.0-255,2902,226057,90,299037
855,0.001716,172.31.47.0-255,66,226123,90,299037
856,0.001721,74.125.24.0-255,5738,231861,90,299037
857,0.001723,172.31.47.0-255,66,231927,90,299037
858,0.001754,172.31.47.0-255,66,231993,90,299037
859,0.001758,74.125.24.0-255,2902,234895,90,299037
860,0.001759,172.31.47.0-255,66,234961,90,299037
861,0.001776,74.125.24.0-255,5738,240699,90,299037
862,0.001779,172.31.47.0-255,66,240765,90,299037
863,0.001806,74.125.24.0-255,2184,242949,90,299037
864,0.001808,172.31.47.0-255,66,243015,90,299037
865,0.001835,74.125.24.0-255,2902,245917,90,299037
866,0.001838,172.31.47.0-255,66,245983,90,299037
867,0.00184,74.125.24.0-255,1484,247467,90,299037
868,0.00186,74.125.24.0-255,5738,253205,90,299037
869,0.001862,172.31.47.0-255,66,253271,90,299037
870,0.001868,74.125.24.0-255,7156,260427,90,299037
871,0.00187,172.31.47.0-255,66,260493,90,299037
872,0.001906,172.31.47.0-255,66,260559,90,299037
873,0.001908,74.125.24.0-255,766,261325,90,299037
874,0.001935,74.125.24.0-255,1484,262809,90,299037
875,0.001938,172.31.47.0-255,66,262875,90,299037
876,0.001943,74.125.24.0-255,4320,267195,90,299037
877,0.001945,172.31.47.0-255,66,267261,90,299037
878,0.001955,74.125.24.0-255,1484,268745,90,299037
879,0.001975,74.125.24.0-255,4320,273065,90,299037
880,0.001978,172.31.47.0-255,66,273131,90,299037
881,0.001985,74.125.24.0-255,8574,281705,90,299037
882,0.001987,172.31.47.0-255,66,281771,90,299037
883,0.002001,74.125.24.0-255,2902,284673,90,299037
884,0.002003,172.31.47.0-255,66,284739,90,299037
885,0.002006,74.125.24.0-255,1484,286223,90,299037
886,0.002021,74.125.24.0-255,4320,290543,90,299037
887,0.002023,172.31.47.0-255,66,290609,90,299037
888,0.002038,74.125.24.0-255,8020,298629,90,299037
889,0.002041,172.31.47.0-255,66,298695,90,299037
890,0.002057,74.125.24.0-255,105,298800,90,299037
891,0.003141,172.31.47.0-255,66,298866,90,299037
892,0.003165,172.31.47.0-255,105,298971,90,299037
893,0.005196,74.125.24.0-255,66,299037,90,299037
894,0.0,216.58.221.0-255,146,146,90,153071
895,2.4e-05,172.31.47.0-255,66,212,90,153071
896,3e-05,216.58.221.0-255,1484,1696,90,153071
897,3.4e-05,172.31.47.0-255,66,1762,90,153071
898,3.8e-05,216.58.221.0-255,2902,4664,90,153071
899,4e-05,172.31.47.0-255,66,4730,90,153071
900,7.3e-05,216.58.221.0-255,7156,11886,90,153071
901,7.5e-05,172.31.47.0-255,66,11952,90,153071
902,0.000169,216.58.221.0-255,1975,13927,90,153071
903,0.000173,172.31.47.0-255,66,13993,90,153071
904,0.000195,216.58.221.0-255,2902,16895,90,153071
905,0.000198,172.31.47.0-255,66,16961,90,153071
906,0.000223,216.58.221.0-255,8574,25535,90,153071
907,0.000226,172.31.47.0-255,66,25601,90,153071
908,0.000367,216.58.221.0-255,5379,30980,90,153071
909,0.000373,172.31.47.0-255,66,31046,90,153071
910,0.000445,216.58.221.0-255,1484,32530,90,153071
911,0.000448,172.31.47.0-255,66,32596,90,153071
912,0.000473,216.58.221.0-255,7156,39752,90,153071
913,0.000476,172.31.47.0-255,66,39818,90,153071
914,0.000495,216.58.221.0-255,1484,41302,90,153071
915,0.000498,172.31.47.0-255,66,41368,90,153071
916,0.000591,216.58.221.0-255,4320,45688,90,153071
917,0.000595,172.31.47.0-255,66,45754,90,153071
918,0.000637,172.31.47.0-255,66,45820,90,153071
919,0.000854,216.58.221.0-255,5710,51530,90,153071
920,0.000859,172.31.47.0-255,66,51596,90,153071
921,0.000947,216.58.221.0-255,113,51709,90,153071
922,0.000951,172.31.47.0-255,66,51775,90,153071
923,0.001064,216.58.221.0-255,1484,53259,90,153071
924,0.001068,172.31.47.0-255,66,53325,90,153071
925,0.001073,216.58.221.0-255,2902,56227,90,153071
926,0.001075,172.31.47.0-255,66,56293,90,153071
927,0.001112,216.58.221.0-255,2902,59195,90,153071
928,0.001115,172.31.47.0-255,66,59261,90,153071
929,0.001144,216.58.221.0-255,2902,62163,90,153071
930,0.001147,172.31.47.0-255,66,62229,90,153071
931,0.001193,216.58.221.0-255,2902,65131,90,153071
932,0.001196,172.31.47.0-255,66,65197,90,153071
933,0.001221,216.58.221.0-255,3961,69158,90,153071
934,0.001224,172.31.47.0-255,66,69224,90,153071
935,0.001294,216.58.221.0-255,1484,70708,90,153071
936,0.001313,216.58.221.0-255,2902,73610,90,153071
937,0.001316,172.31.47.0-255,66,73676,90,153071
938,0.001357,216.58.221.0-255,5738,79414,90,153071
939,0.001361,172.31.47.0-255,66,79480,90,153071
940,0.001439,216.58.221.0-255,4320,83800,90,153071
941,0.001441,172.31.47.0-255,66,83866,90,153071
942,0.001452,216.58.221.0-255,2543,86409,90,153071
943,0.001457,172.31.47.0-255,66,86475,90,153071
944,0.0017,216.58.221.0-255,1484,87959,90,153071
945,0.001713,216.58.221.0-255,1484,89443,90,153071
946,0.001715,172.31.47.0-255,66,89509,90,153071
947,0.001737,216.58.221.0-255,2902,92411,90,153071
948,0.001774,216.58.221.0-255,2902,95313,90,153071
949,0.001788,216.58.221.0-255,2902,98215,90,153071
950,0.001846,216.58.221.0-255,1484,99699,90,153071
951,0.001866,216.58.221.0-255,8574,108273,90,153071
952,0.001876,216.58.221.0-255,2902,111175,90,153071
953,0.002042,216.58.221.0-255,7156,118331,90,153071
954,0.002133,216.58.221.0-255,1484,119815,90,153071
955,0.002165,216.58.221.0-255,3602,123417,90,153071
956,0.002405,216.58.221.0-255,2902,126319,90,153071
957,0.002423,216.58.221.0-255,5738,132057,90,153071
958,0.002438,216.58.221.0-255,5738,137795,90,153071
959,0.002448,216.58.221.0-255,3602,141397,90,153071
960,0.005555,172.31.47.0-255,66,141463,90,153071
961,0.007498,216.58.221.0-255,5738,147201,90,153071
962,0.007507,172.31.47.0-255,66,147267,90,153071
963,0.009486,216.58.221.0-255,5738,153005,90,153071
964,0.009493,172.31.47.0-255,66,153071,90,153071
965,0.0,74.125.130.0-255,146,146,90,402008
966,2.7e-05,172.31.47.0-255,66,212,90,402008
967,3.3e-05,74.125.130.0-255,1484,1696,90,402008
968,3.7e-05,172.31.47.0-255,66,1762,90,402008
969,4.1e-05,74.125.130.0-255,2902,4664,90,402008
970,4.4e-05,172.31.47.0-255,66,4730,90,402008
971,4.6e-05,74.125.130.0-255,1484,6214,90,402008
972,4.8e-05,172.31.47.0-255,66,6280,90,402008
973,7.2e-05,74.125.130.0-255,2902,9182,90,402008
974,7.4e-05,172.31.47.0-255,66,9248,90,402008
975,9.1e-05,74.125.130.0-255,4320,13568,90,402008
976,9.3e-05,172.31.47.0-255,66,13634,90,402008
977,0.000114,74.125.130.0-255,2104,15738,90,402008
978,0.000116,172.31.47.0-255,66,15804,90,402008
979,0.00012,74.125.130.0-255,2902,18706,90,402008
980,0.000121,172.31.47.0-255,66,18772,90,402008
981,0.000131,74.125.130.0-255,1484,20256,90,402008
982,0.000135,172.31.47.0-255,66,20322,90,402008
983,0.000162,74.125.130.0-255,9992,30314,90,402008
984,0.000164,172.31.47.0-255,66,30380,90,402008
985,0.000172,74.125.130.0-255,7156,37536,90,402008
986,0.000174,172.31.47.0-255,66,37602,90,402008
987,0.000199,74.125.130.0-255,4320,41922,90,402008
988,0.000201,172.31.47.0-255,66,41988,90,402008
989,0.000223,74.125.130.0-255,6438,48426,90,402008
990,0.000225,172.31.47.0-255,66,48492,90,402008
991,0.000245,74.125.130.0-255,4320,52812,90,402008
992,0.000247,172.31.47.0-255,66,52878,90,402008
993,0.000262,74.125.130.0-255,2902,55780,90,402008
994,0.000264,172.31.47.0-255,66,55846,90,402008
995,0.000271,74.125.130.0-255,4320,60166,90,402008
996,0.000273,172.31.47.0-255,66,60232,90,402008
997,0.000277,74.125.130.0-255,5629,65861,90,402008
998,0.000279,172.31.47.0-255,66,65927,90,402008
999,0.000282,74.125.130.0-255,405,66332,90,402008
1000,0.000423,74.125.130.0-255,1484,67816,90,402008
1001,0.000427,172.31.47.0-255,66,67882,90,402008
1002,0.000447,74.125.130.0-255,2902,70784,90,402008
1003,0.000449,172.31.47.0-255,66,70850,90,402008
1004,0.000452,74.125.130.0-255,1484,72334,90,402008
1005,0.000471,74.125.130.0-255,4320,76654,90,402008
1006,0.000473,172.31.47.0-255,66,76720,90,402008
1007,0.000496,74.125.130.0-255,7156,83876,90,402008
1008,0.000499,172.31.47.0-255,66,83942,90,402008
1009,0.000517,74.125.130.0-255,4320,88262,90,402008
1010,0.000519,172.31.47.0-255,66,88328,90,402008
1011,0.000543,74.125.130.0-255,7156,95484,90,402008
1012,0.000546,172.31.47.0-255,66,95550,90,402008
1013,0.000559,74.125.130.0-255,2902,98452,90,402008
1014,0.000562,172.31.47.0-255,66,98518,90,402008
1015,0.000582,74.125.130.0-255,2184,100702,90,402008
1016,0.000585,172.31.47.0-255,66,100768,90,402008
1017,0.000879,74.125.130.0-255,1484,102252,90,402008
1018,0.000884,74.125.130.0-255,2902,105154,90,402008
1019,0.000886,172.31.47.0-255,66,105220,90,402008
1020,0.000903,74.125.130.0-255,1484,106704,90,402008
1021,0.000918,74.125.130.0-255,4320,111024,90,402008
1022,0.000921,172.31.47.0-255,66,111090,90,402008
1023,0.000925,74.125.130.0-255,2902,113992,90,402008
1024,0.000926,172.31.47.0-255,66,114058,90,402008
1025,0.000929,74.125.130.0-255,1484,115542,90,402008
1026,0.000946,74.125.130.0-255,2902,118444,90,402008
1027,0.000948,172.31.47.0-255,66,118510,90,402008
1028,0.000951,74.125.130.0-255,2902,121412,90,402008
1029,0.000953,172.31.47.0-255,66,121478,90,402008
1030,0.00098,74.125.130.0-255,5738,127216,90,402008
1031,0.000985,172.31.47.0-255,66,127282,90,402008
1032,0.000985,74.125.130.0-255,4320,131602,90,402008
1033,0.000988,172.31.47.0-255,66,131668,90,402008
1034,0.001026,74.125.130.0-255,3602,135270,90,402008
1035,0.001028,172.31.47.0-255,66,135336,90,402008
1036,0.001102,74.125.130.0-255,1484,136820,90,402008
1037,0.001126,74.125.130.0-255,2902,139722,90,402008
1038,0.00113,172.31.47.0-255,66,139788,90,402008
1039,0.001149,74.125.130.0-255,4320,144108,90,402008
1040,0.001152,172.31.47.0-255,66,144174,90,402008
1041,0.001169,74.125.130.0-255,1484,145658,90,402008
1042,0.001174,74.125.130.0-255,2902,148560,90,402008
1043,0.001176,172.31.47.0-255,66,148626,90,402008
1044,0.001193,74.125.130.0-255,2902,151528,90,402008
1045,0.001196,172.31.47.0-255,66,151594,90,402008
1046,0.001213,74.125.130.0-255,1484,153078,90,402008
1047,0.001216,74.125.130.0-255,1484,154562,90,402008
1048,0.001224,172.31.47.0-255,66,154628,90,402008
1049,0.001227,74.125.130.0-255,2902,157530,90,402008
1050,0.001229,172.31.47.0-255,66,157596,90,402008
1051,0.001245,74.125.130.0-255,4320,161916,90,402008
1052,0.001248,172.31.47.0-255,66,161982,90,402008
1053,0.001273,74.125.130.0-255,1484,163466,90,402008
1054,0.001279,74.125.130.0-255,4320,167786,90,402008
1055,0.001282,172.31.47.0-255,66,167852,90,402008
1056,0.001325,74.125.130.0-255,2184,170036,90,402008
1057,0.001328,172.31.47.0-255,66,170102,90,402008
1058,0.00151,74.125.130.0-255,1484,171586,90,402008
1059,0.001532,74.125.130.0-255,2902,174488,90,402008
1060,0.001536,172.31.47.0-255,66,174554,90,402008
1061,0.001542,74.125.130.0-255,4320,178874,90,402008
1062,0.001544,172.31.47.0-255,66,178940,90,402008
1063,0.001554,74.125.130.0-255,1484,180424,90,402008
1064,0.001612,74.125.130.0-255,4320,184744,90,402008
1065,0.001616,172.31.47.0-255,66,184810,90,402008
1066,0.001644,74.125.130.0-255,7156,191966,90,402008
1067,0.001646,172.31.47.0-255,66,192032,90,402008
1068,0.001659,172.31.47.0-255,66,192098,90,402008
1069,0.001875,74.125.130.0-255,1484,193582,90,402008
1070,0.001883,74.125.130.0-255,2902,196484,90,402008
1071,0.001886,172.31.47.0-255,66,196550,90,402008
1072,0.001908,74.125.130.0-255,5738,202288,90,402008
1073,0.00191,172.31.47.0-255,66,202354,90,402008
1074,0.001928,74.125.130.0-255,1484,203838,90,402008
1075,0.001952,74.125.130.0-255,9992,213830,90,402008
1076,0.001955,172.31.47.0-255,66,213896,90,402008
1077,0.001962,74.125.130.0-255,5738,219634,90,402008
1078,0.001964,172.31.47.0-255,66,219700,90,402008
1079,0.001979,74.125.130.0-255,6438,226138,90,402008
1080,0.001983,172.31.47.0-255,66,226204,90,402008
1081,0.002106,74.125.130.0-255,1484,227688,90,402008
1082,0.00211,74.125.130.0-255,1484,229172,90,402008
1083,0.002113,172.31.47.0-255,66,229238,90,402008
1084,0.00213,74.125.130.0-255,1484,230722,90,402008
1085,0.002133,74.125.130.0-255,1484,232206,90,402008
1086,0.002134,172.31.47.0-255,66,232272,90,402008
1087,0.002139,74.125.130.0-255,2902,235174,90,402008
1088,0.002141,172.31.47.0-255,66,235240,90,402008
1089,0.002159,74.125.130.0-255,2902,238142,90,402008
1090,0.002161,172.31.47.0-255,66,238208,90,402008
1091,0.002185,74.125.130.0-255,2902,241110,90,402008
1092,0.002188,172.31.47.0-255,66,241176,90,402008
1093,0.002197,74.125.130.0-255,8574,249750,90,402008
1094,0.002199,172.31.47.0-255,66,249816,90,402008
1095,0.00223,74.125.130.0-255,9992,259808,90,402008
1096,0.002232,172.31.47.0-255,66,259874,90,402008
1097,0.002237,74.125.130.0-255,2184,262058,90,402008
1098,0.002238,172.31.47.0-255,66,262124,90,402008
1099,0.002251,74.125.130.0-255,2902,265026,90,402008
1100,0.002254,172.31.47.0-255,66,265092,90,402008
1101,0.002285,74.125.130.0-255,7156,272248,90,402008
1102,0.002288,172.31.47.0-255,66,272314,90,402008
1103,0.002291,74.125.130.0-255,1484,273798,90,402008
1104,0.00231,74.125.130.0-255,1484,275282,90,402008
1105,0.002312,172.31.47.0-255,66,275348,90,402008
1106,0.002322,74.125.130.0-255,1484,276832,90,402008
1107,0.002333,74.125.130.0-255,1484,278316,90,402008
1108,0.002335,172.31.47.0-255,66,278382,90,402008
1109,0.002348,74.125.130.0-255,4320,282702,90,402008
1110,0.002351,172.31.47.0-255,66,282768,90,402008
1111,0.002369,74.125.130.0-255,1484,284252,90,402008
1112,0.002388,74.125.130.0-255,5738,289990,90,402008
1113,0.002391,172.31.47.0-255,66,290056,90,402008
1114,0.002394,74.125.130.0-255,1484,291540,90,402008
1115,0.002397,74.125.130.0-255,2902,294442,90,402008
1116,0.0024,172.31.47.0-255,66,294508,90,402008
1117,0.002419,74.125.130.0-255,766,295274,90,402008
1118,0.002444,74.125.130.0-255,1484,296758,90,402008
1119,0.002448,172.31.47.0-255,66,296824,90,402008
1120,0.002466,74.125.130.0-255,1484,298308,90,402008
1121,0.002481,74.125.130.0-255,2902,301210,90,402008
1122,0.002484,172.31.47.0-255,66,301276,90,402008
1123,0.002488,74.125.130.0-255,1484,302760,90,402008
1124,0.002502,74.125.130.0-255,2902,305662,90,402008
1125,0.002504,172.31.47.0-255,66,305728,90,402008
1126,0.002524,74.125.130.0-255,4320,310048,90,402008
1127,0.002528,172.31.47.0-255,66,310114,90,402008
1128,0.002544,74.125.130.0-255,1484,311598,90,402008
1129,0.002547,74.125.130.0-255,1484,313082,90,402008
1130,0.002548,172.31.47.0-255,66,313148,90,402008
1131,0.002552,74.125.130.0-255,2902,316050,90,402008
1132,0.002554,172.31.47.0-255,66,316116,90,402008
1133,0.002566,74.125.130.0-255,1484,317600,90,402008
1134,0.002583,74.125.130.0-255,4320,321920,90,402008
1135,0.002585,172.31.47.0-255,66,321986,90,402008
1136,0.002589,74.125.130.0-255,2902,324888,90,402008
1137,0.002591,172.31.47.0-255,66,324954,90,402008
1138,0.002602,74.125.130.0-255,1484,326438,90,402008
1139,0.002616,74.125.130.0-255,1484,327922,90,402008
1140,0.002618,172.31.47.0-255,66,327988,90,402008
1141,0.002629,74.125.130.0-255,1484,329472,90,402008
1142,0.002632,74.125.130.0-255,766,330238,90,402008
1143,0.002634,172.31.47.0-255,66,330304,90,402008
1144,0.002677,74.125.130.0-255,1484,331788,90,402008
1145,0.002702,74.125.130.0-255,2902,334690,90,402008
1146,0.002704,172.31.47.0-255,66,334756,90,402008
1147,0.002734,74.125.130.0-255,4320,339076,90,402008
1148,0.002737,172.31.47.0-255,66,339142,90,402008
1149,0.002739,74.125.130.0-255,1484,340626,90,402008
1150,0.002777,74.125.130.0-255,7156,347782,90,402008
1151,0.002779,172.31.47.0-255,66,347848,90,402008
1152,0.002793,74.125.130.0-255,2902,350750,90,402008
1153,0.002795,172.31.47.0-255,66,350816,90,402008
1154,0.002797,74.125.130.0-255,1484,352300,90,402008
1155,0.002817,74.125.130.0-255,2902,355202,90,402008
1156,0.002819,172.31.47.0-255,66,355268,90,402008
1157,0.002822,74.125.130.0-255,1484,356752,90,402008
1158,0.002837,74.125.130.0-255,2902,359654,90,402008
1159,0.002839,172.31.47.0-255,66,359720,90,402008
1160,0.002841,74.125.130.0-255,1484,361204,90,402008
1161,0.002844,74.125.130.0-255,1484,362688,90,402008
1162,0.002845,172.31.47.0-255,66,362754,90,402008
1163,0.002892,74.125.130.0-255,2184,364938,90,402008
1164,0.002894,172.31.47.0-255,66,365004,90,402008
1165,0.002897,74.125.130.0-255,1484,366488,90,402008
1166,0.002932,74.125.130.0-255,5738,372226,90,402008
1167,0.002936,172.31.47.0-255,66,372292,90,402008
1168,0.002938,74.125.130.0-255,1484,373776,90,402008
1169,0.002941,74.125.130.0-255,1484,375260,90,402008
1170,0.002943,172.31.47.0-255,66,375326,90,402008
1171,0.002947,74.125.130.0-255,2902,378228,90,402008
1172,0.002949,172.31.47.0-255,66,378294,90,402008
1173,0.002982,74.125.130.0-255,5738,384032,90,402008
1174,0.002986,172.31.47.0-255,66,384098,90,402008
1175,0.002991,74.125.130.0-255,4320,388418,90,402008
1176,0.002993,172.31.47.0-255,66,388484,90,402008
1177,0.002996,74.125.130.0-255,1484,389968,90,402008
1178,0.003018,74.125.130.0-255,5738,395706,90,402008
1179,0.003022,172.31.47.0-255,66,395772,90,402008
1180,0.003026,74.125.130.0-255,3602,399374,90,402008
1181,0.003029,172.31.47.0-255,66,399440,90,402008
1182,0.00306,74.125.130.0-255,2129,401569,90,402008
1183,0.003062,172.31.47.0-255,66,401635,90,402008
1184,0.003065,74.125.130.0-255,97,401732,90,402008
1185,0.003115,74.125.130.0-255,105,401837,90,402008
1186,0.009151,172.31.47.0-255,66,401903,90,402008
1187,0.009174,172.31.47.0-255,105,402008,90,402008
1188,0.0,74.125.24.0-255,153,153,90,229114
1189,3.4e-05,172.31.47.0-255,66,219,90,229114
1190,4.1e-05,74.125.24.0-255,1484,1703,90,229114
1191,4.5e-05,172.31.47.0-255,66,1769,90,229114
1192,5e-05,74.125.24.0-255,2902,4671,90,229114
1193,5.4e-05,172.31.47.0-255,66,4737,90,229114
1194,6e-05,74.125.24.0-255,7156,11893,90,229114
1195,6.3e-05,172.31.47.0-255,66,11959,90,229114
1196,6.8e-05,74.125.24.0-255,3624,15583,90,229114
1197,7e-05,172.31.47.0-255,66,15649,90,229114
1198,7.7e-05,74.125.24.0-255,4320,19969,90,229114
1199,8e-05,172.31.47.0-255,66,20035,90,229114
1200,0.000105,74.125.24.0-255,9992,30027,90,229114
1201,0.000108,172.31.47.0-255,66,30093,90,229114
1202,0.000112,74.125.24.0-255,1125,31218,90,229114
1203,0.000113,172.31.47.0-255,66,31284,90,229114
1204,0.000156,74.125.24.0-255,1484,32768,90,229114
1205,0.000159,172.31.47.0-255,66,32834,90,229114
1206,0.000176,74.125.24.0-255,2902,35736,90,229114
1207,0.000179,172.31.47.0-255,66,35802,90,229114
1208,0.000182,74.125.24.0-255,1484,37286,90,229114
1209,0.000183,172.31.47.0-255,66,37352,90,229114
1210,0.000207,74.125.24.0-255,4320,41672,90,229114
1211,0.00021,172.31.47.0-255,66,41738,90,229114
1212,0.000215,74.125.24.0-255,2902,44640,90,229114
1213,0.000217,172.31.47.0-255,66,44706,90,229114
1214,0.000235,74.125.24.0-255,3961,48667,90,229114
1215,0.000238,172.31.47.0-255,66,48733,90,229114
1216,0.000389,74.125.24.0-255,1484,50217,90,229114
1217,0.000393,172.31.47.0-255,66,50283,90,229114
1218,0.000398,74.125.24.0-255,2902,53185,90,229114
1219,0.000401,172.31.47.0-255,66,53251,90,229114
1220,0.000427,74.125.24.0-255,5738,58989,90,229114
1221,0.00043,172.31.47.0-255,66,59055,90,229114
1222,0.000437,74.125.24.0-255,6797,65852,90,229114
1223,0.00044,172.31.47.0-255,66,65918,90,229114
1224,0.00046,74.125.24.0-255,646,66564,90,229114
1225,0.000581,74.125.24.0-255,1484,68048,90,229114
1226,0.000585,172.31.47.0-255,66,68114,90,229114
1227,0.00059,74.125.24.0-255,2902,71016,90,229114
1228,0.000592,172.31.47.0-255,66,71082,90,229114
1229,0.000598,74.125.24.0-255,5738,76820,90,229114
1230,0.000601,172.31.47.0-255,66,76886,90,229114
1231,0.000635,74.125.24.0-255,2902,79788,90,229114
1232,0.00064,172.31.47.0-255,66,79854,90,229114
1233,0.000659,74.125.24.0-255,3961,83815,90,229114
1234,0.000661,172.31.47.0-255,66,83881,90,229114
1235,0.000669,74.125.24.0-255,7156,91037,90,229114
1236,0.000671,172.31.47.0-255,66,91103,90,229114
1237,0.000695,74.125.24.0-255,5738,96841,90,229114
1238,0.000699,172.31.47.0-255,66,96907,90,229114
1239,0.000713,74.125.24.0-255,3961,100868,90,229114
1240,0.000716,172.31.47.0-255,66,100934,90,229114
1241,0.001025,74.125.24.0-255,1484,102418,90,229114
1242,0.001039,74.125.24.0-255,2902,105320,90,229114
1243,0.001042,172.31.47.0-255,66,105386,90,229114
1244,0.001063,74.125.24.0-255,5738,111124,90,229114
1245,0.001067,172.31.47.0-255,66,111190,90,229114
1246,0.001087,74.125.24.0-255,5738,116928,90,229114
1247,0.00109,172.31.47.0-255,66,116994,90,229114
1248,0.001122,74.125.24.0-255,5738,122732,90,229114
1249,0.001125,172.31.47.0-255,66,122798,90,229114
1250,0.001152,74.125.24.0-255,7156,129954,90,229114
1251,0.001154,172.31.47.0-255,66,130020,90,229114
1252,0.00116,74.125.24.0-255,5020,135040,90,229114
1253,0.001162,172.31.47.0-255,66,135106,90,229114
1254,0.00166,74.125.24.0-255,1484,136590,90,229114
1255,0.001674,74.125.24.0-255,2902,139492,90,229114
1256,0.001678,172.31.47.0-255,66,139558,90,229114
1257,0.001686,74.125.24.0-255,5738,145296,90,229114
1258,0.001688,172.31.47.0-255,66,145362,90,229114
1259,0.001693,74.125.24.0-255,5738,151100,90,229114
1260,0.001695,172.31.47.0-255,66,151166,90,229114
1261,0.001763,172.31.47.0-255,66,151232,90,229114
1262,0.001769,74.125.24.0-255,5020,156252,90,229114
1263,0.00177,172.31.47.0-255,66,156318,90,229114
1264,0.001776,74.125.24.0-255,2902,159220,90,229114
1265,0.001778,172.31.47.0-255,66,159286,90,229114
1266,0.001803,74.125.24.0-255,2902,162188,90,229114
1267,0.001805,172.31.47.0-255,66,162254,90,229114
1268,0.001811,74.125.24.0-255,5738,167992,90,229114
1269,0.001814,172.31.47.0-255,66,168058,90,229114
1270,0.001822,74.125.24.0-255,9992,178050,90,229114
1271,0.001824,172.31.47.0-255,66,178116,90,229114
1272,0.001847,74.125.24.0-255,2902,181018,90,229114
1273,0.00185,172.31.47.0-255,66,181084,90,229114
1274,0.00186,74.125.24.0-255,9274,190358,90,229114
1275,0.001862,172.31.47.0-255,66,190424,90,229114
1276,0.001931,74.125.24.0-255,1484,191908,90,229114
1277,0.001938,74.125.24.0-255,2902,194810,90,229114
1278,0.001941,172.31.47.0-255,66,194876,90,229114
1279,0.001947,74.125.24.0-255,2902,197778,90,229114
1280,0.001949,172.31.47.0-255,66,197844,90,229114
1281,0.001964,74.125.24.0-255,2902,200746,90,229114
1282,0.001967,172.31.47.0-255,66,200812,90,229114
1283,0.00198,172.31.47.0-255,66,200878,90,229114
1284,0.001995,74.125.24.0-255,1484,202362,90,229114
1285,0.002018,74.125.24.0-255,9274,211636,90,229114
1286,0.002021,172.31.47.0-255,66,211702,90,229114
1287,0.004304,74.125.24.0-255,5738,217440,90,229114
1288,0.004307,172.31.47.0-255,66,217506,90,229114
1289,0.006572,74.125.24.0-255,5738,223244,90,229114
1290,0.00658,172.31.47.0-255,66,223310,90,229114
1291,0.008871,74.125.24.0-255,5738,229048,90,229114
1292,0.008884,172.31.47.0-255,66,229114,90,229114
1293,0.0,172.217.194.0-255,153,153,90,113720
1294,3.1e-05,172.31.47.0-255,66,219,90,113720
1295,5.3e-05,172.217.194.0-255,1484,1703,90,113720
1296,5.7e-05,172.31.47.0-255,66,1769,90,113720
1297,6.2e-05,172.217.194.0-255,2902,4671,90,113720
1298,6.4e-05,172.31.47.0-255,66,4737,90,113720
1299,0.000101,172.217.194.0-255,5738,10475,90,113720
1300,0.000104,172.31.47.0-255,66,10541,90,113720
1301,0.000135,172.217.194.0-255,3412,13953,90,113720
1302,0.000138,172.31.47.0-255,66,14019,90,113720
1303,0.000142,172.217.194.0-255,2902,16921,90,113720
1304,0.000144,172.31.47.0-255,66,16987,90,113720
1305,0.000184,172.217.194.0-255,8574,25561,90,113720
1306,0.000188,172.31.47.0-255,66,25627,90,113720
1307,0.000194,172.217.194.0-255,5738,31365,90,113720
1308,0.000196,172.31.47.0-255,66,31431,90,113720
1309,0.000233,172.217.194.0-255,5738,37169,90,113720
1310,0.000236,172.31.47.0-255,66,37235,90,113720
1311,0.000273,172.217.194.0-255,9992,47227,90,113720
1312,0.000276,172.31.47.0-255,66,47293,90,113720
1313,0.000279,172.217.194.0-255,766,48059,90,113720
1314,0.000283,172.31.47.0-255,66,48125,90,113720
1315,0.000628,172.217.194.0-255,1484,49609,90,113720
1316,0.000633,172.31.47.0-255,66,49675,90,113720
1317,0.000639,172.217.194.0-255,2902,52577,90,113720
1318,0.000641,172.31.47.0-255,66,52643,90,113720
1319,0.000668,172.217.194.0-255,5738,58381,90,113720
1320,0.000671,172.31.47.0-255,66,58447,90,113720
1321,0.000676,172.217.194.0-255,4320,62767,90,113720
1322,0.000678,172.31.47.0-255,66,62833,90,113720
1323,0.000733,172.217.194.0-255,2839,65672,90,113720
1324,0.000737,172.31.47.0-255,66,65738,90,113720
1325,0.002208,172.217.194.0-255,1484,67222,90,113720
1326,0.002229,172.217.194.0-255,2902,70124,90,113720
1327,0.002233,172.31.47.0-255,66,70190,90,113720
1328,0.00224,172.217.194.0-255,5738,75928,90,113720
1329,0.002242,172.31.47.0-255,66,75994,90,113720
1330,0.002246,172.217.194.0-255,4320,80314,90,113720
1331,0.002248,172.31.47.0-255,66,80380,90,113720
1332,0.002311,172.217.194.0-255,9992,90372,90,113720
1333,0.002315,172.31.47.0-255,66,90438,90,113720
1334,0.002348,172.217.194.0-255,5738,96176,90,113720
1335,0.002351,172.31.47.0-255,66,96242,90,113720
1336,0.002354,172.217.194.0-255,1484,97726,90,113720
1337,0.004657,172.217.194.0-255,4320,102046,90,113720
1338,0.004662,172.31.47.0-255,66,102112,90,113720
1339,0.006997,172.217.194.0-255,5738,107850,90,113720
1340,0.007004,172.31.47.0-255,66,107916,90,113720
1341,0.009298,172.217.194.0-255,5738,113654,90,113720
1342,0.009308,172.31.47.0-255,66,113720,90,113720
1343,0.0,172.217.194.0-255,153,153,90,359816
1344,2.4e-05,172.31.47.0-255,66,219,90,359816
1345,3e-05,172.217.194.0-255,1484,1703,90,359816
1346,3.4e-05,172.31.47.0-255,66,1769,90,359816
1347,3.8e-05,172.217.194.0-255,2902,4671,90,359816
1348,4e-05,172.31.47.0-255,66,4737,90,359816
1349,6.9e-05,172.217.194.0-255,7156,11893,90,359816
1350,7.3e-05,172.217.194.0-255,2216,14109,90,359816
1351,7.3e-05,172.31.47.0-255,66,14175,90,359816
1352,7.6e-05,172.31.47.0-255,66,14241,90,359816
1353,0.000121,172.217.194.0-255,5738,19979,90,359816
1354,0.000125,172.31.47.0-255,66,20045,90,359816
1355,0.000129,172.217.194.0-255,4320,24365,90,359816
1356,0.000131,172.31.47.0-255,66,24431,90,359816
1357,0.000144,172.217.194.0-255,2902,27333,90,359816
1358,0.000146,172.31.47.0-255,66,27399,90,359816
1359,0.000161,172.217.194.0-255,2902,30301,90,359816
1360,0.000163,172.31.47.0-255,66,30367,90,359816
1361,0.000197,172.31.47.0-255,66,30433,90,359816
1362,0.000202,172.217.194.0-255,6438,36871,90,359816
1363,0.000204,172.31.47.0-255,66,36937,90,359816
1364,0.000291,172.217.194.0-255,1484,38421,90,359816
1365,0.000296,172.31.47.0-255,66,38487,90,359816
1366,0.000313,172.217.194.0-255,2902,41389,90,359816
1367,0.000316,172.31.47.0-255,66,41455,90,359816
1368,0.000321,172.217.194.0-255,2902,44357,90,359816
1369,0.000323,172.31.47.0-255,66,44423,90,359816
1370,0.000339,172.217.194.0-255,1484,45907,90,359816
1371,0.000341,172.31.47.0-255,66,45973,90,359816
1372,0.000349,172.217.194.0-255,7156,53129,90,359816
1373,0.000352,172.31.47.0-255,66,53195,90,359816
1374,0.00037,172.217.194.0-255,1416,54611,90,359816
1375,0.000384,172.217.194.0-255,365,54976,90,359816
1376,0.000387,172.31.47.0-255,66,55042,90,359816
1377,0.000417,172.217.194.0-255,1484,56526,90,359816
1378,0.000421,172.217.194.0-255,1484,58010,90,359816
1379,0.000425,172.31.47.0-255,66,58076,90,359816
1380,0.000449,172.217.194.0-255,4320,62396,90,359816
1381,0.000452,172.31.47.0-255,66,62462,90,359816
1382,0.0005,172.217.194.0-255,9633,72095,90,359816
1383,0.000504,172.31.47.0-255,66,72161,90,359816
1384,0.000651,172.217.194.0-255,1484,73645,90,359816
1385,0.000669,172.217.194.0-255,2902,76547,90,359816
1386,0.000672,172.31.47.0-255,66,76613,90,359816
1387,0.000677,172.217.194.0-255,2902,79515,90,359816
1388,0.000679,172.31.47.0-255,66,79581,90,359816
1389,0.000694,172.217.194.0-255,2902,82483,90,359816
1390,0.000697,172.31.47.0-255,66,82549,90,359816
1391,0.000703,172.217.194.0-255,6797,89346,90,359816
1392,0.000705,172.31.47.0-255,66,89412,90,359816
1393,0.00074,172.217.194.0-255,4320,93732,90,359816
1394,0.000743,172.31.47.0-255,66,93798,90,359816
1395,0.000762,172.217.194.0-255,7156,100954,90,359816
1396,0.000765,172.31.47.0-255,66,101020,90,359816
1397,0.000778,172.31.47.0-255,66,101086,90,359816
1398,0.000813,172.217.194.0-255,9274,110360,90,359816
1399,0.000818,172.31.47.0-255,66,110426,90,359816
1400,0.000883,172.217.194.0-255,1484,111910,90,359816
1401,0.00089,172.217.194.0-255,2902,114812,90,359816
1402,0.000893,172.31.47.0-255,66,114878,90,359816
1403,0.000914,172.217.194.0-255,5738,120616,90,359816
1404,0.000917,172.31.47.0-255,66,120682,90,359816
1405,0.000931,172.217.194.0-255,1484,122166,90,359816
1406,0.000955,172.31.47.0-255,66,122232,90,359816
1407,0.000961,172.217.194.0-255,5738,127970,90,359816
1408,0.000963,172.31.47.0-255,66,128036,90,359816
1409,0.001003,172.217.194.0-255,1484,129520,90,359816
1410,0.00102,172.217.194.0-255,5738,135258,90,359816
1411,0.001024,172.31.47.0-255,66,135324,90,359816
1412,0.001056,172.31.47.0-255,66,135390,90,359816
1413,0.001059,172.217.194.0-255,1125,136515,90,359816
1414,0.001091,172.217.194.0-255,1484,137999,90,359816
1415,0.001095,172.31.47.0-255,66,138065,90,359816
1416,0.001113,172.217.194.0-255,2902,140967,90,359816
1417,0.001115,172.31.47.0-255,66,141033,90,359816
1418,0.001121,172.217.194.0-255,5738,146771,90,359816
1419,0.001124,172.31.47.0-255,66,146837,90,359816
1420,0.00115,172.217.194.0-255,4320,151157,90,359816
1421,0.001154,172.31.47.0-255,66,151223,90,359816
1422,0.001171,172.217.194.0-255,2902,154125,90,359816
1423,0.001174,172.31.47.0-255,66,154191,90,359816
1424,0.001191,172.217.194.0-255,7156,161347,90,359816
1425,0.001194,172.31.47.0-255,66,161413,90,359816
1426,0.001207,172.217.194.0-255,1484,162897,90,359816
1427,0.001211,172.217.194.0-255,1484,164381,90,359816
1428,0.001213,172.31.47.0-255,66,164447,90,359816
1429,0.001256,172.217.194.0-255,4320,168767,90,359816
1430,0.001259,172.31.47.0-255,66,168833,90,359816
1431,0.001276,172.217.194.0-255,2184,171017,90,359816
1432,0.001279,172.31.47.0-255,66,171083,90,359816
1433,0.001346,172.217.194.0-255,1484,172567,90,359816
1434,0.001361,172.217.194.0-255,2902,175469,90,359816
1435,0.001364,172.31.47.0-255,66,175535,90,359816
1436,0.001368,172.217.194.0-255,1484,177019,90,359816
1437,0.001385,172.217.194.0-255,4320,181339,90,359816
1438,0.001388,172.31.47.0-255,66,181405,90,359816
1439,0.001411,172.217.194.0-255,5738,187143,90,359816
1440,0.001414,172.31.47.0-255,66,187209,90,359816
1441,0.001434,172.217.194.0-255,2543,189752,90,359816
1442,0.001437,172.31.47.0-255,66,189818,90,359816
1443,0.001444,172.217.194.0-255,8574,198392,90,359816
1444,0.001447,172.31.47.0-255,66,198458,90,359816
1445,0.001467,172.217.194.0-255,5738,204196,90,359816
1446,0.00147,172.31.47.0-255,66,204262,90,359816
1447,0.001495,172.217.194.0-255,9992,214254,90,359816
1448,0.001499,172.31.47.0-255,66,214320,90,359816
1449,0.001513,172.217.194.0-255,5738,220058,90,359816
1450,0.001517,172.31.47.0-255,66,220124,90,359816
1451,0.00153,172.217.194.0-255,2184,222308,90,359816
1452,0.001533,172.31.47.0-255,66,222374,90,359816
1453,0.001662,172.217.194.0-255,1484,223858,90,359816
1454,0.001667,172.217.194.0-255,2902,226760,90,359816
1455,0.001669,172.31.47.0-255,66,226826,90,359816
1456,0.00169,172.217.194.0-255,5738,232564,90,359816
1457,0.001692,172.31.47.0-255,66,232630,90,359816
1458,0.001711,172.217.194.0-255,7156,239786,90,359816
1459,0.001714,172.31.47.0-255,66,239852,90,359816
1460,0.001729,172.217.194.0-255,2902,242754,90,359816
1461,0.001732,172.31.47.0-255,66,242820,90,359816
1462,0.001764,172.217.194.0-255,1484,244304,90,359816
1463,0.001777,172.217.194.0-255,7156,251460,90,359816
1464,0.001779,172.31.47.0-255,66,251526,90,359816
1465,0.0018,172.217.194.0-255,7856,259382,90,359816
1466,0.001805,172.31.47.0-255,66,259448,90,359816
1467,0.001806,172.217.194.0-255,7156,266604,90,359816
1468,0.001808,172.31.47.0-255,66,266670,90,359816
1469,0.001833,172.217.194.0-255,9992,276662,90,359816
1470,0.001836,172.31.47.0-255,66,276728,90,359816
1471,0.001842,172.217.194.0-255,8574,285302,90,359816
1472,0.001845,172.31.47.0-255,66,285368,90,359816
1473,0.001897,172.217.194.0-255,5020,290388,90,359816
1474,0.0019,172.31.47.0-255,66,290454,90,359816
1475,0.002264,172.217.194.0-255,1484,291938,90,359816
1476,0.002284,172.217.194.0-255,2902,294840,90,359816
1477,0.002287,172.31.47.0-255,66,294906,90,359816
1478,0.002292,172.217.194.0-255,5738,300644,90,359816
1479,0.002294,172.31.47.0-255,66,300710,90,359816
1480,0.002319,172.217.194.0-255,2902,303612,90,359816
1481,0.002321,172.31.47.0-255,66,303678,90,359816
1482,0.002337,172.217.194.0-255,5738,309416,90,359816
1483,0.002339,172.31.47.0-255,66,309482,90,359816
1484,0.002346,172.217.194.0-255,8574,318056,90,359816
1485,0.002348,172.31.47.0-255,66,318122,90,359816
1486,0.002367,172.217.194.0-255,1484,319606,90,359816
1487,0.002373,172.217.194.0-255,5020,324626,90,359816
1488,0.002375,172.31.47.0-255,66,324692,90,359816
1489,0.002409,172.217.194.0-255,2902,327594,90,359816
1490,0.002412,172.31.47.0-255,66,327660,90,359816
1491,0.002431,172.217.194.0-255,2902,330562,90,359816
1492,0.002434,172.31.47.0-255,66,330628,90,359816
1493,0.002439,172.217.194.0-255,5738,336366,90,359816
1494,0.002441,172.31.47.0-255,66,336432,90,359816
1495,0.002446,172.217.194.0-255,4320,340752,90,359816
1496,0.002448,172.31.47.0-255,66,340818,90,359816
1497,0.002465,172.217.194.0-255,8574,349392,90,359816
1498,0.002468,172.31.47.0-255,66,349458,90,359816
1499,0.002473,172.217.194.0-255,5738,355196,90,359816
1500,0.002475,172.31.47.0-255,66,355262,90,359816
1501,0.002496,172.217.194.0-255,3602,358864,90,359816
1502,0.002498,172.217.194.0-255,544,359408,90,359816
1503,0.0025,172.31.47.0-255,66,359474,90,359816
1504,0.002552,172.217.194.0-255,105,359579,90,359816
1505,0.00321,172.31.47.0-255,66,359645,90,359816
1506,0.003232,172.31.47.0-255,105,359750,90,359816
1507,0.005753,172.217.194.0-255,66,359816,90,359816
1508,0.0,172.31.47.0-255,105,105,90,105
1509,0.0,172.31.47.0-255,105,105,90,105
1510,0.0,74.125.24.0-255,153,153,90,222660
1511,2.4e-05,172.31.47.0-255,66,219,90,222660
1512,3.1e-05,74.125.24.0-255,1484,1703,90,222660
1513,3.4e-05,172.31.47.0-255,66,1769,90,222660
1514,3.8e-05,74.125.24.0-255,2902,4671,90,222660
1515,4e-05,172.31.47.0-255,66,4737,90,222660
1516,4.3e-05,74.125.24.0-255,1484,6221,90,222660
1517,4.4e-05,172.31.47.0-255,66,6287,90,222660
1518,6.9e-05,74.125.24.0-255,5738,12025,90,222660
1519,7.1e-05,172.31.47.0-255,66,12091,90,222660
1520,8.1e-05,172.31.47.0-255,66,12157,90,222660
1521,0.000121,74.125.24.0-255,7156,19313,90,222660
1522,0.000124,172.31.47.0-255,66,19379,90,222660
1523,0.00014,74.125.24.0-255,1125,20504,90,222660
1524,0.000142,172.31.47.0-255,66,20570,90,222660
1525,0.000169,74.125.24.0-255,7156,27726,90,222660
1526,0.000171,172.31.47.0-255,66,27792,90,222660
1527,0.000186,74.125.24.0-255,1484,29276,90,222660
1528,0.000188,172.31.47.0-255,66,29342,90,222660
1529,0.000192,74.125.24.0-255,2902,32244,90,222660
1530,0.000193,172.31.47.0-255,66,32310,90,222660
1531,0.000205,74.125.24.0-255,2902,35212,90,222660
1532,0.000207,172.31.47.0-255,66,35278,90,222660
1533,0.000244,172.31.47.0-255,66,35344,90,222660
1534,0.000252,74.125.24.0-255,8488,43832,90,222660
1535,0.000254,172.31.47.0-255,66,43898,90,222660
1536,0.000256,74.125.24.0-255,134,44032,90,222660
1537,0.000259,172.31.47.0-255,66,44098,90,222660
1538,0.000261,74.125.24.0-255,346,44444,90,222660
1539,0.000263,172.31.47.0-255,66,44510,90,222660
1540,0.00051,74.125.24.0-255,1484,45994,90,222660
1541,0.000516,74.125.24.0-255,2902,48896,90,222660
1542,0.000518,172.31.47.0-255,66,48962,90,222660
1543,0.000535,74.125.24.0-255,1484,50446,90,222660
1544,0.000538,74.125.24.0-255,1484,51930,90,222660
1545,0.00054,172.31.47.0-255,66,51996,90,222660
1546,0.00056,74.125.24.0-255,4320,56316,90,222660
1547,0.000564,74.125.24.0-255,2902,59218,90,222660
1548,0.000572,172.31.47.0-255,66,59284,90,222660
1549,0.000593,74.125.24.0-255,9992,69276,90,222660
1550,0.000601,74.125.24.0-255,9274,78550,90,222660
1551,0.000602,172.31.47.0-255,66,78616,90,222660
1552,0.000607,172.31.47.0-255,66,78682,90,222660
1553,0.001047,74.125.24.0-255,1484,80166,90,222660
1554,0.001056,74.125.24.0-255,2902,83068,90,222660
1555,0.00106,172.31.47.0-255,66,83134,90,222660
1556,0.001066,74.125.24.0-255,5738,88872,90,222660
1557,0.001069,172.31.47.0-255,66,88938,90,222660
1558,0.001107,172.31.47.0-255,66,89004,90,222660
1559,0.001116,74.125.24.0-255,1484,90488,90,222660
1560,0.001122,74.125.24.0-255,7156,97644,90,222660
1561,0.001136,74.125.24.0-255,1484,99128,90,222660
1562,0.001148,74.125.24.0-255,2184,101312,90,222660
1563,0.001168,172.31.47.0-255,66,101378,90,222660
1564,0.001402,74.125.24.0-255,1484,102862,90,222660
1565,0.001407,74.125.24.0-255,2902,105764,90,222660
1566,0.001411,172.31.47.0-255,66,105830,90,222660
1567,0.001414,74.125.24.0-255,1484,107314,90,222660
1568,0.001432,74.125.24.0-255,4320,111634,90,222660
1569,0.001434,172.31.47.0-255,66,111700,90,222660
1570,0.001438,74.125.24.0-255,4320,116020,90,222660
1571,0.001452,74.125.24.0-255,7156,123176,90,222660
1572,0.001462,74.125.24.0-255,1484,124660,90,222660
1573,0.001464,74.125.24.0-255,1484,126144,90,222660
1574,0.001466,172.31.47.0-255,66,126210,90,222660
1575,0.00147,172.31.47.0-255,66,126276,90,222660
1576,0.001479,74.125.24.0-255,5738,132014,90,222660
1577,0.001493,74.125.24.0-255,5738,137752,90,222660
1578,0.001538,74.125.24.0-255,7156,144908,90,222660
1579,0.001546,172.31.47.0-255,66,144974,90,222660
1580,0.001559,74.125.24.0-255,9274,154248,90,222660
1581,0.001584,172.31.47.0-255,66,154314,90,222660
1582,0.001591,74.125.24.0-255,2902,157216,90,222660
1583,0.001595,172.31.47.0-255,66,157282,90,222660
1584,0.001606,74.125.24.0-255,7856,165138,90,222660
1585,0.001622,172.31.47.0-255,66,165204,90,222660
1586,0.00163,74.125.24.0-255,5738,170942,90,222660
1587,0.001634,172.31.47.0-255,66,171008,90,222660
1588,0.001664,74.125.24.0-255,2902,173910,90,222660
1589,0.001671,172.31.47.0-255,66,173976,90,222660
1590,0.0017,74.125.24.0-255,2184,176160,90,222660
1591,0.001713,74.125.24.0-255,2902,179062,90,222660
1592,0.001721,172.31.47.0-255,66,179128,90,222660
1593,0.001758,74.125.24.0-255,9992,189120,90,222660
1594,0.001764,172.31.47.0-255,66,189186,90,222660
1595,0.0018,74.125.24.0-255,2902,192088,90,222660
1596,0.00183,172.31.47.0-255,66,192154,90,222660
1597,0.001862,172.31.47.0-255,66,192220,90,222660
1598,0.0019,74.125.24.0-255,7156,199376,90,222660
1599,0.001905,172.31.47.0-255,66,199442,90,222660
1600,0.001912,74.125.24.0-255,2184,201626,90,222660
1601,0.001914,74.125.24.0-255,1484,203110,90,222660
1602,0.001919,172.31.47.0-255,66,203176,90,222660
1603,0.001959,172.31.47.0-255,66,203242,90,222660
1604,0.001976,74.125.24.0-255,6438,209680,90,222660
1605,0.00198,172.31.47.0-255,66,209746,90,222660
1606,0.002041,74.125.24.0-255,7156,216902,90,222660
1607,0.002047,172.31.47.0-255,66,216968,90,222660
1608,0.002109,172.31.47.0-255,66,217034,90,222660
1609,0.002117,74.125.24.0-255,2184,219218,90,222660
1610,0.002121,172.31.47.0-255,66,219284,90,222660
1611,0.002136,74.125.24.0-255,2902,222186,90,222660
1612,0.002153,172.31.47.0-255,66,222252,90,222660
1613,0.002198,172.31.47.0-255,66,222318,90,222660
1614,0.002209,74.125.24.0-255,105,222423,90,222660
1615,0.00352,172.31.47.0-255,66,222489,90,222660
1616,0.003549,172.31.47.0-255,105,222594,90,222660
1617,0.005927,74.125.24.0-255,66,222660,90,222660
1618,0.0,172.217.194.0-255,147,147,90,330296
1619,1.4e-05,172.31.47.0-255,66,213,90,330296
1620,1.9e-05,172.217.194.0-255,1484,1697,90,330296
1621,2.4e-05,172.31.47.0-255,66,1763,90,330296
1622,2.9e-05,172.217.194.0-255,2902,4665,90,330296
1623,3.2e-05,172.31.47.0-255,66,4731,90,330296
1624,3.8e-05,172.217.194.0-255,7156,11887,90,330296
1625,4e-05,172.31.47.0-255,66,11953,90,330296
1626,6.4e-05,172.217.194.0-255,4849,16802,90,330296
1627,6.6e-05,172.31.47.0-255,66,16868,90,330296
1628,9.3e-05,172.31.47.0-255,66,16934,90,330296
1629,0.000109,172.217.194.0-255,1484,18418,90,330296
1630,0.00011,172.31.47.0-255,66,18484,90,330296
1631,0.000123,172.217.194.0-255,2902,21386,90,330296
1632,0.000125,172.31.47.0-255,66,21452,90,330296
1633,0.00013,172.217.194.0-255,4320,25772,90,330296
1634,0.000132,172.31.47.0-255,66,25838,90,330296
1635,0.000152,172.217.194.0-255,1484,27322,90,330296
1636,0.000156,172.31.47.0-255,66,27388,90,330296
1637,0.000178,172.217.194.0-255,6797,34185,90,330296
1638,0.00018,172.31.47.0-255,66,34251,90,330296
1639,0.000469,172.217.194.0-255,1484,35735,90,330296
1640,0.000473,172.31.47.0-255,66,35801,90,330296
1641,0.000479,172.217.194.0-255,2902,38703,90,330296
1642,0.000481,172.31.47.0-255,66,38769,90,330296
1643,0.000506,172.217.194.0-255,5738,44507,90,330296
1644,0.000511,172.217.194.0-255,4320,48827,90,330296
1645,0.000511,172.31.47.0-255,66,48893,90,330296
1646,0.000514,172.31.47.0-255,66,48959,90,330296
1647,0.000538,172.217.194.0-255,2543,51502,90,330296
1648,0.000541,172.31.47.0-255,66,51568,90,330296
1649,0.000564,172.217.194.0-255,7156,58724,90,330296
1650,0.000566,172.31.47.0-255,66,58790,90,330296
1651,0.000581,172.217.194.0-255,5738,64528,90,330296
1652,0.000584,172.31.47.0-255,66,64594,90,330296
1653,0.000621,172.217.194.0-255,5960,70554,90,330296
1654,0.000624,172.31.47.0-255,66,70620,90,330296
1655,0.00063,172.217.194.0-255,7156,77776,90,330296
1656,0.000632,172.31.47.0-255,66,77842,90,330296
1657,0.000651,172.217.194.0-255,1484,79326,90,330296
1658,0.000664,172.217.194.0-255,6797,86123,90,330296
1659,0.000667,172.31.47.0-255,66,86189,90,330296
1660,0.000909,172.217.194.0-255,1484,87673,90,330296
1661,0.000917,172.217.194.0-255,2902,90575,90,330296
1662,0.000921,172.31.47.0-255,66,90641,90,330296
1663,0.000927,172.217.194.0-255,5738,96379,90,330296
1664,0.00093,172.31.47.0-255,66,96445,90,330296
1665,0.00098,172.217.194.0-255,6233,102678,90,330296
1666,0.000984,172.31.47.0-255,66,102744,90,330296
1667,0.001222,172.217.194.0-255,1484,104228,90,330296
1668,0.001228,172.217.194.0-255,2902,107130,90,330296
1669,0.001232,172.31.47.0-255,66,107196,90,330296
1670,0.001251,172.217.194.0-255,5738,112934,90,330296
1671,0.001253,172.31.47.0-255,66,113000,90,330296
1672,0.001274,172.217.194.0-255,2902,115902,90,330296
1673,0.001275,172.31.47.0-255,66,115968,90,330296
1674,0.001298,172.217.194.0-255,9992,125960,90,330296
1675,0.0013,172.31.47.0-255,66,126026,90,330296
1676,0.001313,172.217.194.0-255,2902,128928,90,330296
1677,0.001316,172.31.47.0-255,66,128994,90,330296
1678,0.00134,172.217.194.0-255,7856,136850,90,330296
1679,0.001342,172.31.47.0-255,66,136916,90,330296
1680,0.001579,172.217.194.0-255,1484,138400,90,330296
1681,0.001594,172.217.194.0-255,2902,141302,90,330296
1682,0.001596,172.31.47.0-255,66,141368,90,330296
1683,0.001599,172.217.194.0-255,2902,144270,90,330296
1684,0.001601,172.31.47.0-255,66,144336,90,330296
1685,0.001616,172.217.194.0-255,2902,147238,90,330296
1686,0.001618,172.31.47.0-255,66,147304,90,330296
1687,0.00162,172.217.194.0-255,1484,148788,90,330296
1688,0.001642,172.31.47.0-255,66,148854,90,330296
1689,0.001648,172.217.194.0-255,7156,156010,90,330296
1690,0.001689,172.217.194.0-255,1484,157494,90,330296
1691,0.001703,172.217.194.0-255,1152,158646,90,330296
1692,0.001706,172.217.194.0-255,2902,161548,90,330296
1693,0.001721,172.217.194.0-255,7156,168704,90,330296
1694,0.001743,172.217.194.0-255,5738,174442,90,330296
1695,0.001762,172.217.194.0-255,9992,184434,90,330296
1696,0.00177,172.217.194.0-255,7856,192290,90,330296
1697,0.00198,172.217.194.0-255,1484,193774,90,330296
1698,0.001983,172.217.194.0-255,1484,195258,90,330296
1699,0.001997,172.217.194.0-255,1484,196742,90,330296
1700,0.002003,172.217.194.0-255,5738,202480,90,330296
1701,0.002059,172.217.194.0-255,1484,203964,90,330296
1702,0.002083,172.217.194.0-255,9274,213238,90,330296
1703,0.002281,172.217.194.0-255,1484,214722,90,330296
1704,0.002301,172.217.194.0-255,2902,217624,90,330296
1705,0.002307,172.217.194.0-255,5738,223362,90,330296
1706,0.002331,172.217.194.0-255,4320,227682,90,330296
1707,0.002355,172.217.194.0-255,8574,236256,90,330296
1708,0.00238,172.217.194.0-255,8574,244830,90,330296
1709,0.002406,172.217.194.0-255,2184,247014,90,330296
1710,0.002475,172.217.194.0-255,5738,252752,90,330296
1711,0.00248,172.217.194.0-255,5020,257772,90,330296
1712,0.002486,172.217.194.0-255,5738,263510,90,330296
1713,0.00251,172.217.194.0-255,9992,273502,90,330296
1714,0.002535,172.217.194.0-255,2902,276404,90,330296
1715,0.002544,172.217.194.0-255,9992,286396,90,330296
1716,0.002577,172.217.194.0-255,1484,287880,90,330296
1717,0.002603,172.217.194.0-255,6438,294318,90,330296
1718,0.002611,172.217.194.0-255,8574,302892,90,330296
1719,0.002631,172.217.194.0-255,8574,311466,90,330296
1720,0.002658,172.217.194.0-255,7156,318622,90,330296
1721,0.004664,172.31.47.0-255,66,318688,90,330296
1722,0.007272,172.217.194.0-255,5738,324426,90,330296
1723,0.007278,172.31.47.0-255,66,324492,90,330296
1724,0.009888,172.217.194.0-255,5738,330230,90,330296
1725,0.009897,172.31.47.0-255,66,330296,90,330296
1726,0.0,74.125.68.0-255,150,150,90,140207
1727,2.2e-05,172.31.47.0-255,66,216,90,140207
1728,2.9e-05,74.125.68.0-255,1484,1700,90,140207
1729,3.3e-05,172.31.47.0-255,66,1766,90,140207
1730,3.8e-05,74.125.68.0-255,2902,4668,90,140207
1731,4.8e-05,172.31.47.0-255,66,4734,90,140207
1732,5.4e-05,74.125.68.0-255,4320,9054,90,140207
1733,5.7e-05,172.31.47.0-255,66,9120,90,140207
1734,6.1e-05,74.125.68.0-255,1484,10604,90,140207
1735,6.4e-05,172.31.47.0-255,66,10670,90,140207
1736,9.3e-05,74.125.68.0-255,3511,14181,90,140207
1737,9.7e-05,172.31.47.0-255,66,14247,90,140207
1738,0.000164,74.125.68.0-255,1484,15731,90,140207
1739,0.000169,172.31.47.0-255,66,15797,90,140207
1740,0.000179,74.125.68.0-255,2902,18699,90,140207
1741,0.000185,172.31.47.0-255,66,18765,90,140207
1742,0.000206,74.125.68.0-255,5738,24503,90,140207
1743,0.000208,172.31.47.0-255,66,24569,90,140207
1744,0.000213,74.125.68.0-255,2902,27471,90,140207
1745,0.000215,172.31.47.0-255,66,27537,90,140207
1746,0.000234,74.125.68.0-255,3961,31498,90,140207
1747,0.000241,172.31.47.0-255,66,31564,90,140207
1748,0.000248,74.125.68.0-255,2902,34466,90,140207
1749,0.00025,172.31.47.0-255,66,34532,90,140207
1750,0.00028,74.125.68.0-255,4320,38852,90,140207
1751,0.000284,172.31.47.0-255,66,38918,90,140207
1752,0.000291,74.125.68.0-255,7156,46074,90,140207
1753,0.000296,172.31.47.0-255,66,46140,90,140207
1754,0.000311,74.125.68.0-255,1484,47624,90,140207
1755,0.000313,172.31.47.0-255,66,47690,90,140207
1756,0.000316,74.125.68.0-255,1125,48815,90,140207
1757,0.000318,172.31.47.0-255,66,48881,90,140207
1758,0.00035,74.125.68.0-255,2902,51783,90,140207
1759,0.000353,172.31.47.0-255,66,51849,90,140207
1760,0.000381,74.125.68.0-255,4320,56169,90,140207
1761,0.000384,172.31.47.0-255,66,56235,90,140207
1762,0.00039,74.125.68.0-255,5738,61973,90,140207
1763,0.000392,172.31.47.0-255,66,62039,90,140207
1764,0.000417,74.125.68.0-255,2902,64941,90,140207
1765,0.00042,172.31.47.0-255,66,65007,90,140207
1766,0.000423,74.125.68.0-255,1395,66402,90,140207
1767,0.000427,74.125.68.0-255,134,66536,90,140207
1768,0.000759,74.125.68.0-255,347,66883,90,140207
1769,0.000765,172.31.47.0-255,66,66949,90,140207
1770,0.001091,74.125.68.0-255,1484,68433,90,140207
1771,0.001097,74.125.68.0-255,2902,71335,90,140207
1772,0.001101,172.31.47.0-255,66,71401,90,140207
1773,0.001106,74.125.68.0-255,2902,74303,90,140207
1774,0.001109,172.31.47.0-255,66,74369,90,140207
1775,0.001131,74.125.68.0-255,4320,78689,90,140207
1776,0.001134,172.31.47.0-255,66,78755,90,140207
1777,0.001158,74.125.68.0-255,7156,85911,90,140207
1778,0.001161,172.31.47.0-255,66,85977,90,140207
1779,0.001188,74.125.68.0-255,1484,87461,90,140207
1780,0.001194,74.125.68.0-255,2902,90363,90,140207
1781,0.001196,172.31.47.0-255,66,90429,90,140207
1782,0.00122,74.125.68.0-255,4320,94749,90,140207
1783,0.001222,172.31.47.0-255,66,94815,90,140207
1784,0.00125,74.125.68.0-255,6438,101253,90,140207
1785,0.001252,172.31.47.0-255,66,101319,90,140207
1786,0.001805,74.125.68.0-255,1484,102803,90,140207
1787,0.001814,74.125.68.0-255,2902,105705,90,140207
1788,0.001818,172.31.47.0-255,66,105771,90,140207
1789,0.001848,74.125.68.0-255,4320,110091,90,140207
1790,0.001851,172.31.47.0-255,66,110157,90,140207
1791,0.001857,74.125.68.0-255,5738,115895,90,140207
1792,0.001859,172.31.47.0-255,66,115961,90,140207
1793,0.0019,172.31.47.0-255,66,116027,90,140207
1794,0.001906,74.125.68.0-255,4320,120347,90,140207
1795,0.001908,172.31.47.0-255,66,120413,90,140207
1796,0.001941,74.125.68.0-255,3602,124015,90,140207
1797,0.001944,172.31.47.0-255,66,124081,90,140207
1798,0.004222,74.125.68.0-255,1484,125565,90,140207
1799,0.004256,74.125.68.0-255,2902,128467,90,140207
1800,0.00426,172.31.47.0-255,66,128533,90,140207
1801,0.00429,74.125.68.0-255,1484,130017,90,140207
1802,0.006593,74.125.68.0-255,4320,134337,90,140207
1803,0.006599,172.31.47.0-255,66,134403,90,140207
1804,0.008926,74.125.68.0-255,5738,140141,90,140207
1805,0.008932,172.31.47.0-255,66,140207,90,140207
1806,0.0,74.125.24.0-255,159,159,90,213660
1807,2.2e-05,172.31.47.0-255,66,225,90,213660
1808,3e-05,74.125.24.0-255,1484,1709,90,213660
1809,3.5e-05,172.31.47.0-255,66,1775,90,213660
1810,4.1e-05,74.125.24.0-255,2902,4677,90,213660
1811,4.5e-05,172.31.47.0-255,66,4743,90,213660
1812,5.3e-05,74.125.24.0-255,7156,11899,90,213660
1813,5.6e-05,172.31.47.0-255,66,11965,90,213660
1814,6e-05,74.125.24.0-255,2000,13965,90,213660
1815,6.3e-05,172.31.47.0-255,66,14031,90,213660
1816,0.000102,74.125.24.0-255,1484,15515,90,213660
1817,0.000105,172.31.47.0-255,66,15581,90,213660
1818,0.00011,74.125.24.0-255,2902,18483,90,213660
1819,0.000112,172.31.47.0-255,66,18549,90,213660
1820,0.000117,74.125.24.0-255,2902,21451,90,213660
1821,0.000119,172.31.47.0-255,66,21517,90,213660
1822,0.000138,74.125.24.0-255,2902,24419,90,213660
1823,0.00014,172.31.47.0-255,66,24485,90,213660
1824,0.000148,74.125.24.0-255,5738,30223,90,213660
1825,0.000151,172.31.47.0-255,66,30289,90,213660
1826,0.000185,74.125.24.0-255,5738,36027,90,213660
1827,0.000188,172.31.47.0-255,66,36093,90,213660
1828,0.000213,74.125.24.0-255,8215,44308,90,213660
1829,0.000215,172.31.47.0-255,66,44374,90,213660
1830,0.00026,74.125.24.0-255,2902,47276,90,213660
1831,0.000263,172.31.47.0-255,66,47342,90,213660
1832,0.000266,74.125.24.0-255,1125,48467,90,213660
1833,0.000268,172.31.47.0-255,66,48533,90,213660
1834,0.00085,74.125.24.0-255,1484,50017,90,213660
1835,0.000856,172.31.47.0-255,66,50083,90,213660
1836,0.000863,74.125.24.0-255,2902,52985,90,213660
1837,0.000865,172.31.47.0-255,66,53051,90,213660
1838,0.000871,74.125.24.0-255,4320,57371,90,213660
1839,0.000873,172.31.47.0-255,66,57437,90,213660
1840,0.000891,74.125.24.0-255,1484,58921,90,213660
1841,0.0009,74.125.24.0-255,6797,65718,90,213660
1842,0.000902,172.31.47.0-255,66,65784,90,213660
1843,0.000925,74.125.24.0-255,646,66430,90,213660
1844,0.00099,74.125.24.0-255,1484,67914,90,213660
1845,0.000994,172.31.47.0-255,66,67980,90,213660
1846,0.000997,74.125.24.0-255,1484,69464,90,213660
1847,0.001011,74.125.24.0-255,1484,70948,90,213660
1848,0.001013,172.31.47.0-255,66,71014,90,213660
1849,0.001019,74.125.24.0-255,5738,76752,90,213660
1850,0.001021,172.31.47.0-255,66,76818,90,213660
1851,0.001052,74.125.24.0-255,4320,81138,90,213660
1852,0.001054,172.31.47.0-255,66,81204,90,213660
1853,0.001068,74.125.24.0-255,8574,89778,90,213660
1854,0.00107,172.31.47.0-255,66,89844,90,213660
1855,0.001113,74.125.24.0-255,2902,92746,90,213660
1856,0.001116,172.31.47.0-255,66,92812,90,213660
1857,0.001137,74.125.24.0-255,7856,100668,90,213660
1858,0.00114,172.31.47.0-255,66,100734,90,213660
1859,0.001246,74.125.24.0-255,1484,102218,90,213660
1860,0.00125,74.125.24.0-255,1484,103702,90,213660
1861,0.001253,172.31.47.0-255,66,103768,90,213660
1862,0.001273,74.125.24.0-255,1484,105252,90,213660
1863,0.001279,74.125.24.0-255,5738,110990,90,213660
1864,0.001281,172.31.47.0-255,66,111056,90,213660
1865,0.00131,74.125.24.0-255,5738,116794,90,213660
1866,0.001312,172.31.47.0-255,66,116860,90,213660
1867,0.00133,74.125.24.0-255,7156,124016,90,213660
1868,0.001332,172.31.47.0-255,66,124082,90,213660
1869,0.00138,74.125.24.0-255,4320,128402,90,213660
1870,0.001383,172.31.47.0-255,66,128468,90,213660
1871,0.001397,74.125.24.0-255,1484,129952,90,213660
1872,0.0014,74.125.24.0-255,1484,131436,90,213660
1873,0.001402,172.31.47.0-255,66,131502,90,213660
1874,0.001433,74.125.24.0-255,9274,140776,90,213660
1875,0.001436,172.31.47.0-255,66,140842,90,213660
1876,0.001467,74.125.24.0-255,4320,145162,90,213660
1877,0.00147,172.31.47.0-255,66,145228,90,213660
1878,0.0015,172.31.47.0-255,66,145294,90,213660
1879,0.001581,74.125.24.0-255,4320,149614,90,213660
1880,0.001584,172.31.47.0-255,66,149680,90,213660
1881,0.001604,74.125.24.0-255,5020,154700,90,213660
1882,0.001607,172.31.47.0-255,66,154766,90,213660
1883,0.001655,74.125.24.0-255,2902,157668,90,213660
1884,0.001657,172.31.47.0-255,66,157734,90,213660
1885,0.001669,172.31.47.0-255,66,157800,90,213660
1886,0.001685,74.125.24.0-255,2902,160702,90,213660
1887,0.001687,172.31.47.0-255,66,160768,90,213660
1888,0.001741,74.125.24.0-255,4320,165088,90,213660
1889,0.001744,172.31.47.0-255,66,165154,90,213660
1890,0.001772,172.31.47.0-255,66,165220,90,213660
1891,0.001795,74.125.24.0-255,5020,170240,90,213660
1892,0.001797,172.31.47.0-255,66,170306,90,213660
1893,0.001908,74.125.24.0-255,5738,176044,90,213660
1894,0.001912,172.31.47.0-255,66,176110,90,213660
1895,0.001941,172.31.47.0-255,66,176176,90,213660
1896,0.002043,74.125.24.0-255,8574,184750,90,213660
1897,0.002048,172.31.47.0-255,66,184816,90,213660
1898,0.002099,172.31.47.0-255,66,184882,90,213660
1899,0.002229,74.125.24.0-255,3602,188484,90,213660
1900,0.002235,172.31.47.0-255,66,188550,90,213660
1901,0.002239,74.125.24.0-255,2902,191452,90,213660
1902,0.002242,172.31.47.0-255,66,191518,90,213660
1903,0.002267,172.31.47.0-255,66,191584,90,213660
1904,0.002321,172.31.47.0-255,66,191650,90,213660
1905,0.002346,74.125.24.0-255,9274,200924,90,213660
1906,0.002349,172.31.47.0-255,66,200990,90,213660
1907,0.002601,74.125.24.0-255,4320,205310,90,213660
1908,0.00261,172.31.47.0-255,66,205376,90,213660
1909,0.002649,172.31.47.0-255,66,205442,90,213660
1910,0.002712,74.125.24.0-255,7156,212598,90,213660
1911,0.002715,172.31.47.0-255,66,212664,90,213660
1912,0.002766,172.31.47.0-255,66,212730,90,213660
1913,0.002797,172.31.47.0-255,66,212796,90,213660
1914,0.003022,74.125.24.0-255,168,212964,90,213660
1915,0.004351,172.31.47.0-255,105,213069,90,213660
1916,0.004385,172.31.47.0-255,105,213174,90,213660
1917,0.004591,172.31.47.0-255,90,213264,90,213660
1918,0.004599,172.31.47.0-255,66,213330,90,213660
1919,0.006534,74.125.24.0-255,66,213396,90,213660
1920,0.006557,74.125.24.0-255,66,213462,90,213660
1921,0.00677,74.125.24.0-255,66,213528,90,213660
1922,0.006797,74.125.24.0-255,66,213594,90,213660
1923,0.006802,172.31.47.0-255,66,213660,90,213660
1924,0.0,172.217.194.0-255,146,146,90,136602
1925,2.5e-05,172.31.47.0-255,66,212,90,136602
1926,3.1e-05,172.217.194.0-255,1484,1696,90,136602
1927,3.5e-05,172.31.47.0-255,66,1762,90,136602
1928,4e-05,172.217.194.0-255,2902,4664,90,136602
1929,4.3e-05,172.31.47.0-255,66,4730,90,136602
1930,7.6e-05,172.217.194.0-255,7156,11886,90,136602
1931,7.9e-05,172.31.47.0-255,66,11952,90,136602
1932,8.8e-05,172.217.194.0-255,6471,18423,90,136602
1933,9.1e-05,172.31.47.0-255,66,18489,90,136602
1934,0.000134,172.217.194.0-255,4320,22809,90,136602
1935,0.000138,172.31.47.0-255,66,22875,90,136602
1936,0.000162,172.217.194.0-255,8215,31090,90,136602
1937,0.000165,172.31.47.0-255,66,31156,90,136602
1938,0.000273,172.217.194.0-255,1484,32640,90,136602
1939,0.000277,172.31.47.0-255,66,32706,90,136602
1940,0.000282,172.217.194.0-255,2902,35608,90,136602
1941,0.000285,172.31.47.0-255,66,35674,90,136602
1942,0.000324,172.217.194.0-255,2902,38576,90,136602
1943,0.000327,172.31.47.0-255,66,38642,90,136602
1944,0.000348,172.217.194.0-255,2902,41544,90,136602
1945,0.000352,172.31.47.0-255,66,41610,90,136602
1946,0.000367,172.31.47.0-255,66,41676,90,136602
1947,0.000384,172.217.194.0-255,8574,50250,90,136602
1948,0.000387,172.31.47.0-255,66,50316,90,136602
1949,0.00039,172.217.194.0-255,1417,51733,90,136602
1950,0.000395,172.31.47.0-255,66,51799,90,136602
1951,0.000414,172.217.194.0-255,100,51899,90,136602
1952,0.000417,172.31.47.0-255,66,51965,90,136602
1953,0.000446,172.217.194.0-255,1484,53449,90,136602
1954,0.000449,172.31.47.0-255,66,53515,90,136602
1955,0.000453,172.217.194.0-255,1484,54999,90,136602
1956,0.000467,172.217.194.0-255,1484,56483,90,136602
1957,0.000476,172.217.194.0-255,7156,63639,90,136602
1958,0.000479,172.31.47.0-255,66,63705,90,136602
1959,0.000484,172.31.47.0-255,66,63771,90,136602
1960,0.000505,172.217.194.0-255,9992,73763,90,136602
1961,0.00052,172.31.47.0-255,66,73829,90,136602
1962,0.000538,172.217.194.0-255,1484,75313,90,136602
1963,0.00057,172.31.47.0-255,66,75379,90,136602
1964,0.000793,172.217.194.0-255,1484,76863,90,136602
1965,0.000798,172.217.194.0-255,2902,79765,90,136602
1966,0.000802,172.31.47.0-255,66,79831,90,136602
1967,0.000809,172.217.194.0-255,5738,85569,90,136602
1968,0.000817,172.31.47.0-255,66,85635,90,136602
1969,0.000849,172.31.47.0-255,66,85701,90,136602
1970,0.000858,172.217.194.0-255,10692,96393,90,136602
1971,0.000864,172.31.47.0-255,66,96459,90,136602
1972,0.001059,172.217.194.0-255,1484,97943,90,136602
1973,0.001065,172.217.194.0-255,2902,100845,90,136602
1974,0.001068,172.31.47.0-255,66,100911,90,136602
1975,0.001091,172.217.194.0-255,5738,106649,90,136602
1976,0.001095,172.217.194.0-255,1484,108133,90,136602
1977,0.001104,172.31.47.0-255,66,108199,90,136602
1978,0.001131,172.31.47.0-255,66,108265,90,136602
1979,0.001173,172.217.194.0-255,10692,118957,90,136602
1980,0.001181,172.31.47.0-255,66,119023,90,136602
1981,0.001282,172.31.47.0-255,101,119124,90,136602
1982,0.00348,172.217.194.0-255,5738,124862,90,136602
1983,0.003486,172.31.47.0-255,66,124928,90,136602
1984,0.003508,172.217.194.0-255,66,124994,90,136602
1985,0.00577,172.217.194.0-255,5738,130732,90,136602
1986,0.006278,172.31.47.0-255,66,130798,90,136602
1987,0.008545,172.217.194.0-255,5738,136536,90,136602
1988,0.008552,172.31.47.0-255,66,136602,90,136602
1989,0.0,74.125.200.0-255,373,373,90,63875
1990,3.3e-05,172.31.47.0-255,66,439,90,63875
1991,3.9e-05,74.125.200.0-255,1484,1923,90,63875
1992,4.3e-05,172.31.47.0-255,66,1989,90,63875
1993,6.3e-05,74.125.200.0-255,2902,4891,90,63875
1994,6.5e-05,172.31.47.0-255,66,4957,90,63875
1995,0.00018,74.125.200.0-255,4320,9277,90,63875
1996,0.000184,172.31.47.0-255,66,9343,90,63875
1997,0.000348,74.125.200.0-255,1484,10827,90,63875
1998,0.000354,172.31.47.0-255,66,10893,90,63875
1999,0.000381,74.125.200.0-255,7601,18494,90,63875
2000,0.000385,172.31.47.0-255,66,18560,90,63875
2001,0.000714,74.125.200.0-255,4320,22880,90,63875
2002,0.00072,172.31.47.0-255,66,22946,90,63875
2003,0.000889,74.125.200.0-255,5738,28684,90,63875
2004,0.000895,172.31.47.0-255,66,28750,90,63875
2005,0.000912,74.125.200.0-255,2543,31293,90,63875
2006,0.000914,172.31.47.0-255,66,31359,90,63875
2007,0.001213,74.125.200.0-255,5738,37097,90,63875
2008,0.00122,172.31.47.0-255,66,37163,90,63875
2009,0.00201,74.125.200.0-255,2902,40065,90,63875
2010,0.002014,172.31.47.0-255,66,40131,90,63875
2011,0.00319,74.125.200.0-255,2902,43033,90,63875
2012,0.003193,172.31.47.0-255,66,43099,90,63875
2013,0.003992,74.125.200.0-255,2902,46001,90,63875
2014,0.003999,172.31.47.0-255,66,46067,90,63875
2015,0.005162,74.125.200.0-255,2902,48969,90,63875
2016,0.005169,172.31.47.0-255,66,49035,90,63875
2017,0.005969,74.125.200.0-255,2902,51937,90,63875
2018,0.005978,172.31.47.0-255,66,52003,90,63875
2019,0.007184,74.125.200.0-255,2902,54905,90,63875
2020,0.007193,172.31.47.0-255,66,54971,90,63875
2021,0.007944,74.125.200.0-255,2902,57873,90,63875
2022,0.007948,172.31.47.0-255,66,57939,90,63875
2023,0.00916,74.125.200.0-255,2902,60841,90,63875
2024,0.009166,172.31.47.0-255,66,60907,90,63875
2025,0.009917,74.125.200.0-255,2902,63809,90,63875
2026,0.009923,172.31.47.0-255,66,63875,90,63875
2027,0.0,172.217.194.0-255,153,153,90,224805
2028,2.4e-05,172.31.47.0-255,66,219,90,224805
2029,3e-05,172.217.194.0-255,1484,1703,90,224805
2030,3.4e-05,172.31.47.0-255,66,1769,90,224805
2031,4.6e-05,172.217.194.0-255,2902,4671,90,224805
2032,4.8e-05,172.31.47.0-255,66,4737,90,224805
2033,5.4e-05,172.217.194.0-255,5738,10475,90,224805
2034,5.6e-05,172.31.47.0-255,66,10541,90,224805
2035,7.9e-05,172.217.194.0-255,1484,12025,90,224805
2036,8.1e-05,172.31.47.0-255,66,12091,90,224805
2037,0.000111,172.217.194.0-255,10609,22700,90,224805
2038,0.000113,172.31.47.0-255,66,22766,90,224805
2039,0.000135,172.217.194.0-255,1484,24250,90,224805
2040,0.000137,172.31.47.0-255,66,24316,90,224805
2041,0.000163,172.217.194.0-255,6797,31113,90,224805
2042,0.000168,172.31.47.0-255,66,31179,90,224805
2043,0.000203,172.217.194.0-255,1484,32663,90,224805
2044,0.000205,172.31.47.0-255,66,32729,90,224805
2045,0.00021,172.217.194.0-255,2902,35631,90,224805
2046,0.000211,172.31.47.0-255,66,35697,90,224805
2047,0.00023,172.217.194.0-255,4320,40017,90,224805
2048,0.000232,172.31.47.0-255,66,40083,90,224805
2049,0.000257,172.217.194.0-255,1484,41567,90,224805
2050,0.00026,172.31.47.0-255,66,41633,90,224805
2051,0.000267,172.217.194.0-255,6797,48430,90,224805
2052,0.000269,172.31.47.0-255,66,48496,90,224805
2053,0.000271,172.217.194.0-255,1484,49980,90,224805
2054,0.000274,172.31.47.0-255,66,50046,90,224805
2055,0.00032,172.31.47.0-255,66,50112,90,224805
2056,0.000324,172.217.194.0-255,2833,52945,90,224805
2057,0.000326,172.31.47.0-255,66,53011,90,224805
2058,0.000328,172.217.194.0-255,398,53409,90,224805
2059,0.00048,172.217.194.0-255,1484,54893,90,224805
2060,0.000484,172.31.47.0-255,66,54959,90,224805
2061,0.000489,172.217.194.0-255,2902,57861,90,224805
2062,0.000492,172.31.47.0-255,66,57927,90,224805
2063,0.000494,172.217.194.0-255,1484,59411,90,224805
2064,0.00051,172.217.194.0-255,2902,62313,90,224805
2065,0.000515,172.31.47.0-255,66,62379,90,224805
2066,0.000525,172.217.194.0-255,5738,68117,90,224805
2067,0.000528,172.31.47.0-255,66,68183,90,224805
2068,0.000564,172.31.47.0-255,66,68249,90,224805
2069,0.000599,172.217.194.0-255,4320,72569,90,224805
2070,0.000602,172.31.47.0-255,66,72635,90,224805
2071,0.000619,172.217.194.0-255,3602,76237,90,224805
2072,0.000622,172.31.47.0-255,66,76303,90,224805
2073,0.000922,172.217.194.0-255,1484,77787,90,224805
2074,0.00093,172.217.194.0-255,2902,80689,90,224805
2075,0.000933,172.31.47.0-255,66,80755,90,224805
2076,0.000939,172.217.194.0-255,5738,86493,90,224805
2077,0.000941,172.31.47.0-255,66,86559,90,224805
2078,0.000943,172.217.194.0-255,1484,88043,90,224805
2079,0.000994,172.217.194.0-255,2902,90945,90,224805
2080,0.001,172.217.194.0-255,5738,96683,90,224805
2081,0.001002,172.31.47.0-255,66,96749,90,224805
2082,0.001008,172.31.47.0-255,66,96815,90,224805
2083,0.001011,172.217.194.0-255,766,97581,90,224805
2084,0.001032,172.31.47.0-255,66,97647,90,224805
2085,0.001295,172.217.194.0-255,1484,99131,90,224805
2086,0.001299,172.217.194.0-255,1484,100615,90,224805
2087,0.001302,172.31.47.0-255,66,100681,90,224805
2088,0.001314,172.217.194.0-255,1484,102165,90,224805
2089,0.001337,172.217.194.0-255,5738,107903,90,224805
2090,0.001339,172.31.47.0-255,66,107969,90,224805
2091,0.001365,172.217.194.0-255,4320,112289,90,224805
2092,0.001367,172.31.47.0-255,66,112355,90,224805
2093,0.001395,172.217.194.0-255,8574,120929,90,224805
2094,0.001399,172.31.47.0-255,66,120995,90,224805
2095,0.001407,172.217.194.0-255,8574,129569,90,224805
2096,0.001408,172.31.47.0-255,66,129635,90,224805
2097,0.001432,172.217.194.0-255,2184,131819,90,224805
2098,0.001439,172.31.47.0-255,66,131885,90,224805
2099,0.001457,172.217.194.0-255,2902,134787,90,224805
2100,0.001459,172.31.47.0-255,66,134853,90,224805
2101,0.001487,172.217.194.0-255,7156,142009,90,224805
2102,0.00149,172.31.47.0-255,66,142075,90,224805
2103,0.001495,172.217.194.0-255,5738,147813,90,224805
2104,0.001497,172.31.47.0-255,66,147879,90,224805
2105,0.001535,172.217.194.0-255,2902,150781,90,224805
2106,0.001543,172.31.47.0-255,66,150847,90,224805
2107,0.001572,172.217.194.0-255,7156,158003,90,224805
2108,0.001575,172.31.47.0-255,66,158069,90,224805
2109,0.001597,172.217.194.0-255,7156,165225,90,224805
2110,0.0016,172.31.47.0-255,66,165291,90,224805
2111,0.001615,172.217.194.0-255,766,166057,90,224805
2112,0.001642,172.217.194.0-255,1484,167541,90,224805
2113,0.001645,172.217.194.0-255,1484,169025,90,224805
2114,0.001645,172.31.47.0-255,66,169091,90,224805
2115,0.001653,172.217.194.0-255,1484,170575,90,224805
2116,0.001655,172.31.47.0-255,66,170641,90,224805
2117,0.001683,172.217.194.0-255,5738,176379,90,224805
2118,0.001687,172.217.194.0-255,1484,177863,90,224805
2119,0.001694,172.31.47.0-255,66,177929,90,224805
2120,0.001701,172.217.194.0-255,5738,183667,90,224805
2121,0.001707,172.31.47.0-255,66,183733,90,224805
2122,0.001741,172.217.194.0-255,2184,185917,90,224805
2123,0.001742,172.31.47.0-255,66,185983,90,224805
2124,0.001746,172.31.47.0-255,66,186049,90,224805
2125,0.001902,172.217.194.0-255,1484,187533,90,224805
2126,0.00192,172.217.194.0-255,2902,190435,90,224805
2127,0.001924,172.31.47.0-255,66,190501,90,224805
2128,0.001929,172.217.194.0-255,2902,193403,90,224805
2129,0.001932,172.31.47.0-255,66,193469,90,224805
2130,0.001961,172.217.194.0-255,2902,196371,90,224805
2131,0.001967,172.31.47.0-255,66,196437,90,224805
2132,0.001973,172.217.194.0-255,5738,202175,90,224805
2133,0.001977,172.31.47.0-255,66,202241,90,224805
2134,0.001991,172.31.47.0-255,66,202307,90,224805
2135,0.001994,172.217.194.0-255,5020,207327,90,224805
2136,0.002007,172.31.47.0-255,66,207393,90,224805
2137,0.004045,172.217.194.0-255,5738,213131,90,224805
2138,0.004052,172.31.47.0-255,66,213197,90,224805
2139,0.006081,172.217.194.0-255,5738,218935,90,224805
2140,0.006088,172.31.47.0-255,66,219001,90,224805
2141,0.008108,172.217.194.0-255,5738,224739,90,224805
2142,0.008111,172.31.47.0-255,66,224805,90,224805
2143,0.0,172.217.194.0-255,226,226,90,52501
2144,2.3e-05,172.31.47.0-255,66,292,90,52501
2145,2.9e-05,172.217.194.0-255,1484,1776,90,52501
2146,3.3e-05,172.31.47.0-255,66,1842,90,52501
2147,7.4e-05,172.217.194.0-255,4320,6162,90,52501
2148,7.7e-05,172.31.47.0-255,66,6228,90,52501
2149,0.000256,172.217.194.0-255,5738,11966,90,52501
2150,0.000261,172.31.47.0-255,66,12032,90,52501
2151,0.000287,172.217.194.0-255,3501,15533,90,52501
2152,0.000289,172.31.47.0-255,66,15599,90,52501
2153,0.000663,172.217.194.0-255,7156,22755,90,52501
2154,0.000668,172.31.47.0-255,66,22821,90,52501
2155,0.000699,172.217.194.0-255,7156,29977,90,52501
2156,0.000702,172.31.47.0-255,66,30043,90,52501
2157,0.002297,172.217.194.0-255,2467,32510,90,52501
2158,0.002303,172.31.47.0-255,66,32576,90,52501
2159,0.003004,172.217.194.0-255,2902,35478,90,52501
2160,0.003009,172.31.47.0-255,66,35544,90,52501
2161,0.004575,172.217.194.0-255,2902,38446,90,52501
2162,0.004581,172.31.47.0-255,66,38512,90,52501
2163,0.005262,172.217.194.0-255,2902,41414,90,52501
2164,0.005267,172.31.47.0-255,66,41480,90,52501
2165,0.00683,172.217.194.0-255,2902,44382,90,52501
2166,0.006836,172.31.47.0-255,66,44448,90,52501
2167,0.007525,172.217.194.0-255,501,44949,90,52501
2168,0.007532,172.31.47.0-255,66,45015,90,52501
2169,0.00756,172.217.194.0-255,1484,46499,90,52501
2170,0.007563,172.31.47.0-255,66,46565,90,52501
2171,0.009138,172.217.194.0-255,2902,49467,90,52501
2172,0.009145,172.31.47.0-255,66,49533,90,52501
2173,0.009849,172.217.194.0-255,2902,52435,90,52501
2174,0.009854,172.31.47.0-255,66,52501,90,52501
2175,0.0,172.31.47.0-255,105,105,90,105
2176,0.0,172.31.47.0-255,105,105,90,276
2177,0.001457,157.240.13.0-255,105,210,90,276
2178,0.00147,172.31.47.0-255,66,276,90,276
2179,0.0,172.217.160.0-255,66,66,90,66
2180,0.0,172.31.47.0-255,105,105,90,105
2181,0.0,172.217.194.0-255,159,159,90,140780
2182,2e-05,172.31.47.0-255,66,225,90,140780
2183,4.9e-05,172.217.194.0-255,1484,1709,90,140780
2184,5.2e-05,172.31.47.0-255,66,1775,90,140780
2185,7.2e-05,172.217.194.0-255,2902,4677,90,140780
2186,7.4e-05,172.31.47.0-255,66,4743,90,140780
2187,9.7e-05,172.217.194.0-255,5738,10481,90,140780
2188,9.9e-05,172.31.47.0-255,66,10547,90,140780
2189,0.000114,172.217.194.0-255,3579,14126,90,140780
2190,0.000116,172.31.47.0-255,66,14192,90,140780
2191,0.000143,172.217.194.0-255,2902,17094,90,140780
2192,0.000146,172.31.47.0-255,66,17160,90,140780
2193,0.000169,172.217.194.0-255,8574,25734,90,140780
2194,0.000171,172.31.47.0-255,66,25800,90,140780
2195,0.000176,172.217.194.0-255,5379,31179,90,140780
2196,0.000178,172.31.47.0-255,66,31245,90,140780
2197,0.000216,172.217.194.0-255,1484,32729,90,140780
2198,0.000218,172.31.47.0-255,66,32795,90,140780
2199,0.000221,172.217.194.0-255,1484,34279,90,140780
2200,0.000223,172.31.47.0-255,66,34345,90,140780
2201,0.000236,172.217.194.0-255,1484,35829,90,140780
2202,0.000238,172.31.47.0-255,66,35895,90,140780
2203,0.000258,172.217.194.0-255,5738,41633,90,140780
2204,0.00026,172.31.47.0-255,66,41699,90,140780
2205,0.000263,172.217.194.0-255,1484,43183,90,140780
2206,0.000265,172.31.47.0-255,66,43249,90,140780
2207,0.000287,172.217.194.0-255,5379,48628,90,140780
2208,0.00029,172.31.47.0-255,66,48694,90,140780
2209,0.000297,172.217.194.0-255,8574,57268,90,140780
2210,0.0003,172.31.47.0-255,66,57334,90,140780
2211,0.000322,172.217.194.0-255,5738,63072,90,140780
2212,0.000326,172.31.47.0-255,66,63138,90,140780
2213,0.00033,172.217.194.0-255,2543,65681,90,140780
2214,0.000331,172.31.47.0-255,66,65747,90,140780
2215,0.000334,172.217.194.0-255,395,66142,90,140780
2216,0.00066,172.31.47.0-255,66,66208,90,140780
2217,0.000891,172.217.194.0-255,380,66588,90,140780
2218,0.001033,172.217.194.0-255,1484,68072,90,140780
2219,0.001038,172.31.47.0-255,66,68138,90,140780
2220,0.001043,172.217.194.0-255,2902,71040,90,140780
2221,0.001045,172.31.47.0-255,66,71106,90,140780
2222,0.001059,172.217.194.0-255,2902,74008,90,140780
2223,0.001061,172.31.47.0-255,66,74074,90,140780
2224,0.001087,172.217.194.0-255,2902,76976,90,140780
2225,0.001089,172.31.47.0-255,66,77042,90,140780
2226,0.001095,172.217.194.0-255,6797,83839,90,140780
2227,0.001097,172.31.47.0-255,66,83905,90,140780
2228,0.001137,172.31.47.0-255,66,83971,90,140780
2229,0.001154,172.217.194.0-255,1484,85455,90,140780
2230,0.001158,172.217.194.0-255,1993,87448,90,140780
2231,0.00116,172.31.47.0-255,66,87514,90,140780
2232,0.001636,172.217.194.0-255,1484,88998,90,140780
2233,0.001642,172.217.194.0-255,2902,91900,90,140780
2234,0.001644,172.31.47.0-255,66,91966,90,140780
2235,0.001662,172.217.194.0-255,4320,96286,90,140780
2236,0.001664,172.31.47.0-255,66,96352,90,140780
2237,0.001674,172.217.194.0-255,1484,97836,90,140780
2238,0.001701,172.31.47.0-255,66,97902,90,140780
2239,0.001708,172.217.194.0-255,9992,107894,90,140780
2240,0.001711,172.31.47.0-255,66,107960,90,140780
2241,0.001741,172.217.194.0-255,766,108726,90,140780
2242,0.002288,172.217.194.0-255,1484,110210,90,140780
2243,0.00229,172.31.47.0-255,66,110276,90,140780
2244,0.0023,172.217.194.0-255,2902,113178,90,140780
2245,0.002302,172.31.47.0-255,66,113244,90,140780
2246,0.002317,172.217.194.0-255,1484,114728,90,140780
2247,0.002363,172.217.194.0-255,8574,123302,90,140780
2248,0.002365,172.31.47.0-255,66,123368,90,140780
2249,0.004657,172.217.194.0-255,5738,129106,90,140780
2250,0.004663,172.31.47.0-255,66,129172,90,140780
2251,0.006955,172.217.194.0-255,5738,134910,90,140780
2252,0.006961,172.31.47.0-255,66,134976,90,140780
2253,0.009256,172.217.194.0-255,5738,140714,90,140780
2254,0.009266,172.31.47.0-255,66,140780,90,140780
2255,0.0,74.125.200.0-255,153,153,90,345104
2256,2.4e-05,172.31.47.0-255,66,219,90,345104
2257,3e-05,74.125.200.0-255,1484,1703,90,345104
2258,3.3e-05,172.31.47.0-255,66,1769,90,345104
2259,3.8e-05,74.125.200.0-255,2902,4671,90,345104
2260,4e-05,172.31.47.0-255,66,4737,90,345104
2261,5e-05,74.125.200.0-255,2902,7639,90,345104
2262,5.3e-05,172.31.47.0-255,66,7705,90,345104
2263,8.4e-05,74.125.200.0-255,4320,12025,90,345104
2264,8.8e-05,172.31.47.0-255,66,12091,90,345104
2265,9.8e-05,74.125.200.0-255,2902,14993,90,345104
2266,0.0001,172.31.47.0-255,66,15059,90,345104
2267,0.000124,74.125.200.0-255,6262,21321,90,345104
2268,0.000127,172.31.47.0-255,66,21387,90,345104
2269,0.000131,74.125.200.0-255,4320,25707,90,345104
2270,0.000133,172.31.47.0-255,66,25773,90,345104
2271,0.00016,74.125.200.0-255,1484,27257,90,345104
2272,0.000162,172.31.47.0-255,66,27323,90,345104
2273,0.000182,74.125.200.0-255,3961,31284,90,345104
2274,0.000184,172.31.47.0-255,66,31350,90,345104
2275,0.000218,74.125.200.0-255,2902,34252,90,345104
2276,0.00022,172.31.47.0-255,66,34318,90,345104
2277,0.000223,74.125.200.0-255,1484,35802,90,345104
2278,0.000225,172.31.47.0-255,66,35868,90,345104
2279,0.000258,74.125.200.0-255,2902,38770,90,345104
2280,0.000262,172.31.47.0-255,66,38836,90,345104
2281,0.000269,74.125.200.0-255,8574,47410,90,345104
2282,0.000271,172.31.47.0-255,66,47476,90,345104
2283,0.000277,74.125.200.0-255,7156,54632,90,345104
2284,0.000279,172.31.47.0-255,66,54698,90,345104
2285,0.000283,74.125.200.0-255,4320,59018,90,345104
2286,0.000286,172.31.47.0-255,66,59084,90,345104
2287,0.000312,74.125.200.0-255,4320,63404,90,345104
2288,0.000315,172.31.47.0-255,66,63470,90,345104
2289,0.000319,74.125.200.0-255,2184,65654,90,345104
2290,0.000321,172.31.47.0-255,66,65720,90,345104
2291,0.000342,74.125.200.0-255,678,66398,90,345104
2292,0.000453,74.125.200.0-255,1484,67882,90,345104
2293,0.000456,172.31.47.0-255,66,67948,90,345104
2294,0.000461,74.125.200.0-255,2902,70850,90,345104
2295,0.000463,172.31.47.0-255,66,70916,90,345104
2296,0.000497,74.125.200.0-255,5738,76654,90,345104
2297,0.000502,172.31.47.0-255,66,76720,90,345104
2298,0.000511,74.125.200.0-255,1484,78204,90,345104
2299,0.000528,74.125.200.0-255,5738,83942,90,345104
2300,0.00053,172.31.47.0-255,66,84008,90,345104
2301,0.000556,74.125.200.0-255,5738,89746,90,345104
2302,0.000559,172.31.47.0-255,66,89812,90,345104
2303,0.000562,74.125.200.0-255,2902,92714,90,345104
2304,0.000564,172.31.47.0-255,66,92780,90,345104
2305,0.000595,74.125.200.0-255,7856,100636,90,345104
2306,0.000598,172.31.47.0-255,66,100702,90,345104
2307,0.001069,74.125.200.0-255,1484,102186,90,345104
2308,0.001078,74.125.200.0-255,2902,105088,90,345104
2309,0.001081,172.31.47.0-255,66,105154,90,345104
2310,0.00111,74.125.200.0-255,5738,110892,90,345104
2311,0.001113,172.31.47.0-255,66,110958,90,345104
2312,0.001119,74.125.200.0-255,5738,116696,90,345104
2313,0.001121,172.31.47.0-255,66,116762,90,345104
2314,0.001148,74.125.200.0-255,1484,118246,90,345104
2315,0.001157,74.125.200.0-255,8574,126820,90,345104
2316,0.00116,172.31.47.0-255,66,126886,90,345104
2317,0.001191,74.125.200.0-255,6260,133146,90,345104
2318,0.001193,172.31.47.0-255,66,133212,90,345104
2319,0.001215,74.125.200.0-255,2902,136114,90,345104
2320,0.001218,172.31.47.0-255,66,136180,90,345104
2321,0.001242,74.125.200.0-255,4320,140500,90,345104
2322,0.001244,172.31.47.0-255,66,140566,90,345104
2323,0.001248,74.125.200.0-255,2902,143468,90,345104
2324,0.001249,172.31.47.0-255,66,143534,90,345104
2325,0.001276,74.125.200.0-255,5738,149272,90,345104
2326,0.001278,172.31.47.0-255,66,149338,90,345104
2327,0.001283,74.125.200.0-255,4320,153658,90,345104
2328,0.001284,172.31.47.0-255,66,153724,90,345104
2329,0.001289,74.125.200.0-255,5738,159462,90,345104
2330,0.001291,172.31.47.0-255,66,159528,90,345104
2331,0.001351,74.125.200.0-255,7856,167384,90,345104
2332,0.001354,172.31.47.0-255,66,167450,90,345104
2333,0.001549,74.125.200.0-255,1484,168934,90,345104
2334,0.001568,74.125.200.0-255,2902,171836,90,345104
2335,0.001572,172.31.47.0-255,66,171902,90,345104
2336,0.001596,74.125.200.0-255,4320,176222,90,345104
2337,0.001599,172.31.47.0-255,66,176288,90,345104
2338,0.001629,74.125.200.0-255,5738,182026,90,345104
2339,0.001631,172.31.47.0-255,66,182092,90,345104
2340,0.001638,74.125.200.0-255,7156,189248,90,345104
2341,0.00164,172.31.47.0-255,66,189314,90,345104
2342,0.001673,74.125.200.0-255,4320,193634,90,345104
2343,0.001675,172.31.47.0-255,66,193700,90,345104
2344,0.001679,74.125.200.0-255,4320,198020,90,345104
2345,0.001682,172.31.47.0-255,66,198086,90,345104
2346,0.001686,74.125.200.0-255,3602,201688,90,345104
2347,0.001688,172.31.47.0-255,66,201754,90,345104
2348,0.001691,74.125.200.0-255,1484,203238,90,345104
2349,0.001722,74.125.200.0-255,2902,206140,90,345104
2350,0.001724,172.31.47.0-255,66,206206,90,345104
2351,0.001732,74.125.200.0-255,7156,213362,90,345104
2352,0.001734,172.31.47.0-255,66,213428,90,345104
2353,0.001762,74.125.200.0-255,2902,216330,90,345104
2354,0.001764,172.31.47.0-255,66,216396,90,345104
2355,0.001769,74.125.200.0-255,2902,219298,90,345104
2356,0.001771,172.31.47.0-255,66,219364,90,345104
2357,0.001784,172.31.47.0-255,66,219430,90,345104
2358,0.001788,74.125.200.0-255,2184,221614,90,345104
2359,0.00179,172.31.47.0-255,66,221680,90,345104
2360,0.001826,74.125.200.0-255,1484,223164,90,345104
2361,0.001841,74.125.200.0-255,2902,226066,90,345104
2362,0.001843,172.31.47.0-255,66,226132,90,345104
2363,0.001848,74.125.200.0-255,2902,229034,90,345104
2364,0.00185,172.31.47.0-255,66,229100,90,345104
2365,0.001869,74.125.200.0-255,2902,232002,90,345104
2366,0.001871,172.31.47.0-255,66,232068,90,345104
2367,0.001924,172.31.47.0-255,66,232134,90,345104
2368,0.001936,172.31.47.0-255,66,232200,90,345104
2369,0.002033,74.125.200.0-255,1484,233684,90,345104
2370,0.002048,74.125.200.0-255,2902,236586,90,345104
2371,0.002052,172.31.47.0-255,66,236652,90,345104
2372,0.002077,74.125.200.0-255,4320,240972,90,345104
2373,0.002081,172.31.47.0-255,66,241038,90,345104
2374,0.002104,74.125.200.0-255,1484,242522,90,345104
2375,0.00212,74.125.200.0-255,2902,245424,90,345104
2376,0.002124,172.31.47.0-255,66,245490,90,345104
2377,0.002154,74.125.200.0-255,2902,248392,90,345104
2378,0.002156,172.31.47.0-255,66,248458,90,345104
2379,0.002163,74.125.200.0-255,7156,255614,90,345104
2380,0.002165,172.31.47.0-255,66,255680,90,345104
2381,0.002177,74.125.200.0-255,10692,266372,90,345104
2382,0.00218,172.31.47.0-255,66,266438,90,345104
2383,0.002237,74.125.200.0-255,1484,267922,90,345104
2384,0.002249,74.125.200.0-255,2902,270824,90,345104
2385,0.002252,172.31.47.0-255,66,270890,90,345104
2386,0.002289,74.125.200.0-255,5738,276628,90,345104
2387,0.002293,172.31.47.0-255,66,276694,90,345104
2388,0.002298,74.125.200.0-255,4320,281014,90,345104
2389,0.002301,172.31.47.0-255,66,281080,90,345104
2390,0.002302,74.125.200.0-255,4320,285400,90,345104
2391,0.002304,172.31.47.0-255,66,285466,90,345104
2392,0.002334,74.125.200.0-255,1484,286950,90,345104
2393,0.002347,74.125.200.0-255,2184,289134,90,345104
2394,0.002348,172.31.47.0-255,66,289200,90,345104
2395,0.002351,172.31.47.0-255,66,289266,90,345104
2396,0.002425,74.125.200.0-255,8574,297840,90,345104
2397,0.002429,172.31.47.0-255,66,297906,90,345104
2398,0.002447,74.125.200.0-255,7156,305062,90,345104
2399,0.00245,172.31.47.0-255,66,305128,90,345104
2400,0.002456,74.125.200.0-255,7156,312284,90,345104
2401,0.002459,172.31.47.0-255,66,312350,90,345104
2402,0.002467,74.125.200.0-255,10692,323042,90,345104
2403,0.002469,172.31.47.0-255,66,323108,90,345104
2404,0.002496,74.125.200.0-255,1484,324592,90,345104
2405,0.002515,74.125.200.0-255,4320,328912,90,345104
2406,0.002517,172.31.47.0-255,66,328978,90,345104
2407,0.00252,74.125.200.0-255,1484,330462,90,345104
2408,0.002543,74.125.200.0-255,2902,333364,90,345104
2409,0.002546,172.31.47.0-255,66,333430,90,345104
2410,0.005009,74.125.200.0-255,1484,334914,90,345104
2411,0.005033,74.125.200.0-255,4320,339234,90,345104
2412,0.005038,172.31.47.0-255,66,339300,90,345104
2413,0.007535,74.125.200.0-255,5738,345038,90,345104
2414,0.00754,172.31.47.0-255,66,345104,90,345104
2415,0.0,74.125.68.0-255,153,153,90,374219
2416,3.5e-05,172.31.47.0-255,66,219,90,374219
2417,4.3e-05,74.125.68.0-255,1484,1703,90,374219
2418,4.8e-05,172.31.47.0-255,66,1769,90,374219
2419,5.2e-05,74.125.68.0-255,2902,4671,90,374219
2420,5.4e-05,172.31.47.0-255,66,4737,90,374219
2421,6e-05,74.125.68.0-255,5738,10475,90,374219
2422,6.3e-05,172.31.47.0-255,66,10541,90,374219
2423,0.000123,74.125.68.0-255,4320,14861,90,374219
2424,0.000127,172.31.47.0-255,66,14927,90,374219
2425,0.000148,74.125.68.0-255,2138,17065,90,374219
2426,0.000152,172.31.47.0-255,66,17131,90,374219
2427,0.00016,74.125.68.0-255,7156,24287,90,374219
2428,0.000162,172.31.47.0-255,66,24353,90,374219
2429,0.000171,74.125.68.0-255,6797,31150,90,374219
2430,0.000174,172.31.47.0-255,66,31216,90,374219
2431,0.000234,74.125.68.0-255,1484,32700,90,374219
2432,0.000238,172.31.47.0-255,66,32766,90,374219
2433,0.000259,74.125.68.0-255,2902,35668,90,374219
2434,0.000262,172.31.47.0-255,66,35734,90,374219
2435,0.000269,74.125.68.0-255,5738,41472,90,374219
2436,0.000271,172.31.47.0-255,66,41538,90,374219
2437,0.000274,74.125.68.0-255,1484,43022,90,374219
2438,0.000276,172.31.47.0-255,66,43088,90,374219
2439,0.000294,74.125.68.0-255,5379,48467,90,374219
2440,0.000297,172.31.47.0-255,66,48533,90,374219
2441,0.0003,74.125.68.0-255,1484,50017,90,374219
2442,0.000301,172.31.47.0-255,66,50083,90,374219
2443,0.000324,74.125.68.0-255,5738,55821,90,374219
2444,0.000327,172.31.47.0-255,66,55887,90,374219
2445,0.00033,74.125.68.0-255,1484,57371,90,374219
2446,0.000331,172.31.47.0-255,66,57437,90,374219
2447,0.000364,74.125.68.0-255,8490,65927,90,374219
2448,0.000369,74.125.68.0-255,130,66057,90,374219
2449,0.000371,172.31.47.0-255,66,66123,90,374219
2450,0.000434,74.125.68.0-255,1484,67607,90,374219
2451,0.00044,172.31.47.0-255,66,67673,90,374219
2452,0.000452,74.125.68.0-255,2902,70575,90,374219
2453,0.000456,172.31.47.0-255,66,70641,90,374219
2454,0.000475,74.125.68.0-255,5738,76379,90,374219
2455,0.00048,74.125.68.0-255,2902,79281,90,374219
2456,0.000487,172.31.47.0-255,66,79347,90,374219
2457,0.000497,74.125.68.0-255,2902,82249,90,374219
2458,0.0005,74.125.68.0-255,1484,83733,90,374219
2459,0.000502,172.31.47.0-255,66,83799,90,374219
2460,0.000527,74.125.68.0-255,5738,89537,90,374219
2461,0.000533,172.31.47.0-255,66,89603,90,374219
2462,0.000562,74.125.68.0-255,10692,100295,90,374219
2463,0.000565,74.125.68.0-255,349,100644,90,374219
2464,0.00057,172.31.47.0-255,66,100710,90,374219
2465,0.000698,74.125.68.0-255,1484,102194,90,374219
2466,0.000714,74.125.68.0-255,2902,105096,90,374219
2467,0.000725,172.31.47.0-255,66,105162,90,374219
2468,0.000732,74.125.68.0-255,5738,110900,90,374219
2469,0.000735,172.31.47.0-255,66,110966,90,374219
2470,0.00074,74.125.68.0-255,2902,113868,90,374219
2471,0.000742,74.125.68.0-255,1484,115352,90,374219
2472,0.000748,172.31.47.0-255,66,115418,90,374219
2473,0.000767,74.125.68.0-255,2902,118320,90,374219
2474,0.000772,74.125.68.0-255,2902,121222,90,374219
2475,0.000775,172.31.47.0-255,66,121288,90,374219
2476,0.000779,172.31.47.0-255,66,121354,90,374219
2477,0.000798,74.125.68.0-255,5738,127092,90,374219
2478,0.000805,74.125.68.0-255,7156,134248,90,374219
2479,0.000805,172.31.47.0-255,66,134314,90,374219
2480,0.000809,172.31.47.0-255,66,134380,90,374219
2481,0.000822,74.125.68.0-255,766,135146,90,374219
2482,0.000847,74.125.68.0-255,1484,136630,90,374219
2483,0.000854,172.31.47.0-255,66,136696,90,374219
2484,0.000873,74.125.68.0-255,4320,141016,90,374219
2485,0.00088,172.31.47.0-255,66,141082,90,374219
2486,0.000892,74.125.68.0-255,4320,145402,90,374219
2487,0.000906,74.125.68.0-255,4320,149722,90,374219
2488,0.000911,172.31.47.0-255,66,149788,90,374219
2489,0.000917,74.125.68.0-255,1484,151272,90,374219
2490,0.000939,74.125.68.0-255,5738,157010,90,374219
2491,0.00095,172.31.47.0-255,66,157076,90,374219
2492,0.000958,74.125.68.0-255,5738,162814,90,374219
2493,0.000961,172.31.47.0-255,66,162880,90,374219
2494,0.000966,74.125.68.0-255,4320,167200,90,374219
2495,0.000976,172.31.47.0-255,66,167266,90,374219
2496,0.001001,74.125.68.0-255,2184,169450,90,374219
2497,0.001011,172.31.47.0-255,66,169516,90,374219
2498,0.001018,74.125.68.0-255,2902,172418,90,374219
2499,0.001025,172.31.47.0-255,66,172484,90,374219
2500,0.001044,74.125.68.0-255,7156,179640,90,374219
2501,0.001049,74.125.68.0-255,2902,182542,90,374219
2502,0.00105,172.31.47.0-255,66,182608,90,374219
2503,0.001056,172.31.47.0-255,66,182674,90,374219
2504,0.001086,74.125.68.0-255,2902,185576,90,374219
2505,0.001099,172.31.47.0-255,66,185642,90,374219
2506,0.001114,74.125.68.0-255,8574,194216,90,374219
2507,0.001121,74.125.68.0-255,7156,201372,90,374219
2508,0.001125,172.31.47.0-255,66,201438,90,374219
2509,0.001155,74.125.68.0-255,2184,203622,90,374219
2510,0.001158,172.31.47.0-255,66,203688,90,374219
2511,0.001207,74.125.68.0-255,1484,205172,90,374219
2512,0.001221,74.125.68.0-255,2902,208074,90,374219
2513,0.001227,172.31.47.0-255,66,208140,90,374219
2514,0.001249,74.125.68.0-255,5738,213878,90,374219
2515,0.001253,172.31.47.0-255,66,213944,90,374219
2516,0.001302,74.125.68.0-255,7156,221100,90,374219
2517,0.001308,172.31.47.0-255,66,221166,90,374219
2518,0.00131,74.125.68.0-255,8574,229740,90,374219
2519,0.001315,74.125.68.0-255,4320,234060,90,374219
2520,0.001326,172.31.47.0-255,66,234126,90,374219
2521,0.001332,74.125.68.0-255,3602,237728,90,374219
2522,0.001338,172.31.47.0-255,66,237794,90,374219
2523,0.001418,74.125.68.0-255,1484,239278,90,374219
2524,0.001423,74.125.68.0-255,2902,242180,90,374219
2525,0.001426,172.31.47.0-255,66,242246,90,374219
2526,0.001438,74.125.68.0-255,1484,243730,90,374219
2527,0.001457,74.125.68.0-255,4320,248050,90,374219
2528,0.001461,74.125.68.0-255,2902,250952,90,374219
2529,0.001462,172.31.47.0-255,66,251018,90,374219
2530,0.001466,172.31.47.0-255,66,251084,90,374219
2531,0.001501,74.125.68.0-255,7156,258240,90,374219
2532,0.001527,74.125.68.0-255,2902,261142,90,374219
2533,0.001536,74.125.68.0-255,10692,271834,90,374219
2534,0.001599,74.125.68.0-255,1484,273318,90,374219
2535,0.001605,74.125.68.0-255,2902,276220,90,374219
2536,0.00161,74.125.68.0-255,5738,281958,90,374219
2537,0.001633,74.125.68.0-255,7156,289114,90,374219
2538,0.001665,74.125.68.0-255,4320,293434,90,374219
2539,0.00169,74.125.68.0-255,9992,303426,90,374219
2540,0.001706,74.125.68.0-255,1484,304910,90,374219
2541,0.001745,74.125.68.0-255,4320,309230,90,374219
2542,0.00177,74.125.68.0-255,5020,314250,90,374219
2543,0.001789,74.125.68.0-255,1484,315734,90,374219
2544,0.001804,74.125.68.0-255,4320,320054,90,374219
2545,0.001807,74.125.68.0-255,1484,321538,90,374219
2546,0.001827,74.125.68.0-255,5738,327276,90,374219
2547,0.001833,74.125.68.0-255,4320,331596,90,374219
2548,0.001848,74.125.68.0-255,4320,335916,90,374219
2549,0.001913,74.125.68.0-255,4320,340236,90,374219
2550,0.001929,74.125.68.0-255,4320,344556,90,374219
2551,0.001951,74.125.68.0-255,9992,354548,90,374219
2552,0.001966,74.125.68.0-255,2902,357450,90,374219
2553,0.001985,74.125.68.0-255,7156,364606,90,374219
2554,0.00204,74.125.68.0-255,9508,374114,90,374219
2555,0.002055,74.125.68.0-255,105,374219,90,374219
2556,0.0,172.31.47.0-255,105,105,90,105
2557,0.0,172.31.47.0-255,105,105,90,105
2558,0.0,74.125.24.0-255,153,153,90,275575
2559,3.2e-05,172.31.47.0-255,66,219,90,275575
2560,4.2e-05,74.125.24.0-255,1484,1703,90,275575
2561,6.4e-05,172.31.47.0-255,66,1769,90,275575
2562,7.2e-05,74.125.24.0-255,2902,4671,90,275575
2563,7.6e-05,172.31.47.0-255,66,4737,90,275575
2564,9.1e-05,74.125.24.0-255,7156,11893,90,275575
2565,9.4e-05,172.31.47.0-255,66,11959,90,275575
2566,9.9e-05,74.125.24.0-255,2139,14098,90,275575
2567,0.000102,172.31.47.0-255,66,14164,90,275575
2568,0.000121,172.31.47.0-255,66,14230,90,275575
2569,0.00013,74.125.24.0-255,5379,19609,90,275575
2570,0.000135,172.31.47.0-255,66,19675,90,275575
2571,0.000165,74.125.24.0-255,1484,21159,90,275575
2572,0.000175,172.31.47.0-255,66,21225,90,275575
2573,0.000182,74.125.24.0-255,2902,24127,90,275575
2574,0.000185,172.31.47.0-255,66,24193,90,275575
2575,0.000222,74.125.24.0-255,1484,25677,90,275575
2576,0.000227,172.31.47.0-255,66,25743,90,275575
2577,0.000237,74.125.24.0-255,2902,28645,90,275575
2578,0.000241,172.31.47.0-255,66,28711,90,275575
2579,0.00025,74.125.24.0-255,5738,34449,90,275575
2580,0.000253,172.31.47.0-255,66,34515,90,275575
2581,0.000258,74.125.24.0-255,2543,37058,90,275575
2582,0.00026,172.31.47.0-255,66,37124,90,275575
2583,0.000385,74.125.24.0-255,1484,38608,90,275575
2584,0.00039,172.31.47.0-255,66,38674,90,275575
2585,0.000398,74.125.24.0-255,2902,41576,90,275575
2586,0.000402,172.31.47.0-255,66,41642,90,275575
2587,0.000416,74.125.24.0-255,5738,47380,90,275575
2588,0.00042,172.31.47.0-255,66,47446,90,275575
2589,0.000486,74.125.24.0-255,7156,54602,90,275575
2590,0.000511,74.125.24.0-255,3123,57725,90,275575
2591,0.000519,74.125.24.0-255,4320,62045,90,275575
2592,0.00056,74.125.24.0-255,9992,72037,90,275575
2593,0.000565,74.125.24.0-255,2543,74580,90,275575
2594,0.000611,74.125.24.0-255,1876,76456,90,275575
2595,0.000684,74.125.24.0-255,5738,82194,90,275575
2596,0.000709,74.125.24.0-255,2902,85096,90,275575
2597,0.000728,74.125.24.0-255,8913,94009,90,275575
2598,0.000758,74.125.24.0-255,1484,95493,90,275575
2599,0.000766,74.125.24.0-255,2902,98395,90,275575
2600,0.000775,74.125.24.0-255,5738,104133,90,275575
2601,0.000829,74.125.24.0-255,1484,105617,90,275575
2602,0.000851,74.125.24.0-255,1484,107101,90,275575
2603,0.000887,74.125.24.0-255,7856,114957,90,275575
2604,0.000919,74.125.24.0-255,8574,123531,90,275575
2605,0.000932,74.125.24.0-255,9992,133523,90,275575
2606,0.000995,74.125.24.0-255,3602,137125,90,275575
2607,0.001118,74.125.24.0-255,1484,138609,90,275575
2608,0.001125,74.125.24.0-255,2902,141511,90,275575
2609,0.001138,172.31.47.0-255,66,141577,90,275575
2610,0.001157,74.125.24.0-255,5738,147315,90,275575
2611,0.001196,74.125.24.0-255,7156,154471,90,275575
2612,0.001215,74.125.24.0-255,3602,158073,90,275575
2613,0.001234,172.31.47.0-255,66,158139,90,275575
2614,0.00169,74.125.24.0-255,1484,159623,90,275575
2615,0.001718,74.125.24.0-255,2902,162525,90,275575
2616,0.001727,74.125.24.0-255,5738,168263,90,275575
2617,0.001738,74.125.24.0-255,7156,175419,90,275575
2618,0.001764,74.125.24.0-255,1484,176903,90,275575
2619,0.001779,172.31.47.0-255,66,176969,90,275575
2620,0.001821,74.125.24.0-255,2184,179153,90,275575
2621,0.001839,172.31.47.0-255,66,179219,90,275575
2622,0.002014,74.125.24.0-255,1484,180703,90,275575
2623,0.002024,74.125.24.0-255,2902,183605,90,275575
2624,0.002031,74.125.24.0-255,2902,186507,90,275575
2625,0.002044,172.31.47.0-255,66,186573,90,275575
2626,0.002067,74.125.24.0-255,7156,193729,90,275575
2627,0.002082,74.125.24.0-255,8574,202303,90,275575
2628,0.00211,74.125.24.0-255,7156,209459,90,275575
2629,0.002116,74.125.24.0-255,2902,212361,90,275575
2630,0.002119,74.125.24.0-255,766,213127,90,275575
2631,0.002195,172.31.47.0-255,66,213193,90,275575
2632,0.002232,74.125.24.0-255,1484,214677,90,275575
2633,0.002252,74.125.24.0-255,2902,217579,90,275575
2634,0.002261,74.125.24.0-255,5738,223317,90,275575
2635,0.002306,74.125.24.0-255,7156,230473,90,275575
2636,0.002312,172.31.47.0-255,66,230539,90,275575
2637,0.002335,74.125.24.0-255,3602,234141,90,275575
2638,0.002377,74.125.24.0-255,1484,235625,90,275575
2639,0.002397,74.125.24.0-255,2902,238527,90,275575
2640,0.002427,74.125.24.0-255,5738,244265,90,275575
2641,0.002448,74.125.24.0-255,7156,251421,90,275575
2642,0.002472,74.125.24.0-255,1484,252905,90,275575
2643,0.002486,74.125.24.0-255,9992,262897,90,275575
2644,0.002561,74.125.24.0-255,10692,273589,90,275575
2645,0.0026,74.125.24.0-255,1881,275470,90,275575
2646,0.002615,74.125.24.0-255,105,275575,90,275575
2647,0.0,172.217.194.0-255,143,143,90,177814
2648,3.5e-05,172.31.47.0-255,66,209,90,177814
2649,4.2e-05,172.217.194.0-255,1484,1693,90,177814
2650,4.7e-05,172.31.47.0-255,66,1759,90,177814
2651,5.2e-05,172.217.194.0-255,2902,4661,90,177814
2652,6.1e-05,172.31.47.0-255,66,4727,90,177814
2653,6.9e-05,172.217.194.0-255,7156,11883,90,177814
2654,7.2e-05,172.31.47.0-255,66,11949,90,177814
2655,8e-05,172.217.194.0-255,9146,21095,90,177814
2656,8.3e-05,172.31.47.0-255,66,21161,90,177814
2657,0.000132,172.217.194.0-255,9633,30794,90,177814
2658,0.000136,172.31.47.0-255,66,30860,90,177814
2659,0.000289,172.217.194.0-255,1484,32344,90,177814
2660,0.000294,172.31.47.0-255,66,32410,90,177814
2661,0.0003,172.217.194.0-255,2902,35312,90,177814
2662,0.000302,172.31.47.0-255,66,35378,90,177814
2663,0.000315,172.217.194.0-255,5738,41116,90,177814
2664,0.000319,172.31.47.0-255,66,41182,90,177814
2665,0.000322,172.217.194.0-255,1484,42666,90,177814
2666,0.000324,172.31.47.0-255,66,42732,90,177814
2667,0.000358,172.217.194.0-255,5379,48111,90,177814
2668,0.000363,172.31.47.0-255,66,48177,90,177814
2669,0.000513,172.217.194.0-255,1484,49661,90,177814
2670,0.000517,172.31.47.0-255,66,49727,90,177814
2671,0.000523,172.217.194.0-255,2902,52629,90,177814
2672,0.000525,172.31.47.0-255,66,52695,90,177814
2673,0.000534,172.217.194.0-255,1484,54179,90,177814
2674,0.000537,172.31.47.0-255,66,54245,90,177814
2675,0.000565,172.217.194.0-255,4320,58565,90,177814
2676,0.000574,172.31.47.0-255,66,58631,90,177814
2677,0.000583,172.217.194.0-255,5738,64369,90,177814
2678,0.000586,172.31.47.0-255,66,64435,90,177814
2679,0.000612,172.217.194.0-255,1125,65560,90,177814
2680,0.000787,172.31.47.0-255,66,65626,90,177814
2681,0.00083,172.217.194.0-255,645,66271,90,177814
2682,0.000844,172.31.47.0-255,66,66337,90,177814
2683,0.001729,172.217.194.0-255,1484,67821,90,177814
2684,0.001737,172.217.194.0-255,2902,70723,90,177814
2685,0.001741,172.31.47.0-255,66,70789,90,177814
2686,0.001745,172.217.194.0-255,1484,72273,90,177814
2687,0.001767,172.217.194.0-255,2902,75175,90,177814
2688,0.001769,172.31.47.0-255,66,75241,90,177814
2689,0.001775,172.217.194.0-255,5738,80979,90,177814
2690,0.001776,172.31.47.0-255,66,81045,90,177814
2691,0.001779,172.217.194.0-255,1484,82529,90,177814
2692,0.001812,172.217.194.0-255,9992,92521,90,177814
2693,0.001814,172.31.47.0-255,66,92587,90,177814
2694,0.001822,172.217.194.0-255,7856,100443,90,177814
2695,0.001823,172.31.47.0-255,66,100509,90,177814
2696,0.001965,172.217.194.0-255,1484,101993,90,177814
2697,0.001974,172.217.194.0-255,1484,103477,90,177814
2698,0.001976,172.31.47.0-255,66,103543,90,177814
2699,0.001996,172.217.194.0-255,1484,105027,90,177814
2700,0.001999,172.217.194.0-255,1484,106511,90,177814
2701,0.002,172.31.47.0-255,66,106577,90,177814
2702,0.002022,172.217.194.0-255,4320,110897,90,177814
2703,0.002024,172.31.47.0-255,66,110963,90,177814
2704,0.002035,172.31.47.0-255,66,111029,90,177814
2705,0.002063,172.217.194.0-255,1995,113024,90,177814
2706,0.002065,172.31.47.0-255,66,113090,90,177814
2707,0.002083,172.31.47.0-255,66,113156,90,177814
2708,0.00209,172.217.194.0-255,9274,122430,90,177814
2709,0.002092,172.31.47.0-255,66,122496,90,177814
2710,0.002174,172.217.194.0-255,1484,123980,90,177814
2711,0.002178,172.217.194.0-255,2902,126882,90,177814
2712,0.00218,172.31.47.0-255,66,126948,90,177814
2713,0.002203,172.217.194.0-255,5738,132686,90,177814
2714,0.002205,172.31.47.0-255,66,132752,90,177814
2715,0.002211,172.217.194.0-255,7156,139908,90,177814
2716,0.002213,172.31.47.0-255,66,139974,90,177814
2717,0.002246,172.31.47.0-255,66,140040,90,177814
2718,0.002272,172.217.194.0-255,8574,148614,90,177814
2719,0.002274,172.31.47.0-255,66,148680,90,177814
2720,0.002302,172.217.194.0-255,5020,153700,90,177814
2721,0.002304,172.31.47.0-255,66,153766,90,177814
2722,0.002316,172.31.47.0-255,66,153832,90,177814
2723,0.002326,172.217.194.0-255,7856,161688,90,177814
2724,0.002328,172.31.47.0-255,66,161754,90,177814
2725,0.004628,172.217.194.0-255,4320,166074,90,177814
2726,0.004631,172.31.47.0-255,66,166140,90,177814
2727,0.004652,172.217.194.0-255,1484,167624,90,177814
2728,0.006915,172.217.194.0-255,4320,171944,90,177814
2729,0.00692,172.31.47.0-255,66,172010,90,177814
2730,0.009236,172.217.194.0-255,5738,177748,90,177814
2731,0.009244,172.31.47.0-255,66,177814,90,177814
2732,0.0,74.125.200.0-255,153,153,90,174969
2733,3.4e-05,172.31.47.0-255,66,219,90,174969
2734,4.1e-05,74.125.200.0-255,1484,1703,90,174969
2735,4.6e-05,172.31.47.0-255,66,1769,90,174969
2736,6e-05,74.125.200.0-255,2902,4671,90,174969
2737,6.4e-05,172.31.47.0-255,66,4737,90,174969
2738,7.1e-05,74.125.200.0-255,7156,11893,90,174969
2739,7.4e-05,172.31.47.0-255,66,11959,90,174969
2740,0.000103,74.125.200.0-255,2053,14012,90,174969
2741,0.000106,172.31.47.0-255,66,14078,90,174969
2742,0.00054,74.125.200.0-255,1484,15562,90,174969
2743,0.000546,172.31.47.0-255,66,15628,90,174969
2744,0.00057,74.125.200.0-255,2902,18530,90,174969
2745,0.000573,172.31.47.0-255,66,18596,90,174969
2746,0.000602,74.125.200.0-255,5738,24334,90,174969
2747,0.000606,172.31.47.0-255,66,24400,90,174969
2748,0.000611,74.125.200.0-255,4320,28720,90,174969
2749,0.000613,172.31.47.0-255,66,28786,90,174969
2750,0.000649,74.125.200.0-255,2543,31329,90,174969
2751,0.000654,172.31.47.0-255,66,31395,90,174969
2752,0.000827,74.125.200.0-255,1484,32879,90,174969
2753,0.000832,172.31.47.0-255,66,32945,90,174969
2754,0.000856,74.125.200.0-255,2902,35847,90,174969
2755,0.00086,172.31.47.0-255,66,35913,90,174969
2756,0.000865,74.125.200.0-255,4320,40233,90,174969
2757,0.000867,172.31.47.0-255,66,40299,90,174969
2758,0.000915,74.125.200.0-255,8215,48514,90,174969
2759,0.000919,172.31.47.0-255,66,48580,90,174969
2760,0.000928,74.125.200.0-255,8574,57154,90,174969
2761,0.000938,172.31.47.0-255,66,57220,90,174969
2762,0.000948,74.125.200.0-255,7156,64376,90,174969
2763,0.000951,172.31.47.0-255,66,64442,90,174969
2764,0.001005,74.125.200.0-255,1437,65879,90,174969
2765,0.001009,74.125.200.0-255,374,66253,90,174969
2766,0.001012,172.31.47.0-255,66,66319,90,174969
2767,0.001275,74.125.200.0-255,1484,67803,90,174969
2768,0.001285,74.125.200.0-255,2902,70705,90,174969
2769,0.001289,172.31.47.0-255,66,70771,90,174969
2770,0.001318,74.125.200.0-255,5738,76509,90,174969
2771,0.00132,172.31.47.0-255,66,76575,90,174969
2772,0.001328,74.125.200.0-255,7156,83731,90,174969
2773,0.00133,172.31.47.0-255,66,83797,90,174969
2774,0.001372,74.125.200.0-255,2902,86699,90,174969
2775,0.001374,172.31.47.0-255,66,86765,90,174969
2776,0.00141,172.31.47.0-255,66,86831,90,174969
2777,0.001414,74.125.200.0-255,2184,89015,90,174969
2778,0.001416,172.31.47.0-255,66,89081,90,174969
2779,0.001685,74.125.200.0-255,1484,90565,90,174969
2780,0.001689,74.125.200.0-255,1484,92049,90,174969
2781,0.001691,172.31.47.0-255,66,92115,90,174969
2782,0.001714,74.125.200.0-255,1484,93599,90,174969
2783,0.001729,74.125.200.0-255,2902,96501,90,174969
2784,0.001732,172.31.47.0-255,66,96567,90,174969
2785,0.001738,74.125.200.0-255,4320,100887,90,174969
2786,0.00174,172.31.47.0-255,66,100953,90,174969
2787,0.001744,74.125.200.0-255,2902,103855,90,174969
2788,0.001751,172.31.47.0-255,66,103921,90,174969
2789,0.001779,74.125.200.0-255,5738,109659,90,174969
2790,0.001785,172.31.47.0-255,66,109725,90,174969
2791,0.001793,74.125.200.0-255,7156,116881,90,174969
2792,0.001795,172.31.47.0-255,66,116947,90,174969
2793,0.001834,74.125.200.0-255,6438,123385,90,174969
2794,0.001837,172.31.47.0-255,66,123451,90,174969
2795,0.001913,74.125.200.0-255,1484,124935,90,174969
2796,0.001925,74.125.200.0-255,2902,127837,90,174969
2797,0.001928,172.31.47.0-255,66,127903,90,174969
2798,0.001957,74.125.200.0-255,5738,133641,90,174969
2799,0.00196,172.31.47.0-255,66,133707,90,174969
2800,0.001989,74.125.200.0-255,7156,140863,90,174969
2801,0.001992,172.31.47.0-255,66,140929,90,174969
2802,0.002,74.125.200.0-255,8574,149503,90,174969
2803,0.002004,172.31.47.0-255,66,149569,90,174969
2804,0.002006,74.125.200.0-255,1484,151053,90,174969
2805,0.002039,74.125.200.0-255,6438,157491,90,174969
2806,0.002042,172.31.47.0-255,66,157557,90,174969
2807,0.004043,74.125.200.0-255,5738,163295,90,174969
2808,0.004047,172.31.47.0-255,66,163361,90,174969
2809,0.006058,74.125.200.0-255,5738,169099,90,174969
2810,0.006064,172.31.47.0-255,66,169165,90,174969
2811,0.008069,74.125.200.0-255,5738,174903,90,174969
2812,0.008076,172.31.47.0-255,66,174969,90,174969
2813,0.0,74.125.24.0-255,146,146,90,230130
2814,2.9e-05,172.31.47.0-255,66,212,90,230130
2815,3.5e-05,74.125.24.0-255,1484,1696,90,230130
2816,3.9e-05,172.31.47.0-255,66,1762,90,230130
2817,4.3e-05,74.125.24.0-255,2902,4664,90,230130
2818,4.6e-05,172.31.47.0-255,66,4730,90,230130
2819,5.1e-05,74.125.24.0-255,5738,10468,90,230130
2820,5.4e-05,172.31.47.0-255,66,10534,90,230130
2821,8.3e-05,74.125.24.0-255,5738,16272,90,230130
2822,8.7e-05,172.31.47.0-255,66,16338,90,230130
2823,0.000114,74.125.24.0-255,715,17053,90,230130
2824,0.000117,172.31.47.0-255,66,17119,90,230130
2825,0.000129,172.31.47.0-255,66,17185,90,230130
2826,0.000131,74.125.24.0-255,1125,18310,90,230130
2827,0.000133,172.31.47.0-255,66,18376,90,230130
2828,0.000179,74.125.24.0-255,1484,19860,90,230130
2829,0.000183,172.31.47.0-255,66,19926,90,230130
2830,0.000186,74.125.24.0-255,1484,21410,90,230130
2831,0.000188,172.31.47.0-255,66,21476,90,230130
2832,0.000203,74.125.24.0-255,1484,22960,90,230130
2833,0.000205,172.31.47.0-255,66,23026,90,230130
2834,0.00021,74.125.24.0-255,4320,27346,90,230130
2835,0.000212,172.31.47.0-255,66,27412,90,230130
2836,0.000227,74.125.24.0-255,1484,28896,90,230130
2837,0.000229,172.31.47.0-255,66,28962,90,230130
2838,0.000235,74.125.24.0-255,4320,33282,90,230130
2839,0.000237,172.31.47.0-255,66,33348,90,230130
2840,0.000264,74.125.24.0-255,5379,38727,90,230130
2841,0.000268,172.31.47.0-255,66,38793,90,230130
2842,0.000275,74.125.24.0-255,8574,47367,90,230130
2843,0.000277,172.31.47.0-255,66,47433,90,230130
2844,0.0003,74.125.24.0-255,1484,48917,90,230130
2845,0.000302,172.31.47.0-255,66,48983,90,230130
2846,0.000307,74.125.24.0-255,3961,52944,90,230130
2847,0.000309,172.31.47.0-255,66,53010,90,230130
2848,0.000613,74.125.24.0-255,396,53406,90,230130
2849,0.000618,172.31.47.0-255,66,53472,90,230130
2850,0.000809,74.125.24.0-255,1484,54956,90,230130
2851,0.000813,172.31.47.0-255,66,55022,90,230130
2852,0.000821,74.125.24.0-255,2902,57924,90,230130
2853,0.000823,172.31.47.0-255,66,57990,90,230130
2854,0.000846,74.125.24.0-255,5738,63728,90,230130
2855,0.000849,172.31.47.0-255,66,63794,90,230130
2856,0.000852,74.125.24.0-255,1484,65278,90,230130
2857,0.000872,74.125.24.0-255,1484,66762,90,230130
2858,0.000905,74.125.24.0-255,4320,71082,90,230130
2859,0.000929,74.125.24.0-255,3662,74744,90,230130
2860,0.001076,74.125.24.0-255,1484,76228,90,230130
2861,0.001093,74.125.24.0-255,2902,79130,90,230130
2862,0.001099,74.125.24.0-255,5738,84868,90,230130
2863,0.001136,74.125.24.0-255,9992,94860,90,230130
2864,0.001151,74.125.24.0-255,1484,96344,90,230130
2865,0.001156,74.125.24.0-255,2902,99246,90,230130
2866,0.001173,74.125.24.0-255,7156,106402,90,230130
2867,0.001192,74.125.24.0-255,2184,108586,90,230130
2868,0.001345,172.31.47.0-255,66,108652,90,230130
2869,0.001423,74.125.24.0-255,1484,110136,90,230130
2870,0.001431,74.125.24.0-255,2902,113038,90,230130
2871,0.001437,74.125.24.0-255,5738,118776,90,230130
2872,0.001452,172.31.47.0-255,66,118842,90,230130
2873,0.001458,74.125.24.0-255,4320,123162,90,230130
2874,0.001462,172.31.47.0-255,66,123228,90,230130
2875,0.001474,74.125.24.0-255,5738,128966,90,230130
2876,0.001492,74.125.24.0-255,2902,131868,90,230130
2877,0.001499,172.31.47.0-255,66,131934,90,230130
2878,0.001514,74.125.24.0-255,4320,136254,90,230130
2879,0.001532,74.125.24.0-255,6438,142692,90,230130
2880,0.001539,172.31.47.0-255,66,142758,90,230130
2881,0.001571,74.125.24.0-255,1484,144242,90,230130
2882,0.001591,74.125.24.0-255,2902,147144,90,230130
2883,0.001602,74.125.24.0-255,1484,148628,90,230130
2884,0.001616,74.125.24.0-255,4320,152948,90,230130
2885,0.001619,172.31.47.0-255,66,153014,90,230130
2886,0.001628,172.31.47.0-255,66,153080,90,230130
2887,0.001657,74.125.24.0-255,8574,161654,90,230130
2888,0.001669,172.31.47.0-255,66,161720,90,230130
2889,0.001674,74.125.24.0-255,4320,166040,90,230130
2890,0.001682,74.125.24.0-255,10692,176732,90,230130
2891,0.001721,172.31.47.0-255,66,176798,90,230130
2892,0.001765,74.125.24.0-255,1484,178282,90,230130
2893,0.001779,74.125.24.0-255,1484,179766,90,230130
2894,0.001792,172.31.47.0-255,66,179832,90,230130
2895,0.0018,74.125.24.0-255,1484,181316,90,230130
2896,0.001805,74.125.24.0-255,5738,187054,90,230130
2897,0.00181,172.31.47.0-255,66,187120,90,230130
2898,0.001841,74.125.24.0-255,4320,191440,90,230130
2899,0.001847,172.31.47.0-255,66,191506,90,230130
2900,0.001875,74.125.24.0-255,2902,194408,90,230130
2901,0.001888,74.125.24.0-255,3602,198010,90,230130
2902,0.001893,172.31.47.0-255,66,198076,90,230130
2903,0.00201,74.125.24.0-255,1484,199560,90,230130
2904,0.002025,74.125.24.0-255,2902,202462,90,230130
2905,0.002039,172.31.47.0-255,66,202528,90,230130
2906,0.002046,74.125.24.0-255,1484,204012,90,230130
2907,0.002059,74.125.24.0-255,4320,208332,90,230130
2908,0.002061,74.125.24.0-255,1484,209816,90,230130
2909,0.002079,74.125.24.0-255,2902,212718,90,230130
2910,0.002084,172.31.47.0-255,66,212784,90,230130
2911,0.004083,74.125.24.0-255,5738,218522,90,230130
2912,0.004087,172.31.47.0-255,66,218588,90,230130
2913,0.006098,74.125.24.0-255,5738,224326,90,230130
2914,0.006105,172.31.47.0-255,66,224392,90,230130
2915,0.008126,74.125.24.0-255,5738,230130,90,230130
2916,0.0,172.31.47.0-255,66,66,90,66
2917,0.0,172.217.194.0-255,153,153,90,354129
2918,2.3e-05,172.31.47.0-255,66,219,90,354129
2919,3e-05,172.217.194.0-255,1484,1703,90,354129
2920,3.4e-05,172.31.47.0-255,66,1769,90,354129
2921,4e-05,172.217.194.0-255,2902,4671,90,354129
2922,4.3e-05,172.31.47.0-255,66,4737,90,354129
2923,5e-05,172.217.194.0-255,7156,11893,90,354129
2924,5.4e-05,172.31.47.0-255,66,11959,90,354129
2925,5.8e-05,172.217.194.0-255,2110,14069,90,354129
2926,6e-05,172.31.47.0-255,66,14135,90,354129
2927,8.7e-05,172.217.194.0-255,9992,24127,90,354129
2928,9e-05,172.31.47.0-255,66,24193,90,354129
2929,0.00011,172.217.194.0-255,1484,25677,90,354129
2930,0.000112,172.31.47.0-255,66,25743,90,354129
2931,0.000127,172.31.47.0-255,66,25809,90,354129
2932,0.00018,172.217.194.0-255,9274,35083,90,354129
2933,0.000183,172.31.47.0-255,66,35149,90,354129
2934,0.000186,172.217.194.0-255,1484,36633,90,354129
2935,0.000187,172.31.47.0-255,66,36699,90,354129
2936,0.000213,172.217.194.0-255,8574,45273,90,354129
2937,0.000216,172.31.47.0-255,66,45339,90,354129
2938,0.000224,172.217.194.0-255,7386,52725,90,354129
2939,0.000226,172.31.47.0-255,66,52791,90,354129
2940,0.000246,172.217.194.0-255,1484,54275,90,354129
2941,0.000248,172.31.47.0-255,66,54341,90,354129
2942,0.000252,172.217.194.0-255,1484,55825,90,354129
2943,0.000253,172.31.47.0-255,66,55891,90,354129
2944,0.000267,172.217.194.0-255,1484,57375,90,354129
2945,0.00027,172.31.47.0-255,66,57441,90,354129
2946,0.000276,172.217.194.0-255,5738,63179,90,354129
2947,0.000278,172.31.47.0-255,66,63245,90,354129
2948,0.000295,172.217.194.0-255,4320,67565,90,354129
2949,0.000298,172.31.47.0-255,66,67631,90,354129
2950,0.000311,172.217.194.0-255,5738,73369,90,354129
2951,0.000314,172.31.47.0-255,66,73435,90,354129
2952,0.000317,172.217.194.0-255,1484,74919,90,354129
2953,0.000344,172.217.194.0-255,9992,84911,90,354129
2954,0.000346,172.31.47.0-255,66,84977,90,354129
2955,0.000353,172.217.194.0-255,7856,92833,90,354129
2956,0.000356,172.31.47.0-255,66,92899,90,354129
2957,0.000383,172.217.194.0-255,4320,97219,90,354129
2958,0.000386,172.31.47.0-255,66,97285,90,354129
2959,0.000412,172.31.47.0-255,66,97351,90,354129
2960,0.000435,172.217.194.0-255,4320,101671,90,354129
2961,0.000438,172.31.47.0-255,66,101737,90,354129
2962,0.000445,172.217.194.0-255,5889,107626,90,354129
2963,0.000448,172.31.47.0-255,66,107692,90,354129
2964,0.000517,172.217.194.0-255,1484,109176,90,354129
2965,0.000522,172.217.194.0-255,2902,112078,90,354129
2966,0.000525,172.31.47.0-255,66,112144,90,354129
2967,0.000562,172.217.194.0-255,1484,113628,90,354129
2968,0.000577,172.217.194.0-255,4320,117948,90,354129
2969,0.00058,172.31.47.0-255,66,118014,90,354129
2970,0.000587,172.217.194.0-255,7156,125170,90,354129
2971,0.000589,172.31.47.0-255,66,125236,90,354129
2972,0.000597,172.217.194.0-255,8574,133810,90,354129
2973,0.0006,172.31.47.0-255,66,133876,90,354129
2974,0.000623,172.217.194.0-255,5738,139614,90,354129
2975,0.000626,172.31.47.0-255,66,139680,90,354129
2976,0.00063,172.217.194.0-255,2184,141864,90,354129
2977,0.000633,172.31.47.0-255,66,141930,90,354129
2978,0.000678,172.217.194.0-255,1484,143414,90,354129
2979,0.000694,172.217.194.0-255,2902,146316,90,354129
2980,0.000697,172.31.47.0-255,66,146382,90,354129
2981,0.000713,172.217.194.0-255,1484,147866,90,354129
2982,0.000746,172.217.194.0-255,4320,152186,90,354129
2983,0.000749,172.31.47.0-255,66,152252,90,354129
2984,0.000757,172.217.194.0-255,5738,157990,90,354129
2985,0.000759,172.31.47.0-255,66,158056,90,354129
2986,0.000776,172.217.194.0-255,5738,163794,90,354129
2987,0.000779,172.31.47.0-255,66,163860,90,354129
2988,0.000792,172.217.194.0-255,1484,165344,90,354129
2989,0.000811,172.217.194.0-255,4320,169664,90,354129
2990,0.000814,172.31.47.0-255,66,169730,90,354129
2991,0.00083,172.217.194.0-255,6438,176168,90,354129
2992,0.000832,172.31.47.0-255,66,176234,90,354129
2993,0.00089,172.217.194.0-255,1484,177718,90,354129
2994,0.000896,172.217.194.0-255,2902,180620,90,354129
2995,0.000898,172.31.47.0-255,66,180686,90,354129
2996,0.000904,172.217.194.0-255,4320,185006,90,354129
2997,0.000907,172.31.47.0-255,66,185072,90,354129
2998,0.000921,172.217.194.0-255,1484,186556,90,354129
2999,0.000928,172.217.194.0-255,5738,192294,90,354129
3000,0.00093,172.31.47.0-255,66,192360,90,354129
3001,0.00096,172.217.194.0-255,7156,199516,90,354129
3002,0.000963,172.31.47.0-255,66,199582,90,354129
3003,0.000971,172.217.194.0-255,8574,208156,90,354129
3004,0.000974,172.31.47.0-255,66,208222,90,354129
3005,0.000989,172.217.194.0-255,2184,210406,90,354129
3006,0.000992,172.31.47.0-255,66,210472,90,354129
3007,0.001192,172.217.194.0-255,1484,211956,90,354129
3008,0.001198,172.217.194.0-255,2902,214858,90,354129
3009,0.001202,172.31.47.0-255,66,214924,90,354129
3010,0.001207,172.217.194.0-255,2902,217826,90,354129
3011,0.001209,172.31.47.0-255,66,217892,90,354129
3012,0.001223,172.217.194.0-255,2902,220794,90,354129
3013,0.001226,172.31.47.0-255,66,220860,90,354129
3014,0.001232,172.217.194.0-255,4320,225180,90,354129
3015,0.001234,172.31.47.0-255,66,225246,90,354129
3016,0.001273,172.217.194.0-255,8574,233820,90,354129
3017,0.001277,172.31.47.0-255,66,233886,90,354129
3018,0.001286,172.217.194.0-255,10692,244578,90,354129
3019,0.001288,172.31.47.0-255,66,244644,90,354129
3020,0.001318,172.217.194.0-255,9992,254636,90,354129
3021,0.001321,172.31.47.0-255,66,254702,90,354129
3022,0.001341,172.217.194.0-255,1484,256186,90,354129
3023,0.001356,172.31.47.0-255,66,256252,90,354129
3024,0.001368,172.217.194.0-255,1484,257736,90,354129
3025,0.001384,172.217.194.0-255,5738,263474,90,354129
3026,0.001386,172.31.47.0-255,66,263540,90,354129
3027,0.001405,172.217.194.0-255,2184,265724,90,354129
3028,0.001408,172.31.47.0-255,66,265790,90,354129
3029,0.001418,172.217.194.0-255,9992,275782,90,354129
3030,0.00142,172.31.47.0-255,66,275848,90,354129
3031,0.001465,172.31.47.0-255,66,275914,90,354129
3032,0.001481,172.217.194.0-255,5738,281652,90,354129
3033,0.001483,172.31.47.0-255,66,281718,90,354129
3034,0.00149,172.217.194.0-255,6438,288156,90,354129
3035,0.001493,172.31.47.0-255,66,288222,90,354129
3036,0.001511,172.217.194.0-255,2902,291124,90,354129
3037,0.001513,172.31.47.0-255,66,291190,90,354129
3038,0.001528,172.217.194.0-255,1484,292674,90,354129
3039,0.001535,172.217.194.0-255,5738,298412,90,354129
3040,0.001538,172.31.47.0-255,66,298478,90,354129
3041,0.001541,172.217.194.0-255,1484,299962,90,354129
3042,0.001564,172.217.194.0-255,9992,309954,90,354129
3043,0.001566,172.31.47.0-255,66,310020,90,354129
3044,0.001573,172.217.194.0-255,5738,315758,90,354129
3045,0.001576,172.31.47.0-255,66,315824,90,354129
3046,0.001607,172.217.194.0-255,6438,322262,90,354129
3047,0.001611,172.31.47.0-255,66,322328,90,354129
3048,0.001661,172.217.194.0-255,1484,323812,90,354129
3049,0.001666,172.217.194.0-255,2902,326714,90,354129
3050,0.001669,172.31.47.0-255,66,326780,90,354129
3051,0.001675,172.217.194.0-255,5738,332518,90,354129
3052,0.001678,172.31.47.0-255,66,332584,90,354129
3053,0.001687,172.217.194.0-255,9992,342576,90,354129
3054,0.00169,172.31.47.0-255,66,342642,90,354129
3055,0.001716,172.217.194.0-255,2902,345544,90,354129
3056,0.001718,172.31.47.0-255,66,345610,90,354129
3057,0.001745,172.217.194.0-255,8111,353721,90,354129
3058,0.001748,172.31.47.0-255,66,353787,90,354129
3059,0.001751,172.217.194.0-255,105,353892,90,354129
3060,0.004511,172.31.47.0-255,66,353958,90,354129
3061,0.004549,172.31.47.0-255,105,354063,90,354129
3062,0.006836,172.217.194.0-255,66,354129,90,354129
3063,0.0,172.31.47.0-255,105,105,90,105
3064,0.0,172.31.47.0-255,66,66,90,66
3065,0.0,74.125.24.0-255,143,143,90,232001
3066,2.7e-05,172.31.47.0-255,66,209,90,232001
3067,3.3e-05,74.125.24.0-255,1484,1693,90,232001
3068,3.8e-05,172.31.47.0-255,66,1759,90,232001
3069,4.3e-05,74.125.24.0-255,2902,4661,90,232001
3070,5.2e-05,172.31.47.0-255,66,4727,90,232001
3071,5.9e-05,74.125.24.0-255,7156,11883,90,232001
3072,6.2e-05,172.31.47.0-255,66,11949,90,232001
3073,8.8e-05,74.125.24.0-255,2209,14158,90,232001
3074,9.1e-05,172.31.47.0-255,66,14224,90,232001
3075,0.000116,74.125.24.0-255,2902,17126,90,232001
3076,0.000119,172.31.47.0-255,66,17192,90,232001
3077,0.000122,74.125.24.0-255,1484,18676,90,232001
3078,0.000125,172.31.47.0-255,66,18742,90,232001
3079,0.000158,74.125.24.0-255,5738,24480,90,232001
3080,0.000163,172.31.47.0-255,66,24546,90,232001
3081,0.00017,74.125.24.0-255,4320,28866,90,232001
3082,0.000172,172.31.47.0-255,66,28932,90,232001
3083,0.00019,74.125.24.0-255,2543,31475,90,232001
3084,0.000193,172.31.47.0-255,66,31541,90,232001
3085,0.00028,74.125.24.0-255,1484,33025,90,232001
3086,0.000285,172.31.47.0-255,66,33091,90,232001
3087,0.000291,74.125.24.0-255,2902,35993,90,232001
3088,0.000293,172.31.47.0-255,66,36059,90,232001
3089,0.000302,74.125.24.0-255,1484,37543,90,232001
3090,0.000306,172.31.47.0-255,66,37609,90,232001
3091,0.000329,74.125.24.0-255,4320,41929,90,232001
3092,0.000332,172.31.47.0-255,66,41995,90,232001
3093,0.000358,74.125.24.0-255,8574,50569,90,232001
3094,0.000362,172.31.47.0-255,66,50635,90,232001
3095,0.000389,74.125.24.0-255,5379,56014,90,232001
3096,0.000393,172.31.47.0-255,66,56080,90,232001
3097,0.0004,74.125.24.0-255,7156,63236,90,232001
3098,0.000404,172.31.47.0-255,66,63302,90,232001
3099,0.000407,74.125.24.0-255,2543,65845,90,232001
3100,0.00041,172.31.47.0-255,66,65911,90,232001
3101,0.000601,74.125.24.0-255,398,66309,90,232001
3102,0.000636,74.125.24.0-255,346,66655,90,232001
3103,0.000803,172.31.47.0-255,66,66721,90,232001
3104,0.000883,74.125.24.0-255,1484,68205,90,232001
3105,0.00089,74.125.24.0-255,1484,69689,90,232001
3106,0.000895,172.31.47.0-255,66,69755,90,232001
3107,0.000916,74.125.24.0-255,1484,71239,90,232001
3108,0.000923,74.125.24.0-255,5738,76977,90,232001
3109,0.000925,172.31.47.0-255,66,77043,90,232001
3110,0.000929,74.125.24.0-255,2902,79945,90,232001
3111,0.000931,172.31.47.0-255,66,80011,90,232001
3112,0.000937,74.125.24.0-255,4320,84331,90,232001
3113,0.000939,172.31.47.0-255,66,84397,90,232001
3114,0.000975,74.125.24.0-255,5738,90135,90,232001
3115,0.000979,172.31.47.0-255,66,90201,90,232001
3116,0.00099,74.125.24.0-255,10692,100893,90,232001
3117,0.000992,172.31.47.0-255,66,100959,90,232001
3118,0.001066,74.125.24.0-255,1484,102443,90,232001
3119,0.001073,74.125.24.0-255,2902,105345,90,232001
3120,0.001076,172.31.47.0-255,66,105411,90,232001
3121,0.001081,74.125.24.0-255,2902,108313,90,232001
3122,0.001084,172.31.47.0-255,66,108379,90,232001
3123,0.00111,74.125.24.0-255,2902,111281,90,232001
3124,0.001113,172.31.47.0-255,66,111347,90,232001
3125,0.001126,172.31.47.0-255,66,111413,90,232001
3126,0.001132,74.125.24.0-255,8574,119987,90,232001
3127,0.001134,172.31.47.0-255,66,120053,90,232001
3128,0.001171,74.125.24.0-255,2184,122237,90,232001
3129,0.001174,172.31.47.0-255,66,122303,90,232001
3130,0.001198,74.125.24.0-255,1484,123787,90,232001
3131,0.001215,74.125.24.0-255,1484,125271,90,232001
3132,0.001218,172.31.47.0-255,66,125337,90,232001
3133,0.001225,74.125.24.0-255,5738,131075,90,232001
3134,0.001227,172.31.47.0-255,66,131141,90,232001
3135,0.001259,74.125.24.0-255,7156,138297,90,232001
3136,0.001263,172.31.47.0-255,66,138363,90,232001
3137,0.001297,172.31.47.0-255,66,138429,90,232001
3138,0.001328,74.125.24.0-255,3602,142031,90,232001
3139,0.001332,172.31.47.0-255,66,142097,90,232001
3140,0.001639,74.125.24.0-255,1484,143581,90,232001
3141,0.001657,74.125.24.0-255,2902,146483,90,232001
3142,0.00166,172.31.47.0-255,66,146549,90,232001
3143,0.001663,74.125.24.0-255,1484,148033,90,232001
3144,0.001684,74.125.24.0-255,4320,152353,90,232001
3145,0.001686,172.31.47.0-255,66,152419,90,232001
3146,0.001689,74.125.24.0-255,2902,155321,90,232001
3147,0.001691,172.31.47.0-255,66,155387,90,232001
3148,0.00171,74.125.24.0-255,5738,161125,90,232001
3149,0.001712,172.31.47.0-255,66,161191,90,232001
3150,0.001731,74.125.24.0-255,2902,164093,90,232001
3151,0.001732,172.31.47.0-255,66,164159,90,232001
3152,0.001765,172.31.47.0-255,66,164225,90,232001
3153,0.001802,172.31.47.0-255,66,164291,90,232001
3154,0.001805,74.125.24.0-255,1484,165775,90,232001
3155,0.001839,172.31.47.0-255,66,165841,90,232001
3156,0.00188,74.125.24.0-255,5738,171579,90,232001
3157,0.001882,172.31.47.0-255,66,171645,90,232001
3158,0.001911,74.125.24.0-255,3602,175247,90,232001
3159,0.001913,172.31.47.0-255,66,175313,90,232001
3160,0.001928,74.125.24.0-255,9992,185305,90,232001
3161,0.00193,172.31.47.0-255,66,185371,90,232001
3162,0.001942,172.31.47.0-255,66,185437,90,232001
3163,0.001983,74.125.24.0-255,1484,186921,90,232001
3164,0.002001,74.125.24.0-255,2902,189823,90,232001
3165,0.002003,172.31.47.0-255,66,189889,90,232001
3166,0.002007,74.125.24.0-255,4320,194209,90,232001
3167,0.002009,172.31.47.0-255,66,194275,90,232001
3168,0.002026,74.125.24.0-255,1484,195759,90,232001
3169,0.002033,74.125.24.0-255,8574,204333,90,232001
3170,0.002038,172.31.47.0-255,66,204399,90,232001
3171,0.002062,74.125.24.0-255,4320,208719,90,232001
3172,0.002064,172.31.47.0-255,66,208785,90,232001
3173,0.002068,74.125.24.0-255,5738,214523,90,232001
3174,0.00207,172.31.47.0-255,66,214589,90,232001
3175,0.004086,74.125.24.0-255,5738,220327,90,232001
3176,0.004091,172.31.47.0-255,66,220393,90,232001
3177,0.006132,74.125.24.0-255,5738,226131,90,232001
3178,0.006135,172.31.47.0-255,66,226197,90,232001
3179,0.008155,74.125.24.0-255,5738,231935,90,232001
3180,0.008161,172.31.47.0-255,66,232001,90,232001
3181,0.0,172.31.47.0-255,105,105,90,276
3182,0.001509,157.240.13.0-255,105,210,90,276
3183,0.00152,172.31.47.0-255,66,276,90,276
3184,0.0,74.125.24.0-255,153,153,90,144182
3185,1.8e-05,172.31.47.0-255,66,219,90,144182
3186,2.5e-05,74.125.24.0-255,1484,1703,90,144182
3187,2.9e-05,172.31.47.0-255,66,1769,90,144182
3188,3.4e-05,74.125.24.0-255,2902,4671,90,144182
3189,3.7e-05,172.31.47.0-255,66,4737,90,144182
3190,4.3e-05,74.125.24.0-255,7156,11893,90,144182
3191,4.6e-05,172.31.47.0-255,66,11959,90,144182
3192,0.000109,172.31.47.0-255,66,12025,90,144182
3193,0.000113,74.125.24.0-255,2543,14568,90,144182
3194,0.000114,172.31.47.0-255,66,14634,90,144182
3195,0.000159,74.125.24.0-255,1484,16118,90,144182
3196,0.000162,172.31.47.0-255,66,16184,90,144182
3197,0.000181,74.125.24.0-255,2902,19086,90,144182
3198,0.000183,172.31.47.0-255,66,19152,90,144182
3199,0.000189,74.125.24.0-255,5738,24890,90,144182
3200,0.000191,172.31.47.0-255,66,24956,90,144182
3201,0.000232,172.31.47.0-255,66,25022,90,144182
3202,0.000246,74.125.24.0-255,2902,27924,90,144182
3203,0.000248,172.31.47.0-255,66,27990,90,144182
3204,0.000281,74.125.24.0-255,7856,35846,90,144182
3205,0.000283,172.31.47.0-255,66,35912,90,144182
3206,0.000286,74.125.24.0-255,395,36307,90,144182
3207,0.000287,172.31.47.0-255,66,36373,90,144182
3208,0.000324,74.125.24.0-255,379,36752,90,144182
3209,0.000326,172.31.47.0-255,66,36818,90,144182
3210,0.000451,74.125.24.0-255,1484,38302,90,144182
3211,0.000457,172.31.47.0-255,66,38368,90,144182
3212,0.000466,74.125.24.0-255,2902,41270,90,144182
3213,0.000468,172.31.47.0-255,66,41336,90,144182
3214,0.000473,74.125.24.0-255,2902,44238,90,144182
3215,0.000474,172.31.47.0-255,66,44304,90,144182
3216,0.000503,74.125.24.0-255,2902,47206,90,144182
3217,0.000509,74.125.24.0-255,6797,54003,90,144182
3218,0.000513,172.31.47.0-255,66,54069,90,144182
3219,0.000516,172.31.47.0-255,66,54135,90,144182
3220,0.000541,74.125.24.0-255,4320,58455,90,144182
3221,0.000544,172.31.47.0-255,66,58521,90,144182
3222,0.000562,74.125.24.0-255,7156,65677,90,144182
3223,0.000564,172.31.47.0-255,66,65743,90,144182
3224,0.000609,74.125.24.0-255,2902,68645,90,144182
3225,0.000611,172.31.47.0-255,66,68711,90,144182
3226,0.000628,74.125.24.0-255,2543,71254,90,144182
3227,0.00063,172.31.47.0-255,66,71320,90,144182
3228,0.000736,74.125.24.0-255,1484,72804,90,144182
3229,0.000742,74.125.24.0-255,2902,75706,90,144182
3230,0.000744,172.31.47.0-255,66,75772,90,144182
3231,0.000781,74.125.24.0-255,4320,80092,90,144182
3232,0.000784,172.31.47.0-255,66,80158,90,144182
3233,0.000808,74.125.24.0-255,5738,85896,90,144182
3234,0.000811,172.31.47.0-255,66,85962,90,144182
3235,0.000815,74.125.24.0-255,2902,88864,90,144182
3236,0.000816,172.31.47.0-255,66,88930,90,144182
3237,0.000835,74.125.24.0-255,8574,97504,90,144182
3238,0.000838,172.31.47.0-255,66,97570,90,144182
3239,0.000845,74.125.24.0-255,7856,105426,90,144182
3240,0.000848,172.31.47.0-255,66,105492,90,144182
3241,0.001969,74.125.24.0-255,1484,106976,90,144182
3242,0.001979,74.125.24.0-255,2902,109878,90,144182
3243,0.001984,172.31.47.0-255,66,109944,90,144182
3244,0.001991,74.125.24.0-255,5738,115682,90,144182
3245,0.001992,172.31.47.0-255,66,115748,90,144182
3246,0.002008,74.125.24.0-255,5738,121486,90,144182
3247,0.00201,172.31.47.0-255,66,121552,90,144182
3248,0.002044,172.31.47.0-255,66,121618,90,144182
3249,0.002047,74.125.24.0-255,1484,123102,90,144182
3250,0.002064,74.125.24.0-255,3602,126704,90,144182
3251,0.002066,172.31.47.0-255,66,126770,90,144182
3252,0.004309,74.125.24.0-255,5738,132508,90,144182
3253,0.004313,172.31.47.0-255,66,132574,90,144182
3254,0.006603,74.125.24.0-255,5738,138312,90,144182
3255,0.006609,172.31.47.0-255,66,138378,90,144182
3256,0.008859,74.125.24.0-255,5738,144116,90,144182
3257,0.008866,172.31.47.0-255,66,144182,90,144182
3258,0.0,74.125.200.0-255,152,152,90,160640
3259,3.1e-05,172.31.47.0-255,66,218,90,160640
3260,4.9e-05,74.125.200.0-255,1484,1702,90,160640
3261,5.4e-05,172.31.47.0-255,66,1768,90,160640
3262,8.5e-05,74.125.200.0-255,2902,4670,90,160640
3263,8.8e-05,172.31.47.0-255,66,4736,90,160640
3264,0.000105,74.125.200.0-255,4320,9056,90,160640
3265,0.000107,172.31.47.0-255,66,9122,90,160640
3266,0.000125,74.125.200.0-255,1484,10606,90,160640
3267,0.000128,172.31.47.0-255,66,10672,90,160640
3268,0.000166,74.125.200.0-255,3433,14105,90,160640
3269,0.000169,172.31.47.0-255,66,14171,90,160640
3270,0.000198,74.125.200.0-255,4320,18491,90,160640
3271,0.000201,172.31.47.0-255,66,18557,90,160640
3272,0.000216,74.125.200.0-255,1484,20041,90,160640
3273,0.000219,172.31.47.0-255,66,20107,90,160640
3274,0.000243,74.125.200.0-255,4320,24427,90,160640
3275,0.000246,172.31.47.0-255,66,24493,90,160640
3276,0.000265,74.125.200.0-255,2902,27395,90,160640
3277,0.000267,172.31.47.0-255,66,27461,90,160640
3278,0.000288,74.125.200.0-255,5379,32840,90,160640
3279,0.000291,172.31.47.0-255,66,32906,90,160640
3280,0.000299,74.125.200.0-255,8574,41480,90,160640
3281,0.000301,172.31.47.0-255,66,41546,90,160640
3282,0.000326,74.125.200.0-255,4320,45866,90,160640
3283,0.000329,172.31.47.0-255,66,45932,90,160640
3284,0.000376,74.125.200.0-255,2543,48475,90,160640
3285,0.000379,172.31.47.0-255,66,48541,90,160640
3286,0.000417,74.125.200.0-255,2902,51443,90,160640
3287,0.000419,172.31.47.0-255,66,51509,90,160640
3288,0.000424,74.125.200.0-255,2902,54411,90,160640
3289,0.000426,172.31.47.0-255,66,54477,90,160640
3290,0.000438,74.125.200.0-255,1484,55961,90,160640
3291,0.000442,74.125.200.0-255,1484,57445,90,160640
3292,0.000444,172.31.47.0-255,66,57511,90,160640
3293,0.000469,74.125.200.0-255,7156,64667,90,160640
3294,0.000472,172.31.47.0-255,66,64733,90,160640
3295,0.000474,74.125.200.0-255,1125,65858,90,160640
3296,0.000487,74.125.200.0-255,647,66505,90,160640
3297,0.00049,172.31.47.0-255,66,66571,90,160640
3298,0.0007,74.125.200.0-255,1484,68055,90,160640
3299,0.000726,74.125.200.0-255,2902,70957,90,160640
3300,0.000729,172.31.47.0-255,66,71023,90,160640
3301,0.0008,74.125.200.0-255,4320,75343,90,160640
3302,0.000804,172.31.47.0-255,66,75409,90,160640
3303,0.000824,74.125.200.0-255,1484,76893,90,160640
3304,0.000829,74.125.200.0-255,4320,81213,90,160640
3305,0.000831,172.31.47.0-255,66,81279,90,160640
3306,0.000834,74.125.200.0-255,2543,83822,90,160640
3307,0.000836,172.31.47.0-255,66,83888,90,160640
3308,0.000839,74.125.200.0-255,2902,86790,90,160640
3309,0.000842,172.31.47.0-255,66,86856,90,160640
3310,0.000862,74.125.200.0-255,7156,94012,90,160640
3311,0.000865,172.31.47.0-255,66,94078,90,160640
3312,0.000946,74.125.200.0-255,6797,100875,90,160640
3313,0.000951,172.31.47.0-255,66,100941,90,160640
3314,0.001874,74.125.200.0-255,1484,102425,90,160640
3315,0.001883,74.125.200.0-255,2902,105327,90,160640
3316,0.001886,172.31.47.0-255,66,105393,90,160640
3317,0.001892,74.125.200.0-255,5738,111131,90,160640
3318,0.001894,172.31.47.0-255,66,111197,90,160640
3319,0.00191,74.125.200.0-255,7156,118353,90,160640
3320,0.001912,172.31.47.0-255,66,118419,90,160640
3321,0.001932,74.125.200.0-255,1484,119903,90,160640
3322,0.001937,74.125.200.0-255,2902,122805,90,160640
3323,0.001938,172.31.47.0-255,66,122871,90,160640
3324,0.001958,74.125.200.0-255,5738,128609,90,160640
3325,0.00196,172.31.47.0-255,66,128675,90,160640
3326,0.001963,74.125.200.0-255,1484,130159,90,160640
3327,0.001976,74.125.200.0-255,2902,133061,90,160640
3328,0.001978,172.31.47.0-255,66,133127,90,160640
3329,0.002028,74.125.200.0-255,2184,135311,90,160640
3330,0.002031,172.31.47.0-255,66,135377,90,160640
3331,0.002293,74.125.200.0-255,1484,136861,90,160640
3332,0.002301,74.125.200.0-255,2902,139763,90,160640
3333,0.002304,172.31.47.0-255,66,139829,90,160640
3334,0.002307,74.125.200.0-255,1484,141313,90,160640
3335,0.002319,74.125.200.0-255,1484,142797,90,160640
3336,0.00232,172.31.47.0-255,66,142863,90,160640
3337,0.002362,172.31.47.0-255,101,142964,90,160640
3338,0.004589,74.125.200.0-255,1484,144448,90,160640
3339,0.004603,74.125.200.0-255,1484,145932,90,160640
3340,0.004606,172.31.47.0-255,66,145998,90,160640
3341,0.004625,74.125.200.0-255,2902,148900,90,160640
3342,0.004627,172.31.47.0-255,66,148966,90,160640
3343,0.004628,74.125.200.0-255,66,149032,90,160640
3344,0.006895,74.125.200.0-255,5738,154770,90,160640
3345,0.006901,172.31.47.0-255,66,154836,90,160640
3346,0.0092,74.125.200.0-255,5738,160574,90,160640
3347,0.00921,172.31.47.0-255,66,160640,90,160640
3348,0.0,172.31.47.0-255,105,105,90,276
3349,0.001476,157.240.13.0-255,105,210,90,276
3350,0.001486,172.31.47.0-255,66,276,90,276
3351,0.0,172.217.194.0-255,153,153,90,258298
3352,2.4e-05,172.31.47.0-255,66,219,90,258298
3353,3.1e-05,172.217.194.0-255,1484,1703,90,258298
3354,3.5e-05,172.31.47.0-255,66,1769,90,258298
3355,4.1e-05,172.217.194.0-255,2902,4671,90,258298
3356,4.4e-05,172.31.47.0-255,66,4737,90,258298
3357,5.2e-05,172.217.194.0-255,7156,11893,90,258298
3358,5.5e-05,172.31.47.0-255,66,11959,90,258298
3359,7.7e-05,172.217.194.0-255,2110,14069,90,258298
3360,8e-05,172.31.47.0-255,66,14135,90,258298
3361,0.000136,172.217.194.0-255,1484,15619,90,258298
3362,0.000139,172.31.47.0-255,66,15685,90,258298
3363,0.000144,172.217.194.0-255,2902,18587,90,258298
3364,0.000146,172.31.47.0-255,66,18653,90,258298
3365,0.000173,172.217.194.0-255,5738,24391,90,258298
3366,0.000175,172.31.47.0-255,66,24457,90,258298
3367,0.000181,172.217.194.0-255,2902,27359,90,258298
3368,0.000183,172.31.47.0-255,66,27425,90,258298
3369,0.00021,172.217.194.0-255,5379,32804,90,258298
3370,0.000212,172.31.47.0-255,66,32870,90,258298
3371,0.000225,172.31.47.0-255,66,32936,90,258298
3372,0.000243,172.217.194.0-255,4320,37256,90,258298
3373,0.000246,172.31.47.0-255,66,37322,90,258298
3374,0.000262,172.31.47.0-255,66,37388,90,258298
3375,0.000264,172.217.194.0-255,375,37763,90,258298
3376,0.000266,172.31.47.0-255,66,37829,90,258298
3377,0.000301,172.217.194.0-255,99,37928,90,258298
3378,0.000304,172.31.47.0-255,66,37994,90,258298
3379,0.000397,172.217.194.0-255,366,38360,90,258298
3380,0.0004,172.31.47.0-255,66,38426,90,258298
3381,0.000783,172.217.194.0-255,1484,39910,90,258298
3382,0.00079,172.217.194.0-255,2902,42812,90,258298
3383,0.000794,172.31.47.0-255,66,42878,90,258298
3384,0.000801,172.217.194.0-255,5738,48616,90,258298
3385,0.000803,172.31.47.0-255,66,48682,90,258298
3386,0.000831,172.217.194.0-255,9992,58674,90,258298
3387,0.000834,172.31.47.0-255,66,58740,90,258298
3388,0.000854,172.217.194.0-255,2902,61642,90,258298
3389,0.000856,172.31.47.0-255,66,61708,90,258298
3390,0.000866,172.217.194.0-255,10692,72400,90,258298
3391,0.000869,172.31.47.0-255,66,72466,90,258298
3392,0.001173,172.217.194.0-255,1484,73950,90,258298
3393,0.001179,172.217.194.0-255,2902,76852,90,258298
3394,0.001182,172.31.47.0-255,66,76918,90,258298
3395,0.001186,172.217.194.0-255,1484,78402,90,258298
3396,0.001206,172.217.194.0-255,4320,82722,90,258298
3397,0.001209,172.31.47.0-255,66,82788,90,258298
3398,0.001218,172.217.194.0-255,8574,91362,90,258298
3399,0.00122,172.31.47.0-255,66,91428,90,258298
3400,0.00124,172.217.194.0-255,4320,95748,90,258298
3401,0.001242,172.31.47.0-255,66,95814,90,258298
3402,0.001248,172.217.194.0-255,4320,100134,90,258298
3403,0.00125,172.31.47.0-255,66,100200,90,258298
3404,0.001269,172.217.194.0-255,6438,106638,90,258298
3405,0.001272,172.31.47.0-255,66,106704,90,258298
3406,0.001294,172.217.194.0-255,1484,108188,90,258298
3407,0.00131,172.217.194.0-255,5738,113926,90,258298
3408,0.001314,172.31.47.0-255,66,113992,90,258298
3409,0.001333,172.217.194.0-255,1484,115476,90,258298
3410,0.001342,172.217.194.0-255,9992,125468,90,258298
3411,0.001344,172.31.47.0-255,66,125534,90,258298
3412,0.001348,172.217.194.0-255,1484,127018,90,258298
3413,0.001378,172.31.47.0-255,66,127084,90,258298
3414,0.00144,172.217.194.0-255,1484,128568,90,258298
3415,0.001445,172.217.194.0-255,2902,131470,90,258298
3416,0.001448,172.31.47.0-255,66,131536,90,258298
3417,0.001483,172.217.194.0-255,1484,133020,90,258298
3418,0.001499,172.217.194.0-255,4320,137340,90,258298
3419,0.001501,172.31.47.0-255,66,137406,90,258298
3420,0.001515,172.31.47.0-255,66,137472,90,258298
3421,0.001524,172.217.194.0-255,10692,148164,90,258298
3422,0.001527,172.31.47.0-255,66,148230,90,258298
3423,0.001607,172.217.194.0-255,1484,149714,90,258298
3424,0.001611,172.217.194.0-255,1484,151198,90,258298
3425,0.001614,172.31.47.0-255,66,151264,90,258298
3426,0.001643,172.217.194.0-255,1484,152748,90,258298
3427,0.001649,172.217.194.0-255,5738,158486,90,258298
3428,0.001652,172.31.47.0-255,66,158552,90,258298
3429,0.00166,172.217.194.0-255,7156,165708,90,258298
3430,0.001662,172.31.47.0-255,66,165774,90,258298
3431,0.00169,172.217.194.0-255,5738,171512,90,258298
3432,0.001693,172.31.47.0-255,66,171578,90,258298
3433,0.001696,172.217.194.0-255,1484,173062,90,258298
3434,0.001712,172.217.194.0-255,4320,177382,90,258298
3435,0.001714,172.31.47.0-255,66,177448,90,258298
3436,0.001735,172.217.194.0-255,5020,182468,90,258298
3437,0.001738,172.31.47.0-255,66,182534,90,258298
3438,0.001744,172.217.194.0-255,5738,188272,90,258298
3439,0.001746,172.31.47.0-255,66,188338,90,258298
3440,0.001777,172.217.194.0-255,4320,192658,90,258298
3441,0.001781,172.31.47.0-255,66,192724,90,258298
3442,0.001804,172.217.194.0-255,8574,201298,90,258298
3443,0.001806,172.31.47.0-255,66,201364,90,258298
3444,0.00181,172.217.194.0-255,2902,204266,90,258298
3445,0.001812,172.31.47.0-255,66,204332,90,258298
3446,0.001853,172.31.47.0-255,66,204398,90,258298
3447,0.001881,172.217.194.0-255,1484,205882,90,258298
3448,0.001894,172.217.194.0-255,2902,208784,90,258298
3449,0.001898,172.31.47.0-255,66,208850,90,258298
3450,0.001923,172.217.194.0-255,5738,214588,90,258298
3451,0.001927,172.31.47.0-255,66,214654,90,258298
3452,0.001929,172.217.194.0-255,1484,216138,90,258298
3453,0.001949,172.217.194.0-255,7156,223294,90,258298
3454,0.001953,172.31.47.0-255,66,223360,90,258298
3455,0.001979,172.217.194.0-255,9992,233352,90,258298
3456,0.001982,172.31.47.0-255,66,233418,90,258298
3457,0.002012,172.217.194.0-255,6438,239856,90,258298
3458,0.002016,172.31.47.0-255,66,239922,90,258298
3459,0.002029,172.31.47.0-255,66,239988,90,258298
3460,0.002032,172.217.194.0-255,1484,241472,90,258298
3461,0.002066,172.31.47.0-255,66,241538,90,258298
3462,0.002082,172.217.194.0-255,766,242304,90,258298
3463,0.004119,172.217.194.0-255,4320,246624,90,258298
3464,0.004148,172.31.47.0-255,66,246690,90,258298
3465,0.006203,172.217.194.0-255,5738,252428,90,258298
3466,0.006223,172.31.47.0-255,66,252494,90,258298
3467,0.00826,172.217.194.0-255,5738,258232,90,258298
3468,0.00827,172.31.47.0-255,66,258298,90,258298
3469,0.0,172.217.194.0-255,153,153,90,196238
3470,2e-05,172.31.47.0-255,66,219,90,196238
3471,2.6e-05,172.217.194.0-255,1484,1703,90,196238
3472,3e-05,172.31.47.0-255,66,1769,90,196238
3473,3.6e-05,172.217.194.0-255,2902,4671,90,196238
3474,4.8e-05,172.31.47.0-255,66,4737,90,196238
3475,5.5e-05,172.217.194.0-255,7156,11893,90,196238
3476,5.8e-05,172.31.47.0-255,66,11959,90,196238
3477,6.2e-05,172.217.194.0-255,2084,14043,90,196238
3478,6.4e-05,172.31.47.0-255,66,14109,90,196238
3479,0.000625,172.217.194.0-255,1484,15593,90,196238
3480,0.000632,172.31.47.0-255,66,15659,90,196238
3481,0.00064,172.217.194.0-255,2902,18561,90,196238
3482,0.000642,172.31.47.0-255,66,18627,90,196238
3483,0.000654,172.217.194.0-255,5738,24365,90,196238
3484,0.000656,172.31.47.0-255,66,24431,90,196238
3485,0.000679,172.217.194.0-255,6797,31228,90,196238
3486,0.000683,172.31.47.0-255,66,31294,90,196238
3487,0.000729,172.217.194.0-255,1484,32778,90,196238
3488,0.000733,172.31.47.0-255,66,32844,90,196238
3489,0.000738,172.217.194.0-255,2902,35746,90,196238
3490,0.000739,172.31.47.0-255,66,35812,90,196238
3491,0.000758,172.217.194.0-255,5738,41550,90,196238
3492,0.000761,172.31.47.0-255,66,41616,90,196238
3493,0.000784,172.217.194.0-255,4320,45936,90,196238
3494,0.000787,172.31.47.0-255,66,46002,90,196238
3495,0.000807,172.217.194.0-255,1484,47486,90,196238
3496,0.00081,172.31.47.0-255,66,47552,90,196238
3497,0.000813,172.217.194.0-255,1125,48677,90,196238
3498,0.000814,172.31.47.0-255,66,48743,90,196238
3499,0.000866,172.217.194.0-255,1484,50227,90,196238
3500,0.000871,172.31.47.0-255,66,50293,90,196238
3501,0.000875,172.217.194.0-255,2902,53195,90,196238
3502,0.000877,172.31.47.0-255,66,53261,90,196238
3503,0.000904,172.217.194.0-255,5738,58999,90,196238
3504,0.000907,172.31.47.0-255,66,59065,90,196238
3505,0.000937,172.217.194.0-255,7377,66442,90,196238
3506,0.00094,172.31.47.0-255,66,66508,90,196238
3507,0.00121,172.217.194.0-255,1484,67992,90,196238
3508,0.001217,172.217.194.0-255,2902,70894,90,196238
3509,0.001221,172.31.47.0-255,66,70960,90,196238
3510,0.001251,172.217.194.0-255,5738,76698,90,196238
3511,0.001255,172.31.47.0-255,66,76764,90,196238
3512,0.001258,172.217.194.0-255,1484,78248,90,196238
3513,0.001264,172.217.194.0-255,7156,85404,90,196238
3514,0.001267,172.31.47.0-255,66,85470,90,196238
3515,0.001287,172.217.194.0-255,1484,86954,90,196238
3516,0.001292,172.217.194.0-255,2902,89856,90,196238
3517,0.001294,172.31.47.0-255,66,89922,90,196238
3518,0.001328,172.217.194.0-255,10692,100614,90,196238
3519,0.00133,172.31.47.0-255,66,100680,90,196238
3520,0.001614,172.217.194.0-255,1484,102164,90,196238
3521,0.00162,172.217.194.0-255,2902,105066,90,196238
3522,0.001623,172.31.47.0-255,66,105132,90,196238
3523,0.001649,172.217.194.0-255,5738,110870,90,196238
3524,0.001652,172.31.47.0-255,66,110936,90,196238
3525,0.001656,172.217.194.0-255,2902,113838,90,196238
3526,0.001658,172.31.47.0-255,66,113904,90,196238
3527,0.001678,172.217.194.0-255,4320,118224,90,196238
3528,0.00168,172.31.47.0-255,66,118290,90,196238
3529,0.001722,172.31.47.0-255,66,118356,90,196238
3530,0.001748,172.217.194.0-255,2902,121258,90,196238
3531,0.00175,172.31.47.0-255,66,121324,90,196238
3532,0.001754,172.217.194.0-255,2184,123508,90,196238
3533,0.001756,172.31.47.0-255,66,123574,90,196238
3534,0.001839,172.217.194.0-255,1484,125058,90,196238
3535,0.001843,172.217.194.0-255,2902,127960,90,196238
3536,0.001845,172.31.47.0-255,66,128026,90,196238
3537,0.001869,172.217.194.0-255,5738,133764,90,196238
3538,0.001872,172.31.47.0-255,66,133830,90,196238
3539,0.001894,172.217.194.0-255,5738,139568,90,196238
3540,0.001896,172.31.47.0-255,66,139634,90,196238
3541,0.001921,172.217.194.0-255,7156,146790,90,196238
3542,0.001923,172.31.47.0-255,66,146856,90,196238
3543,0.001932,172.217.194.0-255,10692,157548,90,196238
3544,0.001934,172.31.47.0-255,66,157614,90,196238
3545,0.002008,172.217.194.0-255,1484,159098,90,196238
3546,0.002012,172.217.194.0-255,2902,162000,90,196238
3547,0.002014,172.31.47.0-255,66,162066,90,196238
3548,0.002037,172.217.194.0-255,5738,167804,90,196238
3549,0.00204,172.31.47.0-255,66,167870,90,196238
3550,0.002073,172.31.47.0-255,66,167936,90,196238
3551,0.00208,172.217.194.0-255,8574,176510,90,196238
3552,0.002082,172.31.47.0-255,66,176576,90,196238
3553,0.002086,172.217.194.0-255,2184,178760,90,196238
3554,0.002088,172.31.47.0-255,66,178826,90,196238
3555,0.004128,172.217.194.0-255,5738,184564,90,196238
3556,0.004136,172.31.47.0-255,66,184630,90,196238
3557,0.006185,172.217.194.0-255,5738,190368,90,196238
3558,0.006192,172.31.47.0-255,66,190434,90,196238
3559,0.008229,172.217.194.0-255,5738,196172,90,196238
3560,0.008238,172.31.47.0-255,66,196238,90,196238
3561,0.0,74.125.24.0-255,153,153,90,192437
3562,2.1e-05,172.31.47.0-255,66,219,90,192437
3563,2.8e-05,74.125.24.0-255,1484,1703,90,192437
3564,3.2e-05,172.31.47.0-255,66,1769,90,192437
3565,3.7e-05,74.125.24.0-255,2902,4671,90,192437
3566,4e-05,172.31.47.0-255,66,4737,90,192437
3567,4.8e-05,74.125.24.0-255,7156,11893,90,192437
3568,5.1e-05,172.31.47.0-255,66,11959,90,192437
3569,5.7e-05,74.125.24.0-255,4320,16279,90,192437
3570,6e-05,172.31.47.0-255,66,16345,90,192437
3571,7.8e-05,74.125.24.0-255,2254,18599,90,192437
3572,8.1e-05,172.31.47.0-255,66,18665,90,192437
3573,9.8e-05,74.125.24.0-255,4320,22985,90,192437
3574,0.000101,172.31.47.0-255,66,23051,90,192437
3575,0.000127,74.125.24.0-255,8215,31266,90,192437
3576,0.000129,172.31.47.0-255,66,31332,90,192437
3577,0.00019,74.125.24.0-255,1484,32816,90,192437
3578,0.000193,172.31.47.0-255,66,32882,90,192437
3579,0.00021,74.125.24.0-255,2902,35784,90,192437
3580,0.000212,172.31.47.0-255,66,35850,90,192437
3581,0.000215,74.125.24.0-255,1484,37334,90,192437
3582,0.000216,172.31.47.0-255,66,37400,90,192437
3583,0.000232,74.125.24.0-255,4320,41720,90,192437
3584,0.000235,172.31.47.0-255,66,41786,90,192437
3585,0.000262,74.125.24.0-255,6797,48583,90,192437
3586,0.000265,172.31.47.0-255,66,48649,90,192437
3587,0.000269,74.125.24.0-255,4320,52969,90,192437
3588,0.000271,172.31.47.0-255,66,53035,90,192437
3589,0.000286,74.125.24.0-255,2902,55937,90,192437
3590,0.000289,172.31.47.0-255,66,56003,90,192437
3591,0.000299,74.125.24.0-255,1484,57487,90,192437
3592,0.000301,172.31.47.0-255,66,57553,90,192437
3593,0.00033,74.125.24.0-255,8488,66041,90,192437
3594,0.000333,172.31.47.0-255,66,66107,90,192437
3595,0.000596,74.125.24.0-255,132,66239,90,192437
3596,0.0006,74.125.24.0-255,347,66586,90,192437
3597,0.000908,74.125.24.0-255,1484,68070,90,192437
3598,0.000914,172.31.47.0-255,66,68136,90,192437
3599,0.00092,74.125.24.0-255,2902,71038,90,192437
3600,0.000922,172.31.47.0-255,66,71104,90,192437
3601,0.000927,74.125.24.0-255,4320,75424,90,192437
3602,0.000929,172.31.47.0-255,66,75490,90,192437
3603,0.000946,74.125.24.0-255,1484,76974,90,192437
3604,0.000949,74.125.24.0-255,1484,78458,90,192437
3605,0.000951,172.31.47.0-255,66,78524,90,192437
3606,0.000983,172.31.47.0-255,66,78590,90,192437
3607,0.00099,74.125.24.0-255,7156,85746,90,192437
3608,0.000992,172.31.47.0-255,66,85812,90,192437
3609,0.001013,74.125.24.0-255,3053,88865,90,192437
3610,0.001015,172.31.47.0-255,66,88931,90,192437
3611,0.001046,74.125.24.0-255,4320,93251,90,192437
3612,0.001048,172.31.47.0-255,66,93317,90,192437
3613,0.001066,74.125.24.0-255,2902,96219,90,192437
3614,0.001068,172.31.47.0-255,66,96285,90,192437
3615,0.001086,74.125.24.0-255,2902,99187,90,192437
3616,0.001089,172.31.47.0-255,66,99253,90,192437
3617,0.001119,74.125.24.0-255,8574,107827,90,192437
3618,0.001121,172.31.47.0-255,66,107893,90,192437
3619,0.00114,74.125.24.0-255,2902,110795,90,192437
3620,0.001142,172.31.47.0-255,66,110861,90,192437
3621,0.001155,172.31.47.0-255,66,110927,90,192437
3622,0.001911,74.125.24.0-255,1484,112411,90,192437
3623,0.001927,74.125.24.0-255,2902,115313,90,192437
3624,0.001933,172.31.47.0-255,66,115379,90,192437
3625,0.001939,74.125.24.0-255,4320,119699,90,192437
3626,0.001942,172.31.47.0-255,66,119765,90,192437
3627,0.001954,74.125.24.0-255,1484,121249,90,192437
3628,0.00197,172.31.47.0-255,66,121315,90,192437
3629,0.001976,74.125.24.0-255,4320,125635,90,192437
3630,0.001978,172.31.47.0-255,66,125701,90,192437
3631,0.002005,74.125.24.0-255,6438,132139,90,192437
3632,0.002008,172.31.47.0-255,66,132205,90,192437
3633,0.002051,74.125.24.0-255,1484,133689,90,192437
3634,0.002067,74.125.24.0-255,2902,136591,90,192437
3635,0.00207,172.31.47.0-255,66,136657,90,192437
3636,0.002073,74.125.24.0-255,1484,138141,90,192437
3637,0.002095,74.125.24.0-255,2902,141043,90,192437
3638,0.002097,172.31.47.0-255,66,141109,90,192437
3639,0.002104,74.125.24.0-255,7156,148265,90,192437
3640,0.002106,172.31.47.0-255,66,148331,90,192437
3641,0.002118,74.125.24.0-255,1484,149815,90,192437
3642,0.002153,74.125.24.0-255,5738,155553,90,192437
3643,0.002155,172.31.47.0-255,66,155619,90,192437
3644,0.002185,74.125.24.0-255,10692,166311,90,192437
3645,0.002188,172.31.47.0-255,66,166377,90,192437
3646,0.002202,172.31.47.0-255,66,166443,90,192437
3647,0.002205,74.125.24.0-255,1484,167927,90,192437
3648,0.002238,172.31.47.0-255,66,167993,90,192437
3649,0.002243,74.125.24.0-255,2902,170895,90,192437
3650,0.002246,172.31.47.0-255,66,170961,90,192437
3651,0.00227,74.125.24.0-255,3602,174563,90,192437
3652,0.002273,172.31.47.0-255,66,174629,90,192437
3653,0.004591,74.125.24.0-255,2902,177531,90,192437
3654,0.004599,172.31.47.0-255,66,177597,90,192437
3655,0.004651,74.125.24.0-255,2902,180499,90,192437
3656,0.004655,172.31.47.0-255,66,180565,90,192437
3657,0.006937,74.125.24.0-255,2902,183467,90,192437
3658,0.006945,172.31.47.0-255,66,183533,90,192437
3659,0.007013,74.125.24.0-255,2902,186435,90,192437
3660,0.007018,172.31.47.0-255,66,186501,90,192437
3661,0.009277,74.125.24.0-255,2902,189403,90,192437
3662,0.009287,172.31.47.0-255,66,189469,90,192437
3663,0.009354,74.125.24.0-255,2902,192371,90,192437
3664,0.009359,172.31.47.0-255,66,192437,90,192437
3665,0.0,74.125.24.0-255,297,297,90,213628
3666,2.7e-05,172.31.47.0-255,66,363,90,213628
3667,3.2e-05,74.125.24.0-255,1484,1847,90,213628
3668,3.7e-05,172.31.47.0-255,66,1913,90,213628
3669,4.2e-05,74.125.24.0-255,4320,6233,90,213628
3670,4.5e-05,172.31.47.0-255,66,6299,90,213628
3671,5.1e-05,74.125.24.0-255,7680,13979,90,213628
3672,5.4e-05,172.31.47.0-255,66,14045,90,213628
3673,7.7e-05,74.125.24.0-255,7156,21201,90,213628
3674,7.9e-05,172.31.47.0-255,66,21267,90,213628
3675,0.000113,74.125.24.0-255,7156,28423,90,213628
3676,0.000116,172.31.47.0-255,66,28489,90,213628
3677,0.000126,172.31.47.0-255,66,28555,90,213628
3678,0.000156,74.125.24.0-255,6438,34993,90,213628
3679,0.000159,172.31.47.0-255,66,35059,90,213628
3680,0.000455,74.125.24.0-255,1484,36543,90,213628
3681,0.000459,172.31.47.0-255,66,36609,90,213628
3682,0.000476,74.125.24.0-255,2902,39511,90,213628
3683,0.000478,172.31.47.0-255,66,39577,90,213628
3684,0.000484,74.125.24.0-255,5738,45315,90,213628
3685,0.000486,172.31.47.0-255,66,45381,90,213628
3686,0.000509,74.125.24.0-255,7140,52521,90,213628
3687,0.000512,172.31.47.0-255,66,52587,90,213628
3688,0.000605,74.125.24.0-255,1484,54071,90,213628
3689,0.000608,172.31.47.0-255,66,54137,90,213628
3690,0.000612,74.125.24.0-255,2902,57039,90,213628
3691,0.000614,172.31.47.0-255,66,57105,90,213628
3692,0.000631,74.125.24.0-255,5738,62843,90,213628
3693,0.000634,172.31.47.0-255,66,62909,90,213628
3694,0.000669,172.31.47.0-255,66,62975,90,213628
3695,0.000687,74.125.24.0-255,1484,64459,90,213628
3696,0.000692,74.125.24.0-255,4320,68779,90,213628
3697,0.000694,172.31.47.0-255,66,68845,90,213628
3698,0.000706,74.125.24.0-255,4320,73165,90,213628
3699,0.000709,172.31.47.0-255,66,73231,90,213628
3700,0.000726,74.125.24.0-255,2184,75415,90,213628
3701,0.000728,172.31.47.0-255,66,75481,90,213628
3702,0.000757,74.125.24.0-255,2902,78383,90,213628
3703,0.00076,172.31.47.0-255,66,78449,90,213628
3704,0.000765,74.125.24.0-255,4320,82769,90,213628
3705,0.000767,172.31.47.0-255,66,82835,90,213628
3706,0.0008,74.125.24.0-255,8574,91409,90,213628
3707,0.000803,172.31.47.0-255,66,91475,90,213628
3708,0.000818,74.125.24.0-255,2902,94377,90,213628
3709,0.00082,172.31.47.0-255,66,94443,90,213628
3710,0.000853,172.31.47.0-255,66,94509,90,213628
3711,0.00086,74.125.24.0-255,8574,103083,90,213628
3712,0.000863,172.31.47.0-255,66,103149,90,213628
3713,0.000875,74.125.24.0-255,4320,107469,90,213628
3714,0.000878,172.31.47.0-255,66,107535,90,213628
3715,0.000899,74.125.24.0-255,5738,113273,90,213628
3716,0.000902,172.31.47.0-255,66,113339,90,213628
3717,0.000917,172.31.47.0-255,66,113405,90,213628
3718,0.000976,172.31.47.0-255,66,113471,90,213628
3719,0.00101,172.31.47.0-255,66,113537,90,213628
3720,0.001017,74.125.24.0-255,9274,122811,90,213628
3721,0.001019,172.31.47.0-255,66,122877,90,213628
3722,0.001023,74.125.24.0-255,4320,127197,90,213628
3723,0.001025,172.31.47.0-255,66,127263,90,213628
3724,0.001031,74.125.24.0-255,5738,133001,90,213628
3725,0.001034,172.31.47.0-255,66,133067,90,213628
3726,0.001069,74.125.24.0-255,1484,134551,90,213628
3727,0.00107,172.31.47.0-255,66,134617,90,213628
3728,0.001094,74.125.24.0-255,10389,145006,90,213628
3729,0.001097,172.31.47.0-255,66,145072,90,213628
3730,0.001108,172.31.47.0-255,66,145138,90,213628
3731,0.001124,74.125.24.0-255,1484,146622,90,213628
3732,0.00113,74.125.24.0-255,5738,152360,90,213628
3733,0.001132,172.31.47.0-255,66,152426,90,213628
3734,0.001176,172.31.47.0-255,66,152492,90,213628
3735,0.001194,74.125.24.0-255,1484,153976,90,213628
3736,0.001198,74.125.24.0-255,2902,156878,90,213628
3737,0.0012,172.31.47.0-255,66,156944,90,213628
3738,0.001218,74.125.24.0-255,5738,162682,90,213628
3739,0.00122,172.31.47.0-255,66,162748,90,213628
3740,0.001224,74.125.24.0-255,2902,165650,90,213628
3741,0.001226,172.31.47.0-255,66,165716,90,213628
3742,0.001258,74.125.24.0-255,2902,168618,90,213628
3743,0.001262,172.31.47.0-255,66,168684,90,213628
3744,0.001273,172.31.47.0-255,66,168750,90,213628
3745,0.001276,74.125.24.0-255,2902,171652,90,213628
3746,0.001278,172.31.47.0-255,66,171718,90,213628
3747,0.001299,74.125.24.0-255,2184,173902,90,213628
3748,0.001302,172.31.47.0-255,66,173968,90,213628
3749,0.001317,74.125.24.0-255,4320,178288,90,213628
3750,0.001319,172.31.47.0-255,66,178354,90,213628
3751,0.001335,74.125.24.0-255,1484,179838,90,213628
3752,0.001342,74.125.24.0-255,7156,186994,90,213628
3753,0.001344,172.31.47.0-255,66,187060,90,213628
3754,0.001362,74.125.24.0-255,4320,191380,90,213628
3755,0.001365,172.31.47.0-255,66,191446,90,213628
3756,0.001403,74.125.24.0-255,9992,201438,90,213628
3757,0.001407,172.31.47.0-255,66,201504,90,213628
3758,0.001419,172.31.47.0-255,66,201570,90,213628
3759,0.001431,172.31.47.0-255,66,201636,90,213628
3760,0.001459,172.31.47.0-255,66,201702,90,213628
3761,0.001531,172.31.47.0-255,66,201768,90,213628
3762,0.001557,74.125.24.0-255,3602,205370,90,213628
3763,0.00156,172.31.47.0-255,66,205436,90,213628
3764,0.001568,74.125.24.0-255,7850,213286,90,213628
3765,0.00157,172.31.47.0-255,66,213352,90,213628
3766,0.001573,74.125.24.0-255,105,213457,90,213628
3767,0.00813,172.31.47.0-255,66,213523,90,213628
3768,0.008158,172.31.47.0-255,105,213628,90,213628
3769,0.0,172.31.47.0-255,105,105,90,381
3770,4.3e-05,172.31.47.0-255,105,210,90,381
3771,0.001529,157.240.13.0-255,105,315,90,381
3772,0.00154,172.31.47.0-255,66,381,90,381
3773,0.0,172.217.27.0-255,153,153,90,114160
3774,1.7e-05,172.31.47.0-255,66,219,90,114160
3775,2.3e-05,172.217.27.0-255,1484,1703,90,114160
3776,2.8e-05,172.31.47.0-255,66,1769,90,114160
3777,3.1e-05,172.217.27.0-255,1484,3253,90,114160
3778,3.3e-05,172.31.47.0-255,66,3319,90,114160
3779,4.4e-05,172.217.27.0-255,2902,6221,90,114160
3780,4.7e-05,172.31.47.0-255,66,6287,90,114160
3781,5.3e-05,172.217.27.0-255,5738,12025,90,114160
3782,5.7e-05,172.31.47.0-255,66,12091,90,114160
3783,6e-05,172.217.27.0-255,1484,13575,90,114160
3784,6.2e-05,172.31.47.0-255,66,13641,90,114160
3785,9e-05,172.217.27.0-255,791,14432,90,114160
3786,9.2e-05,172.31.47.0-255,66,14498,90,114160
3787,0.000252,172.217.27.0-255,1484,15982,90,114160
3788,0.000257,172.31.47.0-255,66,16048,90,114160
3789,0.00026,172.217.27.0-255,1484,17532,90,114160
3790,0.000263,172.31.47.0-255,66,17598,90,114160
3791,0.000297,172.217.27.0-255,1484,19082,90,114160
3792,0.0003,172.31.47.0-255,66,19148,90,114160
3793,0.000305,172.217.27.0-255,4320,23468,90,114160
3794,0.000307,172.31.47.0-255,66,23534,90,114160
3795,0.000316,172.217.27.0-255,5738,29272,90,114160
3796,0.000318,172.31.47.0-255,66,29338,90,114160
3797,0.000335,172.217.27.0-255,2902,32240,90,114160
3798,0.000341,172.31.47.0-255,66,32306,90,114160
3799,0.000374,172.217.27.0-255,9633,41939,90,114160
3800,0.000377,172.31.47.0-255,66,42005,90,114160
3801,0.000379,172.217.27.0-255,1484,43489,90,114160
3802,0.000381,172.31.47.0-255,66,43555,90,114160
3803,0.000387,172.217.27.0-255,5379,48934,90,114160
3804,0.000389,172.31.47.0-255,66,49000,90,114160
3805,0.001205,172.217.27.0-255,1484,50484,90,114160
3806,0.001214,172.217.27.0-255,2902,53386,90,114160
3807,0.001218,172.31.47.0-255,66,53452,90,114160
3808,0.00125,172.217.27.0-255,5738,59190,90,114160
3809,0.001253,172.31.47.0-255,66,59256,90,114160
3810,0.001279,172.217.27.0-255,5738,64994,90,114160
3811,0.001281,172.31.47.0-255,66,65060,90,114160
3812,0.001308,172.217.27.0-255,1125,66185,90,114160
3813,0.001322,172.31.47.0-255,66,66251,90,114160
3814,0.001326,172.217.27.0-255,3122,69373,90,114160
3815,0.001328,172.31.47.0-255,66,69439,90,114160
3816,0.001337,172.217.27.0-255,4320,73759,90,114160
3817,0.001339,172.31.47.0-255,66,73825,90,114160
3818,0.001345,172.217.27.0-255,5738,79563,90,114160
3819,0.001347,172.31.47.0-255,66,79629,90,114160
3820,0.001384,172.217.27.0-255,6797,86426,90,114160
3821,0.001388,172.31.47.0-255,66,86492,90,114160
3822,0.003063,172.217.27.0-255,5738,92230,90,114160
3823,0.003069,172.31.47.0-255,66,92296,90,114160
3824,0.004734,172.217.27.0-255,4320,96616,90,114160
3825,0.00474,172.31.47.0-255,66,96682,90,114160
3826,0.004766,172.217.27.0-255,1484,98166,90,114160
3827,0.006407,172.217.27.0-255,4320,102486,90,114160
3828,0.00641,172.31.47.0-255,66,102552,90,114160
3829,0.008075,172.217.27.0-255,5738,108290,90,114160
3830,0.008081,172.31.47.0-255,66,108356,90,114160
3831,0.009747,172.217.27.0-255,5738,114094,90,114160
3832,0.009754,172.31.47.0-255,66,114160,90,114160
3833,0.0,172.31.47.0-255,105,105,90,105
3834,0.0,172.31.47.0-255,105,105,90,105
3835,0.0,172.31.47.0-255,105,105,90,105
3836,0.0,172.31.47.0-255,105,105,90,276
3837,0.001935,157.240.13.0-255,105,210,90,276
3838,0.001948,172.31.47.0-255,66,276,90,276
3839,0.0,74.125.24.0-255,146,146,90,81587
3840,3.2e-05,172.31.47.0-255,66,212,90,81587
3841,3.9e-05,74.125.24.0-255,1484,1696,90,81587
3842,4.2e-05,172.31.47.0-255,66,1762,90,81587
3843,4.7e-05,74.125.24.0-255,2902,4664,90,81587
3844,5.8e-05,172.31.47.0-255,66,4730,90,81587
3845,6.5e-05,74.125.24.0-255,7156,11886,90,81587
3846,6.8e-05,172.31.47.0-255,66,11952,90,81587
3847,7.2e-05,74.125.24.0-255,2161,14113,90,81587
3848,7.5e-05,172.31.47.0-255,66,14179,90,81587
3849,0.000794,74.125.24.0-255,1484,15663,90,81587
3850,0.0008,172.31.47.0-255,66,15729,90,81587
3851,0.00081,74.125.24.0-255,2902,18631,90,81587
3852,0.000812,172.31.47.0-255,66,18697,90,81587
3853,0.000823,74.125.24.0-255,5738,24435,90,81587
3854,0.000825,172.31.47.0-255,66,24501,90,81587
3855,0.000858,74.125.24.0-255,2902,27403,90,81587
3856,0.000861,172.31.47.0-255,66,27469,90,81587
3857,0.000889,74.125.24.0-255,3961,31430,90,81587
3858,0.000893,172.31.47.0-255,66,31496,90,81587
3859,0.001552,74.125.24.0-255,1484,32980,90,81587
3860,0.001558,172.31.47.0-255,66,33046,90,81587
3861,0.001566,74.125.24.0-255,2902,35948,90,81587
3862,0.001568,172.31.47.0-255,66,36014,90,81587
3863,0.001577,74.125.24.0-255,5738,41752,90,81587
3864,0.001579,172.31.47.0-255,66,41818,90,81587
3865,0.001631,172.31.47.0-255,66,41884,90,81587
3866,0.001639,74.125.24.0-255,9912,51796,90,81587
3867,0.00164,172.31.47.0-255,66,51862,90,81587
3868,0.002182,74.125.24.0-255,375,52237,90,81587
3869,0.002185,172.31.47.0-255,66,52303,90,81587
3870,0.002224,74.125.24.0-255,1484,53787,90,81587
3871,0.00226,74.125.24.0-255,1484,55271,90,81587
3872,0.002263,172.31.47.0-255,66,55337,90,81587
3873,0.002267,74.125.24.0-255,2902,58239,90,81587
3874,0.002269,172.31.47.0-255,66,58305,90,81587
3875,0.002312,74.125.24.0-255,5738,64043,90,81587
3876,0.002315,172.31.47.0-255,66,64109,90,81587
3877,0.00458,74.125.24.0-255,1484,65593,90,81587
3878,0.004608,74.125.24.0-255,4320,69913,90,81587
3879,0.004612,172.31.47.0-255,66,69979,90,81587
3880,0.006927,74.125.24.0-255,5738,75717,90,81587
3881,0.006939,172.31.47.0-255,66,75783,90,81587
3882,0.009233,74.125.24.0-255,5738,81521,90,81587
3883,0.009248,172.31.47.0-255,66,81587,90,81587
3884,0.0,74.125.24.0-255,297,297,90,298458
3885,3.4e-05,172.31.47.0-255,66,363,90,298458
3886,4e-05,74.125.24.0-255,1484,1847,90,298458
3887,4.4e-05,172.31.47.0-255,66,1913,90,298458
3888,4.9e-05,74.125.24.0-255,4320,6233,90,298458
3889,5.7e-05,172.31.47.0-255,66,6299,90,298458
3890,8.3e-05,74.125.24.0-255,8574,14873,90,298458
3891,8.8e-05,172.31.47.0-255,66,14939,90,298458
3892,9.8e-05,74.125.24.0-255,548,15487,90,298458
3893,0.000101,172.31.47.0-255,66,15553,90,298458
3894,0.000113,74.125.24.0-255,8574,24127,90,298458
3895,0.000116,172.31.47.0-255,66,24193,90,298458
3896,0.000147,74.125.24.0-255,6797,30990,90,298458
3897,0.000151,172.31.47.0-255,66,31056,90,298458
3898,0.000192,74.125.24.0-255,1484,32540,90,298458
3899,0.000194,172.31.47.0-255,66,32606,90,298458
3900,0.000198,74.125.24.0-255,2902,35508,90,298458
3901,0.000202,172.31.47.0-255,66,35574,90,298458
3902,0.000207,74.125.24.0-255,5738,41312,90,298458
3903,0.000214,172.31.47.0-255,66,41378,90,298458
3904,0.000244,74.125.24.0-255,9992,51370,90,298458
3905,0.000247,172.31.47.0-255,66,51436,90,298458
3906,0.000269,74.125.24.0-255,3961,55397,90,298458
3907,0.000271,172.31.47.0-255,66,55463,90,298458
3908,0.000301,74.125.24.0-255,9633,65096,90,298458
3909,0.000305,172.31.47.0-255,66,65162,90,298458
3910,0.000388,74.125.24.0-255,646,65808,90,298458
3911,0.000392,172.31.47.0-255,66,65874,90,298458
3912,0.000636,74.125.24.0-255,1484,67358,90,298458
3913,0.00064,172.31.47.0-255,66,67424,90,298458
3914,0.000644,74.125.24.0-255,2902,70326,90,298458
3915,0.000646,172.31.47.0-255,66,70392,90,298458
3916,0.000649,74.125.24.0-255,1484,71876,90,298458
3917,0.000672,74.125.24.0-255,4320,76196,90,298458
3918,0.000674,172.31.47.0-255,66,76262,90,298458
3919,0.000725,74.125.24.0-255,4320,80582,90,298458
3920,0.000728,172.31.47.0-255,66,80648,90,298458
3921,0.000752,74.125.24.0-255,1994,82642,90,298458
3922,0.000755,172.31.47.0-255,66,82708,90,298458
3923,0.000778,74.125.24.0-255,4320,87028,90,298458
3924,0.00078,172.31.47.0-255,66,87094,90,298458
3925,0.000791,74.125.24.0-255,2902,89996,90,298458
3926,0.000797,74.125.24.0-255,1484,91480,90,298458
3927,0.000799,172.31.47.0-255,66,91546,90,298458
3928,0.000832,74.125.24.0-255,8215,99761,90,298458
3929,0.000835,172.31.47.0-255,66,99827,90,298458
3930,0.000856,74.125.24.0-255,1484,101311,90,298458
3931,0.000872,74.125.24.0-255,2902,104213,90,298458
3932,0.000875,172.31.47.0-255,66,104279,90,298458
3933,0.000879,74.125.24.0-255,2902,107181,90,298458
3934,0.00088,172.31.47.0-255,66,107247,90,298458
3935,0.000902,74.125.24.0-255,2902,110149,90,298458
3936,0.000904,172.31.47.0-255,66,110215,90,298458
3937,0.000916,74.125.24.0-255,5738,115953,90,298458
3938,0.000918,172.31.47.0-255,66,116019,90,298458
3939,0.000937,74.125.24.0-255,1125,117144,90,298458
3940,0.001061,172.31.47.0-255,66,117210,90,298458
3941,0.00124,74.125.24.0-255,1484,118694,90,298458
3942,0.001249,74.125.24.0-255,2902,121596,90,298458
3943,0.001252,172.31.47.0-255,66,121662,90,298458
3944,0.001257,74.125.24.0-255,2902,124564,90,298458
3945,0.001259,172.31.47.0-255,66,124630,90,298458
3946,0.001281,74.125.24.0-255,2902,127532,90,298458
3947,0.001288,172.31.47.0-255,66,127598,90,298458
3948,0.001293,74.125.24.0-255,4320,131918,90,298458
3949,0.001295,172.31.47.0-255,66,131984,90,298458
3950,0.001333,74.125.24.0-255,8574,140558,90,298458
3951,0.001336,172.31.47.0-255,66,140624,90,298458
3952,0.001343,74.125.24.0-255,8574,149198,90,298458
3953,0.001344,172.31.47.0-255,66,149264,90,298458
3954,0.001361,74.125.24.0-255,2184,151448,90,298458
3955,0.001367,172.31.47.0-255,66,151514,90,298458
3956,0.001412,74.125.24.0-255,1484,152998,90,298458
3957,0.001423,74.125.24.0-255,2902,155900,90,298458
3958,0.001426,172.31.47.0-255,66,155966,90,298458
3959,0.001479,74.125.24.0-255,5738,161704,90,298458
3960,0.001482,172.31.47.0-255,66,161770,90,298458
3961,0.001498,172.31.47.0-255,66,161836,90,298458
3962,0.001512,74.125.24.0-255,4320,166156,90,298458
3963,0.001518,172.31.47.0-255,66,166222,90,298458
3964,0.001545,74.125.24.0-255,6438,172660,90,298458
3965,0.001548,172.31.47.0-255,66,172726,90,298458
3966,0.001594,74.125.24.0-255,1484,174210,90,298458
3967,0.001598,74.125.24.0-255,2902,177112,90,298458
3968,0.001601,172.31.47.0-255,66,177178,90,298458
3969,0.001627,74.125.24.0-255,4320,181498,90,298458
3970,0.00163,172.31.47.0-255,66,181564,90,298458
3971,0.001652,74.125.24.0-255,1484,183048,90,298458
3972,0.001663,74.125.24.0-255,7156,190204,90,298458
3973,0.001666,172.31.47.0-255,66,190270,90,298458
3974,0.001689,74.125.24.0-255,5738,196008,90,298458
3975,0.001692,172.31.47.0-255,66,196074,90,298458
3976,0.0017,74.125.24.0-255,10692,206766,90,298458
3977,0.001704,172.31.47.0-255,66,206832,90,298458
3978,0.001752,74.125.24.0-255,1484,208316,90,298458
3979,0.001768,74.125.24.0-255,2902,211218,90,298458
3980,0.001771,172.31.47.0-255,66,211284,90,298458
3981,0.001774,74.125.24.0-255,1484,212768,90,298458
3982,0.00178,74.125.24.0-255,5738,218506,90,298458
3983,0.001782,172.31.47.0-255,66,218572,90,298458
3984,0.001807,74.125.24.0-255,2902,221474,90,298458
3985,0.00181,172.31.47.0-255,66,221540,90,298458
3986,0.001843,74.125.24.0-255,9992,231532,90,298458
3987,0.001847,172.31.47.0-255,66,231598,90,298458
3988,0.001859,74.125.24.0-255,9274,240872,90,298458
3989,0.001861,172.31.47.0-255,66,240938,90,298458
3990,0.001909,74.125.24.0-255,1484,242422,90,298458
3991,0.001929,74.125.24.0-255,2902,245324,90,298458
3992,0.001931,172.31.47.0-255,66,245390,90,298458
3993,0.001934,74.125.24.0-255,1484,246874,90,298458
3994,0.00196,74.125.24.0-255,4320,251194,90,298458
3995,0.001962,172.31.47.0-255,66,251260,90,298458
3996,0.001973,74.125.24.0-255,4320,255580,90,298458
3997,0.001975,172.31.47.0-255,66,255646,90,298458
3998,0.002002,74.125.24.0-255,8574,264220,90,298458
3999,0.002004,172.31.47.0-255,66,264286,90,298458
4000,0.002006,74.125.24.0-255,1484,265770,90,298458
4001,0.002027,74.125.24.0-255,5738,271508,90,298458
4002,0.002029,172.31.47.0-255,66,271574,90,298458
4003,0.002053,74.125.24.0-255,3602,275176,90,298458
4004,0.002055,172.31.47.0-255,66,275242,90,298458
4005,0.003988,74.125.24.0-255,1484,276726,90,298458
4006,0.004029,74.125.24.0-255,4320,281046,90,298458
4007,0.004034,172.31.47.0-255,66,281112,90,298458
4008,0.006021,74.125.24.0-255,5738,286850,90,298458
4009,0.006029,172.31.47.0-255,66,286916,90,298458
4010,0.008008,74.125.24.0-255,5738,292654,90,298458
4011,0.008012,172.31.47.0-255,66,292720,90,298458
4012,0.009995,74.125.24.0-255,5738,298458,90,298458
4013,0.0,172.217.194.0-255,431,431,90,135038
4014,1.4e-05,172.217.194.0-255,1484,1915,90,135038
4015,2.2e-05,172.31.47.0-255,66,1981,90,135038
4016,3.1e-05,172.217.194.0-255,4320,6301,90,135038
4017,3.4e-05,172.31.47.0-255,66,6367,90,135038
4018,0.00018,172.217.194.0-255,8574,14941,90,135038
4019,0.000184,172.31.47.0-255,66,15007,90,135038
4020,0.000201,172.217.194.0-255,645,15652,90,135038
4021,0.00055,172.217.194.0-255,8574,24226,90,135038
4022,0.000556,172.31.47.0-255,66,24292,90,135038
4023,0.00089,172.217.194.0-255,5738,30030,90,135038
4024,0.000896,172.31.47.0-255,66,30096,90,135038
4025,0.00236,172.217.194.0-255,5738,35834,90,135038
4026,0.002366,172.31.47.0-255,66,35900,90,135038
4027,0.002495,172.217.194.0-255,2902,38802,90,135038
4028,0.002519,172.217.194.0-255,9992,48794,90,135038
4029,0.002975,172.217.194.0-255,5738,54532,90,135038
4030,0.003722,172.217.194.0-255,4320,58852,90,135038
4031,0.004135,172.31.47.0-255,66,58918,90,135038
4032,0.004391,172.217.194.0-255,7156,66074,90,135038
4033,0.004396,172.31.47.0-255,66,66140,90,135038
4034,0.004707,172.217.194.0-255,5738,71878,90,135038
4035,0.004712,172.31.47.0-255,66,71944,90,135038
4036,0.004741,172.217.194.0-255,5738,77682,90,135038
4037,0.004755,172.31.47.0-255,66,77748,90,135038
4038,0.006654,172.217.194.0-255,8574,86322,90,135038
4039,0.006676,172.217.194.0-255,9992,96314,90,135038
4040,0.007093,172.217.194.0-255,1484,97798,90,135038
4041,0.007268,172.217.194.0-255,4320,102118,90,135038
4042,0.007289,172.217.194.0-255,5738,107856,90,135038
4043,0.007315,172.217.194.0-255,8574,116430,90,135038
4044,0.00753,172.217.194.0-255,7156,123586,90,135038
4045,0.007753,172.217.194.0-255,5738,129324,90,135038
4046,0.007777,172.217.194.0-255,5648,134972,90,135038
4047,0.009792,172.31.47.0-255,66,135038,90,135038
4048,0.0,74.125.24.0-255,153,153,90,116923
4049,2.3e-05,172.31.47.0-255,66,219,90,116923
4050,2.9e-05,74.125.24.0-255,1484,1703,90,116923
4051,3.3e-05,172.31.47.0-255,66,1769,90,116923
4052,6.2e-05,74.125.24.0-255,2902,4671,90,116923
4053,6.5e-05,172.31.47.0-255,66,4737,90,116923
4054,7.2e-05,74.125.24.0-255,7156,11893,90,116923
4055,7.5e-05,172.31.47.0-255,66,11959,90,116923
4056,0.000117,74.125.24.0-255,2003,13962,90,116923
4057,0.000121,172.31.47.0-255,66,14028,90,116923
4058,0.000213,74.125.24.0-255,1484,15512,90,116923
4059,0.000216,172.31.47.0-255,66,15578,90,116923
4060,0.000221,74.125.24.0-255,2902,18480,90,116923
4061,0.000223,172.31.47.0-255,66,18546,90,116923
4062,0.000225,74.125.24.0-255,1484,20030,90,116923
4063,0.000227,172.31.47.0-255,66,20096,90,116923
4064,0.000256,74.125.24.0-255,4320,24416,90,116923
4065,0.00026,172.31.47.0-255,66,24482,90,116923
4066,0.000268,74.125.24.0-255,5738,30220,90,116923
4067,0.000271,172.31.47.0-255,66,30286,90,116923
4068,0.000292,74.125.24.0-255,1125,31411,90,116923
4069,0.000296,172.31.47.0-255,66,31477,90,116923
4070,0.000395,74.125.24.0-255,1484,32961,90,116923
4071,0.000399,172.31.47.0-255,66,33027,90,116923
4072,0.000404,74.125.24.0-255,2902,35929,90,116923
4073,0.000408,172.31.47.0-255,66,35995,90,116923
4074,0.000428,74.125.24.0-255,5738,41733,90,116923
4075,0.000432,172.31.47.0-255,66,41799,90,116923
4076,0.000468,74.125.24.0-255,5738,47537,90,116923
4077,0.000471,172.31.47.0-255,66,47603,90,116923
4078,0.000501,74.125.24.0-255,8215,55818,90,116923
4079,0.000505,172.31.47.0-255,66,55884,90,116923
4080,0.00051,74.125.24.0-255,2902,58786,90,116923
4081,0.000512,172.31.47.0-255,66,58852,90,116923
4082,0.000545,74.125.24.0-255,6797,65649,90,116923
4083,0.000548,172.31.47.0-255,66,65715,90,116923
4084,0.000917,74.125.24.0-255,646,66361,90,116923
4085,0.001187,74.125.24.0-255,1484,67845,90,116923
4086,0.001193,172.31.47.0-255,66,67911,90,116923
4087,0.001198,74.125.24.0-255,1484,69395,90,116923
4088,0.001221,74.125.24.0-255,1484,70879,90,116923
4089,0.001224,172.31.47.0-255,66,70945,90,116923
4090,0.001231,74.125.24.0-255,5738,76683,90,116923
4091,0.001233,172.31.47.0-255,66,76749,90,116923
4092,0.001235,74.125.24.0-255,1484,78233,90,116923
4093,0.001276,74.125.24.0-255,4320,82553,90,116923
4094,0.001279,172.31.47.0-255,66,82619,90,116923
4095,0.001308,74.125.24.0-255,4320,86939,90,116923
4096,0.001312,172.31.47.0-255,66,87005,90,116923
4097,0.001321,74.125.24.0-255,9992,96997,90,116923
4098,0.001323,172.31.47.0-255,66,97063,90,116923
4099,0.001326,74.125.24.0-255,1484,98547,90,116923
4100,0.00136,74.125.24.0-255,2184,100731,90,116923
4101,0.001363,172.31.47.0-255,66,100797,90,116923
4102,0.003677,74.125.24.0-255,1484,102281,90,116923
4103,0.003713,74.125.24.0-255,2902,105183,90,116923
4104,0.003717,172.31.47.0-255,66,105249,90,116923
4105,0.003728,74.125.24.0-255,1484,106733,90,116923
4106,0.006059,74.125.24.0-255,4320,111053,90,116923
4107,0.006063,172.31.47.0-255,66,111119,90,116923
4108,0.008409,74.125.24.0-255,5738,116857,90,116923
4109,0.008416,172.31.47.0-255,66,116923,90,116923
4110,0.0,172.217.194.0-255,155,155,90,247002
4111,2.2e-05,172.31.47.0-255,66,221,90,247002
4112,2.9e-05,172.217.194.0-255,1484,1705,90,247002
4113,3.3e-05,172.31.47.0-255,66,1771,90,247002
4114,3.8e-05,172.217.194.0-255,2902,4673,90,247002
4115,4.1e-05,172.31.47.0-255,66,4739,90,247002
4116,5.7e-05,172.217.194.0-255,7156,11895,90,247002
4117,6e-05,172.31.47.0-255,66,11961,90,247002
4118,6.3e-05,172.217.194.0-255,1484,13445,90,247002
4119,6.6e-05,172.31.47.0-255,66,13511,90,247002
4120,7.2e-05,172.217.194.0-255,4320,17831,90,247002
4121,7.5e-05,172.31.47.0-255,66,17897,90,247002
4122,0.000103,172.217.194.0-255,6300,24197,90,247002
4123,0.000107,172.31.47.0-255,66,24263,90,247002
4124,0.000113,172.217.194.0-255,6797,31060,90,247002
4125,0.000116,172.31.47.0-255,66,31126,90,247002
4126,0.000527,172.217.194.0-255,1484,32610,90,247002
4127,0.000532,172.31.47.0-255,66,32676,90,247002
4128,0.000539,172.217.194.0-255,2902,35578,90,247002
4129,0.000541,172.31.47.0-255,66,35644,90,247002
4130,0.000571,172.217.194.0-255,5738,41382,90,247002
4131,0.000575,172.31.47.0-255,66,41448,90,247002
4132,0.000604,172.31.47.0-255,66,41514,90,247002
4133,0.000609,172.217.194.0-255,4320,45834,90,247002
4134,0.000612,172.31.47.0-255,66,45900,90,247002
4135,0.000634,172.217.194.0-255,4320,50220,90,247002
4136,0.000637,172.31.47.0-255,66,50286,90,247002
4137,0.00064,172.217.194.0-255,1415,51701,90,247002
4138,0.000642,172.31.47.0-255,66,51767,90,247002
4139,0.00073,172.217.194.0-255,365,52132,90,247002
4140,0.000735,172.31.47.0-255,66,52198,90,247002
4141,0.000824,172.217.194.0-255,1484,53682,90,247002
4142,0.000844,172.217.194.0-255,2902,56584,90,247002
4143,0.000847,172.31.47.0-255,66,56650,90,247002
4144,0.000852,172.217.194.0-255,2902,59552,90,247002
4145,0.000854,172.31.47.0-255,66,59618,90,247002
4146,0.000877,172.217.194.0-255,1484,61102,90,247002
4147,0.000887,172.217.194.0-255,9633,70735,90,247002
4148,0.000893,172.31.47.0-255,66,70801,90,247002
4149,0.000941,172.217.194.0-255,9992,80793,90,247002
4150,0.000944,172.31.47.0-255,66,80859,90,247002
4151,0.000962,172.217.194.0-255,2902,83761,90,247002
4152,0.000965,172.31.47.0-255,66,83827,90,247002
4153,0.000969,172.217.194.0-255,2543,86370,90,247002
4154,0.000971,172.31.47.0-255,66,86436,90,247002
4155,0.001456,172.217.194.0-255,1484,87920,90,247002
4156,0.001462,172.217.194.0-255,2902,90822,90,247002
4157,0.001466,172.31.47.0-255,66,90888,90,247002
4158,0.001472,172.217.194.0-255,4320,95208,90,247002
4159,0.001474,172.31.47.0-255,66,95274,90,247002
4160,0.001498,172.217.194.0-255,1484,96758,90,247002
4161,0.001504,172.217.194.0-255,4320,101078,90,247002
4162,0.001506,172.31.47.0-255,66,101144,90,247002
4163,0.001534,172.217.194.0-255,8574,109718,90,247002
4164,0.001536,172.31.47.0-255,66,109784,90,247002
4165,0.001544,172.217.194.0-255,8574,118358,90,247002
4166,0.001546,172.31.47.0-255,66,118424,90,247002
4167,0.001575,172.217.194.0-255,2184,120608,90,247002
4168,0.001578,172.31.47.0-255,66,120674,90,247002
4169,0.001601,172.217.194.0-255,2902,123576,90,247002
4170,0.001603,172.31.47.0-255,66,123642,90,247002
4171,0.001608,172.217.194.0-255,2902,126544,90,247002
4172,0.00161,172.31.47.0-255,66,126610,90,247002
4173,0.001638,172.217.194.0-255,4320,130930,90,247002
4174,0.00164,172.31.47.0-255,66,130996,90,247002
4175,0.001653,172.31.47.0-255,66,131062,90,247002
4176,0.001675,172.217.194.0-255,1484,132546,90,247002
4177,0.00171,172.217.194.0-255,10692,143238,90,247002
4178,0.001713,172.31.47.0-255,66,143304,90,247002
4179,0.001735,172.217.194.0-255,1484,144788,90,247002
4180,0.001739,172.217.194.0-255,2902,147690,90,247002
4181,0.001741,172.31.47.0-255,66,147756,90,247002
4182,0.001779,172.217.194.0-255,5738,153494,90,247002
4183,0.001783,172.31.47.0-255,66,153560,90,247002
4184,0.00179,172.217.194.0-255,5738,159298,90,247002
4185,0.001792,172.31.47.0-255,66,159364,90,247002
4186,0.001803,172.217.194.0-255,7156,166520,90,247002
4187,0.001805,172.31.47.0-255,66,166586,90,247002
4188,0.001834,172.217.194.0-255,10692,177278,90,247002
4189,0.001837,172.31.47.0-255,66,177344,90,247002
4190,0.001925,172.217.194.0-255,1484,178828,90,247002
4191,0.00193,172.217.194.0-255,2902,181730,90,247002
4192,0.001934,172.31.47.0-255,66,181796,90,247002
4193,0.001939,172.217.194.0-255,2902,184698,90,247002
4194,0.001941,172.31.47.0-255,66,184764,90,247002
4195,0.00197,172.217.194.0-255,2902,187666,90,247002
4196,0.001973,172.31.47.0-255,66,187732,90,247002
4197,0.001985,172.31.47.0-255,66,187798,90,247002
4198,0.002017,172.217.194.0-255,2902,190700,90,247002
4199,0.00202,172.31.47.0-255,66,190766,90,247002
4200,0.002059,172.217.194.0-255,9274,200040,90,247002
4201,0.002062,172.31.47.0-255,66,200106,90,247002
4202,0.002066,172.217.194.0-255,2902,203008,90,247002
4203,0.002068,172.31.47.0-255,66,203074,90,247002
4204,0.002098,172.217.194.0-255,7156,210230,90,247002
4205,0.002119,172.31.47.0-255,66,210296,90,247002
4206,0.002122,172.31.47.0-255,66,210362,90,247002
4207,0.002181,172.31.47.0-255,66,210428,90,247002
4208,0.002187,172.217.194.0-255,3602,214030,90,247002
4209,0.002253,172.31.47.0-255,66,214096,90,247002
4210,0.002337,172.217.194.0-255,4320,218416,90,247002
4211,0.00235,172.31.47.0-255,66,218482,90,247002
4212,0.002379,172.31.47.0-255,66,218548,90,247002
4213,0.002408,172.217.194.0-255,7856,226404,90,247002
4214,0.002417,172.217.194.0-255,9992,236396,90,247002
4215,0.002432,172.31.47.0-255,66,236462,90,247002
4216,0.00473,172.217.194.0-255,5738,242200,90,247002
4217,0.004738,172.31.47.0-255,66,242266,90,247002
4218,0.007034,172.217.194.0-255,4565,246831,90,247002
4219,0.00704,172.31.47.0-255,66,246897,90,247002
4220,0.009848,172.31.47.0-255,105,247002,90,247002
4221,0.0,172.217.24.0-255,143,143,90,147755
4222,3.3e-05,172.31.47.0-255,66,209,90,147755
4223,4e-05,172.217.24.0-255,1484,1693,90,147755
4224,4.5e-05,172.31.47.0-255,66,1759,90,147755
4225,4.9e-05,172.217.24.0-255,2902,4661,90,147755
4226,5.1e-05,172.31.47.0-255,66,4727,90,147755
4227,5.5e-05,172.217.24.0-255,2902,7629,90,147755
4228,5.8e-05,172.31.47.0-255,66,7695,90,147755
4229,6.4e-05,172.217.24.0-255,4320,12015,90,147755
4230,6.6e-05,172.31.47.0-255,66,12081,90,147755
4231,9.1e-05,172.217.24.0-255,2022,14103,90,147755
4232,9.4e-05,172.31.47.0-255,66,14169,90,147755
4233,0.000144,172.217.24.0-255,2902,17071,90,147755
4234,0.000147,172.31.47.0-255,66,17137,90,147755
4235,0.000151,172.217.24.0-255,1484,18621,90,147755
4236,0.000153,172.31.47.0-255,66,18687,90,147755
4237,0.000165,172.217.24.0-255,2902,21589,90,147755
4238,0.000167,172.31.47.0-255,66,21655,90,147755
4239,0.000172,172.217.24.0-255,4320,25975,90,147755
4240,0.000175,172.31.47.0-255,66,26041,90,147755
4241,0.000201,172.217.24.0-255,4320,30361,90,147755
4242,0.000203,172.31.47.0-255,66,30427,90,147755
4243,0.000206,172.217.24.0-255,1125,31552,90,147755
4244,0.000208,172.31.47.0-255,66,31618,90,147755
4245,0.000211,172.217.24.0-255,1484,33102,90,147755
4246,0.000213,172.31.47.0-255,66,33168,90,147755
4247,0.000218,172.217.24.0-255,4320,37488,90,147755
4248,0.00022,172.31.47.0-255,66,37554,90,147755
4249,0.000225,172.217.24.0-255,2902,40456,90,147755
4250,0.000227,172.31.47.0-255,66,40522,90,147755
4251,0.000254,172.217.24.0-255,7156,47678,90,147755
4252,0.000256,172.31.47.0-255,66,47744,90,147755
4253,0.000259,172.217.24.0-255,1125,48869,90,147755
4254,0.000282,172.217.24.0-255,1484,50353,90,147755
4255,0.000285,172.31.47.0-255,66,50419,90,147755
4256,0.000306,172.217.24.0-255,4320,54739,90,147755
4257,0.000309,172.31.47.0-255,66,54805,90,147755
4258,0.000315,172.217.24.0-255,5738,60543,90,147755
4259,0.000318,172.31.47.0-255,66,60609,90,147755
4260,0.000352,172.217.24.0-255,2902,63511,90,147755
4261,0.000357,172.31.47.0-255,66,63577,90,147755
4262,0.000369,172.217.24.0-255,2543,66120,90,147755
4263,0.000372,172.31.47.0-255,66,66186,90,147755
4264,0.000374,172.217.24.0-255,360,66546,90,147755
4265,0.000807,172.31.47.0-255,66,66612,90,147755
4266,0.001008,172.217.24.0-255,135,66747,90,147755
4267,0.00112,172.217.24.0-255,1484,68231,90,147755
4268,0.001125,172.31.47.0-255,66,68297,90,147755
4269,0.001132,172.217.24.0-255,2902,71199,90,147755
4270,0.001133,172.31.47.0-255,66,71265,90,147755
4271,0.001136,172.217.24.0-255,1484,72749,90,147755
4272,0.001151,172.217.24.0-255,4320,77069,90,147755
4273,0.001154,172.31.47.0-255,66,77135,90,147755
4274,0.001158,172.217.24.0-255,2902,80037,90,147755
4275,0.00116,172.31.47.0-255,66,80103,90,147755
4276,0.001176,172.217.24.0-255,3961,84064,90,147755
4277,0.001178,172.31.47.0-255,66,84130,90,147755
4278,0.001202,172.217.24.0-255,1484,85614,90,147755
4279,0.001224,172.217.24.0-255,2902,88516,90,147755
4280,0.001227,172.31.47.0-255,66,88582,90,147755
4281,0.001234,172.217.24.0-255,5738,94320,90,147755
4282,0.001235,172.31.47.0-255,66,94386,90,147755
4283,0.00127,172.217.24.0-255,4320,98706,90,147755
4284,0.001273,172.31.47.0-255,66,98772,90,147755
4285,0.001285,172.217.24.0-255,2543,101315,90,147755
4286,0.001288,172.31.47.0-255,66,101381,90,147755
4287,0.00186,172.217.24.0-255,1484,102865,90,147755
4288,0.001866,172.217.24.0-255,2902,105767,90,147755
4289,0.00187,172.31.47.0-255,66,105833,90,147755
4290,0.001874,172.217.24.0-255,1484,107317,90,147755
4291,0.001887,172.217.24.0-255,4320,111637,90,147755
4292,0.001889,172.31.47.0-255,66,111703,90,147755
4293,0.001909,172.217.24.0-255,1484,113187,90,147755
4294,0.001935,172.31.47.0-255,66,113253,90,147755
4295,0.00194,172.217.24.0-255,5738,118991,90,147755
4296,0.001942,172.31.47.0-255,66,119057,90,147755
4297,0.001952,172.217.24.0-255,1484,120541,90,147755
4298,0.001972,172.217.24.0-255,1484,122025,90,147755
4299,0.001974,172.31.47.0-255,66,122091,90,147755
4300,0.00199,172.217.24.0-255,2184,124275,90,147755
4301,0.001992,172.31.47.0-255,66,124341,90,147755
4302,0.003946,172.217.24.0-255,2902,127243,90,147755
4303,0.00395,172.31.47.0-255,66,127309,90,147755
4304,0.003969,172.217.24.0-255,2902,130211,90,147755
4305,0.003971,172.31.47.0-255,66,130277,90,147755
4306,0.005921,172.217.24.0-255,1484,131761,90,147755
4307,0.005943,172.217.24.0-255,4320,136081,90,147755
4308,0.005947,172.31.47.0-255,66,136147,90,147755
4309,0.007931,172.217.24.0-255,5738,141885,90,147755
4310,0.007938,172.31.47.0-255,66,141951,90,147755
4311,0.009925,172.217.24.0-255,5738,147689,90,147755
4312,0.009932,172.31.47.0-255,66,147755,90,147755
4313,0.0,172.217.194.0-255,153,153,90,323257
4314,2.8e-05,172.31.47.0-255,66,219,90,323257
4315,3.5e-05,172.217.194.0-255,1484,1703,90,323257
4316,3.9e-05,172.31.47.0-255,66,1769,90,323257
4317,4.3e-05,172.217.194.0-255,2902,4671,90,323257
4318,4.5e-05,172.31.47.0-255,66,4737,90,323257
4319,5.2e-05,172.217.194.0-255,7156,11893,90,323257
4320,5.5e-05,172.31.47.0-255,66,11959,90,323257
4321,8.8e-05,172.217.194.0-255,5738,17697,90,323257
4322,9.1e-05,172.31.47.0-255,66,17763,90,323257
4323,0.000117,172.217.194.0-255,10520,28283,90,323257
4324,0.000119,172.31.47.0-255,66,28349,90,323257
4325,0.000124,172.217.194.0-255,2543,30892,90,323257
4326,0.000126,172.31.47.0-255,66,30958,90,323257
4327,0.000146,172.217.194.0-255,2902,33860,90,323257
4328,0.000148,172.31.47.0-255,66,33926,90,323257
4329,0.000167,172.217.194.0-255,5738,39664,90,323257
4330,0.00017,172.31.47.0-255,66,39730,90,323257
4331,0.000195,172.217.194.0-255,1484,41214,90,323257
4332,0.000197,172.31.47.0-255,66,41280,90,323257
4333,0.000203,172.217.194.0-255,5738,47018,90,323257
4334,0.000205,172.31.47.0-255,66,47084,90,323257
4335,0.000219,172.217.194.0-255,1125,48209,90,323257
4336,0.000221,172.31.47.0-255,66,48275,90,323257
4337,0.000581,172.217.194.0-255,1484,49759,90,323257
4338,0.000586,172.31.47.0-255,66,49825,90,323257
4339,0.000591,172.217.194.0-255,2902,52727,90,323257
4340,0.000594,172.31.47.0-255,66,52793,90,323257
4341,0.000618,172.217.194.0-255,5738,58531,90,323257
4342,0.000621,172.31.47.0-255,66,58597,90,323257
4343,0.000637,172.217.194.0-255,1484,60081,90,323257
4344,0.000639,172.31.47.0-255,66,60147,90,323257
4345,0.000659,172.217.194.0-255,5694,65841,90,323257
4346,0.000673,172.31.47.0-255,66,65907,90,323257
4347,0.000852,172.217.194.0-255,364,66271,90,323257
4348,0.000881,172.31.47.0-255,66,66337,90,323257
4349,0.000999,172.217.194.0-255,1484,67821,90,323257
4350,0.001016,172.217.194.0-255,2902,70723,90,323257
4351,0.00102,172.217.194.0-255,1484,72207,90,323257
4352,0.001038,172.217.194.0-255,4320,76527,90,323257
4353,0.001042,172.217.194.0-255,2902,79429,90,323257
4354,0.001051,172.31.47.0-255,66,79495,90,323257
4355,0.001062,172.217.194.0-255,3961,83456,90,323257
4356,0.001064,172.217.194.0-255,1484,84940,90,323257
4357,0.001069,172.31.47.0-255,66,85006,90,323257
4358,0.001079,172.217.194.0-255,5738,90744,90,323257
4359,0.001123,172.217.194.0-255,9633,100377,90,323257
4360,0.001148,172.31.47.0-255,66,100443,90,323257
4361,0.001236,172.217.194.0-255,1484,101927,90,323257
4362,0.001252,172.217.194.0-255,1484,103411,90,323257
4363,0.001256,172.217.194.0-255,2902,106313,90,323257
4364,0.001258,172.217.194.0-255,1484,107797,90,323257
4365,0.00127,172.217.194.0-255,4320,112117,90,323257
4366,0.001276,172.31.47.0-255,66,112183,90,323257
4367,0.001287,172.217.194.0-255,4320,116503,90,323257
4368,0.001306,172.217.194.0-255,5738,122241,90,323257
4369,0.001327,172.217.194.0-255,2902,125143,90,323257
4370,0.001332,172.217.194.0-255,4320,129463,90,323257
4371,0.001344,172.31.47.0-255,66,129529,90,323257
4372,0.00136,172.217.194.0-255,4320,133849,90,323257
4373,0.001372,172.217.194.0-255,766,134615,90,323257
4374,0.001376,172.217.194.0-255,4320,138935,90,323257
4375,0.001378,172.31.47.0-255,66,139001,90,323257
4376,0.001383,172.217.194.0-255,1484,140485,90,323257
4377,0.001389,172.31.47.0-255,66,140551,90,323257
4378,0.001398,172.217.194.0-255,7156,147707,90,323257
4379,0.001412,172.31.47.0-255,66,147773,90,323257
4380,0.001422,172.217.194.0-255,5738,153511,90,323257
4381,0.001429,172.217.194.0-255,9992,163503,90,323257
4382,0.001432,172.31.47.0-255,66,163569,90,323257
4383,0.001468,172.217.194.0-255,5738,169307,90,323257
4384,0.001483,172.217.194.0-255,6438,175745,90,323257
4385,0.001486,172.217.194.0-255,2902,178647,90,323257
4386,0.001488,172.31.47.0-255,66,178713,90,323257
4387,0.001498,172.217.194.0-255,8574,187287,90,323257
4388,0.001506,172.31.47.0-255,66,187353,90,323257
4389,0.001509,172.217.194.0-255,1484,188837,90,323257
4390,0.001512,172.217.194.0-255,2902,191739,90,323257
4391,0.001529,172.217.194.0-255,8574,200313,90,323257
4392,0.00154,172.217.194.0-255,2184,202497,90,323257
4393,0.001547,172.31.47.0-255,66,202563,90,323257
4394,0.001564,172.217.194.0-255,1484,204047,90,323257
4395,0.001601,172.217.194.0-255,8574,212621,90,323257
4396,0.001609,172.31.47.0-255,66,212687,90,323257
4397,0.00162,172.217.194.0-255,8574,221261,90,323257
4398,0.001621,172.217.194.0-255,766,222027,90,323257
4399,0.001627,172.31.47.0-255,66,222093,90,323257
4400,0.002052,172.217.194.0-255,1484,223577,90,323257
4401,0.002056,172.217.194.0-255,1484,225061,90,323257
4402,0.002058,172.31.47.0-255,66,225127,90,323257
4403,0.002075,172.217.194.0-255,1484,226611,90,323257
4404,0.002081,172.217.194.0-255,5738,232349,90,323257
4405,0.002084,172.31.47.0-255,66,232415,90,323257
4406,0.002111,172.217.194.0-255,9992,242407,90,323257
4407,0.002121,172.31.47.0-255,66,242473,90,323257
4408,0.002131,172.217.194.0-255,2902,245375,90,323257
4409,0.002139,172.217.194.0-255,10692,256067,90,323257
4410,0.002154,172.31.47.0-255,66,256133,90,323257
4411,0.00218,172.217.194.0-255,1484,257617,90,323257
4412,0.002199,172.217.194.0-255,2902,260519,90,323257
4413,0.002227,172.217.194.0-255,1484,262003,90,323257
4414,0.002237,172.31.47.0-255,66,262069,90,323257
4415,0.002249,172.217.194.0-255,4320,266389,90,323257
4416,0.002255,172.217.194.0-255,7156,273545,90,323257
4417,0.002261,172.217.194.0-255,8574,282119,90,323257
4418,0.002263,172.217.194.0-255,1484,283603,90,323257
4419,0.002279,172.217.194.0-255,6438,290041,90,323257
4420,0.002296,172.31.47.0-255,66,290107,90,323257
4421,0.002363,172.217.194.0-255,1484,291591,90,323257
4422,0.00238,172.217.194.0-255,2902,294493,90,323257
4423,0.002382,172.217.194.0-255,1484,295977,90,323257
4424,0.002386,172.31.47.0-255,66,296043,90,323257
4425,0.002403,172.217.194.0-255,4320,300363,90,323257
4426,0.002405,172.217.194.0-255,1484,301847,90,323257
4427,0.002411,172.31.47.0-255,66,301913,90,323257
4428,0.002448,172.217.194.0-255,7156,309069,90,323257
4429,0.002452,172.31.47.0-255,66,309135,90,323257
4430,0.002469,172.217.194.0-255,2902,312037,90,323257
4431,0.002473,172.31.47.0-255,66,312103,90,323257
4432,0.002479,172.217.194.0-255,766,312869,90,323257
4433,0.003295,172.31.47.0-255,66,312935,90,323257
4434,0.00502,172.217.194.0-255,1484,314419,90,323257
4435,0.005045,172.217.194.0-255,2902,317321,90,323257
4436,0.005061,172.31.47.0-255,66,317387,90,323257
4437,0.00587,172.217.194.0-255,1484,318871,90,323257
4438,0.007646,172.217.194.0-255,4320,323191,90,323257
4439,0.007652,172.31.47.0-255,66,323257,90,323257
4440,0.0,172.217.194.0-255,153,153,90,256218
4441,2.2e-05,172.31.47.0-255,66,219,90,256218
4442,3e-05,172.217.194.0-255,1484,1703,90,256218
4443,3.5e-05,172.31.47.0-255,66,1769,90,256218
4444,4e-05,172.217.194.0-255,2902,4671,90,256218
4445,5.1e-05,172.31.47.0-255,66,4737,90,256218
4446,6e-05,172.217.194.0-255,7156,11893,90,256218
4447,6.3e-05,172.31.47.0-255,66,11959,90,256218
4448,6.7e-05,172.217.194.0-255,2044,14003,90,256218
4449,7e-05,172.31.47.0-255,66,14069,90,256218
4450,0.000142,172.217.194.0-255,1484,15553,90,256218
4451,0.000145,172.31.47.0-255,66,15619,90,256218
4452,0.00015,172.217.194.0-255,2902,18521,90,256218
4453,0.000152,172.31.47.0-255,66,18587,90,256218
4454,0.000156,172.217.194.0-255,1484,20071,90,256218
4455,0.000163,172.31.47.0-255,66,20137,90,256218
4456,0.000193,172.217.194.0-255,4320,24457,90,256218
4457,0.000196,172.31.47.0-255,66,24523,90,256218
4458,0.000249,172.31.47.0-255,66,24589,90,256218
4459,0.000269,172.31.47.0-255,66,24655,90,256218
4460,0.000277,172.217.194.0-255,8574,33229,90,256218
4461,0.00028,172.31.47.0-255,66,33295,90,256218
4462,0.000312,172.217.194.0-255,3602,36897,90,256218
4463,0.000315,172.31.47.0-255,66,36963,90,256218
4464,0.000318,172.217.194.0-255,380,37343,90,256218
4465,0.00032,172.31.47.0-255,66,37409,90,256218
4466,0.000341,172.217.194.0-255,98,37507,90,256218
4467,0.000343,172.31.47.0-255,66,37573,90,256218
4468,0.000427,172.217.194.0-255,1484,39057,90,256218
4469,0.000431,172.31.47.0-255,66,39123,90,256218
4470,0.000438,172.217.194.0-255,2902,42025,90,256218
4471,0.00044,172.31.47.0-255,66,42091,90,256218
4472,0.000445,172.217.194.0-255,2902,44993,90,256218
4473,0.000447,172.31.47.0-255,66,45059,90,256218
4474,0.000474,172.217.194.0-255,2902,47961,90,256218
4475,0.000483,172.31.47.0-255,66,48027,90,256218
4476,0.000493,172.217.194.0-255,9992,58019,90,256218
4477,0.000495,172.31.47.0-255,66,58085,90,256218
4478,0.000523,172.217.194.0-255,4320,62405,90,256218
4479,0.000525,172.31.47.0-255,66,62471,90,256218
4480,0.000561,172.217.194.0-255,8990,71461,90,256218
4481,0.000564,172.31.47.0-255,66,71527,90,256218
4482,0.000603,172.217.194.0-255,1484,73011,90,256218
4483,0.000619,172.217.194.0-255,2902,75913,90,256218
4484,0.000622,172.31.47.0-255,66,75979,90,256218
4485,0.000647,172.217.194.0-255,5738,81717,90,256218
4486,0.00065,172.31.47.0-255,66,81783,90,256218
4487,0.000653,172.217.194.0-255,1484,83267,90,256218
4488,0.00069,172.31.47.0-255,66,83333,90,256218
4489,0.000699,172.217.194.0-255,8574,91907,90,256218
4490,0.000706,172.31.47.0-255,66,91973,90,256218
4491,0.000731,172.217.194.0-255,2184,94157,90,256218
4492,0.000735,172.31.47.0-255,66,94223,90,256218
4493,0.000807,172.217.194.0-255,1484,95707,90,256218
4494,0.000812,172.217.194.0-255,2902,98609,90,256218
4495,0.000815,172.217.194.0-255,2902,101511,90,256218
4496,0.000821,172.31.47.0-255,66,101577,90,256218
4497,0.000829,172.31.47.0-255,66,101643,90,256218
4498,0.000837,172.217.194.0-255,2902,104545,90,256218
4499,0.00084,172.31.47.0-255,66,104611,90,256218
4500,0.000882,172.31.47.0-255,66,104677,90,256218
4501,0.000892,172.217.194.0-255,10692,115369,90,256218
4502,0.000895,172.31.47.0-255,66,115435,90,256218
4503,0.000932,172.31.47.0-255,66,115501,90,256218
4504,0.000935,172.217.194.0-255,1484,116985,90,256218
4505,0.000978,172.217.194.0-255,4320,121305,90,256218
4506,0.000983,172.31.47.0-255,66,121371,90,256218
4507,0.000986,172.31.47.0-255,66,121437,90,256218
4508,0.001012,172.217.194.0-255,5020,126457,90,256218
4509,0.001016,172.31.47.0-255,66,126523,90,256218
4510,0.001025,172.217.194.0-255,9992,136515,90,256218
4511,0.001027,172.31.47.0-255,66,136581,90,256218
4512,0.001125,172.31.47.0-255,66,136647,90,256218
4513,0.001176,172.217.194.0-255,1484,138131,90,256218
4514,0.00118,172.217.194.0-255,2902,141033,90,256218
4515,0.0012,172.217.194.0-255,5738,146771,90,256218
4516,0.001208,172.31.47.0-255,66,146837,90,256218
4517,0.001245,172.217.194.0-255,9992,156829,90,256218
4518,0.001267,172.217.194.0-255,766,157595,90,256218
4519,0.001281,172.31.47.0-255,66,157661,90,256218
4520,0.00148,172.217.194.0-255,1484,159145,90,256218
4521,0.001486,172.217.194.0-255,2902,162047,90,256218
4522,0.00149,172.31.47.0-255,66,162113,90,256218
4523,0.001494,172.217.194.0-255,1484,163597,90,256218
4524,0.001525,172.217.194.0-255,4320,167917,90,256218
4525,0.001545,172.217.194.0-255,9992,177909,90,256218
4526,0.001568,172.217.194.0-255,766,178675,90,256218
4527,0.001575,172.31.47.0-255,66,178741,90,256218
4528,0.001597,172.217.194.0-255,1484,180225,90,256218
4529,0.001614,172.217.194.0-255,4320,184545,90,256218
4530,0.001617,172.217.194.0-255,1484,186029,90,256218
4531,0.001621,172.31.47.0-255,66,186095,90,256218
4532,0.001658,172.217.194.0-255,8574,194669,90,256218
4533,0.001666,172.217.194.0-255,7156,201825,90,256218
4534,0.001682,172.31.47.0-255,66,201891,90,256218
4535,0.001692,172.217.194.0-255,2902,204793,90,256218
4536,0.001714,172.217.194.0-255,7856,212649,90,256218
4537,0.001731,172.217.194.0-255,1484,214133,90,256218
4538,0.001744,172.31.47.0-255,66,214199,90,256218
4539,0.001754,172.217.194.0-255,9992,224191,90,256218
4540,0.001766,172.217.194.0-255,8574,232765,90,256218
4541,0.001773,172.31.47.0-255,66,232831,90,256218
4542,0.001809,172.217.194.0-255,7156,239987,90,256218
4543,0.001814,172.31.47.0-255,66,240053,90,256218
4544,0.001832,172.217.194.0-255,6438,246491,90,256218
4545,0.001853,172.217.194.0-255,2902,249393,90,256218
4546,0.001888,172.31.47.0-255,66,249459,90,256218
4547,0.001908,172.217.194.0-255,6417,255876,90,256218
4548,0.001912,172.217.194.0-255,105,255981,90,256218
4549,0.001964,172.31.47.0-255,66,256047,90,256218
4550,0.004659,172.31.47.0-255,105,256152,90,256218
4551,0.006623,172.217.194.0-255,66,256218,90,256218
4552,0.0,172.31.47.0-255,236,236,90,302
4553,0.006817,74.125.68.0-255,66,302,90,302
4554,0.0,172.217.194.0-255,150,150,90,185382
4555,3.3e-05,172.31.47.0-255,66,216,90,185382
4556,3.9e-05,172.217.194.0-255,1484,1700,90,185382
4557,4.3e-05,172.31.47.0-255,66,1766,90,185382
4558,4.8e-05,172.217.194.0-255,2902,4668,90,185382
4559,5e-05,172.31.47.0-255,66,4734,90,185382
4560,6.4e-05,172.217.194.0-255,7156,11890,90,185382
4561,6.6e-05,172.31.47.0-255,66,11956,90,185382
4562,6.9e-05,172.217.194.0-255,1484,13440,90,185382
4563,7.1e-05,172.31.47.0-255,66,13506,90,185382
4564,0.000102,172.217.194.0-255,4791,18297,90,185382
4565,0.000105,172.31.47.0-255,66,18363,90,185382
4566,0.000132,172.217.194.0-255,7156,25519,90,185382
4567,0.000134,172.31.47.0-255,66,25585,90,185382
4568,0.000164,172.217.194.0-255,5379,30964,90,185382
4569,0.000167,172.31.47.0-255,66,31030,90,185382
4570,0.000171,172.217.194.0-255,2902,33932,90,185382
4571,0.000173,172.31.47.0-255,66,33998,90,185382
4572,0.000205,172.217.194.0-255,9992,43990,90,185382
4573,0.000208,172.31.47.0-255,66,44056,90,185382
4574,0.000233,172.217.194.0-255,3961,48017,90,185382
4575,0.000236,172.31.47.0-255,66,48083,90,185382
4576,0.000848,172.217.194.0-255,1484,49567,90,185382
4577,0.000854,172.31.47.0-255,66,49633,90,185382
4578,0.000862,172.217.194.0-255,2902,52535,90,185382
4579,0.000865,172.31.47.0-255,66,52601,90,185382
4580,0.000877,172.217.194.0-255,5738,58339,90,185382
4581,0.000879,172.31.47.0-255,66,58405,90,185382
4582,0.000881,172.217.194.0-255,1484,59889,90,185382
4583,0.000883,172.31.47.0-255,66,59955,90,185382
4584,0.000919,172.217.194.0-255,5379,65334,90,185382
4585,0.000922,172.31.47.0-255,66,65400,90,185382
4586,0.000945,172.217.194.0-255,4320,69720,90,185382
4587,0.000948,172.31.47.0-255,66,69786,90,185382
4588,0.000974,172.217.194.0-255,2902,72688,90,185382
4589,0.000976,172.31.47.0-255,66,72754,90,185382
4590,0.000984,172.217.194.0-255,8574,81328,90,185382
4591,0.000985,172.31.47.0-255,66,81394,90,185382
4592,0.000994,172.217.194.0-255,1705,83099,90,185382
4593,0.000997,172.31.47.0-255,66,83165,90,185382
4594,0.001001,172.217.194.0-255,2902,86067,90,185382
4595,0.001002,172.31.47.0-255,66,86133,90,185382
4596,0.00101,172.217.194.0-255,7156,93289,90,185382
4597,0.001012,172.31.47.0-255,66,93355,90,185382
4598,0.001035,172.217.194.0-255,4320,97675,90,185382
4599,0.001038,172.31.47.0-255,66,97741,90,185382
4600,0.001062,172.217.194.0-255,2543,100284,90,185382
4601,0.001066,172.31.47.0-255,66,100350,90,185382
4602,0.001311,172.217.194.0-255,1484,101834,90,185382
4603,0.001318,172.217.194.0-255,2902,104736,90,185382
4604,0.00132,172.31.47.0-255,66,104802,90,185382
4605,0.001323,172.217.194.0-255,1484,106286,90,185382
4606,0.001348,172.217.194.0-255,4320,110606,90,185382
4607,0.001351,172.31.47.0-255,66,110672,90,185382
4608,0.001358,172.217.194.0-255,6234,116906,90,185382
4609,0.00136,172.31.47.0-255,66,116972,90,185382
4610,0.001744,172.217.194.0-255,1484,118456,90,185382
4611,0.001765,172.217.194.0-255,2902,121358,90,185382
4612,0.001768,172.31.47.0-255,66,121424,90,185382
4613,0.001793,172.217.194.0-255,5738,127162,90,185382
4614,0.001795,172.31.47.0-255,66,127228,90,185382
4615,0.00182,172.217.194.0-255,5738,132966,90,185382
4616,0.001822,172.31.47.0-255,66,133032,90,185382
4617,0.001842,172.217.194.0-255,4320,137352,90,185382
4618,0.001844,172.31.47.0-255,66,137418,90,185382
4619,0.001855,172.31.47.0-255,66,137484,90,185382
4620,0.001874,172.217.194.0-255,2184,139668,90,185382
4621,0.001876,172.31.47.0-255,66,139734,90,185382
4622,0.0026,172.217.194.0-255,1484,141218,90,185382
4623,0.002611,172.217.194.0-255,2902,144120,90,185382
4624,0.002614,172.31.47.0-255,66,144186,90,185382
4625,0.002642,172.217.194.0-255,5738,149924,90,185382
4626,0.002644,172.31.47.0-255,66,149990,90,185382
4627,0.002648,172.217.194.0-255,2902,152892,90,185382
4628,0.00265,172.31.47.0-255,66,152958,90,185382
4629,0.002692,172.217.194.0-255,9992,162950,90,185382
4630,0.002695,172.31.47.0-255,66,163016,90,185382
4631,0.002704,172.217.194.0-255,10692,173708,90,185382
4632,0.002711,172.31.47.0-255,66,173774,90,185382
4633,0.005336,172.217.194.0-255,5738,179512,90,185382
4634,0.005341,172.31.47.0-255,66,179578,90,185382
4635,0.007977,172.217.194.0-255,5738,185316,90,185382
4636,0.007984,172.31.47.0-255,66,185382,90,185382
4637,0.0,74.125.130.0-255,226,226,90,79782
4638,2.3e-05,172.31.47.0-255,66,292,90,79782
4639,2.9e-05,74.125.130.0-255,1484,1776,90,79782
4640,3.3e-05,172.31.47.0-255,66,1842,90,79782
4641,6.5e-05,74.125.130.0-255,2902,4744,90,79782
4642,6.7e-05,172.31.47.0-255,66,4810,90,79782
4643,8.3e-05,74.125.130.0-255,1484,6294,90,79782
4644,8.5e-05,172.31.47.0-255,66,6360,90,79782
4645,0.000235,74.125.130.0-255,2902,9262,90,79782
4646,0.000239,172.31.47.0-255,66,9328,90,79782
4647,0.000254,74.125.130.0-255,4320,13648,90,79782
4648,0.000257,172.31.47.0-255,66,13714,90,79782
4649,0.00051,74.125.130.0-255,6427,20141,90,79782
4650,0.000515,172.31.47.0-255,66,20207,90,79782
4651,0.00076,74.125.130.0-255,2902,23109,90,79782
4652,0.000765,172.31.47.0-255,66,23175,90,79782
4653,0.000786,74.125.130.0-255,8215,31390,90,79782
4654,0.000789,172.31.47.0-255,66,31456,90,79782
4655,0.001213,74.125.130.0-255,4320,35776,90,79782
4656,0.001217,172.31.47.0-255,66,35842,90,79782
4657,0.001233,74.125.130.0-255,5738,41580,90,79782
4658,0.001236,172.31.47.0-255,66,41646,90,79782
4659,0.001252,74.125.130.0-255,9633,51279,90,79782
4660,0.001255,172.31.47.0-255,66,51345,90,79782
4661,0.00197,74.125.130.0-255,4320,55665,90,79782
4662,0.001973,172.31.47.0-255,66,55731,90,79782
4663,0.001992,74.125.130.0-255,3267,58998,90,79782
4664,0.002298,74.125.130.0-255,3042,62040,90,79782
4665,0.002984,172.31.47.0-255,66,62106,90,79782
4666,0.005275,74.125.130.0-255,5738,67844,90,79782
4667,0.005283,172.31.47.0-255,66,67910,90,79782
4668,0.007559,74.125.130.0-255,2902,70812,90,79782
4669,0.007566,172.31.47.0-255,66,70878,90,79782
4670,0.007586,74.125.130.0-255,2902,73780,90,79782
4671,0.007589,172.31.47.0-255,66,73846,90,79782
4672,0.009843,74.125.130.0-255,2902,76748,90,79782
4673,0.009849,172.31.47.0-255,66,76814,90,79782
4674,0.009886,74.125.130.0-255,2902,79716,90,79782
4675,0.00989,172.31.47.0-255,66,79782,90,79782
4676,0.0,172.217.194.0-255,153,153,90,301828
4677,1.9e-05,172.31.47.0-255,66,219,90,301828
4678,2.5e-05,172.217.194.0-255,1484,1703,90,301828
4679,3e-05,172.31.47.0-255,66,1769,90,301828
4680,3.6e-05,172.217.194.0-255,2902,4671,90,301828
4681,4.7e-05,172.31.47.0-255,66,4737,90,301828
4682,5.4e-05,172.217.194.0-255,7156,11893,90,301828
4683,5.8e-05,172.31.47.0-255,66,11959,90,301828
4684,6.1e-05,172.217.194.0-255,2046,14005,90,301828
4685,6.4e-05,172.31.47.0-255,66,14071,90,301828
4686,6.8e-05,172.217.194.0-255,2902,16973,90,301828
4687,7.1e-05,172.31.47.0-255,66,17039,90,301828
4688,0.000102,172.217.194.0-255,8574,25613,90,301828
4689,0.00011,172.31.47.0-255,66,25679,90,301828
4690,0.000113,172.217.194.0-255,1484,27163,90,301828
4691,0.000115,172.31.47.0-255,66,27229,90,301828
4692,0.000151,172.217.194.0-255,3961,31190,90,301828
4693,0.000155,172.31.47.0-255,66,31256,90,301828
4694,0.000197,172.217.194.0-255,1484,32740,90,301828
4695,0.0002,172.31.47.0-255,66,32806,90,301828
4696,0.000204,172.217.194.0-255,2902,35708,90,301828
4697,0.000206,172.31.47.0-255,66,35774,90,301828
4698,0.00025,172.217.194.0-255,5738,41512,90,301828
4699,0.000253,172.31.47.0-255,66,41578,90,301828
4700,0.000261,172.217.194.0-255,6797,48375,90,301828
4701,0.000263,172.31.47.0-255,66,48441,90,301828
4702,0.000268,172.217.194.0-255,4320,52761,90,301828
4703,0.00027,172.31.47.0-255,66,52827,90,301828
4704,0.000301,172.217.194.0-255,2902,55729,90,301828
4705,0.000303,172.31.47.0-255,66,55795,90,301828
4706,0.000307,172.217.194.0-255,2902,58697,90,301828
4707,0.00031,172.31.47.0-255,66,58763,90,301828
4708,0.000333,172.217.194.0-255,7085,65848,90,301828
4709,0.000336,172.31.47.0-255,66,65914,90,301828
4710,0.000339,172.217.194.0-255,366,66280,90,301828
4711,0.000378,172.217.194.0-255,1484,67764,90,301828
4712,0.000381,172.31.47.0-255,66,67830,90,301828
4713,0.000408,172.217.194.0-255,2902,70732,90,301828
4714,0.000411,172.31.47.0-255,66,70798,90,301828
4715,0.000417,172.217.194.0-255,5738,76536,90,301828
4716,0.000419,172.31.47.0-255,66,76602,90,301828
4717,0.000422,172.217.194.0-255,1484,78086,90,301828
4718,0.000449,172.217.194.0-255,8574,86660,90,301828
4719,0.000452,172.31.47.0-255,66,86726,90,301828
4720,0.000474,172.217.194.0-255,3961,90687,90,301828
4721,0.000477,172.31.47.0-255,66,90753,90,301828
4722,0.000485,172.217.194.0-255,9633,100386,90,301828
4723,0.000488,172.31.47.0-255,66,100452,90,301828
4724,0.000506,172.217.194.0-255,1484,101936,90,301828
4725,0.000529,172.217.194.0-255,2902,104838,90,301828
4726,0.000532,172.31.47.0-255,66,104904,90,301828
4727,0.000538,172.217.194.0-255,5738,110642,90,301828
4728,0.000541,172.31.47.0-255,66,110708,90,301828
4729,0.000546,172.217.194.0-255,4320,115028,90,301828
4730,0.000548,172.31.47.0-255,66,115094,90,301828
4731,0.000579,172.217.194.0-255,8574,123668,90,301828
4732,0.000583,172.31.47.0-255,66,123734,90,301828
4733,0.000593,172.217.194.0-255,9992,133726,90,301828
4734,0.000595,172.31.47.0-255,66,133792,90,301828
4735,0.000598,172.217.194.0-255,766,134558,90,301828
4736,0.000677,172.217.194.0-255,1484,136042,90,301828
4737,0.000682,172.31.47.0-255,66,136108,90,301828
4738,0.000687,172.217.194.0-255,2902,139010,90,301828
4739,0.000689,172.31.47.0-255,66,139076,90,301828
4740,0.000702,172.217.194.0-255,5738,144814,90,301828
4741,0.000706,172.31.47.0-255,66,144880,90,301828
4742,0.000709,172.217.194.0-255,1484,146364,90,301828
4743,0.000745,172.217.194.0-255,8574,154938,90,301828
4744,0.00075,172.31.47.0-255,66,155004,90,301828
4745,0.000783,172.31.47.0-255,66,155070,90,301828
4746,0.000808,172.217.194.0-255,1484,156554,90,301828
4747,0.000834,172.31.47.0-255,66,156620,90,301828
4748,0.000851,172.31.47.0-255,66,156686,90,301828
4749,0.000881,172.217.194.0-255,2902,159588,90,301828
4750,0.000884,172.31.47.0-255,66,159654,90,301828
4751,0.000891,172.217.194.0-255,6438,166092,90,301828
4752,0.000894,172.31.47.0-255,66,166158,90,301828
4753,0.001158,172.217.194.0-255,1484,167642,90,301828
4754,0.001166,172.217.194.0-255,2902,170544,90,301828
4755,0.00117,172.31.47.0-255,66,170610,90,301828
4756,0.001176,172.217.194.0-255,4320,174930,90,301828
4757,0.001178,172.31.47.0-255,66,174996,90,301828
4758,0.001197,172.217.194.0-255,1484,176480,90,301828
4759,0.001242,172.217.194.0-255,8574,185054,90,301828
4760,0.001248,172.31.47.0-255,66,185120,90,301828
4761,0.001264,172.217.194.0-255,4320,189440,90,301828
4762,0.001268,172.31.47.0-255,66,189506,90,301828
4763,0.001277,172.217.194.0-255,10692,200198,90,301828
4764,0.001279,172.31.47.0-255,66,200264,90,301828
4765,0.001382,172.217.194.0-255,1484,201748,90,301828
4766,0.001401,172.217.194.0-255,2902,204650,90,301828
4767,0.001406,172.217.194.0-255,5738,210388,90,301828
4768,0.001411,172.31.47.0-255,66,210454,90,301828
4769,0.001415,172.31.47.0-255,66,210520,90,301828
4770,0.001446,172.31.47.0-255,66,210586,90,301828
4771,0.001455,172.217.194.0-255,10692,221278,90,301828
4772,0.001458,172.31.47.0-255,66,221344,90,301828
4773,0.00153,172.217.194.0-255,1484,222828,90,301828
4774,0.001536,172.217.194.0-255,1484,224312,90,301828
4775,0.001539,172.31.47.0-255,66,224378,90,301828
4776,0.001571,172.217.194.0-255,1484,225862,90,301828
4777,0.001578,172.217.194.0-255,5738,231600,90,301828
4778,0.001581,172.31.47.0-255,66,231666,90,301828
4779,0.001586,172.217.194.0-255,4320,235986,90,301828
4780,0.001588,172.31.47.0-255,66,236052,90,301828
4781,0.001612,172.217.194.0-255,5738,241790,90,301828
4782,0.001615,172.31.47.0-255,66,241856,90,301828
4783,0.00165,172.217.194.0-255,2902,244758,90,301828
4784,0.001653,172.31.47.0-255,66,244824,90,301828
4785,0.001656,172.217.194.0-255,1484,246308,90,301828
4786,0.001669,172.217.194.0-255,9274,255582,90,301828
4787,0.00169,172.31.47.0-255,66,255648,90,301828
4788,0.001694,172.217.194.0-255,1484,257132,90,301828
4789,0.001716,172.217.194.0-255,2902,260034,90,301828
4790,0.001723,172.217.194.0-255,5738,265772,90,301828
4791,0.001727,172.217.194.0-255,2902,268674,90,301828
4792,0.001741,172.217.194.0-255,5738,274412,90,301828
4793,0.001762,172.31.47.0-255,66,274478,90,301828
4794,0.001775,172.217.194.0-255,4320,278798,90,301828
4795,0.001808,172.217.194.0-255,4320,283118,90,301828
4796,0.001828,172.217.194.0-255,5738,288856,90,301828
4797,0.001838,172.31.47.0-255,66,288922,90,301828
4798,0.001848,172.217.194.0-255,1484,290406,90,301828
4799,0.001898,172.217.194.0-255,6438,296844,90,301828
4800,0.001943,172.217.194.0-255,4642,301486,90,301828
4801,0.001946,172.217.194.0-255,105,301591,90,301828
4802,0.001993,172.31.47.0-255,66,301657,90,301828
4803,0.004663,172.31.47.0-255,105,301762,90,301828
4804,0.006953,172.217.194.0-255,66,301828,90,301828
4805,0.0,172.217.194.0-255,153,153,90,203026
4806,2.2e-05,172.31.47.0-255,66,219,90,203026
4807,2.9e-05,172.217.194.0-255,1484,1703,90,203026
4808,3.4e-05,172.31.47.0-255,66,1769,90,203026
4809,3.9e-05,172.217.194.0-255,2902,4671,90,203026
4810,4.2e-05,172.31.47.0-255,66,4737,90,203026
4811,5.8e-05,172.217.194.0-255,7156,11893,90,203026
4812,6.1e-05,172.31.47.0-255,66,11959,90,203026
4813,7e-05,172.217.194.0-255,7781,19740,90,203026
4814,7.3e-05,172.31.47.0-255,66,19806,90,203026
4815,0.000125,172.31.47.0-255,66,19872,90,203026
4816,0.000179,172.217.194.0-255,1484,21356,90,203026
4817,0.000182,172.31.47.0-255,66,21422,90,203026
4818,0.000187,172.217.194.0-255,2902,24324,90,203026
4819,0.000189,172.31.47.0-255,66,24390,90,203026
4820,0.00021,172.217.194.0-255,5738,30128,90,203026
4821,0.000213,172.31.47.0-255,66,30194,90,203026
4822,0.000216,172.217.194.0-255,1484,31678,90,203026
4823,0.000222,172.31.47.0-255,66,31744,90,203026
4824,0.000261,172.31.47.0-255,66,31810,90,203026
4825,0.000272,172.217.194.0-255,10692,42502,90,203026
4826,0.000274,172.31.47.0-255,66,42568,90,203026
4827,0.000549,172.217.194.0-255,381,42949,90,203026
4828,0.000554,172.31.47.0-255,66,43015,90,203026
4829,0.00058,172.217.194.0-255,364,43379,90,203026
4830,0.000582,172.31.47.0-255,66,43445,90,203026
4831,0.000825,172.217.194.0-255,1484,44929,90,203026
4832,0.000829,172.31.47.0-255,66,44995,90,203026
4833,0.000834,172.217.194.0-255,2902,47897,90,203026
4834,0.000836,172.31.47.0-255,66,47963,90,203026
4835,0.000839,172.217.194.0-255,1484,49447,90,203026
4836,0.000864,172.217.194.0-255,4320,53767,90,203026
4837,0.000866,172.31.47.0-255,66,53833,90,203026
4838,0.000872,172.217.194.0-255,5738,59571,90,203026
4839,0.000874,172.31.47.0-255,66,59637,90,203026
4840,0.000877,172.217.194.0-255,1484,61121,90,203026
4841,0.000908,172.217.194.0-255,9992,71113,90,203026
4842,0.00091,172.31.47.0-255,66,71179,90,203026
4843,0.00094,172.217.194.0-255,1484,72663,90,203026
4844,0.000946,172.217.194.0-255,5020,77683,90,203026
4845,0.000948,172.31.47.0-255,66,77749,90,203026
4846,0.000953,172.217.194.0-255,2902,80651,90,203026
4847,0.000955,172.31.47.0-255,66,80717,90,203026
4848,0.000999,172.31.47.0-255,66,80783,90,203026
4849,0.001006,172.217.194.0-255,7156,87939,90,203026
4850,0.001008,172.31.47.0-255,66,88005,90,203026
4851,0.001023,172.217.194.0-255,2902,90907,90,203026
4852,0.001025,172.31.47.0-255,66,90973,90,203026
4853,0.001079,172.31.47.0-255,66,91039,90,203026
4854,0.001137,172.217.194.0-255,1484,92523,90,203026
4855,0.001147,172.217.194.0-255,9274,101797,90,203026
4856,0.00115,172.31.47.0-255,66,101863,90,203026
4857,0.001163,172.31.47.0-255,66,101929,90,203026
4858,0.00119,172.217.194.0-255,7156,109085,90,203026
4859,0.001192,172.31.47.0-255,66,109151,90,203026
4860,0.001231,172.31.47.0-255,66,109217,90,203026
4861,0.001272,172.217.194.0-255,1484,110701,90,203026
4862,0.001276,172.217.194.0-255,1484,112185,90,203026
4863,0.001278,172.31.47.0-255,66,112251,90,203026
4864,0.001303,172.217.194.0-255,1484,113735,90,203026
4865,0.001309,172.217.194.0-255,5738,119473,90,203026
4866,0.001311,172.31.47.0-255,66,119539,90,203026
4867,0.001316,172.217.194.0-255,2902,122441,90,203026
4868,0.001318,172.31.47.0-255,66,122507,90,203026
4869,0.001344,172.217.194.0-255,2902,125409,90,203026
4870,0.001346,172.31.47.0-255,66,125475,90,203026
4871,0.001362,172.31.47.0-255,66,125541,90,203026
4872,0.001367,172.217.194.0-255,5020,130561,90,203026
4873,0.001369,172.31.47.0-255,66,130627,90,203026
4874,0.001421,172.217.194.0-255,1484,132111,90,203026
4875,0.001426,172.217.194.0-255,2902,135013,90,203026
4876,0.001428,172.31.47.0-255,66,135079,90,203026
4877,0.001434,172.217.194.0-255,4320,139399,90,203026
4878,0.001436,172.31.47.0-255,66,139465,90,203026
4879,0.001451,172.217.194.0-255,1484,140949,90,203026
4880,0.001456,172.217.194.0-255,5738,146687,90,203026
4881,0.001458,172.31.47.0-255,66,146753,90,203026
4882,0.001491,172.217.194.0-255,7156,153909,90,203026
4883,0.001494,172.31.47.0-255,66,153975,90,203026
4884,0.0015,172.217.194.0-255,5738,159713,90,203026
4885,0.001502,172.31.47.0-255,66,159779,90,203026
4886,0.001528,172.217.194.0-255,4320,164099,90,203026
4887,0.00153,172.31.47.0-255,66,164165,90,203026
4888,0.001536,172.217.194.0-255,5738,169903,90,203026
4889,0.001538,172.31.47.0-255,66,169969,90,203026
4890,0.001588,172.31.47.0-255,66,170035,90,203026
4891,0.001605,172.217.194.0-255,4320,174355,90,203026
4892,0.001608,172.31.47.0-255,66,174421,90,203026
4893,0.001634,172.217.194.0-255,5020,179441,90,203026
4894,0.001637,172.31.47.0-255,66,179507,90,203026
4895,0.00165,172.31.47.0-255,66,179573,90,203026
4896,0.001682,172.217.194.0-255,7156,186729,90,203026
4897,0.001684,172.31.47.0-255,66,186795,90,203026
4898,0.001699,172.217.194.0-255,1484,188279,90,203026
4899,0.001773,172.31.47.0-255,66,188345,90,203026
4900,0.00182,172.31.47.0-255,66,188411,90,203026
4901,0.001844,172.217.194.0-255,4320,192731,90,203026
4902,0.001848,172.31.47.0-255,66,192797,90,203026
4903,0.001871,172.217.194.0-255,9992,202789,90,203026
4904,0.001874,172.31.47.0-255,66,202855,90,203026
4905,0.001911,172.31.47.0-255,66,202921,90,203026
4906,0.001914,172.217.194.0-255,105,203026,90,203026
4907,0.0,172.217.160.0-255,226,226,90,63768
4908,2.6e-05,172.31.47.0-255,66,292,90,63768
4909,3.4e-05,172.217.160.0-255,1484,1776,90,63768
4910,4e-05,172.31.47.0-255,66,1842,90,63768
4911,5.5e-05,172.217.160.0-255,4320,6162,90,63768
4912,5.9e-05,172.31.47.0-255,66,6228,90,63768
4913,0.000186,172.217.160.0-255,4320,10548,90,63768
4914,0.000191,172.31.47.0-255,66,10614,90,63768
4915,0.000211,172.217.160.0-255,2902,13516,90,63768
4916,0.000214,172.31.47.0-255,66,13582,90,63768
4917,0.000418,172.217.160.0-255,683,14265,90,63768
4918,0.000423,172.31.47.0-255,66,14331,90,63768
4919,0.000462,172.217.160.0-255,9992,24323,90,63768
4920,0.000466,172.31.47.0-255,66,24389,90,63768
4921,0.000797,172.217.160.0-255,6797,31186,90,63768
4922,0.000804,172.31.47.0-255,66,31252,90,63768
4923,0.001019,172.217.160.0-255,5738,36990,90,63768
4924,0.001024,172.31.47.0-255,66,37056,90,63768
4925,0.00197,172.217.160.0-255,2902,39958,90,63768
4926,0.001977,172.31.47.0-255,66,40024,90,63768
4927,0.002969,172.217.160.0-255,2902,42926,90,63768
4928,0.002973,172.31.47.0-255,66,42992,90,63768
4929,0.003914,172.217.160.0-255,2902,45894,90,63768
4930,0.003917,172.31.47.0-255,66,45960,90,63768
4931,0.00491,172.217.160.0-255,2902,48862,90,63768
4932,0.004915,172.31.47.0-255,66,48928,90,63768
4933,0.005859,172.217.160.0-255,2902,51830,90,63768
4934,0.005863,172.31.47.0-255,66,51896,90,63768
4935,0.006863,172.217.160.0-255,2902,54798,90,63768
4936,0.006868,172.31.47.0-255,66,54864,90,63768
4937,0.007812,172.217.160.0-255,2902,57766,90,63768
4938,0.007828,172.31.47.0-255,66,57832,90,63768
4939,0.00882,172.217.160.0-255,2902,60734,90,63768
4940,0.008839,172.31.47.0-255,66,60800,90,63768
4941,0.009777,172.217.160.0-255,2902,63702,90,63768
4942,0.009792,172.31.47.0-255,66,63768,90,63768
4943,0.0,74.125.200.0-255,150,150,90,146187
4944,2.4e-05,172.31.47.0-255,66,216,90,146187
4945,3.2e-05,74.125.200.0-255,1484,1700,90,146187
4946,3.6e-05,172.31.47.0-255,66,1766,90,146187
4947,4.2e-05,74.125.200.0-255,2902,4668,90,146187
4948,4.5e-05,172.31.47.0-255,66,4734,90,146187
4949,8.8e-05,74.125.200.0-255,5738,10472,90,146187
4950,9.1e-05,172.31.47.0-255,66,10538,90,146187
4951,0.000107,74.125.200.0-255,1484,12022,90,146187
4952,0.00011,172.31.47.0-255,66,12088,90,146187
4953,0.000231,74.125.200.0-255,1484,13572,90,146187
4954,0.000235,172.31.47.0-255,66,13638,90,146187
4955,0.000239,74.125.200.0-255,594,14232,90,146187
4956,0.000241,172.31.47.0-255,66,14298,90,146187
4957,0.000272,74.125.200.0-255,1484,15782,90,146187
4958,0.000275,172.31.47.0-255,66,15848,90,146187
4959,0.000292,74.125.200.0-255,2902,18750,90,146187
4960,0.000295,172.31.47.0-255,66,18816,90,146187
4961,0.000363,74.125.200.0-255,1484,20300,90,146187
4962,0.000366,172.31.47.0-255,66,20366,90,146187
4963,0.000391,74.125.200.0-255,8574,28940,90,146187
4964,0.000394,172.31.47.0-255,66,29006,90,146187
4965,0.000573,74.125.200.0-255,2543,31549,90,146187
4966,0.000616,172.31.47.0-255,66,31615,90,146187
4967,0.000627,74.125.200.0-255,2902,34517,90,146187
4968,0.00063,172.31.47.0-255,66,34583,90,146187
4969,0.000685,74.125.200.0-255,1484,36067,90,146187
4970,0.000689,172.31.47.0-255,66,36133,90,146187
4971,0.00071,74.125.200.0-255,5738,41871,90,146187
4972,0.000713,172.31.47.0-255,66,41937,90,146187
4973,0.000838,74.125.200.0-255,1484,43421,90,146187
4974,0.000842,172.31.47.0-255,66,43487,90,146187
4975,0.000869,74.125.200.0-255,9992,53479,90,146187
4976,0.000888,74.125.200.0-255,3961,57440,90,146187
4977,0.000908,172.31.47.0-255,66,57506,90,146187
4978,0.001169,74.125.200.0-255,5738,63244,90,146187
4979,0.001183,74.125.200.0-255,2543,65787,90,146187
4980,0.001194,172.31.47.0-255,66,65853,90,146187
4981,0.001317,74.125.200.0-255,646,66499,90,146187
4982,0.001363,74.125.200.0-255,1484,67983,90,146187
4983,0.001367,172.31.47.0-255,66,68049,90,146187
4984,0.001388,74.125.200.0-255,4320,72369,90,146187
4985,0.001407,172.31.47.0-255,66,72435,90,146187
4986,0.001478,74.125.200.0-255,2902,75337,90,146187
4987,0.001494,74.125.200.0-255,7156,82493,90,146187
4988,0.001514,172.31.47.0-255,66,82559,90,146187
4989,0.001681,74.125.200.0-255,4320,86879,90,146187
4990,0.001686,172.31.47.0-255,66,86945,90,146187
4991,0.001777,74.125.200.0-255,7156,94101,90,146187
4992,0.001781,172.31.47.0-255,66,94167,90,146187
4993,0.001806,74.125.200.0-255,6438,100605,90,146187
4994,0.001813,172.31.47.0-255,66,100671,90,146187
4995,0.002051,74.125.200.0-255,1484,102155,90,146187
4996,0.002085,74.125.200.0-255,2902,105057,90,146187
4997,0.00209,172.31.47.0-255,66,105123,90,146187
4998,0.002165,74.125.200.0-255,5738,110861,90,146187
4999,0.002289,74.125.200.0-255,8574,119435,90,146187
5000,0.002306,74.125.200.0-255,4320,123755,90,146187
5001,0.00255,74.125.200.0-255,8574,132329,90,146187
5002,0.002569,74.125.200.0-255,2184,134513,90,146187
5003,0.002781,74.125.200.0-255,4320,138833,90,146187
5004,0.002832,74.125.200.0-255,1484,140317,90,146187
5005,0.006824,172.31.47.0-255,66,140383,90,146187
5006,0.009105,74.125.200.0-255,5738,146121,90,146187
5007,0.009111,172.31.47.0-255,66,146187,90,146187
5008,0.0,172.217.194.0-255,297,297,90,313621
5009,2.6e-05,172.31.47.0-255,66,363,90,313621
5010,3.1e-05,172.217.194.0-255,1484,1847,90,313621
5011,3.4e-05,172.31.47.0-255,66,1913,90,313621
5012,3.9e-05,172.217.194.0-255,4320,6233,90,313621
5013,4.2e-05,172.31.47.0-255,66,6299,90,313621
5014,6.6e-05,172.217.194.0-255,7449,13748,90,313621
5015,6.8e-05,172.31.47.0-255,66,13814,90,313621
5016,0.000486,172.217.194.0-255,1484,15298,90,313621
5017,0.000491,172.31.47.0-255,66,15364,90,313621
5018,0.0005,172.217.194.0-255,2902,18266,90,313621
5019,0.000502,172.31.47.0-255,66,18332,90,313621
5020,0.000524,172.217.194.0-255,5738,24070,90,313621
5021,0.000527,172.31.47.0-255,66,24136,90,313621
5022,0.000559,172.217.194.0-255,2902,27038,90,313621
5023,0.000562,172.31.47.0-255,66,27104,90,313621
5024,0.00058,172.217.194.0-255,3961,31065,90,313621
5025,0.000582,172.31.47.0-255,66,31131,90,313621
5026,0.000728,172.217.194.0-255,1484,32615,90,313621
5027,0.000732,172.31.47.0-255,66,32681,90,313621
5028,0.000755,172.217.194.0-255,2902,35583,90,313621
5029,0.000758,172.31.47.0-255,66,35649,90,313621
5030,0.000762,172.217.194.0-255,2902,38551,90,313621
5031,0.000764,172.31.47.0-255,66,38617,90,313621
5032,0.000782,172.217.194.0-255,2902,41519,90,313621
5033,0.000784,172.31.47.0-255,66,41585,90,313621
5034,0.000816,172.217.194.0-255,6797,48382,90,313621
5035,0.000819,172.31.47.0-255,66,48448,90,313621
5036,0.000822,172.217.194.0-255,1484,49932,90,313621
5037,0.000823,172.31.47.0-255,66,49998,90,313621
5038,0.000839,172.217.194.0-255,5738,55736,90,313621
5039,0.000842,172.31.47.0-255,66,55802,90,313621
5040,0.000857,172.217.194.0-255,1484,57286,90,313621
5041,0.000875,172.217.194.0-255,8215,65501,90,313621
5042,0.000878,172.31.47.0-255,66,65567,90,313621
5043,0.000896,172.217.194.0-255,646,66213,90,313621
5044,0.001128,172.217.194.0-255,1484,67697,90,313621
5045,0.001133,172.31.47.0-255,66,67763,90,313621
5046,0.00114,172.217.194.0-255,2902,70665,90,313621
5047,0.001143,172.31.47.0-255,66,70731,90,313621
5048,0.001149,172.217.194.0-255,5738,76469,90,313621
5049,0.00115,172.31.47.0-255,66,76535,90,313621
5050,0.001175,172.217.194.0-255,9992,86527,90,313621
5051,0.001179,172.31.47.0-255,66,86593,90,313621
5052,0.001198,172.217.194.0-255,1484,88077,90,313621
5053,0.001215,172.217.194.0-255,5738,93815,90,313621
5054,0.001217,172.31.47.0-255,66,93881,90,313621
5055,0.001238,172.217.194.0-255,6438,100319,90,313621
5056,0.00124,172.31.47.0-255,66,100385,90,313621
5057,0.001505,172.217.194.0-255,1484,101869,90,313621
5058,0.001508,172.217.194.0-255,1484,103353,90,313621
5059,0.001509,172.31.47.0-255,66,103419,90,313621
5060,0.001524,172.217.194.0-255,1484,104903,90,313621
5061,0.001529,172.217.194.0-255,5738,110641,90,313621
5062,0.001531,172.31.47.0-255,66,110707,90,313621
5063,0.001551,172.217.194.0-255,8574,119281,90,313621
5064,0.001552,172.31.47.0-255,66,119347,90,313621
5065,0.001572,172.217.194.0-255,4320,123667,90,313621
5066,0.001574,172.31.47.0-255,66,123733,90,313621
5067,0.001581,172.217.194.0-255,10692,134425,90,313621
5068,0.001583,172.31.47.0-255,66,134491,90,313621
5069,0.001617,172.217.194.0-255,4320,138811,90,313621
5070,0.001619,172.31.47.0-255,66,138877,90,313621
5071,0.001631,172.217.194.0-255,5738,144615,90,313621
5072,0.001633,172.31.47.0-255,66,144681,90,313621
5073,0.001664,172.217.194.0-255,2902,147583,90,313621
5074,0.001666,172.31.47.0-255,66,147649,90,313621
5075,0.001693,172.217.194.0-255,8574,156223,90,313621
5076,0.001695,172.31.47.0-255,66,156289,90,313621
5077,0.001705,172.31.47.0-255,66,156355,90,313621
5078,0.001769,172.217.194.0-255,1484,157839,90,313621
5079,0.001772,172.217.194.0-255,1484,159323,90,313621
5080,0.001773,172.31.47.0-255,66,159389,90,313621
5081,0.001788,172.217.194.0-255,1484,160873,90,313621
5082,0.001792,172.217.194.0-255,5738,166611,90,313621
5083,0.001794,172.31.47.0-255,66,166677,90,313621
5084,0.00181,172.217.194.0-255,1484,168161,90,313621
5085,0.001834,172.31.47.0-255,66,168227,90,313621
5086,0.001873,172.217.194.0-255,1484,169711,90,313621
5087,0.001892,172.217.194.0-255,9274,178985,90,313621
5088,0.001894,172.31.47.0-255,66,179051,90,313621
5089,0.001899,172.217.194.0-255,5738,184789,90,313621
5090,0.001901,172.31.47.0-255,66,184855,90,313621
5091,0.001916,172.217.194.0-255,5738,190593,90,313621
5092,0.001917,172.31.47.0-255,66,190659,90,313621
5093,0.001922,172.217.194.0-255,4320,194979,90,313621
5094,0.001923,172.31.47.0-255,66,195045,90,313621
5095,0.001964,172.31.47.0-255,66,195111,90,313621
5096,0.001968,172.217.194.0-255,4320,199431,90,313621
5097,0.00197,172.31.47.0-255,66,199497,90,313621
5098,0.001978,172.217.194.0-255,1484,200981,90,313621
5099,0.00198,172.217.194.0-255,1484,202465,90,313621
5100,0.001982,172.31.47.0-255,66,202531,90,313621
5101,0.002002,172.217.194.0-255,5738,208269,90,313621
5102,0.002004,172.31.47.0-255,66,208335,90,313621
5103,0.002013,172.217.194.0-255,7156,215491,90,313621
5104,0.002015,172.31.47.0-255,66,215557,90,313621
5105,0.002039,172.217.194.0-255,7156,222713,90,313621
5106,0.002041,172.31.47.0-255,66,222779,90,313621
5107,0.002046,172.217.194.0-255,6438,229217,90,313621
5108,0.002048,172.31.47.0-255,66,229283,90,313621
5109,0.002077,172.217.194.0-255,2902,232185,90,313621
5110,0.002079,172.31.47.0-255,66,232251,90,313621
5111,0.0021,172.217.194.0-255,9992,242243,90,313621
5112,0.002102,172.31.47.0-255,66,242309,90,313621
5113,0.002109,172.217.194.0-255,9992,252301,90,313621
5114,0.002111,172.31.47.0-255,66,252367,90,313621
5115,0.002122,172.217.194.0-255,4320,256687,90,313621
5116,0.002124,172.31.47.0-255,66,256753,90,313621
5117,0.002129,172.217.194.0-255,4320,261073,90,313621
5118,0.002131,172.31.47.0-255,66,261139,90,313621
5119,0.002149,172.217.194.0-255,2184,263323,90,313621
5120,0.002152,172.31.47.0-255,66,263389,90,313621
5121,0.002202,172.217.194.0-255,1484,264873,90,313621
5122,0.002212,172.217.194.0-255,2902,267775,90,313621
5123,0.002214,172.31.47.0-255,66,267841,90,313621
5124,0.002232,172.217.194.0-255,2902,270743,90,313621
5125,0.002233,172.31.47.0-255,66,270809,90,313621
5126,0.00225,172.217.194.0-255,2902,273711,90,313621
5127,0.002252,172.31.47.0-255,66,273777,90,313621
5128,0.00226,172.217.194.0-255,9992,283769,90,313621
5129,0.002261,172.31.47.0-255,66,283835,90,313621
5130,0.002271,172.217.194.0-255,2902,286737,90,313621
5131,0.002273,172.31.47.0-255,66,286803,90,313621
5132,0.002313,172.217.194.0-255,10692,297495,90,313621
5133,0.002315,172.31.47.0-255,66,297561,90,313621
5134,0.004649,172.217.194.0-255,5738,303299,90,313621
5135,0.004656,172.31.47.0-255,66,303365,90,313621
5136,0.00699,172.217.194.0-255,4320,307685,90,313621
5137,0.006998,172.31.47.0-255,66,307751,90,313621
5138,0.007017,172.217.194.0-255,1484,309235,90,313621
5139,0.00934,172.217.194.0-255,4320,313555,90,313621
5140,0.009347,172.31.47.0-255,66,313621,90,313621
5141,0.0,172.217.194.0-255,153,153,90,151665
5142,1.3e-05,172.31.47.0-255,66,219,90,151665
5143,1.9e-05,172.217.194.0-255,1484,1703,90,151665
5144,2.3e-05,172.31.47.0-255,66,1769,90,151665
5145,2.9e-05,172.217.194.0-255,2902,4671,90,151665
5146,3.1e-05,172.31.47.0-255,66,4737,90,151665
5147,3.8e-05,172.217.194.0-255,7156,11893,90,151665
5148,4e-05,172.31.47.0-255,66,11959,90,151665
5149,5.7e-05,172.217.194.0-255,2176,14135,90,151665
5150,5.9e-05,172.31.47.0-255,66,14201,90,151665
5151,0.000127,172.217.194.0-255,1484,15685,90,151665
5152,0.00013,172.31.47.0-255,66,15751,90,151665
5153,0.000134,172.217.194.0-255,2902,18653,90,151665
5154,0.000136,172.31.47.0-255,66,18719,90,151665
5155,0.000152,172.217.194.0-255,2902,21621,90,151665
5156,0.000154,172.31.47.0-255,66,21687,90,151665
5157,0.000168,172.217.194.0-255,1484,23171,90,151665
5158,0.00017,172.31.47.0-255,66,23237,90,151665
5159,0.000187,172.217.194.0-255,5738,28975,90,151665
5160,0.00019,172.31.47.0-255,66,29041,90,151665
5161,0.000213,172.217.194.0-255,2543,31584,90,151665
5162,0.000215,172.31.47.0-255,66,31650,90,151665
5163,0.000232,172.217.194.0-255,2902,34552,90,151665
5164,0.000234,172.31.47.0-255,66,34618,90,151665
5165,0.000248,172.217.194.0-255,4320,38938,90,151665
5166,0.00025,172.31.47.0-255,66,39004,90,151665
5167,0.000272,172.217.194.0-255,2902,41906,90,151665
5168,0.000274,172.31.47.0-255,66,41972,90,151665
5169,0.000279,172.217.194.0-255,4320,46292,90,151665
5170,0.000281,172.31.47.0-255,66,46358,90,151665
5171,0.000305,172.217.194.0-255,2543,48901,90,151665
5172,0.000307,172.31.47.0-255,66,48967,90,151665
5173,0.000853,172.217.194.0-255,1484,50451,90,151665
5174,0.000897,172.217.194.0-255,1484,51935,90,151665
5175,0.000901,172.31.47.0-255,66,52001,90,151665
5176,0.000906,172.217.194.0-255,2902,54903,90,151665
5177,0.000908,172.31.47.0-255,66,54969,90,151665
5178,0.000932,172.217.194.0-255,2902,57871,90,151665
5179,0.000934,172.31.47.0-255,66,57937,90,151665
5180,0.000951,172.217.194.0-255,2902,60839,90,151665
5181,0.000953,172.31.47.0-255,66,60905,90,151665
5182,0.000971,172.217.194.0-255,5379,66284,90,151665
5183,0.000973,172.31.47.0-255,66,66350,90,151665
5184,0.001006,172.217.194.0-255,4320,70670,90,151665
5185,0.001009,172.31.47.0-255,66,70736,90,151665
5186,0.001031,172.217.194.0-255,1484,72220,90,151665
5187,0.001038,172.217.194.0-255,5738,77958,90,151665
5188,0.00104,172.31.47.0-255,66,78024,90,151665
5189,0.001069,172.217.194.0-255,2902,80926,90,151665
5190,0.001072,172.31.47.0-255,66,80992,90,151665
5191,0.001085,172.217.194.0-255,3124,84116,90,151665
5192,0.001087,172.31.47.0-255,66,84182,90,151665
5193,0.001115,172.217.194.0-255,2902,87084,90,151665
5194,0.001117,172.31.47.0-255,66,87150,90,151665
5195,0.001134,172.217.194.0-255,4320,91470,90,151665
5196,0.001136,172.31.47.0-255,66,91536,90,151665
5197,0.001139,172.217.194.0-255,2902,94438,90,151665
5198,0.001141,172.31.47.0-255,66,94504,90,151665
5199,0.00117,172.217.194.0-255,1484,95988,90,151665
5200,0.001193,172.217.194.0-255,5379,101367,90,151665
5201,0.001197,172.31.47.0-255,66,101433,90,151665
5202,0.001692,172.217.194.0-255,1484,102917,90,151665
5203,0.0017,172.217.194.0-255,2902,105819,90,151665
5204,0.001704,172.31.47.0-255,66,105885,90,151665
5205,0.001712,172.217.194.0-255,4320,110205,90,151665
5206,0.001714,172.31.47.0-255,66,110271,90,151665
5207,0.001728,172.217.194.0-255,1484,111755,90,151665
5208,0.001776,172.217.194.0-255,7156,118911,90,151665
5209,0.001779,172.31.47.0-255,66,118977,90,151665
5210,0.001787,172.217.194.0-255,8574,127551,90,151665
5211,0.00179,172.31.47.0-255,66,127617,90,151665
5212,0.001798,172.217.194.0-255,7856,135473,90,151665
5213,0.001801,172.31.47.0-255,66,135539,90,151665
5214,0.005011,172.217.194.0-255,1484,137023,90,151665
5215,0.00502,172.217.194.0-255,2902,139925,90,151665
5216,0.005024,172.31.47.0-255,66,139991,90,151665
5217,0.005043,172.217.194.0-255,1484,141475,90,151665
5218,0.007291,172.217.194.0-255,4320,145795,90,151665
5219,0.007296,172.31.47.0-255,66,145861,90,151665
5220,0.009633,172.217.194.0-255,5738,151599,90,151665
5221,0.009642,172.31.47.0-255,66,151665,90,151665
5222,0.0,74.125.130.0-255,152,152,90,118332
5223,4e-05,172.31.47.0-255,66,218,90,118332
5224,4.7e-05,74.125.130.0-255,1484,1702,90,118332
5225,5.2e-05,172.31.47.0-255,66,1768,90,118332
5226,5.7e-05,74.125.130.0-255,2902,4670,90,118332
5227,6.7e-05,172.31.47.0-255,66,4736,90,118332
5228,7.4e-05,74.125.130.0-255,7156,11892,90,118332
5229,7.7e-05,172.31.47.0-255,66,11958,90,118332
5230,0.000119,74.125.130.0-255,7874,19832,90,118332
5231,0.000122,172.31.47.0-255,66,19898,90,118332
5232,0.00013,74.125.130.0-255,7156,27054,90,118332
5233,0.000132,172.31.47.0-255,66,27120,90,118332
5234,0.000164,74.125.130.0-255,3961,31081,90,118332
5235,0.000168,172.31.47.0-255,66,31147,90,118332
5236,0.000276,74.125.130.0-255,1484,32631,90,118332
5237,0.00028,172.31.47.0-255,66,32697,90,118332
5238,0.000305,74.125.130.0-255,2902,35599,90,118332
5239,0.000325,172.31.47.0-255,66,35665,90,118332
5240,0.00033,74.125.130.0-255,2902,38567,90,118332
5241,0.000333,172.31.47.0-255,66,38633,90,118332
5242,0.000344,74.125.130.0-255,4320,42953,90,118332
5243,0.000347,172.31.47.0-255,66,43019,90,118332
5244,0.000376,74.125.130.0-255,5379,48398,90,118332
5245,0.00038,172.31.47.0-255,66,48464,90,118332
5246,0.000405,74.125.130.0-255,5738,54202,90,118332
5247,0.000409,172.31.47.0-255,66,54268,90,118332
5248,0.000433,74.125.130.0-255,1484,55752,90,118332
5249,0.000437,172.31.47.0-255,66,55818,90,118332
5250,0.000441,74.125.130.0-255,2902,58720,90,118332
5251,0.000443,172.31.47.0-255,66,58786,90,118332
5252,0.000468,74.125.130.0-255,5738,64524,90,118332
5253,0.000471,172.31.47.0-255,66,64590,90,118332
5254,0.000515,74.125.130.0-255,1376,65966,90,118332
5255,0.000527,74.125.130.0-255,122,66088,90,118332
5256,0.00069,74.125.130.0-255,1484,67572,90,118332
5257,0.000694,172.31.47.0-255,66,67638,90,118332
5258,0.000699,74.125.130.0-255,2902,70540,90,118332
5259,0.000702,74.125.130.0-255,1484,72024,90,118332
5260,0.000708,172.31.47.0-255,66,72090,90,118332
5261,0.00072,74.125.130.0-255,4320,76410,90,118332
5262,0.000727,172.31.47.0-255,66,76476,90,118332
5263,0.000729,74.125.130.0-255,2902,79378,90,118332
5264,0.000734,74.125.130.0-255,4320,83698,90,118332
5265,0.000745,172.31.47.0-255,66,83764,90,118332
5266,0.000775,74.125.130.0-255,5738,89502,90,118332
5267,0.00078,172.31.47.0-255,66,89568,90,118332
5268,0.000797,74.125.130.0-255,2902,92470,90,118332
5269,0.000805,172.31.47.0-255,66,92536,90,118332
5270,0.000835,74.125.130.0-255,7856,100392,90,118332
5271,0.000841,172.31.47.0-255,66,100458,90,118332
5272,0.00258,74.125.130.0-255,1484,101942,90,118332
5273,0.002588,74.125.130.0-255,1484,103426,90,118332
5274,0.002591,172.31.47.0-255,66,103492,90,118332
5275,0.003391,74.125.130.0-255,2902,106394,90,118332
5276,0.003584,172.31.47.0-255,66,106460,90,118332
5277,0.005145,74.125.130.0-255,2902,109362,90,118332
5278,0.005149,172.31.47.0-255,66,109428,90,118332
5279,0.006137,74.125.130.0-255,2902,112330,90,118332
5280,0.006141,172.31.47.0-255,66,112396,90,118332
5281,0.007703,74.125.130.0-255,2902,115298,90,118332
5282,0.007709,172.31.47.0-255,66,115364,90,118332
5283,0.008697,74.125.130.0-255,2902,118266,90,118332
5284,0.008702,172.31.47.0-255,66,118332,90,118332
5285,0.0,74.125.68.0-255,66,66,90,3977
5286,0.001283,74.125.68.0-255,3845,3911,90,3977
5287,0.001296,172.31.47.0-255,66,3977,90,3977
5288,0.0,74.125.24.0-255,153,153,90,256574
5289,3.2e-05,172.31.47.0-255,66,219,90,256574
5290,3.8e-05,74.125.24.0-255,1484,1703,90,256574
5291,4.3e-05,172.31.47.0-255,66,1769,90,256574
5292,5.5e-05,74.125.24.0-255,2902,4671,90,256574
5293,6e-05,172.31.47.0-255,66,4737,90,256574
5294,6.5e-05,74.125.24.0-255,4320,9057,90,256574
5295,6.8e-05,172.31.47.0-255,66,9123,90,256574
5296,8.4e-05,74.125.24.0-255,4320,13443,90,256574
5297,8.7e-05,172.31.47.0-255,66,13509,90,256574
5298,0.0001,74.125.24.0-255,674,14183,90,256574
5299,0.00011,172.31.47.0-255,66,14249,90,256574
5300,0.000186,74.125.24.0-255,1484,15733,90,256574
5301,0.00019,172.31.47.0-255,66,15799,90,256574
5302,0.000195,74.125.24.0-255,2902,18701,90,256574
5303,0.000198,172.31.47.0-255,66,18767,90,256574
5304,0.000203,74.125.24.0-255,4320,23087,90,256574
5305,0.000206,172.31.47.0-255,66,23153,90,256574
5306,0.000239,74.125.24.0-255,1484,24637,90,256574
5307,0.000242,172.31.47.0-255,66,24703,90,256574
5308,0.00025,74.125.24.0-255,6797,31500,90,256574
5309,0.000252,172.31.47.0-255,66,31566,90,256574
5310,0.000264,74.125.24.0-255,7156,38722,90,256574
5311,0.000267,172.31.47.0-255,66,38788,90,256574
5312,0.00027,74.125.24.0-255,1484,40272,90,256574
5313,0.000272,172.31.47.0-255,66,40338,90,256574
5314,0.000313,172.31.47.0-255,66,40404,90,256574
5315,0.000323,74.125.24.0-255,10692,51096,90,256574
5316,0.000326,172.31.47.0-255,66,51162,90,256574
5317,0.0007,74.125.24.0-255,645,51807,90,256574
5318,0.000705,172.31.47.0-255,66,51873,90,256574
5319,0.001173,74.125.24.0-255,1484,53357,90,256574
5320,0.001185,74.125.24.0-255,2902,56259,90,256574
5321,0.00119,172.31.47.0-255,66,56325,90,256574
5322,0.001198,74.125.24.0-255,4320,60645,90,256574
5323,0.0012,172.31.47.0-255,66,60711,90,256574
5324,0.001234,74.125.24.0-255,1484,62195,90,256574
5325,0.001241,74.125.24.0-255,5738,67933,90,256574
5326,0.001244,172.31.47.0-255,66,67999,90,256574
5327,0.001257,172.31.47.0-255,66,68065,90,256574
5328,0.001267,74.125.24.0-255,5020,73085,90,256574
5329,0.00127,172.31.47.0-255,66,73151,90,256574
5330,0.002181,74.125.24.0-255,1484,74635,90,256574
5331,0.002204,74.125.24.0-255,2902,77537,90,256574
5332,0.002208,172.31.47.0-255,66,77603,90,256574
5333,0.002214,74.125.24.0-255,5738,83341,90,256574
5334,0.002215,172.31.47.0-255,66,83407,90,256574
5335,0.002244,74.125.24.0-255,8574,91981,90,256574
5336,0.002246,172.31.47.0-255,66,92047,90,256574
5337,0.002252,74.125.24.0-255,7156,99203,90,256574
5338,0.002254,172.31.47.0-255,66,99269,90,256574
5339,0.00227,74.125.24.0-255,2902,102171,90,256574
5340,0.002272,172.31.47.0-255,66,102237,90,256574
5341,0.002278,74.125.24.0-255,1484,103721,90,256574
5342,0.002303,74.125.24.0-255,3602,107323,90,256574
5343,0.002305,172.31.47.0-255,66,107389,90,256574
5344,0.00242,74.125.24.0-255,1484,108873,90,256574
5345,0.002434,74.125.24.0-255,2902,111775,90,256574
5346,0.002436,172.31.47.0-255,66,111841,90,256574
5347,0.002441,74.125.24.0-255,4320,116161,90,256574
5348,0.002443,172.31.47.0-255,66,116227,90,256574
5349,0.00246,74.125.24.0-255,1484,117711,90,256574
5350,0.002462,74.125.24.0-255,1484,119195,90,256574
5351,0.002464,172.31.47.0-255,66,119261,90,256574
5352,0.002495,172.31.47.0-255,66,119327,90,256574
5353,0.002504,74.125.24.0-255,10692,130019,90,256574
5354,0.002506,172.31.47.0-255,66,130085,90,256574
5355,0.00253,74.125.24.0-255,1484,131569,90,256574
5356,0.002542,74.125.24.0-255,1484,133053,90,256574
5357,0.002544,172.31.47.0-255,66,133119,90,256574
5358,0.002548,74.125.24.0-255,2902,136021,90,256574
5359,0.00255,172.31.47.0-255,66,136087,90,256574
5360,0.002568,74.125.24.0-255,1484,137571,90,256574
5361,0.002575,74.125.24.0-255,8574,146145,90,256574
5362,0.002577,172.31.47.0-255,66,146211,90,256574
5363,0.002584,74.125.24.0-255,2902,149113,90,256574
5364,0.002586,172.31.47.0-255,66,149179,90,256574
5365,0.002619,74.125.24.0-255,2902,152081,90,256574
5366,0.002622,172.31.47.0-255,66,152147,90,256574
5367,0.002628,74.125.24.0-255,7156,159303,90,256574
5368,0.002629,172.31.47.0-255,66,159369,90,256574
5369,0.002686,74.125.24.0-255,5020,164389,90,256574
5370,0.002689,172.31.47.0-255,66,164455,90,256574
5371,0.002757,74.125.24.0-255,1484,165939,90,256574
5372,0.002768,74.125.24.0-255,1484,167423,90,256574
5373,0.00277,172.31.47.0-255,66,167489,90,256574
5374,0.002796,74.125.24.0-255,1484,168973,90,256574
5375,0.002801,74.125.24.0-255,5738,174711,90,256574
5376,0.002803,172.31.47.0-255,66,174777,90,256574
5377,0.002813,172.31.47.0-255,66,174843,90,256574
5378,0.002819,74.125.24.0-255,8574,183417,90,256574
5379,0.002821,172.31.47.0-255,66,183483,90,256574
5380,0.002857,74.125.24.0-255,3602,187085,90,256574
5381,0.00286,172.31.47.0-255,66,187151,90,256574
5382,0.002949,74.125.24.0-255,1484,188635,90,256574
5383,0.002973,74.125.24.0-255,2902,191537,90,256574
5384,0.002976,172.31.47.0-255,66,191603,90,256574
5385,0.002988,74.125.24.0-255,4320,195923,90,256574
5386,0.002993,172.31.47.0-255,66,195989,90,256574
5387,0.003009,74.125.24.0-255,1484,197473,90,256574
5388,0.003014,74.125.24.0-255,4320,201793,90,256574
5389,0.003016,172.31.47.0-255,66,201859,90,256574
5390,0.003031,74.125.24.0-255,1484,203343,90,256574
5391,0.00306,74.125.24.0-255,9992,213335,90,256574
5392,0.003063,172.31.47.0-255,66,213401,90,256574
5393,0.003069,74.125.24.0-255,7856,221257,90,256574
5394,0.003071,172.31.47.0-255,66,221323,90,256574
5395,0.003075,74.125.24.0-255,2902,224225,90,256574
5396,0.003076,172.31.47.0-255,66,224291,90,256574
5397,0.003104,74.125.24.0-255,5738,230029,90,256574
5398,0.003111,172.31.47.0-255,66,230095,90,256574
5399,0.003122,172.31.47.0-255,66,230161,90,256574
5400,0.003145,74.125.24.0-255,1484,231645,90,256574
5401,0.003186,172.31.47.0-255,66,231711,90,256574
5402,0.003203,172.31.47.0-255,66,231777,90,256574
5403,0.003241,172.31.47.0-255,66,231843,90,256574
5404,0.00328,74.125.24.0-255,10692,242535,90,256574
5405,0.003284,172.31.47.0-255,66,242601,90,256574
5406,0.003304,172.31.47.0-255,66,242667,90,256574
5407,0.003336,74.125.24.0-255,7156,249823,90,256574
5408,0.003339,172.31.47.0-255,66,249889,90,256574
5409,0.003373,172.31.47.0-255,66,249955,90,256574
5410,0.003383,172.31.47.0-255,66,250021,90,256574
5411,0.003389,74.125.24.0-255,6211,256232,90,256574
5412,0.003391,74.125.24.0-255,105,256337,90,256574
5413,0.003417,172.31.47.0-255,66,256403,90,256574
5414,0.004861,172.31.47.0-255,105,256508,90,256574
5415,0.007168,74.125.24.0-255,66,256574,90,256574
5416,0.0,172.31.47.0-255,105,105,90,276
5417,0.00149,157.240.13.0-255,105,210,90,276
5418,0.001501,172.31.47.0-255,66,276,90,276
5419,0.0,172.31.47.0-255,66,66,90,66
5420,0.0,172.217.194.0-255,143,143,90,307439
5421,2.5e-05,172.31.47.0-255,66,209,90,307439
5422,3.1e-05,172.217.194.0-255,1484,1693,90,307439
5423,3.4e-05,172.31.47.0-255,66,1759,90,307439
5424,3.9e-05,172.217.194.0-255,2902,4661,90,307439
5425,4.1e-05,172.31.47.0-255,66,4727,90,307439
5426,4.6e-05,172.217.194.0-255,5738,10465,90,307439
5427,4.8e-05,172.31.47.0-255,66,10531,90,307439
5428,6.6e-05,172.217.194.0-255,1484,12015,90,307439
5429,6.8e-05,172.31.47.0-255,66,12081,90,307439
5430,7.7e-05,172.217.194.0-255,1983,14064,90,307439
5431,7.9e-05,172.31.47.0-255,66,14130,90,307439
5432,0.0001,172.217.194.0-255,1484,15614,90,307439
5433,0.000103,172.31.47.0-255,66,15680,90,307439
5434,0.000132,172.217.194.0-255,9992,25672,90,307439
5435,0.000135,172.31.47.0-255,66,25738,90,307439
5436,0.00014,172.217.194.0-255,5379,31117,90,307439
5437,0.000142,172.31.47.0-255,66,31183,90,307439
5438,0.00018,172.217.194.0-255,4320,35503,90,307439
5439,0.000183,172.31.47.0-255,66,35569,90,307439
5440,0.000223,172.31.47.0-255,66,35635,90,307439
5441,0.00026,172.217.194.0-255,1484,37119,90,307439
5442,0.000262,172.31.47.0-255,66,37185,90,307439
5443,0.000267,172.217.194.0-255,2902,40087,90,307439
5444,0.000269,172.31.47.0-255,66,40153,90,307439
5445,0.000295,172.217.194.0-255,5738,45891,90,307439
5446,0.000298,172.31.47.0-255,66,45957,90,307439
5447,0.000339,172.217.194.0-255,2902,48859,90,307439
5448,0.000341,172.31.47.0-255,66,48925,90,307439
5449,0.000368,172.217.194.0-255,4542,53467,90,307439
5450,0.000371,172.31.47.0-255,66,53533,90,307439
5451,0.000379,172.217.194.0-255,8574,62107,90,307439
5452,0.000381,172.31.47.0-255,66,62173,90,307439
5453,0.000432,172.217.194.0-255,4320,66493,90,307439
5454,0.000436,172.31.47.0-255,66,66559,90,307439
5455,0.000458,172.217.194.0-255,3411,69970,90,307439
5456,0.000461,172.31.47.0-255,66,70036,90,307439
5457,0.000477,172.217.194.0-255,5738,75774,90,307439
5458,0.000484,172.31.47.0-255,66,75840,90,307439
5459,0.000502,172.217.194.0-255,1484,77324,90,307439
5460,0.00051,172.217.194.0-255,8574,85898,90,307439
5461,0.000513,172.31.47.0-255,66,85964,90,307439
5462,0.000515,172.217.194.0-255,1125,87089,90,307439
5463,0.000742,172.217.194.0-255,1484,88573,90,307439
5464,0.000751,172.31.47.0-255,66,88639,90,307439
5465,0.000755,172.217.194.0-255,2902,91541,90,307439
5466,0.000757,172.31.47.0-255,66,91607,90,307439
5467,0.00076,172.217.194.0-255,1484,93091,90,307439
5468,0.000788,172.217.194.0-255,4320,97411,90,307439
5469,0.000791,172.31.47.0-255,66,97477,90,307439
5470,0.000796,172.217.194.0-255,5738,103215,90,307439
5471,0.000798,172.31.47.0-255,66,103281,90,307439
5472,0.000802,172.217.194.0-255,2902,106183,90,307439
5473,0.000803,172.31.47.0-255,66,106249,90,307439
5474,0.000838,172.217.194.0-255,9992,116241,90,307439
5475,0.000841,172.31.47.0-255,66,116307,90,307439
5476,0.000846,172.217.194.0-255,5020,121327,90,307439
5477,0.000848,172.31.47.0-255,66,121393,90,307439
5478,0.001075,172.217.194.0-255,1484,122877,90,307439
5479,0.001089,172.217.194.0-255,2902,125779,90,307439
5480,0.001092,172.31.47.0-255,66,125845,90,307439
5481,0.001128,172.217.194.0-255,2902,128747,90,307439
5482,0.001131,172.31.47.0-255,66,128813,90,307439
5483,0.001157,172.217.194.0-255,2902,131715,90,307439
5484,0.00116,172.31.47.0-255,66,131781,90,307439
5485,0.00118,172.31.47.0-255,66,131847,90,307439
5486,0.001187,172.217.194.0-255,8574,140421,90,307439
5487,0.001188,172.31.47.0-255,66,140487,90,307439
5488,0.001195,172.217.194.0-255,7156,147643,90,307439
5489,0.001197,172.31.47.0-255,66,147709,90,307439
5490,0.001228,172.217.194.0-255,2184,149893,90,307439
5491,0.00123,172.31.47.0-255,66,149959,90,307439
5492,0.001238,172.217.194.0-255,9992,159951,90,307439
5493,0.00124,172.31.47.0-255,66,160017,90,307439
5494,0.001244,172.217.194.0-255,2902,162919,90,307439
5495,0.001245,172.31.47.0-255,66,162985,90,307439
5496,0.001291,172.31.47.0-255,66,163051,90,307439
5497,0.00131,172.217.194.0-255,1484,164535,90,307439
5498,0.001331,172.217.194.0-255,2902,167437,90,307439
5499,0.001334,172.31.47.0-255,66,167503,90,307439
5500,0.001366,172.217.194.0-255,5738,173241,90,307439
5501,0.001369,172.31.47.0-255,66,173307,90,307439
5502,0.001383,172.217.194.0-255,4320,177627,90,307439
5503,0.001385,172.31.47.0-255,66,177693,90,307439
5504,0.001419,172.217.194.0-255,8574,186267,90,307439
5505,0.001422,172.31.47.0-255,66,186333,90,307439
5506,0.001431,172.217.194.0-255,10692,197025,90,307439
5507,0.001433,172.31.47.0-255,66,197091,90,307439
5508,0.001444,172.31.47.0-255,66,197157,90,307439
5509,0.001446,172.217.194.0-255,1484,198641,90,307439
5510,0.001478,172.217.194.0-255,5738,204379,90,307439
5511,0.001482,172.31.47.0-255,66,204445,90,307439
5512,0.001496,172.217.194.0-255,8574,213019,90,307439
5513,0.001503,172.31.47.0-255,66,213085,90,307439
5514,0.001508,172.217.194.0-255,6438,219523,90,307439
5515,0.001511,172.31.47.0-255,66,219589,90,307439
5516,0.001541,172.217.194.0-255,2902,222491,90,307439
5517,0.001544,172.31.47.0-255,66,222557,90,307439
5518,0.001571,172.217.194.0-255,4320,226877,90,307439
5519,0.001574,172.31.47.0-255,66,226943,90,307439
5520,0.001581,172.217.194.0-255,8574,235517,90,307439
5521,0.001583,172.31.47.0-255,66,235583,90,307439
5522,0.001586,172.217.194.0-255,1484,237067,90,307439
5523,0.001625,172.31.47.0-255,66,237133,90,307439
5524,0.001628,172.217.194.0-255,766,237899,90,307439
5525,0.001666,172.217.194.0-255,1484,239383,90,307439
5526,0.00167,172.217.194.0-255,2902,242285,90,307439
5527,0.00167,172.31.47.0-255,66,242351,90,307439
5528,0.001673,172.31.47.0-255,66,242417,90,307439
5529,0.001696,172.217.194.0-255,1484,243901,90,307439
5530,0.001702,172.217.194.0-255,7156,251057,90,307439
5531,0.001705,172.31.47.0-255,66,251123,90,307439
5532,0.001716,172.217.194.0-255,8574,259697,90,307439
5533,0.001719,172.31.47.0-255,66,259763,90,307439
5534,0.001785,172.31.47.0-255,66,259829,90,307439
5535,0.001811,172.217.194.0-255,1484,261313,90,307439
5536,0.001826,172.217.194.0-255,2902,264215,90,307439
5537,0.00183,172.31.47.0-255,66,264281,90,307439
5538,0.00186,172.217.194.0-255,5738,270019,90,307439
5539,0.001863,172.31.47.0-255,66,270085,90,307439
5540,0.001868,172.217.194.0-255,5738,275823,90,307439
5541,0.001869,172.31.47.0-255,66,275889,90,307439
5542,0.001872,172.217.194.0-255,1484,277373,90,307439
5543,0.001903,172.31.47.0-255,66,277439,90,307439
5544,0.001926,172.217.194.0-255,4320,281759,90,307439
5545,0.001929,172.31.47.0-255,66,281825,90,307439
5546,0.001932,172.217.194.0-255,766,282591,90,307439
5547,0.001967,172.217.194.0-255,1484,284075,90,307439
5548,0.00197,172.31.47.0-255,66,284141,90,307439
5549,0.001974,172.217.194.0-255,2902,287043,90,307439
5550,0.001976,172.31.47.0-255,66,287109,90,307439
5551,0.002004,172.217.194.0-255,5738,292847,90,307439
5552,0.002007,172.31.47.0-255,66,292913,90,307439
5553,0.002012,172.217.194.0-255,5738,298651,90,307439
5554,0.002014,172.31.47.0-255,66,298717,90,307439
5555,0.002017,172.217.194.0-255,1484,300201,90,307439
5556,0.00206,172.31.47.0-255,66,300267,90,307439
5557,0.002066,172.217.194.0-255,6379,306646,90,307439
5558,0.002068,172.31.47.0-255,66,306712,90,307439
5559,0.002071,172.217.194.0-255,97,306809,90,307439
5560,0.002127,172.217.194.0-255,105,306914,90,307439
5561,0.007326,172.31.47.0-255,105,307019,90,307439
5562,0.007608,172.31.47.0-255,90,307109,90,307439
5563,0.007616,172.31.47.0-255,66,307175,90,307439
5564,0.009624,172.217.194.0-255,66,307241,90,307439
5565,0.009874,172.217.194.0-255,66,307307,90,307439
5566,0.009898,172.217.194.0-255,66,307373,90,307439
5567,0.009903,172.31.47.0-255,66,307439,90,307439
5568,0.0,74.125.24.0-255,153,153,90,227838
5569,3.1e-05,172.31.47.0-255,66,219,90,227838
5570,3.8e-05,74.125.24.0-255,1484,1703,90,227838
5571,4.2e-05,172.31.47.0-255,66,1769,90,227838
5572,5.2e-05,74.125.24.0-255,2902,4671,90,227838
5573,5.5e-05,172.31.47.0-255,66,4737,90,227838
5574,6e-05,74.125.24.0-255,4320,9057,90,227838
5575,6.2e-05,172.31.47.0-255,66,9123,90,227838
5576,8.3e-05,74.125.24.0-255,1484,10607,90,227838
5577,8.5e-05,172.31.47.0-255,66,10673,90,227838
5578,9e-05,74.125.24.0-255,4320,14993,90,227838
5579,9.2e-05,172.31.47.0-255,66,15059,90,227838
5580,0.000116,74.125.24.0-255,2015,17074,90,227838
5581,0.000118,172.31.47.0-255,66,17140,90,227838
5582,0.000124,74.125.24.0-255,7156,24296,90,227838
5583,0.000127,172.31.47.0-255,66,24362,90,227838
5584,0.00013,74.125.24.0-255,1484,25846,90,227838
5585,0.000132,172.31.47.0-255,66,25912,90,227838
5586,0.000163,74.125.24.0-255,5379,31291,90,227838
5587,0.000168,172.31.47.0-255,66,31357,90,227838
5588,0.00031,74.125.24.0-255,1484,32841,90,227838
5589,0.000314,172.31.47.0-255,66,32907,90,227838
5590,0.000343,74.125.24.0-255,2902,35809,90,227838
5591,0.000346,172.31.47.0-255,66,35875,90,227838
5592,0.000351,74.125.24.0-255,4320,40195,90,227838
5593,0.000353,172.31.47.0-255,66,40261,90,227838
5594,0.000364,74.125.24.0-255,5738,45999,90,227838
5595,0.000367,172.31.47.0-255,66,46065,90,227838
5596,0.000397,172.31.47.0-255,66,46131,90,227838
5597,0.000403,74.125.24.0-255,7065,53196,90,227838
5598,0.000406,172.31.47.0-255,66,53262,90,227838
5599,0.000488,74.125.24.0-255,134,53396,90,227838
5600,0.000601,74.125.24.0-255,350,53746,90,227838
5601,0.000723,172.31.47.0-255,66,53812,90,227838
5602,0.000869,74.125.24.0-255,1484,55296,90,227838
5603,0.000878,74.125.24.0-255,2902,58198,90,227838
5604,0.000882,172.31.47.0-255,66,58264,90,227838
5605,0.000913,74.125.24.0-255,5738,64002,90,227838
5606,0.000917,172.31.47.0-255,66,64068,90,227838
5607,0.000921,74.125.24.0-255,2902,66970,90,227838
5608,0.000923,172.31.47.0-255,66,67036,90,227838
5609,0.000947,74.125.24.0-255,7156,74192,90,227838
5610,0.000951,172.31.47.0-255,66,74258,90,227838
5611,0.000957,74.125.24.0-255,8574,82832,90,227838
5612,0.000959,172.31.47.0-255,66,82898,90,227838
5613,0.000987,74.125.24.0-255,1484,84382,90,227838
5614,0.00101,74.125.24.0-255,3602,87984,90,227838
5615,0.001014,172.31.47.0-255,66,88050,90,227838
5616,0.001176,74.125.24.0-255,1484,89534,90,227838
5617,0.001197,74.125.24.0-255,2902,92436,90,227838
5618,0.001201,172.31.47.0-255,66,92502,90,227838
5619,0.001206,74.125.24.0-255,4320,96822,90,227838
5620,0.001208,172.31.47.0-255,66,96888,90,227838
5621,0.001214,74.125.24.0-255,7156,104044,90,227838
5622,0.001221,172.31.47.0-255,66,104110,90,227838
5623,0.001253,74.125.24.0-255,1484,105594,90,227838
5624,0.001268,172.31.47.0-255,66,105660,90,227838
5625,0.001291,74.125.24.0-255,2184,107844,90,227838
5626,0.001293,172.31.47.0-255,66,107910,90,227838
5627,0.001399,74.125.24.0-255,1484,109394,90,227838
5628,0.001427,74.125.24.0-255,2902,112296,90,227838
5629,0.00143,172.31.47.0-255,66,112362,90,227838
5630,0.001458,74.125.24.0-255,5738,118100,90,227838
5631,0.00146,74.125.24.0-255,1484,119584,90,227838
5632,0.001492,172.31.47.0-255,66,119650,90,227838
5633,0.001501,74.125.24.0-255,2902,122552,90,227838
5634,0.001503,172.31.47.0-255,66,122618,90,227838
5635,0.001532,74.125.24.0-255,9992,132610,90,227838
5636,0.001534,172.31.47.0-255,66,132676,90,227838
5637,0.001558,74.125.24.0-255,5738,138414,90,227838
5638,0.001561,172.31.47.0-255,66,138480,90,227838
5639,0.001583,74.125.24.0-255,3602,142082,90,227838
5640,0.001586,172.31.47.0-255,66,142148,90,227838
5641,0.001681,74.125.24.0-255,1484,143632,90,227838
5642,0.001732,74.125.24.0-255,2902,146534,90,227838
5643,0.001735,172.31.47.0-255,66,146600,90,227838
5644,0.001758,74.125.24.0-255,2902,149502,90,227838
5645,0.00176,172.31.47.0-255,66,149568,90,227838
5646,0.001807,74.125.24.0-255,1484,151052,90,227838
5647,0.001826,74.125.24.0-255,5738,156790,90,227838
5648,0.001829,172.31.47.0-255,66,156856,90,227838
5649,0.001833,74.125.24.0-255,2902,159758,90,227838
5650,0.001834,172.31.47.0-255,66,159824,90,227838
5651,0.00186,74.125.24.0-255,5738,165562,90,227838
5652,0.001866,172.31.47.0-255,66,165628,90,227838
5653,0.001868,74.125.24.0-255,1484,167112,90,227838
5654,0.001889,74.125.24.0-255,2902,170014,90,227838
5655,0.001891,172.31.47.0-255,66,170080,90,227838
5656,0.001926,74.125.24.0-255,9274,179354,90,227838
5657,0.001929,172.31.47.0-255,66,179420,90,227838
5658,0.001936,74.125.24.0-255,9992,189412,90,227838
5659,0.001938,172.31.47.0-255,66,189478,90,227838
5660,0.001964,74.125.24.0-255,2902,192380,90,227838
5661,0.001967,172.31.47.0-255,66,192446,90,227838
5662,0.001973,74.125.24.0-255,7156,199602,90,227838
5663,0.001975,172.31.47.0-255,66,199668,90,227838
5664,0.002006,74.125.24.0-255,10692,210360,90,227838
5665,0.002008,172.31.47.0-255,66,210426,90,227838
5666,0.00406,74.125.24.0-255,5738,216164,90,227838
5667,0.004066,172.31.47.0-255,66,216230,90,227838
5668,0.006125,74.125.24.0-255,5738,221968,90,227838
5669,0.006132,172.31.47.0-255,66,222034,90,227838
5670,0.008246,74.125.24.0-255,5738,227772,90,227838
5671,0.008263,172.31.47.0-255,66,227838,90,227838
5672,0.0,74.125.68.0-255,152,152,90,83048
5673,2.3e-05,172.31.47.0-255,66,218,90,83048
5674,3e-05,74.125.68.0-255,1484,1702,90,83048
5675,3.4e-05,172.31.47.0-255,66,1768,90,83048
5676,3.7e-05,74.125.68.0-255,1484,3252,90,83048
5677,4.1e-05,172.31.47.0-255,66,3318,90,83048
5678,6.1e-05,74.125.68.0-255,1484,4802,90,83048
5679,6.4e-05,172.31.47.0-255,66,4868,90,83048
5680,7.2e-05,74.125.68.0-255,7156,12024,90,83048
5681,7.5e-05,172.31.47.0-255,66,12090,90,83048
5682,7.9e-05,74.125.68.0-255,2102,14192,90,83048
5683,8.2e-05,172.31.47.0-255,66,14258,90,83048
5684,0.000157,74.125.68.0-255,1484,15742,90,83048
5685,0.000162,172.31.47.0-255,66,15808,90,83048
5686,0.000183,74.125.68.0-255,2902,18710,90,83048
5687,0.000189,74.125.68.0-255,5738,24448,90,83048
5688,0.000188,172.31.47.0-255,66,24514,90,83048
5689,0.000192,172.31.47.0-255,66,24580,90,83048
5690,0.000216,74.125.68.0-255,1484,26064,90,83048
5691,0.000219,172.31.47.0-255,66,26130,90,83048
5692,0.000242,74.125.68.0-255,5379,31509,90,83048
5693,0.000246,172.31.47.0-255,66,31575,90,83048
5694,0.000279,74.125.68.0-255,1484,33059,90,83048
5695,0.000282,172.31.47.0-255,66,33125,90,83048
5696,0.000286,74.125.68.0-255,2902,36027,90,83048
5697,0.000289,172.31.47.0-255,66,36093,90,83048
5698,0.00031,74.125.68.0-255,2902,38995,90,83048
5699,0.000313,172.31.47.0-255,66,39061,90,83048
5700,0.000333,74.125.68.0-255,2902,41963,90,83048
5701,0.000336,172.31.47.0-255,66,42029,90,83048
5702,0.00034,74.125.68.0-255,2902,44931,90,83048
5703,0.000343,172.31.47.0-255,66,44997,90,83048
5704,0.000347,74.125.68.0-255,3961,48958,90,83048
5705,0.000349,172.31.47.0-255,66,49024,90,83048
5706,0.000437,74.125.68.0-255,1484,50508,90,83048
5707,0.000443,74.125.68.0-255,2902,53410,90,83048
5708,0.000447,172.31.47.0-255,66,53476,90,83048
5709,0.000473,74.125.68.0-255,5738,59214,90,83048
5710,0.000476,172.31.47.0-255,66,59280,90,83048
5711,0.00048,74.125.68.0-255,2902,62182,90,83048
5712,0.000483,172.31.47.0-255,66,62248,90,83048
5713,0.000522,74.125.68.0-255,3961,66209,90,83048
5714,0.000527,172.31.47.0-255,66,66275,90,83048
5715,0.001147,74.125.68.0-255,647,66922,90,83048
5716,0.005445,74.125.68.0-255,1484,68406,90,83048
5717,0.005455,172.31.47.0-255,66,68472,90,83048
5718,0.005462,74.125.68.0-255,2902,71374,90,83048
5719,0.005464,172.31.47.0-255,66,71440,90,83048
5720,0.007531,74.125.68.0-255,5738,77178,90,83048
5721,0.007539,172.31.47.0-255,66,77244,90,83048
5722,0.009632,74.125.68.0-255,5738,82982,90,83048
5723,0.009639,172.31.47.0-255,66,83048,90,83048
5724,0.0,74.125.24.0-255,153,153,90,213807
5725,1.7e-05,172.31.47.0-255,66,219,90,213807
5726,2.3e-05,74.125.24.0-255,1484,1703,90,213807
5727,2.7e-05,172.31.47.0-255,66,1769,90,213807
5728,3.2e-05,74.125.24.0-255,2902,4671,90,213807
5729,3.5e-05,172.31.47.0-255,66,4737,90,213807
5730,4e-05,74.125.24.0-255,2902,7639,90,213807
5731,4.3e-05,172.31.47.0-255,66,7705,90,213807
5732,9.8e-05,74.125.24.0-255,6438,14143,90,213807
5733,0.000102,172.31.47.0-255,66,14209,90,213807
5734,0.000142,74.125.24.0-255,1484,15693,90,213807
5735,0.000145,172.31.47.0-255,66,15759,90,213807
5736,0.000148,74.125.24.0-255,1484,17243,90,213807
5737,0.00015,172.31.47.0-255,66,17309,90,213807
5738,0.000163,74.125.24.0-255,1484,18793,90,213807
5739,0.000165,172.31.47.0-255,66,18859,90,213807
5740,0.000172,74.125.24.0-255,5738,24597,90,213807
5741,0.000174,172.31.47.0-255,66,24663,90,213807
5742,0.000208,74.125.24.0-255,6797,31460,90,213807
5743,0.000211,172.31.47.0-255,66,31526,90,213807
5744,0.00024,74.125.24.0-255,1484,33010,90,213807
5745,0.000243,172.31.47.0-255,66,33076,90,213807
5746,0.00026,74.125.24.0-255,1484,34560,90,213807
5747,0.000262,172.31.47.0-255,66,34626,90,213807
5748,0.000267,74.125.24.0-255,4320,38946,90,213807
5749,0.000269,172.31.47.0-255,66,39012,90,213807
5750,0.000295,74.125.24.0-255,1484,40496,90,213807
5751,0.000297,172.31.47.0-255,66,40562,90,213807
5752,0.000318,74.125.24.0-255,2902,43464,90,213807
5753,0.00032,172.31.47.0-255,66,43530,90,213807
5754,0.000359,74.125.24.0-255,5379,48909,90,213807
5755,0.000362,172.31.47.0-255,66,48975,90,213807
5756,0.000416,74.125.24.0-255,1484,50459,90,213807
5757,0.000448,74.125.24.0-255,2902,53361,90,213807
5758,0.000451,172.31.47.0-255,66,53427,90,213807
5759,0.000454,74.125.24.0-255,1484,54911,90,213807
5760,0.00047,74.125.24.0-255,2902,57813,90,213807
5761,0.000473,172.31.47.0-255,66,57879,90,213807
5762,0.000495,74.125.24.0-255,1484,59363,90,213807
5763,0.000508,74.125.24.0-255,2902,62265,90,213807
5764,0.00051,172.31.47.0-255,66,62331,90,213807
5765,0.000522,74.125.24.0-255,3961,66292,90,213807
5766,0.000524,172.31.47.0-255,66,66358,90,213807
5767,0.000606,74.125.24.0-255,409,66767,90,213807
5768,0.000623,74.125.24.0-255,334,67101,90,213807
5769,0.000721,74.125.24.0-255,1484,68585,90,213807
5770,0.000725,172.31.47.0-255,66,68651,90,213807
5771,0.000728,74.125.24.0-255,1484,70135,90,213807
5772,0.000742,74.125.24.0-255,1484,71619,90,213807
5773,0.000744,172.31.47.0-255,66,71685,90,213807
5774,0.000749,74.125.24.0-255,2902,74587,90,213807
5775,0.00075,172.31.47.0-255,66,74653,90,213807
5776,0.000764,74.125.24.0-255,2902,77555,90,213807
5777,0.000767,172.31.47.0-255,66,77621,90,213807
5778,0.000791,74.125.24.0-255,4320,81941,90,213807
5779,0.000793,172.31.47.0-255,66,82007,90,213807
5780,0.000813,74.125.24.0-255,8574,90581,90,213807
5781,0.000815,172.31.47.0-255,66,90647,90,213807
5782,0.000822,74.125.24.0-255,7156,97803,90,213807
5783,0.000824,172.31.47.0-255,66,97869,90,213807
5784,0.000845,74.125.24.0-255,3602,101471,90,213807
5785,0.000847,172.31.47.0-255,66,101537,90,213807
5786,0.00089,74.125.24.0-255,4320,105857,90,213807
5787,0.000894,172.31.47.0-255,66,105923,90,213807
5788,0.000898,74.125.24.0-255,2902,108825,90,213807
5789,0.0009,172.31.47.0-255,66,108891,90,213807
5790,0.000922,74.125.24.0-255,7156,116047,90,213807
5791,0.000924,172.31.47.0-255,66,116113,90,213807
5792,0.00094,74.125.24.0-255,1484,117597,90,213807
5793,0.000969,74.125.24.0-255,4320,121917,90,213807
5794,0.000972,172.31.47.0-255,66,121983,90,213807
5795,0.001014,172.31.47.0-255,66,122049,90,213807
5796,0.001019,74.125.24.0-255,7156,129205,90,213807
5797,0.001022,172.31.47.0-255,66,129271,90,213807
5798,0.001028,74.125.24.0-255,8574,137845,90,213807
5799,0.00103,172.31.47.0-255,66,137911,90,213807
5800,0.001061,74.125.24.0-255,9992,147903,90,213807
5801,0.001063,172.31.47.0-255,66,147969,90,213807
5802,0.001081,74.125.24.0-255,7156,155125,90,213807
5803,0.001083,74.125.24.0-255,766,155891,90,213807
5804,0.001086,172.31.47.0-255,66,155957,90,213807
5805,0.00169,74.125.24.0-255,1484,157441,90,213807
5806,0.001694,172.31.47.0-255,66,157507,90,213807
5807,0.001713,74.125.24.0-255,1484,158991,90,213807
5808,0.001734,74.125.24.0-255,2902,161893,90,213807
5809,0.001737,172.31.47.0-255,66,161959,90,213807
5810,0.001751,74.125.24.0-255,1484,163443,90,213807
5811,0.001767,74.125.24.0-255,2902,166345,90,213807
5812,0.00177,172.31.47.0-255,66,166411,90,213807
5813,0.001788,74.125.24.0-255,1484,167895,90,213807
5814,0.001805,74.125.24.0-255,4320,172215,90,213807
5815,0.001808,172.31.47.0-255,66,172281,90,213807
5816,0.001811,74.125.24.0-255,2902,175183,90,213807
5817,0.001813,172.31.47.0-255,66,175249,90,213807
5818,0.001828,74.125.24.0-255,2902,178151,90,213807
5819,0.00183,172.31.47.0-255,66,178217,90,213807
5820,0.001846,74.125.24.0-255,7156,185373,90,213807
5821,0.001848,172.31.47.0-255,66,185439,90,213807
5822,0.001869,74.125.24.0-255,1484,186923,90,213807
5823,0.001885,74.125.24.0-255,3602,190525,90,213807
5824,0.001887,172.31.47.0-255,66,190591,90,213807
5825,0.003821,74.125.24.0-255,5738,196329,90,213807
5826,0.003827,172.31.47.0-255,66,196395,90,213807
5827,0.005796,74.125.24.0-255,5738,202133,90,213807
5828,0.005799,172.31.47.0-255,66,202199,90,213807
5829,0.007741,74.125.24.0-255,5738,207937,90,213807
5830,0.007747,172.31.47.0-255,66,208003,90,213807
5831,0.009746,74.125.24.0-255,5738,213741,90,213807
5832,0.009752,172.31.47.0-255,66,213807,90,213807
5833,0.0,192.229.237.0-255,128,128,90,611
5834,1.6e-05,192.229.237.0-255,90,218,90,611
5835,2e-05,192.229.237.0-255,66,284,90,611
5836,0.000148,172.31.47.0-255,105,389,90,611
5837,0.00032,172.31.47.0-255,90,479,90,611
5838,0.00033,172.31.47.0-255,66,545,90,611
5839,0.00176,192.229.237.0-255,66,611,90,611
5840,0.0,74.125.200.0-255,226,226,90,141880
5841,3e-05,172.31.47.0-255,66,292,90,141880
5842,3.5e-05,74.125.200.0-255,1484,1776,90,141880
5843,3.8e-05,172.31.47.0-255,66,1842,90,141880
5844,6.5e-05,74.125.200.0-255,2902,4744,90,141880
5845,6.7e-05,172.31.47.0-255,66,4810,90,141880
5846,8.4e-05,74.125.200.0-255,1484,6294,90,141880
5847,8.7e-05,172.31.47.0-255,66,6360,90,141880
5848,0.00027,74.125.200.0-255,5738,12098,90,141880
5849,0.000275,172.31.47.0-255,66,12164,90,141880
5850,0.00051,74.125.200.0-255,2028,14192,90,141880
5851,0.000514,172.31.47.0-255,66,14258,90,141880
5852,0.00059,74.125.200.0-255,2902,17160,90,141880
5853,0.000594,172.31.47.0-255,66,17226,90,141880
5854,0.000718,74.125.200.0-255,7156,24382,90,141880
5855,0.000725,172.31.47.0-255,66,24448,90,141880
5856,0.001025,74.125.200.0-255,4320,28768,90,141880
5857,0.001029,172.31.47.0-255,66,28834,90,141880
5858,0.001045,74.125.200.0-255,8574,37408,90,141880
5859,0.001047,172.31.47.0-255,66,37474,90,141880
5860,0.002236,74.125.200.0-255,2902,40376,90,141880
5861,0.002241,172.31.47.0-255,66,40442,90,141880
5862,0.002279,74.125.200.0-255,2902,43344,90,141880
5863,0.002282,172.31.47.0-255,66,43410,90,141880
5864,0.002401,74.125.200.0-255,2902,46312,90,141880
5865,0.002406,172.31.47.0-255,66,46378,90,141880
5866,0.002423,74.125.200.0-255,2902,49280,90,141880
5867,0.002426,172.31.47.0-255,66,49346,90,141880
5868,0.002651,74.125.200.0-255,2902,52248,90,141880
5869,0.002654,172.31.47.0-255,66,52314,90,141880
5870,0.002784,74.125.200.0-255,5738,58052,90,141880
5871,0.002788,172.31.47.0-255,66,58118,90,141880
5872,0.003028,74.125.200.0-255,5738,63856,90,141880
5873,0.003033,172.31.47.0-255,66,63922,90,141880
5874,0.00328,74.125.200.0-255,5738,69660,90,141880
5875,0.003285,172.31.47.0-255,66,69726,90,141880
5876,0.003544,74.125.200.0-255,5738,75464,90,141880
5877,0.003549,172.31.47.0-255,66,75530,90,141880
5878,0.003566,74.125.200.0-255,2902,78432,90,141880
5879,0.003568,172.31.47.0-255,66,78498,90,141880
5880,0.003865,74.125.200.0-255,5738,84236,90,141880
5881,0.00387,172.31.47.0-255,66,84302,90,141880
5882,0.003885,74.125.200.0-255,5738,90040,90,141880
5883,0.003887,172.31.47.0-255,66,90106,90,141880
5884,0.004325,74.125.200.0-255,8574,98680,90,141880
5885,0.004331,172.31.47.0-255,66,98746,90,141880
5886,0.004573,74.125.200.0-255,5738,104484,90,141880
5887,0.004578,172.31.47.0-255,66,104550,90,141880
5888,0.005073,74.125.200.0-255,2902,107452,90,141880
5889,0.005128,74.125.200.0-255,2902,110354,90,141880
5890,0.005148,74.125.200.0-255,7156,117510,90,141880
5891,0.005175,74.125.200.0-255,9992,127502,90,141880
5892,0.005506,74.125.200.0-255,7156,134658,90,141880
5893,0.005881,74.125.200.0-255,7156,141814,90,141880
5894,0.008378,172.31.47.0-255,66,141880,90,141880
5895,0.0,172.31.47.0-255,105,105,90,719
5896,0.001158,172.31.47.0-255,90,195,90,719
5897,0.001169,172.31.47.0-255,66,261,90,719
5898,0.001482,172.31.47.0-255,97,358,90,719
5899,0.002215,74.125.24.0-255,97,455,90,719
5900,0.00344,172.217.194.0-255,66,521,90,719
5901,0.003455,172.217.194.0-255,66,587,90,719
5902,0.00347,172.31.47.0-255,66,653,90,719
5903,0.0037,74.125.24.0-255,66,719,90,719
5904,0.0,74.125.24.0-255,153,153,90,205632
5905,1.5e-05,172.31.47.0-255,66,219,90,205632
5906,2e-05,74.125.24.0-255,1484,1703,90,205632
5907,2.3e-05,172.31.47.0-255,66,1769,90,205632
5908,3.9e-05,74.125.24.0-255,2902,4671,90,205632
5909,4.1e-05,172.31.47.0-255,66,4737,90,205632
5910,7.4e-05,74.125.24.0-255,1484,6221,90,205632
5911,7.6e-05,172.31.47.0-255,66,6287,90,205632
5912,9.8e-05,74.125.24.0-255,5738,12025,90,205632
5913,0.0001,172.31.47.0-255,66,12091,90,205632
5914,0.000103,74.125.24.0-255,2054,14145,90,205632
5915,0.000105,172.31.47.0-255,66,14211,90,205632
5916,0.00017,74.125.24.0-255,1484,15695,90,205632
5917,0.000173,172.31.47.0-255,66,15761,90,205632
5918,0.000178,74.125.24.0-255,2902,18663,90,205632
5919,0.00018,172.31.47.0-255,66,18729,90,205632
5920,0.000191,74.125.24.0-255,1484,20213,90,205632
5921,0.000193,172.31.47.0-255,66,20279,90,205632
5922,0.000221,74.125.24.0-255,4320,24599,90,205632
5923,0.000224,172.31.47.0-255,66,24665,90,205632
5924,0.000229,74.125.24.0-255,5738,30403,90,205632
5925,0.000231,172.31.47.0-255,66,30469,90,205632
5926,0.000247,74.125.24.0-255,1125,31594,90,205632
5927,0.00025,172.31.47.0-255,66,31660,90,205632
5928,0.00062,74.125.24.0-255,1484,33144,90,205632
5929,0.000625,172.31.47.0-255,66,33210,90,205632
5930,0.000631,74.125.24.0-255,2902,36112,90,205632
5931,0.000633,172.31.47.0-255,66,36178,90,205632
5932,0.000637,74.125.24.0-255,4320,40498,90,205632
5933,0.000639,172.31.47.0-255,66,40564,90,205632
5934,0.000665,74.125.24.0-255,1484,42048,90,205632
5935,0.000668,172.31.47.0-255,66,42114,90,205632
5936,0.000674,74.125.24.0-255,6797,48911,90,205632
5937,0.000676,172.31.47.0-255,66,48977,90,205632
5938,0.000679,74.125.24.0-255,2902,51879,90,205632
5939,0.00068,172.31.47.0-255,66,51945,90,205632
5940,0.00072,172.31.47.0-255,66,52011,90,205632
5941,0.000724,74.125.24.0-255,2543,54554,90,205632
5942,0.000725,172.31.47.0-255,66,54620,90,205632
5943,0.001187,74.125.24.0-255,645,55265,90,205632
5944,0.00121,172.31.47.0-255,66,55331,90,205632
5945,0.001245,74.125.24.0-255,1484,56815,90,205632
5946,0.001249,74.125.24.0-255,2902,59717,90,205632
5947,0.001252,172.31.47.0-255,66,59783,90,205632
5948,0.001255,74.125.24.0-255,1484,61267,90,205632
5949,0.001266,74.125.24.0-255,2902,64169,90,205632
5950,0.001268,172.31.47.0-255,66,64235,90,205632
5951,0.001277,74.125.24.0-255,1484,65719,90,205632
5952,0.001298,74.125.24.0-255,7156,72875,90,205632
5953,0.0013,172.31.47.0-255,66,72941,90,205632
5954,0.001304,74.125.24.0-255,4320,77261,90,205632
5955,0.001306,172.31.47.0-255,66,77327,90,205632
5956,0.001324,74.125.24.0-255,9992,87319,90,205632
5957,0.001326,172.31.47.0-255,66,87385,90,205632
5958,0.001329,74.125.24.0-255,2184,89569,90,205632
5959,0.001331,172.31.47.0-255,66,89635,90,205632
5960,0.001373,74.125.24.0-255,1484,91119,90,205632
5961,0.001392,74.125.24.0-255,1484,92603,90,205632
5962,0.001396,74.125.24.0-255,4320,96923,90,205632
5963,0.001397,74.125.24.0-255,1484,98407,90,205632
5964,0.001401,172.31.47.0-255,66,98473,90,205632
5965,0.001404,172.31.47.0-255,66,98539,90,205632
5966,0.001419,74.125.24.0-255,7156,105695,90,205632
5967,0.001422,172.31.47.0-255,66,105761,90,205632
5968,0.001448,74.125.24.0-255,7156,112917,90,205632
5969,0.001451,172.31.47.0-255,66,112983,90,205632
5970,0.001475,74.125.24.0-255,10692,123675,90,205632
5971,0.001478,172.31.47.0-255,66,123741,90,205632
5972,0.00148,74.125.24.0-255,1484,125225,90,205632
5973,0.001508,74.125.24.0-255,2902,128127,90,205632
5974,0.001511,172.31.47.0-255,66,128193,90,205632
5975,0.001517,74.125.24.0-255,5738,133931,90,205632
5976,0.001519,172.31.47.0-255,66,133997,90,205632
5977,0.001567,74.125.24.0-255,5203,139200,90,205632
5978,0.001569,172.31.47.0-255,66,139266,90,205632
5979,0.002089,74.125.24.0-255,1484,140750,90,205632
5980,0.002097,74.125.24.0-255,2902,143652,90,205632
5981,0.0021,172.31.47.0-255,66,143718,90,205632
5982,0.00212,74.125.24.0-255,5738,149456,90,205632
5983,0.002122,172.31.47.0-255,66,149522,90,205632
5984,0.002135,74.125.24.0-255,1484,151006,90,205632
5985,0.002151,74.125.24.0-255,5379,156385,90,205632
5986,0.002153,172.31.47.0-255,66,156451,90,205632
5987,0.002206,74.125.24.0-255,1484,157935,90,205632
5988,0.002211,74.125.24.0-255,2902,160837,90,205632
5989,0.002214,172.31.47.0-255,66,160903,90,205632
5990,0.002232,74.125.24.0-255,2902,163805,90,205632
5991,0.002234,172.31.47.0-255,66,163871,90,205632
5992,0.002252,74.125.24.0-255,2902,166773,90,205632
5993,0.002254,172.31.47.0-255,66,166839,90,205632
5994,0.00226,74.125.24.0-255,6797,173636,90,205632
5995,0.002262,172.31.47.0-255,66,173702,90,205632
5996,0.002302,172.31.47.0-255,66,173768,90,205632
5997,0.002306,74.125.24.0-255,2543,176311,90,205632
5998,0.002308,172.31.47.0-255,66,176377,90,205632
5999,0.002424,74.125.24.0-255,1484,177861,90,205632
6000,0.002428,74.125.24.0-255,2902,180763,90,205632
6001,0.002431,172.31.47.0-255,66,180829,90,205632
6002,0.00245,74.125.24.0-255,4320,185149,90,205632
6003,0.002452,74.125.24.0-255,1484,186633,90,205632
6004,0.002457,172.31.47.0-255,66,186699,90,205632
6005,0.002467,74.125.24.0-255,4320,191019,90,205632
6006,0.002469,172.31.47.0-255,66,191085,90,205632
6007,0.0025,74.125.24.0-255,2543,193628,90,205632
6008,0.002503,172.31.47.0-255,66,193694,90,205632
6009,0.005023,74.125.24.0-255,2902,196596,90,205632
6010,0.005028,172.31.47.0-255,66,196662,90,205632
6011,0.005064,74.125.24.0-255,1484,198146,90,205632
6012,0.005077,74.125.24.0-255,1484,199630,90,205632
6013,0.00508,172.31.47.0-255,66,199696,90,205632
6014,0.007573,74.125.24.0-255,2902,202598,90,205632
6015,0.00758,172.31.47.0-255,66,202664,90,205632
6016,0.007618,74.125.24.0-255,2902,205566,90,205632
6017,0.007622,172.31.47.0-255,66,205632,90,205632
6018,0.0,74.125.24.0-255,153,153,90,221336
6019,2.7e-05,172.31.47.0-255,66,219,90,221336
6020,3.4e-05,74.125.24.0-255,1484,1703,90,221336
6021,3.8e-05,172.31.47.0-255,66,1769,90,221336
6022,4.2e-05,74.125.24.0-255,2902,4671,90,221336
6023,5.3e-05,172.31.47.0-255,66,4737,90,221336
6024,5.8e-05,74.125.24.0-255,4320,9057,90,221336
6025,6.1e-05,172.31.47.0-255,66,9123,90,221336
6026,6.6e-05,74.125.24.0-255,4841,13964,90,221336
6027,6.9e-05,172.31.47.0-255,66,14030,90,221336
6028,0.000177,74.125.24.0-255,1484,15514,90,221336
6029,0.000181,172.31.47.0-255,66,15580,90,221336
6030,0.000187,74.125.24.0-255,2902,18482,90,221336
6031,0.000189,172.31.47.0-255,66,18548,90,221336
6032,0.000202,74.125.24.0-255,5738,24286,90,221336
6033,0.000205,172.31.47.0-255,66,24352,90,221336
6034,0.000234,74.125.24.0-255,2902,27254,90,221336
6035,0.000237,172.31.47.0-255,66,27320,90,221336
6036,0.000277,172.31.47.0-255,66,27386,90,221336
6037,0.000285,74.125.24.0-255,9992,37378,90,221336
6038,0.000288,172.31.47.0-255,66,37444,90,221336
6039,0.000315,74.125.24.0-255,2902,40346,90,221336
6040,0.000318,172.31.47.0-255,66,40412,90,221336
6041,0.000334,74.125.24.0-255,2902,43314,90,221336
6042,0.000338,172.31.47.0-255,66,43380,90,221336
6043,0.000375,172.31.47.0-255,66,43446,90,221336
6044,0.000377,74.125.24.0-255,414,43860,90,221336
6045,0.000379,172.31.47.0-255,66,43926,90,221336
6046,0.000571,74.125.24.0-255,1484,45410,90,221336
6047,0.000575,172.31.47.0-255,66,45476,90,221336
6048,0.000581,74.125.24.0-255,2902,48378,90,221336
6049,0.000592,172.31.47.0-255,66,48444,90,221336
6050,0.000608,74.125.24.0-255,5738,54182,90,221336
6051,0.000618,74.125.24.0-255,4320,58502,90,221336
6052,0.000619,172.31.47.0-255,66,58568,90,221336
6053,0.000625,172.31.47.0-255,66,58634,90,221336
6054,0.000657,172.31.47.0-255,66,58700,90,221336
6055,0.000687,74.125.24.0-255,7856,66556,90,221336
6056,0.000692,172.31.47.0-255,66,66622,90,221336
6057,0.000791,74.125.24.0-255,1484,68106,90,221336
6058,0.000797,74.125.24.0-255,2902,71008,90,221336
6059,0.000803,172.31.47.0-255,66,71074,90,221336
6060,0.000809,74.125.24.0-255,2902,73976,90,221336
6061,0.000819,172.31.47.0-255,66,74042,90,221336
6062,0.00083,74.125.24.0-255,1484,75526,90,221336
6063,0.000838,74.125.24.0-255,8574,84100,90,221336
6064,0.000848,172.31.47.0-255,66,84166,90,221336
6065,0.0009,172.31.47.0-255,66,84232,90,221336
6066,0.00107,74.125.24.0-255,1484,85716,90,221336
6067,0.001077,74.125.24.0-255,2902,88618,90,221336
6068,0.00108,172.31.47.0-255,66,88684,90,221336
6069,0.001086,74.125.24.0-255,5738,94422,90,221336
6070,0.001094,172.31.47.0-255,66,94488,90,221336
6071,0.001102,74.125.24.0-255,1484,95972,90,221336
6072,0.001137,172.31.47.0-255,66,96038,90,221336
6073,0.001143,74.125.24.0-255,5738,101776,90,221336
6074,0.00115,172.31.47.0-255,66,101842,90,221336
6075,0.001175,74.125.24.0-255,4320,106162,90,221336
6076,0.001181,172.31.47.0-255,66,106228,90,221336
6077,0.001206,74.125.24.0-255,766,106994,90,221336
6078,0.001213,74.125.24.0-255,5738,112732,90,221336
6079,0.00122,172.31.47.0-255,66,112798,90,221336
6080,0.001231,74.125.24.0-255,7156,119954,90,221336
6081,0.001233,172.31.47.0-255,66,120020,90,221336
6082,0.001237,172.31.47.0-255,66,120086,90,221336
6083,0.001297,74.125.24.0-255,7856,127942,90,221336
6084,0.001302,172.31.47.0-255,66,128008,90,221336
6085,0.001486,74.125.24.0-255,1484,129492,90,221336
6086,0.001493,74.125.24.0-255,2902,132394,90,221336
6087,0.001496,172.31.47.0-255,66,132460,90,221336
6088,0.001507,74.125.24.0-255,5738,138198,90,221336
6089,0.001517,172.31.47.0-255,66,138264,90,221336
6090,0.001533,172.31.47.0-255,66,138330,90,221336
6091,0.001546,74.125.24.0-255,1484,139814,90,221336
6092,0.001552,74.125.24.0-255,4320,144134,90,221336
6093,0.001556,172.31.47.0-255,66,144200,90,221336
6094,0.001593,74.125.24.0-255,6438,150638,90,221336
6095,0.001614,172.31.47.0-255,66,150704,90,221336
6096,0.001639,74.125.24.0-255,2902,153606,90,221336
6097,0.001645,74.125.24.0-255,4320,157926,90,221336
6098,0.001648,172.31.47.0-255,66,157992,90,221336
6099,0.001673,74.125.24.0-255,8574,166566,90,221336
6100,0.001683,172.31.47.0-255,66,166632,90,221336
6101,0.001684,74.125.24.0-255,1484,168116,90,221336
6102,0.001734,172.31.47.0-255,66,168182,90,221336
6103,0.001743,74.125.24.0-255,2902,171084,90,221336
6104,0.001746,172.31.47.0-255,66,171150,90,221336
6105,0.001794,172.31.47.0-255,66,171216,90,221336
6106,0.001798,172.31.47.0-255,66,171282,90,221336
6107,0.001845,74.125.24.0-255,7856,179138,90,221336
6108,0.001849,172.31.47.0-255,66,179204,90,221336
6109,0.001911,74.125.24.0-255,1484,180688,90,221336
6110,0.001916,74.125.24.0-255,1484,182172,90,221336
6111,0.001918,172.31.47.0-255,66,182238,90,221336
6112,0.001944,74.125.24.0-255,1484,183722,90,221336
6113,0.001949,74.125.24.0-255,4320,188042,90,221336
6114,0.001955,74.125.24.0-255,5738,193780,90,221336
6115,0.001956,172.31.47.0-255,66,193846,90,221336
6116,0.001961,172.31.47.0-255,66,193912,90,221336
6117,0.002006,172.31.47.0-255,66,193978,90,221336
6118,0.002009,74.125.24.0-255,7856,201834,90,221336
6119,0.002021,172.31.47.0-255,66,201900,90,221336
6120,0.002046,74.125.24.0-255,1484,203384,90,221336
6121,0.00206,74.125.24.0-255,2902,206286,90,221336
6122,0.002075,172.31.47.0-255,66,206352,90,221336
6123,0.002109,74.125.24.0-255,5738,212090,90,221336
6124,0.002113,172.31.47.0-255,66,212156,90,221336
6125,0.00213,172.31.47.0-255,66,212222,90,221336
6126,0.002164,172.31.47.0-255,66,212288,90,221336
6127,0.002167,74.125.24.0-255,8574,220862,90,221336
6128,0.002177,172.31.47.0-255,66,220928,90,221336
6129,0.002253,172.31.47.0-255,66,220994,90,221336
6130,0.004484,74.125.24.0-255,105,221099,90,221336
6131,0.007573,172.31.47.0-255,66,221165,90,221336
6132,0.0076,172.31.47.0-255,105,221270,90,221336
6133,0.009802,74.125.24.0-255,66,221336,90,221336
6134,0.0,74.125.200.0-255,153,153,90,123475
6135,2.1e-05,172.31.47.0-255,66,219,90,123475
6136,2.7e-05,74.125.200.0-255,1484,1703,90,123475
6137,3e-05,172.31.47.0-255,66,1769,90,123475
6138,5.5e-05,74.125.200.0-255,2902,4671,90,123475
6139,5.7e-05,172.31.47.0-255,66,4737,90,123475
6140,6.6e-05,74.125.200.0-255,2902,7639,90,123475
6141,6.8e-05,172.31.47.0-255,66,7705,90,123475
6142,7e-05,74.125.200.0-255,1484,9189,90,123475
6143,7.2e-05,172.31.47.0-255,66,9255,90,123475
6144,9.1e-05,74.125.200.0-255,2902,12157,90,123475
6145,9.3e-05,172.31.47.0-255,66,12223,90,123475
6146,0.000114,74.125.200.0-255,2126,14349,90,123475
6147,0.000117,172.31.47.0-255,66,14415,90,123475
6148,0.000209,74.125.200.0-255,1484,15899,90,123475
6149,0.000213,172.31.47.0-255,66,15965,90,123475
6150,0.000231,74.125.200.0-255,2902,18867,90,123475
6151,0.000234,172.31.47.0-255,66,18933,90,123475
6152,0.000239,74.125.200.0-255,5738,24671,90,123475
6153,0.000242,172.31.47.0-255,66,24737,90,123475
6154,0.000276,74.125.200.0-255,5738,30475,90,123475
6155,0.00028,172.31.47.0-255,66,30541,90,123475
6156,0.000308,74.125.200.0-255,1125,31666,90,123475
6157,0.000312,172.31.47.0-255,66,31732,90,123475
6158,0.000396,74.125.200.0-255,1484,33216,90,123475
6159,0.0004,172.31.47.0-255,66,33282,90,123475
6160,0.000403,74.125.200.0-255,1484,34766,90,123475
6161,0.000406,172.31.47.0-255,66,34832,90,123475
6162,0.000409,74.125.200.0-255,1484,36316,90,123475
6163,0.000411,172.31.47.0-255,66,36382,90,123475
6164,0.000433,74.125.200.0-255,1484,37866,90,123475
6165,0.000437,172.31.47.0-255,66,37932,90,123475
6166,0.000449,74.125.200.0-255,5738,43670,90,123475
6167,0.000451,172.31.47.0-255,66,43736,90,123475
6168,0.00049,74.125.200.0-255,5379,49115,90,123475
6169,0.000495,172.31.47.0-255,66,49181,90,123475
6170,0.000533,74.125.200.0-255,1484,50665,90,123475
6171,0.000548,74.125.200.0-255,2902,53567,90,123475
6172,0.000551,172.31.47.0-255,66,53633,90,123475
6173,0.000569,74.125.200.0-255,2902,56535,90,123475
6174,0.000572,172.31.47.0-255,66,56601,90,123475
6175,0.000577,74.125.200.0-255,4320,60921,90,123475
6176,0.000579,172.31.47.0-255,66,60987,90,123475
6177,0.000624,74.125.200.0-255,4320,65307,90,123475
6178,0.000627,172.31.47.0-255,66,65373,90,123475
6179,0.000654,74.125.200.0-255,1125,66498,90,123475
6180,0.000724,74.125.200.0-255,412,66910,90,123475
6181,0.000781,172.31.47.0-255,66,66976,90,123475
6182,0.000852,74.125.200.0-255,331,67307,90,123475
6183,0.001303,74.125.200.0-255,1484,68791,90,123475
6184,0.00131,172.31.47.0-255,66,68857,90,123475
6185,0.001317,74.125.200.0-255,2902,71759,90,123475
6186,0.001319,172.31.47.0-255,66,71825,90,123475
6187,0.001325,74.125.200.0-255,5738,77563,90,123475
6188,0.001334,172.31.47.0-255,66,77629,90,123475
6189,0.001376,74.125.200.0-255,7156,84785,90,123475
6190,0.001379,172.31.47.0-255,66,84851,90,123475
6191,0.001386,74.125.200.0-255,5738,90589,90,123475
6192,0.001388,172.31.47.0-255,66,90655,90,123475
6193,0.00141,74.125.200.0-255,5738,96393,90,123475
6194,0.001413,172.31.47.0-255,66,96459,90,123475
6195,0.001444,74.125.200.0-255,5020,101479,90,123475
6196,0.001446,172.31.47.0-255,66,101545,90,123475
6197,0.003405,74.125.200.0-255,1484,103029,90,123475
6198,0.003421,74.125.200.0-255,4320,107349,90,123475
6199,0.003423,172.31.47.0-255,66,107415,90,123475
6200,0.005387,74.125.200.0-255,5738,113153,90,123475
6201,0.005391,172.31.47.0-255,66,113219,90,123475
6202,0.007349,74.125.200.0-255,4320,117539,90,123475
6203,0.007354,172.31.47.0-255,66,117605,90,123475
6204,0.007385,74.125.200.0-255,1484,119089,90,123475
6205,0.009472,74.125.200.0-255,4320,123409,90,123475
6206,0.00953,172.31.47.0-255,66,123475,90,123475
6207,0.0,74.125.130.0-255,298,298,90,169553
6208,1.4e-05,172.31.47.0-255,66,364,90,169553
6209,2e-05,74.125.130.0-255,1484,1848,90,169553
6210,2.3e-05,172.31.47.0-255,66,1914,90,169553
6211,4.8e-05,74.125.130.0-255,2902,4816,90,169553
6212,5e-05,172.31.47.0-255,66,4882,90,169553
6213,5.9e-05,74.125.130.0-255,4320,9202,90,169553
6214,6.2e-05,172.31.47.0-255,66,9268,90,169553
6215,8.9e-05,74.125.130.0-255,1484,10752,90,169553
6216,9.1e-05,172.31.47.0-255,66,10818,90,169553
6217,0.000114,74.125.130.0-255,3358,14176,90,169553
6218,0.000116,172.31.47.0-255,66,14242,90,169553
6219,0.00014,74.125.130.0-255,1484,15726,90,169553
6220,0.000142,172.31.47.0-255,66,15792,90,169553
6221,0.000153,74.125.130.0-255,2902,18694,90,169553
6222,0.000159,172.31.47.0-255,66,18760,90,169553
6223,0.000163,74.125.130.0-255,1484,20244,90,169553
6224,0.000165,172.31.47.0-255,66,20310,90,169553
6225,0.000186,74.125.130.0-255,4320,24630,90,169553
6226,0.000189,172.31.47.0-255,66,24696,90,169553
6227,0.000195,74.125.130.0-255,6797,31493,90,169553
6228,0.000197,172.31.47.0-255,66,31559,90,169553
6229,0.000316,74.125.130.0-255,1484,33043,90,169553
6230,0.000321,172.31.47.0-255,66,33109,90,169553
6231,0.000327,74.125.130.0-255,2902,36011,90,169553
6232,0.000329,172.31.47.0-255,66,36077,90,169553
6233,0.000333,74.125.130.0-255,2902,38979,90,169553
6234,0.00034,172.31.47.0-255,66,39045,90,169553
6235,0.000371,74.125.130.0-255,4320,43365,90,169553
6236,0.000375,172.31.47.0-255,66,43431,90,169553
6237,0.000411,74.125.130.0-255,9633,53064,90,169553
6238,0.000415,172.31.47.0-255,66,53130,90,169553
6239,0.000423,74.125.130.0-255,8574,61704,90,169553
6240,0.000425,172.31.47.0-255,66,61770,90,169553
6241,0.000456,74.125.130.0-255,1484,63254,90,169553
6242,0.000462,74.125.130.0-255,2543,65797,90,169553
6243,0.000465,172.31.47.0-255,66,65863,90,169553
6244,0.000908,74.125.130.0-255,646,66509,90,169553
6245,0.001103,74.125.130.0-255,1484,67993,90,169553
6246,0.001109,172.31.47.0-255,66,68059,90,169553
6247,0.001115,74.125.130.0-255,2902,70961,90,169553
6248,0.001117,172.31.47.0-255,66,71027,90,169553
6249,0.001121,74.125.130.0-255,1484,72511,90,169553
6250,0.001154,74.125.130.0-255,4320,76831,90,169553
6251,0.001157,172.31.47.0-255,66,76897,90,169553
6252,0.001168,74.125.130.0-255,9992,86889,90,169553
6253,0.001171,172.31.47.0-255,66,86955,90,169553
6254,0.001216,172.31.47.0-255,66,87021,90,169553
6255,0.001221,74.125.130.0-255,2184,89205,90,169553
6256,0.001223,172.31.47.0-255,66,89271,90,169553
6257,0.001478,74.125.130.0-255,1484,90755,90,169553
6258,0.001486,74.125.130.0-255,2902,93657,90,169553
6259,0.00149,172.31.47.0-255,66,93723,90,169553
6260,0.001494,74.125.130.0-255,1484,95207,90,169553
6261,0.001523,74.125.130.0-255,4320,99527,90,169553
6262,0.001527,172.31.47.0-255,66,99593,90,169553
6263,0.001532,74.125.130.0-255,4320,103913,90,169553
6264,0.001534,172.31.47.0-255,66,103979,90,169553
6265,0.001541,74.125.130.0-255,5738,109717,90,169553
6266,0.001543,172.31.47.0-255,66,109783,90,169553
6267,0.001605,172.31.47.0-255,66,109849,90,169553
6268,0.001609,74.125.130.0-255,2184,112033,90,169553
6269,0.001611,172.31.47.0-255,66,112099,90,169553
6270,0.00181,74.125.130.0-255,1484,113583,90,169553
6271,0.001831,74.125.130.0-255,2902,116485,90,169553
6272,0.001835,172.31.47.0-255,66,116551,90,169553
6273,0.001838,74.125.130.0-255,1484,118035,90,169553
6274,0.001862,74.125.130.0-255,4320,122355,90,169553
6275,0.001864,172.31.47.0-255,66,122421,90,169553
6276,0.001876,74.125.130.0-255,2902,125323,90,169553
6277,0.001882,172.31.47.0-255,66,125389,90,169553
6278,0.001903,74.125.130.0-255,9992,135381,90,169553
6279,0.001906,172.31.47.0-255,66,135447,90,169553
6280,0.00191,74.125.130.0-255,4320,139767,90,169553
6281,0.001912,172.31.47.0-255,66,139833,90,169553
6282,0.001946,74.125.130.0-255,6438,146271,90,169553
6283,0.001949,172.31.47.0-255,66,146337,90,169553
6284,0.003939,74.125.130.0-255,5738,152075,90,169553
6285,0.003951,172.31.47.0-255,66,152141,90,169553
6286,0.005936,74.125.130.0-255,5738,157879,90,169553
6287,0.005941,172.31.47.0-255,66,157945,90,169553
6288,0.007928,74.125.130.0-255,5738,163683,90,169553
6289,0.007934,172.31.47.0-255,66,163749,90,169553
6290,0.00995,74.125.130.0-255,5738,169487,90,169553
6291,0.009956,172.31.47.0-255,66,169553,90,169553
6292,0.0,74.125.200.0-255,153,153,90,261660
6293,4.1e-05,172.31.47.0-255,66,219,90,261660
6294,4.9e-05,74.125.200.0-255,1484,1703,90,261660
6295,5.4e-05,172.31.47.0-255,66,1769,90,261660
6296,5.9e-05,74.125.200.0-255,2902,4671,90,261660
6297,6.1e-05,172.31.47.0-255,66,4737,90,261660
6298,6.8e-05,74.125.200.0-255,5738,10475,90,261660
6299,7.1e-05,172.31.47.0-255,66,10541,90,261660
6300,7.4e-05,74.125.200.0-255,1484,12025,90,261660
6301,7.6e-05,172.31.47.0-255,66,12091,90,261660
6302,9.4e-05,74.125.200.0-255,2162,14253,90,261660
6303,9.6e-05,172.31.47.0-255,66,14319,90,261660
6304,0.000102,74.125.200.0-255,4320,18639,90,261660
6305,0.000104,172.31.47.0-255,66,18705,90,261660
6306,0.000115,74.125.200.0-255,1484,20189,90,261660
6307,0.000117,172.31.47.0-255,66,20255,90,261660
6308,0.000141,74.125.200.0-255,8574,28829,90,261660
6309,0.000143,172.31.47.0-255,66,28895,90,261660
6310,0.000146,74.125.200.0-255,1484,30379,90,261660
6311,0.000148,172.31.47.0-255,66,30445,90,261660
6312,0.000161,74.125.200.0-255,2902,33347,90,261660
6313,0.000164,172.31.47.0-255,66,33413,90,261660
6314,0.000203,74.125.200.0-255,1484,34897,90,261660
6315,0.000206,172.31.47.0-255,66,34963,90,261660
6316,0.00024,172.31.47.0-255,66,35029,90,261660
6317,0.00106,74.125.200.0-255,1484,36513,90,261660
6318,0.001067,172.31.47.0-255,66,36579,90,261660
6319,0.001077,74.125.200.0-255,2902,39481,90,261660
6320,0.001079,172.31.47.0-255,66,39547,90,261660
6321,0.001087,74.125.200.0-255,5738,45285,90,261660
6322,0.00109,172.31.47.0-255,66,45351,90,261660
6323,0.001097,74.125.200.0-255,5738,51089,90,261660
6324,0.0011,172.31.47.0-255,66,51155,90,261660
6325,0.001145,74.125.200.0-255,1713,52868,90,261660
6326,0.001148,172.31.47.0-255,66,52934,90,261660
6327,0.001409,74.125.200.0-255,1484,54418,90,261660
6328,0.00142,74.125.200.0-255,2902,57320,90,261660
6329,0.001424,172.31.47.0-255,66,57386,90,261660
6330,0.001447,74.125.200.0-255,5738,63124,90,261660
6331,0.001449,172.31.47.0-255,66,63190,90,261660
6332,0.001452,74.125.200.0-255,1484,64674,90,261660
6333,0.001479,74.125.200.0-255,5738,70412,90,261660
6334,0.001481,172.31.47.0-255,66,70478,90,261660
6335,0.001498,74.125.200.0-255,2902,73380,90,261660
6336,0.0015,172.31.47.0-255,66,73446,90,261660
6337,0.001507,74.125.200.0-255,5738,79184,90,261660
6338,0.001509,172.31.47.0-255,66,79250,90,261660
6339,0.001544,74.125.200.0-255,5738,84988,90,261660
6340,0.001546,172.31.47.0-255,66,85054,90,261660
6341,0.001563,74.125.200.0-255,1484,86538,90,261660
6342,0.001567,74.125.200.0-255,766,87304,90,261660
6343,0.001569,172.31.47.0-255,66,87370,90,261660
6344,0.001632,74.125.200.0-255,1484,88854,90,261660
6345,0.001652,74.125.200.0-255,1484,90338,90,261660
6346,0.001654,172.31.47.0-255,66,90404,90,261660
6347,0.001659,74.125.200.0-255,2902,93306,90,261660
6348,0.001661,172.31.47.0-255,66,93372,90,261660
6349,0.001673,74.125.200.0-255,1484,94856,90,261660
6350,0.001691,74.125.200.0-255,4320,99176,90,261660
6351,0.001693,172.31.47.0-255,66,99242,90,261660
6352,0.001716,74.125.200.0-255,1484,100726,90,261660
6353,0.001741,74.125.200.0-255,7156,107882,90,261660
6354,0.001744,172.31.47.0-255,66,107948,90,261660
6355,0.001757,74.125.200.0-255,2902,110850,90,261660
6356,0.00176,172.31.47.0-255,66,110916,90,261660
6357,0.00179,74.125.200.0-255,7156,118072,90,261660
6358,0.001793,172.31.47.0-255,66,118138,90,261660
6359,0.001798,74.125.200.0-255,3602,121740,90,261660
6360,0.0018,172.31.47.0-255,66,121806,90,261660
6361,0.001812,74.125.200.0-255,1484,123290,90,261660
6362,0.00184,172.31.47.0-255,66,123356,90,261660
6363,0.001845,74.125.200.0-255,2902,126258,90,261660
6364,0.001848,172.31.47.0-255,66,126324,90,261660
6365,0.001869,74.125.200.0-255,9992,136316,90,261660
6366,0.001871,172.31.47.0-255,66,136382,90,261660
6367,0.00189,74.125.200.0-255,4320,140702,90,261660
6368,0.001892,172.31.47.0-255,66,140768,90,261660
6369,0.001895,74.125.200.0-255,766,141534,90,261660
6370,0.001916,74.125.200.0-255,4320,145854,90,261660
6371,0.001918,172.31.47.0-255,66,145920,90,261660
6372,0.00194,74.125.200.0-255,5738,151658,90,261660
6373,0.001942,172.31.47.0-255,66,151724,90,261660
6374,0.001962,74.125.200.0-255,5738,157462,90,261660
6375,0.001964,172.31.47.0-255,66,157528,90,261660
6376,0.001985,74.125.200.0-255,5738,163266,90,261660
6377,0.001988,172.31.47.0-255,66,163332,90,261660
6378,0.001993,74.125.200.0-255,4320,167652,90,261660
6379,0.001995,172.31.47.0-255,66,167718,90,261660
6380,0.002031,74.125.200.0-255,4320,172038,90,261660
6381,0.002033,172.31.47.0-255,66,172104,90,261660
6382,0.002054,74.125.200.0-255,3602,175706,90,261660
6383,0.002056,172.31.47.0-255,66,175772,90,261660
6384,0.002073,74.125.200.0-255,1484,177256,90,261660
6385,0.002078,74.125.200.0-255,2902,180158,90,261660
6386,0.00208,172.31.47.0-255,66,180224,90,261660
6387,0.002102,74.125.200.0-255,5738,185962,90,261660
6388,0.002105,172.31.47.0-255,66,186028,90,261660
6389,0.002127,74.125.200.0-255,7156,193184,90,261660
6390,0.002129,172.31.47.0-255,66,193250,90,261660
6391,0.002146,74.125.200.0-255,2902,196152,90,261660
6392,0.002148,172.31.47.0-255,66,196218,90,261660
6393,0.002157,74.125.200.0-255,7156,203374,90,261660
6394,0.002159,172.31.47.0-255,66,203440,90,261660
6395,0.002185,74.125.200.0-255,4320,207760,90,261660
6396,0.002187,172.31.47.0-255,66,207826,90,261660
6397,0.002194,74.125.200.0-255,5020,212846,90,261660
6398,0.002197,172.31.47.0-255,66,212912,90,261660
6399,0.002204,74.125.200.0-255,5738,218650,90,261660
6400,0.002207,172.31.47.0-255,66,218716,90,261660
6401,0.002231,74.125.200.0-255,7156,225872,90,261660
6402,0.002233,172.31.47.0-255,66,225938,90,261660
6403,0.002256,74.125.200.0-255,5738,231676,90,261660
6404,0.002257,172.31.47.0-255,66,231742,90,261660
6405,0.002261,74.125.200.0-255,1484,233226,90,261660
6406,0.002266,74.125.200.0-255,2902,236128,90,261660
6407,0.002268,172.31.47.0-255,66,236194,90,261660
6408,0.002275,74.125.200.0-255,5738,241932,90,261660
6409,0.002278,172.31.47.0-255,66,241998,90,261660
6410,0.002282,74.125.200.0-255,2184,244182,90,261660
6411,0.002284,172.31.47.0-255,66,244248,90,261660
6412,0.004517,74.125.200.0-255,5738,249986,90,261660
6413,0.004525,172.31.47.0-255,66,250052,90,261660
6414,0.006811,74.125.200.0-255,5738,255790,90,261660
6415,0.006826,172.31.47.0-255,66,255856,90,261660
6416,0.009106,74.125.200.0-255,5738,261594,90,261660
6417,0.00913,172.31.47.0-255,66,261660,90,261660
6418,0.0,74.125.68.0-255,143,143,90,176140
6419,2.8e-05,172.31.47.0-255,66,209,90,176140
6420,3.4e-05,74.125.68.0-255,1484,1693,90,176140
6421,3.7e-05,172.31.47.0-255,66,1759,90,176140
6422,6e-05,74.125.68.0-255,2902,4661,90,176140
6423,6.6e-05,172.31.47.0-255,66,4727,90,176140
6424,9.2e-05,74.125.68.0-255,2902,7629,90,176140
6425,9.5e-05,172.31.47.0-255,66,7695,90,176140
6426,0.000132,74.125.68.0-255,4320,12015,90,176140
6427,0.000135,172.31.47.0-255,66,12081,90,176140
6428,0.000138,74.125.68.0-255,1484,13565,90,176140
6429,0.000139,172.31.47.0-255,66,13631,90,176140
6430,0.000162,74.125.68.0-255,2255,15886,90,176140
6431,0.000168,172.31.47.0-255,66,15952,90,176140
6432,0.000179,74.125.68.0-255,2902,18854,90,176140
6433,0.000185,172.31.47.0-255,66,18920,90,176140
6434,0.00021,74.125.68.0-255,1484,20404,90,176140
6435,0.000212,172.31.47.0-255,66,20470,90,176140
6436,0.000218,74.125.68.0-255,5738,26208,90,176140
6437,0.000219,172.31.47.0-255,66,26274,90,176140
6438,0.000248,74.125.68.0-255,5379,31653,90,176140
6439,0.000252,172.31.47.0-255,66,31719,90,176140
6440,0.000551,74.125.68.0-255,1484,33203,90,176140
6441,0.000556,172.31.47.0-255,66,33269,90,176140
6442,0.000564,74.125.68.0-255,2902,36171,90,176140
6443,0.000566,172.31.47.0-255,66,36237,90,176140
6444,0.000577,74.125.68.0-255,5738,41975,90,176140
6445,0.00058,172.31.47.0-255,66,42041,90,176140
6446,0.000585,74.125.68.0-255,4320,46361,90,176140
6447,0.000587,172.31.47.0-255,66,46427,90,176140
6448,0.000615,74.125.68.0-255,5379,51806,90,176140
6449,0.000618,172.31.47.0-255,66,51872,90,176140
6450,0.000644,74.125.68.0-255,5738,57610,90,176140
6451,0.000647,172.31.47.0-255,66,57676,90,176140
6452,0.000672,74.125.68.0-255,5738,63414,90,176140
6453,0.000675,172.31.47.0-255,66,63480,90,176140
6454,0.000699,74.125.68.0-255,1484,64964,90,176140
6455,0.000715,74.125.68.0-255,1705,66669,90,176140
6456,0.000718,172.31.47.0-255,66,66735,90,176140
6457,0.000935,74.125.68.0-255,1484,68219,90,176140
6458,0.000943,74.125.68.0-255,2902,71121,90,176140
6459,0.000946,172.31.47.0-255,66,71187,90,176140
6460,0.000975,74.125.68.0-255,4320,75507,90,176140
6461,0.000979,172.31.47.0-255,66,75573,90,176140
6462,0.001004,74.125.68.0-255,5738,81311,90,176140
6463,0.001007,172.31.47.0-255,66,81377,90,176140
6464,0.001023,74.125.68.0-255,2543,83920,90,176140
6465,0.001026,172.31.47.0-255,66,83986,90,176140
6466,0.001668,74.125.68.0-255,1484,85470,90,176140
6467,0.001683,74.125.68.0-255,2902,88372,90,176140
6468,0.001686,172.31.47.0-255,66,88438,90,176140
6469,0.001709,74.125.68.0-255,5738,94176,90,176140
6470,0.001711,172.31.47.0-255,66,94242,90,176140
6471,0.001714,74.125.68.0-255,2902,97144,90,176140
6472,0.001716,172.31.47.0-255,66,97210,90,176140
6473,0.001767,74.125.68.0-255,2902,100112,90,176140
6474,0.00177,172.31.47.0-255,66,100178,90,176140
6475,0.001795,74.125.68.0-255,5738,105916,90,176140
6476,0.001797,172.31.47.0-255,66,105982,90,176140
6477,0.001802,74.125.68.0-255,5738,111720,90,176140
6478,0.001803,172.31.47.0-255,66,111786,90,176140
6479,0.001825,74.125.68.0-255,4320,116106,90,176140
6480,0.001826,172.31.47.0-255,66,116172,90,176140
6481,0.00183,74.125.68.0-255,2184,118356,90,176140
6482,0.001835,172.31.47.0-255,66,118422,90,176140
6483,0.002132,74.125.68.0-255,1484,119906,90,176140
6484,0.002135,74.125.68.0-255,1484,121390,90,176140
6485,0.002137,172.31.47.0-255,66,121456,90,176140
6486,0.00216,74.125.68.0-255,1484,122940,90,176140
6487,0.002174,74.125.68.0-255,4320,127260,90,176140
6488,0.002176,172.31.47.0-255,66,127326,90,176140
6489,0.002198,74.125.68.0-255,1484,128810,90,176140
6490,0.002204,74.125.68.0-255,7156,135966,90,176140
6491,0.002206,172.31.47.0-255,66,136032,90,176140
6492,0.002233,74.125.68.0-255,7156,143188,90,176140
6493,0.002235,172.31.47.0-255,66,143254,90,176140
6494,0.002256,74.125.68.0-255,1484,144738,90,176140
6495,0.002261,74.125.68.0-255,4320,149058,90,176140
6496,0.002262,172.31.47.0-255,66,149124,90,176140
6497,0.002288,74.125.68.0-255,5020,154144,90,176140
6498,0.00229,172.31.47.0-255,66,154210,90,176140
6499,0.002294,74.125.68.0-255,4320,158530,90,176140
6500,0.002296,172.31.47.0-255,66,158596,90,176140
6501,0.004573,74.125.68.0-255,2902,161498,90,176140
6502,0.004578,172.31.47.0-255,66,161564,90,176140
6503,0.004596,74.125.68.0-255,2902,164466,90,176140
6504,0.004598,172.31.47.0-255,66,164532,90,176140
6505,0.006827,74.125.68.0-255,5738,170270,90,176140
6506,0.006833,172.31.47.0-255,66,170336,90,176140
6507,0.009094,74.125.68.0-255,5738,176074,90,176140
6508,0.0091,172.31.47.0-255,66,176140,90,176140
6509,0.0,172.31.47.0-255,105,105,90,105
6510,0.0,172.31.47.0-255,66,66,90,66
6511,0.0,74.125.130.0-255,153,153,90,94213
6512,1.1e-05,172.31.47.0-255,66,219,90,94213
6513,3.9e-05,74.125.130.0-255,1484,1703,90,94213
6514,4.3e-05,172.31.47.0-255,66,1769,90,94213
6515,7.1e-05,74.125.130.0-255,2902,4671,90,94213
6516,7.4e-05,172.31.47.0-255,66,4737,90,94213
6517,8e-05,74.125.130.0-255,5738,10475,90,94213
6518,8.3e-05,172.31.47.0-255,66,10541,90,94213
6519,9.2e-05,74.125.130.0-255,3590,14131,90,94213
6520,9.5e-05,172.31.47.0-255,66,14197,90,94213
6521,0.000101,74.125.130.0-255,4320,18517,90,94213
6522,0.000104,172.31.47.0-255,66,18583,90,94213
6523,0.000139,74.125.130.0-255,4320,22903,90,94213
6524,0.000141,172.31.47.0-255,66,22969,90,94213
6525,0.000171,74.125.130.0-255,5738,28707,90,94213
6526,0.000174,172.31.47.0-255,66,28773,90,94213
6527,0.000177,74.125.130.0-255,2543,31316,90,94213
6528,0.000179,172.31.47.0-255,66,31382,90,94213
6529,0.000261,74.125.130.0-255,1484,32866,90,94213
6530,0.000264,172.31.47.0-255,66,32932,90,94213
6531,0.00029,74.125.130.0-255,1484,34416,90,94213
6532,0.000292,172.31.47.0-255,66,34482,90,94213
6533,0.000316,74.125.130.0-255,2902,37384,90,94213
6534,0.000319,172.31.47.0-255,66,37450,90,94213
6535,0.000348,74.125.130.0-255,5738,43188,90,94213
6536,0.000351,172.31.47.0-255,66,43254,90,94213
6537,0.000362,172.31.47.0-255,66,43320,90,94213
6538,0.000376,172.31.47.0-255,66,43386,90,94213
6539,0.000949,74.125.130.0-255,98,43484,90,94213
6540,0.000954,172.31.47.0-255,66,43550,90,94213
6541,0.001238,74.125.130.0-255,365,43915,90,94213
6542,0.001587,74.125.130.0-255,1484,45399,90,94213
6543,0.001592,172.31.47.0-255,66,45465,90,94213
6544,0.001598,74.125.130.0-255,2902,48367,90,94213
6545,0.0016,172.31.47.0-255,66,48433,90,94213
6546,0.001627,74.125.130.0-255,5738,54171,90,94213
6547,0.001629,172.31.47.0-255,66,54237,90,94213
6548,0.001657,74.125.130.0-255,5738,59975,90,94213
6549,0.001659,172.31.47.0-255,66,60041,90,94213
6550,0.001686,74.125.130.0-255,4320,64361,90,94213
6551,0.001688,172.31.47.0-255,66,64427,90,94213
6552,0.001694,74.125.130.0-255,5738,70165,90,94213
6553,0.001696,172.31.47.0-255,66,70231,90,94213
6554,0.001729,74.125.130.0-255,7856,78087,90,94213
6555,0.001731,172.31.47.0-255,66,78153,90,94213
6556,0.004314,74.125.130.0-255,5738,83891,90,94213
6557,0.00432,172.31.47.0-255,66,83957,90,94213
6558,0.006911,74.125.130.0-255,4320,88277,90,94213
6559,0.006918,172.31.47.0-255,66,88343,90,94213
6560,0.006949,74.125.130.0-255,1484,89827,90,94213
6561,0.009508,74.125.130.0-255,4320,94147,90,94213
6562,0.009517,172.31.47.0-255,66,94213,90,94213
6563,0.0,172.31.47.0-255,105,105,90,105
6564,0.0,172.217.24.0-255,152,152,90,181272
6565,2.6e-05,172.31.47.0-255,66,218,90,181272
6566,3.3e-05,172.217.24.0-255,1484,1702,90,181272
6567,3.7e-05,172.31.47.0-255,66,1768,90,181272
6568,4.1e-05,172.217.24.0-255,2902,4670,90,181272
6569,5.1e-05,172.31.47.0-255,66,4736,90,181272
6570,5.8e-05,172.217.24.0-255,7156,11892,90,181272
6571,6e-05,172.31.47.0-255,66,11958,90,181272
6572,6.4e-05,172.217.24.0-255,2165,14123,90,181272
6573,6.6e-05,172.31.47.0-255,66,14189,90,181272
6574,9.3e-05,172.217.24.0-255,2902,17091,90,181272
6575,0.0001,172.31.47.0-255,66,17157,90,181272
6576,0.000107,172.217.24.0-255,7156,24313,90,181272
6577,0.00011,172.31.47.0-255,66,24379,90,181272
6578,0.000113,172.217.24.0-255,2902,27281,90,181272
6579,0.000115,172.31.47.0-255,66,27347,90,181272
6580,0.000147,172.217.24.0-255,3961,31308,90,181272
6581,0.00015,172.31.47.0-255,66,31374,90,181272
6582,0.000307,172.217.24.0-255,1484,32858,90,181272
6583,0.000311,172.31.47.0-255,66,32924,90,181272
6584,0.000317,172.217.24.0-255,2902,35826,90,181272
6585,0.000319,172.31.47.0-255,66,35892,90,181272
6586,0.000331,172.217.24.0-255,4320,40212,90,181272
6587,0.000333,172.31.47.0-255,66,40278,90,181272
6588,0.000339,172.217.24.0-255,5738,46016,90,181272
6589,0.000342,172.31.47.0-255,66,46082,90,181272
6590,0.000375,172.217.24.0-255,2543,48625,90,181272
6591,0.000378,172.31.47.0-255,66,48691,90,181272
6592,0.000541,172.217.24.0-255,1484,50175,90,181272
6593,0.000546,172.31.47.0-255,66,50241,90,181272
6594,0.000566,172.217.24.0-255,2902,53143,90,181272
6595,0.00057,172.31.47.0-255,66,53209,90,181272
6596,0.000575,172.217.24.0-255,4320,57529,90,181272
6597,0.000578,172.31.47.0-255,66,57595,90,181272
6598,0.000583,172.217.24.0-255,5738,63333,90,181272
6599,0.000585,172.31.47.0-255,66,63399,90,181272
6600,0.00061,172.217.24.0-255,2543,65942,90,181272
6601,0.000618,172.31.47.0-255,66,66008,90,181272
6602,0.001023,172.217.24.0-255,353,66361,90,181272
6603,0.001327,172.217.24.0-255,391,66752,90,181272
6604,0.001413,172.217.24.0-255,1484,68236,90,181272
6605,0.001418,172.31.47.0-255,66,68302,90,181272
6606,0.001425,172.217.24.0-255,2902,71204,90,181272
6607,0.001427,172.31.47.0-255,66,71270,90,181272
6608,0.001439,172.217.24.0-255,5738,77008,90,181272
6609,0.001442,172.31.47.0-255,66,77074,90,181272
6610,0.001479,172.217.24.0-255,6797,83871,90,181272
6611,0.001483,172.31.47.0-255,66,83937,90,181272
6612,0.001521,172.217.24.0-255,1484,85421,90,181272
6613,0.001537,172.217.24.0-255,2902,88323,90,181272
6614,0.00154,172.31.47.0-255,66,88389,90,181272
6615,0.001544,172.217.24.0-255,1484,89873,90,181272
6616,0.001566,172.217.24.0-255,4320,94193,90,181272
6617,0.001568,172.31.47.0-255,66,94259,90,181272
6618,0.001575,172.217.24.0-255,6797,101056,90,181272
6619,0.001576,172.31.47.0-255,66,101122,90,181272
6620,0.001658,172.217.24.0-255,1484,102606,90,181272
6621,0.001669,172.217.24.0-255,2902,105508,90,181272
6622,0.001671,172.31.47.0-255,66,105574,90,181272
6623,0.001674,172.217.24.0-255,1484,107058,90,181272
6624,0.001696,172.217.24.0-255,4320,111378,90,181272
6625,0.001698,172.31.47.0-255,66,111444,90,181272
6626,0.001703,172.217.24.0-255,4320,115764,90,181272
6627,0.001705,172.31.47.0-255,66,115830,90,181272
6628,0.001741,172.217.24.0-255,8574,124404,90,181272
6629,0.001743,172.31.47.0-255,66,124470,90,181272
6630,0.001748,172.217.24.0-255,4320,128790,90,181272
6631,0.001749,172.31.47.0-255,66,128856,90,181272
6632,0.001755,172.217.24.0-255,5738,134594,90,181272
6633,0.001762,172.31.47.0-255,66,134660,90,181272
6634,0.001765,172.217.24.0-255,766,135426,90,181272
6635,0.001834,172.217.24.0-255,1484,136910,90,181272
6636,0.001836,172.31.47.0-255,66,136976,90,181272
6637,0.001839,172.217.24.0-255,1484,138460,90,181272
6638,0.001858,172.217.24.0-255,1484,139944,90,181272
6639,0.001861,172.31.47.0-255,66,140010,90,181272
6640,0.001867,172.217.24.0-255,5738,145748,90,181272
6641,0.001869,172.31.47.0-255,66,145814,90,181272
6642,0.001877,172.217.24.0-255,2902,148716,90,181272
6643,0.001878,172.31.47.0-255,66,148782,90,181272
6644,0.001883,172.217.24.0-255,4320,153102,90,181272
6645,0.001885,172.31.47.0-255,66,153168,90,181272
6646,0.001946,172.217.24.0-255,8574,161742,90,181272
6647,0.001953,172.217.24.0-255,7856,169598,90,181272
6648,0.004554,172.31.47.0-255,66,169664,90,181272
6649,0.006458,172.217.24.0-255,5738,175402,90,181272
6650,0.006466,172.31.47.0-255,66,175468,90,181272
6651,0.008365,172.217.24.0-255,5738,181206,90,181272
6652,0.008372,172.31.47.0-255,66,181272,90,181272
6653,0.0,172.31.47.0-255,66,66,90,66
6654,0.0,172.31.47.0-255,105,105,90,276
6655,0.001499,157.240.7.0-255,105,210,90,276
6656,0.001512,172.31.47.0-255,66,276,90,276
6657,0.0,172.217.194.0-255,153,153,90,327428
6658,2.5e-05,172.31.47.0-255,66,219,90,327428
6659,3.1e-05,172.217.194.0-255,1484,1703,90,327428
6660,3.5e-05,172.31.47.0-255,66,1769,90,327428
6661,4.8e-05,172.217.194.0-255,2902,4671,90,327428
6662,5.1e-05,172.31.47.0-255,66,4737,90,327428
6663,5.4e-05,172.217.194.0-255,1484,6221,90,327428
6664,5.6e-05,172.31.47.0-255,66,6287,90,327428
6665,6e-05,172.217.194.0-255,1484,7771,90,327428
6666,6.2e-05,172.31.47.0-255,66,7837,90,327428
6667,0.000103,172.217.194.0-255,6392,14229,90,327428
6668,0.000106,172.31.47.0-255,66,14295,90,327428
6669,0.000205,172.217.194.0-255,1484,15779,90,327428
6670,0.000208,172.31.47.0-255,66,15845,90,327428
6671,0.000213,172.217.194.0-255,2902,18747,90,327428
6672,0.000215,172.31.47.0-255,66,18813,90,327428
6673,0.000241,172.217.194.0-255,4320,23133,90,327428
6674,0.000244,172.31.47.0-255,66,23199,90,327428
6675,0.00028,172.217.194.0-255,2902,26101,90,327428
6676,0.000282,172.31.47.0-255,66,26167,90,327428
6677,0.000307,172.217.194.0-255,5379,31546,90,327428
6678,0.00031,172.31.47.0-255,66,31612,90,327428
6679,0.000341,172.217.194.0-255,8574,40186,90,327428
6680,0.000344,172.31.47.0-255,66,40252,90,327428
6681,0.000351,172.217.194.0-255,8215,48467,90,327428
6682,0.000353,172.31.47.0-255,66,48533,90,327428
6683,0.000376,172.217.194.0-255,2902,51435,90,327428
6684,0.000378,172.31.47.0-255,66,51501,90,327428
6685,0.000381,172.217.194.0-255,1484,52985,90,327428
6686,0.000383,172.31.47.0-255,66,53051,90,327428
6687,0.000405,172.217.194.0-255,2902,55953,90,327428
6688,0.000407,172.31.47.0-255,66,56019,90,327428
6689,0.000415,172.217.194.0-255,8574,64593,90,327428
6690,0.000417,172.31.47.0-255,66,64659,90,327428
6691,0.00042,172.217.194.0-255,1448,66107,90,327428
6692,0.000451,172.217.194.0-255,385,66492,90,327428
6693,0.000453,172.31.47.0-255,66,66558,90,327428
6694,0.000935,172.217.194.0-255,1484,68042,90,327428
6695,0.000941,172.217.194.0-255,2902,70944,90,327428
6696,0.000944,172.31.47.0-255,66,71010,90,327428
6697,0.000951,172.217.194.0-255,5738,76748,90,327428
6698,0.000953,172.31.47.0-255,66,76814,90,327428
6699,0.000984,172.217.194.0-255,5738,82552,90,327428
6700,0.000986,172.31.47.0-255,66,82618,90,327428
6701,0.001005,172.217.194.0-255,7156,89774,90,327428
6702,0.001008,172.217.194.0-255,1484,91258,90,327428
6703,0.001012,172.31.47.0-255,66,91324,90,327428
6704,0.001042,172.217.194.0-255,4320,95644,90,327428
6705,0.001046,172.31.47.0-255,66,95710,90,327428
6706,0.001075,172.217.194.0-255,5020,100730,90,327428
6707,0.001079,172.31.47.0-255,66,100796,90,327428
6708,0.00123,172.217.194.0-255,1484,102280,90,327428
6709,0.001235,172.217.194.0-255,2902,105182,90,327428
6710,0.001264,172.31.47.0-255,66,105248,90,327428
6711,0.001303,172.217.194.0-255,5738,110986,90,327428
6712,0.001321,172.217.194.0-255,10692,121678,90,327428
6713,0.001325,172.31.47.0-255,66,121744,90,327428
6714,0.001329,172.31.47.0-255,66,121810,90,327428
6715,0.001332,172.31.47.0-255,66,121876,90,327428
6716,0.001349,172.217.194.0-255,1484,123360,90,327428
6717,0.001354,172.217.194.0-255,2902,126262,90,327428
6718,0.001356,172.31.47.0-255,66,126328,90,327428
6719,0.001392,172.217.194.0-255,5738,132066,90,327428
6720,0.001395,172.31.47.0-255,66,132132,90,327428
6721,0.001403,172.217.194.0-255,7156,139288,90,327428
6722,0.001405,172.31.47.0-255,66,139354,90,327428
6723,0.001439,172.217.194.0-255,5738,145092,90,327428
6724,0.001443,172.31.47.0-255,66,145158,90,327428
6725,0.001448,172.217.194.0-255,2902,148060,90,327428
6726,0.00145,172.31.47.0-255,66,148126,90,327428
6727,0.001483,172.217.194.0-255,7856,155982,90,327428
6728,0.001486,172.31.47.0-255,66,156048,90,327428
6729,0.001519,172.217.194.0-255,1484,157532,90,327428
6730,0.001523,172.217.194.0-255,1484,159016,90,327428
6731,0.001525,172.31.47.0-255,66,159082,90,327428
6732,0.001536,172.217.194.0-255,1484,160566,90,327428
6733,0.001547,172.217.194.0-255,5738,166304,90,327428
6734,0.001549,172.31.47.0-255,66,166370,90,327428
6735,0.001552,172.217.194.0-255,1484,167854,90,327428
6736,0.001582,172.217.194.0-255,5738,173592,90,327428
6737,0.001585,172.31.47.0-255,66,173658,90,327428
6738,0.001595,172.217.194.0-255,9992,183650,90,327428
6739,0.001597,172.31.47.0-255,66,183716,90,327428
6740,0.001631,172.217.194.0-255,4320,188036,90,327428
6741,0.001634,172.31.47.0-255,66,188102,90,327428
6742,0.001641,172.217.194.0-255,5020,193122,90,327428
6743,0.001643,172.31.47.0-255,66,193188,90,327428
6744,0.00165,172.217.194.0-255,5738,198926,90,327428
6745,0.001652,172.31.47.0-255,66,198992,90,327428
6746,0.001666,172.31.47.0-255,66,199058,90,327428
6747,0.001675,172.217.194.0-255,9992,209050,90,327428
6748,0.001678,172.31.47.0-255,66,209116,90,327428
6749,0.00169,172.217.194.0-255,2184,211300,90,327428
6750,0.001692,172.31.47.0-255,66,211366,90,327428
6751,0.001732,172.217.194.0-255,1484,212850,90,327428
6752,0.001737,172.217.194.0-255,2902,215752,90,327428
6753,0.00174,172.31.47.0-255,66,215818,90,327428
6754,0.001778,172.217.194.0-255,5738,221556,90,327428
6755,0.001781,172.31.47.0-255,66,221622,90,327428
6756,0.001787,172.217.194.0-255,5738,227360,90,327428
6757,0.001794,172.31.47.0-255,66,227426,90,327428
6758,0.001819,172.217.194.0-255,7156,234582,90,327428
6759,0.001822,172.31.47.0-255,66,234648,90,327428
6760,0.001845,172.217.194.0-255,10692,245340,90,327428
6761,0.001848,172.31.47.0-255,66,245406,90,327428
6762,0.001855,172.217.194.0-255,7156,252562,90,327428
6763,0.001857,172.31.47.0-255,66,252628,90,327428
6764,0.001901,172.217.194.0-255,4320,256948,90,327428
6765,0.001904,172.31.47.0-255,66,257014,90,327428
6766,0.001917,172.31.47.0-255,66,257080,90,327428
6767,0.001959,172.217.194.0-255,8574,265654,90,327428
6768,0.001961,172.31.47.0-255,66,265720,90,327428
6769,0.001991,172.217.194.0-255,2184,267904,90,327428
6770,0.001993,172.31.47.0-255,66,267970,90,327428
6771,0.002114,172.217.194.0-255,1484,269454,90,327428
6772,0.00212,172.217.194.0-255,2902,272356,90,327428
6773,0.002123,172.31.47.0-255,66,272422,90,327428
6774,0.002128,172.217.194.0-255,2902,275324,90,327428
6775,0.002131,172.31.47.0-255,66,275390,90,327428
6776,0.002154,172.217.194.0-255,2902,278292,90,327428
6777,0.002156,172.31.47.0-255,66,278358,90,327428
6778,0.002174,172.31.47.0-255,66,278424,90,327428
6779,0.002183,172.217.194.0-255,9992,288416,90,327428
6780,0.002185,172.31.47.0-255,66,288482,90,327428
6781,0.002212,172.217.194.0-255,2902,291384,90,327428
6782,0.002215,172.31.47.0-255,66,291450,90,327428
6783,0.002241,172.217.194.0-255,7856,299306,90,327428
6784,0.002244,172.31.47.0-255,66,299372,90,327428
6785,0.002281,172.217.194.0-255,5738,305110,90,327428
6786,0.002293,172.31.47.0-255,66,305176,90,327428
6787,0.002302,172.217.194.0-255,9992,315168,90,327428
6788,0.002325,172.217.194.0-255,3602,318770,90,327428
6789,0.002348,172.217.194.0-255,8324,327094,90,327428
6790,0.00235,172.217.194.0-255,97,327191,90,327428
6791,0.00236,172.31.47.0-255,66,327257,90,327428
6792,0.002387,172.217.194.0-255,105,327362,90,327428
6793,0.002396,172.31.47.0-255,66,327428,90,327428
6794,0.0,74.125.24.0-255,153,153,90,132656
6795,2.4e-05,172.31.47.0-255,66,219,90,132656
6796,4.7e-05,74.125.24.0-255,1484,1703,90,132656
6797,5.3e-05,172.31.47.0-255,66,1769,90,132656
6798,5.8e-05,74.125.24.0-255,2902,4671,90,132656
6799,6.1e-05,172.31.47.0-255,66,4737,90,132656
6800,6.8e-05,74.125.24.0-255,7156,11893,90,132656
6801,7.1e-05,172.31.47.0-255,66,11959,90,132656
6802,7.5e-05,74.125.24.0-255,2138,14097,90,132656
6803,7.9e-05,172.31.47.0-255,66,14163,90,132656
6804,0.000692,74.125.24.0-255,1484,15647,90,132656
6805,0.000699,172.31.47.0-255,66,15713,90,132656
6806,0.00071,74.125.24.0-255,2902,18615,90,132656
6807,0.000712,172.31.47.0-255,66,18681,90,132656
6808,0.000743,74.125.24.0-255,5738,24419,90,132656
6809,0.000746,172.31.47.0-255,66,24485,90,132656
6810,0.000785,74.125.24.0-255,6797,31282,90,132656
6811,0.000789,172.31.47.0-255,66,31348,90,132656
6812,0.001045,74.125.24.0-255,1484,32832,90,132656
6813,0.001052,172.31.47.0-255,66,32898,90,132656
6814,0.001057,74.125.24.0-255,1484,34382,90,132656
6815,0.001059,172.31.47.0-255,66,34448,90,132656
6816,0.001072,74.125.24.0-255,1484,35932,90,132656
6817,0.001075,172.31.47.0-255,66,35998,90,132656
6818,0.001081,74.125.24.0-255,4320,40318,90,132656
6819,0.001084,172.31.47.0-255,66,40384,90,132656
6820,0.001096,74.125.24.0-255,1484,41868,90,132656
6821,0.001099,172.31.47.0-255,66,41934,90,132656
6822,0.001112,74.125.24.0-255,2902,44836,90,132656
6823,0.001114,172.31.47.0-255,66,44902,90,132656
6824,0.001138,74.125.24.0-255,8215,53117,90,132656
6825,0.001141,172.31.47.0-255,66,53183,90,132656
6826,0.001147,74.125.24.0-255,5738,58921,90,132656
6827,0.001149,172.31.47.0-255,66,58987,90,132656
6828,0.001197,74.125.24.0-255,6797,65784,90,132656
6829,0.0012,172.31.47.0-255,66,65850,90,132656
6830,0.001514,74.125.24.0-255,646,66496,90,132656
6831,0.00176,74.125.24.0-255,1484,67980,90,132656
6832,0.001763,172.31.47.0-255,66,68046,90,132656
6833,0.001786,74.125.24.0-255,2902,70948,90,132656
6834,0.001789,172.31.47.0-255,66,71014,90,132656
6835,0.001794,74.125.24.0-255,4320,75334,90,132656
6836,0.001796,172.31.47.0-255,66,75400,90,132656
6837,0.001802,74.125.24.0-255,5738,81138,90,132656
6838,0.001805,172.31.47.0-255,66,81204,90,132656
6839,0.001822,74.125.24.0-255,2902,84106,90,132656
6840,0.001824,172.31.47.0-255,66,84172,90,132656
6841,0.001842,74.125.24.0-255,2902,87074,90,132656
6842,0.001844,172.31.47.0-255,66,87140,90,132656
6843,0.002021,74.125.24.0-255,1484,88624,90,132656
6844,0.002037,74.125.24.0-255,2902,91526,90,132656
6845,0.002055,74.125.24.0-255,5738,97264,90,132656
6846,0.002073,74.125.24.0-255,4320,101584,90,132656
6847,0.002091,74.125.24.0-255,8574,110158,90,132656
6848,0.002096,74.125.24.0-255,4320,114478,90,132656
6849,0.002114,74.125.24.0-255,5738,120216,90,132656
6850,0.002127,74.125.24.0-255,766,120982,90,132656
6851,0.003587,172.31.47.0-255,66,121048,90,132656
6852,0.005836,74.125.24.0-255,5738,126786,90,132656
6853,0.005846,172.31.47.0-255,66,126852,90,132656
6854,0.008123,74.125.24.0-255,5738,132590,90,132656
6855,0.008134,172.31.47.0-255,66,132656,90,132656
6856,0.0,74.125.24.0-255,146,146,90,244700
6857,2.9e-05,172.31.47.0-255,66,212,90,244700
6858,3.7e-05,74.125.24.0-255,1484,1696,90,244700
6859,4.1e-05,172.31.47.0-255,66,1762,90,244700
6860,4.6e-05,74.125.24.0-255,2902,4664,90,244700
6861,5.6e-05,172.31.47.0-255,66,4730,90,244700
6862,6.4e-05,74.125.24.0-255,7156,11886,90,244700
6863,6.7e-05,172.31.47.0-255,66,11952,90,244700
6864,7.2e-05,74.125.24.0-255,2102,14054,90,244700
6865,7.4e-05,172.31.47.0-255,66,14120,90,244700
6866,7.9e-05,74.125.24.0-255,2902,17022,90,244700
6867,8.2e-05,172.31.47.0-255,66,17088,90,244700
6868,0.000123,74.125.24.0-255,8574,25662,90,244700
6869,0.000126,172.31.47.0-255,66,25728,90,244700
6870,0.000132,74.125.24.0-255,5379,31107,90,244700
6871,0.000134,172.31.47.0-255,66,31173,90,244700
6872,0.000165,74.125.24.0-255,1484,32657,90,244700
6873,0.000169,172.31.47.0-255,66,32723,90,244700
6874,0.000174,74.125.24.0-255,2902,35625,90,244700
6875,0.000175,172.31.47.0-255,66,35691,90,244700
6876,0.000181,74.125.24.0-255,4320,40011,90,244700
6877,0.000183,172.31.47.0-255,66,40077,90,244700
6878,0.000212,74.125.24.0-255,1484,41561,90,244700
6879,0.000215,172.31.47.0-255,66,41627,90,244700
6880,0.00023,172.31.47.0-255,66,41693,90,244700
6881,0.000241,74.125.24.0-255,9992,51685,90,244700
6882,0.000244,172.31.47.0-255,66,51751,90,244700
6883,0.000274,74.125.24.0-255,1126,52877,90,244700
6884,0.000276,172.31.47.0-255,66,52943,90,244700
6885,0.000363,74.125.24.0-255,1484,54427,90,244700
6886,0.000367,172.31.47.0-255,66,54493,90,244700
6887,0.000373,74.125.24.0-255,2902,57395,90,244700
6888,0.000375,172.31.47.0-255,66,57461,90,244700
6889,0.000386,74.125.24.0-255,5738,63199,90,244700
6890,0.000389,172.31.47.0-255,66,63265,90,244700
6891,0.000432,172.31.47.0-255,66,63331,90,244700
6892,0.00044,74.125.24.0-255,9992,73323,90,244700
6893,0.000443,172.31.47.0-255,66,73389,90,244700
6894,0.000445,74.125.24.0-255,766,74155,90,244700
6895,0.000556,74.125.24.0-255,1484,75639,90,244700
6896,0.000561,172.31.47.0-255,66,75705,90,244700
6897,0.000566,74.125.24.0-255,2902,78607,90,244700
6898,0.000568,172.31.47.0-255,66,78673,90,244700
6899,0.000572,74.125.24.0-255,1484,80157,90,244700
6900,0.000594,74.125.24.0-255,2902,83059,90,244700
6901,0.0006,172.31.47.0-255,66,83125,90,244700
6902,0.000602,74.125.24.0-255,8574,91699,90,244700
6903,0.000604,172.31.47.0-255,66,91765,90,244700
6904,0.000652,172.31.47.0-255,66,91831,90,244700
6905,0.000671,172.31.47.0-255,66,91897,90,244700
6906,0.000691,74.125.24.0-255,5738,97635,90,244700
6907,0.000694,172.31.47.0-255,66,97701,90,244700
6908,0.000711,172.31.47.0-255,66,97767,90,244700
6909,0.000752,74.125.24.0-255,8574,106341,90,244700
6910,0.000756,172.31.47.0-255,66,106407,90,244700
6911,0.000825,74.125.24.0-255,8215,114622,90,244700
6912,0.000829,172.31.47.0-255,66,114688,90,244700
6913,0.00087,74.125.24.0-255,1484,116172,90,244700
6914,0.000891,74.125.24.0-255,2902,119074,90,244700
6915,0.000894,172.31.47.0-255,66,119140,90,244700
6916,0.000901,74.125.24.0-255,5738,124878,90,244700
6917,0.000903,172.31.47.0-255,66,124944,90,244700
6918,0.000938,172.31.47.0-255,66,125010,90,244700
6919,0.000947,74.125.24.0-255,9992,135002,90,244700
6920,0.000949,172.31.47.0-255,66,135068,90,244700
6921,0.000957,74.125.24.0-255,766,135834,90,244700
6922,0.001032,74.125.24.0-255,1484,137318,90,244700
6923,0.001036,172.31.47.0-255,66,137384,90,244700
6924,0.001039,74.125.24.0-255,1484,138868,90,244700
6925,0.001063,74.125.24.0-255,1484,140352,90,244700
6926,0.001066,172.31.47.0-255,66,140418,90,244700
6927,0.001072,74.125.24.0-255,5738,146156,90,244700
6928,0.001077,74.125.24.0-255,4320,150476,90,244700
6929,0.00108,172.31.47.0-255,66,150542,90,244700
6930,0.001083,172.31.47.0-255,66,150608,90,244700
6931,0.001118,74.125.24.0-255,8574,159182,90,244700
6932,0.001122,172.31.47.0-255,66,159248,90,244700
6933,0.001128,74.125.24.0-255,5738,164986,90,244700
6934,0.00113,172.31.47.0-255,66,165052,90,244700
6935,0.001152,172.31.47.0-255,66,165118,90,244700
6936,0.001178,74.125.24.0-255,7856,172974,90,244700
6937,0.001182,172.31.47.0-255,66,173040,90,244700
6938,0.001195,172.31.47.0-255,66,173106,90,244700
6939,0.0012,74.125.24.0-255,5020,178126,90,244700
6940,0.001203,172.31.47.0-255,66,178192,90,244700
6941,0.001233,74.125.24.0-255,5738,183930,90,244700
6942,0.001238,172.31.47.0-255,66,183996,90,244700
6943,0.00125,172.31.47.0-255,66,184062,90,244700
6944,0.001276,74.125.24.0-255,1484,185546,90,244700
6945,0.001286,74.125.24.0-255,9992,195538,90,244700
6946,0.001291,172.31.47.0-255,66,195604,90,244700
6947,0.001322,74.125.24.0-255,6438,202042,90,244700
6948,0.001326,172.31.47.0-255,66,202108,90,244700
6949,0.001328,74.125.24.0-255,7156,209264,90,244700
6950,0.00133,172.31.47.0-255,66,209330,90,244700
6951,0.001337,74.125.24.0-255,7156,216486,90,244700
6952,0.001341,172.31.47.0-255,66,216552,90,244700
6953,0.00137,74.125.24.0-255,8574,225126,90,244700
6954,0.001374,172.31.47.0-255,66,225192,90,244700
6955,0.001382,74.125.24.0-255,9274,234466,90,244700
6956,0.001391,172.31.47.0-255,66,234532,90,244700
6957,0.001474,172.31.47.0-255,66,234598,90,244700
6958,0.001489,74.125.24.0-255,2902,237500,90,244700
6959,0.001495,74.125.24.0-255,6438,243938,90,244700
6960,0.001502,172.31.47.0-255,66,244004,90,244700
6961,0.001514,74.125.24.0-255,105,244109,90,244700
6962,0.001516,172.31.47.0-255,66,244175,90,244700
6963,0.003674,172.31.47.0-255,105,244280,90,244700
6964,0.003933,172.31.47.0-255,90,244370,90,244700
6965,0.003942,172.31.47.0-255,66,244436,90,244700
6966,0.006217,74.125.24.0-255,66,244502,90,244700
6967,0.006483,74.125.24.0-255,66,244568,90,244700
6968,0.006512,74.125.24.0-255,66,244634,90,244700
6969,0.006518,172.31.47.0-255,66,244700,90,244700
6970,0.0,74.125.24.0-255,153,153,90,363989
6971,1.9e-05,172.31.47.0-255,66,219,90,363989
6972,2.6e-05,74.125.24.0-255,1484,1703,90,363989
6973,3e-05,172.31.47.0-255,66,1769,90,363989
6974,3.5e-05,74.125.24.0-255,2902,4671,90,363989
6975,3.9e-05,172.31.47.0-255,66,4737,90,363989
6976,4.4e-05,74.125.24.0-255,4320,9057,90,363989
6977,4.8e-05,172.31.47.0-255,66,9123,90,363989
6978,5.4e-05,74.125.24.0-255,4916,14039,90,363989
6979,5.7e-05,172.31.47.0-255,66,14105,90,363989
6980,9.5e-05,172.31.47.0-255,66,14171,90,363989
6981,0.000101,74.125.24.0-255,5379,19550,90,363989
6982,0.000103,172.31.47.0-255,66,19616,90,363989
6983,0.000196,74.125.24.0-255,1484,21100,90,363989
6984,0.0002,172.31.47.0-255,66,21166,90,363989
6985,0.000206,74.125.24.0-255,2902,24068,90,363989
6986,0.000208,172.31.47.0-255,66,24134,90,363989
6987,0.000214,74.125.24.0-255,5738,29872,90,363989
6988,0.000216,172.31.47.0-255,66,29938,90,363989
6989,0.00025,172.31.47.0-255,66,30004,90,363989
6990,0.000258,74.125.24.0-255,8574,38578,90,363989
6991,0.00026,172.31.47.0-255,66,38644,90,363989
6992,0.000279,74.125.24.0-255,2483,41127,90,363989
6993,0.000281,172.31.47.0-255,66,41193,90,363989
6994,0.000338,74.125.24.0-255,130,41323,90,363989
6995,0.000341,172.31.47.0-255,66,41389,90,363989
6996,0.00051,74.125.24.0-255,1484,42873,90,363989
6997,0.000516,172.31.47.0-255,66,42939,90,363989
6998,0.000527,74.125.24.0-255,2902,45841,90,363989
6999,0.00053,172.31.47.0-255,66,45907,90,363989
7000,0.000546,74.125.24.0-255,1484,47391,90,363989
7001,0.000567,74.125.24.0-255,4320,51711,90,363989
7002,0.00057,172.31.47.0-255,66,51777,90,363989
7003,0.000576,74.125.24.0-255,4320,56097,90,363989
7004,0.000579,172.31.47.0-255,66,56163,90,363989
7005,0.000598,74.125.24.0-255,7156,63319,90,363989
7006,0.000601,172.31.47.0-255,66,63385,90,363989
7007,0.000609,74.125.24.0-255,8574,71959,90,363989
7008,0.000612,172.31.47.0-255,66,72025,90,363989
7009,0.000634,74.125.24.0-255,3602,75627,90,363989
7010,0.000636,172.31.47.0-255,66,75693,90,363989
7011,0.000652,74.125.24.0-255,344,76037,90,363989
7012,0.000776,74.125.24.0-255,1484,77521,90,363989
7013,0.00078,172.31.47.0-255,66,77587,90,363989
7014,0.000809,74.125.24.0-255,2902,80489,90,363989
7015,0.000813,172.31.47.0-255,66,80555,90,363989
7016,0.000852,74.125.24.0-255,1484,82039,90,363989
7017,0.000868,74.125.24.0-255,2902,84941,90,363989
7018,0.00087,172.31.47.0-255,66,85007,90,363989
7019,0.000878,74.125.24.0-255,8574,93581,90,363989
7020,0.000881,172.31.47.0-255,66,93647,90,363989
7021,0.000887,74.125.24.0-255,7156,100803,90,363989
7022,0.000891,172.31.47.0-255,66,100869,90,363989
7023,0.000938,74.125.24.0-255,7156,108025,90,363989
7024,0.000941,172.31.47.0-255,66,108091,90,363989
7025,0.000955,74.125.24.0-255,2184,110275,90,363989
7026,0.000957,172.31.47.0-255,66,110341,90,363989
7027,0.001002,74.125.24.0-255,1484,111825,90,363989
7028,0.001021,74.125.24.0-255,2902,114727,90,363989
7029,0.001023,172.31.47.0-255,66,114793,90,363989
7030,0.001027,74.125.24.0-255,1484,116277,90,363989
7031,0.001041,74.125.24.0-255,1484,117761,90,363989
7032,0.001043,172.31.47.0-255,66,117827,90,363989
7033,0.001048,74.125.24.0-255,2902,120729,90,363989
7034,0.00105,172.31.47.0-255,66,120795,90,363989
7035,0.001072,74.125.24.0-255,4320,125115,90,363989
7036,0.001075,172.31.47.0-255,66,125181,90,363989
7037,0.001087,74.125.24.0-255,2902,128083,90,363989
7038,0.00109,172.31.47.0-255,66,128149,90,363989
7039,0.001109,74.125.24.0-255,7156,135305,90,363989
7040,0.001111,172.31.47.0-255,66,135371,90,363989
7041,0.001133,74.125.24.0-255,1484,136855,90,363989
7042,0.001155,74.125.24.0-255,7856,144711,90,363989
7043,0.001158,172.31.47.0-255,66,144777,90,363989
7044,0.001219,74.125.24.0-255,1484,146261,90,363989
7045,0.001236,74.125.24.0-255,2902,149163,90,363989
7046,0.00124,172.31.47.0-255,66,149229,90,363989
7047,0.001243,74.125.24.0-255,1484,150713,90,363989
7048,0.001263,74.125.24.0-255,4320,155033,90,363989
7049,0.001266,172.31.47.0-255,66,155099,90,363989
7050,0.001281,74.125.24.0-255,4320,159419,90,363989
7051,0.001284,172.31.47.0-255,66,159485,90,363989
7052,0.001308,74.125.24.0-255,8574,168059,90,363989
7053,0.001311,172.31.47.0-255,66,168125,90,363989
7054,0.001353,74.125.24.0-255,2902,171027,90,363989
7055,0.001357,172.31.47.0-255,66,171093,90,363989
7056,0.001382,74.125.24.0-255,7856,178949,90,363989
7057,0.001385,172.31.47.0-255,66,179015,90,363989
7058,0.001666,74.125.24.0-255,1484,180499,90,363989
7059,0.001671,74.125.24.0-255,1484,181983,90,363989
7060,0.001674,172.31.47.0-255,66,182049,90,363989
7061,0.001691,74.125.24.0-255,1484,183533,90,363989
7062,0.001713,74.125.24.0-255,5738,189271,90,363989
7063,0.001716,172.31.47.0-255,66,189337,90,363989
7064,0.001729,74.125.24.0-255,2902,192239,90,363989
7065,0.001731,172.31.47.0-255,66,192305,90,363989
7066,0.001767,74.125.24.0-255,9992,202297,90,363989
7067,0.001769,172.31.47.0-255,66,202363,90,363989
7068,0.001775,74.125.24.0-255,5738,208101,90,363989
7069,0.001776,172.31.47.0-255,66,208167,90,363989
7070,0.001799,74.125.24.0-255,5020,213187,90,363989
7071,0.001802,172.31.47.0-255,66,213253,90,363989
7072,0.002077,74.125.24.0-255,1484,214737,90,363989
7073,0.002101,74.125.24.0-255,2902,217639,90,363989
7074,0.002104,172.31.47.0-255,66,217705,90,363989
7075,0.002124,74.125.24.0-255,5738,223443,90,363989
7076,0.002126,172.31.47.0-255,66,223509,90,363989
7077,0.002149,74.125.24.0-255,2902,226411,90,363989
7078,0.002152,172.31.47.0-255,66,226477,90,363989
7079,0.002185,74.125.24.0-255,2902,229379,90,363989
7080,0.002188,172.31.47.0-255,66,229445,90,363989
7081,0.002191,74.125.24.0-255,1484,230929,90,363989
7082,0.002193,74.125.24.0-255,1484,232413,90,363989
7083,0.002194,172.31.47.0-255,66,232479,90,363989
7084,0.002198,74.125.24.0-255,4320,236799,90,363989
7085,0.0022,172.31.47.0-255,66,236865,90,363989
7086,0.002225,74.125.24.0-255,7156,244021,90,363989
7087,0.002228,172.31.47.0-255,66,244087,90,363989
7088,0.002248,74.125.24.0-255,2902,246989,90,363989
7089,0.002251,172.31.47.0-255,66,247055,90,363989
7090,0.002253,74.125.24.0-255,766,247821,90,363989
7091,0.002257,74.125.24.0-255,4320,252141,90,363989
7092,0.002259,172.31.47.0-255,66,252207,90,363989
7093,0.002283,74.125.24.0-255,4320,256527,90,363989
7094,0.002286,172.31.47.0-255,66,256593,90,363989
7095,0.00229,74.125.24.0-255,2902,259495,90,363989
7096,0.002291,172.31.47.0-255,66,259561,90,363989
7097,0.002294,74.125.24.0-255,1484,261045,90,363989
7098,0.002333,74.125.24.0-255,4320,265365,90,363989
7099,0.002336,172.31.47.0-255,66,265431,90,363989
7100,0.002359,74.125.24.0-255,2902,268333,90,363989
7101,0.002362,172.31.47.0-255,66,268399,90,363989
7102,0.002366,74.125.24.0-255,1484,269883,90,363989
7103,0.002369,74.125.24.0-255,2902,272785,90,363989
7104,0.002371,172.31.47.0-255,66,272851,90,363989
7105,0.002374,74.125.24.0-255,1484,274335,90,363989
7106,0.002376,74.125.24.0-255,1484,275819,90,363989
7107,0.002377,172.31.47.0-255,66,275885,90,363989
7108,0.002427,74.125.24.0-255,6438,282323,90,363989
7109,0.00243,172.31.47.0-255,66,282389,90,363989
7110,0.00245,74.125.24.0-255,1484,283873,90,363989
7111,0.002463,74.125.24.0-255,2902,286775,90,363989
7112,0.002465,172.31.47.0-255,66,286841,90,363989
7113,0.002468,74.125.24.0-255,1484,288325,90,363989
7114,0.00249,74.125.24.0-255,4320,292645,90,363989
7115,0.002494,172.31.47.0-255,66,292711,90,363989
7116,0.002527,172.31.47.0-255,66,292777,90,363989
7117,0.002562,74.125.24.0-255,4320,297097,90,363989
7118,0.002565,172.31.47.0-255,66,297163,90,363989
7119,0.002588,74.125.24.0-255,6438,303601,90,363989
7120,0.00259,172.31.47.0-255,66,303667,90,363989
7121,0.002608,74.125.24.0-255,2902,306569,90,363989
7122,0.00261,172.31.47.0-255,66,306635,90,363989
7123,0.002632,74.125.24.0-255,2902,309537,90,363989
7124,0.002634,172.31.47.0-255,66,309603,90,363989
7125,0.002639,74.125.24.0-255,4320,313923,90,363989
7126,0.002641,172.31.47.0-255,66,313989,90,363989
7127,0.002644,74.125.24.0-255,1484,315473,90,363989
7128,0.002662,74.125.24.0-255,1484,316957,90,363989
7129,0.002666,172.31.47.0-255,66,317023,90,363989
7130,0.00269,74.125.24.0-255,2902,319925,90,363989
7131,0.002692,172.31.47.0-255,66,319991,90,363989
7132,0.002698,74.125.24.0-255,5738,325729,90,363989
7133,0.002699,172.31.47.0-255,66,325795,90,363989
7134,0.002713,74.125.24.0-255,7156,332951,90,363989
7135,0.002716,172.31.47.0-255,66,333017,90,363989
7136,0.002725,74.125.24.0-255,1484,334501,90,363989
7137,0.002741,74.125.24.0-255,3602,338103,90,363989
7138,0.002744,172.31.47.0-255,66,338169,90,363989
7139,0.002761,74.125.24.0-255,1484,339653,90,363989
7140,0.002785,74.125.24.0-255,9992,349645,90,363989
7141,0.002789,172.31.47.0-255,66,349711,90,363989
7142,0.002793,74.125.24.0-255,2902,352613,90,363989
7143,0.002794,172.31.47.0-255,66,352679,90,363989
7144,0.002817,74.125.24.0-255,4320,356999,90,363989
7145,0.00282,172.31.47.0-255,66,357065,90,363989
7146,0.002846,172.31.47.0-255,66,357131,90,363989
7147,0.002867,74.125.24.0-255,2902,360033,90,363989
7148,0.002871,172.31.47.0-255,66,360099,90,363989
7149,0.00288,74.125.24.0-255,3482,363581,90,363989
7150,0.002883,172.31.47.0-255,66,363647,90,363989
7151,0.002935,74.125.24.0-255,105,363752,90,363989
7152,0.004338,172.31.47.0-255,66,363818,90,363989
7153,0.004371,172.31.47.0-255,105,363923,90,363989
7154,0.006411,74.125.24.0-255,66,363989,90,363989
7155,0.0,172.31.47.0-255,105,105,90,105
7156,0.0,31.13.82.0-255,105,105,90,105
7157,0.0,172.31.47.0-255,105,105,90,105
7158,0.0,172.31.47.0-255,105,105,90,105
7159,0.0,172.31.47.0-255,105,105,90,276
7160,0.00147,157.240.13.0-255,105,210,90,276
7161,0.001481,172.31.47.0-255,66,276,90,276
7162,0.0,172.31.47.0-255,66,66,90,66
7163,0.0,172.31.47.0-255,105,105,90,105
7164,0.0,172.31.47.0-255,105,105,90,276
7165,0.002213,157.240.13.0-255,105,210,90,276
7166,0.002224,172.31.47.0-255,66,276,90,276
7167,0.0,172.217.194.0-255,153,153,90,255854
7168,1.4e-05,172.31.47.0-255,66,219,90,255854
7169,2.1e-05,172.217.194.0-255,1484,1703,90,255854
7170,2.6e-05,172.31.47.0-255,66,1769,90,255854
7171,3.1e-05,172.217.194.0-255,2902,4671,90,255854
7172,4.6e-05,172.31.47.0-255,66,4737,90,255854
7173,5.3e-05,172.217.194.0-255,7156,11893,90,255854
7174,5.7e-05,172.31.47.0-255,66,11959,90,255854
7175,6.2e-05,172.217.194.0-255,3590,15549,90,255854
7176,6.7e-05,172.31.47.0-255,66,15615,90,255854
7177,8e-05,172.31.47.0-255,66,15681,90,255854
7178,8.5e-05,172.217.194.0-255,2543,18224,90,255854
7179,8.8e-05,172.31.47.0-255,66,18290,90,255854
7180,0.000144,172.217.194.0-255,1484,19774,90,255854
7181,0.000147,172.31.47.0-255,66,19840,90,255854
7182,0.000151,172.217.194.0-255,2902,22742,90,255854
7183,0.000153,172.31.47.0-255,66,22808,90,255854
7184,0.000187,172.217.194.0-255,5738,28546,90,255854
7185,0.000189,172.31.47.0-255,66,28612,90,255854
7186,0.000212,172.217.194.0-255,6797,35409,90,255854
7187,0.000215,172.31.47.0-255,66,35475,90,255854
7188,0.000551,172.217.194.0-255,1484,36959,90,255854
7189,0.000557,172.31.47.0-255,66,37025,90,255854
7190,0.000563,172.217.194.0-255,2902,39927,90,255854
7191,0.000566,172.31.47.0-255,66,39993,90,255854
7192,0.00057,172.217.194.0-255,2902,42895,90,255854
7193,0.000578,172.31.47.0-255,66,42961,90,255854
7194,0.0006,172.217.194.0-255,2902,45863,90,255854
7195,0.000603,172.31.47.0-255,66,45929,90,255854
7196,0.000606,172.217.194.0-255,1484,47413,90,255854
7197,0.000608,172.31.47.0-255,66,47479,90,255854
7198,0.000639,172.217.194.0-255,5379,52858,90,255854
7199,0.000641,172.31.47.0-255,66,52924,90,255854
7200,0.000647,172.217.194.0-255,7156,60080,90,255854
7201,0.000649,172.31.47.0-255,66,60146,90,255854
7202,0.000656,172.217.194.0-255,8574,68720,90,255854
7203,0.000659,172.31.47.0-255,66,68786,90,255854
7204,0.000686,172.217.194.0-255,1707,70493,90,255854
7205,0.000689,172.31.47.0-255,66,70559,90,255854
7206,0.000698,172.217.194.0-255,9992,80551,90,255854
7207,0.0007,172.31.47.0-255,66,80617,90,255854
7208,0.00073,172.217.194.0-255,1484,82101,90,255854
7209,0.000737,172.217.194.0-255,5379,87480,90,255854
7210,0.00074,172.31.47.0-255,66,87546,90,255854
7211,0.000967,172.217.194.0-255,1484,89030,90,255854
7212,0.000972,172.217.194.0-255,2902,91932,90,255854
7213,0.000975,172.31.47.0-255,66,91998,90,255854
7214,0.001012,172.217.194.0-255,5738,97736,90,255854
7215,0.001015,172.31.47.0-255,66,97802,90,255854
7216,0.001023,172.217.194.0-255,8574,106376,90,255854
7217,0.001025,172.31.47.0-255,66,106442,90,255854
7218,0.001035,172.217.194.0-255,5738,112180,90,255854
7219,0.001038,172.31.47.0-255,66,112246,90,255854
7220,0.001065,172.217.194.0-255,4320,116566,90,255854
7221,0.001067,172.31.47.0-255,66,116632,90,255854
7222,0.001073,172.217.194.0-255,5020,121652,90,255854
7223,0.001075,172.31.47.0-255,66,121718,90,255854
7224,0.001115,172.217.194.0-255,5738,127456,90,255854
7225,0.001117,172.31.47.0-255,66,127522,90,255854
7226,0.001127,172.217.194.0-255,7156,134678,90,255854
7227,0.001129,172.31.47.0-255,66,134744,90,255854
7228,0.001133,172.217.194.0-255,2902,137646,90,255854
7229,0.001135,172.31.47.0-255,66,137712,90,255854
7230,0.001165,172.31.47.0-255,66,137778,90,255854
7231,0.001171,172.217.194.0-255,6438,144216,90,255854
7232,0.001173,172.31.47.0-255,66,144282,90,255854
7233,0.001201,172.217.194.0-255,2902,147184,90,255854
7234,0.001204,172.31.47.0-255,66,147250,90,255854
7235,0.001227,172.217.194.0-255,4320,151570,90,255854
7236,0.001229,172.31.47.0-255,66,151636,90,255854
7237,0.001236,172.217.194.0-255,7156,158792,90,255854
7238,0.001238,172.31.47.0-255,66,158858,90,255854
7239,0.00124,172.217.194.0-255,1484,160342,90,255854
7240,0.001286,172.31.47.0-255,66,160408,90,255854
7241,0.001292,172.217.194.0-255,5020,165428,90,255854
7242,0.001294,172.31.47.0-255,66,165494,90,255854
7243,0.001312,172.217.194.0-255,2902,168396,90,255854
7244,0.001314,172.31.47.0-255,66,168462,90,255854
7245,0.001359,172.31.47.0-255,66,168528,90,255854
7246,0.001367,172.217.194.0-255,9274,177802,90,255854
7247,0.001369,172.31.47.0-255,66,177868,90,255854
7248,0.001375,172.217.194.0-255,1484,179352,90,255854
7249,0.001379,172.217.194.0-255,2902,182254,90,255854
7250,0.001382,172.31.47.0-255,66,182320,90,255854
7251,0.001411,172.217.194.0-255,5738,188058,90,255854
7252,0.001413,172.31.47.0-255,66,188124,90,255854
7253,0.001424,172.217.194.0-255,8574,196698,90,255854
7254,0.001426,172.31.47.0-255,66,196764,90,255854
7255,0.001457,172.217.194.0-255,4320,201084,90,255854
7256,0.00146,172.31.47.0-255,66,201150,90,255854
7257,0.001469,172.217.194.0-255,10692,211842,90,255854
7258,0.001471,172.31.47.0-255,66,211908,90,255854
7259,0.001587,172.217.194.0-255,1484,213392,90,255854
7260,0.001593,172.217.194.0-255,2902,216294,90,255854
7261,0.001596,172.31.47.0-255,66,216360,90,255854
7262,0.001621,172.217.194.0-255,5738,222098,90,255854
7263,0.001623,172.31.47.0-255,66,222164,90,255854
7264,0.001661,172.31.47.0-255,66,222230,90,255854
7265,0.001688,172.217.194.0-255,4320,226550,90,255854
7266,0.001691,172.31.47.0-255,66,226616,90,255854
7267,0.001718,172.217.194.0-255,6438,233054,90,255854
7268,0.001721,172.31.47.0-255,66,233120,90,255854
7269,0.001746,172.217.194.0-255,2902,236022,90,255854
7270,0.001749,172.31.47.0-255,66,236088,90,255854
7271,0.001754,172.217.194.0-255,4320,240408,90,255854
7272,0.001756,172.31.47.0-255,66,240474,90,255854
7273,0.00179,172.217.194.0-255,5738,246212,90,255854
7274,0.001792,172.31.47.0-255,66,246278,90,255854
7275,0.001804,172.217.194.0-255,2902,249180,90,255854
7276,0.001806,172.31.47.0-255,66,249246,90,255854
7277,0.001829,172.31.47.0-255,66,249312,90,255854
7278,0.001833,172.217.194.0-255,2902,252214,90,255854
7279,0.001834,172.31.47.0-255,66,252280,90,255854
7280,0.001882,172.31.47.0-255,66,252346,90,255854
7281,0.001898,172.31.47.0-255,66,252412,90,255854
7282,0.001912,172.31.47.0-255,66,252478,90,255854
7283,0.00195,172.217.194.0-255,2902,255380,90,255854
7284,0.001953,172.31.47.0-255,66,255446,90,255854
7285,0.001998,172.31.47.0-255,66,255512,90,255854
7286,0.002001,172.217.194.0-255,105,255617,90,255854
7287,0.007643,172.31.47.0-255,66,255683,90,255854
7288,0.007676,172.31.47.0-255,105,255788,90,255854
7289,0.009905,172.217.194.0-255,66,255854,90,255854
7290,0.0,74.125.24.0-255,158,158,90,340120
7291,3e-05,172.31.47.0-255,66,224,90,340120
7292,3.6e-05,74.125.24.0-255,1484,1708,90,340120
7293,4e-05,172.31.47.0-255,66,1774,90,340120
7294,4.4e-05,74.125.24.0-255,2902,4676,90,340120
7295,5.5e-05,172.31.47.0-255,66,4742,90,340120
7296,5.8e-05,74.125.24.0-255,2902,7644,90,340120
7297,6.1e-05,172.31.47.0-255,66,7710,90,340120
7298,9.5e-05,74.125.24.0-255,10558,18268,90,340120
7299,0.0001,172.31.47.0-255,66,18334,90,340120
7300,0.000105,74.125.24.0-255,4320,22654,90,340120
7301,0.000106,172.31.47.0-255,66,22720,90,340120
7302,0.000126,74.125.24.0-255,1484,24204,90,340120
7303,0.000128,172.31.47.0-255,66,24270,90,340120
7304,0.00017,172.31.47.0-255,66,24336,90,340120
7305,0.000175,74.125.24.0-255,5738,30074,90,340120
7306,0.000178,172.31.47.0-255,66,30140,90,340120
7307,0.000221,74.125.24.0-255,3602,33742,90,340120
7308,0.000224,172.31.47.0-255,66,33808,90,340120
7309,0.000228,74.125.24.0-255,4320,38128,90,340120
7310,0.00023,172.31.47.0-255,66,38194,90,340120
7311,0.000239,74.125.24.0-255,4320,42514,90,340120
7312,0.000242,172.31.47.0-255,66,42580,90,340120
7313,0.000275,74.125.24.0-255,5738,48318,90,340120
7314,0.000278,172.31.47.0-255,66,48384,90,340120
7315,0.000282,74.125.24.0-255,1717,50101,90,340120
7316,0.000286,172.31.47.0-255,66,50167,90,340120
7317,0.000434,74.125.24.0-255,1484,51651,90,340120
7318,0.000437,172.31.47.0-255,66,51717,90,340120
7319,0.000441,74.125.24.0-255,1484,53201,90,340120
7320,0.000444,172.31.47.0-255,66,53267,90,340120
7321,0.000464,74.125.24.0-255,1484,54751,90,340120
7322,0.000478,74.125.24.0-255,5738,60489,90,340120
7323,0.00048,172.31.47.0-255,66,60555,90,340120
7324,0.000489,74.125.24.0-255,9992,70547,90,340120
7325,0.000491,172.31.47.0-255,66,70613,90,340120
7326,0.000515,74.125.24.0-255,2902,73515,90,340120
7327,0.000522,172.31.47.0-255,66,73581,90,340120
7328,0.000532,74.125.24.0-255,10692,84273,90,340120
7329,0.000534,172.31.47.0-255,66,84339,90,340120
7330,0.000536,74.125.24.0-255,1484,85823,90,340120
7331,0.000569,74.125.24.0-255,2902,88725,90,340120
7332,0.000572,172.31.47.0-255,66,88791,90,340120
7333,0.000578,74.125.24.0-255,5738,94529,90,340120
7334,0.00058,172.31.47.0-255,66,94595,90,340120
7335,0.000599,172.31.47.0-255,66,94661,90,340120
7336,0.000604,74.125.24.0-255,5738,100399,90,340120
7337,0.000607,172.31.47.0-255,66,100465,90,340120
7338,0.000635,74.125.24.0-255,5738,106203,90,340120
7339,0.000638,172.31.47.0-255,66,106269,90,340120
7340,0.000674,172.31.47.0-255,66,106335,90,340120
7341,0.000686,172.31.47.0-255,66,106401,90,340120
7342,0.000713,74.125.24.0-255,5020,111421,90,340120
7343,0.00072,172.31.47.0-255,66,111487,90,340120
7344,0.000743,74.125.24.0-255,1484,112971,90,340120
7345,0.000758,74.125.24.0-255,2902,115873,90,340120
7346,0.00076,172.31.47.0-255,66,115939,90,340120
7347,0.000787,74.125.24.0-255,5738,121677,90,340120
7348,0.00079,172.31.47.0-255,66,121743,90,340120
7349,0.000815,74.125.24.0-255,4320,126063,90,340120
7350,0.000818,172.31.47.0-255,66,126129,90,340120
7351,0.000844,74.125.24.0-255,2902,129031,90,340120
7352,0.000847,172.31.47.0-255,66,129097,90,340120
7353,0.000854,74.125.24.0-255,8574,137671,90,340120
7354,0.000857,172.31.47.0-255,66,137737,90,340120
7355,0.000868,74.125.24.0-255,5738,143475,90,340120
7356,0.00087,172.31.47.0-255,66,143541,90,340120
7357,0.000895,74.125.24.0-255,2184,145725,90,340120
7358,0.000898,172.31.47.0-255,66,145791,90,340120
7359,0.001164,74.125.24.0-255,1484,147275,90,340120
7360,0.001168,74.125.24.0-255,1484,148759,90,340120
7361,0.00117,172.31.47.0-255,66,148825,90,340120
7362,0.001195,74.125.24.0-255,1484,150309,90,340120
7363,0.001201,74.125.24.0-255,5738,156047,90,340120
7364,0.001204,172.31.47.0-255,66,156113,90,340120
7365,0.00123,74.125.24.0-255,2902,159015,90,340120
7366,0.001232,172.31.47.0-255,66,159081,90,340120
7367,0.001254,74.125.24.0-255,7156,166237,90,340120
7368,0.001256,172.31.47.0-255,66,166303,90,340120
7369,0.001261,74.125.24.0-255,4320,170623,90,340120
7370,0.001262,172.31.47.0-255,66,170689,90,340120
7371,0.001292,74.125.24.0-255,7156,177845,90,340120
7372,0.001295,172.31.47.0-255,66,177911,90,340120
7373,0.001298,74.125.24.0-255,2184,180095,90,340120
7374,0.0013,172.31.47.0-255,66,180161,90,340120
7375,0.00134,74.125.24.0-255,1484,181645,90,340120
7376,0.001365,74.125.24.0-255,1484,183129,90,340120
7377,0.001368,172.31.47.0-255,66,183195,90,340120
7378,0.001375,74.125.24.0-255,7156,190351,90,340120
7379,0.001377,172.31.47.0-255,66,190417,90,340120
7380,0.001395,74.125.24.0-255,7156,197573,90,340120
7381,0.001398,172.31.47.0-255,66,197639,90,340120
7382,0.001405,74.125.24.0-255,8574,206213,90,340120
7383,0.00141,172.31.47.0-255,66,206279,90,340120
7384,0.001436,74.125.24.0-255,7156,213435,90,340120
7385,0.001443,172.31.47.0-255,66,213501,90,340120
7386,0.001446,74.125.24.0-255,766,214267,90,340120
7387,0.001557,74.125.24.0-255,1484,215751,90,340120
7388,0.001561,172.31.47.0-255,66,215817,90,340120
7389,0.001565,74.125.24.0-255,2902,218719,90,340120
7390,0.001567,172.31.47.0-255,66,218785,90,340120
7391,0.001595,74.125.24.0-255,5738,224523,90,340120
7392,0.001597,172.31.47.0-255,66,224589,90,340120
7393,0.001624,74.125.24.0-255,7156,231745,90,340120
7394,0.001627,172.31.47.0-255,66,231811,90,340120
7395,0.001644,74.125.24.0-255,4320,236131,90,340120
7396,0.001646,172.31.47.0-255,66,236197,90,340120
7397,0.001649,74.125.24.0-255,1484,237681,90,340120
7398,0.00168,74.125.24.0-255,10692,248373,90,340120
7399,0.001683,172.31.47.0-255,66,248439,90,340120
7400,0.001725,74.125.24.0-255,1484,249923,90,340120
7401,0.00174,74.125.24.0-255,2902,252825,90,340120
7402,0.001742,172.31.47.0-255,66,252891,90,340120
7403,0.001768,74.125.24.0-255,5738,258629,90,340120
7404,0.001771,172.31.47.0-255,66,258695,90,340120
7405,0.001774,74.125.24.0-255,1484,260179,90,340120
7406,0.001776,74.125.24.0-255,1484,261663,90,340120
7407,0.001778,172.31.47.0-255,66,261729,90,340120
7408,0.001802,74.125.24.0-255,7156,268885,90,340120
7409,0.001805,172.31.47.0-255,66,268951,90,340120
7410,0.001812,74.125.24.0-255,1484,270435,90,340120
7411,0.001835,74.125.24.0-255,8574,279009,90,340120
7412,0.001838,172.31.47.0-255,66,279075,90,340120
7413,0.001863,74.125.24.0-255,4320,283395,90,340120
7414,0.001866,172.31.47.0-255,66,283461,90,340120
7415,0.001894,74.125.24.0-255,6438,289899,90,340120
7416,0.001896,172.31.47.0-255,66,289965,90,340120
7417,0.0019,74.125.24.0-255,2902,292867,90,340120
7418,0.001902,172.31.47.0-255,66,292933,90,340120
7419,0.001925,74.125.24.0-255,5738,298671,90,340120
7420,0.001932,172.31.47.0-255,66,298737,90,340120
7421,0.001952,74.125.24.0-255,8574,307311,90,340120
7422,0.001954,172.31.47.0-255,66,307377,90,340120
7423,0.001975,74.125.24.0-255,1484,308861,90,340120
7424,0.001982,74.125.24.0-255,7156,316017,90,340120
7425,0.001985,172.31.47.0-255,66,316083,90,340120
7426,0.001995,74.125.24.0-255,4320,320403,90,340120
7427,0.001997,172.31.47.0-255,66,320469,90,340120
7428,0.002025,74.125.24.0-255,7856,328325,90,340120
7429,0.002029,172.31.47.0-255,66,328391,90,340120
7430,0.00204,172.31.47.0-255,66,328457,90,340120
7431,0.002052,74.125.24.0-255,8574,337031,90,340120
7432,0.002055,172.31.47.0-255,66,337097,90,340120
7433,0.002084,74.125.24.0-255,2681,339778,90,340120
7434,0.002092,172.31.47.0-255,66,339844,90,340120
7435,0.002139,74.125.24.0-255,105,339949,90,340120
7436,0.008587,172.31.47.0-255,66,340015,90,340120
7437,0.008613,172.31.47.0-255,105,340120,90,340120
7438,0.0,74.125.24.0-255,145,145,90,157290
7439,1.8e-05,172.31.47.0-255,66,211,90,157290
7440,2.5e-05,74.125.24.0-255,1484,1695,90,157290
7441,2.8e-05,172.31.47.0-255,66,1761,90,157290
7442,3.3e-05,74.125.24.0-255,2902,4663,90,157290
7443,3.6e-05,172.31.47.0-255,66,4729,90,157290
7444,4.8e-05,74.125.24.0-255,4320,9049,90,157290
7445,5.1e-05,172.31.47.0-255,66,9115,90,157290
7446,8.3e-05,74.125.24.0-255,4800,13915,90,157290
7447,8.6e-05,172.31.47.0-255,66,13981,90,157290
7448,9.3e-05,74.125.24.0-255,5738,19719,90,157290
7449,9.5e-05,172.31.47.0-255,66,19785,90,157290
7450,0.000149,172.31.47.0-255,66,19851,90,157290
7451,0.000296,74.125.24.0-255,1484,21335,90,157290
7452,0.0003,172.31.47.0-255,66,21401,90,157290
7453,0.000305,74.125.24.0-255,2902,24303,90,157290
7454,0.000308,172.31.47.0-255,66,24369,90,157290
7455,0.000313,74.125.24.0-255,4320,28689,90,157290
7456,0.000315,172.31.47.0-255,66,28755,90,157290
7457,0.000346,74.125.24.0-255,1484,30239,90,157290
7458,0.000348,172.31.47.0-255,66,30305,90,157290
7459,0.000354,74.125.24.0-255,5738,36043,90,157290
7460,0.000357,172.31.47.0-255,66,36109,90,157290
7461,0.000372,172.31.47.0-255,66,36175,90,157290
7462,0.00039,74.125.24.0-255,4273,40448,90,157290
7463,0.000392,172.31.47.0-255,66,40514,90,157290
7464,0.000433,74.125.24.0-255,110,40624,90,157290
7465,0.000435,172.31.47.0-255,66,40690,90,157290
7466,0.000447,74.125.24.0-255,332,41022,90,157290
7467,0.000453,172.31.47.0-255,66,41088,90,157290
7468,0.00074,74.125.24.0-255,1484,42572,90,157290
7469,0.000746,74.125.24.0-255,2902,45474,90,157290
7470,0.000749,172.31.47.0-255,66,45540,90,157290
7471,0.000756,74.125.24.0-255,5738,51278,90,157290
7472,0.000758,172.31.47.0-255,66,51344,90,157290
7473,0.000789,172.31.47.0-255,66,51410,90,157290
7474,0.000825,74.125.24.0-255,1484,52894,90,157290
7475,0.000854,74.125.24.0-255,10692,63586,90,157290
7476,0.000858,172.31.47.0-255,66,63652,90,157290
7477,0.001001,74.125.24.0-255,1484,65136,90,157290
7478,0.001005,74.125.24.0-255,1484,66620,90,157290
7479,0.001008,172.31.47.0-255,66,66686,90,157290
7480,0.001023,74.125.24.0-255,1484,68170,90,157290
7481,0.001032,74.125.24.0-255,5738,73908,90,157290
7482,0.001034,172.31.47.0-255,66,73974,90,157290
7483,0.001037,74.125.24.0-255,1484,75458,90,157290
7484,0.001043,74.125.24.0-255,5738,81196,90,157290
7485,0.001045,172.31.47.0-255,66,81262,90,157290
7486,0.001073,74.125.24.0-255,2902,84164,90,157290
7487,0.001075,172.31.47.0-255,66,84230,90,157290
7488,0.001106,172.31.47.0-255,66,84296,90,157290
7489,0.001654,74.125.24.0-255,1484,85780,90,157290
7490,0.001662,74.125.24.0-255,2902,88682,90,157290
7491,0.001666,172.31.47.0-255,66,88748,90,157290
7492,0.001671,74.125.24.0-255,4320,93068,90,157290
7493,0.001673,172.31.47.0-255,66,93134,90,157290
7494,0.001692,74.125.24.0-255,1484,94618,90,157290
7495,0.0017,74.125.24.0-255,4320,98938,90,157290
7496,0.001702,172.31.47.0-255,66,99004,90,157290
7497,0.00174,172.31.47.0-255,66,99070,90,157290
7498,0.001747,74.125.24.0-255,7856,106926,90,157290
7499,0.001749,172.31.47.0-255,66,106992,90,157290
7500,0.001852,74.125.24.0-255,1484,108476,90,157290
7501,0.001857,74.125.24.0-255,2902,111378,90,157290
7502,0.00186,172.31.47.0-255,66,111444,90,157290
7503,0.001866,74.125.24.0-255,5738,117182,90,157290
7504,0.001868,172.31.47.0-255,66,117248,90,157290
7505,0.001895,74.125.24.0-255,2902,120150,90,157290
7506,0.001898,172.31.47.0-255,66,120216,90,157290
7507,0.001903,74.125.24.0-255,4320,124536,90,157290
7508,0.001905,172.31.47.0-255,66,124602,90,157290
7509,0.001929,74.125.24.0-255,8574,133176,90,157290
7510,0.001932,172.31.47.0-255,66,133242,90,157290
7511,0.001936,74.125.24.0-255,1484,134726,90,157290
7512,0.001971,74.125.24.0-255,6438,141164,90,157290
7513,0.001974,172.31.47.0-255,66,141230,90,157290
7514,0.004054,74.125.24.0-255,5738,146968,90,157290
7515,0.004062,172.31.47.0-255,66,147034,90,157290
7516,0.006146,74.125.24.0-255,4320,151354,90,157290
7517,0.006152,172.31.47.0-255,66,151420,90,157290
7518,0.00618,74.125.24.0-255,1484,152904,90,157290
7519,0.00822,74.125.24.0-255,4320,157224,90,157290
7520,0.008227,172.31.47.0-255,66,157290,90,157290
7521,0.0,172.31.47.0-255,105,105,90,276
7522,0.001764,157.240.13.0-255,105,210,90,276
7523,0.001775,172.31.47.0-255,66,276,90,276
7524,0.0,104.244.42.0-255,66,66,90,66
7525,0.0,74.125.24.0-255,298,298,90,146693
7526,4e-05,172.31.47.0-255,66,364,90,146693
7527,4.6e-05,74.125.24.0-255,1484,1848,90,146693
7528,5.1e-05,172.31.47.0-255,66,1914,90,146693
7529,5.6e-05,74.125.24.0-255,4320,6234,90,146693
7530,5.9e-05,172.31.47.0-255,66,6300,90,146693
7531,8.8e-05,74.125.24.0-255,4320,10620,90,146693
7532,9.1e-05,172.31.47.0-255,66,10686,90,146693
7533,0.000113,74.125.24.0-255,3392,14078,90,146693
7534,0.000115,172.31.47.0-255,66,14144,90,146693
7535,0.00026,74.125.24.0-255,1484,15628,90,146693
7536,0.000265,172.31.47.0-255,66,15694,90,146693
7537,0.000285,74.125.24.0-255,2902,18596,90,146693
7538,0.000289,172.31.47.0-255,66,18662,90,146693
7539,0.000294,74.125.24.0-255,5738,24400,90,146693
7540,0.000297,172.31.47.0-255,66,24466,90,146693
7541,0.000343,74.125.24.0-255,6797,31263,90,146693
7542,0.000346,172.31.47.0-255,66,31329,90,146693
7543,0.00055,74.125.24.0-255,1484,32813,90,146693
7544,0.000555,172.31.47.0-255,66,32879,90,146693
7545,0.000561,74.125.24.0-255,2902,35781,90,146693
7546,0.000563,172.31.47.0-255,66,35847,90,146693
7547,0.000567,74.125.24.0-255,1484,37331,90,146693
7548,0.000568,172.31.47.0-255,66,37397,90,146693
7549,0.000588,74.125.24.0-255,4320,41717,90,146693
7550,0.000591,172.31.47.0-255,66,41783,90,146693
7551,0.000598,74.125.24.0-255,6797,48580,90,146693
7552,0.0006,172.31.47.0-255,66,48646,90,146693
7553,0.000639,172.31.47.0-255,66,48712,90,146693
7554,0.000656,74.125.24.0-255,2902,51614,90,146693
7555,0.000659,172.31.47.0-255,66,51680,90,146693
7556,0.000663,74.125.24.0-255,2543,54223,90,146693
7557,0.000665,172.31.47.0-255,66,54289,90,146693
7558,0.001075,74.125.24.0-255,646,54935,90,146693
7559,0.001113,172.31.47.0-255,66,55001,90,146693
7560,0.001236,74.125.24.0-255,1484,56485,90,146693
7561,0.001242,74.125.24.0-255,1484,57969,90,146693
7562,0.001245,172.31.47.0-255,66,58035,90,146693
7563,0.001266,74.125.24.0-255,1484,59519,90,146693
7564,0.001272,74.125.24.0-255,5738,65257,90,146693
7565,0.001274,172.31.47.0-255,66,65323,90,146693
7566,0.001278,74.125.24.0-255,2902,68225,90,146693
7567,0.00128,172.31.47.0-255,66,68291,90,146693
7568,0.001302,74.125.24.0-255,9992,78283,90,146693
7569,0.001305,172.31.47.0-255,66,78349,90,146693
7570,0.001311,74.125.24.0-255,7156,85505,90,146693
7571,0.001313,172.31.47.0-255,66,85571,90,146693
7572,0.00135,74.125.24.0-255,3602,89173,90,146693
7573,0.001353,172.31.47.0-255,66,89239,90,146693
7574,0.001509,74.125.24.0-255,1484,90723,90,146693
7575,0.001531,74.125.24.0-255,2902,93625,90,146693
7576,0.001535,172.31.47.0-255,66,93691,90,146693
7577,0.001541,74.125.24.0-255,5738,99429,90,146693
7578,0.001543,172.31.47.0-255,66,99495,90,146693
7579,0.001548,74.125.24.0-255,5738,105233,90,146693
7580,0.00155,172.31.47.0-255,66,105299,90,146693
7581,0.00158,74.125.24.0-255,5738,111037,90,146693
7582,0.001583,172.31.47.0-255,66,111103,90,146693
7583,0.001604,74.125.24.0-255,7156,118259,90,146693
7584,0.001608,74.125.24.0-255,5020,123279,90,146693
7585,0.001639,172.31.47.0-255,66,123345,90,146693
7586,0.001646,172.31.47.0-255,66,123411,90,146693
7587,0.003655,74.125.24.0-255,5738,129149,90,146693
7588,0.00366,172.31.47.0-255,66,129215,90,146693
7589,0.005678,74.125.24.0-255,5738,134953,90,146693
7590,0.005682,172.31.47.0-255,66,135019,90,146693
7591,0.00771,74.125.24.0-255,5738,140757,90,146693
7592,0.007717,172.31.47.0-255,66,140823,90,146693
7593,0.009715,74.125.24.0-255,4320,145143,90,146693
7594,0.009722,172.31.47.0-255,66,145209,90,146693
7595,0.009744,74.125.24.0-255,1484,146693,90,146693
7596,0.0,172.31.47.0-255,105,105,90,459
7597,0.000117,172.31.47.0-255,90,195,90,459
7598,0.000126,172.31.47.0-255,66,261,90,459
7599,0.002723,172.217.194.0-255,66,327,90,459
7600,0.002739,172.217.194.0-255,66,393,90,459
7601,0.00275,172.31.47.0-255,66,459,90,459
7602,0.0,172.217.194.0-255,153,153,90,199141
7603,2.6e-05,172.31.47.0-255,66,219,90,199141
7604,3.2e-05,172.217.194.0-255,1484,1703,90,199141
7605,3.6e-05,172.31.47.0-255,66,1769,90,199141
7606,4e-05,172.217.194.0-255,2902,4671,90,199141
7607,4.3e-05,172.31.47.0-255,66,4737,90,199141
7608,4.9e-05,172.217.194.0-255,7156,11893,90,199141
7609,5.1e-05,172.31.47.0-255,66,11959,90,199141
7610,5.4e-05,172.217.194.0-255,2171,14130,90,199141
7611,5.6e-05,172.31.47.0-255,66,14196,90,199141
7612,0.000406,172.217.194.0-255,1484,15680,90,199141
7613,0.00041,172.31.47.0-255,66,15746,90,199141
7614,0.000418,172.217.194.0-255,2902,18648,90,199141
7615,0.00042,172.31.47.0-255,66,18714,90,199141
7616,0.000425,172.217.194.0-255,2902,21616,90,199141
7617,0.000426,172.31.47.0-255,66,21682,90,199141
7618,0.000446,172.217.194.0-255,2902,24584,90,199141
7619,0.000449,172.31.47.0-255,66,24650,90,199141
7620,0.000466,172.217.194.0-255,4320,28970,90,199141
7621,0.000469,172.31.47.0-255,66,29036,90,199141
7622,0.000495,172.217.194.0-255,8215,37251,90,199141
7623,0.000499,172.31.47.0-255,66,37317,90,199141
7624,0.000512,172.31.47.0-255,66,37383,90,199141
7625,0.00052,172.217.194.0-255,8574,45957,90,199141
7626,0.000523,172.31.47.0-255,66,46023,90,199141
7627,0.000559,172.217.194.0-255,5738,51761,90,199141
7628,0.000562,172.31.47.0-255,66,51827,90,199141
7629,0.000576,172.217.194.0-255,1378,53205,90,199141
7630,0.000579,172.31.47.0-255,66,53271,90,199141
7631,0.00063,172.217.194.0-255,1484,54755,90,199141
7632,0.000632,172.31.47.0-255,66,54821,90,199141
7633,0.000637,172.217.194.0-255,2902,57723,90,199141
7634,0.000649,172.217.194.0-255,1484,59207,90,199141
7635,0.000669,172.217.194.0-255,4320,63527,90,199141
7636,0.000675,172.217.194.0-255,5738,69265,90,199141
7637,0.000689,172.217.194.0-255,1484,70749,90,199141
7638,0.000694,172.217.194.0-255,4320,75069,90,199141
7639,0.000724,172.217.194.0-255,9992,85061,90,199141
7640,0.000729,172.217.194.0-255,2184,87245,90,199141
7641,0.001209,172.217.194.0-255,1484,88729,90,199141
7642,0.001216,172.217.194.0-255,2902,91631,90,199141
7643,0.001229,172.217.194.0-255,5738,97369,90,199141
7644,0.001281,172.217.194.0-255,10692,108061,90,199141
7645,0.001546,172.217.194.0-255,1484,109545,90,199141
7646,0.001554,172.217.194.0-255,1484,111029,90,199141
7647,0.001568,172.217.194.0-255,1484,112513,90,199141
7648,0.001578,172.217.194.0-255,2902,115415,90,199141
7649,0.001597,172.217.194.0-255,1484,116899,90,199141
7650,0.001617,172.217.194.0-255,5738,122637,90,199141
7651,0.001642,172.217.194.0-255,9992,132629,90,199141
7652,0.001664,172.217.194.0-255,2902,135531,90,199141
7653,0.001686,172.217.194.0-255,7856,143387,90,199141
7654,0.001688,172.217.194.0-255,1484,144871,90,199141
7655,0.001705,172.217.194.0-255,4320,149191,90,199141
7656,0.001726,172.217.194.0-255,4320,153511,90,199141
7657,0.001767,172.217.194.0-255,1484,154995,90,199141
7658,0.001774,172.217.194.0-255,7856,162851,90,199141
7659,0.001837,172.217.194.0-255,4320,167171,90,199141
7660,0.001859,172.217.194.0-255,1484,168655,90,199141
7661,0.001874,172.217.194.0-255,2184,170839,90,199141
7662,0.001902,172.217.194.0-255,5738,176577,90,199141
7663,0.001946,172.217.194.0-255,1484,178061,90,199141
7664,0.001974,172.217.194.0-255,2184,180245,90,199141
7665,0.001998,172.217.194.0-255,1484,181729,90,199141
7666,0.002849,172.31.47.0-255,66,181795,90,199141
7667,0.004842,172.217.194.0-255,5738,187533,90,199141
7668,0.004848,172.31.47.0-255,66,187599,90,199141
7669,0.006811,172.217.194.0-255,5738,193337,90,199141
7670,0.00682,172.31.47.0-255,66,193403,90,199141
7671,0.008825,172.217.194.0-255,5738,199141,90,199141
7672,0.0,172.31.47.0-255,105,105,90,105
7673,0.0,74.125.24.0-255,143,143,90,252716
7674,2.9e-05,172.31.47.0-255,66,209,90,252716
7675,3.5e-05,74.125.24.0-255,1484,1693,90,252716
7676,3.9e-05,172.31.47.0-255,66,1759,90,252716
7677,4.4e-05,74.125.24.0-255,2902,4661,90,252716
7678,4.7e-05,172.31.47.0-255,66,4727,90,252716
7679,6.2e-05,74.125.24.0-255,7156,11883,90,252716
7680,6.5e-05,172.31.47.0-255,66,11949,90,252716
7681,6.9e-05,74.125.24.0-255,3472,15421,90,252716
7682,7.2e-05,172.31.47.0-255,66,15487,90,252716
7683,0.000125,172.31.47.0-255,66,15553,90,252716
7684,0.000129,74.125.24.0-255,2543,18096,90,252716
7685,0.000132,172.31.47.0-255,66,18162,90,252716
7686,0.000189,74.125.24.0-255,1484,19646,90,252716
7687,0.000192,172.31.47.0-255,66,19712,90,252716
7688,0.000197,74.125.24.0-255,2902,22614,90,252716
7689,0.0002,172.31.47.0-255,66,22680,90,252716
7690,0.000234,74.125.24.0-255,5738,28418,90,252716
7691,0.000237,172.31.47.0-255,66,28484,90,252716
7692,0.000241,74.125.24.0-255,2902,31386,90,252716
7693,0.000243,172.31.47.0-255,66,31452,90,252716
7694,0.000287,172.31.47.0-255,66,31518,90,252716
7695,0.000295,74.125.24.0-255,8574,40092,90,252716
7696,0.000297,172.31.47.0-255,66,40158,90,252716
7697,0.000317,74.125.24.0-255,1479,41637,90,252716
7698,0.000319,172.31.47.0-255,66,41703,90,252716
7699,0.000341,74.125.24.0-255,332,42035,90,252716
7700,0.000344,172.31.47.0-255,66,42101,90,252716
7701,0.000552,74.125.24.0-255,1484,43585,90,252716
7702,0.000555,172.31.47.0-255,66,43651,90,252716
7703,0.000559,74.125.24.0-255,1484,45135,90,252716
7704,0.00058,74.125.24.0-255,1484,46619,90,252716
7705,0.000582,172.31.47.0-255,66,46685,90,252716
7706,0.000589,74.125.24.0-255,5738,52423,90,252716
7707,0.000591,172.31.47.0-255,66,52489,90,252716
7708,0.000616,74.125.24.0-255,2902,55391,90,252716
7709,0.000619,172.31.47.0-255,66,55457,90,252716
7710,0.000649,74.125.24.0-255,9992,65449,90,252716
7711,0.000652,172.31.47.0-255,66,65515,90,252716
7712,0.000677,74.125.24.0-255,2902,68417,90,252716
7713,0.00068,172.31.47.0-255,66,68483,90,252716
7714,0.000708,74.125.24.0-255,7856,76339,90,252716
7715,0.000711,172.31.47.0-255,66,76405,90,252716
7716,0.000811,74.125.24.0-255,1484,77889,90,252716
7717,0.000815,74.125.24.0-255,2902,80791,90,252716
7718,0.000818,172.31.47.0-255,66,80857,90,252716
7719,0.000847,74.125.24.0-255,5738,86595,90,252716
7720,0.00085,172.31.47.0-255,66,86661,90,252716
7721,0.000888,74.125.24.0-255,8574,95235,90,252716
7722,0.000891,172.31.47.0-255,66,95301,90,252716
7723,0.000916,74.125.24.0-255,4320,99621,90,252716
7724,0.00092,172.31.47.0-255,66,99687,90,252716
7725,0.000923,74.125.24.0-255,9992,109679,90,252716
7726,0.000925,172.31.47.0-255,66,109745,90,252716
7727,0.000927,74.125.24.0-255,766,110511,90,252716
7728,0.001068,74.125.24.0-255,1484,111995,90,252716
7729,0.001071,172.31.47.0-255,66,112061,90,252716
7730,0.001076,74.125.24.0-255,2902,114963,90,252716
7731,0.00108,172.31.47.0-255,66,115029,90,252716
7732,0.00111,74.125.24.0-255,5738,120767,90,252716
7733,0.001113,172.31.47.0-255,66,120833,90,252716
7734,0.001124,172.31.47.0-255,66,120899,90,252716
7735,0.001129,74.125.24.0-255,4320,125219,90,252716
7736,0.00113,172.31.47.0-255,66,125285,90,252716
7737,0.001157,74.125.24.0-255,4320,129605,90,252716
7738,0.00116,172.31.47.0-255,66,129671,90,252716
7739,0.001163,74.125.24.0-255,2184,131855,90,252716
7740,0.00117,172.31.47.0-255,66,131921,90,252716
7741,0.001174,74.125.24.0-255,2902,134823,90,252716
7742,0.001176,172.31.47.0-255,66,134889,90,252716
7743,0.001186,74.125.24.0-255,1484,136373,90,252716
7744,0.001214,74.125.24.0-255,5738,142111,90,252716
7745,0.001217,172.31.47.0-255,66,142177,90,252716
7746,0.001222,74.125.24.0-255,4320,146497,90,252716
7747,0.001225,172.31.47.0-255,66,146563,90,252716
7748,0.001262,172.31.47.0-255,66,146629,90,252716
7749,0.001287,74.125.24.0-255,7856,154485,90,252716
7750,0.00129,172.31.47.0-255,66,154551,90,252716
7751,0.001413,74.125.24.0-255,1484,156035,90,252716
7752,0.001435,74.125.24.0-255,2902,158937,90,252716
7753,0.001439,172.31.47.0-255,66,159003,90,252716
7754,0.001444,74.125.24.0-255,5738,164741,90,252716
7755,0.001446,172.31.47.0-255,66,164807,90,252716
7756,0.001449,74.125.24.0-255,1484,166291,90,252716
7757,0.001492,172.31.47.0-255,66,166357,90,252716
7758,0.001501,74.125.24.0-255,10692,177049,90,252716
7759,0.001508,172.31.47.0-255,66,177115,90,252716
7760,0.001548,74.125.24.0-255,1484,178599,90,252716
7761,0.00156,74.125.24.0-255,2902,181501,90,252716
7762,0.001564,172.31.47.0-255,66,181567,90,252716
7763,0.001591,74.125.24.0-255,5738,187305,90,252716
7764,0.001594,172.31.47.0-255,66,187371,90,252716
7765,0.001617,172.31.47.0-255,66,187437,90,252716
7766,0.001621,74.125.24.0-255,2902,190339,90,252716
7767,0.001624,172.31.47.0-255,66,190405,90,252716
7768,0.001651,74.125.24.0-255,7856,198261,90,252716
7769,0.001655,172.31.47.0-255,66,198327,90,252716
7770,0.001751,74.125.24.0-255,1484,199811,90,252716
7771,0.001771,74.125.24.0-255,2902,202713,90,252716
7772,0.001775,172.31.47.0-255,66,202779,90,252716
7773,0.00178,74.125.24.0-255,5738,208517,90,252716
7774,0.001782,172.31.47.0-255,66,208583,90,252716
7775,0.001816,172.31.47.0-255,66,208649,90,252716
7776,0.001827,74.125.24.0-255,1484,210133,90,252716
7777,0.001867,74.125.24.0-255,8574,218707,90,252716
7778,0.001871,172.31.47.0-255,66,218773,90,252716
7779,0.00189,74.125.24.0-255,2184,220957,90,252716
7780,0.001892,172.31.47.0-255,66,221023,90,252716
7781,0.001895,74.125.24.0-255,1484,222507,90,252716
7782,0.001898,74.125.24.0-255,2902,225409,90,252716
7783,0.001902,172.31.47.0-255,66,225475,90,252716
7784,0.001907,74.125.24.0-255,5738,231213,90,252716
7785,0.001911,172.31.47.0-255,66,231279,90,252716
7786,0.00195,172.31.47.0-255,66,231345,90,252716
7787,0.001974,74.125.24.0-255,1484,232829,90,252716
7788,0.00201,172.31.47.0-255,66,232895,90,252716
7789,0.002015,74.125.24.0-255,5738,238633,90,252716
7790,0.002018,172.31.47.0-255,66,238699,90,252716
7791,0.002051,74.125.24.0-255,4320,243019,90,252716
7792,0.002054,172.31.47.0-255,66,243085,90,252716
7793,0.002094,172.31.47.0-255,66,243151,90,252716
7794,0.002112,172.31.47.0-255,66,243217,90,252716
7795,0.002118,74.125.24.0-255,6438,249655,90,252716
7796,0.00212,172.31.47.0-255,66,249721,90,252716
7797,0.002148,74.125.24.0-255,2653,252374,90,252716
7798,0.002156,172.31.47.0-255,66,252440,90,252716
7799,0.002159,74.125.24.0-255,105,252545,90,252716
7800,0.007543,172.31.47.0-255,66,252611,90,252716
7801,0.007565,172.31.47.0-255,105,252716,90,252716
7802,0.0,172.31.47.0-255,105,105,90,276
7803,0.001487,157.240.13.0-255,105,210,90,276
7804,0.001501,172.31.47.0-255,66,276,90,276
7805,0.0,172.217.24.0-255,154,154,90,194511
7806,3e-05,172.31.47.0-255,66,220,90,194511
7807,3.7e-05,172.217.24.0-255,1484,1704,90,194511
7808,4.1e-05,172.31.47.0-255,66,1770,90,194511
7809,4.6e-05,172.217.24.0-255,2902,4672,90,194511
7810,4.8e-05,172.31.47.0-255,66,4738,90,194511
7811,5.4e-05,172.217.24.0-255,4320,9058,90,194511
7812,5.6e-05,172.31.47.0-255,66,9124,90,194511
7813,5.9e-05,172.217.24.0-255,1484,10608,90,194511
7814,6.1e-05,172.31.47.0-255,66,10674,90,194511
7815,9.7e-05,172.217.24.0-255,7928,18602,90,194511
7816,0.000101,172.31.47.0-255,66,18668,90,194511
7817,0.000109,172.217.24.0-255,9992,28660,90,194511
7818,0.000111,172.31.47.0-255,66,28726,90,194511
7819,0.000137,172.217.24.0-255,2543,31269,90,194511
7820,0.000139,172.31.47.0-255,66,31335,90,194511
7821,0.000157,172.217.24.0-255,2902,34237,90,194511
7822,0.000159,172.31.47.0-255,66,34303,90,194511
7823,0.000187,172.217.24.0-255,7156,41459,90,194511
7824,0.00019,172.31.47.0-255,66,41525,90,194511
7825,0.000196,172.217.24.0-255,5738,47263,90,194511
7826,0.000198,172.31.47.0-255,66,47329,90,194511
7827,0.000224,172.217.24.0-255,1125,48454,90,194511
7828,0.000227,172.31.47.0-255,66,48520,90,194511
7829,0.00072,172.217.24.0-255,1484,50004,90,194511
7830,0.000726,172.31.47.0-255,66,50070,90,194511
7831,0.000737,172.217.24.0-255,2902,52972,90,194511
7832,0.000739,172.31.47.0-255,66,53038,90,194511
7833,0.000743,172.217.24.0-255,2902,55940,90,194511
7834,0.000745,172.31.47.0-255,66,56006,90,194511
7835,0.000751,172.217.24.0-255,4320,60326,90,194511
7836,0.000753,172.31.47.0-255,66,60392,90,194511
7837,0.000792,172.217.24.0-255,5669,66061,90,194511
7838,0.000815,172.31.47.0-255,66,66127,90,194511
7839,0.001008,172.217.24.0-255,1484,67611,90,194511
7840,0.001014,172.217.24.0-255,2902,70513,90,194511
7841,0.001019,172.31.47.0-255,66,70579,90,194511
7842,0.001027,172.217.24.0-255,5738,76317,90,194511
7843,0.001044,172.31.47.0-255,66,76383,90,194511
7844,0.001059,172.217.24.0-255,6797,83180,90,194511
7845,0.001066,172.217.24.0-255,7156,90336,90,194511
7846,0.00107,172.31.47.0-255,66,90402,90,194511
7847,0.001094,172.217.24.0-255,4320,94722,90,194511
7848,0.00111,172.217.24.0-255,5120,99842,90,194511
7849,0.001126,172.217.24.0-255,5738,105580,90,194511
7850,0.001139,172.31.47.0-255,66,105646,90,194511
7851,0.001155,172.217.24.0-255,4320,109966,90,194511
7852,0.001162,172.217.24.0-255,6683,116649,90,194511
7853,0.001189,172.31.47.0-255,66,116715,90,194511
7854,0.001595,172.217.24.0-255,1484,118199,90,194511
7855,0.001603,172.217.24.0-255,2902,121101,90,194511
7856,0.001607,172.31.47.0-255,66,121167,90,194511
7857,0.001614,172.217.24.0-255,5738,126905,90,194511
7858,0.001638,172.31.47.0-255,66,126971,90,194511
7859,0.001647,172.217.24.0-255,2902,129873,90,194511
7860,0.001651,172.31.47.0-255,66,129939,90,194511
7861,0.001665,172.217.24.0-255,4084,134023,90,194511
7862,0.001691,172.217.24.0-255,2902,136925,90,194511
7863,0.001694,172.217.24.0-255,1484,138409,90,194511
7864,0.001701,172.31.47.0-255,66,138475,90,194511
7865,0.001711,172.217.24.0-255,2902,141377,90,194511
7866,0.001715,172.217.24.0-255,2902,144279,90,194511
7867,0.001731,172.217.24.0-255,5738,150017,90,194511
7868,0.001764,172.31.47.0-255,66,150083,90,194511
7869,0.001805,172.31.47.0-255,66,150149,90,194511
7870,0.001838,172.217.24.0-255,1484,151633,90,194511
7871,0.001841,172.217.24.0-255,1484,153117,90,194511
7872,0.00185,172.217.24.0-255,1484,154601,90,194511
7873,0.001853,172.217.24.0-255,1484,156085,90,194511
7874,0.001872,172.217.24.0-255,4320,160405,90,194511
7875,0.001876,172.31.47.0-255,66,160471,90,194511
7876,0.001881,172.31.47.0-255,66,160537,90,194511
7877,0.001914,172.217.24.0-255,10692,171229,90,194511
7878,0.001918,172.31.47.0-255,66,171295,90,194511
7879,0.003839,172.217.24.0-255,5738,177033,90,194511
7880,0.003844,172.31.47.0-255,66,177099,90,194511
7881,0.005772,172.217.24.0-255,5738,182837,90,194511
7882,0.005777,172.31.47.0-255,66,182903,90,194511
7883,0.007713,172.217.24.0-255,5738,188641,90,194511
7884,0.007719,172.31.47.0-255,66,188707,90,194511
7885,0.00965,172.217.24.0-255,5738,194445,90,194511
7886,0.009657,172.31.47.0-255,66,194511,90,194511
7887,0.0,74.125.24.0-255,153,153,90,105353
7888,2.5e-05,172.31.47.0-255,66,219,90,105353
7889,3.1e-05,74.125.24.0-255,1484,1703,90,105353
7890,3.4e-05,172.31.47.0-255,66,1769,90,105353
7891,5.4e-05,74.125.24.0-255,1484,3253,90,105353
7892,5.6e-05,172.31.47.0-255,66,3319,90,105353
7893,5.9e-05,74.125.24.0-255,1484,4803,90,105353
7894,6.1e-05,172.31.47.0-255,66,4869,90,105353
7895,8e-05,74.125.24.0-255,1484,6353,90,105353
7896,8.1e-05,172.31.47.0-255,66,6419,90,105353
7897,8.7e-05,74.125.24.0-255,5738,12157,90,105353
7898,8.9e-05,172.31.47.0-255,66,12223,90,105353
7899,0.000112,74.125.24.0-255,2046,14269,90,105353
7900,0.000114,172.31.47.0-255,66,14335,90,105353
7901,0.000147,74.125.24.0-255,1484,15819,90,105353
7902,0.000149,172.31.47.0-255,66,15885,90,105353
7903,0.000153,74.125.24.0-255,2902,18787,90,105353
7904,0.000155,172.31.47.0-255,66,18853,90,105353
7905,0.000169,74.125.24.0-255,4320,23173,90,105353
7906,0.000172,172.31.47.0-255,66,23239,90,105353
7907,0.00019,74.125.24.0-255,1484,24723,90,105353
7908,0.000192,172.31.47.0-255,66,24789,90,105353
7909,0.000226,74.125.24.0-255,8215,33004,90,105353
7910,0.00023,172.31.47.0-255,66,33070,90,105353
7911,0.000237,74.125.24.0-255,8574,41644,90,105353
7912,0.000239,172.31.47.0-255,66,41710,90,105353
7913,0.00026,74.125.24.0-255,6797,48507,90,105353
7914,0.000263,172.31.47.0-255,66,48573,90,105353
7915,0.000277,74.125.24.0-255,4320,52893,90,105353
7916,0.000279,172.31.47.0-255,66,52959,90,105353
7917,0.000291,74.125.24.0-255,2902,55861,90,105353
7918,0.000293,172.31.47.0-255,66,55927,90,105353
7919,0.000334,74.125.24.0-255,9633,65560,90,105353
7920,0.000338,172.31.47.0-255,66,65626,90,105353
7921,0.00034,74.125.24.0-255,396,66022,90,105353
7922,0.000379,74.125.24.0-255,112,66134,90,105353
7923,0.000638,74.125.24.0-255,331,66465,90,105353
7924,0.000641,172.31.47.0-255,66,66531,90,105353
7925,0.000656,172.31.47.0-255,66,66597,90,105353
7926,0.000998,74.125.24.0-255,1484,68081,90,105353
7927,0.001007,74.125.24.0-255,2902,70983,90,105353
7928,0.001011,172.31.47.0-255,66,71049,90,105353
7929,0.00104,74.125.24.0-255,5738,76787,90,105353
7930,0.001044,172.31.47.0-255,66,76853,90,105353
7931,0.001047,74.125.24.0-255,1484,78337,90,105353
7932,0.001062,74.125.24.0-255,1484,79821,90,105353
7933,0.001064,172.31.47.0-255,66,79887,90,105353
7934,0.001086,172.31.47.0-255,66,79953,90,105353
7935,0.001095,74.125.24.0-255,9274,89227,90,105353
7936,0.001097,172.31.47.0-255,66,89293,90,105353
7937,0.003441,74.125.24.0-255,4320,93613,90,105353
7938,0.003446,172.31.47.0-255,66,93679,90,105353
7939,0.003464,74.125.24.0-255,1484,95163,90,105353
7940,0.005766,74.125.24.0-255,4320,99483,90,105353
7941,0.005772,172.31.47.0-255,66,99549,90,105353
7942,0.008262,74.125.24.0-255,5738,105287,90,105353
7943,0.008321,172.31.47.0-255,66,105353,90,105353
7944,0.0,172.31.47.0-255,74,74,90,74
7945,0.0,172.31.47.0-255,105,105,90,276
7946,0.001489,157.240.7.0-255,105,210,90,276
7947,0.001499,172.31.47.0-255,66,276,90,276
7948,0.0,172.217.194.0-255,143,143,90,218446
7949,2.4e-05,172.31.47.0-255,66,209,90,218446
7950,3.2e-05,172.217.194.0-255,1484,1693,90,218446
7951,3.7e-05,172.31.47.0-255,66,1759,90,218446
7952,4.2e-05,172.217.194.0-255,2902,4661,90,218446
7953,5.4e-05,172.31.47.0-255,66,4727,90,218446
7954,6.2e-05,172.217.194.0-255,7156,11883,90,218446
7955,6.6e-05,172.31.47.0-255,66,11949,90,218446
7956,7e-05,172.217.194.0-255,2130,14079,90,218446
7957,7.3e-05,172.31.47.0-255,66,14145,90,218446
7958,0.000141,172.217.194.0-255,7156,21301,90,218446
7959,0.000146,172.31.47.0-255,66,21367,90,218446
7960,0.000155,172.217.194.0-255,8574,29941,90,218446
7961,0.000158,172.31.47.0-255,66,30007,90,218446
7962,0.000171,172.31.47.0-255,66,30073,90,218446
7963,0.000203,172.217.194.0-255,8215,38288,90,218446
7964,0.000207,172.31.47.0-255,66,38354,90,218446
7965,0.000215,172.217.194.0-255,8574,46928,90,218446
7966,0.000217,172.31.47.0-255,66,46994,90,218446
7967,0.000261,172.217.194.0-255,7106,54100,90,218446
7968,0.000264,172.31.47.0-255,66,54166,90,218446
7969,0.000267,172.217.194.0-255,99,54265,90,218446
7970,0.000269,172.31.47.0-255,66,54331,90,218446
7971,0.000291,172.217.194.0-255,368,54699,90,218446
7972,0.000298,172.31.47.0-255,66,54765,90,218446
7973,0.000448,172.217.194.0-255,1484,56249,90,218446
7974,0.000452,172.31.47.0-255,66,56315,90,218446
7975,0.000458,172.217.194.0-255,2902,59217,90,218446
7976,0.000461,172.31.47.0-255,66,59283,90,218446
7977,0.000472,172.217.194.0-255,5738,65021,90,218446
7978,0.000474,172.31.47.0-255,66,65087,90,218446
7979,0.000517,172.31.47.0-255,66,65153,90,218446
7980,0.000526,172.217.194.0-255,9992,75145,90,218446
7981,0.000528,172.31.47.0-255,66,75211,90,218446
7982,0.000531,172.217.194.0-255,215,75426,90,218446
7983,0.000873,172.217.194.0-255,1484,76910,90,218446
7984,0.000878,172.31.47.0-255,66,76976,90,218446
7985,0.000885,172.217.194.0-255,2902,79878,90,218446
7986,0.000887,172.31.47.0-255,66,79944,90,218446
7987,0.000893,172.217.194.0-255,5738,85682,90,218446
7988,0.000899,172.31.47.0-255,66,85748,90,218446
7989,0.000955,172.31.47.0-255,66,85814,90,218446
7990,0.000958,172.217.194.0-255,1484,87298,90,218446
7991,0.000993,172.217.194.0-255,9274,96572,90,218446
7992,0.000997,172.31.47.0-255,66,96638,90,218446
7993,0.001231,172.217.194.0-255,1484,98122,90,218446
7994,0.001237,172.217.194.0-255,2902,101024,90,218446
7995,0.00124,172.31.47.0-255,66,101090,90,218446
7996,0.001248,172.217.194.0-255,5738,106828,90,218446
7997,0.00125,172.31.47.0-255,66,106894,90,218446
7998,0.001285,172.31.47.0-255,66,106960,90,218446
7999,0.001321,172.217.194.0-255,5738,112698,90,218446
8000,0.001324,172.31.47.0-255,66,112764,90,218446
8001,0.001351,172.217.194.0-255,6438,119202,90,218446
8002,0.001354,172.31.47.0-255,66,119268,90,218446
8003,0.001424,172.217.194.0-255,1484,120752,90,218446
8004,0.001428,172.217.194.0-255,2902,123654,90,218446
8005,0.001433,172.31.47.0-255,66,123720,90,218446
8006,0.001462,172.217.194.0-255,5738,129458,90,218446
8007,0.001466,172.31.47.0-255,66,129524,90,218446
8008,0.001479,172.31.47.0-255,66,129590,90,218446
8009,0.001492,172.217.194.0-255,9992,139582,90,218446
8010,0.001494,172.31.47.0-255,66,139648,90,218446
8011,0.001585,172.31.47.0-255,66,139714,90,218446
8012,0.001599,172.31.47.0-255,66,139780,90,218446
8013,0.001769,172.217.194.0-255,1484,141264,90,218446
8014,0.001775,172.217.194.0-255,2902,144166,90,218446
8015,0.001778,172.31.47.0-255,66,144232,90,218446
8016,0.001781,172.217.194.0-255,1484,145716,90,218446
8017,0.00181,172.217.194.0-255,4320,150036,90,218446
8018,0.001813,172.31.47.0-255,66,150102,90,218446
8019,0.001832,172.217.194.0-255,9992,160094,90,218446
8020,0.001835,172.31.47.0-255,66,160160,90,218446
8021,0.001852,172.217.194.0-255,2902,163062,90,218446
8022,0.001859,172.31.47.0-255,66,163128,90,218446
8023,0.001869,172.217.194.0-255,10692,173820,90,218446
8024,0.001872,172.31.47.0-255,66,173886,90,218446
8025,0.001901,172.217.194.0-255,7156,181042,90,218446
8026,0.001904,172.31.47.0-255,66,181108,90,218446
8027,0.001911,172.217.194.0-255,5738,186846,90,218446
8028,0.001913,172.31.47.0-255,66,186912,90,218446
8029,0.001933,172.217.194.0-255,2902,189814,90,218446
8030,0.001936,172.31.47.0-255,66,189880,90,218446
8031,0.001955,172.31.47.0-255,66,189946,90,218446
8032,0.001981,172.217.194.0-255,5738,195684,90,218446
8033,0.001984,172.31.47.0-255,66,195750,90,218446
8034,0.001991,172.217.194.0-255,766,196516,90,218446
8035,0.003571,172.31.47.0-255,66,196582,90,218446
8036,0.003967,172.217.194.0-255,4320,200902,90,218446
8037,0.003974,172.31.47.0-255,66,200968,90,218446
8038,0.005529,172.217.194.0-255,1484,202452,90,218446
8039,0.005947,172.217.194.0-255,4320,206772,90,218446
8040,0.005952,172.31.47.0-255,66,206838,90,218446
8041,0.007935,172.217.194.0-255,5738,212576,90,218446
8042,0.00794,172.31.47.0-255,66,212642,90,218446
8043,0.009945,172.217.194.0-255,5738,218380,90,218446
8044,0.009951,172.31.47.0-255,66,218446,90,218446
8045,0.0,172.217.194.0-255,145,145,90,283980
8046,2.2e-05,172.31.47.0-255,66,211,90,283980
8047,2.8e-05,172.217.194.0-255,1484,1695,90,283980
8048,3.2e-05,172.31.47.0-255,66,1761,90,283980
8049,6.3e-05,172.217.194.0-255,2902,4663,90,283980
8050,6.5e-05,172.31.47.0-255,66,4729,90,283980
8051,7.1e-05,172.217.194.0-255,7156,11885,90,283980
8052,7.5e-05,172.31.47.0-255,66,11951,90,283980
8053,0.000115,172.217.194.0-255,2172,14123,90,283980
8054,0.000118,172.31.47.0-255,66,14189,90,283980
8055,0.000142,172.217.194.0-255,2902,17091,90,283980
8056,0.000144,172.31.47.0-255,66,17157,90,283980
8057,0.000173,172.217.194.0-255,7156,24313,90,283980
8058,0.000175,172.31.47.0-255,66,24379,90,283980
8059,0.000178,172.217.194.0-255,1484,25863,90,283980
8060,0.000179,172.31.47.0-255,66,25929,90,283980
8061,0.000229,172.31.47.0-255,66,25995,90,283980
8062,0.000235,172.217.194.0-255,6797,32792,90,283980
8063,0.000237,172.31.47.0-255,66,32858,90,283980
8064,0.000267,172.217.194.0-255,4320,37178,90,283980
8065,0.00027,172.31.47.0-255,66,37244,90,283980
8066,0.000297,172.31.47.0-255,66,37310,90,283980
8067,0.000319,172.217.194.0-255,1737,39047,90,283980
8068,0.000321,172.31.47.0-255,66,39113,90,283980
8069,0.000534,172.217.194.0-255,1484,40597,90,283980
8070,0.000538,172.31.47.0-255,66,40663,90,283980
8071,0.000542,172.217.194.0-255,2902,43565,90,283980
8072,0.000543,172.31.47.0-255,66,43631,90,283980
8073,0.000563,172.217.194.0-255,5738,49369,90,283980
8074,0.000566,172.31.47.0-255,66,49435,90,283980
8075,0.000577,172.217.194.0-255,7156,56591,90,283980
8076,0.00058,172.31.47.0-255,66,56657,90,283980
8077,0.000604,172.217.194.0-255,5738,62395,90,283980
8078,0.000607,172.31.47.0-255,66,62461,90,283980
8079,0.00061,172.217.194.0-255,1484,63945,90,283980
8080,0.000641,172.217.194.0-255,5738,69683,90,283980
8081,0.000644,172.31.47.0-255,66,69749,90,283980
8082,0.000662,172.217.194.0-255,3602,73351,90,283980
8083,0.000665,172.31.47.0-255,66,73417,90,283980
8084,0.000987,172.217.194.0-255,1484,74901,90,283980
8085,0.000995,172.217.194.0-255,2902,77803,90,283980
8086,0.000998,172.31.47.0-255,66,77869,90,283980
8087,0.001004,172.217.194.0-255,5738,83607,90,283980
8088,0.001006,172.31.47.0-255,66,83673,90,283980
8089,0.001031,172.217.194.0-255,5738,89411,90,283980
8090,0.001035,172.31.47.0-255,66,89477,90,283980
8091,0.00106,172.217.194.0-255,7156,96633,90,283980
8092,0.001063,172.31.47.0-255,66,96699,90,283980
8093,0.001072,172.217.194.0-255,10692,107391,90,283980
8094,0.001074,172.31.47.0-255,66,107457,90,283980
8095,0.001213,172.217.194.0-255,1484,108941,90,283980
8096,0.00122,172.217.194.0-255,2902,111843,90,283980
8097,0.001223,172.31.47.0-255,66,111909,90,283980
8098,0.001228,172.217.194.0-255,4320,116229,90,283980
8099,0.00123,172.31.47.0-255,66,116295,90,283980
8100,0.00125,172.217.194.0-255,1484,117779,90,283980
8101,0.001256,172.217.194.0-255,7156,124935,90,283980
8102,0.001258,172.31.47.0-255,66,125001,90,283980
8103,0.001289,172.217.194.0-255,4320,129321,90,283980
8104,0.001291,172.31.47.0-255,66,129387,90,283980
8105,0.001316,172.217.194.0-255,9992,139379,90,283980
8106,0.001319,172.31.47.0-255,66,139445,90,283980
8107,0.001323,172.217.194.0-255,2184,141629,90,283980
8108,0.001325,172.31.47.0-255,66,141695,90,283980
8109,0.001353,172.217.194.0-255,1484,143179,90,283980
8110,0.001364,172.217.194.0-255,1484,144663,90,283980
8111,0.001367,172.31.47.0-255,66,144729,90,283980
8112,0.00139,172.217.194.0-255,1484,146213,90,283980
8113,0.001396,172.217.194.0-255,5738,151951,90,283980
8114,0.001399,172.31.47.0-255,66,152017,90,283980
8115,0.001412,172.217.194.0-255,5738,157755,90,283980
8116,0.001421,172.31.47.0-255,66,157821,90,283980
8117,0.001425,172.217.194.0-255,4320,162141,90,283980
8118,0.001427,172.31.47.0-255,66,162207,90,283980
8119,0.001448,172.217.194.0-255,8574,170781,90,283980
8120,0.00145,172.31.47.0-255,66,170847,90,283980
8121,0.001459,172.217.194.0-255,5020,175867,90,283980
8122,0.001461,172.31.47.0-255,66,175933,90,283980
8123,0.001613,172.217.194.0-255,1484,177417,90,283980
8124,0.001618,172.217.194.0-255,2902,180319,90,283980
8125,0.00162,172.31.47.0-255,66,180385,90,283980
8126,0.001622,172.217.194.0-255,1484,181869,90,283980
8127,0.001643,172.217.194.0-255,4320,186189,90,283980
8128,0.001645,172.31.47.0-255,66,186255,90,283980
8129,0.001667,172.217.194.0-255,7156,193411,90,283980
8130,0.001669,172.31.47.0-255,66,193477,90,283980
8131,0.001671,172.217.194.0-255,1484,194961,90,283980
8132,0.00171,172.31.47.0-255,66,195027,90,283980
8133,0.001714,172.217.194.0-255,2184,197211,90,283980
8134,0.001715,172.31.47.0-255,66,197277,90,283980
8135,0.001874,172.217.194.0-255,1484,198761,90,283980
8136,0.001884,172.217.194.0-255,2902,201663,90,283980
8137,0.001886,172.31.47.0-255,66,201729,90,283980
8138,0.00189,172.217.194.0-255,4320,206049,90,283980
8139,0.001892,172.31.47.0-255,66,206115,90,283980
8140,0.001922,172.217.194.0-255,1484,207599,90,283980
8141,0.001927,172.217.194.0-255,5738,213337,90,283980
8142,0.001929,172.31.47.0-255,66,213403,90,283980
8143,0.001943,172.31.47.0-255,66,213469,90,283980
8144,0.001965,172.217.194.0-255,1484,214953,90,283980
8145,0.00197,172.217.194.0-255,5020,219973,90,283980
8146,0.001972,172.31.47.0-255,66,220039,90,283980
8147,0.002019,172.217.194.0-255,1484,221523,90,283980
8148,0.002035,172.217.194.0-255,2902,224425,90,283980
8149,0.002038,172.31.47.0-255,66,224491,90,283980
8150,0.002042,172.217.194.0-255,4320,228811,90,283980
8151,0.002044,172.31.47.0-255,66,228877,90,283980
8152,0.002068,172.217.194.0-255,1484,230361,90,283980
8153,0.002073,172.217.194.0-255,4320,234681,90,283980
8154,0.002075,172.31.47.0-255,66,234747,90,283980
8155,0.002079,172.217.194.0-255,5738,240485,90,283980
8156,0.002081,172.31.47.0-255,66,240551,90,283980
8157,0.002088,172.217.194.0-255,8574,249125,90,283980
8158,0.002094,172.31.47.0-255,66,249191,90,283980
8159,0.002119,172.217.194.0-255,2902,252093,90,283980
8160,0.002121,172.31.47.0-255,66,252159,90,283980
8161,0.002124,172.217.194.0-255,2184,254343,90,283980
8162,0.002126,172.31.47.0-255,66,254409,90,283980
8163,0.002185,172.217.194.0-255,1484,255893,90,283980
8164,0.002199,172.217.194.0-255,2902,258795,90,283980
8165,0.002201,172.31.47.0-255,66,258861,90,283980
8166,0.002204,172.217.194.0-255,2902,261763,90,283980
8167,0.002206,172.31.47.0-255,66,261829,90,283980
8168,0.002225,172.217.194.0-255,2902,264731,90,283980
8169,0.002226,172.31.47.0-255,66,264797,90,283980
8170,0.002229,172.217.194.0-255,1484,266281,90,283980
8171,0.00226,172.31.47.0-255,66,266347,90,283980
8172,0.002285,172.217.194.0-255,8574,274921,90,283980
8173,0.002287,172.31.47.0-255,66,274987,90,283980
8174,0.002315,172.217.194.0-255,3602,278589,90,283980
8175,0.002316,172.31.47.0-255,66,278655,90,283980
8176,0.002327,172.31.47.0-255,66,278721,90,283980
8177,0.002376,172.31.47.0-255,66,278787,90,283980
8178,0.002412,172.217.194.0-255,2184,280971,90,283980
8179,0.002414,172.31.47.0-255,66,281037,90,283980
8180,0.002427,172.31.47.0-255,66,281103,90,283980
8181,0.002441,172.217.194.0-255,1484,282587,90,283980
8182,0.002443,172.217.194.0-255,919,283506,90,283980
8183,0.002447,172.217.194.0-255,105,283611,90,283980
8184,0.00245,172.31.47.0-255,66,283677,90,283980
8185,0.002451,172.31.47.0-255,66,283743,90,283980
8186,0.006371,172.31.47.0-255,66,283809,90,283980
8187,0.0064,172.31.47.0-255,105,283914,90,283980
8188,0.008714,172.217.194.0-255,66,283980,90,283980
8189,0.0,172.31.47.0-255,105,105,90,276
8190,0.002087,157.240.13.0-255,105,210,90,276
8191,0.002103,172.31.47.0-255,66,276,90,276
8192,0.0,172.217.194.0-255,153,153,90,289252
8193,3.3e-05,172.31.47.0-255,66,219,90,289252
8194,4e-05,172.217.194.0-255,1484,1703,90,289252
8195,4.5e-05,172.31.47.0-255,66,1769,90,289252
8196,4.9e-05,172.217.194.0-255,2902,4671,90,289252
8197,5.2e-05,172.31.47.0-255,66,4737,90,289252
8198,5.6e-05,172.217.194.0-255,2902,7639,90,289252
8199,5.8e-05,172.31.47.0-255,66,7705,90,289252
8200,8.2e-05,172.217.194.0-255,2902,10607,90,289252
8201,8.5e-05,172.31.47.0-255,66,10673,90,289252
8202,9.2e-05,172.217.194.0-255,7156,17829,90,289252
8203,9.4e-05,172.31.47.0-255,66,17895,90,289252
8204,0.000109,172.217.194.0-255,3429,21324,90,289252
8205,0.000111,172.31.47.0-255,66,21390,90,289252
8206,0.000119,172.217.194.0-255,9633,31023,90,289252
8207,0.000121,172.31.47.0-255,66,31089,90,289252
8208,0.000205,172.217.194.0-255,1484,32573,90,289252
8209,0.000209,172.31.47.0-255,66,32639,90,289252
8210,0.000214,172.217.194.0-255,2902,35541,90,289252
8211,0.000216,172.31.47.0-255,66,35607,90,289252
8212,0.000219,172.217.194.0-255,1484,37091,90,289252
8213,0.000221,172.31.47.0-255,66,37157,90,289252
8214,0.000235,172.217.194.0-255,4320,41477,90,289252
8215,0.000238,172.31.47.0-255,66,41543,90,289252
8216,0.000269,172.31.47.0-255,66,41609,90,289252
8217,0.000277,172.217.194.0-255,2543,44152,90,289252
8218,0.000279,172.31.47.0-255,66,44218,90,289252
8219,0.000318,172.217.194.0-255,8574,52792,90,289252
8220,0.000323,172.31.47.0-255,66,52858,90,289252
8221,0.00033,172.217.194.0-255,1746,54604,90,289252
8222,0.000332,172.31.47.0-255,66,54670,90,289252
8223,0.000446,172.217.194.0-255,1484,56154,90,289252
8224,0.000452,172.217.194.0-255,2902,59056,90,289252
8225,0.000455,172.31.47.0-255,66,59122,90,289252
8226,0.000461,172.217.194.0-255,5738,64860,90,289252
8227,0.000463,172.31.47.0-255,66,64926,90,289252
8228,0.000505,172.217.194.0-255,5738,70664,90,289252
8229,0.000508,172.31.47.0-255,66,70730,90,289252
8230,0.000531,172.217.194.0-255,7156,77886,90,289252
8231,0.000534,172.31.47.0-255,66,77952,90,289252
8232,0.000543,172.217.194.0-255,10692,88644,90,289252
8233,0.000547,172.31.47.0-255,66,88710,90,289252
8234,0.00108,172.217.194.0-255,1484,90194,90,289252
8235,0.001087,172.217.194.0-255,2902,93096,90,289252
8236,0.001091,172.31.47.0-255,66,93162,90,289252
8237,0.001107,172.217.194.0-255,5738,98900,90,289252
8238,0.00111,172.31.47.0-255,66,98966,90,289252
8239,0.001149,172.217.194.0-255,8574,107540,90,289252
8240,0.001153,172.31.47.0-255,66,107606,90,289252
8241,0.001176,172.217.194.0-255,4320,111926,90,289252
8242,0.001181,172.31.47.0-255,66,111992,90,289252
8243,0.001182,172.217.194.0-255,5738,117730,90,289252
8244,0.001184,172.31.47.0-255,66,117796,90,289252
8245,0.001214,172.217.194.0-255,5020,122816,90,289252
8246,0.001217,172.31.47.0-255,66,122882,90,289252
8247,0.001281,172.217.194.0-255,1484,124366,90,289252
8248,0.001295,172.217.194.0-255,2902,127268,90,289252
8249,0.001298,172.31.47.0-255,66,127334,90,289252
8250,0.001303,172.217.194.0-255,4320,131654,90,289252
8251,0.001305,172.31.47.0-255,66,131720,90,289252
8252,0.001319,172.217.194.0-255,1484,133204,90,289252
8253,0.001324,172.217.194.0-255,4320,137524,90,289252
8254,0.001326,172.31.47.0-255,66,137590,90,289252
8255,0.001348,172.217.194.0-255,2902,140492,90,289252
8256,0.00135,172.31.47.0-255,66,140558,90,289252
8257,0.001358,172.217.194.0-255,8574,149132,90,289252
8258,0.001361,172.31.47.0-255,66,149198,90,289252
8259,0.001381,172.217.194.0-255,5738,154936,90,289252
8260,0.001383,172.31.47.0-255,66,155002,90,289252
8261,0.001387,172.217.194.0-255,2184,157186,90,289252
8262,0.001389,172.31.47.0-255,66,157252,90,289252
8263,0.001409,172.217.194.0-255,1484,158736,90,289252
8264,0.001429,172.217.194.0-255,2902,161638,90,289252
8265,0.001432,172.31.47.0-255,66,161704,90,289252
8266,0.001437,172.217.194.0-255,2902,164606,90,289252
8267,0.001439,172.31.47.0-255,66,164672,90,289252
8268,0.001454,172.217.194.0-255,2902,167574,90,289252
8269,0.001457,172.31.47.0-255,66,167640,90,289252
8270,0.001461,172.217.194.0-255,2902,170542,90,289252
8271,0.001463,172.31.47.0-255,66,170608,90,289252
8272,0.001494,172.217.194.0-255,9992,180600,90,289252
8273,0.001497,172.31.47.0-255,66,180666,90,289252
8274,0.001515,172.217.194.0-255,2902,183568,90,289252
8275,0.001517,172.31.47.0-255,66,183634,90,289252
8276,0.001542,172.217.194.0-255,7856,191490,90,289252
8277,0.001544,172.31.47.0-255,66,191556,90,289252
8278,0.001574,172.217.194.0-255,1484,193040,90,289252
8279,0.001577,172.217.194.0-255,1484,194524,90,289252
8280,0.00158,172.31.47.0-255,66,194590,90,289252
8281,0.001595,172.217.194.0-255,1484,196074,90,289252
8282,0.001601,172.217.194.0-255,5738,201812,90,289252
8283,0.001603,172.31.47.0-255,66,201878,90,289252
8284,0.001629,172.31.47.0-255,66,201944,90,289252
8285,0.001651,172.217.194.0-255,1484,203428,90,289252
8286,0.001659,172.217.194.0-255,8574,212002,90,289252
8287,0.001663,172.31.47.0-255,66,212068,90,289252
8288,0.001676,172.217.194.0-255,2184,214252,90,289252
8289,0.001682,172.31.47.0-255,66,214318,90,289252
8290,0.001731,172.217.194.0-255,1484,215802,90,289252
8291,0.001736,172.217.194.0-255,2902,218704,90,289252
8292,0.001738,172.31.47.0-255,66,218770,90,289252
8293,0.001743,172.217.194.0-255,2902,221672,90,289252
8294,0.001746,172.31.47.0-255,66,221738,90,289252
8295,0.00176,172.217.194.0-255,2902,224640,90,289252
8296,0.001763,172.31.47.0-255,66,224706,90,289252
8297,0.001767,172.217.194.0-255,1484,226190,90,289252
8298,0.001809,172.31.47.0-255,66,226256,90,289252
8299,0.001816,172.217.194.0-255,8574,234830,90,289252
8300,0.001819,172.31.47.0-255,66,234896,90,289252
8301,0.001869,172.217.194.0-255,2184,237080,90,289252
8302,0.001872,172.31.47.0-255,66,237146,90,289252
8303,0.001877,172.217.194.0-255,2902,240048,90,289252
8304,0.001878,172.31.47.0-255,66,240114,90,289252
8305,0.001884,172.217.194.0-255,7156,247270,90,289252
8306,0.001886,172.31.47.0-255,66,247336,90,289252
8307,0.00189,172.217.194.0-255,2902,250238,90,289252
8308,0.001892,172.31.47.0-255,66,250304,90,289252
8309,0.001905,172.217.194.0-255,4320,254624,90,289252
8310,0.001908,172.31.47.0-255,66,254690,90,289252
8311,0.001912,172.217.194.0-255,4320,259010,90,289252
8312,0.001914,172.31.47.0-255,66,259076,90,289252
8313,0.001933,172.31.47.0-255,66,259142,90,289252
8314,0.001936,172.217.194.0-255,1484,260626,90,289252
8315,0.001974,172.31.47.0-255,66,260692,90,289252
8316,0.002001,172.217.194.0-255,2902,263594,90,289252
8317,0.002003,172.31.47.0-255,66,263660,90,289252
8318,0.00204,172.31.47.0-255,66,263726,90,289252
8319,0.002065,172.217.194.0-255,9992,273718,90,289252
8320,0.002068,172.31.47.0-255,66,273784,90,289252
8321,0.002091,172.31.47.0-255,66,273850,90,289252
8322,0.002115,172.217.194.0-255,5020,278870,90,289252
8323,0.002117,172.217.194.0-255,1484,280354,90,289252
8324,0.002119,172.31.47.0-255,66,280420,90,289252
8325,0.002131,172.31.47.0-255,66,280486,90,289252
8326,0.002158,172.217.194.0-255,8358,288844,90,289252
8327,0.00216,172.31.47.0-255,66,288910,90,289252
8328,0.002163,172.217.194.0-255,105,289015,90,289252
8329,0.003428,172.31.47.0-255,66,289081,90,289252
8330,0.003455,172.31.47.0-255,105,289186,90,289252
8331,0.005656,172.217.194.0-255,66,289252,90,289252
8332,0.0,74.125.68.0-255,153,153,90,187330
8333,3e-05,172.31.47.0-255,66,219,90,187330
8334,3.7e-05,74.125.68.0-255,1484,1703,90,187330
8335,4.1e-05,172.31.47.0-255,66,1769,90,187330
8336,4.5e-05,74.125.68.0-255,2902,4671,90,187330
8337,4.8e-05,172.31.47.0-255,66,4737,90,187330
8338,7.5e-05,74.125.68.0-255,5738,10475,90,187330
8339,7.7e-05,172.31.47.0-255,66,10541,90,187330
8340,9.6e-05,74.125.68.0-255,3365,13906,90,187330
8341,9.9e-05,172.31.47.0-255,66,13972,90,187330
8342,0.000115,74.125.68.0-255,2902,16874,90,187330
8343,0.000118,172.31.47.0-255,66,16940,90,187330
8344,0.000134,74.125.68.0-255,1484,18424,90,187330
8345,0.000136,172.31.47.0-255,66,18490,90,187330
8346,0.000143,74.125.68.0-255,4320,22810,90,187330
8347,0.000145,172.31.47.0-255,66,22876,90,187330
8348,0.000148,74.125.68.0-255,2902,25778,90,187330
8349,0.00015,172.31.47.0-255,66,25844,90,187330
8350,0.000169,74.125.68.0-255,2902,28746,90,187330
8351,0.000171,172.31.47.0-255,66,28812,90,187330
8352,0.000177,74.125.68.0-255,2543,31355,90,187330
8353,0.000179,172.31.47.0-255,66,31421,90,187330
8354,0.000313,74.125.68.0-255,1484,32905,90,187330
8355,0.000317,172.31.47.0-255,66,32971,90,187330
8356,0.00032,74.125.68.0-255,1484,34455,90,187330
8357,0.000323,172.31.47.0-255,66,34521,90,187330
8358,0.000335,74.125.68.0-255,1484,36005,90,187330
8359,0.000338,172.31.47.0-255,66,36071,90,187330
8360,0.000342,74.125.68.0-255,2902,38973,90,187330
8361,0.000345,172.31.47.0-255,66,39039,90,187330
8362,0.000359,74.125.68.0-255,1484,40523,90,187330
8363,0.000361,172.31.47.0-255,66,40589,90,187330
8364,0.000379,74.125.68.0-255,5738,46327,90,187330
8365,0.000382,172.31.47.0-255,66,46393,90,187330
8366,0.000403,74.125.68.0-255,3961,50354,90,187330
8367,0.000407,74.125.68.0-255,4320,54674,90,187330
8368,0.000408,172.31.47.0-255,66,54740,90,187330
8369,0.000411,172.31.47.0-255,66,54806,90,187330
8370,0.000445,74.125.68.0-255,1484,56290,90,187330
8371,0.000468,74.125.68.0-255,9942,66232,90,187330
8372,0.000471,172.31.47.0-255,66,66298,90,187330
8373,0.000514,74.125.68.0-255,111,66409,90,187330
8374,0.000665,74.125.68.0-255,1484,67893,90,187330
8375,0.000669,172.31.47.0-255,66,67959,90,187330
8376,0.000674,74.125.68.0-255,2902,70861,90,187330
8377,0.000676,172.31.47.0-255,66,70927,90,187330
8378,0.000696,74.125.68.0-255,4320,75247,90,187330
8379,0.000698,172.31.47.0-255,66,75313,90,187330
8380,0.000701,74.125.68.0-255,1484,76797,90,187330
8381,0.000718,74.125.68.0-255,4320,81117,90,187330
8382,0.00072,172.31.47.0-255,66,81183,90,187330
8383,0.000735,74.125.68.0-255,1484,82667,90,187330
8384,0.000755,74.125.68.0-255,9992,92659,90,187330
8385,0.000758,172.31.47.0-255,66,92725,90,187330
8386,0.000763,74.125.68.0-255,4320,97045,90,187330
8387,0.000765,172.31.47.0-255,66,97111,90,187330
8388,0.000796,74.125.68.0-255,2902,100013,90,187330
8389,0.000799,172.31.47.0-255,66,100079,90,187330
8390,0.000822,74.125.68.0-255,766,100845,90,187330
8391,0.000868,74.125.68.0-255,333,101178,90,187330
8392,0.000912,74.125.68.0-255,1484,102662,90,187330
8393,0.000916,172.31.47.0-255,66,102728,90,187330
8394,0.000934,74.125.68.0-255,4320,107048,90,187330
8395,0.000939,172.31.47.0-255,66,107114,90,187330
8396,0.000958,74.125.68.0-255,1484,108598,90,187330
8397,0.000962,74.125.68.0-255,2902,111500,90,187330
8398,0.000965,172.31.47.0-255,66,111566,90,187330
8399,0.001014,74.125.68.0-255,5738,117304,90,187330
8400,0.001017,172.31.47.0-255,66,117370,90,187330
8401,0.001023,74.125.68.0-255,5738,123108,90,187330
8402,0.001025,172.31.47.0-255,66,123174,90,187330
8403,0.001031,74.125.68.0-255,7156,130330,90,187330
8404,0.001033,172.31.47.0-255,66,130396,90,187330
8405,0.001057,74.125.68.0-255,5020,135416,90,187330
8406,0.00106,172.31.47.0-255,66,135482,90,187330
8407,0.001184,74.125.68.0-255,1484,136966,90,187330
8408,0.001197,74.125.68.0-255,2902,139868,90,187330
8409,0.001201,172.31.47.0-255,66,139934,90,187330
8410,0.001205,74.125.68.0-255,2902,142836,90,187330
8411,0.001207,172.31.47.0-255,66,142902,90,187330
8412,0.00122,74.125.68.0-255,1484,144386,90,187330
8413,0.001232,74.125.68.0-255,2902,147288,90,187330
8414,0.001234,172.31.47.0-255,66,147354,90,187330
8415,0.001254,74.125.68.0-255,5738,153092,90,187330
8416,0.001256,172.31.47.0-255,66,153158,90,187330
8417,0.001262,74.125.68.0-255,5738,158896,90,187330
8418,0.001264,172.31.47.0-255,66,158962,90,187330
8419,0.00127,74.125.68.0-255,7156,166118,90,187330
8420,0.001272,172.31.47.0-255,66,166184,90,187330
8421,0.001296,74.125.68.0-255,3602,169786,90,187330
8422,0.001298,172.31.47.0-255,66,169852,90,187330
8423,0.003541,74.125.68.0-255,1484,171336,90,187330
8424,0.003563,74.125.68.0-255,4320,175656,90,187330
8425,0.003568,172.31.47.0-255,66,175722,90,187330
8426,0.005837,74.125.68.0-255,5738,181460,90,187330
8427,0.005842,172.31.47.0-255,66,181526,90,187330
8428,0.008112,74.125.68.0-255,5738,187264,90,187330
8429,0.00812,172.31.47.0-255,66,187330,90,187330
8430,0.0,74.125.24.0-255,153,153,90,129336
8431,2.6e-05,172.31.47.0-255,66,219,90,129336
8432,3.2e-05,74.125.24.0-255,1484,1703,90,129336
8433,3.6e-05,172.31.47.0-255,66,1769,90,129336
8434,4.1e-05,74.125.24.0-255,2902,4671,90,129336
8435,4.4e-05,172.31.47.0-255,66,4737,90,129336
8436,5e-05,74.125.24.0-255,5738,10475,90,129336
8437,5.3e-05,172.31.47.0-255,66,10541,90,129336
8438,7.1e-05,74.125.24.0-255,1484,12025,90,129336
8439,7.3e-05,172.31.47.0-255,66,12091,90,129336
8440,0.000116,172.31.47.0-255,66,12157,90,129336
8441,0.000122,74.125.24.0-255,6797,18954,90,129336
8442,0.000126,172.31.47.0-255,66,19020,90,129336
8443,0.000129,74.125.24.0-255,1484,20504,90,129336
8444,0.000131,172.31.47.0-255,66,20570,90,129336
8445,0.000158,74.125.24.0-255,1484,22054,90,129336
8446,0.000161,172.31.47.0-255,66,22120,90,129336
8447,0.000166,74.125.24.0-255,4320,26440,90,129336
8448,0.000169,172.31.47.0-255,66,26506,90,129336
8449,0.000177,74.125.24.0-255,7156,33662,90,129336
8450,0.00018,172.31.47.0-255,66,33728,90,129336
8451,0.000201,74.125.24.0-255,1484,35212,90,129336
8452,0.000203,172.31.47.0-255,66,35278,90,129336
8453,0.000206,74.125.24.0-255,1125,36403,90,129336
8454,0.000208,172.31.47.0-255,66,36469,90,129336
8455,0.000657,74.125.24.0-255,1484,37953,90,129336
8456,0.000664,172.31.47.0-255,66,38019,90,129336
8457,0.00067,74.125.24.0-255,2902,40921,90,129336
8458,0.000673,172.31.47.0-255,66,40987,90,129336
8459,0.00069,74.125.24.0-255,5738,46725,90,129336
8460,0.000694,74.125.24.0-255,2902,49627,90,129336
8461,0.000695,172.31.47.0-255,66,49693,90,129336
8462,0.000698,172.31.47.0-255,66,49759,90,129336
8463,0.000715,74.125.24.0-255,1484,51243,90,129336
8464,0.000747,74.125.24.0-255,2543,53786,90,129336
8465,0.000751,172.31.47.0-255,66,53852,90,129336
8466,0.001094,74.125.24.0-255,388,54240,90,129336
8467,0.001128,74.125.24.0-255,354,54594,90,129336
8468,0.001324,74.125.24.0-255,1484,56078,90,129336
8469,0.00133,172.31.47.0-255,66,56144,90,129336
8470,0.001336,74.125.24.0-255,2902,59046,90,129336
8471,0.001338,172.31.47.0-255,66,59112,90,129336
8472,0.001342,74.125.24.0-255,2902,62014,90,129336
8473,0.001344,172.31.47.0-255,66,62080,90,129336
8474,0.001366,74.125.24.0-255,2902,64982,90,129336
8475,0.001368,172.31.47.0-255,66,65048,90,129336
8476,0.001381,172.31.47.0-255,66,65114,90,129336
8477,0.001427,74.125.24.0-255,5738,70852,90,129336
8478,0.001431,172.31.47.0-255,66,70918,90,129336
8479,0.001447,74.125.24.0-255,6438,77356,90,129336
8480,0.00145,172.31.47.0-255,66,77422,90,129336
8481,0.001871,74.125.24.0-255,1484,78906,90,129336
8482,0.001894,74.125.24.0-255,2902,81808,90,129336
8483,0.001897,172.31.47.0-255,66,81874,90,129336
8484,0.001924,74.125.24.0-255,5738,87612,90,129336
8485,0.001926,172.31.47.0-255,66,87678,90,129336
8486,0.001931,74.125.24.0-255,4320,91998,90,129336
8487,0.001933,172.31.47.0-255,66,92064,90,129336
8488,0.001944,74.125.24.0-255,2902,94966,90,129336
8489,0.001947,172.31.47.0-255,66,95032,90,129336
8490,0.001964,74.125.24.0-255,8574,103606,90,129336
8491,0.001966,172.31.47.0-255,66,103672,90,129336
8492,0.001972,74.125.24.0-255,5738,109410,90,129336
8493,0.001975,172.31.47.0-255,66,109476,90,129336
8494,0.001994,74.125.24.0-255,1484,110960,90,129336
8495,0.001997,74.125.24.0-255,766,111726,90,129336
8496,0.001999,172.31.47.0-255,66,111792,90,129336
8497,0.004505,74.125.24.0-255,2902,114694,90,129336
8498,0.00451,172.31.47.0-255,66,114760,90,129336
8499,0.004547,74.125.24.0-255,2902,117662,90,129336
8500,0.00455,172.31.47.0-255,66,117728,90,129336
8501,0.007053,74.125.24.0-255,5738,123466,90,129336
8502,0.007058,172.31.47.0-255,66,123532,90,129336
8503,0.009768,74.125.24.0-255,5738,129270,90,129336
8504,0.009828,172.31.47.0-255,66,129336,90,129336
8505,0.0,172.217.194.0-255,298,298,90,139292
8506,4.3e-05,172.31.47.0-255,66,364,90,139292
8507,5e-05,172.217.194.0-255,1484,1848,90,139292
8508,5.5e-05,172.31.47.0-255,66,1914,90,139292
8509,6e-05,172.217.194.0-255,4320,6234,90,139292
8510,6.3e-05,172.31.47.0-255,66,6300,90,139292
8511,6.9e-05,172.217.194.0-255,7156,13456,90,139292
8512,7.3e-05,172.31.47.0-255,66,13522,90,139292
8513,7.6e-05,172.217.194.0-255,379,13901,90,139292
8514,7.8e-05,172.31.47.0-255,66,13967,90,139292
8515,0.000101,172.217.194.0-255,1484,15451,90,139292
8516,0.000103,172.31.47.0-255,66,15517,90,139292
8517,0.00011,172.217.194.0-255,4320,19837,90,139292
8518,0.000113,172.31.47.0-255,66,19903,90,139292
8519,0.000159,172.217.194.0-255,5738,25641,90,139292
8520,0.000162,172.31.47.0-255,66,25707,90,139292
8521,0.000181,172.217.194.0-255,4320,30027,90,139292
8522,0.000183,172.31.47.0-255,66,30093,90,139292
8523,0.000186,172.217.194.0-255,1125,31218,90,139292
8524,0.000187,172.31.47.0-255,66,31284,90,139292
8525,0.00021,172.217.194.0-255,1484,32768,90,139292
8526,0.000212,172.31.47.0-255,66,32834,90,139292
8527,0.000232,172.217.194.0-255,2902,35736,90,139292
8528,0.000236,172.31.47.0-255,66,35802,90,139292
8529,0.000242,172.217.194.0-255,5738,41540,90,139292
8530,0.000244,172.31.47.0-255,66,41606,90,139292
8531,0.000248,172.217.194.0-255,2902,44508,90,139292
8532,0.00025,172.31.47.0-255,66,44574,90,139292
8533,0.000255,172.217.194.0-255,3961,48535,90,139292
8534,0.000257,172.31.47.0-255,66,48601,90,139292
8535,0.000291,172.217.194.0-255,8574,57175,90,139292
8536,0.000295,172.31.47.0-255,66,57241,90,139292
8537,0.000301,172.217.194.0-255,4320,61561,90,139292
8538,0.000303,172.31.47.0-255,66,61627,90,139292
8539,0.000318,172.217.194.0-255,4238,65865,90,139292
8540,0.000321,172.31.47.0-255,66,65931,90,139292
8541,0.000424,172.217.194.0-255,116,66047,90,139292
8542,0.000802,172.31.47.0-255,66,66113,90,139292
8543,0.000938,172.217.194.0-255,383,66496,90,139292
8544,0.001184,172.217.194.0-255,1484,67980,90,139292
8545,0.001189,172.31.47.0-255,66,68046,90,139292
8546,0.001195,172.217.194.0-255,2902,70948,90,139292
8547,0.001197,172.31.47.0-255,66,71014,90,139292
8548,0.001208,172.217.194.0-255,1484,72498,90,139292
8549,0.001223,172.217.194.0-255,4320,76818,90,139292
8550,0.001226,172.31.47.0-255,66,76884,90,139292
8551,0.001235,172.217.194.0-255,9992,86876,90,139292
8552,0.001237,172.31.47.0-255,66,86942,90,139292
8553,0.001273,172.217.194.0-255,8574,95516,90,139292
8554,0.001276,172.31.47.0-255,66,95582,90,139292
8555,0.001296,172.217.194.0-255,5020,100602,90,139292
8556,0.001299,172.31.47.0-255,66,100668,90,139292
8557,0.001522,172.217.194.0-255,1484,102152,90,139292
8558,0.00154,172.217.194.0-255,2902,105054,90,139292
8559,0.001544,172.31.47.0-255,66,105120,90,139292
8560,0.001551,172.217.194.0-255,5738,110858,90,139292
8561,0.001554,172.31.47.0-255,66,110924,90,139292
8562,0.001597,172.31.47.0-255,66,110990,90,139292
8563,0.001623,172.217.194.0-255,2902,113892,90,139292
8564,0.001626,172.31.47.0-255,66,113958,90,139292
8565,0.001647,172.217.194.0-255,7856,121814,90,139292
8566,0.00165,172.31.47.0-255,66,121880,90,139292
8567,0.003942,172.217.194.0-255,5738,127618,90,139292
8568,0.003947,172.31.47.0-255,66,127684,90,139292
8569,0.006212,172.217.194.0-255,5738,133422,90,139292
8570,0.006219,172.31.47.0-255,66,133488,90,139292
8571,0.008491,172.217.194.0-255,5738,139226,90,139292
8572,0.008496,172.31.47.0-255,66,139292,90,139292
8573,0.0,74.125.24.0-255,431,431,90,193492
8574,1.4e-05,74.125.24.0-255,1484,1915,90,193492
8575,2.1e-05,172.31.47.0-255,66,1981,90,193492
8576,2.9e-05,74.125.24.0-255,4320,6301,90,193492
8577,3.2e-05,172.31.47.0-255,66,6367,90,193492
8578,7.7e-05,74.125.24.0-255,7881,14248,90,193492
8579,8e-05,172.31.47.0-255,66,14314,90,193492
8580,0.000394,74.125.24.0-255,4320,18634,90,193492
8581,0.000399,172.31.47.0-255,66,18700,90,193492
8582,0.000416,74.125.24.0-255,4320,23020,90,193492
8583,0.000419,172.31.47.0-255,66,23086,90,193492
8584,0.000786,74.125.24.0-255,6890,29976,90,193492
8585,0.000791,172.31.47.0-255,66,30042,90,193492
8586,0.002351,74.125.24.0-255,4320,34362,90,193492
8587,0.002356,172.31.47.0-255,66,34428,90,193492
8588,0.002372,74.125.24.0-255,1484,35912,90,193492
8589,0.00247,74.125.24.0-255,7156,43068,90,193492
8590,0.002473,172.31.47.0-255,66,43134,90,193492
8591,0.002496,74.125.24.0-255,1484,44618,90,193492
8592,0.002865,74.125.24.0-255,7156,51774,90,193492
8593,0.002869,172.31.47.0-255,66,51840,90,193492
8594,0.0029,74.125.24.0-255,7156,58996,90,193492
8595,0.002909,172.31.47.0-255,66,59062,90,193492
8596,0.003527,74.125.24.0-255,4320,63382,90,193492
8597,0.003532,172.31.47.0-255,66,63448,90,193492
8598,0.003564,74.125.24.0-255,9992,73440,90,193492
8599,0.003578,172.31.47.0-255,66,73506,90,193492
8600,0.004094,74.125.24.0-255,8574,82080,90,193492
8601,0.004099,172.31.47.0-255,66,82146,90,193492
8602,0.004129,74.125.24.0-255,5738,87884,90,193492
8603,0.004146,172.31.47.0-255,66,87950,90,193492
8604,0.004591,74.125.24.0-255,5738,93688,90,193492
8605,0.004596,172.31.47.0-255,66,93754,90,193492
8606,0.004784,74.125.24.0-255,8574,102328,90,193492
8607,0.004813,172.31.47.0-255,66,102394,90,193492
8608,0.004996,74.125.24.0-255,2902,105296,90,193492
8609,0.005,172.31.47.0-255,66,105362,90,193492
8610,0.00505,172.31.47.0-255,66,105428,90,193492
8611,0.005352,172.31.47.0-255,66,105494,90,193492
8612,0.005383,74.125.24.0-255,1484,106978,90,193492
8613,0.005672,74.125.24.0-255,8574,115552,90,193492
8614,0.005678,172.31.47.0-255,66,115618,90,193492
8615,0.00571,74.125.24.0-255,5738,121356,90,193492
8616,0.005715,172.31.47.0-255,66,121422,90,193492
8617,0.005991,74.125.24.0-255,4320,125742,90,193492
8618,0.005998,172.31.47.0-255,66,125808,90,193492
8619,0.00607,74.125.24.0-255,9992,135800,90,193492
8620,0.006076,172.31.47.0-255,66,135866,90,193492
8621,0.007048,172.31.47.0-255,66,135932,90,193492
8622,0.007325,172.31.47.0-255,66,135998,90,193492
8623,0.007498,172.31.47.0-255,66,136064,90,193492
8624,0.007779,172.31.47.0-255,66,136130,90,193492
8625,0.0078,74.125.24.0-255,2902,139032,90,193492
8626,0.007803,172.31.47.0-255,66,139098,90,193492
8627,0.007837,172.31.47.0-255,66,139164,90,193492
8628,0.007877,74.125.24.0-255,9992,149156,90,193492
8629,0.007881,172.31.47.0-255,66,149222,90,193492
8630,0.008135,74.125.24.0-255,8574,157796,90,193492
8631,0.008142,172.31.47.0-255,66,157862,90,193492
8632,0.00819,172.31.47.0-255,66,157928,90,193492
8633,0.00846,74.125.24.0-255,4320,162248,90,193492
8634,0.008467,172.31.47.0-255,66,162314,90,193492
8635,0.008502,172.31.47.0-255,66,162380,90,193492
8636,0.009475,74.125.24.0-255,8574,170954,90,193492
8637,0.00948,172.31.47.0-255,66,171020,90,193492
8638,0.009597,172.31.47.0-255,66,171086,90,193492
8639,0.009611,74.125.24.0-255,4320,175406,90,193492
8640,0.009623,172.31.47.0-255,66,175472,90,193492
8641,0.009666,172.31.47.0-255,66,175538,90,193492
8642,0.009676,74.125.24.0-255,4320,179858,90,193492
8643,0.009692,172.31.47.0-255,66,179924,90,193492
8644,0.009945,74.125.24.0-255,5738,185662,90,193492
8645,0.00995,172.31.47.0-255,66,185728,90,193492
8646,0.00998,74.125.24.0-255,7698,193426,90,193492
8647,0.009987,172.31.47.0-255,66,193492,90,193492
8648,0.0,172.217.194.0-255,153,153,90,253389
8649,2.5e-05,172.31.47.0-255,66,219,90,253389
8650,3.2e-05,172.217.194.0-255,1484,1703,90,253389
8651,3.6e-05,172.31.47.0-255,66,1769,90,253389
8652,4.2e-05,172.217.194.0-255,2902,4671,90,253389
8653,5.4e-05,172.31.47.0-255,66,4737,90,253389
8654,6.1e-05,172.217.194.0-255,7156,11893,90,253389
8655,6.4e-05,172.31.47.0-255,66,11959,90,253389
8656,6.8e-05,172.217.194.0-255,2020,13979,90,253389
8657,7.2e-05,172.31.47.0-255,66,14045,90,253389
8658,0.000112,172.217.194.0-255,1484,15529,90,253389
8659,0.000115,172.31.47.0-255,66,15595,90,253389
8660,0.000121,172.217.194.0-255,2902,18497,90,253389
8661,0.000123,172.31.47.0-255,66,18563,90,253389
8662,0.00013,172.217.194.0-255,5738,24301,90,253389
8663,0.000132,172.31.47.0-255,66,24367,90,253389
8664,0.00017,172.217.194.0-255,6797,31164,90,253389
8665,0.000173,172.31.47.0-255,66,31230,90,253389
8666,0.000225,172.217.194.0-255,1484,32714,90,253389
8667,0.000228,172.31.47.0-255,66,32780,90,253389
8668,0.000246,172.217.194.0-255,2902,35682,90,253389
8669,0.000248,172.31.47.0-255,66,35748,90,253389
8670,0.000279,172.217.194.0-255,5738,41486,90,253389
8671,0.000282,172.31.47.0-255,66,41552,90,253389
8672,0.000313,172.217.194.0-255,6797,48349,90,253389
8673,0.000316,172.31.47.0-255,66,48415,90,253389
8674,0.000322,172.217.194.0-255,5738,54153,90,253389
8675,0.000325,172.31.47.0-255,66,54219,90,253389
8676,0.000351,172.217.194.0-255,1484,55703,90,253389
8677,0.000353,172.31.47.0-255,66,55769,90,253389
8678,0.000363,172.217.194.0-255,9633,65402,90,253389
8679,0.00037,172.31.47.0-255,66,65468,90,253389
8680,0.000373,172.217.194.0-255,677,66145,90,253389
8681,0.000608,172.217.194.0-255,1484,67629,90,253389
8682,0.000614,172.31.47.0-255,66,67695,90,253389
8683,0.000621,172.217.194.0-255,2902,70597,90,253389
8684,0.000623,172.31.47.0-255,66,70663,90,253389
8685,0.000635,172.217.194.0-255,4320,74983,90,253389
8686,0.000637,172.31.47.0-255,66,75049,90,253389
8687,0.000679,172.217.194.0-255,1484,76533,90,253389
8688,0.000695,172.31.47.0-255,66,76599,90,253389
8689,0.0007,172.217.194.0-255,2902,79501,90,253389
8690,0.000702,172.31.47.0-255,66,79567,90,253389
8691,0.000715,172.217.194.0-255,7856,87423,90,253389
8692,0.000718,172.31.47.0-255,66,87489,90,253389
8693,0.001517,172.217.194.0-255,1484,88973,90,253389
8694,0.001524,172.217.194.0-255,2902,91875,90,253389
8695,0.001528,172.31.47.0-255,66,91941,90,253389
8696,0.001535,172.217.194.0-255,4320,96261,90,253389
8697,0.001537,172.31.47.0-255,66,96327,90,253389
8698,0.001556,172.217.194.0-255,1484,97811,90,253389
8699,0.001563,172.217.194.0-255,5738,103549,90,253389
8700,0.001565,172.31.47.0-255,66,103615,90,253389
8701,0.001597,172.217.194.0-255,7156,110771,90,253389
8702,0.001599,172.31.47.0-255,66,110837,90,253389
8703,0.00161,172.217.194.0-255,10692,121529,90,253389
8704,0.001612,172.31.47.0-255,66,121595,90,253389
8705,0.002246,172.217.194.0-255,1484,123079,90,253389
8706,0.002257,172.217.194.0-255,2902,125981,90,253389
8707,0.002262,172.31.47.0-255,66,126047,90,253389
8708,0.00227,172.217.194.0-255,5738,131785,90,253389
8709,0.002272,172.31.47.0-255,66,131851,90,253389
8710,0.002281,172.217.194.0-255,1484,133335,90,253389
8711,0.002284,172.217.194.0-255,1484,134819,90,253389
8712,0.002286,172.31.47.0-255,66,134885,90,253389
8713,0.002336,172.31.47.0-255,66,134951,90,253389
8714,0.00234,172.217.194.0-255,2184,137135,90,253389
8715,0.002342,172.31.47.0-255,66,137201,90,253389
8716,0.002546,172.217.194.0-255,1484,138685,90,253389
8717,0.002561,172.217.194.0-255,2902,141587,90,253389
8718,0.002565,172.31.47.0-255,66,141653,90,253389
8719,0.002597,172.217.194.0-255,4320,145973,90,253389
8720,0.002599,172.31.47.0-255,66,146039,90,253389
8721,0.002609,172.217.194.0-255,8574,154613,90,253389
8722,0.002611,172.31.47.0-255,66,154679,90,253389
8723,0.002648,172.217.194.0-255,5738,160417,90,253389
8724,0.002651,172.31.47.0-255,66,160483,90,253389
8725,0.002681,172.217.194.0-255,10692,171175,90,253389
8726,0.002684,172.31.47.0-255,66,171241,90,253389
8727,0.002785,172.217.194.0-255,1484,172725,90,253389
8728,0.002806,172.217.194.0-255,2902,175627,90,253389
8729,0.00281,172.31.47.0-255,66,175693,90,253389
8730,0.002835,172.217.194.0-255,5738,181431,90,253389
8731,0.002838,172.31.47.0-255,66,181497,90,253389
8732,0.002846,172.217.194.0-255,7156,188653,90,253389
8733,0.002848,172.31.47.0-255,66,188719,90,253389
8734,0.002878,172.217.194.0-255,5738,194457,90,253389
8735,0.00288,172.31.47.0-255,66,194523,90,253389
8736,0.002893,172.217.194.0-255,8574,203097,90,253389
8737,0.002896,172.31.47.0-255,66,203163,90,253389
8738,0.0029,172.217.194.0-255,2184,205347,90,253389
8739,0.002902,172.31.47.0-255,66,205413,90,253389
8740,0.003217,172.217.194.0-255,1484,206897,90,253389
8741,0.003225,172.217.194.0-255,2902,209799,90,253389
8742,0.00323,172.31.47.0-255,66,209865,90,253389
8743,0.003233,172.217.194.0-255,1484,211349,90,253389
8744,0.003258,172.217.194.0-255,4320,215669,90,253389
8745,0.003261,172.31.47.0-255,66,215735,90,253389
8746,0.003265,172.217.194.0-255,2902,218637,90,253389
8747,0.003267,172.31.47.0-255,66,218703,90,253389
8748,0.003304,172.217.194.0-255,4320,223023,90,253389
8749,0.003307,172.31.47.0-255,66,223089,90,253389
8750,0.003328,172.31.47.0-255,66,223155,90,253389
8751,0.003336,172.217.194.0-255,7856,231011,90,253389
8752,0.003339,172.31.47.0-255,66,231077,90,253389
8753,0.003416,172.31.47.0-255,66,231143,90,253389
8754,0.003437,172.217.194.0-255,7156,238299,90,253389
8755,0.00344,172.31.47.0-255,66,238365,90,253389
8756,0.003447,172.217.194.0-255,6438,244803,90,253389
8757,0.003449,172.31.47.0-255,66,244869,90,253389
8758,0.003488,172.31.47.0-255,66,244935,90,253389
8759,0.003508,172.31.47.0-255,66,245001,90,253389
8760,0.003548,172.217.194.0-255,6438,251439,90,253389
8761,0.003551,172.31.47.0-255,66,251505,90,253389
8762,0.003555,172.217.194.0-255,1484,252989,90,253389
8763,0.003589,172.31.47.0-255,66,253055,90,253389
8764,0.00361,172.31.47.0-255,66,253121,90,253389
8765,0.00366,172.31.47.0-255,66,253187,90,253389
8766,0.003663,172.217.194.0-255,97,253284,90,253389
8767,0.003666,172.217.194.0-255,105,253389,90,253389
8768,0.0,172.31.47.0-255,105,105,90,381
8769,4.6e-05,172.31.47.0-255,105,210,90,381
8770,0.001805,157.240.13.0-255,105,315,90,381
8771,0.001818,172.31.47.0-255,66,381,90,381
8772,0.0,172.31.47.0-255,105,105,90,105
8773,0.0,172.31.47.0-255,105,105,90,276
8774,0.001792,157.240.13.0-255,105,210,90,276
8775,0.001807,172.31.47.0-255,66,276,90,276
8776,0.0,172.217.194.0-255,298,298,90,225151
8777,1.9e-05,172.31.47.0-255,66,364,90,225151
8778,4e-05,172.217.194.0-255,1484,1848,90,225151
8779,4.5e-05,172.31.47.0-255,66,1914,90,225151
8780,5.1e-05,172.217.194.0-255,4320,6234,90,225151
8781,5.3e-05,172.31.47.0-255,66,6300,90,225151
8782,7.7e-05,172.217.194.0-255,7156,13456,90,225151
8783,7.9e-05,172.31.47.0-255,66,13522,90,225151
8784,0.000111,172.217.194.0-255,1911,15433,90,225151
8785,0.000114,172.31.47.0-255,66,15499,90,225151
8786,0.000122,172.217.194.0-255,9992,25491,90,225151
8787,0.000124,172.31.47.0-255,66,25557,90,225151
8788,0.000129,172.217.194.0-255,5379,30936,90,225151
8789,0.000131,172.31.47.0-255,66,31002,90,225151
8790,0.000173,172.217.194.0-255,2902,33904,90,225151
8791,0.000175,172.31.47.0-255,66,33970,90,225151
8792,0.000179,172.217.194.0-255,4320,38290,90,225151
8793,0.000181,172.31.47.0-255,66,38356,90,225151
8794,0.000212,172.217.194.0-255,8574,46930,90,225151
8795,0.000215,172.31.47.0-255,66,46996,90,225151
8796,0.000254,172.31.47.0-255,66,47062,90,225151
8797,0.000257,172.217.194.0-255,1080,48142,90,225151
8798,0.000258,172.31.47.0-255,66,48208,90,225151
8799,0.000305,172.217.194.0-255,365,48573,90,225151
8800,0.000308,172.31.47.0-255,66,48639,90,225151
8801,0.000421,172.217.194.0-255,1484,50123,90,225151
8802,0.000424,172.31.47.0-255,66,50189,90,225151
8803,0.000429,172.217.194.0-255,2902,53091,90,225151
8804,0.000431,172.31.47.0-255,66,53157,90,225151
8805,0.000461,172.217.194.0-255,5738,58895,90,225151
8806,0.000464,172.31.47.0-255,66,58961,90,225151
8807,0.000469,172.217.194.0-255,4320,63281,90,225151
8808,0.000471,172.31.47.0-255,66,63347,90,225151
8809,0.000508,172.217.194.0-255,8574,71921,90,225151
8810,0.00051,172.31.47.0-255,66,71987,90,225151
8811,0.000518,172.217.194.0-255,9992,81979,90,225151
8812,0.000521,172.31.47.0-255,66,82045,90,225151
8813,0.000523,172.217.194.0-255,766,82811,90,225151
8814,0.000731,172.217.194.0-255,1484,84295,90,225151
8815,0.000737,172.31.47.0-255,66,84361,90,225151
8816,0.000744,172.217.194.0-255,2902,87263,90,225151
8817,0.000746,172.31.47.0-255,66,87329,90,225151
8818,0.000772,172.217.194.0-255,5738,93067,90,225151
8819,0.000775,172.31.47.0-255,66,93133,90,225151
8820,0.000811,172.31.47.0-255,66,93199,90,225151
8821,0.000834,172.217.194.0-255,1484,94683,90,225151
8822,0.000849,172.217.194.0-255,4320,99003,90,225151
8823,0.000852,172.31.47.0-255,66,99069,90,225151
8824,0.000881,172.217.194.0-255,5020,104089,90,225151
8825,0.000886,172.31.47.0-255,66,104155,90,225151
8826,0.000907,172.217.194.0-255,1484,105639,90,225151
8827,0.000911,172.217.194.0-255,2902,108541,90,225151
8828,0.000914,172.31.47.0-255,66,108607,90,225151
8829,0.00092,172.217.194.0-255,5738,114345,90,225151
8830,0.000922,172.31.47.0-255,66,114411,90,225151
8831,0.000957,172.217.194.0-255,8574,122985,90,225151
8832,0.00096,172.31.47.0-255,66,123051,90,225151
8833,0.000989,172.217.194.0-255,2902,125953,90,225151
8834,0.000992,172.31.47.0-255,66,126019,90,225151
8835,0.001023,172.31.47.0-255,66,126085,90,225151
8836,0.001038,172.217.194.0-255,1484,127569,90,225151
8837,0.001042,172.217.194.0-255,2902,130471,90,225151
8838,0.00105,172.31.47.0-255,66,130537,90,225151
8839,0.001074,172.217.194.0-255,5738,136275,90,225151
8840,0.001077,172.31.47.0-255,66,136341,90,225151
8841,0.001087,172.217.194.0-255,2902,139243,90,225151
8842,0.00109,172.31.47.0-255,66,139309,90,225151
8843,0.001118,172.217.194.0-255,8574,147883,90,225151
8844,0.00112,172.31.47.0-255,66,147949,90,225151
8845,0.001132,172.217.194.0-255,1484,149433,90,225151
8846,0.00116,172.217.194.0-255,10692,160125,90,225151
8847,0.001163,172.31.47.0-255,66,160191,90,225151
8848,0.001214,172.217.194.0-255,1484,161675,90,225151
8849,0.001232,172.217.194.0-255,2902,164577,90,225151
8850,0.001235,172.31.47.0-255,66,164643,90,225151
8851,0.001239,172.217.194.0-255,4320,168963,90,225151
8852,0.001242,172.31.47.0-255,66,169029,90,225151
8853,0.001258,172.217.194.0-255,1484,170513,90,225151
8854,0.0013,172.217.194.0-255,1484,171997,90,225151
8855,0.001302,172.31.47.0-255,66,172063,90,225151
8856,0.001341,172.31.47.0-255,66,172129,90,225151
8857,0.001352,172.31.47.0-255,66,172195,90,225151
8858,0.001368,172.31.47.0-255,66,172261,90,225151
8859,0.001383,172.31.47.0-255,66,172327,90,225151
8860,0.00141,172.217.194.0-255,5738,178065,90,225151
8861,0.001415,172.31.47.0-255,66,178131,90,225151
8862,0.001453,172.31.47.0-255,66,178197,90,225151
8863,0.001459,172.217.194.0-255,7156,185353,90,225151
8864,0.001461,172.31.47.0-255,66,185419,90,225151
8865,0.001501,172.31.47.0-255,66,185485,90,225151
8866,0.001504,172.217.194.0-255,1484,186969,90,225151
8867,0.001543,172.31.47.0-255,66,187035,90,225151
8868,0.001563,172.217.194.0-255,6438,193473,90,225151
8869,0.001565,172.31.47.0-255,66,193539,90,225151
8870,0.001585,172.217.194.0-255,1484,195023,90,225151
8871,0.00159,172.217.194.0-255,5738,200761,90,225151
8872,0.001595,172.31.47.0-255,66,200827,90,225151
8873,0.001627,172.31.47.0-255,66,200893,90,225151
8874,0.00165,172.217.194.0-255,5020,205913,90,225151
8875,0.001653,172.31.47.0-255,66,205979,90,225151
8876,0.001656,172.217.194.0-255,1484,207463,90,225151
8877,0.001679,172.217.194.0-255,7156,214619,90,225151
8878,0.001682,172.31.47.0-255,66,214685,90,225151
8879,0.001689,172.217.194.0-255,9992,224677,90,225151
8880,0.001692,172.31.47.0-255,66,224743,90,225151
8881,0.001724,172.31.47.0-255,66,224809,90,225151
8882,0.001773,172.217.194.0-255,105,224914,90,225151
8883,0.004295,172.31.47.0-255,66,224980,90,225151
8884,0.004334,172.31.47.0-255,105,225085,90,225151
8885,0.006434,172.217.194.0-255,66,225151,90,225151
8886,0.0,74.125.130.0-255,153,153,90,186123
8887,2.5e-05,172.31.47.0-255,66,219,90,186123
8888,3.3e-05,74.125.130.0-255,1484,1703,90,186123
8889,3.8e-05,172.31.47.0-255,66,1769,90,186123
8890,4.3e-05,74.125.130.0-255,2902,4671,90,186123
8891,4.6e-05,172.31.47.0-255,66,4737,90,186123
8892,5.3e-05,74.125.130.0-255,5738,10475,90,186123
8893,5.6e-05,172.31.47.0-255,66,10541,90,186123
8894,7.9e-05,74.125.130.0-255,3551,14092,90,186123
8895,8.2e-05,172.31.47.0-255,66,14158,90,186123
8896,8.7e-05,74.125.130.0-255,4320,18478,90,186123
8897,9e-05,172.31.47.0-255,66,18544,90,186123
8898,0.000114,74.125.130.0-255,4320,22864,90,186123
8899,0.000117,172.31.47.0-255,66,22930,90,186123
8900,0.000141,74.125.130.0-255,5738,28668,90,186123
8901,0.000143,172.31.47.0-255,66,28734,90,186123
8902,0.000147,74.125.130.0-255,2543,31277,90,186123
8903,0.000149,172.31.47.0-255,66,31343,90,186123
8904,0.00029,74.125.130.0-255,1484,32827,90,186123
8905,0.000294,172.31.47.0-255,66,32893,90,186123
8906,0.000297,74.125.130.0-255,1484,34377,90,186123
8907,0.000299,172.31.47.0-255,66,34443,90,186123
8908,0.000313,74.125.130.0-255,1484,35927,90,186123
8909,0.000315,172.31.47.0-255,66,35993,90,186123
8910,0.00032,74.125.130.0-255,4320,40313,90,186123
8911,0.000322,172.31.47.0-255,66,40379,90,186123
8912,0.000341,74.125.130.0-255,1484,41863,90,186123
8913,0.000343,172.31.47.0-255,66,41929,90,186123
8914,0.000348,74.125.130.0-255,2902,44831,90,186123
8915,0.000349,172.31.47.0-255,66,44897,90,186123
8916,0.000354,74.125.130.0-255,3961,48858,90,186123
8917,0.000356,172.31.47.0-255,66,48924,90,186123
8918,0.00086,74.125.130.0-255,1484,50408,90,186123
8919,0.000871,74.125.130.0-255,2902,53310,90,186123
8920,0.000875,172.31.47.0-255,66,53376,90,186123
8921,0.00089,74.125.130.0-255,2902,56278,90,186123
8922,0.000892,172.31.47.0-255,66,56344,90,186123
8923,0.000906,74.125.130.0-255,2902,59246,90,186123
8924,0.000908,172.31.47.0-255,66,59312,90,186123
8925,0.000915,74.125.130.0-255,6797,66109,90,186123
8926,0.000917,172.31.47.0-255,66,66175,90,186123
8927,0.001014,74.125.130.0-255,1484,67659,90,186123
8928,0.00102,74.125.130.0-255,2902,70561,90,186123
8929,0.001023,172.31.47.0-255,66,70627,90,186123
8930,0.001045,74.125.130.0-255,5738,76365,90,186123
8931,0.001047,172.31.47.0-255,66,76431,90,186123
8932,0.001051,74.125.130.0-255,2902,79333,90,186123
8933,0.001053,172.31.47.0-255,66,79399,90,186123
8934,0.001069,74.125.130.0-255,3961,83360,90,186123
8935,0.001071,172.31.47.0-255,66,83426,90,186123
8936,0.001092,74.125.130.0-255,646,84072,90,186123
8937,0.001193,74.125.130.0-255,1484,85556,90,186123
8938,0.001197,172.31.47.0-255,66,85622,90,186123
8939,0.0012,74.125.130.0-255,1484,87106,90,186123
8940,0.001214,74.125.130.0-255,1484,88590,90,186123
8941,0.001216,172.31.47.0-255,66,88656,90,186123
8942,0.001232,74.125.130.0-255,5738,94394,90,186123
8943,0.001234,172.31.47.0-255,66,94460,90,186123
8944,0.001252,74.125.130.0-255,2902,97362,90,186123
8945,0.001254,172.31.47.0-255,66,97428,90,186123
8946,0.001256,74.125.130.0-255,1484,98912,90,186123
8947,0.001275,74.125.130.0-255,2543,101455,90,186123
8948,0.001278,172.31.47.0-255,66,101521,90,186123
8949,0.001438,74.125.130.0-255,1484,103005,90,186123
8950,0.001442,74.125.130.0-255,1484,104489,90,186123
8951,0.001445,172.31.47.0-255,66,104555,90,186123
8952,0.001477,74.125.130.0-255,1484,106039,90,186123
8953,0.001491,74.125.130.0-255,1484,107523,90,186123
8954,0.001494,172.31.47.0-255,66,107589,90,186123
8955,0.0015,74.125.130.0-255,5738,113327,90,186123
8956,0.001502,172.31.47.0-255,66,113393,90,186123
8957,0.001508,74.125.130.0-255,7156,120549,90,186123
8958,0.001511,172.31.47.0-255,66,120615,90,186123
8959,0.001526,74.125.130.0-255,5738,126353,90,186123
8960,0.001528,172.31.47.0-255,66,126419,90,186123
8961,0.00155,74.125.130.0-255,1484,127903,90,186123
8962,0.001569,74.125.130.0-255,7856,135759,90,186123
8963,0.001572,172.31.47.0-255,66,135825,90,186123
8964,0.001947,74.125.130.0-255,1484,137309,90,186123
8965,0.00196,74.125.130.0-255,2902,140211,90,186123
8966,0.001963,172.31.47.0-255,66,140277,90,186123
8967,0.001968,74.125.130.0-255,4320,144597,90,186123
8968,0.00197,172.31.47.0-255,66,144663,90,186123
8969,0.00198,74.125.130.0-255,1484,146147,90,186123
8970,0.002029,74.125.130.0-255,4320,150467,90,186123
8971,0.002031,172.31.47.0-255,66,150533,90,186123
8972,0.002044,74.125.130.0-255,2902,153435,90,186123
8973,0.002046,172.31.47.0-255,66,153501,90,186123
8974,0.002076,74.125.130.0-255,8574,162075,90,186123
8975,0.002078,172.31.47.0-255,66,162141,90,186123
8976,0.002085,74.125.130.0-255,7156,169297,90,186123
8977,0.002086,172.31.47.0-255,66,169363,90,186123
8978,0.002104,74.125.130.0-255,766,170129,90,186123
8979,0.004699,74.125.130.0-255,4320,174449,90,186123
8980,0.004702,172.31.47.0-255,66,174515,90,186123
8981,0.007327,74.125.130.0-255,5738,180253,90,186123
8982,0.007338,172.31.47.0-255,66,180319,90,186123
8983,0.009975,74.125.130.0-255,5738,186057,90,186123
8984,0.00999,172.31.47.0-255,66,186123,90,186123
8985,0.0,74.125.130.0-255,66,66,90,66
8986,0.0,172.31.47.0-255,105,105,90,276
8987,0.001483,157.240.13.0-255,105,210,90,276
8988,0.001494,172.31.47.0-255,66,276,90,276
8989,0.0,172.31.47.0-255,105,105,90,210
8990,0.001477,157.240.13.0-255,105,210,90,210
8991,0.0,172.217.194.0-255,153,153,90,179582
8992,3.2e-05,172.31.47.0-255,66,219,90,179582
8993,3.9e-05,172.217.194.0-255,1484,1703,90,179582
8994,4.2e-05,172.31.47.0-255,66,1769,90,179582
8995,4.6e-05,172.217.194.0-255,2902,4671,90,179582
8996,4.8e-05,172.31.47.0-255,66,4737,90,179582
8997,5.4e-05,172.217.194.0-255,7156,11893,90,179582
8998,5.7e-05,172.31.47.0-255,66,11959,90,179582
8999,6.2e-05,172.217.194.0-255,2063,14022,90,179582
9000,6.3e-05,172.31.47.0-255,66,14088,90,179582
9001,0.000159,172.217.194.0-255,1484,15572,90,179582
9002,0.000162,172.31.47.0-255,66,15638,90,179582
9003,0.000166,172.217.194.0-255,1484,17122,90,179582
9004,0.000167,172.31.47.0-255,66,17188,90,179582
9005,0.000187,172.217.194.0-255,1484,18672,90,179582
9006,0.000189,172.31.47.0-255,66,18738,90,179582
9007,0.000197,172.217.194.0-255,5738,24476,90,179582
9008,0.000198,172.31.47.0-255,66,24542,90,179582
9009,0.00022,172.217.194.0-255,7156,31698,90,179582
9010,0.000223,172.31.47.0-255,66,31764,90,179582
9011,0.000254,172.217.194.0-255,6797,38561,90,179582
9012,0.000257,172.31.47.0-255,66,38627,90,179582
9013,0.000264,172.217.194.0-255,8574,47201,90,179582
9014,0.000268,172.31.47.0-255,66,47267,90,179582
9015,0.000316,172.217.194.0-255,8574,55841,90,179582
9016,0.000319,172.31.47.0-255,66,55907,90,179582
9017,0.000341,172.217.194.0-255,9586,65493,90,179582
9018,0.000345,172.31.47.0-255,66,65559,90,179582
9019,0.000428,172.217.194.0-255,364,65923,90,179582
9020,0.000431,172.31.47.0-255,66,65989,90,179582
9021,0.000557,172.217.194.0-255,1484,67473,90,179582
9022,0.000561,172.31.47.0-255,66,67539,90,179582
9023,0.000565,172.217.194.0-255,2902,70441,90,179582
9024,0.000567,172.31.47.0-255,66,70507,90,179582
9025,0.000571,172.217.194.0-255,2902,73409,90,179582
9026,0.000573,172.31.47.0-255,66,73475,90,179582
9027,0.000592,172.217.194.0-255,2902,76377,90,179582
9028,0.000595,172.31.47.0-255,66,76443,90,179582
9029,0.000602,172.217.194.0-255,2902,79345,90,179582
9030,0.000604,172.31.47.0-255,66,79411,90,179582
9031,0.000641,172.31.47.0-255,66,79477,90,179582
9032,0.000649,172.217.194.0-255,9633,89110,90,179582
9033,0.000651,172.31.47.0-255,66,89176,90,179582
9034,0.001601,172.217.194.0-255,1484,90660,90,179582
9035,0.001612,172.217.194.0-255,2902,93562,90,179582
9036,0.001616,172.31.47.0-255,66,93628,90,179582
9037,0.001619,172.217.194.0-255,1484,95112,90,179582
9038,0.001638,172.217.194.0-255,4320,99432,90,179582
9039,0.00164,172.31.47.0-255,66,99498,90,179582
9040,0.001642,172.217.194.0-255,1484,100982,90,179582
9041,0.001645,172.217.194.0-255,1484,102466,90,179582
9042,0.001646,172.31.47.0-255,66,102532,90,179582
9043,0.001671,172.217.194.0-255,1484,104016,90,179582
9044,0.001676,172.217.194.0-255,5738,109754,90,179582
9045,0.001678,172.31.47.0-255,66,109820,90,179582
9046,0.001684,172.217.194.0-255,5738,115558,90,179582
9047,0.001685,172.31.47.0-255,66,115624,90,179582
9048,0.001707,172.217.194.0-255,7156,122780,90,179582
9049,0.001709,172.31.47.0-255,66,122846,90,179582
9050,0.001712,172.217.194.0-255,766,123612,90,179582
9051,0.001767,172.217.194.0-255,2902,126514,90,179582
9052,0.001771,172.31.47.0-255,66,126580,90,179582
9053,0.001795,172.217.194.0-255,8574,135154,90,179582
9054,0.001797,172.31.47.0-255,66,135220,90,179582
9055,0.001808,172.217.194.0-255,2902,138122,90,179582
9056,0.00181,172.31.47.0-255,66,138188,90,179582
9057,0.001815,172.217.194.0-255,5738,143926,90,179582
9058,0.001816,172.31.47.0-255,66,143992,90,179582
9059,0.001835,172.217.194.0-255,9992,153984,90,179582
9060,0.001837,172.31.47.0-255,66,154050,90,179582
9061,0.001841,172.217.194.0-255,3602,157652,90,179582
9062,0.001842,172.31.47.0-255,66,157718,90,179582
9063,0.003813,172.217.194.0-255,4320,162038,90,179582
9064,0.00382,172.31.47.0-255,66,162104,90,179582
9065,0.003841,172.217.194.0-255,1484,163588,90,179582
9066,0.005848,172.217.194.0-255,4320,167908,90,179582
9067,0.005856,172.31.47.0-255,66,167974,90,179582
9068,0.007836,172.217.194.0-255,5738,173712,90,179582
9069,0.007843,172.31.47.0-255,66,173778,90,179582
9070,0.009804,172.217.194.0-255,5738,179516,90,179582
9071,0.00981,172.31.47.0-255,66,179582,90,179582
9072,0.0,172.217.194.0-255,153,153,90,181598
9073,3.3e-05,172.31.47.0-255,66,219,90,181598
9074,4e-05,172.217.194.0-255,1484,1703,90,181598
9075,4.5e-05,172.31.47.0-255,66,1769,90,181598
9076,5e-05,172.217.194.0-255,2902,4671,90,181598
9077,5.3e-05,172.31.47.0-255,66,4737,90,181598
9078,5.9e-05,172.217.194.0-255,4320,9057,90,181598
9079,6.2e-05,172.31.47.0-255,66,9123,90,181598
9080,7.6e-05,172.31.47.0-255,66,9189,90,181598
9081,8.2e-05,172.217.194.0-255,4320,13509,90,181598
9082,8.4e-05,172.31.47.0-255,66,13575,90,181598
9083,0.000102,172.217.194.0-255,5379,18954,90,181598
9084,0.000105,172.31.47.0-255,66,19020,90,181598
9085,0.000207,172.217.194.0-255,1484,20504,90,181598
9086,0.000211,172.31.47.0-255,66,20570,90,181598
9087,0.000217,172.217.194.0-255,2902,23472,90,181598
9088,0.000219,172.31.47.0-255,66,23538,90,181598
9089,0.000222,172.217.194.0-255,1484,25022,90,181598
9090,0.000226,172.31.47.0-255,66,25088,90,181598
9091,0.000244,172.217.194.0-255,1484,26572,90,181598
9092,0.000247,172.31.47.0-255,66,26638,90,181598
9093,0.000255,172.217.194.0-255,7156,33794,90,181598
9094,0.000258,172.31.47.0-255,66,33860,90,181598
9095,0.00029,172.217.194.0-255,5738,39598,90,181598
9096,0.000296,172.31.47.0-255,66,39664,90,181598
9097,0.000312,172.31.47.0-255,66,39730,90,181598
9098,0.000341,172.217.194.0-255,2543,42273,90,181598
9099,0.000345,172.31.47.0-255,66,42339,90,181598
9100,0.000684,172.217.194.0-255,647,42986,90,181598
9101,0.000688,172.31.47.0-255,66,43052,90,181598
9102,0.000838,172.217.194.0-255,1484,44536,90,181598
9103,0.000844,172.217.194.0-255,2902,47438,90,181598
9104,0.000847,172.31.47.0-255,66,47504,90,181598
9105,0.000854,172.217.194.0-255,4320,51824,90,181598
9106,0.000857,172.31.47.0-255,66,51890,90,181598
9107,0.000868,172.217.194.0-255,1484,53374,90,181598
9108,0.000887,172.217.194.0-255,7156,60530,90,181598
9109,0.00089,172.31.47.0-255,66,60596,90,181598
9110,0.000918,172.217.194.0-255,5738,66334,90,181598
9111,0.000921,172.31.47.0-255,66,66400,90,181598
9112,0.000931,172.217.194.0-255,10692,77092,90,181598
9113,0.000934,172.31.47.0-255,66,77158,90,181598
9114,0.000963,172.217.194.0-255,2902,80060,90,181598
9115,0.000968,172.217.194.0-255,4320,84380,90,181598
9116,0.000968,172.31.47.0-255,66,84446,90,181598
9117,0.000971,172.31.47.0-255,66,84512,90,181598
9118,0.000972,172.217.194.0-255,4320,88832,90,181598
9119,0.000974,172.31.47.0-255,66,88898,90,181598
9120,0.00099,172.217.194.0-255,4320,93218,90,181598
9121,0.000993,172.31.47.0-255,66,93284,90,181598
9122,0.001019,172.217.194.0-255,9992,103276,90,181598
9123,0.001022,172.31.47.0-255,66,103342,90,181598
9124,0.001049,172.217.194.0-255,7856,111198,90,181598
9125,0.001052,172.31.47.0-255,66,111264,90,181598
9126,0.001068,172.31.47.0-255,66,111330,90,181598
9127,0.001085,172.31.47.0-255,66,111396,90,181598
9128,0.001108,172.217.194.0-255,1484,112880,90,181598
9129,0.001128,172.217.194.0-255,2902,115782,90,181598
9130,0.001132,172.31.47.0-255,66,115848,90,181598
9131,0.001138,172.217.194.0-255,5738,121586,90,181598
9132,0.00114,172.31.47.0-255,66,121652,90,181598
9133,0.001212,172.31.47.0-255,66,121718,90,181598
9134,0.001215,172.217.194.0-255,10692,132410,90,181598
9135,0.001217,172.31.47.0-255,66,132476,90,181598
9136,0.001246,172.217.194.0-255,4320,136796,90,181598
9137,0.00125,172.31.47.0-255,66,136862,90,181598
9138,0.001267,172.217.194.0-255,7156,144018,90,181598
9139,0.00127,172.31.47.0-255,66,144084,90,181598
9140,0.001283,172.31.47.0-255,66,144150,90,181598
9141,0.001315,172.217.194.0-255,2902,147052,90,181598
9142,0.001318,172.31.47.0-255,66,147118,90,181598
9143,0.001347,172.217.194.0-255,10692,157810,90,181598
9144,0.001351,172.31.47.0-255,66,157876,90,181598
9145,0.001365,172.31.47.0-255,66,157942,90,181598
9146,0.001376,172.217.194.0-255,4320,162262,90,181598
9147,0.001379,172.31.47.0-255,66,162328,90,181598
9148,0.001413,172.31.47.0-255,66,162394,90,181598
9149,0.001433,172.31.47.0-255,66,162460,90,181598
9150,0.00146,172.217.194.0-255,1484,163944,90,181598
9151,0.001468,172.217.194.0-255,6438,170382,90,181598
9152,0.00147,172.31.47.0-255,66,170448,90,181598
9153,0.001474,172.217.194.0-255,2902,173350,90,181598
9154,0.001477,172.31.47.0-255,66,173416,90,181598
9155,0.001505,172.31.47.0-255,66,173482,90,181598
9156,0.00152,172.217.194.0-255,4320,177802,90,181598
9157,0.001523,172.31.47.0-255,66,177868,90,181598
9158,0.001569,172.31.47.0-255,66,177934,90,181598
9159,0.001587,172.31.47.0-255,66,178000,90,181598
9160,0.0016,172.31.47.0-255,66,178066,90,181598
9161,0.001683,172.31.47.0-255,66,178132,90,181598
9162,0.001687,172.217.194.0-255,2902,181034,90,181598
9163,0.001689,172.31.47.0-255,66,181100,90,181598
9164,0.001714,172.31.47.0-255,66,181166,90,181598
9165,0.001728,172.217.194.0-255,105,181271,90,181598
9166,0.007588,172.31.47.0-255,105,181376,90,181598
9167,0.008033,172.31.47.0-255,90,181466,90,181598
9168,0.008045,172.31.47.0-255,66,181532,90,181598
9169,0.00989,172.217.194.0-255,66,181598,90,181598
9170,0.0,172.217.194.0-255,162,162,90,263425
9171,2.8e-05,172.31.47.0-255,66,228,90,263425
9172,3.4e-05,172.217.194.0-255,1484,1712,90,263425
9173,3.8e-05,172.31.47.0-255,66,1778,90,263425
9174,4.4e-05,172.217.194.0-255,2902,4680,90,263425
9175,4.7e-05,172.31.47.0-255,66,4746,90,263425
9176,5.4e-05,172.217.194.0-255,7156,11902,90,263425
9177,5.7e-05,172.31.47.0-255,66,11968,90,263425
9178,8.4e-05,172.217.194.0-255,1975,13943,90,263425
9179,8.7e-05,172.31.47.0-255,66,14009,90,263425
9180,0.000208,172.217.194.0-255,1484,15493,90,263425
9181,0.000212,172.31.47.0-255,66,15559,90,263425
9182,0.000217,172.217.194.0-255,2902,18461,90,263425
9183,0.00022,172.31.47.0-255,66,18527,90,263425
9184,0.00025,172.217.194.0-255,5738,24265,90,263425
9185,0.000253,172.31.47.0-255,66,24331,90,263425
9186,0.000272,172.217.194.0-255,5738,30069,90,263425
9187,0.000275,172.31.47.0-255,66,30135,90,263425
9188,0.000291,172.217.194.0-255,2543,32678,90,263425
9189,0.000295,172.31.47.0-255,66,32744,90,263425
9190,0.000298,172.217.194.0-255,8574,41318,90,263425
9191,0.0003,172.31.47.0-255,66,41384,90,263425
9192,0.000305,172.217.194.0-255,4320,45704,90,263425
9193,0.000308,172.31.47.0-255,66,45770,90,263425
9194,0.00034,172.31.47.0-255,66,45836,90,263425
9195,0.000346,172.217.194.0-255,5020,50856,90,263425
9196,0.000348,172.31.47.0-255,66,50922,90,263425
9197,0.00035,172.217.194.0-255,377,51299,90,263425
9198,0.000352,172.31.47.0-255,66,51365,90,263425
9199,0.000439,172.217.194.0-255,366,51731,90,263425
9200,0.000443,172.31.47.0-255,66,51797,90,263425
9201,0.00047,172.217.194.0-255,1484,53281,90,263425
9202,0.000486,172.217.194.0-255,4320,57601,90,263425
9203,0.000489,172.31.47.0-255,66,57667,90,263425
9204,0.000513,172.217.194.0-255,9992,67659,90,263425
9205,0.000515,172.31.47.0-255,66,67725,90,263425
9206,0.000521,172.217.194.0-255,5738,73463,90,263425
9207,0.000523,172.31.47.0-255,66,73529,90,263425
9208,0.000551,172.217.194.0-255,7156,80685,90,263425
9209,0.000554,172.31.47.0-255,66,80751,90,263425
9210,0.000569,172.217.194.0-255,2902,83653,90,263425
9211,0.000572,172.31.47.0-255,66,83719,90,263425
9212,0.000586,172.217.194.0-255,2184,85903,90,263425
9213,0.00059,172.31.47.0-255,66,85969,90,263425
9214,0.000768,172.217.194.0-255,1484,87453,90,263425
9215,0.000787,172.217.194.0-255,2902,90355,90,263425
9216,0.000791,172.31.47.0-255,66,90421,90,263425
9217,0.000797,172.217.194.0-255,5738,96159,90,263425
9218,0.000799,172.31.47.0-255,66,96225,90,263425
9219,0.000826,172.31.47.0-255,66,96291,90,263425
9220,0.000832,172.217.194.0-255,5738,102029,90,263425
9221,0.000834,172.31.47.0-255,66,102095,90,263425
9222,0.000853,172.217.194.0-255,4320,106415,90,263425
9223,0.000855,172.31.47.0-255,66,106481,90,263425
9224,0.000858,172.217.194.0-255,766,107247,90,263425
9225,0.001162,172.31.47.0-255,66,107313,90,263425
9226,0.001961,172.217.194.0-255,1484,108797,90,263425
9227,0.00197,172.217.194.0-255,2902,111699,90,263425
9228,0.001974,172.31.47.0-255,66,111765,90,263425
9229,0.001988,172.217.194.0-255,5738,117503,90,263425
9230,0.00199,172.31.47.0-255,66,117569,90,263425
9231,0.001994,172.217.194.0-255,2902,120471,90,263425
9232,0.001995,172.31.47.0-255,66,120537,90,263425
9233,0.002006,172.217.194.0-255,2902,123439,90,263425
9234,0.002008,172.31.47.0-255,66,123505,90,263425
9235,0.00201,172.217.194.0-255,1484,124989,90,263425
9236,0.002025,172.217.194.0-255,5738,130727,90,263425
9237,0.002027,172.31.47.0-255,66,130793,90,263425
9238,0.002042,172.217.194.0-255,5738,136531,90,263425
9239,0.002044,172.31.47.0-255,66,136597,90,263425
9240,0.002049,172.217.194.0-255,5020,141617,90,263425
9241,0.00205,172.31.47.0-255,66,141683,90,263425
9242,0.002181,172.217.194.0-255,1484,143167,90,263425
9243,0.002194,172.217.194.0-255,2902,146069,90,263425
9244,0.002196,172.31.47.0-255,66,146135,90,263425
9245,0.002198,172.217.194.0-255,1484,147619,90,263425
9246,0.002213,172.217.194.0-255,2902,150521,90,263425
9247,0.002215,172.31.47.0-255,66,150587,90,263425
9248,0.002219,172.217.194.0-255,2902,153489,90,263425
9249,0.00222,172.31.47.0-255,66,153555,90,263425
9250,0.002234,172.217.194.0-255,5738,159293,90,263425
9251,0.002236,172.31.47.0-255,66,159359,90,263425
9252,0.00226,172.217.194.0-255,1484,160843,90,263425
9253,0.002285,172.31.47.0-255,66,160909,90,263425
9254,0.0023,172.217.194.0-255,2184,163093,90,263425
9255,0.002302,172.31.47.0-255,66,163159,90,263425
9256,0.002309,172.217.194.0-255,8574,171733,90,263425
9257,0.00231,172.31.47.0-255,66,171799,90,263425
9258,0.002339,172.217.194.0-255,8574,180373,90,263425
9259,0.002341,172.31.47.0-255,66,180439,90,263425
9260,0.002348,172.217.194.0-255,9992,190431,90,263425
9261,0.00235,172.31.47.0-255,66,190497,90,263425
9262,0.002361,172.217.194.0-255,1484,191981,90,263425
9263,0.002388,172.31.47.0-255,66,192047,90,263425
9264,0.002444,172.217.194.0-255,9992,202039,90,263425
9265,0.002446,172.31.47.0-255,66,202105,90,263425
9266,0.002466,172.217.194.0-255,4320,206425,90,263425
9267,0.002467,172.31.47.0-255,66,206491,90,263425
9268,0.002478,172.31.47.0-255,66,206557,90,263425
9269,0.00248,172.217.194.0-255,766,207323,90,263425
9270,0.002482,172.217.194.0-255,1484,208807,90,263425
9271,0.002484,172.31.47.0-255,66,208873,90,263425
9272,0.002488,172.217.194.0-255,2902,211775,90,263425
9273,0.002489,172.31.47.0-255,66,211841,90,263425
9274,0.002504,172.217.194.0-255,1484,213325,90,263425
9275,0.002509,172.217.194.0-255,5738,219063,90,263425
9276,0.002511,172.31.47.0-255,66,219129,90,263425
9277,0.002533,172.217.194.0-255,4320,223449,90,263425
9278,0.002535,172.31.47.0-255,66,223515,90,263425
9279,0.002542,172.217.194.0-255,8574,232089,90,263425
9280,0.002544,172.31.47.0-255,66,232155,90,263425
9281,0.002554,172.217.194.0-255,1484,233639,90,263425
9282,0.002558,172.217.194.0-255,4320,237959,90,263425
9283,0.00256,172.31.47.0-255,66,238025,90,263425
9284,0.002589,172.217.194.0-255,7856,245881,90,263425
9285,0.002591,172.31.47.0-255,66,245947,90,263425
9286,0.002601,172.31.47.0-255,66,246013,90,263425
9287,0.002613,172.217.194.0-255,5738,251751,90,263425
9288,0.002614,172.31.47.0-255,66,251817,90,263425
9289,0.005161,172.217.194.0-255,5738,257555,90,263425
9290,0.005167,172.31.47.0-255,66,257621,90,263425
9291,0.007734,172.217.194.0-255,5738,263359,90,263425
9292,0.007739,172.31.47.0-255,66,263425,90,263425
9293,0.0,172.31.47.0-255,105,105,90,105
9294,0.0,172.217.194.0-255,146,146,90,250756
9295,3.6e-05,172.31.47.0-255,66,212,90,250756
9296,4.2e-05,172.217.194.0-255,1484,1696,90,250756
9297,4.7e-05,172.31.47.0-255,66,1762,90,250756
9298,5.2e-05,172.217.194.0-255,2902,4664,90,250756
9299,6.2e-05,172.31.47.0-255,66,4730,90,250756
9300,7e-05,172.217.194.0-255,7156,11886,90,250756
9301,7.2e-05,172.31.47.0-255,66,11952,90,250756
9302,8.1e-05,172.217.194.0-255,9992,21944,90,250756
9303,8.4e-05,172.31.47.0-255,66,22010,90,250756
9304,0.000124,172.217.194.0-255,6437,28447,90,250756
9305,0.000127,172.31.47.0-255,66,28513,90,250756
9306,0.000131,172.217.194.0-255,2543,31056,90,250756
9307,0.000134,172.31.47.0-255,66,31122,90,250756
9308,0.000137,172.217.194.0-255,1484,32606,90,250756
9309,0.000138,172.31.47.0-255,66,32672,90,250756
9310,0.000149,172.217.194.0-255,2902,35574,90,250756
9311,0.000151,172.31.47.0-255,66,35640,90,250756
9312,0.000159,172.217.194.0-255,5738,41378,90,250756
9313,0.000163,172.31.47.0-255,66,41444,90,250756
9314,0.000203,172.31.47.0-255,66,41510,90,250756
9315,0.000228,172.217.194.0-255,1125,42635,90,250756
9316,0.000231,172.31.47.0-255,66,42701,90,250756
9317,0.000236,172.217.194.0-255,4320,47021,90,250756
9318,0.000239,172.31.47.0-255,66,47087,90,250756
9319,0.000267,172.217.194.0-255,5667,52754,90,250756
9320,0.00027,172.31.47.0-255,66,52820,90,250756
9321,0.000659,172.217.194.0-255,98,52918,90,250756
9322,0.000664,172.31.47.0-255,66,52984,90,250756
9323,0.000756,172.217.194.0-255,1484,54468,90,250756
9324,0.00076,172.31.47.0-255,66,54534,90,250756
9325,0.000766,172.217.194.0-255,2902,57436,90,250756
9326,0.00077,172.217.194.0-255,1484,58920,90,250756
9327,0.000776,172.31.47.0-255,66,58986,90,250756
9328,0.000794,172.217.194.0-255,4320,63306,90,250756
9329,0.000804,172.31.47.0-255,66,63372,90,250756
9330,0.000813,172.217.194.0-255,8574,71946,90,250756
9331,0.000819,172.31.47.0-255,66,72012,90,250756
9332,0.000848,172.217.194.0-255,5379,77391,90,250756
9333,0.000852,172.217.194.0-255,1484,78875,90,250756
9334,0.000854,172.217.194.0-255,1484,80359,90,250756
9335,0.000856,172.31.47.0-255,66,80425,90,250756
9336,0.00087,172.217.194.0-255,6797,87222,90,250756
9337,0.000877,172.31.47.0-255,66,87288,90,250756
9338,0.000971,172.217.194.0-255,1484,88772,90,250756
9339,0.000977,172.217.194.0-255,2902,91674,90,250756
9340,0.000982,172.31.47.0-255,66,91740,90,250756
9341,0.00101,172.217.194.0-255,1484,93224,90,250756
9342,0.001029,172.217.194.0-255,4320,97544,90,250756
9343,0.001035,172.31.47.0-255,66,97610,90,250756
9344,0.001047,172.217.194.0-255,9992,107602,90,250756
9345,0.00105,172.31.47.0-255,66,107668,90,250756
9346,0.001055,172.31.47.0-255,66,107734,90,250756
9347,0.001067,172.217.194.0-255,766,108500,90,250756
9348,0.001196,172.217.194.0-255,1484,109984,90,250756
9349,0.0012,172.31.47.0-255,66,110050,90,250756
9350,0.001205,172.217.194.0-255,2902,112952,90,250756
9351,0.00121,172.217.194.0-255,2902,115854,90,250756
9352,0.001215,172.31.47.0-255,66,115920,90,250756
9353,0.001237,172.217.194.0-255,2902,118822,90,250756
9354,0.001242,172.31.47.0-255,66,118888,90,250756
9355,0.001245,172.217.194.0-255,8574,127462,90,250756
9356,0.001247,172.31.47.0-255,66,127528,90,250756
9357,0.001281,172.217.194.0-255,4320,131848,90,250756
9358,0.001291,172.31.47.0-255,66,131914,90,250756
9359,0.001314,172.217.194.0-255,10692,142606,90,250756
9360,0.001323,172.31.47.0-255,66,142672,90,250756
9361,0.001521,172.217.194.0-255,1484,144156,90,250756
9362,0.001539,172.217.194.0-255,2902,147058,90,250756
9363,0.001543,172.31.47.0-255,66,147124,90,250756
9364,0.001549,172.217.194.0-255,4320,151444,90,250756
9365,0.001559,172.31.47.0-255,66,151510,90,250756
9366,0.001571,172.217.194.0-255,1484,152994,90,250756
9367,0.001585,172.217.194.0-255,9992,162986,90,250756
9368,0.001591,172.31.47.0-255,66,163052,90,250756
9369,0.0016,172.217.194.0-255,1484,164536,90,250756
9370,0.001624,172.31.47.0-255,66,164602,90,250756
9371,0.001656,172.217.194.0-255,1484,166086,90,250756
9372,0.001662,172.217.194.0-255,2902,168988,90,250756
9373,0.00167,172.31.47.0-255,66,169054,90,250756
9374,0.001675,172.217.194.0-255,2902,171956,90,250756
9375,0.001686,172.31.47.0-255,66,172022,90,250756
9376,0.001696,172.217.194.0-255,2902,174924,90,250756
9377,0.001701,172.31.47.0-255,66,174990,90,250756
9378,0.001715,172.217.194.0-255,4320,179310,90,250756
9379,0.001727,172.31.47.0-255,66,179376,90,250756
9380,0.001745,172.217.194.0-255,8574,187950,90,250756
9381,0.001755,172.31.47.0-255,66,188016,90,250756
9382,0.001789,172.31.47.0-255,66,188082,90,250756
9383,0.001808,172.217.194.0-255,766,188848,90,250756
9384,0.001846,172.217.194.0-255,2184,191032,90,250756
9385,0.00185,172.31.47.0-255,66,191098,90,250756
9386,0.001854,172.31.47.0-255,66,191164,90,250756
9387,0.001887,172.217.194.0-255,1484,192648,90,250756
9388,0.001893,172.217.194.0-255,2902,195550,90,250756
9389,0.001898,172.217.194.0-255,4320,199870,90,250756
9390,0.001901,172.31.47.0-255,66,199936,90,250756
9391,0.001906,172.31.47.0-255,66,200002,90,250756
9392,0.001909,172.217.194.0-255,1484,201486,90,250756
9393,0.001951,172.31.47.0-255,66,201552,90,250756
9394,0.002003,172.217.194.0-255,10692,212244,90,250756
9395,0.002012,172.31.47.0-255,66,212310,90,250756
9396,0.002021,172.217.194.0-255,5738,218048,90,250756
9397,0.002028,172.31.47.0-255,66,218114,90,250756
9398,0.002042,172.217.194.0-255,5738,223852,90,250756
9399,0.002046,172.31.47.0-255,66,223918,90,250756
9400,0.002094,172.31.47.0-255,66,223984,90,250756
9401,0.002104,172.217.194.0-255,7156,231140,90,250756
9402,0.00212,172.31.47.0-255,66,231206,90,250756
9403,0.002142,172.217.194.0-255,5738,236944,90,250756
9404,0.002154,172.31.47.0-255,66,237010,90,250756
9405,0.002204,172.31.47.0-255,66,237076,90,250756
9406,0.002215,172.217.194.0-255,9992,247068,90,250756
9407,0.00222,172.31.47.0-255,66,247134,90,250756
9408,0.00224,172.217.194.0-255,3280,250414,90,250756
9409,0.002246,172.31.47.0-255,66,250480,90,250756
9410,0.002248,172.217.194.0-255,105,250585,90,250756
9411,0.00824,172.31.47.0-255,66,250651,90,250756
9412,0.008272,172.31.47.0-255,105,250756,90,250756
9413,0.0,74.125.68.0-255,153,153,90,397842
9414,2.9e-05,172.31.47.0-255,66,219,90,397842
9415,3.6e-05,74.125.68.0-255,1484,1703,90,397842
9416,4e-05,172.31.47.0-255,66,1769,90,397842
9417,4.2e-05,74.125.68.0-255,1484,3253,90,397842
9418,4.4e-05,172.31.47.0-255,66,3319,90,397842
9419,4.9e-05,74.125.68.0-255,2902,6221,90,397842
9420,5.8e-05,172.31.47.0-255,66,6287,90,397842
9421,6.2e-05,74.125.68.0-255,2902,9189,90,397842
9422,6.5e-05,172.31.47.0-255,66,9255,90,397842
9423,8.5e-05,74.125.68.0-255,2902,12157,90,397842
9424,8.8e-05,172.31.47.0-255,66,12223,90,397842
9425,9.3e-05,74.125.68.0-255,1994,14217,90,397842
9426,0.0001,172.31.47.0-255,66,14283,90,397842
9427,0.000141,74.125.68.0-255,2902,17185,90,397842
9428,0.000144,172.31.47.0-255,66,17251,90,397842
9429,0.00015,74.125.68.0-255,4320,21571,90,397842
9430,0.000153,172.31.47.0-255,66,21637,90,397842
9431,0.000181,74.125.68.0-255,7156,28793,90,397842
9432,0.000183,172.31.47.0-255,66,28859,90,397842
9433,0.000209,74.125.68.0-255,1484,30343,90,397842
9434,0.000212,172.31.47.0-255,66,30409,90,397842
9435,0.000215,74.125.68.0-255,1125,31534,90,397842
9436,0.000216,172.31.47.0-255,66,31600,90,397842
9437,0.000354,74.125.68.0-255,1484,33084,90,397842
9438,0.000358,172.31.47.0-255,66,33150,90,397842
9439,0.000378,74.125.68.0-255,2902,36052,90,397842
9440,0.000385,172.31.47.0-255,66,36118,90,397842
9441,0.000395,74.125.68.0-255,4320,40438,90,397842
9442,0.000401,172.31.47.0-255,66,40504,90,397842
9443,0.000423,74.125.68.0-255,1484,41988,90,397842
9444,0.000426,172.31.47.0-255,66,42054,90,397842
9445,0.000431,74.125.68.0-255,2902,44956,90,397842
9446,0.000438,172.31.47.0-255,66,45022,90,397842
9447,0.000457,74.125.68.0-255,3961,48983,90,397842
9448,0.000469,172.31.47.0-255,66,49049,90,397842
9449,0.000489,74.125.68.0-255,1484,50533,90,397842
9450,0.000512,74.125.68.0-255,2902,53435,90,397842
9451,0.000521,172.31.47.0-255,66,53501,90,397842
9452,0.000545,74.125.68.0-255,1484,54985,90,397842
9453,0.000558,74.125.68.0-255,2902,57887,90,397842
9454,0.00056,172.31.47.0-255,66,57953,90,397842
9455,0.000586,74.125.68.0-255,5738,63691,90,397842
9456,0.00059,74.125.68.0-255,2543,66234,90,397842
9457,0.000591,172.31.47.0-255,66,66300,90,397842
9458,0.000595,172.31.47.0-255,66,66366,90,397842
9459,0.00063,74.125.68.0-255,646,67012,90,397842
9460,0.000666,74.125.68.0-255,1484,68496,90,397842
9461,0.000672,172.31.47.0-255,66,68562,90,397842
9462,0.000696,74.125.68.0-255,1484,70046,90,397842
9463,0.000716,74.125.68.0-255,2902,72948,90,397842
9464,0.00072,172.31.47.0-255,66,73014,90,397842
9465,0.000741,74.125.68.0-255,5738,78752,90,397842
9466,0.000744,74.125.68.0-255,1484,80236,90,397842
9467,0.000755,74.125.68.0-255,3412,83648,90,397842
9468,0.000756,172.31.47.0-255,66,83714,90,397842
9469,0.00076,172.31.47.0-255,66,83780,90,397842
9470,0.00079,74.125.68.0-255,1484,85264,90,397842
9471,0.000806,74.125.68.0-255,2902,88166,90,397842
9472,0.000811,172.31.47.0-255,66,88232,90,397842
9473,0.000837,74.125.68.0-255,5738,93970,90,397842
9474,0.00084,74.125.68.0-255,1484,95454,90,397842
9475,0.000844,172.31.47.0-255,66,95520,90,397842
9476,0.000868,74.125.68.0-255,1484,97004,90,397842
9477,0.000873,74.125.68.0-255,3961,100965,90,397842
9478,0.000881,172.31.47.0-255,66,101031,90,397842
9479,0.001091,74.125.68.0-255,1484,102515,90,397842
9480,0.001098,74.125.68.0-255,1484,103999,90,397842
9481,0.001101,172.31.47.0-255,66,104065,90,397842
9482,0.001125,74.125.68.0-255,2902,106967,90,397842
9483,0.001132,74.125.68.0-255,5738,112705,90,397842
9484,0.001157,74.125.68.0-255,4320,117025,90,397842
9485,0.001167,74.125.68.0-255,1484,118509,90,397842
9486,0.001215,74.125.68.0-255,2902,121411,90,397842
9487,0.00123,74.125.68.0-255,4320,125731,90,397842
9488,0.001234,74.125.68.0-255,2902,128633,90,397842
9489,0.00127,74.125.68.0-255,2902,131535,90,397842
9490,0.00129,74.125.68.0-255,3602,135137,90,397842
9491,0.001356,74.125.68.0-255,1484,136621,90,397842
9492,0.001367,74.125.68.0-255,2902,139523,90,397842
9493,0.001385,74.125.68.0-255,1484,141007,90,397842
9494,0.00139,74.125.68.0-255,2902,143909,90,397842
9495,0.001402,74.125.68.0-255,2902,146811,90,397842
9496,0.001413,74.125.68.0-255,2902,149713,90,397842
9497,0.001416,74.125.68.0-255,1484,151197,90,397842
9498,0.001434,74.125.68.0-255,2902,154099,90,397842
9499,0.001476,74.125.68.0-255,2902,157001,90,397842
9500,0.00149,74.125.68.0-255,8574,165575,90,397842
9501,0.001495,74.125.68.0-255,3602,169177,90,397842
9502,0.00159,74.125.68.0-255,1484,170661,90,397842
9503,0.001602,74.125.68.0-255,2902,173563,90,397842
9504,0.001623,74.125.68.0-255,1484,175047,90,397842
9505,0.001652,74.125.68.0-255,1484,176531,90,397842
9506,0.001666,74.125.68.0-255,1484,178015,90,397842
9507,0.001676,74.125.68.0-255,1484,179499,90,397842
9508,0.0017,74.125.68.0-255,1484,180983,90,397842
9509,0.001714,74.125.68.0-255,1484,182467,90,397842
9510,0.001725,74.125.68.0-255,1484,183951,90,397842
9511,0.001748,74.125.68.0-255,1484,185435,90,397842
9512,0.00176,74.125.68.0-255,1484,186919,90,397842
9513,0.001774,74.125.68.0-255,1484,188403,90,397842
9514,0.001783,74.125.68.0-255,1484,189887,90,397842
9515,0.001809,74.125.68.0-255,2902,192789,90,397842
9516,0.001821,74.125.68.0-255,1484,194273,90,397842
9517,0.001841,74.125.68.0-255,1484,195757,90,397842
9518,0.001871,74.125.68.0-255,1484,197241,90,397842
9519,0.001902,74.125.68.0-255,2902,200143,90,397842
9520,0.00192,74.125.68.0-255,1484,201627,90,397842
9521,0.001945,74.125.68.0-255,2184,203811,90,397842
9522,0.002095,74.125.68.0-255,1484,205295,90,397842
9523,0.002115,74.125.68.0-255,2902,208197,90,397842
9524,0.002131,74.125.68.0-255,1484,209681,90,397842
9525,0.002143,74.125.68.0-255,2902,212583,90,397842
9526,0.002146,74.125.68.0-255,2902,215485,90,397842
9527,0.002158,74.125.68.0-255,2902,218387,90,397842
9528,0.002166,74.125.68.0-255,1484,219871,90,397842
9529,0.002185,74.125.68.0-255,9992,229863,90,397842
9530,0.002196,74.125.68.0-255,4320,234183,90,397842
9531,0.002246,74.125.68.0-255,3602,237785,90,397842
9532,0.002345,74.125.68.0-255,1484,239269,90,397842
9533,0.002371,74.125.68.0-255,2902,242171,90,397842
9534,0.002384,74.125.68.0-255,2902,245073,90,397842
9535,0.002404,74.125.68.0-255,4320,249393,90,397842
9536,0.00243,74.125.68.0-255,1484,250877,90,397842
9537,0.002446,74.125.68.0-255,4320,255197,90,397842
9538,0.002466,74.125.68.0-255,2902,258099,90,397842
9539,0.00247,74.125.68.0-255,4320,262419,90,397842
9540,0.002473,74.125.68.0-255,2902,265321,90,397842
9541,0.002475,74.125.68.0-255,1484,266805,90,397842
9542,0.00253,74.125.68.0-255,5020,271825,90,397842
9543,0.002541,172.31.47.0-255,66,271891,90,397842
9544,0.002813,74.125.68.0-255,1484,273375,90,397842
9545,0.002821,74.125.68.0-255,2902,276277,90,397842
9546,0.002826,74.125.68.0-255,4320,280597,90,397842
9547,0.002829,172.31.47.0-255,66,280663,90,397842
9548,0.002835,172.31.47.0-255,66,280729,90,397842
9549,0.002846,74.125.68.0-255,1484,282213,90,397842
9550,0.002874,74.125.68.0-255,8574,290787,90,397842
9551,0.00288,74.125.68.0-255,4320,295107,90,397842
9552,0.002887,172.31.47.0-255,66,295173,90,397842
9553,0.002894,74.125.68.0-255,1484,296657,90,397842
9554,0.002924,74.125.68.0-255,8574,305231,90,397842
9555,0.002927,74.125.68.0-255,766,305997,90,397842
9556,0.002931,172.31.47.0-255,66,306063,90,397842
9557,0.002965,74.125.68.0-255,1484,307547,90,397842
9558,0.002971,74.125.68.0-255,2902,310449,90,397842
9559,0.00298,172.31.47.0-255,66,310515,90,397842
9560,0.002982,74.125.68.0-255,1484,311999,90,397842
9561,0.003003,74.125.68.0-255,4320,316319,90,397842
9562,0.003006,74.125.68.0-255,1484,317803,90,397842
9563,0.003007,172.31.47.0-255,66,317869,90,397842
9564,0.003009,74.125.68.0-255,2902,320771,90,397842
9565,0.003013,74.125.68.0-255,4320,325091,90,397842
9566,0.00302,172.31.47.0-255,66,325157,90,397842
9567,0.00304,74.125.68.0-255,5738,330895,90,397842
9568,0.003047,74.125.68.0-255,4320,335215,90,397842
9569,0.003047,172.31.47.0-255,66,335281,90,397842
9570,0.003054,172.31.47.0-255,66,335347,90,397842
9571,0.003066,74.125.68.0-255,1484,336831,90,397842
9572,0.003077,74.125.68.0-255,2902,339733,90,397842
9573,0.003088,172.31.47.0-255,66,339799,90,397842
9574,0.003094,74.125.68.0-255,766,340565,90,397842
9575,0.00316,74.125.68.0-255,1484,342049,90,397842
9576,0.003173,172.31.47.0-255,66,342115,90,397842
9577,0.003174,74.125.68.0-255,1484,343599,90,397842
9578,0.003184,74.125.68.0-255,1484,345083,90,397842
9579,0.003189,172.31.47.0-255,66,345149,90,397842
9580,0.003219,74.125.68.0-255,4320,349469,90,397842
9581,0.003225,74.125.68.0-255,5738,355207,90,397842
9582,0.003226,172.31.47.0-255,66,355273,90,397842
9583,0.003231,172.31.47.0-255,66,355339,90,397842
9584,0.003272,172.31.47.0-255,66,355405,90,397842
9585,0.003277,74.125.68.0-255,4320,359725,90,397842
9586,0.003288,172.31.47.0-255,66,359791,90,397842
9587,0.003315,74.125.68.0-255,3602,363393,90,397842
9588,0.003325,172.31.47.0-255,66,363459,90,397842
9589,0.003336,74.125.68.0-255,4320,367779,90,397842
9590,0.003344,172.31.47.0-255,66,367845,90,397842
9591,0.003374,74.125.68.0-255,8574,376419,90,397842
9592,0.003378,172.31.47.0-255,66,376485,90,397842
9593,0.00339,74.125.68.0-255,4320,380805,90,397842
9594,0.003402,172.31.47.0-255,66,380871,90,397842
9595,0.003411,74.125.68.0-255,5738,386609,90,397842
9596,0.003419,172.31.47.0-255,66,386675,90,397842
9597,0.00342,74.125.68.0-255,2902,389577,90,397842
9598,0.003423,74.125.68.0-255,1484,391061,90,397842
9599,0.003434,172.31.47.0-255,66,391127,90,397842
9600,0.003447,74.125.68.0-255,2902,394029,90,397842
9601,0.00345,74.125.68.0-255,1484,395513,90,397842
9602,0.00346,172.31.47.0-255,66,395579,90,397842
9603,0.003476,74.125.68.0-255,1855,397434,90,397842
9604,0.00348,172.31.47.0-255,66,397500,90,397842
9605,0.003521,74.125.68.0-255,105,397605,90,397842
9606,0.004857,172.31.47.0-255,66,397671,90,397842
9607,0.004884,172.31.47.0-255,105,397776,90,397842
9608,0.007174,74.125.68.0-255,66,397842,90,397842
9609,0.0,74.125.130.0-255,143,143,90,244285
9610,2.2e-05,172.31.47.0-255,66,209,90,244285
9611,2.9e-05,74.125.130.0-255,1484,1693,90,244285
9612,3.4e-05,172.31.47.0-255,66,1759,90,244285
9613,6.5e-05,74.125.130.0-255,2902,4661,90,244285
9614,6.8e-05,172.31.47.0-255,66,4727,90,244285
9615,7.1e-05,74.125.130.0-255,1484,6211,90,244285
9616,7.3e-05,172.31.47.0-255,66,6277,90,244285
9617,8.7e-05,74.125.130.0-255,2902,9179,90,244285
9618,9e-05,172.31.47.0-255,66,9245,90,244285
9619,0.000115,74.125.130.0-255,1484,10729,90,244285
9620,0.000117,172.31.47.0-255,66,10795,90,244285
9621,0.000138,74.125.130.0-255,3437,14232,90,244285
9622,0.000141,172.31.47.0-255,66,14298,90,244285
9623,0.000252,74.125.130.0-255,1484,15782,90,244285
9624,0.000255,172.31.47.0-255,66,15848,90,244285
9625,0.000268,74.125.130.0-255,2902,18750,90,244285
9626,0.000271,172.31.47.0-255,66,18816,90,244285
9627,0.000293,74.125.130.0-255,4320,23136,90,244285
9628,0.000296,172.31.47.0-255,66,23202,90,244285
9629,0.000312,74.125.130.0-255,1484,24686,90,244285
9630,0.000314,172.31.47.0-255,66,24752,90,244285
9631,0.000318,74.125.130.0-255,2902,27654,90,244285
9632,0.00032,172.31.47.0-255,66,27720,90,244285
9633,0.000334,74.125.130.0-255,3961,31681,90,244285
9634,0.000336,172.31.47.0-255,66,31747,90,244285
9635,0.00039,74.125.130.0-255,1484,33231,90,244285
9636,0.000392,172.31.47.0-255,66,33297,90,244285
9637,0.000411,74.125.130.0-255,2902,36199,90,244285
9638,0.000413,172.31.47.0-255,66,36265,90,244285
9639,0.000449,74.125.130.0-255,4320,40585,90,244285
9640,0.000451,172.31.47.0-255,66,40651,90,244285
9641,0.000465,74.125.130.0-255,1484,42135,90,244285
9642,0.000479,74.125.130.0-255,4320,46455,90,244285
9643,0.000481,172.31.47.0-255,66,46521,90,244285
9644,0.000539,74.125.130.0-255,2543,49064,90,244285
9645,0.000542,172.31.47.0-255,66,49130,90,244285
9646,0.000617,74.125.130.0-255,1484,50614,90,244285
9647,0.000628,74.125.130.0-255,1484,52098,90,244285
9648,0.00063,172.31.47.0-255,66,52164,90,244285
9649,0.000643,74.125.130.0-255,2902,55066,90,244285
9650,0.000645,172.31.47.0-255,66,55132,90,244285
9651,0.000658,74.125.130.0-255,2902,58034,90,244285
9652,0.00066,172.31.47.0-255,66,58100,90,244285
9653,0.000674,74.125.130.0-255,2902,61002,90,244285
9654,0.000676,172.31.47.0-255,66,61068,90,244285
9655,0.000679,74.125.130.0-255,1484,62552,90,244285
9656,0.000701,74.125.130.0-255,3961,66513,90,244285
9657,0.000704,172.31.47.0-255,66,66579,90,244285
9658,0.000843,74.125.130.0-255,1484,68063,90,244285
9659,0.000857,74.125.130.0-255,2902,70965,90,244285
9660,0.00086,172.31.47.0-255,66,71031,90,244285
9661,0.000888,74.125.130.0-255,2902,73933,90,244285
9662,0.000891,172.31.47.0-255,66,73999,90,244285
9663,0.000907,74.125.130.0-255,2902,76901,90,244285
9664,0.000909,172.31.47.0-255,66,76967,90,244285
9665,0.000924,74.125.130.0-255,2902,79869,90,244285
9666,0.000926,172.31.47.0-255,66,79935,90,244285
9667,0.000947,74.125.130.0-255,4218,84153,90,244285
9668,0.000949,172.31.47.0-255,66,84219,90,244285
9669,0.000952,74.125.130.0-255,1484,85703,90,244285
9670,0.000988,74.125.130.0-255,2902,88605,90,244285
9671,0.00099,172.31.47.0-255,66,88671,90,244285
9672,0.000993,74.125.130.0-255,1484,90155,90,244285
9673,0.001006,74.125.130.0-255,1484,91639,90,244285
9674,0.001008,172.31.47.0-255,66,91705,90,244285
9675,0.001013,74.125.130.0-255,4320,96025,90,244285
9676,0.001015,172.31.47.0-255,66,96091,90,244285
9677,0.001054,74.125.130.0-255,7156,103247,90,244285
9678,0.001057,172.31.47.0-255,66,103313,90,244285
9679,0.001072,74.125.130.0-255,1484,104797,90,244285
9680,0.001089,74.125.130.0-255,5738,110535,90,244285
9681,0.001092,172.31.47.0-255,66,110601,90,244285
9682,0.001111,74.125.130.0-255,4320,114921,90,244285
9683,0.001113,172.31.47.0-255,66,114987,90,244285
9684,0.001116,74.125.130.0-255,1484,116471,90,244285
9685,0.001149,74.125.130.0-255,1818,118289,90,244285
9686,0.001151,172.31.47.0-255,66,118355,90,244285
9687,0.001205,74.125.130.0-255,1484,119839,90,244285
9688,0.001231,74.125.130.0-255,2902,122741,90,244285
9689,0.001234,172.31.47.0-255,66,122807,90,244285
9690,0.001255,74.125.130.0-255,2902,125709,90,244285
9691,0.001257,172.31.47.0-255,66,125775,90,244285
9692,0.001269,74.125.130.0-255,1484,127259,90,244285
9693,0.001284,74.125.130.0-255,2902,130161,90,244285
9694,0.001286,172.31.47.0-255,66,130227,90,244285
9695,0.001305,74.125.130.0-255,4320,134547,90,244285
9696,0.001317,172.31.47.0-255,66,134613,90,244285
9697,0.001333,74.125.130.0-255,1252,135865,90,244285
9698,0.001405,74.125.130.0-255,1484,137349,90,244285
9699,0.001408,172.31.47.0-255,66,137415,90,244285
9700,0.001412,74.125.130.0-255,1484,138899,90,244285
9701,0.001427,74.125.130.0-255,1484,140383,90,244285
9702,0.001429,172.31.47.0-255,66,140449,90,244285
9703,0.001454,74.125.130.0-255,5738,146187,90,244285
9704,0.001457,172.31.47.0-255,66,146253,90,244285
9705,0.001461,74.125.130.0-255,2902,149155,90,244285
9706,0.001463,172.31.47.0-255,66,149221,90,244285
9707,0.001485,74.125.130.0-255,4320,153541,90,244285
9708,0.001487,172.31.47.0-255,66,153607,90,244285
9709,0.001503,74.125.130.0-255,5738,159345,90,244285
9710,0.001505,74.125.130.0-255,1484,160829,90,244285
9711,0.001509,172.31.47.0-255,66,160895,90,244285
9712,0.001526,74.125.130.0-255,2902,163797,90,244285
9713,0.001528,172.31.47.0-255,66,163863,90,244285
9714,0.001531,74.125.130.0-255,1484,165347,90,244285
9715,0.001549,74.125.130.0-255,4320,169667,90,244285
9716,0.001552,172.31.47.0-255,66,169733,90,244285
9717,0.001554,74.125.130.0-255,766,170499,90,244285
9718,0.001864,74.125.130.0-255,1484,171983,90,244285
9719,0.001868,172.31.47.0-255,66,172049,90,244285
9720,0.001872,74.125.130.0-255,1484,173533,90,244285
9721,0.001887,74.125.130.0-255,1484,175017,90,244285
9722,0.001889,172.31.47.0-255,66,175083,90,244285
9723,0.001892,74.125.130.0-255,1484,176567,90,244285
9724,0.001908,74.125.130.0-255,4320,180887,90,244285
9725,0.001909,172.31.47.0-255,66,180953,90,244285
9726,0.001914,74.125.130.0-255,2902,183855,90,244285
9727,0.001915,172.31.47.0-255,66,183921,90,244285
9728,0.001918,74.125.130.0-255,1484,185405,90,244285
9729,0.001938,74.125.130.0-255,2902,188307,90,244285
9730,0.00194,172.31.47.0-255,66,188373,90,244285
9731,0.001945,74.125.130.0-255,4320,192693,90,244285
9732,0.001947,172.31.47.0-255,66,192759,90,244285
9733,0.001961,74.125.130.0-255,4320,197079,90,244285
9734,0.001963,172.31.47.0-255,66,197145,90,244285
9735,0.001968,74.125.130.0-255,2902,200047,90,244285
9736,0.00197,172.31.47.0-255,66,200113,90,244285
9737,0.001973,74.125.130.0-255,1484,201597,90,244285
9738,0.001997,74.125.130.0-255,2902,204499,90,244285
9739,0.001999,172.31.47.0-255,66,204565,90,244285
9740,0.002002,74.125.130.0-255,766,205331,90,244285
9741,0.002106,74.125.130.0-255,1484,206815,90,244285
9742,0.002109,74.125.130.0-255,1484,208299,90,244285
9743,0.002113,172.31.47.0-255,66,208365,90,244285
9744,0.002121,74.125.130.0-255,1484,209849,90,244285
9745,0.002123,172.31.47.0-255,66,209915,90,244285
9746,0.002127,74.125.130.0-255,2902,212817,90,244285
9747,0.002129,172.31.47.0-255,66,212883,90,244285
9748,0.002145,74.125.130.0-255,2902,215785,90,244285
9749,0.002147,172.31.47.0-255,66,215851,90,244285
9750,0.002187,172.31.47.0-255,66,215917,90,244285
9751,0.002222,74.125.130.0-255,4320,220237,90,244285
9752,0.002225,172.31.47.0-255,66,220303,90,244285
9753,0.002241,74.125.130.0-255,6438,226741,90,244285
9754,0.002242,172.31.47.0-255,66,226807,90,244285
9755,0.002381,74.125.130.0-255,1484,228291,90,244285
9756,0.00458,74.125.130.0-255,4320,232611,90,244285
9757,0.00459,172.31.47.0-255,66,232677,90,244285
9758,0.006942,74.125.130.0-255,5738,238415,90,244285
9759,0.006953,172.31.47.0-255,66,238481,90,244285
9760,0.009306,74.125.130.0-255,5738,244219,90,244285
9761,0.009322,172.31.47.0-255,66,244285,90,244285
9762,0.0,172.217.194.0-255,152,152,90,91422
9763,2.4e-05,172.31.47.0-255,66,218,90,91422
9764,3e-05,172.217.194.0-255,1484,1702,90,91422
9765,3.5e-05,172.31.47.0-255,66,1768,90,91422
9766,4.8e-05,172.217.194.0-255,2902,4670,90,91422
9767,5.3e-05,172.31.47.0-255,66,4736,90,91422
9768,6e-05,172.217.194.0-255,7156,11892,90,91422
9769,6.4e-05,172.31.47.0-255,66,11958,90,91422
9770,6.8e-05,172.217.194.0-255,2100,14058,90,91422
9771,7.1e-05,172.31.47.0-255,66,14124,90,91422
9772,0.000101,172.217.194.0-255,5738,19862,90,91422
9773,0.000104,172.31.47.0-255,66,19928,90,91422
9774,0.000112,172.217.194.0-255,7156,27084,90,91422
9775,0.000115,172.31.47.0-255,66,27150,90,91422
9776,0.000142,172.217.194.0-255,3961,31111,90,91422
9777,0.000145,172.31.47.0-255,66,31177,90,91422
9778,0.000303,172.217.194.0-255,1484,32661,90,91422
9779,0.000308,172.31.47.0-255,66,32727,90,91422
9780,0.000342,172.217.194.0-255,2902,35629,90,91422
9781,0.000345,172.31.47.0-255,66,35695,90,91422
9782,0.000351,172.217.194.0-255,5738,41433,90,91422
9783,0.000353,172.31.47.0-255,66,41499,90,91422
9784,0.000417,172.31.47.0-255,66,41565,90,91422
9785,0.00042,172.217.194.0-255,1484,43049,90,91422
9786,0.000422,172.31.47.0-255,66,43115,90,91422
9787,0.000457,172.217.194.0-255,8215,51330,90,91422
9788,0.00046,172.31.47.0-255,66,51396,90,91422
9789,0.001155,172.217.194.0-255,364,51760,90,91422
9790,0.001161,172.31.47.0-255,66,51826,90,91422
9791,0.001188,172.217.194.0-255,378,52204,90,91422
9792,0.00119,172.31.47.0-255,66,52270,90,91422
9793,0.001619,172.217.194.0-255,1484,53754,90,91422
9794,0.001641,172.217.194.0-255,2902,56656,90,91422
9795,0.001645,172.31.47.0-255,66,56722,90,91422
9796,0.00165,172.217.194.0-255,1484,58206,90,91422
9797,0.001678,172.217.194.0-255,4320,62526,90,91422
9798,0.00168,172.31.47.0-255,66,62592,90,91422
9799,0.001694,172.31.47.0-255,66,62658,90,91422
9800,0.001708,172.217.194.0-255,8574,71232,90,91422
9801,0.001711,172.31.47.0-255,66,71298,90,91422
9802,0.001754,172.217.194.0-255,2184,73482,90,91422
9803,0.001757,172.31.47.0-255,66,73548,90,91422
9804,0.00403,172.217.194.0-255,2902,76450,90,91422
9805,0.004037,172.31.47.0-255,66,76516,90,91422
9806,0.004077,172.217.194.0-255,1484,78000,90,91422
9807,0.004088,172.217.194.0-255,1484,79484,90,91422
9808,0.004091,172.31.47.0-255,66,79550,90,91422
9809,0.006349,172.217.194.0-255,2902,82452,90,91422
9810,0.006352,172.31.47.0-255,66,82518,90,91422
9811,0.006377,172.217.194.0-255,2902,85420,90,91422
9812,0.00638,172.31.47.0-255,66,85486,90,91422
9813,0.008702,172.217.194.0-255,2902,88388,90,91422
9814,0.00871,172.31.47.0-255,66,88454,90,91422
9815,0.008744,172.217.194.0-255,2902,91356,90,91422
9816,0.008747,172.31.47.0-255,66,91422,90,91422
9817,0.0,172.217.194.0-255,153,153,90,266694
9818,2.2e-05,172.31.47.0-255,66,219,90,266694
9819,2.8e-05,172.217.194.0-255,1484,1703,90,266694
9820,3.2e-05,172.31.47.0-255,66,1769,90,266694
9821,3.6e-05,172.217.194.0-255,2902,4671,90,266694
9822,4.6e-05,172.31.47.0-255,66,4737,90,266694
9823,5.3e-05,172.217.194.0-255,7156,11893,90,266694
9824,5.6e-05,172.31.47.0-255,66,11959,90,266694
9825,8.9e-05,172.217.194.0-255,2094,14053,90,266694
9826,9.1e-05,172.31.47.0-255,66,14119,90,266694
9827,9.6e-05,172.217.194.0-255,2902,17021,90,266694
9828,9.8e-05,172.31.47.0-255,66,17087,90,266694
9829,0.000124,172.217.194.0-255,7156,24243,90,266694
9830,0.000127,172.31.47.0-255,66,24309,90,266694
9831,0.000149,172.217.194.0-255,6797,31106,90,266694
9832,0.000151,172.31.47.0-255,66,31172,90,266694
9833,0.000185,172.217.194.0-255,1484,32656,90,266694
9834,0.000188,172.31.47.0-255,66,32722,90,266694
9835,0.000191,172.217.194.0-255,1484,34206,90,266694
9836,0.000192,172.31.47.0-255,66,34272,90,266694
9837,0.000223,172.217.194.0-255,1484,35756,90,266694
9838,0.000226,172.31.47.0-255,66,35822,90,266694
9839,0.000232,172.217.194.0-255,5738,41560,90,266694
9840,0.000234,172.31.47.0-255,66,41626,90,266694
9841,0.000254,172.31.47.0-255,66,41692,90,266694
9842,0.00029,172.217.194.0-255,7156,48848,90,266694
9843,0.000294,172.31.47.0-255,66,48914,90,266694
9844,0.000318,172.217.194.0-255,2819,51733,90,266694
9845,0.000321,172.31.47.0-255,66,51799,90,266694
9846,0.00037,172.217.194.0-255,114,51913,90,266694
9847,0.000373,172.31.47.0-255,66,51979,90,266694
9848,0.000388,172.217.194.0-255,383,52362,90,266694
9849,0.000664,172.31.47.0-255,66,52428,90,266694
9850,0.000692,172.217.194.0-255,1484,53912,90,266694
9851,0.000698,172.217.194.0-255,2902,56814,90,266694
9852,0.0007,172.31.47.0-255,66,56880,90,266694
9853,0.000705,172.217.194.0-255,4320,61200,90,266694
9854,0.000707,172.31.47.0-255,66,61266,90,266694
9855,0.000723,172.217.194.0-255,1484,62750,90,266694
9856,0.000745,172.217.194.0-255,7156,69906,90,266694
9857,0.000748,172.31.47.0-255,66,69972,90,266694
9858,0.000761,172.217.194.0-255,5738,75710,90,266694
9859,0.000767,172.31.47.0-255,66,75776,90,266694
9860,0.000775,172.217.194.0-255,9992,85768,90,266694
9861,0.000777,172.31.47.0-255,66,85834,90,266694
9862,0.00078,172.217.194.0-255,766,86600,90,266694
9863,0.000922,172.31.47.0-255,66,86666,90,266694
9864,0.001333,172.217.194.0-255,1484,88150,90,266694
9865,0.001341,172.217.194.0-255,1484,89634,90,266694
9866,0.001345,172.31.47.0-255,66,89700,90,266694
9867,0.001376,172.217.194.0-255,1484,91184,90,266694
9868,0.001383,172.217.194.0-255,5738,96922,90,266694
9869,0.001385,172.31.47.0-255,66,96988,90,266694
9870,0.001402,172.31.47.0-255,66,97054,90,266694
9871,0.001434,172.217.194.0-255,7156,104210,90,266694
9872,0.001437,172.31.47.0-255,66,104276,90,266694
9873,0.001465,172.217.194.0-255,3602,107878,90,266694
9874,0.001468,172.31.47.0-255,66,107944,90,266694
9875,0.001535,172.217.194.0-255,1484,109428,90,266694
9876,0.001549,172.217.194.0-255,2902,112330,90,266694
9877,0.001552,172.31.47.0-255,66,112396,90,266694
9878,0.001557,172.217.194.0-255,4320,116716,90,266694
9879,0.001558,172.31.47.0-255,66,116782,90,266694
9880,0.001584,172.217.194.0-255,1484,118266,90,266694
9881,0.00159,172.217.194.0-255,7156,125422,90,266694
9882,0.001592,172.31.47.0-255,66,125488,90,266694
9883,0.001621,172.217.194.0-255,5738,131226,90,266694
9884,0.001623,172.31.47.0-255,66,131292,90,266694
9885,0.00163,172.217.194.0-255,10692,141984,90,266694
9886,0.001636,172.31.47.0-255,66,142050,90,266694
9887,0.001673,172.217.194.0-255,1484,143534,90,266694
9888,0.001689,172.217.194.0-255,1484,145018,90,266694
9889,0.001691,172.31.47.0-255,66,145084,90,266694
9890,0.001701,172.217.194.0-255,1484,146568,90,266694
9891,0.001718,172.217.194.0-255,2902,149470,90,266694
9892,0.001719,172.31.47.0-255,66,149536,90,266694
9893,0.001745,172.217.194.0-255,2902,152438,90,266694
9894,0.001747,172.31.47.0-255,66,152504,90,266694
9895,0.001751,172.217.194.0-255,4320,156824,90,266694
9896,0.001753,172.31.47.0-255,66,156890,90,266694
9897,0.001767,172.31.47.0-255,66,156956,90,266694
9898,0.001773,172.217.194.0-255,7856,164812,90,266694
9899,0.001775,172.31.47.0-255,66,164878,90,266694
9900,0.002046,172.217.194.0-255,1484,166362,90,266694
9901,0.002049,172.217.194.0-255,1484,167846,90,266694
9902,0.002051,172.31.47.0-255,66,167912,90,266694
9903,0.002077,172.217.194.0-255,1484,169396,90,266694
9904,0.002083,172.217.194.0-255,5738,175134,90,266694
9905,0.002085,172.31.47.0-255,66,175200,90,266694
9906,0.002087,172.217.194.0-255,1484,176684,90,266694
9907,0.002113,172.217.194.0-255,9992,186676,90,266694
9908,0.002115,172.31.47.0-255,66,186742,90,266694
9909,0.002139,172.217.194.0-255,1484,188226,90,266694
9910,0.002148,172.217.194.0-255,10692,198918,90,266694
9911,0.00215,172.31.47.0-255,66,198984,90,266694
9912,0.002454,172.217.194.0-255,1484,200468,90,266694
9913,0.002457,172.217.194.0-255,2902,203370,90,266694
9914,0.002459,172.31.47.0-255,66,203436,90,266694
9915,0.002486,172.217.194.0-255,5738,209174,90,266694
9916,0.002488,172.31.47.0-255,66,209240,90,266694
9917,0.002492,172.217.194.0-255,4320,213560,90,266694
9918,0.002494,172.31.47.0-255,66,213626,90,266694
9919,0.002529,172.217.194.0-255,8574,222200,90,266694
9920,0.002532,172.31.47.0-255,66,222266,90,266694
9921,0.002537,172.217.194.0-255,5738,228004,90,266694
9922,0.002539,172.31.47.0-255,66,228070,90,266694
9923,0.002561,172.217.194.0-255,5020,233090,90,266694
9924,0.002567,172.31.47.0-255,66,233156,90,266694
9925,0.002589,172.217.194.0-255,1484,234640,90,266694
9926,0.002593,172.217.194.0-255,2902,237542,90,266694
9927,0.002594,172.31.47.0-255,66,237608,90,266694
9928,0.002599,172.217.194.0-255,4320,241928,90,266694
9929,0.002601,172.31.47.0-255,66,241994,90,266694
9930,0.002624,172.217.194.0-255,1484,243478,90,266694
9931,0.002639,172.217.194.0-255,4320,247798,90,266694
9932,0.002641,172.31.47.0-255,66,247864,90,266694
9933,0.002666,172.217.194.0-255,7156,255020,90,266694
9934,0.002668,172.31.47.0-255,66,255086,90,266694
9935,0.005263,172.217.194.0-255,5738,260824,90,266694
9936,0.00527,172.31.47.0-255,66,260890,90,266694
9937,0.00788,172.217.194.0-255,5738,266628,90,266694
9938,0.007887,172.31.47.0-255,66,266694,90,266694
9939,0.0,74.125.130.0-255,297,297,90,115127
9940,2.7e-05,172.31.47.0-255,66,363,90,115127
9941,3.3e-05,74.125.130.0-255,1484,1847,90,115127
9942,3.8e-05,172.31.47.0-255,66,1913,90,115127
9943,4.3e-05,74.125.130.0-255,2902,4815,90,115127
9944,4.6e-05,172.31.47.0-255,66,4881,90,115127
9945,6.4e-05,74.125.130.0-255,2902,7783,90,115127
9946,6.6e-05,172.31.47.0-255,66,7849,90,115127
9947,8.7e-05,74.125.130.0-255,2902,10751,90,115127
9948,9e-05,172.31.47.0-255,66,10817,90,115127
9949,0.000129,74.125.130.0-255,6211,17028,90,115127
9950,0.000133,172.31.47.0-255,66,17094,90,115127
9951,0.000157,74.125.130.0-255,7156,24250,90,115127
9952,0.000159,172.31.47.0-255,66,24316,90,115127
9953,0.000173,74.125.130.0-255,1484,25800,90,115127
9954,0.000175,172.31.47.0-255,66,25866,90,115127
9955,0.000195,74.125.130.0-255,7156,33022,90,115127
9956,0.000198,172.31.47.0-255,66,33088,90,115127
9957,0.000202,74.125.130.0-255,2902,35990,90,115127
9958,0.000205,172.31.47.0-255,66,36056,90,115127
9959,0.000221,74.125.130.0-255,7156,43212,90,115127
9960,0.000224,172.31.47.0-255,66,43278,90,115127
9961,0.00023,74.125.130.0-255,5020,48298,90,115127
9962,0.000232,172.31.47.0-255,66,48364,90,115127
9963,0.001426,74.125.130.0-255,1484,49848,90,115127
9964,0.001432,172.31.47.0-255,66,49914,90,115127
9965,0.001439,74.125.130.0-255,1484,51398,90,115127
9966,0.00144,172.31.47.0-255,66,51464,90,115127
9967,0.001445,74.125.130.0-255,2902,54366,90,115127
9968,0.001446,172.31.47.0-255,66,54432,90,115127
9969,0.001465,74.125.130.0-255,5738,60170,90,115127
9970,0.001467,172.31.47.0-255,66,60236,90,115127
9971,0.001486,74.125.130.0-255,2902,63138,90,115127
9972,0.001505,74.125.130.0-255,2833,65971,90,115127
9973,0.00151,74.125.130.0-255,2902,68873,90,115127
9974,0.00152,74.125.130.0-255,1484,70357,90,115127
9975,0.00153,74.125.130.0-255,1484,71841,90,115127
9976,0.001547,74.125.130.0-255,5738,77579,90,115127
9977,0.001565,74.125.130.0-255,4320,81899,90,115127
9978,0.001585,74.125.130.0-255,844,82743,90,115127
9979,0.001692,172.31.47.0-255,66,82809,90,115127
9980,0.002321,74.125.130.0-255,1484,84293,90,115127
9981,0.002339,74.125.130.0-255,2902,87195,90,115127
9982,0.002342,172.31.47.0-255,66,87261,90,115127
9983,0.002345,74.125.130.0-255,1484,88745,90,115127
9984,0.002348,74.125.130.0-255,1484,90229,90,115127
9985,0.00236,74.125.130.0-255,1484,91713,90,115127
9986,0.002362,74.125.130.0-255,1484,93197,90,115127
9987,0.002372,74.125.130.0-255,4320,97517,90,115127
9988,0.002375,172.31.47.0-255,66,97583,90,115127
9989,0.002382,172.31.47.0-255,66,97649,90,115127
9990,0.004713,74.125.130.0-255,1484,99133,90,115127
9991,0.004738,74.125.130.0-255,4320,103453,90,115127
9992,0.004742,172.31.47.0-255,66,103519,90,115127
9993,0.007099,74.125.130.0-255,5738,109257,90,115127
9994,0.007104,172.31.47.0-255,66,109323,90,115127
9995,0.009456,74.125.130.0-255,5738,115061,90,115127
9996,0.009465,172.31.47.0-255,66,115127,90,115127
9997,0.0,74.125.68.0-255,66,66,90,3980
9998,0.000329,74.125.68.0-255,3848,3914,90,3980
9999,0.000347,172.31.47.0-255,66,3980,90,3980
10000,0.0,172.217.24.0-255,153,153,90,215437
10001,2.6e-05,172.31.47.0-255,66,219,90,215437
10002,3.2e-05,172.217.24.0-255,1484,1703,90,215437
10003,3.6e-05,172.31.47.0-255,66,1769,90,215437
10004,4.1e-05,172.217.24.0-255,2902,4671,90,215437
10005,4.3e-05,172.31.47.0-255,66,4737,90,215437
10006,5.3e-05,172.217.24.0-255,4320,9057,90,215437
10007,5.6e-05,172.31.47.0-255,66,9123,90,215437
10008,7.9e-05,172.217.24.0-255,1484,10607,90,215437
10009,8.1e-05,172.31.47.0-255,66,10673,90,215437
10010,8.5e-05,172.217.24.0-255,2902,13575,90,215437
10011,8.6e-05,172.31.47.0-255,66,13641,90,215437
10012,8.9e-05,172.217.24.0-255,1484,15125,90,215437
10013,9.5e-05,172.31.47.0-255,66,15191,90,215437
10014,0.000128,172.217.24.0-255,787,15978,90,215437
10015,0.000132,172.31.47.0-255,66,16044,90,215437
10016,0.000136,172.217.24.0-255,2902,18946,90,215437
10017,0.000138,172.31.47.0-255,66,19012,90,215437
10018,0.000144,172.217.24.0-255,7156,26168,90,215437
10019,0.000151,172.31.47.0-255,66,26234,90,215437
10020,0.000157,172.217.24.0-255,5379,31613,90,215437
10021,0.000159,172.31.47.0-255,66,31679,90,215437
10022,0.000225,172.217.24.0-255,1484,33163,90,215437
10023,0.000227,172.31.47.0-255,66,33229,90,215437
10024,0.000231,172.217.24.0-255,2902,36131,90,215437
10025,0.000233,172.31.47.0-255,66,36197,90,215437
10026,0.000235,172.217.24.0-255,1484,37681,90,215437
10027,0.000237,172.31.47.0-255,66,37747,90,215437
10028,0.000265,172.217.24.0-255,1484,39231,90,215437
10029,0.000267,172.31.47.0-255,66,39297,90,215437
10030,0.000273,172.217.24.0-255,4320,43617,90,215437
10031,0.000275,172.31.47.0-255,66,43683,90,215437
10032,0.000288,172.217.24.0-255,8574,52257,90,215437
10033,0.000291,172.31.47.0-255,66,52323,90,215437
10034,0.000295,172.217.24.0-255,4320,56643,90,215437
10035,0.000297,172.31.47.0-255,66,56709,90,215437
10036,0.000309,172.217.24.0-255,5738,62447,90,215437
10037,0.000312,172.31.47.0-255,66,62513,90,215437
10038,0.000339,172.217.24.0-255,3602,66115,90,215437
10039,0.000342,172.31.47.0-255,66,66181,90,215437
10040,0.000344,172.217.24.0-255,361,66542,90,215437
10041,0.000653,172.31.47.0-255,66,66608,90,215437
10042,0.000964,172.217.24.0-255,137,66745,90,215437
10043,0.001103,172.217.24.0-255,1484,68229,90,215437
10044,0.001108,172.31.47.0-255,66,68295,90,215437
10045,0.001113,172.217.24.0-255,2902,71197,90,215437
10046,0.001115,172.31.47.0-255,66,71263,90,215437
10047,0.00114,172.217.24.0-255,5738,77001,90,215437
10048,0.001142,172.31.47.0-255,66,77067,90,215437
10049,0.001155,172.217.24.0-255,9992,87059,90,215437
10050,0.001158,172.31.47.0-255,66,87125,90,215437
10051,0.001193,172.217.24.0-255,2902,90027,90,215437
10052,0.001195,172.31.47.0-255,66,90093,90,215437
10053,0.001202,172.217.24.0-255,9992,100085,90,215437
10054,0.001204,172.31.47.0-255,66,100151,90,215437
10055,0.00121,172.217.24.0-255,766,100917,90,215437
10056,0.001224,172.217.24.0-255,1484,102401,90,215437
10057,0.001226,172.31.47.0-255,66,102467,90,215437
10058,0.001251,172.217.24.0-255,4320,106787,90,215437
10059,0.001253,172.31.47.0-255,66,106853,90,215437
10060,0.001256,172.217.24.0-255,2902,109755,90,215437
10061,0.001258,172.31.47.0-255,66,109821,90,215437
10062,0.001281,172.217.24.0-255,7156,116977,90,215437
10063,0.001282,172.31.47.0-255,66,117043,90,215437
10064,0.001292,172.31.47.0-255,66,117109,90,215437
10065,0.001326,172.217.24.0-255,6438,123547,90,215437
10066,0.001328,172.31.47.0-255,66,123613,90,215437
10067,0.001352,172.217.24.0-255,1484,125097,90,215437
10068,0.001369,172.217.24.0-255,2902,127999,90,215437
10069,0.001371,172.31.47.0-255,66,128065,90,215437
10070,0.001374,172.217.24.0-255,2902,130967,90,215437
10071,0.001376,172.31.47.0-255,66,131033,90,215437
10072,0.001404,172.217.24.0-255,2902,133935,90,215437
10073,0.001406,172.31.47.0-255,66,134001,90,215437
10074,0.001446,172.217.24.0-255,9992,143993,90,215437
10075,0.001448,172.31.47.0-255,66,144059,90,215437
10076,0.001469,172.217.24.0-255,2902,146961,90,215437
10077,0.001471,172.31.47.0-255,66,147027,90,215437
10078,0.001479,172.217.24.0-255,10692,157719,90,215437
10079,0.00148,172.31.47.0-255,66,157785,90,215437
10080,0.001728,172.217.24.0-255,1484,159269,90,215437
10081,0.001737,172.217.24.0-255,2902,162171,90,215437
10082,0.001738,172.31.47.0-255,66,162237,90,215437
10083,0.001765,172.217.24.0-255,5738,167975,90,215437
10084,0.001767,172.31.47.0-255,66,168041,90,215437
10085,0.001772,172.217.24.0-255,4320,172361,90,215437
10086,0.001774,172.31.47.0-255,66,172427,90,215437
10087,0.001811,172.217.24.0-255,4320,176747,90,215437
10088,0.001813,172.31.47.0-255,66,176813,90,215437
10089,0.001816,172.217.24.0-255,1484,178297,90,215437
10090,0.001838,172.217.24.0-255,1484,179781,90,215437
10091,0.001839,172.31.47.0-255,66,179847,90,215437
10092,0.001844,172.217.24.0-255,4320,184167,90,215437
10093,0.001845,172.31.47.0-255,66,184233,90,215437
10094,0.001872,172.217.24.0-255,7856,192089,90,215437
10095,0.001874,172.31.47.0-255,66,192155,90,215437
10096,0.001917,172.217.24.0-255,1484,193639,90,215437
10097,0.003765,172.217.24.0-255,4320,197959,90,215437
10098,0.003768,172.31.47.0-255,66,198025,90,215437
10099,0.005672,172.217.24.0-255,5738,203763,90,215437
10100,0.005679,172.31.47.0-255,66,203829,90,215437
10101,0.007581,172.217.24.0-255,5738,209567,90,215437
10102,0.007588,172.31.47.0-255,66,209633,90,215437
10103,0.009688,172.217.24.0-255,5738,215371,90,215437
10104,0.00974,172.31.47.0-255,66,215437,90,215437
10105,0.0,172.31.47.0-255,105,105,90,210
10106,0.001793,157.240.13.0-255,105,210,90,210
10107,0.0,216.58.203.0-255,153,153,90,104839
10108,3e-05,172.31.47.0-255,66,219,90,104839
10109,3.7e-05,216.58.203.0-255,1484,1703,90,104839
10110,4.1e-05,172.31.47.0-255,66,1769,90,104839
10111,7.2e-05,216.58.203.0-255,1484,3253,90,104839
10112,7.5e-05,172.31.47.0-255,66,3319,90,104839
10113,9.9e-05,216.58.203.0-255,2902,6221,90,104839
10114,0.000103,172.31.47.0-255,66,6287,90,104839
10115,0.000106,216.58.203.0-255,2902,9189,90,104839
10116,0.000109,172.31.47.0-255,66,9255,90,104839
10117,0.000167,216.58.203.0-255,4320,13575,90,104839
10118,0.000172,172.31.47.0-255,66,13641,90,104839
10119,0.000175,216.58.203.0-255,791,14432,90,104839
10120,0.000177,172.31.47.0-255,66,14498,90,104839
10121,0.000273,216.58.203.0-255,1484,15982,90,104839
10122,0.000278,172.31.47.0-255,66,16048,90,104839
10123,0.000283,216.58.203.0-255,2902,18950,90,104839
10124,0.000286,172.31.47.0-255,66,19016,90,104839
10125,0.000289,216.58.203.0-255,1484,20500,90,104839
10126,0.00029,172.31.47.0-255,66,20566,90,104839
10127,0.000316,216.58.203.0-255,4320,24886,90,104839
10128,0.000319,172.31.47.0-255,66,24952,90,104839
10129,0.000324,216.58.203.0-255,4320,29272,90,104839
10130,0.000332,172.31.47.0-255,66,29338,90,104839
10131,0.000374,172.31.47.0-255,66,29404,90,104839
10132,0.000403,216.58.203.0-255,4320,33724,90,104839
10133,0.000406,172.31.47.0-255,66,33790,90,104839
10134,0.000426,216.58.203.0-255,8574,42364,90,104839
10135,0.000429,172.31.47.0-255,66,42430,90,104839
10136,0.000468,216.58.203.0-255,2902,45332,90,104839
10137,0.000472,172.31.47.0-255,66,45398,90,104839
10138,0.000499,216.58.203.0-255,8149,53547,90,104839
10139,0.000502,172.31.47.0-255,66,53613,90,104839
10140,0.000743,216.58.203.0-255,136,53749,90,104839
10141,0.000772,172.31.47.0-255,66,53815,90,104839
10142,0.001069,216.58.203.0-255,1484,55299,90,104839
10143,0.001077,216.58.203.0-255,1484,56783,90,104839
10144,0.00108,172.31.47.0-255,66,56849,90,104839
10145,0.001108,216.58.203.0-255,1484,58333,90,104839
10146,0.001115,216.58.203.0-255,5738,64071,90,104839
10147,0.001118,172.31.47.0-255,66,64137,90,104839
10148,0.00113,172.31.47.0-255,66,64203,90,104839
10149,0.00118,216.58.203.0-255,4320,68523,90,104839
10150,0.001185,172.31.47.0-255,66,68589,90,104839
10151,0.001208,216.58.203.0-255,2902,71491,90,104839
10152,0.001211,172.31.47.0-255,66,71557,90,104839
10153,0.001237,216.58.203.0-255,3602,75159,90,104839
10154,0.001241,172.31.47.0-255,66,75225,90,104839
10155,0.002846,216.58.203.0-255,1484,76709,90,104839
10156,0.002881,216.58.203.0-255,1484,78193,90,104839
10157,0.002885,172.31.47.0-255,66,78259,90,104839
10158,0.002909,216.58.203.0-255,2902,81161,90,104839
10159,0.002914,172.31.47.0-255,66,81227,90,104839
10160,0.004533,216.58.203.0-255,2902,84129,90,104839
10161,0.004537,172.31.47.0-255,66,84195,90,104839
10162,0.004567,216.58.203.0-255,2902,87097,90,104839
10163,0.004569,172.31.47.0-255,66,87163,90,104839
10164,0.006196,216.58.203.0-255,2902,90065,90,104839
10165,0.006203,172.31.47.0-255,66,90131,90,104839
10166,0.006231,216.58.203.0-255,2902,93033,90,104839
10167,0.006234,172.31.47.0-255,66,93099,90,104839
10168,0.007846,216.58.203.0-255,2902,96001,90,104839
10169,0.007852,172.31.47.0-255,66,96067,90,104839
10170,0.007871,216.58.203.0-255,2902,98969,90,104839
10171,0.007873,172.31.47.0-255,66,99035,90,104839
10172,0.009516,216.58.203.0-255,5738,104773,90,104839
10173,0.009527,172.31.47.0-255,66,104839,90,104839
10174,0.0,74.125.24.0-255,153,153,90,261526
10175,1.5e-05,172.31.47.0-255,66,219,90,261526
10176,2.1e-05,74.125.24.0-255,1484,1703,90,261526
10177,2.5e-05,172.31.47.0-255,66,1769,90,261526
10178,3.1e-05,74.125.24.0-255,2902,4671,90,261526
10179,3.4e-05,172.31.47.0-255,66,4737,90,261526
10180,3.8e-05,74.125.24.0-255,2902,7639,90,261526
10181,4.1e-05,172.31.47.0-255,66,7705,90,261526
10182,6.2e-05,74.125.24.0-255,4320,12025,90,261526
10183,6.5e-05,172.31.47.0-255,66,12091,90,261526
10184,0.000107,172.31.47.0-255,66,12157,90,261526
10185,0.000111,74.125.24.0-255,2543,14700,90,261526
10186,0.000113,172.31.47.0-255,66,14766,90,261526
10187,0.000241,74.125.24.0-255,1484,16250,90,261526
10188,0.000246,172.31.47.0-255,66,16316,90,261526
10189,0.00025,74.125.24.0-255,2902,19218,90,261526
10190,0.000253,172.31.47.0-255,66,19284,90,261526
10191,0.000257,74.125.24.0-255,4320,23604,90,261526
10192,0.000259,172.31.47.0-255,66,23670,90,261526
10193,0.000281,74.125.24.0-255,1484,25154,90,261526
10194,0.000283,172.31.47.0-255,66,25220,90,261526
10195,0.000289,74.125.24.0-255,4320,29540,90,261526
10196,0.000291,172.31.47.0-255,66,29606,90,261526
10197,0.000348,172.31.47.0-255,66,29672,90,261526
10198,0.000354,74.125.24.0-255,7076,36748,90,261526
10199,0.000356,172.31.47.0-255,66,36814,90,261526
10200,0.000358,74.125.24.0-255,126,36940,90,261526
10201,0.00036,172.31.47.0-255,66,37006,90,261526
10202,0.000399,74.125.24.0-255,1484,38490,90,261526
10203,0.000402,172.31.47.0-255,66,38556,90,261526
10204,0.000416,74.125.24.0-255,2902,41458,90,261526
10205,0.000418,172.31.47.0-255,66,41524,90,261526
10206,0.000422,74.125.24.0-255,2902,44426,90,261526
10207,0.000424,172.31.47.0-255,66,44492,90,261526
10208,0.000455,74.125.24.0-255,9992,54484,90,261526
10209,0.000457,172.31.47.0-255,66,54550,90,261526
10210,0.000504,172.31.47.0-255,66,54616,90,261526
10211,0.000507,74.125.24.0-255,348,54964,90,261526
10212,0.000699,74.125.24.0-255,1484,56448,90,261526
10213,0.000704,172.31.47.0-255,66,56514,90,261526
10214,0.000709,74.125.24.0-255,2902,59416,90,261526
10215,0.000711,172.31.47.0-255,66,59482,90,261526
10216,0.000742,74.125.24.0-255,5738,65220,90,261526
10217,0.000745,172.31.47.0-255,66,65286,90,261526
10218,0.000748,74.125.24.0-255,1484,66770,90,261526
10219,0.000755,74.125.24.0-255,8574,75344,90,261526
10220,0.000757,172.31.47.0-255,66,75410,90,261526
10221,0.000762,74.125.24.0-255,4320,79730,90,261526
10222,0.000764,172.31.47.0-255,66,79796,90,261526
10223,0.000793,74.125.24.0-255,8574,88370,90,261526
10224,0.000796,172.31.47.0-255,66,88436,90,261526
10225,0.000798,74.125.24.0-255,766,89202,90,261526
10226,0.000823,74.125.24.0-255,1484,90686,90,261526
10227,0.000826,172.31.47.0-255,66,90752,90,261526
10228,0.000831,74.125.24.0-255,4320,95072,90,261526
10229,0.000833,172.31.47.0-255,66,95138,90,261526
10230,0.000859,74.125.24.0-255,9992,105130,90,261526
10231,0.000861,172.31.47.0-255,66,105196,90,261526
10232,0.000897,74.125.24.0-255,4320,109516,90,261526
10233,0.000899,172.31.47.0-255,66,109582,90,261526
10234,0.000911,74.125.24.0-255,2902,112484,90,261526
10235,0.000913,172.31.47.0-255,66,112550,90,261526
10236,0.000917,74.125.24.0-255,2902,115452,90,261526
10237,0.000919,172.31.47.0-255,66,115518,90,261526
10238,0.000947,74.125.24.0-255,7856,123374,90,261526
10239,0.00095,172.31.47.0-255,66,123440,90,261526
10240,0.001056,74.125.24.0-255,1484,124924,90,261526
10241,0.001094,74.125.24.0-255,2902,127826,90,261526
10242,0.001097,172.31.47.0-255,66,127892,90,261526
10243,0.001142,74.125.24.0-255,5738,133630,90,261526
10244,0.001145,172.31.47.0-255,66,133696,90,261526
10245,0.001196,74.125.24.0-255,1484,135180,90,261526
10246,0.001213,74.125.24.0-255,2902,138082,90,261526
10247,0.001215,172.31.47.0-255,66,138148,90,261526
10248,0.001218,74.125.24.0-255,1484,139632,90,261526
10249,0.001222,74.125.24.0-255,2902,142534,90,261526
10250,0.001223,172.31.47.0-255,66,142600,90,261526
10251,0.001236,74.125.24.0-255,2902,145502,90,261526
10252,0.001239,172.31.47.0-255,66,145568,90,261526
10253,0.001274,74.125.24.0-255,7156,152724,90,261526
10254,0.001276,172.31.47.0-255,66,152790,90,261526
10255,0.001295,74.125.24.0-255,5020,157810,90,261526
10256,0.001297,172.31.47.0-255,66,157876,90,261526
10257,0.001766,74.125.24.0-255,1484,159360,90,261526
10258,0.001771,74.125.24.0-255,2902,162262,90,261526
10259,0.001774,172.31.47.0-255,66,162328,90,261526
10260,0.001777,74.125.24.0-255,1484,163812,90,261526
10261,0.001795,74.125.24.0-255,4320,168132,90,261526
10262,0.001798,172.31.47.0-255,66,168198,90,261526
10263,0.001814,74.125.24.0-255,5738,173936,90,261526
10264,0.001816,172.31.47.0-255,66,174002,90,261526
10265,0.001835,74.125.24.0-255,7156,181158,90,261526
10266,0.001837,172.31.47.0-255,66,181224,90,261526
10267,0.001842,74.125.24.0-255,4320,185544,90,261526
10268,0.001843,172.31.47.0-255,66,185610,90,261526
10269,0.001875,74.125.24.0-255,1484,187094,90,261526
10270,0.001899,172.31.47.0-255,66,187160,90,261526
10271,0.001921,74.125.24.0-255,5020,192180,90,261526
10272,0.001923,172.31.47.0-255,66,192246,90,261526
10273,0.00194,172.31.47.0-255,66,192312,90,261526
10274,0.001962,74.125.24.0-255,5738,198050,90,261526
10275,0.001964,172.31.47.0-255,66,198116,90,261526
10276,0.001966,74.125.24.0-255,766,198882,90,261526
10277,0.002003,74.125.24.0-255,1484,200366,90,261526
10278,0.002005,172.31.47.0-255,66,200432,90,261526
10279,0.002018,74.125.24.0-255,2902,203334,90,261526
10280,0.00202,172.31.47.0-255,66,203400,90,261526
10281,0.002023,74.125.24.0-255,1484,204884,90,261526
10282,0.002035,74.125.24.0-255,4320,209204,90,261526
10283,0.002037,172.31.47.0-255,66,209270,90,261526
10284,0.002057,74.125.24.0-255,4320,213590,90,261526
10285,0.002059,172.31.47.0-255,66,213656,90,261526
10286,0.002082,74.125.24.0-255,8574,222230,90,261526
10287,0.002084,172.31.47.0-255,66,222296,90,261526
10288,0.002093,74.125.24.0-255,10692,232988,90,261526
10289,0.002095,172.31.47.0-255,66,233054,90,261526
10290,0.00214,74.125.24.0-255,5738,238792,90,261526
10291,0.002144,172.31.47.0-255,66,238858,90,261526
10292,0.002164,172.31.47.0-255,66,238924,90,261526
10293,0.002221,172.31.47.0-255,66,238990,90,261526
10294,0.002234,74.125.24.0-255,5020,244010,90,261526
10295,0.002236,172.31.47.0-255,66,244076,90,261526
10296,0.002252,172.31.47.0-255,66,244142,90,261526
10297,0.002259,74.125.24.0-255,6438,250580,90,261526
10298,0.00226,172.31.47.0-255,66,250646,90,261526
10299,0.002274,74.125.24.0-255,1484,252130,90,261526
10300,0.002311,172.31.47.0-255,66,252196,90,261526
10301,0.002323,74.125.24.0-255,4320,256516,90,261526
10302,0.002326,172.31.47.0-255,66,256582,90,261526
10303,0.002329,74.125.24.0-255,2184,258766,90,261526
10304,0.002331,172.31.47.0-255,66,258832,90,261526
10305,0.002349,74.125.24.0-255,2286,261118,90,261526
10306,0.002352,172.31.47.0-255,66,261184,90,261526
10307,0.002376,74.125.24.0-255,105,261289,90,261526
10308,0.004102,172.31.47.0-255,66,261355,90,261526
10309,0.004134,172.31.47.0-255,105,261460,90,261526
10310,0.006738,74.125.24.0-255,66,261526,90,261526
10311,0.0,74.125.68.0-255,153,153,90,151856
10312,2.7e-05,172.31.47.0-255,66,219,90,151856
10313,3.5e-05,74.125.68.0-255,1484,1703,90,151856
10314,4e-05,172.31.47.0-255,66,1769,90,151856
10315,4.7e-05,74.125.68.0-255,2902,4671,90,151856
10316,5.1e-05,172.31.47.0-255,66,4737,90,151856
10317,5.9e-05,74.125.68.0-255,7156,11893,90,151856
10318,6.2e-05,172.31.47.0-255,66,11959,90,151856
10319,6.6e-05,74.125.68.0-255,2108,14067,90,151856
10320,6.9e-05,172.31.47.0-255,66,14133,90,151856
10321,0.000108,74.125.68.0-255,1484,15617,90,151856
10322,0.000111,172.31.47.0-255,66,15683,90,151856
10323,0.000132,74.125.68.0-255,2902,18585,90,151856
10324,0.000134,172.31.47.0-255,66,18651,90,151856
10325,0.00016,74.125.68.0-255,5738,24389,90,151856
10326,0.000162,172.31.47.0-255,66,24455,90,151856
10327,0.000164,74.125.68.0-255,1484,25939,90,151856
10328,0.000166,172.31.47.0-255,66,26005,90,151856
10329,0.000207,74.125.68.0-255,2902,28907,90,151856
10330,0.000209,172.31.47.0-255,66,28973,90,151856
10331,0.000224,74.125.68.0-255,2543,31516,90,151856
10332,0.000228,172.31.47.0-255,66,31582,90,151856
10333,0.00031,74.125.68.0-255,1484,33066,90,151856
10334,0.000314,172.31.47.0-255,66,33132,90,151856
10335,0.000318,74.125.68.0-255,2902,36034,90,151856
10336,0.00032,172.31.47.0-255,66,36100,90,151856
10337,0.000337,74.125.68.0-255,5738,41838,90,151856
10338,0.00034,172.31.47.0-255,66,41904,90,151856
10339,0.000366,74.125.68.0-255,5738,47642,90,151856
10340,0.000368,172.31.47.0-255,66,47708,90,151856
10341,0.000378,74.125.68.0-255,1484,49192,90,151856
10342,0.000379,172.31.47.0-255,66,49258,90,151856
10343,0.0004,74.125.68.0-255,5379,54637,90,151856
10344,0.000402,172.31.47.0-255,66,54703,90,151856
10345,0.000406,74.125.68.0-255,2902,57605,90,151856
10346,0.000408,172.31.47.0-255,66,57671,90,151856
10347,0.000429,74.125.68.0-255,5738,63409,90,151856
10348,0.000431,172.31.47.0-255,66,63475,90,151856
10349,0.000459,74.125.68.0-255,2875,66350,90,151856
10350,0.000478,74.125.68.0-255,376,66726,90,151856
10351,0.000544,172.31.47.0-255,66,66792,90,151856
10352,0.000765,74.125.68.0-255,1484,68276,90,151856
10353,0.000779,74.125.68.0-255,1484,69760,90,151856
10354,0.000782,172.31.47.0-255,66,69826,90,151856
10355,0.000803,74.125.68.0-255,2902,72728,90,151856
10356,0.000805,172.31.47.0-255,66,72794,90,151856
10357,0.000809,74.125.68.0-255,2902,75696,90,151856
10358,0.000811,172.31.47.0-255,66,75762,90,151856
10359,0.000825,74.125.68.0-255,2902,78664,90,151856
10360,0.000827,172.31.47.0-255,66,78730,90,151856
10361,0.000831,74.125.68.0-255,2902,81632,90,151856
10362,0.000833,172.31.47.0-255,66,81698,90,151856
10363,0.00088,74.125.68.0-255,1484,83182,90,151856
10364,0.000895,74.125.68.0-255,2543,85725,90,151856
10365,0.000897,172.31.47.0-255,66,85791,90,151856
10366,0.000902,74.125.68.0-255,2902,88693,90,151856
10367,0.000921,74.125.68.0-255,4320,93013,90,151856
10368,0.000928,74.125.68.0-255,8215,101228,90,151856
10369,0.000941,172.31.47.0-255,66,101294,90,151856
10370,0.001499,74.125.68.0-255,1484,102778,90,151856
10371,0.001507,74.125.68.0-255,2902,105680,90,151856
10372,0.00151,172.31.47.0-255,66,105746,90,151856
10373,0.001529,74.125.68.0-255,1484,107230,90,151856
10374,0.001542,74.125.68.0-255,4320,111550,90,151856
10375,0.001544,172.31.47.0-255,66,111616,90,151856
10376,0.001548,74.125.68.0-255,2902,114518,90,151856
10377,0.00155,172.31.47.0-255,66,114584,90,151856
10378,0.001564,74.125.68.0-255,4320,118904,90,151856
10379,0.001566,172.31.47.0-255,66,118970,90,151856
10380,0.001589,74.125.68.0-255,4320,123290,90,151856
10381,0.001592,172.31.47.0-255,66,123356,90,151856
10382,0.001606,74.125.68.0-255,7156,130512,90,151856
10383,0.001608,172.31.47.0-255,66,130578,90,151856
10384,0.001621,74.125.68.0-255,2902,133480,90,151856
10385,0.001623,172.31.47.0-255,66,133546,90,151856
10386,0.001627,74.125.68.0-255,2184,135730,90,151856
10387,0.001629,172.31.47.0-255,66,135796,90,151856
10388,0.004246,74.125.68.0-255,5738,141534,90,151856
10389,0.004253,172.31.47.0-255,66,141600,90,151856
10390,0.006886,74.125.68.0-255,4320,145920,90,151856
10391,0.006893,172.31.47.0-255,66,145986,90,151856
10392,0.006913,74.125.68.0-255,1484,147470,90,151856
10393,0.00952,74.125.68.0-255,4320,151790,90,151856
10394,0.009527,172.31.47.0-255,66,151856,90,151856
10395,0.0,172.31.47.0-255,105,105,90,105
10396,0.0,172.217.194.0-255,143,143,90,194740
10397,2.4e-05,172.31.47.0-255,66,209,90,194740
10398,3e-05,172.217.194.0-255,1484,1693,90,194740
10399,3.4e-05,172.31.47.0-255,66,1759,90,194740
10400,3.8e-05,172.217.194.0-255,2902,4661,90,194740
10401,4.1e-05,172.31.47.0-255,66,4727,90,194740
10402,5.5e-05,172.217.194.0-255,7156,11883,90,194740
10403,5.9e-05,172.31.47.0-255,66,11949,90,194740
10404,6.3e-05,172.217.194.0-255,3519,15468,90,194740
10405,6.6e-05,172.31.47.0-255,66,15534,90,194740
10406,0.000107,172.31.47.0-255,66,15600,90,194740
10407,0.000111,172.217.194.0-255,2543,18143,90,194740
10408,0.000114,172.31.47.0-255,66,18209,90,194740
10409,0.000156,172.217.194.0-255,2902,21111,90,194740
10410,0.000158,172.31.47.0-255,66,21177,90,194740
10411,0.000161,172.217.194.0-255,1484,22661,90,194740
10412,0.000163,172.31.47.0-255,66,22727,90,194740
10413,0.00019,172.217.194.0-255,5738,28465,90,194740
10414,0.000193,172.31.47.0-255,66,28531,90,194740
10415,0.000239,172.31.47.0-255,66,28597,90,194740
10416,0.000247,172.217.194.0-255,9921,38518,90,194740
10417,0.000249,172.217.194.0-255,100,38618,90,194740
10418,0.000251,172.31.47.0-255,66,38684,90,194740
10419,0.000257,172.31.47.0-255,66,38750,90,194740
10420,0.000299,172.217.194.0-255,1484,40234,90,194740
10421,0.000302,172.31.47.0-255,66,40300,90,194740
10422,0.000306,172.217.194.0-255,2902,43202,90,194740
10423,0.000309,172.31.47.0-255,66,43268,90,194740
10424,0.000334,172.217.194.0-255,5738,49006,90,194740
10425,0.000338,172.31.47.0-255,66,49072,90,194740
10426,0.000377,172.217.194.0-255,5738,54810,90,194740
10427,0.000391,172.31.47.0-255,66,54876,90,194740
10428,0.0004,172.217.194.0-255,8215,63091,90,194740
10429,0.000406,172.31.47.0-255,66,63157,90,194740
10430,0.000408,172.217.194.0-255,1484,64641,90,194740
10431,0.00044,172.217.194.0-255,8515,73156,90,194740
10432,0.000448,172.31.47.0-255,66,73222,90,194740
10433,0.000635,172.217.194.0-255,1484,74706,90,194740
10434,0.00064,172.217.194.0-255,1484,76190,90,194740
10435,0.000655,172.31.47.0-255,66,76256,90,194740
10436,0.000656,172.217.194.0-255,1484,77740,90,194740
10437,0.00066,172.217.194.0-255,2902,80642,90,194740
10438,0.000673,172.31.47.0-255,66,80708,90,194740
10439,0.000683,172.217.194.0-255,2902,83610,90,194740
10440,0.000687,172.31.47.0-255,66,83676,90,194740
10441,0.000704,172.31.47.0-255,66,83742,90,194740
10442,0.000757,172.217.194.0-255,10692,94434,90,194740
10443,0.000762,172.31.47.0-255,66,94500,90,194740
10444,0.001569,172.217.194.0-255,1484,95984,90,194740
10445,0.001578,172.217.194.0-255,2902,98886,90,194740
10446,0.001581,172.31.47.0-255,66,98952,90,194740
10447,0.001586,172.217.194.0-255,2902,101854,90,194740
10448,0.001612,172.217.194.0-255,2902,104756,90,194740
10449,0.001645,172.217.194.0-255,4320,109076,90,194740
10450,0.001662,172.217.194.0-255,6438,115514,90,194740
10451,0.001703,172.217.194.0-255,1484,116998,90,194740
10452,0.001707,172.217.194.0-255,2902,119900,90,194740
10453,0.00173,172.217.194.0-255,5738,125638,90,194740
10454,0.001749,172.217.194.0-255,5738,131376,90,194740
10455,0.001769,172.217.194.0-255,7156,138532,90,194740
10456,0.001804,172.217.194.0-255,8574,147106,90,194740
10457,0.001819,172.217.194.0-255,2184,149290,90,194740
10458,0.001853,172.217.194.0-255,1484,150774,90,194740
10459,0.001857,172.217.194.0-255,2902,153676,90,194740
10460,0.00188,172.217.194.0-255,5738,159414,90,194740
10461,0.001901,172.217.194.0-255,5738,165152,90,194740
10462,0.001922,172.217.194.0-255,7156,172308,90,194740
10463,0.001953,172.217.194.0-255,4320,176628,90,194740
10464,0.001973,172.217.194.0-255,6438,183066,90,194740
10465,0.004695,172.31.47.0-255,66,183132,90,194740
10466,0.006656,172.217.194.0-255,5738,188870,90,194740
10467,0.006661,172.31.47.0-255,66,188936,90,194740
10468,0.008608,172.217.194.0-255,5738,194674,90,194740
10469,0.008616,172.31.47.0-255,66,194740,90,194740
10470,0.0,74.125.68.0-255,146,146,90,266280
10471,2.8e-05,172.31.47.0-255,66,212,90,266280
10472,3.4e-05,74.125.68.0-255,1484,1696,90,266280
10473,3.8e-05,172.31.47.0-255,66,1762,90,266280
10474,4e-05,74.125.68.0-255,1484,3246,90,266280
10475,4.2e-05,172.31.47.0-255,66,3312,90,266280
10476,7.9e-05,74.125.68.0-255,1484,4796,90,266280
10477,8.2e-05,172.31.47.0-255,66,4862,90,266280
10478,9e-05,74.125.68.0-255,7156,12018,90,266280
10479,9.2e-05,172.31.47.0-255,66,12084,90,266280
10480,0.0001,74.125.68.0-255,2128,14212,90,266280
10481,0.000102,172.31.47.0-255,66,14278,90,266280
10482,0.000121,74.125.68.0-255,1484,15762,90,266280
10483,0.000123,172.31.47.0-255,66,15828,90,266280
10484,0.000142,74.125.68.0-255,2902,18730,90,266280
10485,0.000149,172.31.47.0-255,66,18796,90,266280
10486,0.000155,74.125.68.0-255,5738,24534,90,266280
10487,0.000157,172.31.47.0-255,66,24600,90,266280
10488,0.00019,74.125.68.0-255,5738,30338,90,266280
10489,0.000192,172.31.47.0-255,66,30404,90,266280
10490,0.000214,74.125.68.0-255,1125,31529,90,266280
10491,0.000216,172.31.47.0-255,66,31595,90,266280
10492,0.000293,74.125.68.0-255,1484,33079,90,266280
10493,0.000296,172.31.47.0-255,66,33145,90,266280
10494,0.0003,74.125.68.0-255,2902,36047,90,266280
10495,0.000302,172.31.47.0-255,66,36113,90,266280
10496,0.000307,74.125.68.0-255,4320,40433,90,266280
10497,0.000309,172.31.47.0-255,66,40499,90,266280
10498,0.00035,74.125.68.0-255,1484,41983,90,266280
10499,0.000353,172.31.47.0-255,66,42049,90,266280
10500,0.000357,74.125.68.0-255,2902,44951,90,266280
10501,0.000359,172.31.47.0-255,66,45017,90,266280
10502,0.000369,74.125.68.0-255,3961,48978,90,266280
10503,0.000371,172.31.47.0-255,66,49044,90,266280
10504,0.000377,74.125.68.0-255,4320,53364,90,266280
10505,0.000379,172.31.47.0-255,66,53430,90,266280
10506,0.000409,74.125.68.0-255,4320,57750,90,266280
10507,0.000412,172.31.47.0-255,66,57816,90,266280
10508,0.000452,74.125.68.0-255,2902,60718,90,266280
10509,0.000455,172.31.47.0-255,66,60784,90,266280
10510,0.000495,74.125.68.0-255,5379,66163,90,266280
10511,0.000499,172.31.47.0-255,66,66229,90,266280
10512,0.000502,74.125.68.0-255,677,66906,90,266280
10513,0.000582,74.125.68.0-255,1484,68390,90,266280
10514,0.000585,172.31.47.0-255,66,68456,90,266280
10515,0.000589,74.125.68.0-255,1484,69940,90,266280
10516,0.000611,74.125.68.0-255,1484,71424,90,266280
10517,0.000616,172.31.47.0-255,66,71490,90,266280
10518,0.000644,74.125.68.0-255,5738,77228,90,266280
10519,0.000647,172.31.47.0-255,66,77294,90,266280
10520,0.000676,74.125.68.0-255,4320,81614,90,266280
10521,0.000679,172.31.47.0-255,66,81680,90,266280
10522,0.000686,74.125.68.0-255,5738,87418,90,266280
10523,0.000688,172.31.47.0-255,66,87484,90,266280
10524,0.000713,74.125.68.0-255,5738,93222,90,266280
10525,0.000716,172.31.47.0-255,66,93288,90,266280
10526,0.000724,74.125.68.0-255,7307,100595,90,266280
10527,0.000726,172.31.47.0-255,66,100661,90,266280
10528,0.000901,74.125.68.0-255,1484,102145,90,266280
10529,0.000906,74.125.68.0-255,1484,103629,90,266280
10530,0.000909,172.31.47.0-255,66,103695,90,266280
10531,0.000931,74.125.68.0-255,1484,105179,90,266280
10532,0.000938,74.125.68.0-255,4320,109499,90,266280
10533,0.000943,172.31.47.0-255,66,109565,90,266280
10534,0.000981,74.125.68.0-255,2902,112467,90,266280
10535,0.000985,172.31.47.0-255,66,112533,90,266280
10536,0.00101,74.125.68.0-255,2902,115435,90,266280
10537,0.001014,172.31.47.0-255,66,115501,90,266280
10538,0.001022,172.31.47.0-255,66,115567,90,266280
10539,0.001033,74.125.68.0-255,4320,119887,90,266280
10540,0.001036,172.31.47.0-255,66,119953,90,266280
10541,0.001041,74.125.68.0-255,3602,123555,90,266280
10542,0.001043,172.31.47.0-255,66,123621,90,266280
10543,0.001378,74.125.68.0-255,1484,125105,90,266280
10544,0.001396,74.125.68.0-255,2902,128007,90,266280
10545,0.001401,172.31.47.0-255,66,128073,90,266280
10546,0.001408,74.125.68.0-255,4320,132393,90,266280
10547,0.00141,172.31.47.0-255,66,132459,90,266280
10548,0.001431,74.125.68.0-255,1484,133943,90,266280
10549,0.001452,74.125.68.0-255,5738,139681,90,266280
10550,0.001456,172.31.47.0-255,66,139747,90,266280
10551,0.001488,74.125.68.0-255,7156,146903,90,266280
10552,0.001491,172.31.47.0-255,66,146969,90,266280
10553,0.00153,74.125.68.0-255,9992,156961,90,266280
10554,0.001534,172.31.47.0-255,66,157027,90,266280
10555,0.001537,74.125.68.0-255,766,157793,90,266280
10556,0.001693,74.125.68.0-255,1484,159277,90,266280
10557,0.001698,172.31.47.0-255,66,159343,90,266280
10558,0.001726,74.125.68.0-255,1484,160827,90,266280
10559,0.001743,74.125.68.0-255,2902,163729,90,266280
10560,0.001746,172.31.47.0-255,66,163795,90,266280
10561,0.001751,74.125.68.0-255,2902,166697,90,266280
10562,0.001753,172.31.47.0-255,66,166763,90,266280
10563,0.001779,74.125.68.0-255,4320,171083,90,266280
10564,0.001782,172.31.47.0-255,66,171149,90,266280
10565,0.001813,74.125.68.0-255,7156,178305,90,266280
10566,0.001816,172.31.47.0-255,66,178371,90,266280
10567,0.001819,74.125.68.0-255,1484,179855,90,266280
10568,0.001848,74.125.68.0-255,7156,187011,90,266280
10569,0.001852,172.31.47.0-255,66,187077,90,266280
10570,0.001859,74.125.68.0-255,5020,192097,90,266280
10571,0.001861,172.31.47.0-255,66,192163,90,266280
10572,0.001923,74.125.68.0-255,1484,193647,90,266280
10573,0.00194,74.125.68.0-255,2902,196549,90,266280
10574,0.001942,172.31.47.0-255,66,196615,90,266280
10575,0.001946,74.125.68.0-255,1484,198099,90,266280
10576,0.001966,74.125.68.0-255,2902,201001,90,266280
10577,0.001968,172.31.47.0-255,66,201067,90,266280
10578,0.001971,74.125.68.0-255,1484,202551,90,266280
10579,0.001997,74.125.68.0-255,4320,206871,90,266280
10580,0.001999,172.31.47.0-255,66,206937,90,266280
10581,0.002004,74.125.68.0-255,4320,211257,90,266280
10582,0.002006,172.31.47.0-255,66,211323,90,266280
10583,0.002036,74.125.68.0-255,7156,218479,90,266280
10584,0.002038,172.31.47.0-255,66,218545,90,266280
10585,0.002066,74.125.68.0-255,7856,226401,90,266280
10586,0.002101,74.125.68.0-255,1484,227885,90,266280
10587,0.002114,74.125.68.0-255,4320,232205,90,266280
10588,0.002123,74.125.68.0-255,1484,233689,90,266280
10589,0.002128,74.125.68.0-255,4320,238009,90,266280
10590,0.002145,74.125.68.0-255,4320,242329,90,266280
10591,0.002165,74.125.68.0-255,9992,252321,90,266280
10592,0.002216,74.125.68.0-255,5738,258059,90,266280
10593,0.00223,74.125.68.0-255,2184,260243,90,266280
10594,0.006436,172.31.47.0-255,66,260309,90,266280
10595,0.006901,172.31.47.0-255,101,260410,90,266280
10596,0.008728,74.125.68.0-255,5738,266148,90,266280
10597,0.008734,172.31.47.0-255,66,266214,90,266280
10598,0.00915,74.125.68.0-255,66,266280,90,266280
10599,0.0,74.125.24.0-255,153,153,90,83829
10600,3.2e-05,172.31.47.0-255,66,219,90,83829
10601,3.8e-05,74.125.24.0-255,1484,1703,90,83829
10602,4.2e-05,172.31.47.0-255,66,1769,90,83829
10603,4.6e-05,74.125.24.0-255,2902,4671,90,83829
10604,4.8e-05,172.31.47.0-255,66,4737,90,83829
10605,5.1e-05,74.125.24.0-255,1484,6221,90,83829
10606,5.3e-05,172.31.47.0-255,66,6287,90,83829
10607,5.7e-05,74.125.24.0-255,2902,9189,90,83829
10608,5.9e-05,172.31.47.0-255,66,9255,90,83829
10609,0.000103,74.125.24.0-255,4996,14251,90,83829
10610,0.000106,172.31.47.0-255,66,14317,90,83829
10611,0.000549,74.125.24.0-255,1484,15801,90,83829
10612,0.000554,172.31.47.0-255,66,15867,90,83829
10613,0.000561,74.125.24.0-255,2902,18769,90,83829
10614,0.000563,172.31.47.0-255,66,18835,90,83829
10615,0.000569,74.125.24.0-255,5738,24573,90,83829
10616,0.00057,172.31.47.0-255,66,24639,90,83829
10617,0.000667,74.125.24.0-255,5738,30377,90,83829
10618,0.000671,172.31.47.0-255,66,30443,90,83829
10619,0.000687,74.125.24.0-255,1125,31568,90,83829
10620,0.000689,172.31.47.0-255,66,31634,90,83829
10621,0.002059,74.125.24.0-255,1484,33118,90,83829
10622,0.002065,172.31.47.0-255,66,33184,90,83829
10623,0.00207,74.125.24.0-255,2902,36086,90,83829
10624,0.002073,172.31.47.0-255,66,36152,90,83829
10625,0.002092,74.125.24.0-255,1484,37636,90,83829
10626,0.002094,172.31.47.0-255,66,37702,90,83829
10627,0.002117,74.125.24.0-255,4320,42022,90,83829
10628,0.002119,172.31.47.0-255,66,42088,90,83829
10629,0.002123,74.125.24.0-255,2902,44990,90,83829
10630,0.002125,172.31.47.0-255,66,45056,90,83829
10631,0.002147,74.125.24.0-255,7156,52212,90,83829
10632,0.002149,172.31.47.0-255,66,52278,90,83829
10633,0.002169,74.125.24.0-255,3961,56239,90,83829
10634,0.002171,172.31.47.0-255,66,56305,90,83829
10635,0.002175,74.125.24.0-255,4320,60625,90,83829
10636,0.002177,172.31.47.0-255,66,60691,90,83829
10637,0.002215,74.125.24.0-255,5660,66351,90,83829
10638,0.002217,172.31.47.0-255,66,66417,90,83829
10639,0.004479,74.125.24.0-255,5738,72155,90,83829
10640,0.004485,172.31.47.0-255,66,72221,90,83829
10641,0.006727,74.125.24.0-255,5738,77959,90,83829
10642,0.006735,172.31.47.0-255,66,78025,90,83829
10643,0.009006,74.125.24.0-255,5738,83763,90,83829
10644,0.009016,172.31.47.0-255,66,83829,90,83829
10645,0.0,172.217.194.0-255,150,150,90,127341
10646,3e-05,172.31.47.0-255,66,216,90,127341
10647,3.7e-05,172.217.194.0-255,1484,1700,90,127341
10648,4.1e-05,172.31.47.0-255,66,1766,90,127341
10649,4.3e-05,172.217.194.0-255,1484,3250,90,127341
10650,4.6e-05,172.31.47.0-255,66,3316,90,127341
10651,8.4e-05,172.217.194.0-255,1484,4800,90,127341
10652,8.7e-05,172.31.47.0-255,66,4866,90,127341
10653,9.5e-05,172.217.194.0-255,5738,10604,90,127341
10654,9.6e-05,172.31.47.0-255,66,10670,90,127341
10655,0.000104,172.217.194.0-255,2902,13572,90,127341
10656,0.000106,172.31.47.0-255,66,13638,90,127341
10657,0.00013,172.217.194.0-255,766,14404,90,127341
10658,0.000137,172.31.47.0-255,66,14470,90,127341
10659,0.00021,172.217.194.0-255,1484,15954,90,127341
10660,0.000212,172.31.47.0-255,66,16020,90,127341
10661,0.000237,172.217.194.0-255,2902,18922,90,127341
10662,0.00024,172.31.47.0-255,66,18988,90,127341
10663,0.000247,172.217.194.0-255,5738,24726,90,127341
10664,0.000249,172.31.47.0-255,66,24792,90,127341
10665,0.000284,172.217.194.0-255,6797,31589,90,127341
10666,0.000287,172.31.47.0-255,66,31655,90,127341
10667,0.000293,172.217.194.0-255,7156,38811,90,127341
10668,0.000295,172.31.47.0-255,66,38877,90,127341
10669,0.000324,172.31.47.0-255,66,38943,90,127341
10670,0.00035,172.217.194.0-255,4320,43263,90,127341
10671,0.000355,172.31.47.0-255,66,43329,90,127341
10672,0.000364,172.217.194.0-255,4320,47649,90,127341
10673,0.000371,172.31.47.0-255,66,47715,90,127341
10674,0.000398,172.217.194.0-255,6438,54153,90,127341
10675,0.000401,172.31.47.0-255,66,54219,90,127341
10676,0.000404,172.217.194.0-255,377,54596,90,127341
10677,0.000675,172.31.47.0-255,66,54662,90,127341
10678,0.000974,172.217.194.0-255,366,55028,90,127341
10679,0.001016,172.31.47.0-255,66,55094,90,127341
10680,0.001137,172.217.194.0-255,1484,56578,90,127341
10681,0.001156,172.217.194.0-255,2902,59480,90,127341
10682,0.00116,172.31.47.0-255,66,59546,90,127341
10683,0.001166,172.217.194.0-255,5738,65284,90,127341
10684,0.001168,172.31.47.0-255,66,65350,90,127341
10685,0.001172,172.217.194.0-255,2902,68252,90,127341
10686,0.00118,172.31.47.0-255,66,68318,90,127341
10687,0.001204,172.217.194.0-255,2902,71220,90,127341
10688,0.001211,172.31.47.0-255,66,71286,90,127341
10689,0.001235,172.217.194.0-255,5738,77024,90,127341
10690,0.001237,172.31.47.0-255,66,77090,90,127341
10691,0.001264,172.217.194.0-255,5379,82469,90,127341
10692,0.001266,172.31.47.0-255,66,82535,90,127341
10693,0.001294,172.217.194.0-255,6248,88783,90,127341
10694,0.001297,172.31.47.0-255,66,88849,90,127341
10695,0.0014,172.217.194.0-255,1484,90333,90,127341
10696,0.001405,172.217.194.0-255,2902,93235,90,127341
10697,0.001407,172.31.47.0-255,66,93301,90,127341
10698,0.001432,172.217.194.0-255,5738,99039,90,127341
10699,0.001435,172.31.47.0-255,66,99105,90,127341
10700,0.001469,172.31.47.0-255,66,99171,90,127341
10701,0.001518,172.217.194.0-255,10692,109863,90,127341
10702,0.001521,172.31.47.0-255,66,109929,90,127341
10703,0.003871,172.217.194.0-255,5738,115667,90,127341
10704,0.003877,172.31.47.0-255,66,115733,90,127341
10705,0.006237,172.217.194.0-255,5738,121471,90,127341
10706,0.006243,172.31.47.0-255,66,121537,90,127341
10707,0.00864,172.217.194.0-255,5738,127275,90,127341
10708,0.008647,172.31.47.0-255,66,127341,90,127341
10709,0.0,172.31.47.0-255,105,105,90,105
10710,0.0,74.125.24.0-255,145,145,90,226466
10711,2.1e-05,172.31.47.0-255,66,211,90,226466
10712,4.6e-05,74.125.24.0-255,1484,1695,90,226466
10713,4.9e-05,172.31.47.0-255,66,1761,90,226466
10714,5.4e-05,74.125.24.0-255,2902,4663,90,226466
10715,5.6e-05,172.31.47.0-255,66,4729,90,226466
10716,7.1e-05,74.125.24.0-255,2902,7631,90,226466
10717,7.3e-05,172.31.47.0-255,66,7697,90,226466
10718,9.5e-05,74.125.24.0-255,2902,10599,90,226466
10719,9.8e-05,172.31.47.0-255,66,10665,90,226466
10720,0.000105,74.125.24.0-255,8574,19239,90,226466
10721,0.000106,172.31.47.0-255,66,19305,90,226466
10722,0.000135,74.125.24.0-255,2137,21442,90,226466
10723,0.000137,172.31.47.0-255,66,21508,90,226466
10724,0.000142,74.125.24.0-255,4320,25828,90,226466
10725,0.000144,172.31.47.0-255,66,25894,90,226466
10726,0.000176,172.31.47.0-255,66,25960,90,226466
10727,0.000181,74.125.24.0-255,5020,30980,90,226466
10728,0.000183,172.31.47.0-255,66,31046,90,226466
10729,0.00022,74.125.24.0-255,2902,33948,90,226466
10730,0.000223,172.31.47.0-255,66,34014,90,226466
10731,0.000227,74.125.24.0-255,4320,38334,90,226466
10732,0.00023,172.31.47.0-255,66,38400,90,226466
10733,0.000232,74.125.24.0-255,1484,39884,90,226466
10734,0.000234,172.31.47.0-255,66,39950,90,226466
10735,0.000264,74.125.24.0-255,7156,47106,90,226466
10736,0.000272,172.31.47.0-255,66,47172,90,226466
10737,0.000274,74.125.24.0-255,1468,48640,90,226466
10738,0.000276,172.31.47.0-255,66,48706,90,226466
10739,0.000301,74.125.24.0-255,1484,50190,90,226466
10740,0.000304,172.31.47.0-255,66,50256,90,226466
10741,0.000314,74.125.24.0-255,1484,51740,90,226466
10742,0.000323,74.125.24.0-255,4320,56060,90,226466
10743,0.000326,172.31.47.0-255,66,56126,90,226466
10744,0.000344,74.125.24.0-255,5738,61864,90,226466
10745,0.000347,172.31.47.0-255,66,61930,90,226466
10746,0.000374,74.125.24.0-255,4320,66250,90,226466
10747,0.00038,172.31.47.0-255,66,66316,90,226466
10748,0.000385,172.31.47.0-255,66,66382,90,226466
10749,0.000405,74.125.24.0-255,5020,71402,90,226466
10750,0.000411,172.31.47.0-255,66,71468,90,226466
10751,0.000744,74.125.24.0-255,1484,72952,90,226466
10752,0.000748,74.125.24.0-255,1484,74436,90,226466
10753,0.000751,172.31.47.0-255,66,74502,90,226466
10754,0.000776,74.125.24.0-255,1484,75986,90,226466
10755,0.000782,74.125.24.0-255,2902,78888,90,226466
10756,0.000785,172.31.47.0-255,66,78954,90,226466
10757,0.000792,74.125.24.0-255,7156,86110,90,226466
10758,0.000794,172.31.47.0-255,66,86176,90,226466
10759,0.000851,172.31.47.0-255,66,86242,90,226466
10760,0.000877,74.125.24.0-255,3602,89844,90,226466
10761,0.000881,172.31.47.0-255,66,89910,90,226466
10762,0.00157,74.125.24.0-255,1484,91394,90,226466
10763,0.001581,74.125.24.0-255,2902,94296,90,226466
10764,0.001585,172.31.47.0-255,66,94362,90,226466
10765,0.001609,74.125.24.0-255,5738,100100,90,226466
10766,0.001611,172.31.47.0-255,66,100166,90,226466
10767,0.00167,172.31.47.0-255,66,100232,90,226466
10768,0.00169,74.125.24.0-255,10692,110924,90,226466
10769,0.001693,172.31.47.0-255,66,110990,90,226466
10770,0.001723,172.31.47.0-255,66,111056,90,226466
10771,0.001749,74.125.24.0-255,8574,119630,90,226466
10772,0.001752,172.31.47.0-255,66,119696,90,226466
10773,0.001756,74.125.24.0-255,2902,122598,90,226466
10774,0.001757,172.31.47.0-255,66,122664,90,226466
10775,0.001793,74.125.24.0-255,7156,129820,90,226466
10776,0.001797,172.31.47.0-255,66,129886,90,226466
10777,0.001803,74.125.24.0-255,3602,133488,90,226466
10778,0.001805,172.31.47.0-255,66,133554,90,226466
10779,0.001861,74.125.24.0-255,1484,135038,90,226466
10780,0.001873,74.125.24.0-255,2902,137940,90,226466
10781,0.001876,172.31.47.0-255,66,138006,90,226466
10782,0.001904,74.125.24.0-255,5738,143744,90,226466
10783,0.001905,172.31.47.0-255,66,143810,90,226466
10784,0.001909,74.125.24.0-255,2902,146712,90,226466
10785,0.001911,172.31.47.0-255,66,146778,90,226466
10786,0.001945,74.125.24.0-255,9992,156770,90,226466
10787,0.001946,172.31.47.0-255,66,156836,90,226466
10788,0.001955,74.125.24.0-255,10692,167528,90,226466
10789,0.001957,172.31.47.0-255,66,167594,90,226466
10790,0.001987,74.125.24.0-255,1484,169078,90,226466
10791,0.002001,74.125.24.0-255,2902,171980,90,226466
10792,0.002003,172.31.47.0-255,66,172046,90,226466
10793,0.002029,74.125.24.0-255,5738,177784,90,226466
10794,0.002031,172.31.47.0-255,66,177850,90,226466
10795,0.002041,74.125.24.0-255,8574,186424,90,226466
10796,0.002043,172.31.47.0-255,66,186490,90,226466
10797,0.00206,74.125.24.0-255,4320,190810,90,226466
10798,0.002062,172.31.47.0-255,66,190876,90,226466
10799,0.002072,74.125.24.0-255,2902,193778,90,226466
10800,0.002078,172.31.47.0-255,66,193844,90,226466
10801,0.00211,74.125.24.0-255,10692,204536,90,226466
10802,0.002112,172.31.47.0-255,66,204602,90,226466
10803,0.002117,74.125.24.0-255,5738,210340,90,226466
10804,0.002119,172.31.47.0-255,66,210406,90,226466
10805,0.004179,74.125.24.0-255,4320,214726,90,226466
10806,0.004183,172.31.47.0-255,66,214792,90,226466
10807,0.004207,74.125.24.0-255,1484,216276,90,226466
10808,0.006291,74.125.24.0-255,4320,220596,90,226466
10809,0.006305,172.31.47.0-255,66,220662,90,226466
10810,0.008406,74.125.24.0-255,5738,226400,90,226466
10811,0.008424,172.31.47.0-255,66,226466,90,226466
10812,0.0,172.217.194.0-255,152,152,90,93814
10813,3.6e-05,172.31.47.0-255,66,218,90,93814
10814,4.3e-05,172.217.194.0-255,1484,1702,90,93814
10815,4.7e-05,172.31.47.0-255,66,1768,90,93814
10816,5.2e-05,172.217.194.0-255,2902,4670,90,93814
10817,5.4e-05,172.31.47.0-255,66,4736,90,93814
10818,6.8e-05,172.217.194.0-255,7156,11892,90,93814
10819,7.1e-05,172.31.47.0-255,66,11958,90,93814
10820,7.4e-05,172.217.194.0-255,2145,14103,90,93814
10821,7.7e-05,172.31.47.0-255,66,14169,90,93814
10822,0.00013,172.217.194.0-255,1484,15653,90,93814
10823,0.000132,172.31.47.0-255,66,15719,90,93814
10824,0.000135,172.217.194.0-255,1484,17203,90,93814
10825,0.000138,172.31.47.0-255,66,17269,90,93814
10826,0.000154,172.217.194.0-255,1484,18753,90,93814
10827,0.000156,172.31.47.0-255,66,18819,90,93814
10828,0.000164,172.217.194.0-255,5738,24557,90,93814
10829,0.000165,172.31.47.0-255,66,24623,90,93814
10830,0.000172,172.217.194.0-255,6797,31420,90,93814
10831,0.000175,172.31.47.0-255,66,31486,90,93814
10832,0.000328,172.217.194.0-255,1484,32970,90,93814
10833,0.000332,172.31.47.0-255,66,33036,90,93814
10834,0.000337,172.217.194.0-255,2902,35938,90,93814
10835,0.000339,172.31.47.0-255,66,36004,90,93814
10836,0.000343,172.217.194.0-255,2902,38906,90,93814
10837,0.000351,172.31.47.0-255,66,38972,90,93814
10838,0.000373,172.217.194.0-255,2902,41874,90,93814
10839,0.000376,172.31.47.0-255,66,41940,90,93814
10840,0.000383,172.217.194.0-255,6797,48737,90,93814
10841,0.000385,172.31.47.0-255,66,48803,90,93814
10842,0.000584,172.217.194.0-255,1484,50287,90,93814
10843,0.000588,172.31.47.0-255,66,50353,90,93814
10844,0.000592,172.217.194.0-255,2902,53255,90,93814
10845,0.000594,172.31.47.0-255,66,53321,90,93814
10846,0.000613,172.217.194.0-255,5738,59059,90,93814
10847,0.000622,172.31.47.0-255,66,59125,90,93814
10848,0.000649,172.217.194.0-255,6797,65922,90,93814
10849,0.000652,172.217.194.0-255,361,66283,90,93814
10850,0.000653,172.31.47.0-255,66,66349,90,93814
10851,0.000755,172.31.47.0-255,66,66415,90,93814
10852,0.001134,172.217.194.0-255,383,66798,90,93814
10853,0.001383,172.217.194.0-255,1484,68282,90,93814
10854,0.001388,172.31.47.0-255,66,68348,90,93814
10855,0.001394,172.217.194.0-255,2902,71250,90,93814
10856,0.001396,172.31.47.0-255,66,71316,90,93814
10857,0.001401,172.217.194.0-255,5738,77054,90,93814
10858,0.001402,172.31.47.0-255,66,77120,90,93814
10859,0.001446,172.31.47.0-255,66,77186,90,93814
10860,0.00147,172.217.194.0-255,8574,85760,90,93814
10861,0.001481,172.217.194.0-255,2184,87944,90,93814
10862,0.006317,172.31.47.0-255,66,88010,90,93814
10863,0.008704,172.217.194.0-255,5738,93748,90,93814
10864,0.008719,172.31.47.0-255,66,93814,90,93814
10865,0.0,74.125.24.0-255,153,153,90,300152
10866,1.5e-05,172.31.47.0-255,66,219,90,300152
10867,2.1e-05,74.125.24.0-255,1484,1703,90,300152
10868,2.5e-05,172.31.47.0-255,66,1769,90,300152
10869,3.2e-05,74.125.24.0-255,2902,4671,90,300152
10870,3.4e-05,172.31.47.0-255,66,4737,90,300152
10871,4.1e-05,74.125.24.0-255,7156,11893,90,300152
10872,4.4e-05,172.31.47.0-255,66,11959,90,300152
10873,7.7e-05,74.125.24.0-255,10644,22603,90,300152
10874,8e-05,172.31.47.0-255,66,22669,90,300152
10875,0.00011,74.125.24.0-255,8215,30884,90,300152
10876,0.000112,172.31.47.0-255,66,30950,90,300152
10877,0.000138,74.125.24.0-255,8574,39524,90,300152
10878,0.000141,172.31.47.0-255,66,39590,90,300152
10879,0.000153,74.125.24.0-255,1484,41074,90,300152
10880,0.000155,172.31.47.0-255,66,41140,90,300152
10881,0.000171,74.125.24.0-255,6797,47937,90,300152
10882,0.000173,172.31.47.0-255,66,48003,90,300152
10883,0.00061,74.125.24.0-255,1484,49487,90,300152
10884,0.000615,172.31.47.0-255,66,49553,90,300152
10885,0.000621,74.125.24.0-255,2902,52455,90,300152
10886,0.000623,172.31.47.0-255,66,52521,90,300152
10887,0.000629,74.125.24.0-255,4320,56841,90,300152
10888,0.000631,172.31.47.0-255,66,56907,90,300152
10889,0.000653,74.125.24.0-255,1484,58391,90,300152
10890,0.000656,172.31.47.0-255,66,58457,90,300152
10891,0.000664,74.125.24.0-255,6797,65254,90,300152
10892,0.000666,172.31.47.0-255,66,65320,90,300152
10893,0.000723,74.125.24.0-255,1484,66804,90,300152
10894,0.000726,172.31.47.0-255,66,66870,90,300152
10895,0.000732,74.125.24.0-255,2902,69772,90,300152
10896,0.000734,172.31.47.0-255,66,69838,90,300152
10897,0.000739,74.125.24.0-255,4320,74158,90,300152
10898,0.000742,172.31.47.0-255,66,74224,90,300152
10899,0.000765,74.125.24.0-255,1484,75708,90,300152
10900,0.000774,74.125.24.0-255,6797,82505,90,300152
10901,0.000777,172.31.47.0-255,66,82571,90,300152
10902,0.000819,74.125.24.0-255,4320,86891,90,300152
10903,0.000823,172.31.47.0-255,66,86957,90,300152
10904,0.000851,74.125.24.0-255,9992,96949,90,300152
10905,0.000857,74.125.24.0-255,3125,100074,90,300152
10906,0.000868,172.31.47.0-255,66,100140,90,300152
10907,0.00087,172.31.47.0-255,66,100206,90,300152
10908,0.001226,74.125.24.0-255,1484,101690,90,300152
10909,0.001246,74.125.24.0-255,2902,104592,90,300152
10910,0.00125,172.31.47.0-255,66,104658,90,300152
10911,0.001257,74.125.24.0-255,5738,110396,90,300152
10912,0.001259,172.31.47.0-255,66,110462,90,300152
10913,0.001263,74.125.24.0-255,1484,111946,90,300152
10914,0.001278,74.125.24.0-255,2902,114848,90,300152
10915,0.001281,172.31.47.0-255,66,114914,90,300152
10916,0.001287,74.125.24.0-255,5738,120652,90,300152
10917,0.001289,172.31.47.0-255,66,120718,90,300152
10918,0.001294,74.125.24.0-255,2902,123620,90,300152
10919,0.001297,172.31.47.0-255,66,123686,90,300152
10920,0.001326,74.125.24.0-255,8574,132260,90,300152
10921,0.001329,172.31.47.0-255,66,132326,90,300152
10922,0.001337,74.125.24.0-255,6438,138764,90,300152
10923,0.00134,172.31.47.0-255,66,138830,90,300152
10924,0.001347,74.125.24.0-255,7156,145986,90,300152
10925,0.00135,172.31.47.0-255,66,146052,90,300152
10926,0.001395,172.31.47.0-255,66,146118,90,300152
10927,0.001402,74.125.24.0-255,6438,152556,90,300152
10928,0.001405,172.31.47.0-255,66,152622,90,300152
10929,0.001447,74.125.24.0-255,1484,154106,90,300152
10930,0.001453,74.125.24.0-255,2902,157008,90,300152
10931,0.001457,172.31.47.0-255,66,157074,90,300152
10932,0.001463,74.125.24.0-255,5738,162812,90,300152
10933,0.001466,172.31.47.0-255,66,162878,90,300152
10934,0.001469,74.125.24.0-255,1484,164362,90,300152
10935,0.001493,74.125.24.0-255,5738,170100,90,300152
10936,0.001497,172.31.47.0-255,66,170166,90,300152
10937,0.0015,74.125.24.0-255,1484,171650,90,300152
10938,0.001521,74.125.24.0-255,5738,177388,90,300152
10939,0.001526,172.31.47.0-255,66,177454,90,300152
10940,0.00154,74.125.24.0-255,1484,178938,90,300152
10941,0.001573,74.125.24.0-255,7856,186794,90,300152
10942,0.001576,172.31.47.0-255,66,186860,90,300152
10943,0.001584,74.125.24.0-255,8574,195434,90,300152
10944,0.001587,172.31.47.0-255,66,195500,90,300152
10945,0.001593,74.125.24.0-255,5738,201238,90,300152
10946,0.001597,172.31.47.0-255,66,201304,90,300152
10947,0.001604,74.125.24.0-255,7156,208460,90,300152
10948,0.001607,172.31.47.0-255,66,208526,90,300152
10949,0.001636,74.125.24.0-255,8574,217100,90,300152
10950,0.00164,172.31.47.0-255,66,217166,90,300152
10951,0.001645,74.125.24.0-255,3602,220768,90,300152
10952,0.001648,172.31.47.0-255,66,220834,90,300152
10953,0.001862,74.125.24.0-255,1484,222318,90,300152
10954,0.001869,74.125.24.0-255,2902,225220,90,300152
10955,0.001873,172.31.47.0-255,66,225286,90,300152
10956,0.001879,74.125.24.0-255,4320,229606,90,300152
10957,0.001881,172.31.47.0-255,66,229672,90,300152
10958,0.001895,74.125.24.0-255,1484,231156,90,300152
10959,0.00193,74.125.24.0-255,4320,235476,90,300152
10960,0.001933,172.31.47.0-255,66,235542,90,300152
10961,0.001963,74.125.24.0-255,8574,244116,90,300152
10962,0.001968,172.31.47.0-255,66,244182,90,300152
10963,0.001978,74.125.24.0-255,10692,254874,90,300152
10964,0.001981,172.31.47.0-255,66,254940,90,300152
10965,0.001996,74.125.24.0-255,1484,256424,90,300152
10966,0.002001,74.125.24.0-255,2902,259326,90,300152
10967,0.002004,172.31.47.0-255,66,259392,90,300152
10968,0.00201,74.125.24.0-255,5738,265130,90,300152
10969,0.002012,172.31.47.0-255,66,265196,90,300152
10970,0.002052,172.31.47.0-255,66,265262,90,300152
10971,0.002066,74.125.24.0-255,1484,266746,90,300152
10972,0.002102,172.31.47.0-255,66,266812,90,300152
10973,0.002115,172.31.47.0-255,66,266878,90,300152
10974,0.002123,74.125.24.0-255,8574,275452,90,300152
10975,0.002125,172.31.47.0-255,66,275518,90,300152
10976,0.002146,74.125.24.0-255,7156,282674,90,300152
10977,0.002149,172.31.47.0-255,66,282740,90,300152
10978,0.004257,74.125.24.0-255,5738,288478,90,300152
10979,0.004275,172.31.47.0-255,66,288544,90,300152
10980,0.006402,74.125.24.0-255,5738,294282,90,300152
10981,0.006419,172.31.47.0-255,66,294348,90,300152
10982,0.008492,74.125.24.0-255,5738,300086,90,300152
10983,0.008502,172.31.47.0-255,66,300152,90,300152
10984,0.0,172.217.194.0-255,153,153,90,192729
10985,1.4e-05,172.31.47.0-255,66,219,90,192729
10986,2e-05,172.217.194.0-255,1484,1703,90,192729
10987,2.3e-05,172.31.47.0-255,66,1769,90,192729
10988,3e-05,172.217.194.0-255,2902,4671,90,192729
10989,4.3e-05,172.31.47.0-255,66,4737,90,192729
10990,5e-05,172.217.194.0-255,7156,11893,90,192729
10991,5.3e-05,172.31.47.0-255,66,11959,90,192729
10992,5.7e-05,172.217.194.0-255,2128,14087,90,192729
10993,5.9e-05,172.31.47.0-255,66,14153,90,192729
10994,0.000166,172.217.194.0-255,1484,15637,90,192729
10995,0.00017,172.31.47.0-255,66,15703,90,192729
10996,0.000175,172.217.194.0-255,2902,18605,90,192729
10997,0.000177,172.31.47.0-255,66,18671,90,192729
10998,0.000196,172.217.194.0-255,5738,24409,90,192729
10999,0.000198,172.31.47.0-255,66,24475,90,192729
11000,0.000229,172.31.47.0-255,66,24541,90,192729
11001,0.000261,172.31.47.0-255,66,24607,90,192729
11002,0.000296,172.31.47.0-255,66,24673,90,192729
11003,0.000302,172.217.194.0-255,6752,31425,90,192729
11004,0.000304,172.31.47.0-255,66,31491,90,192729
11005,0.00033,172.217.194.0-255,365,31856,90,192729
11006,0.000333,172.31.47.0-255,66,31922,90,192729
11007,0.000432,172.217.194.0-255,1484,33406,90,192729
11008,0.000436,172.31.47.0-255,66,33472,90,192729
11009,0.000454,172.217.194.0-255,2902,36374,90,192729
11010,0.000456,172.31.47.0-255,66,36440,90,192729
11011,0.000461,172.217.194.0-255,4320,40760,90,192729
11012,0.000463,172.31.47.0-255,66,40826,90,192729
11013,0.000492,172.217.194.0-255,1484,42310,90,192729
11014,0.000506,172.31.47.0-255,66,42376,90,192729
11015,0.000515,172.217.194.0-255,10141,52517,90,192729
11016,0.000517,172.31.47.0-255,66,52583,90,192729
11017,0.000593,172.31.47.0-255,66,52649,90,192729
11018,0.000645,172.217.194.0-255,1484,54133,90,192729
11019,0.00066,172.217.194.0-255,2902,57035,90,192729
11020,0.000663,172.31.47.0-255,66,57101,90,192729
11021,0.000669,172.217.194.0-255,5738,62839,90,192729
11022,0.000671,172.31.47.0-255,66,62905,90,192729
11023,0.000693,172.217.194.0-255,5738,68643,90,192729
11024,0.000695,172.31.47.0-255,66,68709,90,192729
11025,0.000726,172.217.194.0-255,7156,75865,90,192729
11026,0.000735,172.217.194.0-255,10692,86557,90,192729
11027,0.000739,172.31.47.0-255,66,86623,90,192729
11028,0.000741,172.31.47.0-255,66,86689,90,192729
11029,0.001554,172.217.194.0-255,1484,88173,90,192729
11030,0.001559,172.217.194.0-255,2902,91075,90,192729
11031,0.001562,172.31.47.0-255,66,91141,90,192729
11032,0.001567,172.217.194.0-255,2902,94043,90,192729
11033,0.001569,172.31.47.0-255,66,94109,90,192729
11034,0.00159,172.217.194.0-255,2902,97011,90,192729
11035,0.001593,172.31.47.0-255,66,97077,90,192729
11036,0.001603,172.217.194.0-255,7156,104233,90,192729
11037,0.001604,172.31.47.0-255,66,104299,90,192729
11038,0.001639,172.217.194.0-255,5738,110037,90,192729
11039,0.001641,172.31.47.0-255,66,110103,90,192729
11040,0.00165,172.217.194.0-255,10692,120795,90,192729
11041,0.001652,172.31.47.0-255,66,120861,90,192729
11042,0.00208,172.217.194.0-255,1484,122345,90,192729
11043,0.002088,172.217.194.0-255,2902,125247,90,192729
11044,0.002091,172.31.47.0-255,66,125313,90,192729
11045,0.002098,172.217.194.0-255,5738,131051,90,192729
11046,0.002099,172.31.47.0-255,66,131117,90,192729
11047,0.00213,172.31.47.0-255,66,131183,90,192729
11048,0.002176,172.31.47.0-255,66,131249,90,192729
11049,0.002193,172.217.194.0-255,7856,139105,90,192729
11050,0.002198,172.31.47.0-255,66,139171,90,192729
11051,0.002212,172.31.47.0-255,66,139237,90,192729
11052,0.002252,172.217.194.0-255,10692,149929,90,192729
11053,0.002254,172.31.47.0-255,66,149995,90,192729
11054,0.002275,172.31.47.0-255,66,150061,90,192729
11055,0.00228,172.217.194.0-255,4320,154381,90,192729
11056,0.002282,172.31.47.0-255,66,154447,90,192729
11057,0.00232,172.31.47.0-255,66,154513,90,192729
11058,0.002356,172.31.47.0-255,66,154579,90,192729
11059,0.00239,172.217.194.0-255,9992,164571,90,192729
11060,0.002392,172.31.47.0-255,66,164637,90,192729
11061,0.002401,172.217.194.0-255,10692,175329,90,192729
11062,0.002403,172.31.47.0-255,66,175395,90,192729
11063,0.00241,172.217.194.0-255,7156,182551,90,192729
11064,0.002411,172.31.47.0-255,66,182617,90,192729
11065,0.00247,172.31.47.0-255,66,182683,90,192729
11066,0.002494,172.31.47.0-255,66,182749,90,192729
11067,0.002519,172.217.194.0-255,9274,192023,90,192729
11068,0.002521,172.31.47.0-255,66,192089,90,192729
11069,0.002547,172.31.47.0-255,66,192155,90,192729
11070,0.002569,172.217.194.0-255,469,192624,90,192729
11071,0.005005,172.217.194.0-255,105,192729,90,192729
11072,0.0,172.31.47.0-255,66,66,90,66
11073,0.0,74.125.68.0-255,153,153,90,232833
11074,3e-05,172.31.47.0-255,66,219,90,232833
11075,3.7e-05,74.125.68.0-255,1484,1703,90,232833
11076,4.2e-05,172.31.47.0-255,66,1769,90,232833
11077,5.4e-05,74.125.68.0-255,2902,4671,90,232833
11078,5.8e-05,172.31.47.0-255,66,4737,90,232833
11079,6.5e-05,74.125.68.0-255,7156,11893,90,232833
11080,6.7e-05,172.31.47.0-255,66,11959,90,232833
11081,7.1e-05,74.125.68.0-255,2125,14084,90,232833
11082,7.3e-05,172.31.47.0-255,66,14150,90,232833
11083,7.7e-05,74.125.68.0-255,1484,15634,90,232833
11084,7.9e-05,172.31.47.0-255,66,15700,90,232833
11085,0.000106,74.125.68.0-255,1484,17184,90,232833
11086,0.000109,172.31.47.0-255,66,17250,90,232833
11087,0.000116,74.125.68.0-255,7156,24406,90,232833
11088,0.000118,172.31.47.0-255,66,24472,90,232833
11089,0.000125,74.125.68.0-255,5738,30210,90,232833
11090,0.000127,172.31.47.0-255,66,30276,90,232833
11091,0.000169,74.125.68.0-255,1125,31401,90,232833
11092,0.000172,172.31.47.0-255,66,31467,90,232833
11093,0.000243,74.125.68.0-255,1484,32951,90,232833
11094,0.000245,172.31.47.0-255,66,33017,90,232833
11095,0.00028,74.125.68.0-255,1484,34501,90,232833
11096,0.000283,172.31.47.0-255,66,34567,90,232833
11097,0.000286,74.125.68.0-255,1484,36051,90,232833
11098,0.000289,172.31.47.0-255,66,36117,90,232833
11099,0.000318,74.125.68.0-255,1484,37601,90,232833
11100,0.000321,172.31.47.0-255,66,37667,90,232833
11101,0.000326,74.125.68.0-255,2902,40569,90,232833
11102,0.000329,172.31.47.0-255,66,40635,90,232833
11103,0.00035,74.125.68.0-255,2902,43537,90,232833
11104,0.000354,172.31.47.0-255,66,43603,90,232833
11105,0.000361,74.125.68.0-255,6797,50400,90,232833
11106,0.000363,172.31.47.0-255,66,50466,90,232833
11107,0.000401,74.125.68.0-255,4320,54786,90,232833
11108,0.000405,172.31.47.0-255,66,54852,90,232833
11109,0.000435,74.125.68.0-255,5738,60590,90,232833
11110,0.000439,172.31.47.0-255,66,60656,90,232833
11111,0.000473,74.125.68.0-255,5735,66391,90,232833
11112,0.000476,74.125.68.0-255,330,66721,90,232833
11113,0.000478,172.31.47.0-255,66,66787,90,232833
11114,0.000698,74.125.68.0-255,1484,68271,90,232833
11115,0.000701,172.31.47.0-255,66,68337,90,232833
11116,0.000705,74.125.68.0-255,1484,69821,90,232833
11117,0.000724,74.125.68.0-255,1484,71305,90,232833
11118,0.000727,172.31.47.0-255,66,71371,90,232833
11119,0.000731,74.125.68.0-255,2902,74273,90,232833
11120,0.000733,172.31.47.0-255,66,74339,90,232833
11121,0.00076,74.125.68.0-255,2902,77241,90,232833
11122,0.000763,172.31.47.0-255,66,77307,90,232833
11123,0.000767,74.125.68.0-255,2902,80209,90,232833
11124,0.000769,172.31.47.0-255,66,80275,90,232833
11125,0.000802,74.125.68.0-255,7156,87431,90,232833
11126,0.000805,172.31.47.0-255,66,87497,90,232833
11127,0.000816,172.31.47.0-255,66,87563,90,232833
11128,0.000819,74.125.68.0-255,2184,89747,90,232833
11129,0.000821,172.31.47.0-255,66,89813,90,232833
11130,0.001183,74.125.68.0-255,1484,91297,90,232833
11131,0.001191,74.125.68.0-255,2902,94199,90,232833
11132,0.001194,172.31.47.0-255,66,94265,90,232833
11133,0.001225,74.125.68.0-255,5738,100003,90,232833
11134,0.001228,172.31.47.0-255,66,100069,90,232833
11135,0.001259,74.125.68.0-255,9992,110061,90,232833
11136,0.001261,172.31.47.0-255,66,110127,90,232833
11137,0.001264,74.125.68.0-255,1484,111611,90,232833
11138,0.001296,74.125.68.0-255,9992,121603,90,232833
11139,0.001298,172.31.47.0-255,66,121669,90,232833
11140,0.001302,74.125.68.0-255,2184,123853,90,232833
11141,0.001304,172.31.47.0-255,66,123919,90,232833
11142,0.001446,74.125.68.0-255,1484,125403,90,232833
11143,0.001452,74.125.68.0-255,2902,128305,90,232833
11144,0.001456,172.31.47.0-255,66,128371,90,232833
11145,0.001469,74.125.68.0-255,1484,129855,90,232833
11146,0.001483,74.125.68.0-255,4320,134175,90,232833
11147,0.001485,172.31.47.0-255,66,134241,90,232833
11148,0.001511,74.125.68.0-255,5738,139979,90,232833
11149,0.001512,172.31.47.0-255,66,140045,90,232833
11150,0.001518,74.125.68.0-255,5738,145783,90,232833
11151,0.00152,172.31.47.0-255,66,145849,90,232833
11152,0.00154,74.125.68.0-255,1484,147333,90,232833
11153,0.001544,74.125.68.0-255,2902,150235,90,232833
11154,0.001546,172.31.47.0-255,66,150301,90,232833
11155,0.001571,74.125.68.0-255,7856,158157,90,232833
11156,0.001573,172.31.47.0-255,66,158223,90,232833
11157,0.001899,74.125.68.0-255,1484,159707,90,232833
11158,0.001918,74.125.68.0-255,2902,162609,90,232833
11159,0.00192,172.31.47.0-255,66,162675,90,232833
11160,0.001941,74.125.68.0-255,2902,165577,90,232833
11161,0.001943,172.31.47.0-255,66,165643,90,232833
11162,0.001962,74.125.68.0-255,2902,168545,90,232833
11163,0.001964,172.31.47.0-255,66,168611,90,232833
11164,0.001968,74.125.68.0-255,2902,171513,90,232833
11165,0.00197,172.31.47.0-255,66,171579,90,232833
11166,0.00199,74.125.68.0-255,5738,177317,90,232833
11167,0.001992,172.31.47.0-255,66,177383,90,232833
11168,0.002016,74.125.68.0-255,4320,181703,90,232833
11169,0.002018,172.31.47.0-255,66,181769,90,232833
11170,0.002026,74.125.68.0-255,9992,191761,90,232833
11171,0.002028,172.31.47.0-255,66,191827,90,232833
11172,0.00203,74.125.68.0-255,766,192593,90,232833
11173,0.002187,74.125.68.0-255,1484,194077,90,232833
11174,0.002189,172.31.47.0-255,66,194143,90,232833
11175,0.002199,74.125.68.0-255,1484,195627,90,232833
11176,0.002212,74.125.68.0-255,2902,198529,90,232833
11177,0.002214,172.31.47.0-255,66,198595,90,232833
11178,0.002239,74.125.68.0-255,5738,204333,90,232833
11179,0.002241,172.31.47.0-255,66,204399,90,232833
11180,0.002302,74.125.68.0-255,9992,214391,90,232833
11181,0.002304,172.31.47.0-255,66,214457,90,232833
11182,0.002314,172.31.47.0-255,66,214523,90,232833
11183,0.00232,74.125.68.0-255,2184,216707,90,232833
11184,0.002322,172.31.47.0-255,66,216773,90,232833
11185,0.004583,74.125.68.0-255,4320,221093,90,232833
11186,0.004586,172.31.47.0-255,66,221159,90,232833
11187,0.004607,74.125.68.0-255,1484,222643,90,232833
11188,0.00688,74.125.68.0-255,4320,226963,90,232833
11189,0.006886,172.31.47.0-255,66,227029,90,232833
11190,0.009188,74.125.68.0-255,5738,232767,90,232833
11191,0.009196,172.31.47.0-255,66,232833,90,232833
11192,0.0,172.31.47.0-255,105,105,90,276
11193,0.002083,157.240.13.0-255,105,210,90,276
11194,0.002098,172.31.47.0-255,66,276,90,276
11195,0.0,172.217.194.0-255,153,153,90,193644
11196,2.2e-05,172.31.47.0-255,66,219,90,193644
11197,2.8e-05,172.217.194.0-255,1484,1703,90,193644
11198,3.2e-05,172.31.47.0-255,66,1769,90,193644
11199,3.7e-05,172.217.194.0-255,2902,4671,90,193644
11200,3.9e-05,172.31.47.0-255,66,4737,90,193644
11201,4.6e-05,172.217.194.0-255,7156,11893,90,193644
11202,4.8e-05,172.31.47.0-255,66,11959,90,193644
11203,7.8e-05,172.217.194.0-255,2088,14047,90,193644
11204,8e-05,172.31.47.0-255,66,14113,90,193644
11205,0.000101,172.217.194.0-255,2902,17015,90,193644
11206,0.000103,172.31.47.0-255,66,17081,90,193644
11207,0.000135,172.217.194.0-255,7156,24237,90,193644
11208,0.000137,172.31.47.0-255,66,24303,90,193644
11209,0.00016,172.217.194.0-255,1484,25787,90,193644
11210,0.000163,172.31.47.0-255,66,25853,90,193644
11211,0.000178,172.217.194.0-255,4320,30173,90,193644
11212,0.00018,172.31.47.0-255,66,30239,90,193644
11213,0.000199,172.217.194.0-255,1125,31364,90,193644
11214,0.000201,172.31.47.0-255,66,31430,90,193644
11215,0.00027,172.217.194.0-255,1484,32914,90,193644
11216,0.000274,172.31.47.0-255,66,32980,90,193644
11217,0.000295,172.217.194.0-255,2902,35882,90,193644
11218,0.000298,172.31.47.0-255,66,35948,90,193644
11219,0.000304,172.217.194.0-255,5738,41686,90,193644
11220,0.000306,172.31.47.0-255,66,41752,90,193644
11221,0.000346,172.217.194.0-255,6797,48549,90,193644
11222,0.00035,172.31.47.0-255,66,48615,90,193644
11223,0.000384,172.217.194.0-255,2902,51517,90,193644
11224,0.000388,172.31.47.0-255,66,51583,90,193644
11225,0.000421,172.31.47.0-255,66,51649,90,193644
11226,0.000498,172.217.194.0-255,2798,54447,90,193644
11227,0.000517,172.31.47.0-255,66,54513,90,193644
11228,0.000553,172.217.194.0-255,431,54944,90,193644
11229,0.000637,172.217.194.0-255,1484,56428,90,193644
11230,0.000644,172.217.194.0-255,2902,59330,90,193644
11231,0.000659,172.31.47.0-255,66,59396,90,193644
11232,0.000666,172.217.194.0-255,5738,65134,90,193644
11233,0.000677,172.31.47.0-255,66,65200,90,193644
11234,0.000692,172.217.194.0-255,1484,66684,90,193644
11235,0.000707,172.217.194.0-255,5738,72422,90,193644
11236,0.000733,172.31.47.0-255,66,72488,90,193644
11237,0.00076,172.217.194.0-255,2902,75390,90,193644
11238,0.000768,172.31.47.0-255,66,75456,90,193644
11239,0.000783,172.217.194.0-255,8574,84030,90,193644
11240,0.000788,172.31.47.0-255,66,84096,90,193644
11241,0.000797,172.217.194.0-255,2902,86998,90,193644
11242,0.000837,172.31.47.0-255,66,87064,90,193644
11243,0.000866,172.217.194.0-255,2184,89248,90,193644
11244,0.000881,172.31.47.0-255,66,89314,90,193644
11245,0.001308,172.217.194.0-255,1484,90798,90,193644
11246,0.001313,172.217.194.0-255,2902,93700,90,193644
11247,0.001317,172.31.47.0-255,66,93766,90,193644
11248,0.001322,172.217.194.0-255,4320,98086,90,193644
11249,0.001334,172.217.194.0-255,1484,99570,90,193644
11250,0.00134,172.31.47.0-255,66,99636,90,193644
11251,0.001362,172.217.194.0-255,2902,102538,90,193644
11252,0.001365,172.31.47.0-255,66,102604,90,193644
11253,0.001376,172.217.194.0-255,8574,111178,90,193644
11254,0.001394,172.31.47.0-255,66,111244,90,193644
11255,0.001455,172.217.194.0-255,2902,114146,90,193644
11256,0.001463,172.31.47.0-255,66,114212,90,193644
11257,0.001476,172.217.194.0-255,9274,123486,90,193644
11258,0.001491,172.31.47.0-255,66,123552,90,193644
11259,0.001623,172.217.194.0-255,1484,125036,90,193644
11260,0.001637,172.217.194.0-255,2902,127938,90,193644
11261,0.001639,172.31.47.0-255,66,128004,90,193644
11262,0.001661,172.217.194.0-255,5738,133742,90,193644
11263,0.001673,172.31.47.0-255,66,133808,90,193644
11264,0.001717,172.31.47.0-255,66,133874,90,193644
11265,0.001788,172.217.194.0-255,2902,136776,90,193644
11266,0.001792,172.31.47.0-255,66,136842,90,193644
11267,0.001814,172.217.194.0-255,7856,144698,90,193644
11268,0.001854,172.31.47.0-255,66,144764,90,193644
11269,0.001948,172.217.194.0-255,1484,146248,90,193644
11270,0.001952,172.217.194.0-255,2902,149150,90,193644
11271,0.001955,172.31.47.0-255,66,149216,90,193644
11272,0.001957,172.217.194.0-255,1484,150700,90,193644
11273,0.001977,172.217.194.0-255,4320,155020,90,193644
11274,0.001991,172.31.47.0-255,66,155086,90,193644
11275,0.002029,172.217.194.0-255,7156,162242,90,193644
11276,0.002037,172.31.47.0-255,66,162308,90,193644
11277,0.002043,172.217.194.0-255,5738,168046,90,193644
11278,0.002047,172.31.47.0-255,66,168112,90,193644
11279,0.002115,172.217.194.0-255,5738,173850,90,193644
11280,0.00212,172.31.47.0-255,66,173916,90,193644
11281,0.00214,172.217.194.0-255,5020,178936,90,193644
11282,0.002144,172.31.47.0-255,66,179002,90,193644
11283,0.004229,172.217.194.0-255,2902,181904,90,193644
11284,0.004234,172.31.47.0-255,66,181970,90,193644
11285,0.004251,172.217.194.0-255,2902,184872,90,193644
11286,0.006306,172.217.194.0-255,2902,187774,90,193644
11287,0.007603,172.31.47.0-255,66,187840,90,193644
11288,0.009679,172.217.194.0-255,5738,193578,90,193644
11289,0.009687,172.31.47.0-255,66,193644,90,193644
11290,0.0,74.125.68.0-255,153,153,90,317563
11291,2e-05,172.31.47.0-255,66,219,90,317563
11292,2.7e-05,74.125.68.0-255,1484,1703,90,317563
11293,3e-05,172.31.47.0-255,66,1769,90,317563
11294,3.3e-05,74.125.68.0-255,1484,3253,90,317563
11295,3.6e-05,172.31.47.0-255,66,3319,90,317563
11296,5.3e-05,74.125.68.0-255,1484,4803,90,317563
11297,5.6e-05,172.31.47.0-255,66,4869,90,317563
11298,6.3e-05,74.125.68.0-255,7156,12025,90,317563
11299,6.4e-05,172.31.47.0-255,66,12091,90,317563
11300,6.6e-05,74.125.68.0-255,1484,13575,90,317563
11301,6.8e-05,172.31.47.0-255,66,13641,90,317563
11302,9.9e-05,74.125.68.0-255,567,14208,90,317563
11303,0.0001,172.31.47.0-255,66,14274,90,317563
11304,0.000145,74.125.68.0-255,1484,15758,90,317563
11305,0.000147,172.31.47.0-255,66,15824,90,317563
11306,0.000165,74.125.68.0-255,4320,20144,90,317563
11307,0.000168,172.31.47.0-255,66,20210,90,317563
11308,0.000171,74.125.68.0-255,2902,23112,90,317563
11309,0.000173,172.31.47.0-255,66,23178,90,317563
11310,0.000194,74.125.68.0-255,4320,27498,90,317563
11311,0.000196,172.31.47.0-255,66,27564,90,317563
11312,0.000224,74.125.68.0-255,1484,29048,90,317563
11313,0.000226,172.31.47.0-255,66,29114,90,317563
11314,0.000242,74.125.68.0-255,2543,31657,90,317563
11315,0.000244,172.31.47.0-255,66,31723,90,317563
11316,0.0003,74.125.68.0-255,1484,33207,90,317563
11317,0.000303,172.31.47.0-255,66,33273,90,317563
11318,0.000308,74.125.68.0-255,2902,36175,90,317563
11319,0.00031,172.31.47.0-255,66,36241,90,317563
11320,0.000327,74.125.68.0-255,4320,40561,90,317563
11321,0.00033,172.31.47.0-255,66,40627,90,317563
11322,0.000334,74.125.68.0-255,4320,44947,90,317563
11323,0.000337,172.31.47.0-255,66,45013,90,317563
11324,0.000352,74.125.68.0-255,1484,46497,90,317563
11325,0.000376,74.125.68.0-255,2902,49399,90,317563
11326,0.000379,172.31.47.0-255,66,49465,90,317563
11327,0.000405,74.125.68.0-255,8215,57680,90,317563
11328,0.000408,172.31.47.0-255,66,57746,90,317563
11329,0.000429,74.125.68.0-255,4320,62066,90,317563
11330,0.000433,172.31.47.0-255,66,62132,90,317563
11331,0.000452,74.125.68.0-255,4235,66367,90,317563
11332,0.000455,172.31.47.0-255,66,66433,90,317563
11333,0.000458,74.125.68.0-255,416,66849,90,317563
11334,0.00058,74.125.68.0-255,1484,68333,90,317563
11335,0.000584,172.31.47.0-255,66,68399,90,317563
11336,0.000603,74.125.68.0-255,2902,71301,90,317563
11337,0.000608,74.125.68.0-255,2902,74203,90,317563
11338,0.000612,172.31.47.0-255,66,74269,90,317563
11339,0.000616,172.31.47.0-255,66,74335,90,317563
11340,0.00062,74.125.68.0-255,1484,75819,90,317563
11341,0.000636,74.125.68.0-255,5738,81557,90,317563
11342,0.000639,172.31.47.0-255,66,81623,90,317563
11343,0.000672,74.125.68.0-255,7156,88779,90,317563
11344,0.000675,172.31.47.0-255,66,88845,90,317563
11345,0.000695,74.125.68.0-255,4320,93165,90,317563
11346,0.000698,172.31.47.0-255,66,93231,90,317563
11347,0.000715,74.125.68.0-255,2902,96133,90,317563
11348,0.000718,172.31.47.0-255,66,96199,90,317563
11349,0.000742,74.125.68.0-255,5020,101219,90,317563
11350,0.000745,172.31.47.0-255,66,101285,90,317563
11351,0.000986,74.125.68.0-255,1484,102769,90,317563
11352,0.000991,74.125.68.0-255,1484,104253,90,317563
11353,0.000994,172.31.47.0-255,66,104319,90,317563
11354,0.001008,74.125.68.0-255,1484,105803,90,317563
11355,0.001025,74.125.68.0-255,2902,108705,90,317563
11356,0.001028,172.31.47.0-255,66,108771,90,317563
11357,0.00105,74.125.68.0-255,2902,111673,90,317563
11358,0.001053,172.31.47.0-255,66,111739,90,317563
11359,0.001061,74.125.68.0-255,7156,118895,90,317563
11360,0.001063,172.31.47.0-255,66,118961,90,317563
11361,0.0011,172.31.47.0-255,66,119027,90,317563
11362,0.001116,74.125.68.0-255,3602,122629,90,317563
11363,0.001119,172.31.47.0-255,66,122695,90,317563
11364,0.001164,74.125.68.0-255,1484,124179,90,317563
11365,0.001185,74.125.68.0-255,2902,127081,90,317563
11366,0.001188,172.31.47.0-255,66,127147,90,317563
11367,0.001193,74.125.68.0-255,5738,132885,90,317563
11368,0.001195,172.31.47.0-255,66,132951,90,317563
11369,0.00122,74.125.68.0-255,8574,141525,90,317563
11370,0.001223,172.31.47.0-255,66,141591,90,317563
11371,0.001248,74.125.68.0-255,8574,150165,90,317563
11372,0.001251,172.31.47.0-255,66,150231,90,317563
11373,0.001267,74.125.68.0-255,1484,151715,90,317563
11374,0.001273,74.125.68.0-255,5020,156735,90,317563
11375,0.001275,172.31.47.0-255,66,156801,90,317563
11376,0.001375,74.125.68.0-255,1484,158285,90,317563
11377,0.001379,74.125.68.0-255,1484,159769,90,317563
11378,0.001383,172.31.47.0-255,66,159835,90,317563
11379,0.001395,74.125.68.0-255,1484,161319,90,317563
11380,0.001413,74.125.68.0-255,5738,167057,90,317563
11381,0.001416,172.31.47.0-255,66,167123,90,317563
11382,0.001421,74.125.68.0-255,4320,171443,90,317563
11383,0.001423,172.31.47.0-255,66,171509,90,317563
11384,0.001439,74.125.68.0-255,5738,177247,90,317563
11385,0.001442,172.31.47.0-255,66,177313,90,317563
11386,0.001459,74.125.68.0-255,2902,180215,90,317563
11387,0.001462,172.31.47.0-255,66,180281,90,317563
11388,0.00148,74.125.68.0-255,8574,188855,90,317563
11389,0.001483,172.31.47.0-255,66,188921,90,317563
11390,0.001488,74.125.68.0-255,2184,191105,90,317563
11391,0.00149,172.31.47.0-255,66,191171,90,317563
11392,0.001537,74.125.68.0-255,1484,192655,90,317563
11393,0.001555,74.125.68.0-255,2902,195557,90,317563
11394,0.001559,172.31.47.0-255,66,195623,90,317563
11395,0.001584,74.125.68.0-255,5738,201361,90,317563
11396,0.001587,172.31.47.0-255,66,201427,90,317563
11397,0.001591,74.125.68.0-255,2902,204329,90,317563
11398,0.001592,172.31.47.0-255,66,204395,90,317563
11399,0.001627,74.125.68.0-255,1484,205879,90,317563
11400,0.00166,74.125.68.0-255,8574,214453,90,317563
11401,0.001664,172.31.47.0-255,66,214519,90,317563
11402,0.001673,74.125.68.0-255,9992,224511,90,317563
11403,0.001676,172.31.47.0-255,66,224577,90,317563
11404,0.001685,74.125.68.0-255,10692,235269,90,317563
11405,0.001688,172.31.47.0-255,66,235335,90,317563
11406,0.001699,74.125.68.0-255,4320,239655,90,317563
11407,0.001702,172.31.47.0-255,66,239721,90,317563
11408,0.001736,74.125.68.0-255,5738,245459,90,317563
11409,0.00174,172.31.47.0-255,66,245525,90,317563
11410,0.001764,74.125.68.0-255,7156,252681,90,317563
11411,0.001768,172.31.47.0-255,66,252747,90,317563
11412,0.001786,74.125.68.0-255,4320,257067,90,317563
11413,0.00179,172.31.47.0-255,66,257133,90,317563
11414,0.001794,74.125.68.0-255,2184,259317,90,317563
11415,0.001796,172.31.47.0-255,66,259383,90,317563
11416,0.001875,74.125.68.0-255,1484,260867,90,317563
11417,0.00188,74.125.68.0-255,1484,262351,90,317563
11418,0.001884,172.31.47.0-255,66,262417,90,317563
11419,0.001901,74.125.68.0-255,1484,263901,90,317563
11420,0.001904,74.125.68.0-255,1484,265385,90,317563
11421,0.001908,172.31.47.0-255,66,265451,90,317563
11422,0.001912,74.125.68.0-255,1484,266935,90,317563
11423,0.001936,74.125.68.0-255,4320,271255,90,317563
11424,0.00194,172.31.47.0-255,66,271321,90,317563
11425,0.001944,74.125.68.0-255,2902,274223,90,317563
11426,0.001946,172.31.47.0-255,66,274289,90,317563
11427,0.001962,74.125.68.0-255,5738,280027,90,317563
11428,0.001966,172.31.47.0-255,66,280093,90,317563
11429,0.001986,74.125.68.0-255,4320,284413,90,317563
11430,0.001989,172.31.47.0-255,66,284479,90,317563
11431,0.001995,74.125.68.0-255,4320,288799,90,317563
11432,0.001998,172.31.47.0-255,66,288865,90,317563
11433,0.002004,74.125.68.0-255,5020,293885,90,317563
11434,0.002006,172.31.47.0-255,66,293951,90,317563
11435,0.003954,74.125.68.0-255,2902,296853,90,317563
11436,0.00396,172.31.47.0-255,66,296919,90,317563
11437,0.003978,74.125.68.0-255,2902,299821,90,317563
11438,0.003981,172.31.47.0-255,66,299887,90,317563
11439,0.005898,74.125.68.0-255,2902,302789,90,317563
11440,0.005904,172.31.47.0-255,66,302855,90,317563
11441,0.005924,74.125.68.0-255,2902,305757,90,317563
11442,0.005927,172.31.47.0-255,66,305823,90,317563
11443,0.007852,74.125.68.0-255,2902,308725,90,317563
11444,0.007857,172.31.47.0-255,66,308791,90,317563
11445,0.007876,74.125.68.0-255,2902,311693,90,317563
11446,0.007879,172.31.47.0-255,66,311759,90,317563
11447,0.00981,74.125.68.0-255,5738,317497,90,317563
11448,0.009817,172.31.47.0-255,66,317563,90,317563
11449,0.0,172.31.47.0-255,105,105,90,105
11450,0.0,74.125.24.0-255,148,148,90,230659
11451,2.6e-05,172.31.47.0-255,66,214,90,230659
11452,3.3e-05,74.125.24.0-255,1484,1698,90,230659
11453,3.7e-05,172.31.47.0-255,66,1764,90,230659
11454,4.2e-05,74.125.24.0-255,2902,4666,90,230659
11455,4.4e-05,172.31.47.0-255,66,4732,90,230659
11456,5.2e-05,74.125.24.0-255,7156,11888,90,230659
11457,5.4e-05,172.31.47.0-255,66,11954,90,230659
11458,5.8e-05,74.125.24.0-255,2163,14117,90,230659
11459,6e-05,172.31.47.0-255,66,14183,90,230659
11460,9.8e-05,172.31.47.0-255,66,14249,90,230659
11461,0.000101,74.125.24.0-255,1484,15733,90,230659
11462,0.000103,172.31.47.0-255,66,15799,90,230659
11463,0.000138,172.31.47.0-255,66,15865,90,230659
11464,0.000146,74.125.24.0-255,9274,25139,90,230659
11465,0.000149,172.31.47.0-255,66,25205,90,230659
11466,0.000285,74.125.24.0-255,1484,26689,90,230659
11467,0.00029,172.31.47.0-255,66,26755,90,230659
11468,0.000296,74.125.24.0-255,2902,29657,90,230659
11469,0.000298,172.31.47.0-255,66,29723,90,230659
11470,0.000303,74.125.24.0-255,4320,34043,90,230659
11471,0.000307,172.31.47.0-255,66,34109,90,230659
11472,0.000329,74.125.24.0-255,1484,35593,90,230659
11473,0.000332,172.31.47.0-255,66,35659,90,230659
11474,0.000337,74.125.24.0-255,2902,38561,90,230659
11475,0.00034,172.31.47.0-255,66,38627,90,230659
11476,0.000357,74.125.24.0-255,4301,42928,90,230659
11477,0.00036,172.31.47.0-255,66,42994,90,230659
11478,0.001006,74.125.24.0-255,1484,44478,90,230659
11479,0.001011,172.31.47.0-255,66,44544,90,230659
11480,0.001022,74.125.24.0-255,2902,47446,90,230659
11481,0.001029,74.125.24.0-255,5738,53184,90,230659
11482,0.001049,74.125.24.0-255,2902,56086,90,230659
11483,0.001077,74.125.24.0-255,9992,66078,90,230659
11484,0.001102,74.125.24.0-255,2902,68980,90,230659
11485,0.001127,74.125.24.0-255,7856,76836,90,230659
11486,0.00138,74.125.24.0-255,1484,78320,90,230659
11487,0.001387,74.125.24.0-255,2902,81222,90,230659
11488,0.001389,74.125.24.0-255,1484,82706,90,230659
11489,0.001411,74.125.24.0-255,4320,87026,90,230659
11490,0.001414,74.125.24.0-255,2902,89928,90,230659
11491,0.0015,74.125.24.0-255,8574,98502,90,230659
11492,0.001522,74.125.24.0-255,4320,102822,90,230659
11493,0.001524,74.125.24.0-255,1484,104306,90,230659
11494,0.001566,74.125.24.0-255,8574,112880,90,230659
11495,0.001592,74.125.24.0-255,7156,120036,90,230659
11496,0.001615,74.125.24.0-255,2902,122938,90,230659
11497,0.001663,74.125.24.0-255,4320,127258,90,230659
11498,0.001717,74.125.24.0-255,4320,131578,90,230659
11499,0.001759,74.125.24.0-255,5738,137316,90,230659
11500,0.001778,74.125.24.0-255,3602,140918,90,230659
11501,0.001819,74.125.24.0-255,7156,148074,90,230659
11502,0.001824,74.125.24.0-255,2902,150976,90,230659
11503,0.001878,74.125.24.0-255,7156,158132,90,230659
11504,0.001908,74.125.24.0-255,8574,166706,90,230659
11505,0.001928,74.125.24.0-255,9992,176698,90,230659
11506,0.001959,74.125.24.0-255,8574,185272,90,230659
11507,0.001966,74.125.24.0-255,8574,193846,90,230659
11508,0.001971,74.125.24.0-255,3602,197448,90,230659
11509,0.001975,74.125.24.0-255,4320,201768,90,230659
11510,0.001983,74.125.24.0-255,9992,211760,90,230659
11511,0.001988,74.125.24.0-255,5738,217498,90,230659
11512,0.002008,74.125.24.0-255,5738,223236,90,230659
11513,0.002036,74.125.24.0-255,5738,228974,90,230659
11514,0.002051,74.125.24.0-255,1343,230317,90,230659
11515,0.00211,74.125.24.0-255,105,230422,90,230659
11516,0.00449,172.31.47.0-255,66,230488,90,230659
11517,0.007182,172.31.47.0-255,105,230593,90,230659
11518,0.009643,74.125.24.0-255,66,230659,90,230659
11519,0.0,172.217.194.0-255,153,153,90,175301
11520,3.7e-05,172.31.47.0-255,66,219,90,175301
11521,4.5e-05,172.217.194.0-255,1484,1703,90,175301
11522,5e-05,172.31.47.0-255,66,1769,90,175301
11523,6.2e-05,172.217.194.0-255,2902,4671,90,175301
11524,6.5e-05,172.31.47.0-255,66,4737,90,175301
11525,8.4e-05,172.217.194.0-255,2902,7639,90,175301
11526,8.7e-05,172.31.47.0-255,66,7705,90,175301
11527,0.000119,172.217.194.0-255,4320,12025,90,175301
11528,0.000122,172.31.47.0-255,66,12091,90,175301
11529,0.00013,172.217.194.0-255,7772,19863,90,175301
11530,0.000133,172.31.47.0-255,66,19929,90,175301
11531,0.000136,172.217.194.0-255,1484,21413,90,175301
11532,0.000138,172.31.47.0-255,66,21479,90,175301
11533,0.000179,172.217.194.0-255,9633,31112,90,175301
11534,0.000185,172.31.47.0-255,66,31178,90,175301
11535,0.000217,172.217.194.0-255,1484,32662,90,175301
11536,0.000219,172.31.47.0-255,66,32728,90,175301
11537,0.000224,172.217.194.0-255,2902,35630,90,175301
11538,0.000229,172.31.47.0-255,66,35696,90,175301
11539,0.000255,172.217.194.0-255,5738,41434,90,175301
11540,0.000258,172.31.47.0-255,66,41500,90,175301
11541,0.000262,172.217.194.0-255,1484,42984,90,175301
11542,0.000264,172.31.47.0-255,66,43050,90,175301
11543,0.000288,172.31.47.0-255,66,43116,90,175301
11544,0.000295,172.217.194.0-255,8574,51690,90,175301
11545,0.000305,172.31.47.0-255,66,51756,90,175301
11546,0.000338,172.217.194.0-255,2462,54218,90,175301
11547,0.000341,172.31.47.0-255,66,54284,90,175301
11548,0.000392,172.217.194.0-255,118,54402,90,175301
11549,0.000395,172.31.47.0-255,66,54468,90,175301
11550,0.000435,172.217.194.0-255,377,54845,90,175301
11551,0.000645,172.217.194.0-255,1484,56329,90,175301
11552,0.000649,172.31.47.0-255,66,56395,90,175301
11553,0.000655,172.217.194.0-255,2902,59297,90,175301
11554,0.000657,172.31.47.0-255,66,59363,90,175301
11555,0.000664,172.217.194.0-255,5738,65101,90,175301
11556,0.000671,172.31.47.0-255,66,65167,90,175301
11557,0.000674,172.217.194.0-255,1484,66651,90,175301
11558,0.0007,172.217.194.0-255,8574,75225,90,175301
11559,0.000703,172.31.47.0-255,66,75291,90,175301
11560,0.000743,172.217.194.0-255,5738,81029,90,175301
11561,0.000746,172.31.47.0-255,66,81095,90,175301
11562,0.000769,172.217.194.0-255,7856,88951,90,175301
11563,0.000772,172.31.47.0-255,66,89017,90,175301
11564,0.001598,172.217.194.0-255,1484,90501,90,175301
11565,0.001609,172.217.194.0-255,2902,93403,90,175301
11566,0.001614,172.31.47.0-255,66,93469,90,175301
11567,0.001621,172.217.194.0-255,2902,96371,90,175301
11568,0.001623,172.31.47.0-255,66,96437,90,175301
11569,0.001647,172.217.194.0-255,2902,99339,90,175301
11570,0.001649,172.31.47.0-255,66,99405,90,175301
11571,0.001658,172.217.194.0-255,8574,107979,90,175301
11572,0.001661,172.31.47.0-255,66,108045,90,175301
11573,0.001702,172.217.194.0-255,4320,112365,90,175301
11574,0.001705,172.31.47.0-255,66,112431,90,175301
11575,0.001715,172.217.194.0-255,10692,123123,90,175301
11576,0.001717,172.31.47.0-255,66,123189,90,175301
11577,0.002062,172.217.194.0-255,1484,124673,90,175301
11578,0.002069,172.217.194.0-255,2902,127575,90,175301
11579,0.002073,172.31.47.0-255,66,127641,90,175301
11580,0.002079,172.217.194.0-255,5738,133379,90,175301
11581,0.002081,172.31.47.0-255,66,133445,90,175301
11582,0.002104,172.217.194.0-255,1484,134929,90,175301
11583,0.00213,172.217.194.0-255,8574,143503,90,175301
11584,0.002132,172.31.47.0-255,66,143569,90,175301
11585,0.002137,172.217.194.0-255,4320,147889,90,175301
11586,0.002139,172.31.47.0-255,66,147955,90,175301
11587,0.002164,172.217.194.0-255,7156,155111,90,175301
11588,0.002166,172.31.47.0-255,66,155177,90,175301
11589,0.002171,172.217.194.0-255,2184,157361,90,175301
11590,0.002173,172.31.47.0-255,66,157427,90,175301
11591,0.004384,172.217.194.0-255,2902,160329,90,175301
11592,0.004391,172.31.47.0-255,66,160395,90,175301
11593,0.004424,172.217.194.0-255,1484,161879,90,175301
11594,0.004438,172.217.194.0-255,1484,163363,90,175301
11595,0.004441,172.31.47.0-255,66,163429,90,175301
11596,0.006624,172.217.194.0-255,2902,166331,90,175301
11597,0.006634,172.31.47.0-255,66,166397,90,175301
11598,0.006679,172.217.194.0-255,2902,169299,90,175301
11599,0.006682,172.31.47.0-255,66,169365,90,175301
11600,0.008886,172.217.194.0-255,2902,172267,90,175301
11601,0.008898,172.31.47.0-255,66,172333,90,175301
11602,0.008929,172.217.194.0-255,2902,175235,90,175301
11603,0.008933,172.31.47.0-255,66,175301,90,175301
11604,0.0,172.217.194.0-255,153,153,90,309438
11605,2.9e-05,172.31.47.0-255,66,219,90,309438
11606,3.5e-05,172.217.194.0-255,1484,1703,90,309438
11607,3.9e-05,172.31.47.0-255,66,1769,90,309438
11608,4.1e-05,172.217.194.0-255,1484,3253,90,309438
11609,4.3e-05,172.31.47.0-255,66,3319,90,309438
11610,4.6e-05,172.217.194.0-255,1484,4803,90,309438
11611,4.8e-05,172.31.47.0-255,66,4869,90,309438
11612,9.5e-05,172.217.194.0-255,2902,7771,90,309438
11613,9.9e-05,172.31.47.0-255,66,7837,90,309438
11614,0.000108,172.217.194.0-255,10510,18347,90,309438
11615,0.000111,172.31.47.0-255,66,18413,90,309438
11616,0.000118,172.217.194.0-255,8574,26987,90,309438
11617,0.00012,172.31.47.0-255,66,27053,90,309438
11618,0.000151,172.217.194.0-255,3961,31014,90,309438
11619,0.000154,172.31.47.0-255,66,31080,90,309438
11620,0.000159,172.217.194.0-255,4320,35400,90,309438
11621,0.000161,172.31.47.0-255,66,35466,90,309438
11622,0.000164,172.217.194.0-255,1484,36950,90,309438
11623,0.000165,172.31.47.0-255,66,37016,90,309438
11624,0.000204,172.217.194.0-255,8574,45590,90,309438
11625,0.000207,172.31.47.0-255,66,45656,90,309438
11626,0.000212,172.217.194.0-255,2543,48199,90,309438
11627,0.000214,172.31.47.0-255,66,48265,90,309438
11628,0.000477,172.217.194.0-255,1484,49749,90,309438
11629,0.000482,172.31.47.0-255,66,49815,90,309438
11630,0.000487,172.217.194.0-255,2902,52717,90,309438
11631,0.000489,172.31.47.0-255,66,52783,90,309438
11632,0.000516,172.217.194.0-255,4320,57103,90,309438
11633,0.000519,172.31.47.0-255,66,57169,90,309438
11634,0.000545,172.217.194.0-255,1484,58653,90,309438
11635,0.000547,172.31.47.0-255,66,58719,90,309438
11636,0.000562,172.31.47.0-255,66,58785,90,309438
11637,0.000618,172.31.47.0-255,66,58851,90,309438
11638,0.000624,172.217.194.0-255,7156,66007,90,309438
11639,0.000627,172.31.47.0-255,66,66073,90,309438
11640,0.00066,172.217.194.0-255,5738,71811,90,309438
11641,0.000663,172.31.47.0-255,66,71877,90,309438
11642,0.000668,172.217.194.0-255,3411,75288,90,309438
11643,0.00067,172.31.47.0-255,66,75354,90,309438
11644,0.000802,172.217.194.0-255,1484,76838,90,309438
11645,0.000808,172.217.194.0-255,2902,79740,90,309438
11646,0.000811,172.31.47.0-255,66,79806,90,309438
11647,0.000817,172.217.194.0-255,5738,85544,90,309438
11648,0.000818,172.31.47.0-255,66,85610,90,309438
11649,0.000873,172.217.194.0-255,6783,92393,90,309438
11650,0.000876,172.31.47.0-255,66,92459,90,309438
11651,0.001098,172.217.194.0-255,1484,93943,90,309438
11652,0.001103,172.217.194.0-255,2902,96845,90,309438
11653,0.001107,172.31.47.0-255,66,96911,90,309438
11654,0.001112,172.217.194.0-255,2902,99813,90,309438
11655,0.001114,172.31.47.0-255,66,99879,90,309438
11656,0.001132,172.217.194.0-255,2902,102781,90,309438
11657,0.001135,172.31.47.0-255,66,102847,90,309438
11658,0.001142,172.217.194.0-255,9992,112839,90,309438
11659,0.001144,172.31.47.0-255,66,112905,90,309438
11660,0.001177,172.217.194.0-255,2902,115807,90,309438
11661,0.00118,172.31.47.0-255,66,115873,90,309438
11662,0.001203,172.217.194.0-255,10692,126565,90,309438
11663,0.001205,172.31.47.0-255,66,126631,90,309438
11664,0.001268,172.217.194.0-255,1484,128115,90,309438
11665,0.001274,172.217.194.0-255,2902,131017,90,309438
11666,0.001276,172.31.47.0-255,66,131083,90,309438
11667,0.001304,172.217.194.0-255,5738,136821,90,309438
11668,0.001306,172.31.47.0-255,66,136887,90,309438
11669,0.001352,172.217.194.0-255,5738,142625,90,309438
11670,0.001355,172.31.47.0-255,66,142691,90,309438
11671,0.001383,172.217.194.0-255,7156,149847,90,309438
11672,0.001386,172.31.47.0-255,66,149913,90,309438
11673,0.001395,172.217.194.0-255,10692,160605,90,309438
11674,0.001397,172.31.47.0-255,66,160671,90,309438
11675,0.001412,172.31.47.0-255,66,160737,90,309438
11676,0.001423,172.31.47.0-255,66,160803,90,309438
11677,0.001448,172.217.194.0-255,4320,165123,90,309438
11678,0.001451,172.31.47.0-255,66,165189,90,309438
11679,0.001455,172.217.194.0-255,2902,168091,90,309438
11680,0.001459,172.31.47.0-255,66,168157,90,309438
11681,0.001494,172.217.194.0-255,3602,171759,90,309438
11682,0.001498,172.31.47.0-255,66,171825,90,309438
11683,0.001505,172.217.194.0-255,7156,178981,90,309438
11684,0.001507,172.31.47.0-255,66,179047,90,309438
11685,0.001519,172.31.47.0-255,66,179113,90,309438
11686,0.001566,172.217.194.0-255,4320,183433,90,309438
11687,0.001569,172.31.47.0-255,66,183499,90,309438
11688,0.001579,172.217.194.0-255,10692,194191,90,309438
11689,0.001581,172.31.47.0-255,66,194257,90,309438
11690,0.001592,172.217.194.0-255,7156,201413,90,309438
11691,0.001596,172.31.47.0-255,66,201479,90,309438
11692,0.001604,172.217.194.0-255,8574,210053,90,309438
11693,0.001606,172.31.47.0-255,66,210119,90,309438
11694,0.001614,172.217.194.0-255,8574,218693,90,309438
11695,0.001617,172.31.47.0-255,66,218759,90,309438
11696,0.00165,172.217.194.0-255,8574,227333,90,309438
11697,0.001654,172.31.47.0-255,66,227399,90,309438
11698,0.001657,172.217.194.0-255,766,228165,90,309438
11699,0.001689,172.31.47.0-255,66,228231,90,309438
11700,0.001722,172.217.194.0-255,7156,235387,90,309438
11701,0.001725,172.31.47.0-255,66,235453,90,309438
11702,0.001731,172.217.194.0-255,5738,241191,90,309438
11703,0.001733,172.31.47.0-255,66,241257,90,309438
11704,0.00175,172.217.194.0-255,4320,245577,90,309438
11705,0.001758,172.31.47.0-255,66,245643,90,309438
11706,0.001789,172.217.194.0-255,3602,249245,90,309438
11707,0.001793,172.31.47.0-255,66,249311,90,309438
11708,0.001808,172.31.47.0-255,66,249377,90,309438
11709,0.001822,172.217.194.0-255,8574,257951,90,309438
11710,0.001825,172.31.47.0-255,66,258017,90,309438
11711,0.00183,172.217.194.0-255,4320,262337,90,309438
11712,0.001832,172.31.47.0-255,66,262403,90,309438
11713,0.001864,172.217.194.0-255,6438,268841,90,309438
11714,0.001869,172.31.47.0-255,66,268907,90,309438
11715,0.001926,172.217.194.0-255,5738,274645,90,309438
11716,0.00193,172.31.47.0-255,66,274711,90,309438
11717,0.001938,172.217.194.0-255,7156,281867,90,309438
11718,0.00194,172.31.47.0-255,66,281933,90,309438
11719,0.001954,172.31.47.0-255,66,281999,90,309438
11720,0.001961,172.217.194.0-255,6438,288437,90,309438
11721,0.001965,172.31.47.0-255,66,288503,90,309438
11722,0.002015,172.217.194.0-255,7156,295659,90,309438
11723,0.002019,172.31.47.0-255,66,295725,90,309438
11724,0.002042,172.217.194.0-255,9992,305717,90,309438
11725,0.002046,172.31.47.0-255,66,305783,90,309438
11726,0.002062,172.217.194.0-255,1484,307267,90,309438
11727,0.002066,172.217.194.0-255,1763,309030,90,309438
11728,0.002068,172.217.194.0-255,105,309135,90,309438
11729,0.00207,172.31.47.0-255,66,309201,90,309438
11730,0.003315,172.31.47.0-255,66,309267,90,309438
11731,0.003338,172.31.47.0-255,105,309372,90,309438
11732,0.005528,172.217.194.0-255,66,309438,90,309438
11733,0.0,172.31.47.0-255,172,172,90,11527
11734,3.6e-05,172.31.47.0-255,1131,1303,90,11527
11735,0.000124,172.31.47.0-255,1514,2817,90,11527
11736,0.000126,172.31.47.0-255,1514,4331,90,11527
11737,0.000127,172.31.47.0-255,1514,5845,90,11527
11738,0.000128,172.31.47.0-255,1514,7359,90,11527
11739,0.000155,172.31.47.0-255,1514,8873,90,11527
11740,0.000156,172.31.47.0-255,1514,10387,90,11527
11741,0.000158,172.31.47.0-255,702,11089,90,11527
11742,0.00153,104.244.42.0-255,66,11155,90,11527
11743,0.001628,104.244.42.0-255,66,11221,90,11527
11744,0.001708,104.244.42.0-255,66,11287,90,11527
11745,0.001713,104.244.42.0-255,66,11353,90,11527
11746,0.00304,104.244.42.0-255,108,11461,90,11527
11747,0.003052,172.31.47.0-255,66,11527,90,11527
11748,0.0,74.125.24.0-255,153,153,90,279129
11749,1.4e-05,172.31.47.0-255,66,219,90,279129
11750,1.9e-05,74.125.24.0-255,1484,1703,90,279129
11751,2.4e-05,172.31.47.0-255,66,1769,90,279129
11752,3.5e-05,74.125.24.0-255,2902,4671,90,279129
11753,3.8e-05,172.31.47.0-255,66,4737,90,279129
11754,4.4e-05,74.125.24.0-255,4320,9057,90,279129
11755,4.7e-05,172.31.47.0-255,66,9123,90,279129
11756,7.5e-05,74.125.24.0-255,2902,12025,90,279129
11757,7.8e-05,172.31.47.0-255,66,12091,90,279129
11758,9.5e-05,172.31.47.0-255,66,12157,90,279129
11759,0.000119,74.125.24.0-255,2902,15059,90,279129
11760,0.00012,172.31.47.0-255,66,15125,90,279129
11761,0.000133,74.125.24.0-255,3961,19086,90,279129
11762,0.000139,172.31.47.0-255,66,19152,90,279129
11763,0.000253,74.125.24.0-255,1484,20636,90,279129
11764,0.000256,172.31.47.0-255,66,20702,90,279129
11765,0.000282,74.125.24.0-255,2902,23604,90,279129
11766,0.000284,172.31.47.0-255,66,23670,90,279129
11767,0.000289,74.125.24.0-255,4320,27990,90,279129
11768,0.000291,172.31.47.0-255,66,28056,90,279129
11769,0.00031,74.125.24.0-255,1484,29540,90,279129
11770,0.000312,172.31.47.0-255,66,29606,90,279129
11771,0.000315,74.125.24.0-255,1484,31090,90,279129
11772,0.000317,172.31.47.0-255,66,31156,90,279129
11773,0.00035,172.31.47.0-255,66,31222,90,279129
11774,0.000359,74.125.24.0-255,9939,41161,90,279129
11775,0.000361,172.31.47.0-255,66,41227,90,279129
11776,0.000364,74.125.24.0-255,380,41607,90,279129
11777,0.000366,172.31.47.0-255,66,41673,90,279129
11778,0.000741,74.125.24.0-255,1484,43157,90,279129
11779,0.000747,74.125.24.0-255,2902,46059,90,279129
11780,0.00075,172.31.47.0-255,66,46125,90,279129
11781,0.000757,74.125.24.0-255,4320,50445,90,279129
11782,0.000759,172.31.47.0-255,66,50511,90,279129
11783,0.000775,74.125.24.0-255,1484,51995,90,279129
11784,0.000791,74.125.24.0-255,7156,59151,90,279129
11785,0.000793,172.31.47.0-255,66,59217,90,279129
11786,0.000822,74.125.24.0-255,5738,64955,90,279129
11787,0.000824,172.31.47.0-255,66,65021,90,279129
11788,0.000847,74.125.24.0-255,2902,67923,90,279129
11789,0.000849,172.31.47.0-255,66,67989,90,279129
11790,0.00088,74.125.24.0-255,7856,75845,90,279129
11791,0.000884,172.31.47.0-255,66,75911,90,279129
11792,0.000888,74.125.24.0-255,2902,78813,90,279129
11793,0.000889,172.31.47.0-255,66,78879,90,279129
11794,0.000916,74.125.24.0-255,8574,87453,90,279129
11795,0.00092,172.31.47.0-255,66,87519,90,279129
11796,0.000926,74.125.24.0-255,5738,93257,90,279129
11797,0.000928,172.31.47.0-255,66,93323,90,279129
11798,0.000962,74.125.24.0-255,7156,100479,90,279129
11799,0.000965,172.31.47.0-255,66,100545,90,279129
11800,0.000973,74.125.24.0-255,9274,109819,90,279129
11801,0.000975,172.31.47.0-255,66,109885,90,279129
11802,0.001199,74.125.24.0-255,1484,111369,90,279129
11803,0.001205,74.125.24.0-255,2902,114271,90,279129
11804,0.001208,172.31.47.0-255,66,114337,90,279129
11805,0.001221,74.125.24.0-255,5738,120075,90,279129
11806,0.001223,172.31.47.0-255,66,120141,90,279129
11807,0.001249,74.125.24.0-255,5738,125879,90,279129
11808,0.001251,172.31.47.0-255,66,125945,90,279129
11809,0.001295,74.125.24.0-255,7156,133101,90,279129
11810,0.001298,172.31.47.0-255,66,133167,90,279129
11811,0.001308,74.125.24.0-255,10692,143859,90,279129
11812,0.001309,172.31.47.0-255,66,143925,90,279129
11813,0.001313,74.125.24.0-255,2902,146827,90,279129
11814,0.001315,172.31.47.0-255,66,146893,90,279129
11815,0.001361,172.31.47.0-255,66,146959,90,279129
11816,0.001363,74.125.24.0-255,1484,148443,90,279129
11817,0.001405,172.31.47.0-255,66,148509,90,279129
11818,0.001431,74.125.24.0-255,10692,159201,90,279129
11819,0.001434,172.31.47.0-255,66,159267,90,279129
11820,0.001436,74.125.24.0-255,1484,160751,90,279129
11821,0.001444,74.125.24.0-255,9274,170025,90,279129
11822,0.001446,172.31.47.0-255,66,170091,90,279129
11823,0.001642,74.125.24.0-255,1484,171575,90,279129
11824,0.001656,74.125.24.0-255,2902,174477,90,279129
11825,0.00166,172.31.47.0-255,66,174543,90,279129
11826,0.001666,74.125.24.0-255,5738,180281,90,279129
11827,0.001668,172.31.47.0-255,66,180347,90,279129
11828,0.001719,74.125.24.0-255,4320,184667,90,279129
11829,0.001721,172.31.47.0-255,66,184733,90,279129
11830,0.00176,74.125.24.0-255,8574,193307,90,279129
11831,0.001762,172.31.47.0-255,66,193373,90,279129
11832,0.001771,74.125.24.0-255,10692,204065,90,279129
11833,0.001778,172.31.47.0-255,66,204131,90,279129
11834,0.001925,74.125.24.0-255,1484,205615,90,279129
11835,0.001931,74.125.24.0-255,2902,208517,90,279129
11836,0.001933,172.31.47.0-255,66,208583,90,279129
11837,0.001937,74.125.24.0-255,1484,210067,90,279129
11838,0.001961,74.125.24.0-255,4320,214387,90,279129
11839,0.001964,172.31.47.0-255,66,214453,90,279129
11840,0.001972,74.125.24.0-255,9992,224445,90,279129
11841,0.001974,172.31.47.0-255,66,224511,90,279129
11842,0.002006,74.125.24.0-255,2902,227413,90,279129
11843,0.002009,172.31.47.0-255,66,227479,90,279129
11844,0.002017,74.125.24.0-255,9992,237471,90,279129
11845,0.002018,172.31.47.0-255,66,237537,90,279129
11846,0.002025,74.125.24.0-255,766,238303,90,279129
11847,0.002244,74.125.24.0-255,1484,239787,90,279129
11848,0.002248,172.31.47.0-255,66,239853,90,279129
11849,0.002253,74.125.24.0-255,2902,242755,90,279129
11850,0.002255,172.31.47.0-255,66,242821,90,279129
11851,0.002287,74.125.24.0-255,5738,248559,90,279129
11852,0.002293,74.125.24.0-255,7156,255715,90,279129
11853,0.002296,172.31.47.0-255,66,255781,90,279129
11854,0.002299,172.31.47.0-255,66,255847,90,279129
11855,0.00232,74.125.24.0-255,1484,257331,90,279129
11856,0.002325,74.125.24.0-255,4320,261651,90,279129
11857,0.00233,172.31.47.0-255,66,261717,90,279129
11858,0.004597,74.125.24.0-255,5738,267455,90,279129
11859,0.004604,172.31.47.0-255,66,267521,90,279129
11860,0.006866,74.125.24.0-255,5738,273259,90,279129
11861,0.006873,172.31.47.0-255,66,273325,90,279129
11862,0.009157,74.125.24.0-255,5738,279063,90,279129
11863,0.009163,172.31.47.0-255,66,279129,90,279129
11864,0.0,74.125.68.0-255,298,298,90,377560
11865,3.1e-05,172.31.47.0-255,66,364,90,377560
11866,3.8e-05,74.125.68.0-255,1484,1848,90,377560
11867,4.2e-05,172.31.47.0-255,66,1914,90,377560
11868,4.6e-05,74.125.68.0-255,4320,6234,90,377560
11869,4.8e-05,172.31.47.0-255,66,6300,90,377560
11870,9.6e-05,74.125.68.0-255,2902,9202,90,377560
11871,9.8e-05,172.31.47.0-255,66,9268,90,377560
11872,0.000118,74.125.68.0-255,4690,13958,90,377560
11873,0.00012,172.31.47.0-255,66,14024,90,377560
11874,0.000162,74.125.68.0-255,1484,15508,90,377560
11875,0.000166,172.31.47.0-255,66,15574,90,377560
11876,0.000183,74.125.68.0-255,2902,18476,90,377560
11877,0.000185,172.31.47.0-255,66,18542,90,377560
11878,0.00019,74.125.68.0-255,2902,21444,90,377560
11879,0.000192,172.31.47.0-255,66,21510,90,377560
11880,0.000208,74.125.68.0-255,2902,24412,90,377560
11881,0.000211,172.31.47.0-255,66,24478,90,377560
11882,0.000214,74.125.68.0-255,1484,25962,90,377560
11883,0.000216,172.31.47.0-255,66,26028,90,377560
11884,0.000245,74.125.68.0-255,5379,31407,90,377560
11885,0.000247,172.31.47.0-255,66,31473,90,377560
11886,0.000264,74.125.68.0-255,4320,35793,90,377560
11887,0.000266,172.31.47.0-255,66,35859,90,377560
11888,0.000291,74.125.68.0-255,2902,38761,90,377560
11889,0.000292,172.31.47.0-255,66,38827,90,377560
11890,0.000297,74.125.68.0-255,4320,43147,90,377560
11891,0.000299,172.31.47.0-255,66,43213,90,377560
11892,0.000304,74.125.68.0-255,5379,48592,90,377560
11893,0.000305,172.31.47.0-255,66,48658,90,377560
11894,0.000347,74.125.68.0-255,1484,50142,90,377560
11895,0.00035,172.31.47.0-255,66,50208,90,377560
11896,0.000354,74.125.68.0-255,1484,51692,90,377560
11897,0.000372,74.125.68.0-255,1484,53176,90,377560
11898,0.000374,172.31.47.0-255,66,53242,90,377560
11899,0.000377,74.125.68.0-255,1484,54726,90,377560
11900,0.000381,74.125.68.0-255,2902,57628,90,377560
11901,0.000383,172.31.47.0-255,66,57694,90,377560
11902,0.000407,74.125.68.0-255,5738,63432,90,377560
11903,0.000412,172.31.47.0-255,66,63498,90,377560
11904,0.00043,74.125.68.0-255,2543,66041,90,377560
11905,0.000432,172.31.47.0-255,66,66107,90,377560
11906,0.000463,74.125.68.0-255,396,66503,90,377560
11907,0.000497,74.125.68.0-255,349,66852,90,377560
11908,0.000625,74.125.68.0-255,1484,68336,90,377560
11909,0.000628,172.31.47.0-255,66,68402,90,377560
11910,0.000633,74.125.68.0-255,2902,71304,90,377560
11911,0.000635,172.31.47.0-255,66,71370,90,377560
11912,0.000647,74.125.68.0-255,2902,74272,90,377560
11913,0.000649,172.31.47.0-255,66,74338,90,377560
11914,0.000669,74.125.68.0-255,2902,77240,90,377560
11915,0.000672,172.31.47.0-255,66,77306,90,377560
11916,0.000694,74.125.68.0-255,8574,85880,90,377560
11917,0.000697,172.31.47.0-255,66,85946,90,377560
11918,0.000719,74.125.68.0-255,4320,90266,90,377560
11919,0.000721,172.31.47.0-255,66,90332,90,377560
11920,0.00074,74.125.68.0-255,7156,97488,90,377560
11921,0.000742,172.31.47.0-255,66,97554,90,377560
11922,0.000764,74.125.68.0-255,3602,101156,90,377560
11923,0.000766,172.31.47.0-255,66,101222,90,377560
11924,0.0008,74.125.68.0-255,1484,102706,90,377560
11925,0.000818,74.125.68.0-255,2902,105608,90,377560
11926,0.00082,172.31.47.0-255,66,105674,90,377560
11927,0.000823,74.125.68.0-255,1484,107158,90,377560
11928,0.00084,74.125.68.0-255,4320,111478,90,377560
11929,0.000842,172.31.47.0-255,66,111544,90,377560
11930,0.000863,74.125.68.0-255,5738,117282,90,377560
11931,0.000866,172.31.47.0-255,66,117348,90,377560
11932,0.000882,74.125.68.0-255,1484,118832,90,377560
11933,0.000894,74.125.68.0-255,4320,123152,90,377560
11934,0.000896,172.31.47.0-255,66,123218,90,377560
11935,0.000911,74.125.68.0-255,8574,131792,90,377560
11936,0.000913,172.31.47.0-255,66,131858,90,377560
11937,0.000934,74.125.68.0-255,3602,135460,90,377560
11938,0.000937,172.31.47.0-255,66,135526,90,377560
11939,0.000977,74.125.68.0-255,1484,137010,90,377560
11940,0.000989,74.125.68.0-255,2902,139912,90,377560
11941,0.000992,172.31.47.0-255,66,139978,90,377560
11942,0.000995,74.125.68.0-255,1484,141462,90,377560
11943,0.001005,74.125.68.0-255,1484,142946,90,377560
11944,0.001007,172.31.47.0-255,66,143012,90,377560
11945,0.001032,74.125.68.0-255,4320,147332,90,377560
11946,0.001035,172.31.47.0-255,66,147398,90,377560
11947,0.001073,74.125.68.0-255,5738,153136,90,377560
11948,0.001077,172.31.47.0-255,66,153202,90,377560
11949,0.001098,74.125.68.0-255,2902,156104,90,377560
11950,0.001102,172.31.47.0-255,66,156170,90,377560
11951,0.001103,74.125.68.0-255,5738,161908,90,377560
11952,0.001105,172.31.47.0-255,66,161974,90,377560
11953,0.001111,74.125.68.0-255,7156,169130,90,377560
11954,0.001114,172.31.47.0-255,66,169196,90,377560
11955,0.001117,74.125.68.0-255,766,169962,90,377560
11956,0.001161,74.125.68.0-255,1484,171446,90,377560
11957,0.001165,172.31.47.0-255,66,171512,90,377560
11958,0.001173,74.125.68.0-255,2902,174414,90,377560
11959,0.001175,172.31.47.0-255,66,174480,90,377560
11960,0.001177,74.125.68.0-255,1484,175964,90,377560
11961,0.001201,74.125.68.0-255,2902,178866,90,377560
11962,0.001204,172.31.47.0-255,66,178932,90,377560
11963,0.001208,74.125.68.0-255,2902,181834,90,377560
11964,0.00121,172.31.47.0-255,66,181900,90,377560
11965,0.001225,74.125.68.0-255,2902,184802,90,377560
11966,0.001228,172.31.47.0-255,66,184868,90,377560
11967,0.001246,74.125.68.0-255,4320,189188,90,377560
11968,0.001248,172.31.47.0-255,66,189254,90,377560
11969,0.001264,74.125.68.0-255,7156,196410,90,377560
11970,0.001267,172.31.47.0-255,66,196476,90,377560
11971,0.001294,74.125.68.0-255,4320,200796,90,377560
11972,0.001297,172.31.47.0-255,66,200862,90,377560
11973,0.001317,74.125.68.0-255,3602,204464,90,377560
11974,0.00132,172.31.47.0-255,66,204530,90,377560
11975,0.00135,74.125.68.0-255,1484,206014,90,377560
11976,0.001369,74.125.68.0-255,2902,208916,90,377560
11977,0.001372,172.31.47.0-255,66,208982,90,377560
11978,0.001406,74.125.68.0-255,2902,211884,90,377560
11979,0.001409,172.31.47.0-255,66,211950,90,377560
11980,0.001431,74.125.68.0-255,2902,214852,90,377560
11981,0.001434,172.31.47.0-255,66,214918,90,377560
11982,0.001441,74.125.68.0-255,7156,222074,90,377560
11983,0.001443,172.31.47.0-255,66,222140,90,377560
11984,0.001449,74.125.68.0-255,4320,226460,90,377560
11985,0.001451,172.31.47.0-255,66,226526,90,377560
11986,0.00148,74.125.68.0-255,9992,236518,90,377560
11987,0.001483,172.31.47.0-255,66,236584,90,377560
11988,0.001505,74.125.68.0-255,2184,238768,90,377560
11989,0.001507,172.31.47.0-255,66,238834,90,377560
11990,0.001571,74.125.68.0-255,1484,240318,90,377560
11991,0.001576,74.125.68.0-255,2902,243220,90,377560
11992,0.001578,74.125.68.0-255,1484,244704,90,377560
11993,0.001579,172.31.47.0-255,66,244770,90,377560
11994,0.001589,74.125.68.0-255,4320,249090,90,377560
11995,0.001592,172.31.47.0-255,66,249156,90,377560
11996,0.001602,74.125.68.0-255,2902,252058,90,377560
11997,0.001604,172.31.47.0-255,66,252124,90,377560
11998,0.001609,74.125.68.0-255,4320,256444,90,377560
11999,0.001612,172.31.47.0-255,66,256510,90,377560
12000,0.001637,74.125.68.0-255,2902,259412,90,377560
12001,0.001641,172.31.47.0-255,66,259478,90,377560
12002,0.001659,74.125.68.0-255,5738,265216,90,377560
12003,0.001661,172.31.47.0-255,66,265282,90,377560
12004,0.001668,74.125.68.0-255,7156,272438,90,377560
12005,0.001671,172.31.47.0-255,66,272504,90,377560
12006,0.001692,74.125.68.0-255,7856,280360,90,377560
12007,0.001695,172.31.47.0-255,66,280426,90,377560
12008,0.001701,74.125.68.0-255,5738,286164,90,377560
12009,0.001703,172.31.47.0-255,66,286230,90,377560
12010,0.001721,74.125.68.0-255,1484,287714,90,377560
12011,0.001724,74.125.68.0-255,1484,289198,90,377560
12012,0.001726,172.31.47.0-255,66,289264,90,377560
12013,0.001746,74.125.68.0-255,7156,296420,90,377560
12014,0.00175,172.31.47.0-255,66,296486,90,377560
12015,0.001754,74.125.68.0-255,2902,299388,90,377560
12016,0.001756,172.31.47.0-255,66,299454,90,377560
12017,0.001778,74.125.68.0-255,5738,305192,90,377560
12018,0.001782,172.31.47.0-255,66,305258,90,377560
12019,0.0018,74.125.68.0-255,2184,307442,90,377560
12020,0.001803,172.31.47.0-255,66,307508,90,377560
12021,0.001879,74.125.68.0-255,1484,308992,90,377560
12022,0.001912,74.125.68.0-255,2902,311894,90,377560
12023,0.001916,74.125.68.0-255,2902,314796,90,377560
12024,0.001916,172.31.47.0-255,66,314862,90,377560
12025,0.00192,172.31.47.0-255,66,314928,90,377560
12026,0.001929,74.125.68.0-255,1484,316412,90,377560
12027,0.001935,74.125.68.0-255,4320,320732,90,377560
12028,0.001938,172.31.47.0-255,66,320798,90,377560
12029,0.001954,74.125.68.0-255,4320,325118,90,377560
12030,0.001957,172.31.47.0-255,66,325184,90,377560
12031,0.001959,74.125.68.0-255,5738,330922,90,377560
12032,0.001962,172.31.47.0-255,66,330988,90,377560
12033,0.001964,74.125.68.0-255,1484,332472,90,377560
12034,0.001988,74.125.68.0-255,5738,338210,90,377560
12035,0.001997,172.31.47.0-255,66,338276,90,377560
12036,0.002022,74.125.68.0-255,1484,339760,90,377560
12037,0.002039,74.125.68.0-255,2184,341944,90,377560
12038,0.002042,172.31.47.0-255,66,342010,90,377560
12039,0.002054,74.125.68.0-255,1484,343494,90,377560
12040,0.002067,74.125.68.0-255,2902,346396,90,377560
12041,0.00207,172.31.47.0-255,66,346462,90,377560
12042,0.002074,74.125.68.0-255,2902,349364,90,377560
12043,0.002076,172.31.47.0-255,66,349430,90,377560
12044,0.002091,74.125.68.0-255,2902,352332,90,377560
12045,0.002094,172.31.47.0-255,66,352398,90,377560
12046,0.002111,74.125.68.0-255,4320,356718,90,377560
12047,0.002114,172.31.47.0-255,66,356784,90,377560
12048,0.002135,74.125.68.0-255,2902,359686,90,377560
12049,0.00214,172.31.47.0-255,66,359752,90,377560
12050,0.004206,74.125.68.0-255,2902,362654,90,377560
12051,0.004213,172.31.47.0-255,66,362720,90,377560
12052,0.004233,74.125.68.0-255,2902,365622,90,377560
12053,0.004236,172.31.47.0-255,66,365688,90,377560
12054,0.006285,74.125.68.0-255,2902,368590,90,377560
12055,0.006288,172.31.47.0-255,66,368656,90,377560
12056,0.006307,74.125.68.0-255,2902,371558,90,377560
12057,0.006309,172.31.47.0-255,66,371624,90,377560
12058,0.008365,74.125.68.0-255,2902,374526,90,377560
12059,0.008372,172.31.47.0-255,66,374592,90,377560
12060,0.008392,74.125.68.0-255,2902,377494,90,377560
12061,0.008394,172.31.47.0-255,66,377560,90,377560
12062,0.0,74.125.130.0-255,153,153,90,250150
12063,2.7e-05,172.31.47.0-255,66,219,90,250150
12064,3.4e-05,74.125.130.0-255,1484,1703,90,250150
12065,3.8e-05,172.31.47.0-255,66,1769,90,250150
12066,4.3e-05,74.125.130.0-255,2902,4671,90,250150
12067,4.5e-05,172.31.47.0-255,66,4737,90,250150
12068,5.9e-05,74.125.130.0-255,4320,9057,90,250150
12069,6.1e-05,172.31.47.0-255,66,9123,90,250150
12070,6.5e-05,74.125.130.0-255,2902,12025,90,250150
12071,6.8e-05,172.31.47.0-255,66,12091,90,250150
12072,9.6e-05,74.125.130.0-255,2105,14196,90,250150
12073,0.000103,172.31.47.0-255,66,14262,90,250150
12074,0.00019,74.125.130.0-255,1484,15746,90,250150
12075,0.000194,172.31.47.0-255,66,15812,90,250150
12076,0.000223,74.125.130.0-255,2902,18714,90,250150
12077,0.000226,172.31.47.0-255,66,18780,90,250150
12078,0.000232,74.125.130.0-255,4320,23100,90,250150
12079,0.000234,172.31.47.0-255,66,23166,90,250150
12080,0.000262,74.125.130.0-255,2902,26068,90,250150
12081,0.000265,172.31.47.0-255,66,26134,90,250150
12082,0.000299,74.125.130.0-255,5379,31513,90,250150
12083,0.000304,172.31.47.0-255,66,31579,90,250150
12084,0.000429,74.125.130.0-255,1484,33063,90,250150
12085,0.000434,172.31.47.0-255,66,33129,90,250150
12086,0.000441,74.125.130.0-255,2902,36031,90,250150
12087,0.000444,172.31.47.0-255,66,36097,90,250150
12088,0.000472,74.125.130.0-255,5738,41835,90,250150
12089,0.000475,172.31.47.0-255,66,41901,90,250150
12090,0.00051,74.125.130.0-255,6797,48698,90,250150
12091,0.000514,172.31.47.0-255,66,48764,90,250150
12092,0.000614,74.125.130.0-255,1484,50248,90,250150
12093,0.000618,172.31.47.0-255,66,50314,90,250150
12094,0.000622,74.125.130.0-255,1484,51798,90,250150
12095,0.000624,172.31.47.0-255,66,51864,90,250150
12096,0.000645,74.125.130.0-255,1484,53348,90,250150
12097,0.000648,172.31.47.0-255,66,53414,90,250150
12098,0.000655,74.125.130.0-255,5738,59152,90,250150
12099,0.000657,172.31.47.0-255,66,59218,90,250150
12100,0.000661,74.125.130.0-255,2902,62120,90,250150
12101,0.000664,172.31.47.0-255,66,62186,90,250150
12102,0.000693,74.125.130.0-255,3961,66147,90,250150
12103,0.000701,172.31.47.0-255,66,66213,90,250150
12104,0.000705,74.125.130.0-255,360,66573,90,250150
12105,0.000707,172.31.47.0-255,66,66639,90,250150
12106,0.00071,74.125.130.0-255,383,67022,90,250150
12107,0.000711,172.31.47.0-255,66,67088,90,250150
12108,0.000846,74.125.130.0-255,1484,68572,90,250150
12109,0.000849,172.31.47.0-255,66,68638,90,250150
12110,0.000853,74.125.130.0-255,1484,70122,90,250150
12111,0.000854,172.31.47.0-255,66,70188,90,250150
12112,0.000885,74.125.130.0-255,1484,71672,90,250150
12113,0.000888,172.31.47.0-255,66,71738,90,250150
12114,0.000892,74.125.130.0-255,1484,73222,90,250150
12115,0.000894,172.31.47.0-255,66,73288,90,250150
12116,0.000898,74.125.130.0-255,2902,76190,90,250150
12117,0.0009,172.31.47.0-255,66,76256,90,250150
12118,0.00091,74.125.130.0-255,5738,81994,90,250150
12119,0.000912,172.31.47.0-255,66,82060,90,250150
12120,0.000915,74.125.130.0-255,2543,84603,90,250150
12121,0.000917,172.31.47.0-255,66,84669,90,250150
12122,0.000965,74.125.130.0-255,2902,87571,90,250150
12123,0.000967,172.31.47.0-255,66,87637,90,250150
12124,0.000997,74.125.130.0-255,4320,91957,90,250150
12125,0.001,172.31.47.0-255,66,92023,90,250150
12126,0.001029,74.125.130.0-255,8574,100597,90,250150
12127,0.001031,172.31.47.0-255,66,100663,90,250150
12128,0.001064,74.125.130.0-255,1125,101788,90,250150
12129,0.001106,172.31.47.0-255,66,101854,90,250150
12130,0.001256,74.125.130.0-255,1484,103338,90,250150
12131,0.001274,74.125.130.0-255,2902,106240,90,250150
12132,0.001278,172.31.47.0-255,66,106306,90,250150
12133,0.001304,74.125.130.0-255,5738,112044,90,250150
12134,0.001307,172.31.47.0-255,66,112110,90,250150
12135,0.001326,74.125.130.0-255,5738,117848,90,250150
12136,0.001329,172.31.47.0-255,66,117914,90,250150
12137,0.00136,74.125.130.0-255,7156,125070,90,250150
12138,0.001363,172.31.47.0-255,66,125136,90,250150
12139,0.001394,74.125.130.0-255,10692,135828,90,250150
12140,0.001397,172.31.47.0-255,66,135894,90,250150
12141,0.00157,74.125.130.0-255,1484,137378,90,250150
12142,0.001578,74.125.130.0-255,2902,140280,90,250150
12143,0.001581,172.31.47.0-255,66,140346,90,250150
12144,0.001603,74.125.130.0-255,2902,143248,90,250150
12145,0.001606,172.31.47.0-255,66,143314,90,250150
12146,0.001627,74.125.130.0-255,2902,146216,90,250150
12147,0.001629,172.31.47.0-255,66,146282,90,250150
12148,0.001635,74.125.130.0-255,7156,153438,90,250150
12149,0.001636,172.31.47.0-255,66,153504,90,250150
12150,0.001661,74.125.130.0-255,5738,159242,90,250150
12151,0.001663,172.31.47.0-255,66,159308,90,250150
12152,0.001689,74.125.130.0-255,2902,162210,90,250150
12153,0.00169,172.31.47.0-255,66,162276,90,250150
12154,0.001697,74.125.130.0-255,7156,169432,90,250150
12155,0.001699,172.31.47.0-255,66,169498,90,250150
12156,0.001728,74.125.130.0-255,7856,177354,90,250150
12157,0.00173,172.31.47.0-255,66,177420,90,250150
12158,0.001733,74.125.130.0-255,1484,178904,90,250150
12159,0.001759,74.125.130.0-255,2902,181806,90,250150
12160,0.001776,74.125.130.0-255,2902,184708,90,250150
12161,0.001785,74.125.130.0-255,1484,186192,90,250150
12162,0.001788,74.125.130.0-255,1484,187676,90,250150
12163,0.001797,74.125.130.0-255,2902,190578,90,250150
12164,0.001806,74.125.130.0-255,1484,192062,90,250150
12165,0.001829,74.125.130.0-255,2902,194964,90,250150
12166,0.001848,74.125.130.0-255,8574,203538,90,250150
12167,0.001858,74.125.130.0-255,766,204304,90,250150
12168,0.001956,74.125.130.0-255,1484,205788,90,250150
12169,0.001967,74.125.130.0-255,1484,207272,90,250150
12170,0.001982,74.125.130.0-255,1484,208756,90,250150
12171,0.001984,74.125.130.0-255,1484,210240,90,250150
12172,0.001987,74.125.130.0-255,2902,213142,90,250150
12173,0.002006,74.125.130.0-255,4320,217462,90,250150
12174,0.002019,74.125.130.0-255,1484,218946,90,250150
12175,0.002031,74.125.130.0-255,1484,220430,90,250150
12176,0.002042,74.125.130.0-255,2902,223332,90,250150
12177,0.002056,74.125.130.0-255,5738,229070,90,250150
12178,0.002065,74.125.130.0-255,1484,230554,90,250150
12179,0.002086,74.125.130.0-255,4320,234874,90,250150
12180,0.002103,74.125.130.0-255,3602,238476,90,250150
12181,0.003255,172.31.47.0-255,66,238542,90,250150
12182,0.005563,74.125.130.0-255,5738,244280,90,250150
12183,0.005569,172.31.47.0-255,66,244346,90,250150
12184,0.007845,74.125.130.0-255,5738,250084,90,250150
12185,0.00785,172.31.47.0-255,66,250150,90,250150
12186,0.0,172.217.27.0-255,153,153,90,98128
12187,3e-05,172.31.47.0-255,66,219,90,98128
12188,3.7e-05,172.217.27.0-255,1484,1703,90,98128
12189,4.2e-05,172.31.47.0-255,66,1769,90,98128
12190,5.3e-05,172.217.27.0-255,2902,4671,90,98128
12191,5.6e-05,172.31.47.0-255,66,4737,90,98128
12192,6e-05,172.217.27.0-255,2902,7639,90,98128
12193,6.2e-05,172.31.47.0-255,66,7705,90,98128
12194,6.7e-05,172.217.27.0-255,4320,12025,90,98128
12195,7e-05,172.31.47.0-255,66,12091,90,98128
12196,7.3e-05,172.217.27.0-255,2108,14199,90,98128
12197,7.5e-05,172.31.47.0-255,66,14265,90,98128
12198,0.000315,172.217.27.0-255,1484,15749,90,98128
12199,0.000321,172.31.47.0-255,66,15815,90,98128
12200,0.000327,172.217.27.0-255,2902,18717,90,98128
12201,0.000329,172.31.47.0-255,66,18783,90,98128
12202,0.000332,172.217.27.0-255,1484,20267,90,98128
12203,0.00034,172.31.47.0-255,66,20333,90,98128
12204,0.000347,172.217.27.0-255,5738,26071,90,98128
12205,0.00035,172.31.47.0-255,66,26137,90,98128
12206,0.000392,172.217.27.0-255,1484,27621,90,98128
12207,0.000396,172.31.47.0-255,66,27687,90,98128
12208,0.000424,172.217.27.0-255,3961,31648,90,98128
12209,0.000428,172.31.47.0-255,66,31714,90,98128
12210,0.000577,172.217.27.0-255,1484,33198,90,98128
12211,0.000582,172.31.47.0-255,66,33264,90,98128
12212,0.00059,172.217.27.0-255,2902,36166,90,98128
12213,0.000592,172.31.47.0-255,66,36232,90,98128
12214,0.000606,172.217.27.0-255,5738,41970,90,98128
12215,0.000608,172.31.47.0-255,66,42036,90,98128
12216,0.000651,172.31.47.0-255,66,42102,90,98128
12217,0.000654,172.217.27.0-255,1484,43586,90,98128
12218,0.00073,172.217.27.0-255,4320,47906,90,98128
12219,0.000746,172.217.27.0-255,3961,51867,90,98128
12220,0.00097,172.217.27.0-255,398,52265,90,98128
12221,0.001049,172.217.27.0-255,347,52612,90,98128
12222,0.001159,172.217.27.0-255,1484,54096,90,98128
12223,0.001165,172.217.27.0-255,2902,56998,90,98128
12224,0.001185,172.217.27.0-255,5738,62736,90,98128
12225,0.001188,172.217.27.0-255,1484,64220,90,98128
12226,0.001208,172.217.27.0-255,5379,69599,90,98128
12227,0.001247,172.217.27.0-255,4320,73919,90,98128
12228,0.00126,172.217.27.0-255,1484,75403,90,98128
12229,0.001267,172.217.27.0-255,7156,82559,90,98128
12230,0.001291,172.217.27.0-255,3961,86520,90,98128
12231,0.005207,172.31.47.0-255,66,86586,90,98128
12232,0.006825,172.217.27.0-255,5738,92324,90,98128
12233,0.006831,172.31.47.0-255,66,92390,90,98128
12234,0.008455,172.217.27.0-255,5738,98128,90,98128
12235,0.0,172.217.194.0-255,153,153,90,85620
12236,2.7e-05,172.31.47.0-255,66,219,90,85620
12237,3.4e-05,172.217.194.0-255,1484,1703,90,85620
12238,3.8e-05,172.31.47.0-255,66,1769,90,85620
12239,4.3e-05,172.217.194.0-255,2902,4671,90,85620
12240,4.6e-05,172.31.47.0-255,66,4737,90,85620
12241,5.3e-05,172.217.194.0-255,7156,11893,90,85620
12242,5.6e-05,172.31.47.0-255,66,11959,90,85620
12243,9.2e-05,172.217.194.0-255,4320,16279,90,85620
12244,9.6e-05,172.31.47.0-255,66,16345,90,85620
12245,0.000116,172.217.194.0-255,754,17099,90,85620
12246,0.000119,172.31.47.0-255,66,17165,90,85620
12247,0.000125,172.217.194.0-255,5738,22903,90,85620
12248,0.000128,172.31.47.0-255,66,22969,90,85620
12249,0.000131,172.217.194.0-255,1484,24453,90,85620
12250,0.000134,172.31.47.0-255,66,24519,90,85620
12251,0.000155,172.217.194.0-255,6797,31316,90,85620
12252,0.000158,172.31.47.0-255,66,31382,90,85620
12253,0.000166,172.217.194.0-255,5738,37120,90,85620
12254,0.000169,172.31.47.0-255,66,37186,90,85620
12255,0.000184,172.217.194.0-255,2902,40088,90,85620
12256,0.000186,172.31.47.0-255,66,40154,90,85620
12257,0.000192,172.217.194.0-255,4320,44474,90,85620
12258,0.000194,172.31.47.0-255,66,44540,90,85620
12259,0.000222,172.217.194.0-255,3961,48501,90,85620
12260,0.000225,172.31.47.0-255,66,48567,90,85620
12261,0.000233,172.217.194.0-255,8574,57141,90,85620
12262,0.000235,172.31.47.0-255,66,57207,90,85620
12263,0.000282,172.217.194.0-255,5738,62945,90,85620
12264,0.000286,172.31.47.0-255,66,63011,90,85620
12265,0.000309,172.217.194.0-255,2819,65830,90,85620
12266,0.000313,172.31.47.0-255,66,65896,90,85620
12267,0.000428,172.217.194.0-255,120,66016,90,85620
12268,0.000769,172.31.47.0-255,66,66082,90,85620
12269,0.001496,172.217.194.0-255,378,66460,90,85620
12270,0.002323,172.217.194.0-255,2902,69362,90,85620
12271,0.002323,172.31.47.0-255,66,69428,90,85620
12272,0.002327,172.31.47.0-255,66,69494,90,85620
12273,0.00303,172.217.194.0-255,1484,70978,90,85620
12274,0.004328,172.217.194.0-255,2902,73880,90,85620
12275,0.004331,172.31.47.0-255,66,73946,90,85620
12276,0.004347,172.217.194.0-255,1484,75430,90,85620
12277,0.006348,172.217.194.0-255,4320,79750,90,85620
12278,0.006353,172.31.47.0-255,66,79816,90,85620
12279,0.008389,172.217.194.0-255,5738,85554,90,85620
12280,0.008395,172.31.47.0-255,66,85620,90,85620
12281,0.0,74.125.24.0-255,298,298,90,277655
12282,1.6e-05,172.31.47.0-255,66,364,90,277655
12283,2.2e-05,74.125.24.0-255,1484,1848,90,277655
12284,2.7e-05,172.31.47.0-255,66,1914,90,277655
12285,4.1e-05,74.125.24.0-255,4320,6234,90,277655
12286,4.4e-05,172.31.47.0-255,66,6300,90,277655
12287,5.4e-05,74.125.24.0-255,9000,15300,90,277655
12288,5.7e-05,172.31.47.0-255,66,15366,90,277655
12289,6e-05,74.125.24.0-255,1484,16850,90,277655
12290,6.3e-05,172.31.47.0-255,66,16916,90,277655
12291,7.8e-05,172.31.47.0-255,66,16982,90,277655
12292,8.1e-05,74.125.24.0-255,1125,18107,90,277655
12293,8.3e-05,172.31.47.0-255,66,18173,90,277655
12294,0.000248,74.125.24.0-255,1484,19657,90,277655
12295,0.000253,172.31.47.0-255,66,19723,90,277655
12296,0.000259,74.125.24.0-255,2902,22625,90,277655
12297,0.000262,172.31.47.0-255,66,22691,90,277655
12298,0.000273,74.125.24.0-255,5738,28429,90,277655
12299,0.000276,172.31.47.0-255,66,28495,90,277655
12300,0.000315,172.31.47.0-255,66,28561,90,277655
12301,0.000363,74.125.24.0-255,8574,37135,90,277655
12302,0.000366,172.31.47.0-255,66,37201,90,277655
12303,0.000395,74.125.24.0-255,2879,40080,90,277655
12304,0.000398,172.31.47.0-255,66,40146,90,277655
12305,0.000423,74.125.24.0-255,108,40254,90,277655
12306,0.000425,172.31.47.0-255,66,40320,90,277655
12307,0.000429,74.125.24.0-255,330,40650,90,277655
12308,0.000431,172.31.47.0-255,66,40716,90,277655
12309,0.000742,74.125.24.0-255,1484,42200,90,277655
12310,0.000747,74.125.24.0-255,2902,45102,90,277655
12311,0.000753,172.31.47.0-255,66,45168,90,277655
12312,0.000757,172.31.47.0-255,66,45234,90,277655
12313,0.000769,74.125.24.0-255,5738,50972,90,277655
12314,0.000799,74.125.24.0-255,1484,52456,90,277655
12315,0.000803,172.31.47.0-255,66,52522,90,277655
12316,0.000807,172.31.47.0-255,66,52588,90,277655
12317,0.00084,74.125.24.0-255,8574,61162,90,277655
12318,0.000847,172.31.47.0-255,66,61228,90,277655
12319,0.00085,74.125.24.0-255,766,61994,90,277655
12320,0.001132,74.125.24.0-255,1484,63478,90,277655
12321,0.001137,172.31.47.0-255,66,63544,90,277655
12322,0.001142,74.125.24.0-255,2902,66446,90,277655
12323,0.001144,172.31.47.0-255,66,66512,90,277655
12324,0.001148,74.125.24.0-255,1484,67996,90,277655
12325,0.001165,74.125.24.0-255,4320,72316,90,277655
12326,0.001167,172.31.47.0-255,66,72382,90,277655
12327,0.001175,74.125.24.0-255,1484,73866,90,277655
12328,0.001209,172.31.47.0-255,66,73932,90,277655
12329,0.001216,74.125.24.0-255,7156,81088,90,277655
12330,0.001218,172.31.47.0-255,66,81154,90,277655
12331,0.001248,74.125.24.0-255,2902,84056,90,277655
12332,0.001251,172.31.47.0-255,66,84122,90,277655
12333,0.001254,74.125.24.0-255,766,84888,90,277655
12334,0.001355,74.125.24.0-255,1484,86372,90,277655
12335,0.001359,172.31.47.0-255,66,86438,90,277655
12336,0.001365,74.125.24.0-255,2902,89340,90,277655
12337,0.001368,172.31.47.0-255,66,89406,90,277655
12338,0.001394,74.125.24.0-255,5738,95144,90,277655
12339,0.001396,172.31.47.0-255,66,95210,90,277655
12340,0.001434,172.31.47.0-255,66,95276,90,277655
12341,0.001437,74.125.24.0-255,1484,96760,90,277655
12342,0.001499,74.125.24.0-255,9274,106034,90,277655
12343,0.001503,172.31.47.0-255,66,106100,90,277655
12344,0.001787,74.125.24.0-255,1484,107584,90,277655
12345,0.001807,74.125.24.0-255,2902,110486,90,277655
12346,0.00181,74.125.24.0-255,1484,111970,90,277655
12347,0.001818,172.31.47.0-255,66,112036,90,277655
12348,0.001824,74.125.24.0-255,2902,114938,90,277655
12349,0.001827,172.31.47.0-255,66,115004,90,277655
12350,0.00183,74.125.24.0-255,1484,116488,90,277655
12351,0.001857,74.125.24.0-255,7156,123644,90,277655
12352,0.00186,172.31.47.0-255,66,123710,90,277655
12353,0.001863,74.125.24.0-255,1484,125194,90,277655
12354,0.001898,172.31.47.0-255,66,125260,90,277655
12355,0.002045,74.125.24.0-255,1484,126744,90,277655
12356,0.002051,74.125.24.0-255,2902,129646,90,277655
12357,0.002054,172.31.47.0-255,66,129712,90,277655
12358,0.002076,74.125.24.0-255,5738,135450,90,277655
12359,0.002078,172.31.47.0-255,66,135516,90,277655
12360,0.002085,74.125.24.0-255,7156,142672,90,277655
12361,0.002087,172.31.47.0-255,66,142738,90,277655
12362,0.002125,74.125.24.0-255,2902,145640,90,277655
12363,0.002128,172.31.47.0-255,66,145706,90,277655
12364,0.00214,172.31.47.0-255,66,145772,90,277655
12365,0.002786,74.125.24.0-255,1484,147256,90,277655
12366,0.002793,74.125.24.0-255,2902,150158,90,277655
12367,0.002797,172.31.47.0-255,66,150224,90,277655
12368,0.002818,74.125.24.0-255,5738,155962,90,277655
12369,0.00282,172.31.47.0-255,66,156028,90,277655
12370,0.002845,74.125.24.0-255,4320,160348,90,277655
12371,0.002848,172.31.47.0-255,66,160414,90,277655
12372,0.002881,74.125.24.0-255,4320,164734,90,277655
12373,0.002884,172.31.47.0-255,66,164800,90,277655
12374,0.002893,74.125.24.0-255,9992,174792,90,277655
12375,0.0029,172.31.47.0-255,66,174858,90,277655
12376,0.002905,74.125.24.0-255,4320,179178,90,277655
12377,0.002907,172.31.47.0-255,66,179244,90,277655
12378,0.002936,74.125.24.0-255,766,180010,90,277655
12379,0.003104,74.125.24.0-255,1484,181494,90,277655
12380,0.00311,172.31.47.0-255,66,181560,90,277655
12381,0.003114,74.125.24.0-255,1484,183044,90,277655
12382,0.003136,74.125.24.0-255,1484,184528,90,277655
12383,0.003139,172.31.47.0-255,66,184594,90,277655
12384,0.003146,74.125.24.0-255,5738,190332,90,277655
12385,0.003148,172.31.47.0-255,66,190398,90,277655
12386,0.003156,74.125.24.0-255,1484,191882,90,277655
12387,0.003192,74.125.24.0-255,8574,200456,90,277655
12388,0.003196,172.31.47.0-255,66,200522,90,277655
12389,0.003212,172.31.47.0-255,66,200588,90,277655
12390,0.003241,74.125.24.0-255,5738,206326,90,277655
12391,0.003244,172.31.47.0-255,66,206392,90,277655
12392,0.00327,74.125.24.0-255,3602,209994,90,277655
12393,0.003273,172.31.47.0-255,66,210060,90,277655
12394,0.003304,74.125.24.0-255,5738,215798,90,277655
12395,0.003307,172.31.47.0-255,66,215864,90,277655
12396,0.003326,74.125.24.0-255,4320,220184,90,277655
12397,0.003328,172.31.47.0-255,66,220250,90,277655
12398,0.003341,172.31.47.0-255,66,220316,90,277655
12399,0.003346,74.125.24.0-255,2902,223218,90,277655
12400,0.003348,172.31.47.0-255,66,223284,90,277655
12401,0.003377,74.125.24.0-255,1484,224768,90,277655
12402,0.00338,74.125.24.0-255,766,225534,90,277655
12403,0.003382,172.31.47.0-255,66,225600,90,277655
12404,0.003406,74.125.24.0-255,1484,227084,90,277655
12405,0.00343,74.125.24.0-255,4320,231404,90,277655
12406,0.003433,172.31.47.0-255,66,231470,90,277655
12407,0.003461,74.125.24.0-255,9992,241462,90,277655
12408,0.003464,172.31.47.0-255,66,241528,90,277655
12409,0.003468,74.125.24.0-255,1484,243012,90,277655
12410,0.003481,172.31.47.0-255,66,243078,90,277655
12411,0.003487,74.125.24.0-255,3602,246680,90,277655
12412,0.003489,172.31.47.0-255,66,246746,90,277655
12413,0.003538,74.125.24.0-255,1484,248230,90,277655
12414,0.003546,74.125.24.0-255,7156,255386,90,277655
12415,0.003555,74.125.24.0-255,8574,263960,90,277655
12416,0.00358,74.125.24.0-255,4320,268280,90,277655
12417,0.003582,74.125.24.0-255,1484,269764,90,277655
12418,0.003585,74.125.24.0-255,1484,271248,90,277655
12419,0.003592,74.125.24.0-255,6302,277550,90,277655
12420,0.00365,74.125.24.0-255,105,277655,90,277655
12421,0.0,172.31.47.0-255,105,105,90,105
12422,0.0,172.31.47.0-255,105,105,90,276
12423,0.002077,157.240.13.0-255,105,210,90,276
12424,0.002088,172.31.47.0-255,66,276,90,276
12425,0.0,172.31.47.0-255,105,105,90,276
12426,0.002055,157.240.13.0-255,105,210,90,276
12427,0.002067,172.31.47.0-255,66,276,90,276
12428,0.0,172.217.194.0-255,156,156,90,258747
12429,2.8e-05,172.31.47.0-255,66,222,90,258747
12430,3.4e-05,172.217.194.0-255,1484,1706,90,258747
12431,3.8e-05,172.31.47.0-255,66,1772,90,258747
12432,4.2e-05,172.217.194.0-255,2902,4674,90,258747
12433,4.4e-05,172.31.47.0-255,66,4740,90,258747
12434,5.5e-05,172.217.194.0-255,2902,7642,90,258747
12435,5.7e-05,172.31.47.0-255,66,7708,90,258747
12436,9.8e-05,172.217.194.0-255,2902,10610,90,258747
12437,0.000102,172.31.47.0-255,66,10676,90,258747
12438,0.00012,172.217.194.0-255,3404,14080,90,258747
12439,0.000124,172.31.47.0-255,66,14146,90,258747
12440,0.000229,172.217.194.0-255,1484,15630,90,258747
12441,0.000233,172.31.47.0-255,66,15696,90,258747
12442,0.000238,172.217.194.0-255,2902,18598,90,258747
12443,0.000241,172.31.47.0-255,66,18664,90,258747
12444,0.000251,172.217.194.0-255,5738,24402,90,258747
12445,0.000254,172.31.47.0-255,66,24468,90,258747
12446,0.000258,172.217.194.0-255,4320,28788,90,258747
12447,0.00026,172.31.47.0-255,66,28854,90,258747
12448,0.0003,172.217.194.0-255,4320,33174,90,258747
12449,0.000305,172.31.47.0-255,66,33240,90,258747
12450,0.000329,172.217.194.0-255,8215,41455,90,258747
12451,0.000335,172.31.47.0-255,66,41521,90,258747
12452,0.000337,172.217.194.0-255,9992,51513,90,258747
12453,0.00034,172.31.47.0-255,66,51579,90,258747
12454,0.000391,172.31.47.0-255,66,51645,90,258747
12455,0.000539,172.217.194.0-255,359,52004,90,258747
12456,0.000544,172.31.47.0-255,66,52070,90,258747
12457,0.000687,172.217.194.0-255,1484,53554,90,258747
12458,0.000691,172.31.47.0-255,66,53620,90,258747
12459,0.000718,172.217.194.0-255,2902,56522,90,258747
12460,0.000721,172.31.47.0-255,66,56588,90,258747
12461,0.000732,172.217.194.0-255,1484,58072,90,258747
12462,0.000783,172.217.194.0-255,2902,60974,90,258747
12463,0.000789,172.217.194.0-255,5738,66712,90,258747
12464,0.000789,172.31.47.0-255,66,66778,90,258747
12465,0.000793,172.31.47.0-255,66,66844,90,258747
12466,0.00083,172.217.194.0-255,7156,74000,90,258747
12467,0.000834,172.31.47.0-255,66,74066,90,258747
12468,0.000858,172.217.194.0-255,1484,75550,90,258747
12469,0.000877,172.217.194.0-255,7156,82706,90,258747
12470,0.000881,172.31.47.0-255,66,82772,90,258747
12471,0.000925,172.217.194.0-255,3602,86374,90,258747
12472,0.000928,172.31.47.0-255,66,86440,90,258747
12473,0.000963,172.217.194.0-255,387,86827,90,258747
12474,0.000995,172.217.194.0-255,1484,88311,90,258747
12475,0.000999,172.31.47.0-255,66,88377,90,258747
12476,0.001024,172.217.194.0-255,2902,91279,90,258747
12477,0.001028,172.31.47.0-255,66,91345,90,258747
12478,0.001033,172.217.194.0-255,2902,94247,90,258747
12479,0.001035,172.31.47.0-255,66,94313,90,258747
12480,0.001055,172.217.194.0-255,2902,97215,90,258747
12481,0.001058,172.31.47.0-255,66,97281,90,258747
12482,0.001077,172.31.47.0-255,66,97347,90,258747
12483,0.001079,172.217.194.0-255,1484,98831,90,258747
12484,0.001106,172.217.194.0-255,2902,101733,90,258747
12485,0.00111,172.31.47.0-255,66,101799,90,258747
12486,0.001116,172.217.194.0-255,5738,107537,90,258747
12487,0.001119,172.31.47.0-255,66,107603,90,258747
12488,0.001121,172.217.194.0-255,766,108369,90,258747
12489,0.001245,172.217.194.0-255,1484,109853,90,258747
12490,0.001249,172.31.47.0-255,66,109919,90,258747
12491,0.001254,172.217.194.0-255,2902,112821,90,258747
12492,0.001256,172.31.47.0-255,66,112887,90,258747
12493,0.001283,172.217.194.0-255,1484,114371,90,258747
12494,0.001288,172.217.194.0-255,2902,117273,90,258747
12495,0.001291,172.31.47.0-255,66,117339,90,258747
12496,0.001297,172.217.194.0-255,5738,123077,90,258747
12497,0.0013,172.31.47.0-255,66,123143,90,258747
12498,0.001338,172.31.47.0-255,66,123209,90,258747
12499,0.00134,172.217.194.0-255,6438,129647,90,258747
12500,0.001343,172.31.47.0-255,66,129713,90,258747
12501,0.001441,172.217.194.0-255,1484,131197,90,258747
12502,0.001447,172.217.194.0-255,2902,134099,90,258747
12503,0.00145,172.31.47.0-255,66,134165,90,258747
12504,0.001456,172.217.194.0-255,4320,138485,90,258747
12505,0.001458,172.31.47.0-255,66,138551,90,258747
12506,0.001482,172.217.194.0-255,1484,140035,90,258747
12507,0.001501,172.31.47.0-255,66,140101,90,258747
12508,0.00153,172.217.194.0-255,5738,145839,90,258747
12509,0.001533,172.31.47.0-255,66,145905,90,258747
12510,0.001557,172.217.194.0-255,7856,153761,90,258747
12511,0.00156,172.31.47.0-255,66,153827,90,258747
12512,0.001567,172.217.194.0-255,7156,160983,90,258747
12513,0.001569,172.31.47.0-255,66,161049,90,258747
12514,0.001593,172.217.194.0-255,7156,168205,90,258747
12515,0.001597,172.31.47.0-255,66,168271,90,258747
12516,0.001611,172.31.47.0-255,66,168337,90,258747
12517,0.001635,172.217.194.0-255,3602,171939,90,258747
12518,0.001639,172.31.47.0-255,66,172005,90,258747
12519,0.001646,172.217.194.0-255,7156,179161,90,258747
12520,0.001649,172.31.47.0-255,66,179227,90,258747
12521,0.001678,172.217.194.0-255,1484,180711,90,258747
12522,0.001692,172.217.194.0-255,9992,190703,90,258747
12523,0.001695,172.31.47.0-255,66,190769,90,258747
12524,0.00171,172.31.47.0-255,66,190835,90,258747
12525,0.00177,172.217.194.0-255,1484,192319,90,258747
12526,0.001775,172.217.194.0-255,2902,195221,90,258747
12527,0.001778,172.31.47.0-255,66,195287,90,258747
12528,0.001784,172.217.194.0-255,5738,201025,90,258747
12529,0.001786,172.31.47.0-255,66,201091,90,258747
12530,0.001795,172.217.194.0-255,9992,211083,90,258747
12531,0.001797,172.31.47.0-255,66,211149,90,258747
12532,0.001822,172.217.194.0-255,2902,214051,90,258747
12533,0.001825,172.31.47.0-255,66,214117,90,258747
12534,0.001839,172.31.47.0-255,66,214183,90,258747
12535,0.001844,172.217.194.0-255,4320,218503,90,258747
12536,0.001846,172.31.47.0-255,66,218569,90,258747
12537,0.001878,172.217.194.0-255,5738,224307,90,258747
12538,0.001882,172.31.47.0-255,66,224373,90,258747
12539,0.001911,172.31.47.0-255,66,224439,90,258747
12540,0.001941,172.217.194.0-255,6438,230877,90,258747
12541,0.001946,172.31.47.0-255,66,230943,90,258747
12542,0.001965,172.31.47.0-255,66,231009,90,258747
12543,0.001972,172.217.194.0-255,9274,240283,90,258747
12544,0.001975,172.31.47.0-255,66,240349,90,258747
12545,0.001999,172.217.194.0-255,1484,241833,90,258747
12546,0.002029,172.217.194.0-255,8574,250407,90,258747
12547,0.002033,172.31.47.0-255,66,250473,90,258747
12548,0.002062,172.31.47.0-255,66,250539,90,258747
12549,0.002078,172.217.194.0-255,1484,252023,90,258747
12550,0.002084,172.217.194.0-255,5728,257751,90,258747
12551,0.002087,172.31.47.0-255,66,257817,90,258747
12552,0.002108,172.217.194.0-255,105,257922,90,258747
12553,0.002121,172.217.194.0-255,129,258051,90,258747
12554,0.003428,172.31.47.0-255,105,258156,90,258747
12555,0.00345,172.31.47.0-255,105,258261,90,258747
12556,0.003701,172.31.47.0-255,90,258351,90,258747
12557,0.003711,172.31.47.0-255,66,258417,90,258747
12558,0.00574,172.217.194.0-255,66,258483,90,258747
12559,0.005748,172.217.194.0-255,66,258549,90,258747
12560,0.005982,172.217.194.0-255,66,258615,90,258747
12561,0.006019,172.217.194.0-255,66,258681,90,258747
12562,0.006025,172.31.47.0-255,66,258747,90,258747
12563,0.0,74.125.24.0-255,153,153,90,131653
12564,2.3e-05,172.31.47.0-255,66,219,90,131653
12565,3.1e-05,74.125.24.0-255,1484,1703,90,131653
12566,3.5e-05,172.31.47.0-255,66,1769,90,131653
12567,4.9e-05,74.125.24.0-255,2902,4671,90,131653
12568,5.2e-05,172.31.47.0-255,66,4737,90,131653
12569,6e-05,74.125.24.0-255,7156,11893,90,131653
12570,6.3e-05,172.31.47.0-255,66,11959,90,131653
12571,6.7e-05,74.125.24.0-255,2138,14097,90,131653
12572,6.9e-05,172.31.47.0-255,66,14163,90,131653
12573,0.001042,74.125.24.0-255,1484,15647,90,131653
12574,0.00105,172.31.47.0-255,66,15713,90,131653
12575,0.001059,74.125.24.0-255,2902,18615,90,131653
12576,0.001061,172.31.47.0-255,66,18681,90,131653
12577,0.001073,74.125.24.0-255,5738,24419,90,131653
12578,0.001075,172.31.47.0-255,66,24485,90,131653
12579,0.001083,74.125.24.0-255,6797,31282,90,131653
12580,0.001086,172.31.47.0-255,66,31348,90,131653
12581,0.001129,172.31.47.0-255,66,31414,90,131653
12582,0.001136,74.125.24.0-255,7156,38570,90,131653
12583,0.001138,172.31.47.0-255,66,38636,90,131653
12584,0.001162,74.125.24.0-255,2902,41538,90,131653
12585,0.001164,172.31.47.0-255,66,41604,90,131653
12586,0.001192,74.125.24.0-255,9274,50878,90,131653
12587,0.001195,172.31.47.0-255,66,50944,90,131653
12588,0.001198,74.125.24.0-255,427,51371,90,131653
12589,0.0012,172.31.47.0-255,66,51437,90,131653
12590,0.001409,74.125.24.0-255,1484,52921,90,131653
12591,0.001411,172.31.47.0-255,66,52987,90,131653
12592,0.00143,74.125.24.0-255,2902,55889,90,131653
12593,0.001433,172.31.47.0-255,66,55955,90,131653
12594,0.001439,74.125.24.0-255,4320,60275,90,131653
12595,0.001441,172.31.47.0-255,66,60341,90,131653
12596,0.001468,74.125.24.0-255,1484,61825,90,131653
12597,0.001477,74.125.24.0-255,7156,68981,90,131653
12598,0.00148,172.31.47.0-255,66,69047,90,131653
12599,0.001504,74.125.24.0-255,2902,71949,90,131653
12600,0.001507,172.31.47.0-255,66,72015,90,131653
12601,0.00152,172.31.47.0-255,66,72081,90,131653
12602,0.001523,74.125.24.0-255,2184,74265,90,131653
12603,0.001526,172.31.47.0-255,66,74331,90,131653
12604,0.001771,74.125.24.0-255,1484,75815,90,131653
12605,0.001787,74.125.24.0-255,2902,78717,90,131653
12606,0.00179,172.31.47.0-255,66,78783,90,131653
12607,0.001816,74.125.24.0-255,5738,84521,90,131653
12608,0.001819,172.31.47.0-255,66,84587,90,131653
12609,0.001827,74.125.24.0-255,7156,91743,90,131653
12610,0.001829,172.31.47.0-255,66,91809,90,131653
12611,0.001852,74.125.24.0-255,4320,96129,90,131653
12612,0.001869,74.125.24.0-255,5738,101867,90,131653
12613,0.001898,74.125.24.0-255,4320,106187,90,131653
12614,0.001902,74.125.24.0-255,2184,108371,90,131653
12615,0.00193,74.125.24.0-255,4320,112691,90,131653
12616,0.002004,74.125.24.0-255,1484,114175,90,131653
12617,0.003751,172.31.47.0-255,66,114241,90,131653
12618,0.005783,74.125.24.0-255,5738,119979,90,131653
12619,0.00579,172.31.47.0-255,66,120045,90,131653
12620,0.007834,74.125.24.0-255,5738,125783,90,131653
12621,0.007842,172.31.47.0-255,66,125849,90,131653
12622,0.009913,74.125.24.0-255,5738,131587,90,131653
12623,0.009921,172.31.47.0-255,66,131653,90,131653
12624,0.0,172.217.194.0-255,143,143,90,75961
12625,2.7e-05,172.31.47.0-255,66,209,90,75961
12626,3.3e-05,172.217.194.0-255,1484,1693,90,75961
12627,3.6e-05,172.31.47.0-255,66,1759,90,75961
12628,4.2e-05,172.217.194.0-255,2902,4661,90,75961
12629,5.2e-05,172.31.47.0-255,66,4727,90,75961
12630,0.00012,172.217.194.0-255,4320,9047,90,75961
12631,0.000124,172.31.47.0-255,66,9113,90,75961
12632,0.000151,172.217.194.0-255,2902,12015,90,75961
12633,0.000155,172.31.47.0-255,66,12081,90,75961
12634,0.000309,172.217.194.0-255,1974,14055,90,75961
12635,0.000314,172.31.47.0-255,66,14121,90,75961
12636,0.000366,172.217.194.0-255,9992,24113,90,75961
12637,0.00037,172.31.47.0-255,66,24179,90,75961
12638,0.000397,172.217.194.0-255,1484,25663,90,75961
12639,0.0004,172.31.47.0-255,66,25729,90,75961
12640,0.000703,172.217.194.0-255,5379,31108,90,75961
12641,0.000709,172.31.47.0-255,66,31174,90,75961
12642,0.000828,172.217.194.0-255,7156,38330,90,75961
12643,0.000832,172.31.47.0-255,66,38396,90,75961
12644,0.000872,172.31.47.0-255,66,38462,90,75961
12645,0.001458,172.217.194.0-255,2902,41364,90,75961
12646,0.001465,172.31.47.0-255,66,41430,90,75961
12647,0.001487,172.217.194.0-255,8215,49645,90,75961
12648,0.00149,172.31.47.0-255,66,49711,90,75961
12649,0.001724,172.217.194.0-255,2902,52613,90,75961
12650,0.001727,172.31.47.0-255,66,52679,90,75961
12651,0.001762,172.31.47.0-255,66,52745,90,75961
12652,0.00213,172.217.194.0-255,5738,58483,90,75961
12653,0.002134,172.31.47.0-255,66,58549,90,75961
12654,0.002887,172.217.194.0-255,5738,64287,90,75961
12655,0.003963,172.31.47.0-255,66,64353,90,75961
12656,0.006485,172.217.194.0-255,5738,70091,90,75961
12657,0.006491,172.31.47.0-255,66,70157,90,75961
12658,0.009011,172.217.194.0-255,5738,75895,90,75961
12659,0.009019,172.31.47.0-255,66,75961,90,75961
12660,0.0,172.217.194.0-255,155,155,90,271287
12661,2.5e-05,172.31.47.0-255,66,221,90,271287
12662,3.2e-05,172.217.194.0-255,1484,1705,90,271287
12663,3.5e-05,172.31.47.0-255,66,1771,90,271287
12664,5.2e-05,172.217.194.0-255,2902,4673,90,271287
12665,5.5e-05,172.31.47.0-255,66,4739,90,271287
12666,8.5e-05,172.217.194.0-255,7156,11895,90,271287
12667,8.8e-05,172.31.47.0-255,66,11961,90,271287
12668,9.3e-05,172.217.194.0-255,1975,13936,90,271287
12669,9.6e-05,172.31.47.0-255,66,14002,90,271287
12670,0.000354,172.217.194.0-255,1484,15486,90,271287
12671,0.000359,172.31.47.0-255,66,15552,90,271287
12672,0.000365,172.217.194.0-255,2902,18454,90,271287
12673,0.000367,172.31.47.0-255,66,18520,90,271287
12674,0.000396,172.217.194.0-255,5738,24258,90,271287
12675,0.000399,172.31.47.0-255,66,24324,90,271287
12676,0.000409,172.217.194.0-255,9992,34316,90,271287
12677,0.000412,172.31.47.0-255,66,34382,90,271287
12678,0.000443,172.217.194.0-255,3961,38343,90,271287
12679,0.000445,172.31.47.0-255,66,38409,90,271287
12680,0.000457,172.31.47.0-255,66,38475,90,271287
12681,0.000492,172.217.194.0-255,9992,48467,90,271287
12682,0.000496,172.31.47.0-255,66,48533,90,271287
12683,0.000517,172.217.194.0-255,5020,53553,90,271287
12684,0.00052,172.31.47.0-255,66,53619,90,271287
12685,0.00054,172.217.194.0-255,378,53997,90,271287
12686,0.000543,172.31.47.0-255,66,54063,90,271287
12687,0.000567,172.217.194.0-255,102,54165,90,271287
12688,0.00057,172.31.47.0-255,66,54231,90,271287
12689,0.000692,172.217.194.0-255,1484,55715,90,271287
12690,0.000696,172.31.47.0-255,66,55781,90,271287
12691,0.000716,172.217.194.0-255,1484,57265,90,271287
12692,0.000729,172.217.194.0-255,1484,58749,90,271287
12693,0.000733,172.31.47.0-255,66,58815,90,271287
12694,0.00075,172.217.194.0-255,5738,64553,90,271287
12695,0.000753,172.31.47.0-255,66,64619,90,271287
12696,0.000756,172.217.194.0-255,1484,66103,90,271287
12697,0.000787,172.31.47.0-255,66,66169,90,271287
12698,0.000814,172.217.194.0-255,10692,76861,90,271287
12699,0.000819,172.31.47.0-255,66,76927,90,271287
12700,0.00099,172.217.194.0-255,1484,78411,90,271287
12701,0.001011,172.217.194.0-255,2902,81313,90,271287
12702,0.001014,172.31.47.0-255,66,81379,90,271287
12703,0.00102,172.217.194.0-255,4320,85699,90,271287
12704,0.001022,172.31.47.0-255,66,85765,90,271287
12705,0.001034,172.217.194.0-255,1484,87249,90,271287
12706,0.001052,172.217.194.0-255,5738,92987,90,271287
12707,0.001055,172.31.47.0-255,66,93053,90,271287
12708,0.001077,172.217.194.0-255,7156,100209,90,271287
12709,0.00108,172.31.47.0-255,66,100275,90,271287
12710,0.001087,172.217.194.0-255,8574,108849,90,271287
12711,0.001095,172.31.47.0-255,66,108915,90,271287
12712,0.001111,172.217.194.0-255,2184,111099,90,271287
12713,0.001114,172.31.47.0-255,66,111165,90,271287
12714,0.001145,172.217.194.0-255,1484,112649,90,271287
12715,0.001163,172.217.194.0-255,2902,115551,90,271287
12716,0.001166,172.31.47.0-255,66,115617,90,271287
12717,0.001188,172.217.194.0-255,5738,121355,90,271287
12718,0.001191,172.31.47.0-255,66,121421,90,271287
12719,0.001197,172.217.194.0-255,5738,127159,90,271287
12720,0.001199,172.31.47.0-255,66,127225,90,271287
12721,0.001202,172.217.194.0-255,1484,128709,90,271287
12722,0.001242,172.31.47.0-255,66,128775,90,271287
12723,0.001245,172.217.194.0-255,766,129541,90,271287
12724,0.001248,172.217.194.0-255,1484,131025,90,271287
12725,0.00125,172.31.47.0-255,66,131091,90,271287
12726,0.001272,172.217.194.0-255,4320,135411,90,271287
12727,0.001276,172.31.47.0-255,66,135477,90,271287
12728,0.001279,172.217.194.0-255,1484,136961,90,271287
12729,0.001301,172.217.194.0-255,8574,145535,90,271287
12730,0.001304,172.31.47.0-255,66,145601,90,271287
12731,0.001307,172.217.194.0-255,1484,147085,90,271287
12732,0.001334,172.31.47.0-255,66,147151,90,271287
12733,0.001357,172.217.194.0-255,5020,152171,90,271287
12734,0.001361,172.31.47.0-255,66,152237,90,271287
12735,0.001366,172.217.194.0-255,5738,157975,90,271287
12736,0.001369,172.31.47.0-255,66,158041,90,271287
12737,0.001393,172.217.194.0-255,1484,159525,90,271287
12738,0.001406,172.217.194.0-255,4320,163845,90,271287
12739,0.001411,172.31.47.0-255,66,163911,90,271287
12740,0.001437,172.217.194.0-255,7156,171067,90,271287
12741,0.00144,172.31.47.0-255,66,171133,90,271287
12742,0.001445,172.217.194.0-255,4320,175453,90,271287
12743,0.001448,172.31.47.0-255,66,175519,90,271287
12744,0.001483,172.217.194.0-255,5738,181257,90,271287
12745,0.001486,172.31.47.0-255,66,181323,90,271287
12746,0.001508,172.217.194.0-255,5020,186343,90,271287
12747,0.001511,172.31.47.0-255,66,186409,90,271287
12748,0.001564,172.217.194.0-255,1484,187893,90,271287
12749,0.001569,172.217.194.0-255,2902,190795,90,271287
12750,0.001572,172.31.47.0-255,66,190861,90,271287
12751,0.001628,172.217.194.0-255,5738,196599,90,271287
12752,0.001631,172.31.47.0-255,66,196665,90,271287
12753,0.001644,172.217.194.0-255,8574,205239,90,271287
12754,0.001647,172.31.47.0-255,66,205305,90,271287
12755,0.001675,172.217.194.0-255,4320,209625,90,271287
12756,0.001678,172.31.47.0-255,66,209691,90,271287
12757,0.001688,172.217.194.0-255,10692,220383,90,271287
12758,0.00169,172.31.47.0-255,66,220449,90,271287
12759,0.001694,172.217.194.0-255,1484,221933,90,271287
12760,0.001712,172.217.194.0-255,2902,224835,90,271287
12761,0.001717,172.31.47.0-255,66,224901,90,271287
12762,0.001737,172.217.194.0-255,5738,230639,90,271287
12763,0.001741,172.31.47.0-255,66,230705,90,271287
12764,0.001745,172.217.194.0-255,2902,233607,90,271287
12765,0.001747,172.31.47.0-255,66,233673,90,271287
12766,0.001782,172.217.194.0-255,9992,243665,90,271287
12767,0.001787,172.31.47.0-255,66,243731,90,271287
12768,0.001795,172.31.47.0-255,66,243797,90,271287
12769,0.001808,172.217.194.0-255,766,244563,90,271287
12770,0.001811,172.217.194.0-255,1484,246047,90,271287
12771,0.001814,172.31.47.0-255,66,246113,90,271287
12772,0.001856,172.31.47.0-255,66,246179,90,271287
12773,0.001859,172.217.194.0-255,1484,247663,90,271287
12774,0.001883,172.217.194.0-255,9992,257655,90,271287
12775,0.001887,172.31.47.0-255,66,257721,90,271287
12776,0.001927,172.31.47.0-255,66,257787,90,271287
12777,0.001931,172.217.194.0-255,2902,260689,90,271287
12778,0.001934,172.31.47.0-255,66,260755,90,271287
12779,0.001952,172.217.194.0-255,9992,270747,90,271287
12780,0.001957,172.31.47.0-255,66,270813,90,271287
12781,0.001998,172.31.47.0-255,66,270879,90,271287
12782,0.002014,172.31.47.0-255,66,270945,90,271287
12783,0.002035,172.217.194.0-255,105,271050,90,271287
12784,0.003418,172.31.47.0-255,66,271116,90,271287
12785,0.003446,172.31.47.0-255,105,271221,90,271287
12786,0.005719,172.217.194.0-255,66,271287,90,271287
12787,0.0,74.125.24.0-255,143,143,90,347368
12788,2.1e-05,172.31.47.0-255,66,209,90,347368
12789,2.8e-05,74.125.24.0-255,1484,1693,90,347368
12790,3.2e-05,172.31.47.0-255,66,1759,90,347368
12791,3.7e-05,74.125.24.0-255,2902,4661,90,347368
12792,3.9e-05,172.31.47.0-255,66,4727,90,347368
12793,4.6e-05,74.125.24.0-255,7156,11883,90,347368
12794,4.8e-05,172.31.47.0-255,66,11949,90,347368
12795,5.2e-05,74.125.24.0-255,2138,14087,90,347368
12796,5.5e-05,172.31.47.0-255,66,14153,90,347368
12797,0.000106,74.125.24.0-255,1484,15637,90,347368
12798,0.000108,172.31.47.0-255,66,15703,90,347368
12799,0.000127,74.125.24.0-255,2902,18605,90,347368
12800,0.00013,172.31.47.0-255,66,18671,90,347368
12801,0.000136,74.125.24.0-255,5738,24409,90,347368
12802,0.000138,172.31.47.0-255,66,24475,90,347368
12803,0.000142,74.125.24.0-255,2902,27377,90,347368
12804,0.000144,172.31.47.0-255,66,27443,90,347368
12805,0.000196,74.125.24.0-255,3961,31404,90,347368
12806,0.000199,172.31.47.0-255,66,31470,90,347368
12807,0.000316,74.125.24.0-255,1484,32954,90,347368
12808,0.00032,172.31.47.0-255,66,33020,90,347368
12809,0.000325,74.125.24.0-255,2902,35922,90,347368
12810,0.000327,172.31.47.0-255,66,35988,90,347368
12811,0.000342,74.125.24.0-255,5738,41726,90,347368
12812,0.000344,172.31.47.0-255,66,41792,90,347368
12813,0.000363,74.125.24.0-255,2902,44694,90,347368
12814,0.000364,172.31.47.0-255,66,44760,90,347368
12815,0.00038,74.125.24.0-255,1484,46244,90,347368
12816,0.000383,172.31.47.0-255,66,46310,90,347368
12817,0.000401,74.125.24.0-255,9633,55943,90,347368
12818,0.000403,172.31.47.0-255,66,56009,90,347368
12819,0.000411,74.125.24.0-255,8574,64583,90,347368
12820,0.000413,172.31.47.0-255,66,64649,90,347368
12821,0.000437,74.125.24.0-255,1125,65774,90,347368
12822,0.000485,74.125.24.0-255,679,66453,90,347368
12823,0.000488,172.31.47.0-255,66,66519,90,347368
12824,0.000705,74.125.24.0-255,1484,68003,90,347368
12825,0.000711,74.125.24.0-255,2902,70905,90,347368
12826,0.000714,172.31.47.0-255,66,70971,90,347368
12827,0.000718,74.125.24.0-255,2902,73873,90,347368
12828,0.00072,172.31.47.0-255,66,73939,90,347368
12829,0.000732,74.125.24.0-255,2902,76841,90,347368
12830,0.000734,172.31.47.0-255,66,76907,90,347368
12831,0.00079,172.31.47.0-255,66,76973,90,347368
12832,0.000815,74.125.24.0-255,2902,79875,90,347368
12833,0.000817,172.31.47.0-255,66,79941,90,347368
12834,0.000838,74.125.24.0-255,7856,87797,90,347368
12835,0.000841,172.31.47.0-255,66,87863,90,347368
12836,0.001039,74.125.24.0-255,1484,89347,90,347368
12837,0.001045,74.125.24.0-255,2902,92249,90,347368
12838,0.001048,172.31.47.0-255,66,92315,90,347368
12839,0.001051,74.125.24.0-255,1484,93799,90,347368
12840,0.001071,74.125.24.0-255,4320,98119,90,347368
12841,0.001073,172.31.47.0-255,66,98185,90,347368
12842,0.001087,74.125.24.0-255,4320,102505,90,347368
12843,0.001089,172.31.47.0-255,66,102571,90,347368
12844,0.001112,74.125.24.0-255,8574,111145,90,347368
12845,0.001114,172.31.47.0-255,66,111211,90,347368
12846,0.001144,74.125.24.0-255,2902,114113,90,347368
12847,0.001146,172.31.47.0-255,66,114179,90,347368
12848,0.001171,74.125.24.0-255,7856,122035,90,347368
12849,0.001173,172.31.47.0-255,66,122101,90,347368
12850,0.001731,74.125.24.0-255,1484,123585,90,347368
12851,0.001739,74.125.24.0-255,2902,126487,90,347368
12852,0.001743,172.31.47.0-255,66,126553,90,347368
12853,0.001761,74.125.24.0-255,5738,132291,90,347368
12854,0.001764,172.31.47.0-255,66,132357,90,347368
12855,0.001783,74.125.24.0-255,2902,135259,90,347368
12856,0.001785,172.31.47.0-255,66,135325,90,347368
12857,0.001803,74.125.24.0-255,9992,145317,90,347368
12858,0.001805,172.31.47.0-255,66,145383,90,347368
12859,0.001809,74.125.24.0-255,4320,149703,90,347368
12860,0.001811,172.31.47.0-255,66,149769,90,347368
12861,0.00185,74.125.24.0-255,4320,154089,90,347368
12862,0.001853,172.31.47.0-255,66,154155,90,347368
12863,0.001865,74.125.24.0-255,2184,156339,90,347368
12864,0.001867,172.31.47.0-255,66,156405,90,347368
12865,0.00207,74.125.24.0-255,1484,157889,90,347368
12866,0.002077,74.125.24.0-255,2902,160791,90,347368
12867,0.00208,172.31.47.0-255,66,160857,90,347368
12868,0.002099,74.125.24.0-255,5738,166595,90,347368
12869,0.002101,172.31.47.0-255,66,166661,90,347368
12870,0.002124,74.125.24.0-255,5738,172399,90,347368
12871,0.002126,172.31.47.0-255,66,172465,90,347368
12872,0.002152,172.31.47.0-255,66,172531,90,347368
12873,0.002155,74.125.24.0-255,1484,174015,90,347368
12874,0.002173,74.125.24.0-255,3602,177617,90,347368
12875,0.002175,172.31.47.0-255,66,177683,90,347368
12876,0.002204,74.125.24.0-255,5738,183421,90,347368
12877,0.002207,172.31.47.0-255,66,183487,90,347368
12878,0.002213,74.125.24.0-255,7156,190643,90,347368
12879,0.002216,172.31.47.0-255,66,190709,90,347368
12880,0.002228,74.125.24.0-255,1484,192193,90,347368
12881,0.002254,172.31.47.0-255,66,192259,90,347368
12882,0.00226,74.125.24.0-255,6438,198697,90,347368
12883,0.002262,172.31.47.0-255,66,198763,90,347368
12884,0.002298,74.125.24.0-255,2902,201665,90,347368
12885,0.0023,172.31.47.0-255,66,201731,90,347368
12886,0.002322,74.125.24.0-255,4320,206051,90,347368
12887,0.002325,172.31.47.0-255,66,206117,90,347368
12888,0.002339,74.125.24.0-255,4320,210437,90,347368
12889,0.002341,172.31.47.0-255,66,210503,90,347368
12890,0.002373,74.125.24.0-255,4320,214823,90,347368
12891,0.002376,172.31.47.0-255,66,214889,90,347368
12892,0.002382,74.125.24.0-255,5738,220627,90,347368
12893,0.002384,172.31.47.0-255,66,220693,90,347368
12894,0.002435,74.125.24.0-255,5738,226431,90,347368
12895,0.002437,172.31.47.0-255,66,226497,90,347368
12896,0.002455,74.125.24.0-255,6438,232935,90,347368
12897,0.002458,172.31.47.0-255,66,233001,90,347368
12898,0.002526,74.125.24.0-255,1484,234485,90,347368
12899,0.002547,74.125.24.0-255,2902,237387,90,347368
12900,0.002549,172.31.47.0-255,66,237453,90,347368
12901,0.002554,74.125.24.0-255,2902,240355,90,347368
12902,0.002556,172.31.47.0-255,66,240421,90,347368
12903,0.002579,74.125.24.0-255,7156,247577,90,347368
12904,0.002582,172.31.47.0-255,66,247643,90,347368
12905,0.002599,74.125.24.0-255,2902,250545,90,347368
12906,0.002601,172.31.47.0-255,66,250611,90,347368
12907,0.002624,74.125.24.0-255,8574,259185,90,347368
12908,0.002627,172.31.47.0-255,66,259251,90,347368
12909,0.002629,74.125.24.0-255,1484,260735,90,347368
12910,0.002658,74.125.24.0-255,6438,267173,90,347368
12911,0.002661,172.31.47.0-255,66,267239,90,347368
12912,0.002747,74.125.24.0-255,1484,268723,90,347368
12913,0.002753,74.125.24.0-255,2902,271625,90,347368
12914,0.002756,172.31.47.0-255,66,271691,90,347368
12915,0.002775,74.125.24.0-255,2902,274593,90,347368
12916,0.002777,172.31.47.0-255,66,274659,90,347368
12917,0.002792,74.125.24.0-255,5738,280397,90,347368
12918,0.002794,172.31.47.0-255,66,280463,90,347368
12919,0.002821,74.125.24.0-255,4320,284783,90,347368
12920,0.002823,172.31.47.0-255,66,284849,90,347368
12921,0.002831,74.125.24.0-255,9992,294841,90,347368
12922,0.002833,172.31.47.0-255,66,294907,90,347368
12923,0.002836,74.125.24.0-255,1484,296391,90,347368
12924,0.002853,74.125.24.0-255,1484,297875,90,347368
12925,0.002855,172.31.47.0-255,66,297941,90,347368
12926,0.002867,74.125.24.0-255,3602,301543,90,347368
12927,0.002869,172.31.47.0-255,66,301609,90,347368
12928,0.002874,74.125.24.0-255,4320,305929,90,347368
12929,0.002876,172.31.47.0-255,66,305995,90,347368
12930,0.002906,74.125.24.0-255,1484,307479,90,347368
12931,0.00292,172.31.47.0-255,66,307545,90,347368
12932,0.002926,74.125.24.0-255,7156,314701,90,347368
12933,0.002928,172.31.47.0-255,66,314767,90,347368
12934,0.002954,74.125.24.0-255,4320,319087,90,347368
12935,0.002955,172.31.47.0-255,66,319153,90,347368
12936,0.002977,74.125.24.0-255,9992,329145,90,347368
12937,0.002979,172.31.47.0-255,66,329211,90,347368
12938,0.003012,74.125.24.0-255,7856,337067,90,347368
12939,0.003015,172.31.47.0-255,66,337133,90,347368
12940,0.003026,172.31.47.0-255,66,337199,90,347368
12941,0.003031,74.125.24.0-255,5738,342937,90,347368
12942,0.003034,172.31.47.0-255,66,343003,90,347368
12943,0.003038,74.125.24.0-255,4194,347197,90,347368
12944,0.00304,172.31.47.0-255,66,347263,90,347368
12945,0.003057,74.125.24.0-255,105,347368,90,347368
12946,0.0,172.31.47.0-255,105,105,90,276
12947,0.001798,157.240.7.0-255,105,210,90,276
12948,0.001812,172.31.47.0-255,66,276,90,276
12949,0.0,172.31.47.0-255,66,66,90,66
12950,0.0,74.125.200.0-255,153,153,90,259333
12951,2.6e-05,172.31.47.0-255,66,219,90,259333
12952,3.3e-05,74.125.200.0-255,1484,1703,90,259333
12953,3.7e-05,172.31.47.0-255,66,1769,90,259333
12954,4.1e-05,74.125.200.0-255,2902,4671,90,259333
12955,5.1e-05,172.31.47.0-255,66,4737,90,259333
12956,8.5e-05,74.125.200.0-255,5738,10475,90,259333
12957,8.8e-05,172.31.47.0-255,66,10541,90,259333
12958,9.3e-05,74.125.200.0-255,3464,14005,90,259333
12959,9.5e-05,172.31.47.0-255,66,14071,90,259333
12960,0.0001,74.125.200.0-255,4320,18391,90,259333
12961,0.000107,172.31.47.0-255,66,18457,90,259333
12962,0.000141,74.125.200.0-255,9992,28449,90,259333
12963,0.000145,172.31.47.0-255,66,28515,90,259333
12964,0.000149,74.125.200.0-255,2543,31058,90,259333
12965,0.00015,172.31.47.0-255,66,31124,90,259333
12966,0.000219,74.125.200.0-255,1484,32608,90,259333
12967,0.000222,172.31.47.0-255,66,32674,90,259333
12968,0.000227,74.125.200.0-255,2902,35576,90,259333
12969,0.000229,172.31.47.0-255,66,35642,90,259333
12970,0.000255,74.125.200.0-255,4320,39962,90,259333
12971,0.000259,172.31.47.0-255,66,40028,90,259333
12972,0.000281,74.125.200.0-255,4320,44348,90,259333
12973,0.000284,172.31.47.0-255,66,44414,90,259333
12974,0.000315,74.125.200.0-255,4320,48734,90,259333
12975,0.000319,172.31.47.0-255,66,48800,90,259333
12976,0.000324,74.125.200.0-255,4320,53120,90,259333
12977,0.000326,172.31.47.0-255,66,53186,90,259333
12978,0.000364,172.31.47.0-255,66,53252,90,259333
12979,0.000367,74.125.200.0-255,399,53651,90,259333
12980,0.000369,172.31.47.0-255,66,53717,90,259333
12981,0.000411,74.125.200.0-255,344,54061,90,259333
12982,0.00059,74.125.200.0-255,1484,55545,90,259333
12983,0.000594,172.31.47.0-255,66,55611,90,259333
12984,0.000635,74.125.200.0-255,2902,58513,90,259333
12985,0.000638,172.31.47.0-255,66,58579,90,259333
12986,0.000641,74.125.200.0-255,1484,60063,90,259333
12987,0.000644,74.125.200.0-255,1484,61547,90,259333
12988,0.000646,172.31.47.0-255,66,61613,90,259333
12989,0.000663,74.125.200.0-255,1484,63097,90,259333
12990,0.000675,74.125.200.0-255,5738,68835,90,259333
12991,0.000679,172.31.47.0-255,66,68901,90,259333
12992,0.000718,172.31.47.0-255,66,68967,90,259333
12993,0.000749,74.125.200.0-255,7307,76274,90,259333
12994,0.000753,172.31.47.0-255,66,76340,90,259333
12995,0.000801,74.125.200.0-255,4320,80660,90,259333
12996,0.000804,172.31.47.0-255,66,80726,90,259333
12997,0.000851,74.125.200.0-255,2902,83628,90,259333
12998,0.000854,172.31.47.0-255,66,83694,90,259333
12999,0.000859,74.125.200.0-255,2902,86596,90,259333
13000,0.000861,172.31.47.0-255,66,86662,90,259333
13001,0.000883,74.125.200.0-255,1484,88146,90,259333
13002,0.0009,74.125.200.0-255,5379,93525,90,259333
13003,0.000904,172.31.47.0-255,66,93591,90,259333
13004,0.001061,74.125.200.0-255,1484,95075,90,259333
13005,0.001066,74.125.200.0-255,2902,97977,90,259333
13006,0.00107,172.31.47.0-255,66,98043,90,259333
13007,0.001092,74.125.200.0-255,1484,99527,90,259333
13008,0.001118,74.125.200.0-255,2902,102429,90,259333
13009,0.001121,172.31.47.0-255,66,102495,90,259333
13010,0.001143,74.125.200.0-255,5738,108233,90,259333
13011,0.001146,172.31.47.0-255,66,108299,90,259333
13012,0.00115,74.125.200.0-255,2902,111201,90,259333
13013,0.001152,172.31.47.0-255,66,111267,90,259333
13014,0.001154,74.125.200.0-255,1484,112751,90,259333
13015,0.001176,74.125.200.0-255,2902,115653,90,259333
13016,0.001179,172.31.47.0-255,66,115719,90,259333
13017,0.001185,74.125.200.0-255,7156,122875,90,259333
13018,0.001187,172.31.47.0-255,66,122941,90,259333
13019,0.001206,74.125.200.0-255,1484,124425,90,259333
13020,0.001211,74.125.200.0-255,3602,128027,90,259333
13021,0.001218,172.31.47.0-255,66,128093,90,259333
13022,0.001386,74.125.200.0-255,1484,129577,90,259333
13023,0.001426,74.125.200.0-255,1484,131061,90,259333
13024,0.001429,172.31.47.0-255,66,131127,90,259333
13025,0.001434,74.125.200.0-255,2902,134029,90,259333
13026,0.001436,172.31.47.0-255,66,134095,90,259333
13027,0.001439,74.125.200.0-255,1484,135579,90,259333
13028,0.001462,74.125.200.0-255,2902,138481,90,259333
13029,0.001464,172.31.47.0-255,66,138547,90,259333
13030,0.001495,74.125.200.0-255,1484,140031,90,259333
13031,0.001509,74.125.200.0-255,2902,142933,90,259333
13032,0.001511,172.31.47.0-255,66,142999,90,259333
13033,0.001514,74.125.200.0-255,1484,144483,90,259333
13034,0.001551,74.125.200.0-255,4320,148803,90,259333
13035,0.001554,172.31.47.0-255,66,148869,90,259333
13036,0.001558,74.125.200.0-255,2902,151771,90,259333
13037,0.001559,172.31.47.0-255,66,151837,90,259333
13038,0.001563,74.125.200.0-255,2902,154739,90,259333
13039,0.001565,172.31.47.0-255,66,154805,90,259333
13040,0.00159,74.125.200.0-255,1484,156289,90,259333
13041,0.001606,74.125.200.0-255,5738,162027,90,259333
13042,0.001609,172.31.47.0-255,66,162093,90,259333
13043,0.00162,74.125.200.0-255,2184,164277,90,259333
13044,0.001622,172.31.47.0-255,66,164343,90,259333
13045,0.001633,74.125.200.0-255,8574,172917,90,259333
13046,0.001635,172.31.47.0-255,66,172983,90,259333
13047,0.001659,74.125.200.0-255,5738,178721,90,259333
13048,0.001666,172.31.47.0-255,66,178787,90,259333
13049,0.001693,74.125.200.0-255,7156,185943,90,259333
13050,0.001696,172.31.47.0-255,66,186009,90,259333
13051,0.00171,74.125.200.0-255,4320,190329,90,259333
13052,0.001717,172.31.47.0-255,66,190395,90,259333
13053,0.001746,74.125.200.0-255,6438,196833,90,259333
13054,0.001749,172.31.47.0-255,66,196899,90,259333
13055,0.001752,74.125.200.0-255,1484,198383,90,259333
13056,0.001775,74.125.200.0-255,2902,201285,90,259333
13057,0.001778,172.31.47.0-255,66,201351,90,259333
13058,0.001782,74.125.200.0-255,2902,204253,90,259333
13059,0.001783,172.31.47.0-255,66,204319,90,259333
13060,0.001807,74.125.200.0-255,2902,207221,90,259333
13061,0.00181,172.31.47.0-255,66,207287,90,259333
13062,0.001817,74.125.200.0-255,1484,208771,90,259333
13063,0.00182,74.125.200.0-255,2902,211673,90,259333
13064,0.001822,172.31.47.0-255,66,211739,90,259333
13065,0.001842,74.125.200.0-255,2902,214641,90,259333
13066,0.001843,172.31.47.0-255,66,214707,90,259333
13067,0.00187,74.125.200.0-255,2902,217609,90,259333
13068,0.001878,172.31.47.0-255,66,217675,90,259333
13069,0.001881,74.125.200.0-255,1484,219159,90,259333
13070,0.001909,74.125.200.0-255,2902,222061,90,259333
13071,0.001912,172.31.47.0-255,66,222127,90,259333
13072,0.001915,74.125.200.0-255,1484,223611,90,259333
13073,0.00192,74.125.200.0-255,2902,226513,90,259333
13074,0.001922,172.31.47.0-255,66,226579,90,259333
13075,0.001968,74.125.200.0-255,5020,231599,90,259333
13076,0.001972,172.31.47.0-255,66,231665,90,259333
13077,0.002008,74.125.200.0-255,1484,233149,90,259333
13078,0.002013,74.125.200.0-255,2902,236051,90,259333
13079,0.002016,172.31.47.0-255,66,236117,90,259333
13080,0.003963,74.125.200.0-255,1484,237601,90,259333
13081,0.003993,74.125.200.0-255,4320,241921,90,259333
13082,0.003998,172.31.47.0-255,66,241987,90,259333
13083,0.005998,74.125.200.0-255,5738,247725,90,259333
13084,0.006005,172.31.47.0-255,66,247791,90,259333
13085,0.007995,74.125.200.0-255,5738,253529,90,259333
13086,0.007999,172.31.47.0-255,66,253595,90,259333
13087,0.009999,74.125.200.0-255,5738,259333,90,259333
13088,0.0,74.125.68.0-255,153,153,90,410029
13089,4.2e-05,172.31.47.0-255,66,219,90,410029
13090,5e-05,74.125.68.0-255,1484,1703,90,410029
13091,5.4e-05,172.31.47.0-255,66,1769,90,410029
13092,6e-05,74.125.68.0-255,2902,4671,90,410029
13093,6.5e-05,172.31.47.0-255,66,4737,90,410029
13094,7.4e-05,74.125.68.0-255,7156,11893,90,410029
13095,7.6e-05,172.31.47.0-255,66,11959,90,410029
13096,8e-05,74.125.68.0-255,2161,14120,90,410029
13097,8.4e-05,172.31.47.0-255,66,14186,90,410029
13098,0.000268,74.125.68.0-255,1484,15670,90,410029
13099,0.000273,172.31.47.0-255,66,15736,90,410029
13100,0.000281,74.125.68.0-255,2902,18638,90,410029
13101,0.000283,172.31.47.0-255,66,18704,90,410029
13102,0.000301,74.125.68.0-255,5738,24442,90,410029
13103,0.000304,172.31.47.0-255,66,24508,90,410029
13104,0.000336,74.125.68.0-255,6797,31305,90,410029
13105,0.000338,172.31.47.0-255,66,31371,90,410029
13106,0.000372,74.125.68.0-255,7156,38527,90,410029
13107,0.000376,172.31.47.0-255,66,38593,90,410029
13108,0.000387,74.125.68.0-255,8574,47167,90,410029
13109,0.000389,172.31.47.0-255,66,47233,90,410029
13110,0.000395,74.125.68.0-255,2902,50135,90,410029
13111,0.000397,172.31.47.0-255,66,50201,90,410029
13112,0.000421,74.125.68.0-255,7156,57357,90,410029
13113,0.000425,172.31.47.0-255,66,57423,90,410029
13114,0.000435,74.125.68.0-255,7856,65279,90,410029
13115,0.000438,172.31.47.0-255,66,65345,90,410029
13116,0.000755,74.125.68.0-255,398,65743,90,410029
13117,0.000759,172.31.47.0-255,66,65809,90,410029
13118,0.000847,74.125.68.0-255,1484,67293,90,410029
13119,0.00085,172.31.47.0-255,66,67359,90,410029
13120,0.000874,74.125.68.0-255,2902,70261,90,410029
13121,0.000897,74.125.68.0-255,4320,74581,90,410029
13122,0.000896,172.31.47.0-255,66,74647,90,410029
13123,0.000899,74.125.68.0-255,1484,76131,90,410029
13124,0.000902,172.31.47.0-255,66,76197,90,410029
13125,0.000924,74.125.68.0-255,4320,80517,90,410029
13126,0.000927,74.125.68.0-255,1484,82001,90,410029
13127,0.000931,172.31.47.0-255,66,82067,90,410029
13128,0.00095,74.125.68.0-255,5738,87805,90,410029
13129,0.000953,172.31.47.0-255,66,87871,90,410029
13130,0.000962,74.125.68.0-255,8574,96445,90,410029
13131,0.000967,172.31.47.0-255,66,96511,90,410029
13132,0.000994,74.125.68.0-255,3602,100113,90,410029
13133,0.001,74.125.68.0-255,4320,104433,90,410029
13134,0.001004,172.31.47.0-255,66,104499,90,410029
13135,0.001027,74.125.68.0-255,8574,113073,90,410029
13136,0.001031,172.31.47.0-255,66,113139,90,410029
13137,0.001038,74.125.68.0-255,1484,114623,90,410029
13138,0.001042,74.125.68.0-255,2242,116865,90,410029
13139,0.001055,172.31.47.0-255,66,116931,90,410029
13140,0.001225,74.125.68.0-255,1484,118415,90,410029
13141,0.001249,74.125.68.0-255,2902,121317,90,410029
13142,0.001252,172.31.47.0-255,66,121383,90,410029
13143,0.001259,74.125.68.0-255,4320,125703,90,410029
13144,0.001268,172.31.47.0-255,66,125769,90,410029
13145,0.001273,74.125.68.0-255,1484,127253,90,410029
13146,0.001296,74.125.68.0-255,4320,131573,90,410029
13147,0.001302,172.31.47.0-255,66,131639,90,410029
13148,0.001324,74.125.68.0-255,7156,138795,90,410029
13149,0.00133,172.31.47.0-255,66,138861,90,410029
13150,0.001363,74.125.68.0-255,8574,147435,90,410029
13151,0.001373,172.31.47.0-255,66,147501,90,410029
13152,0.00138,74.125.68.0-255,3602,151103,90,410029
13153,0.001387,172.31.47.0-255,66,151169,90,410029
13154,0.001874,74.125.68.0-255,1484,152653,90,410029
13155,0.0019,74.125.68.0-255,2902,155555,90,410029
13156,0.001904,172.31.47.0-255,66,155621,90,410029
13157,0.001909,74.125.68.0-255,1484,157105,90,410029
13158,0.001925,74.125.68.0-255,2902,160007,90,410029
13159,0.001946,74.125.68.0-255,4320,164327,90,410029
13160,0.001961,74.125.68.0-255,1484,165811,90,410029
13161,0.001985,74.125.68.0-255,7156,172967,90,410029
13162,0.002008,74.125.68.0-255,2902,175869,90,410029
13163,0.002027,74.125.68.0-255,4320,180189,90,410029
13164,0.002059,74.125.68.0-255,5020,185209,90,410029
13165,0.002195,74.125.68.0-255,1484,186693,90,410029
13166,0.002213,74.125.68.0-255,1484,188177,90,410029
13167,0.002223,74.125.68.0-255,1484,189661,90,410029
13168,0.002234,74.125.68.0-255,1484,191145,90,410029
13169,0.002254,74.125.68.0-255,4320,195465,90,410029
13170,0.002263,74.125.68.0-255,7156,202621,90,410029
13171,0.002292,74.125.68.0-255,4320,206941,90,410029
13172,0.002311,74.125.68.0-255,4320,211261,90,410029
13173,0.002316,74.125.68.0-255,2902,214163,90,410029
13174,0.002336,74.125.68.0-255,4320,218483,90,410029
13175,0.002339,74.125.68.0-255,766,219249,90,410029
13176,0.002569,74.125.68.0-255,1484,220733,90,410029
13177,0.002608,74.125.68.0-255,1484,222217,90,410029
13178,0.002628,74.125.68.0-255,2902,225119,90,410029
13179,0.002653,74.125.68.0-255,4320,229439,90,410029
13180,0.00267,74.125.68.0-255,1484,230923,90,410029
13181,0.002672,74.125.68.0-255,1484,232407,90,410029
13182,0.002688,74.125.68.0-255,2902,235309,90,410029
13183,0.002711,74.125.68.0-255,4320,239629,90,410029
13184,0.002726,74.125.68.0-255,1484,241113,90,410029
13185,0.002729,74.125.68.0-255,1484,242597,90,410029
13186,0.002731,74.125.68.0-255,1484,244081,90,410029
13187,0.002742,74.125.68.0-255,1484,245565,90,410029
13188,0.002755,74.125.68.0-255,2902,248467,90,410029
13189,0.002777,74.125.68.0-255,2902,251369,90,410029
13190,0.002785,74.125.68.0-255,2184,253553,90,410029
13191,0.003243,74.125.68.0-255,1484,255037,90,410029
13192,0.003262,74.125.68.0-255,2902,257939,90,410029
13193,0.003275,74.125.68.0-255,1484,259423,90,410029
13194,0.003279,74.125.68.0-255,1484,260907,90,410029
13195,0.003312,74.125.68.0-255,4320,265227,90,410029
13196,0.003327,74.125.68.0-255,2902,268129,90,410029
13197,0.003346,74.125.68.0-255,2902,271031,90,410029
13198,0.003362,74.125.68.0-255,1484,272515,90,410029
13199,0.003377,74.125.68.0-255,4320,276835,90,410029
13200,0.00338,74.125.68.0-255,1484,278319,90,410029
13201,0.003418,74.125.68.0-255,5738,284057,90,410029
13202,0.003431,74.125.68.0-255,1484,285541,90,410029
13203,0.003445,74.125.68.0-255,2184,287725,90,410029
13204,0.00347,74.125.68.0-255,1484,289209,90,410029
13205,0.003494,74.125.68.0-255,1484,290693,90,410029
13206,0.003509,74.125.68.0-255,1484,292177,90,410029
13207,0.00352,74.125.68.0-255,2902,295079,90,410029
13208,0.003528,74.125.68.0-255,1484,296563,90,410029
13209,0.003531,74.125.68.0-255,1484,298047,90,410029
13210,0.003546,74.125.68.0-255,1484,299531,90,410029
13211,0.003559,74.125.68.0-255,1484,301015,90,410029
13212,0.003575,74.125.68.0-255,2902,303917,90,410029
13213,0.003578,74.125.68.0-255,1484,305401,90,410029
13214,0.00358,74.125.68.0-255,1484,306885,90,410029
13215,0.003615,74.125.68.0-255,4320,311205,90,410029
13216,0.003629,74.125.68.0-255,2902,314107,90,410029
13217,0.003649,74.125.68.0-255,2902,317009,90,410029
13218,0.003663,74.125.68.0-255,1484,318493,90,410029
13219,0.003678,74.125.68.0-255,1484,319977,90,410029
13220,0.00369,74.125.68.0-255,2184,322161,90,410029
13221,0.003763,74.125.68.0-255,1484,323645,90,410029
13222,0.003785,74.125.68.0-255,2902,326547,90,410029
13223,0.003787,74.125.68.0-255,1484,328031,90,410029
13224,0.003801,74.125.68.0-255,2902,330933,90,410029
13225,0.003856,74.125.68.0-255,5738,336671,90,410029
13226,0.00386,74.125.68.0-255,2902,339573,90,410029
13227,0.003862,74.125.68.0-255,1484,341057,90,410029
13228,0.003867,74.125.68.0-255,4320,345377,90,410029
13229,0.00388,74.125.68.0-255,1484,346861,90,410029
13230,0.003898,74.125.68.0-255,2902,349763,90,410029
13231,0.003936,74.125.68.0-255,2902,352665,90,410029
13232,0.003948,74.125.68.0-255,2902,355567,90,410029
13233,0.00397,74.125.68.0-255,766,356333,90,410029
13234,0.00418,74.125.68.0-255,1484,357817,90,410029
13235,0.004192,74.125.68.0-255,2902,360719,90,410029
13236,0.00422,74.125.68.0-255,5738,366457,90,410029
13237,0.004244,74.125.68.0-255,2902,369359,90,410029
13238,0.00426,74.125.68.0-255,5738,375097,90,410029
13239,0.004281,74.125.68.0-255,2902,377999,90,410029
13240,0.004298,74.125.68.0-255,7156,385155,90,410029
13241,0.004301,74.125.68.0-255,2902,388057,90,410029
13242,0.004344,74.125.68.0-255,1484,389541,90,410029
13243,0.004363,74.125.68.0-255,3602,393143,90,410029
13244,0.004367,74.125.68.0-255,2902,396045,90,410029
13245,0.004383,74.125.68.0-255,2902,398947,90,410029
13246,0.004396,74.125.68.0-255,1484,400431,90,410029
13247,0.004408,74.125.68.0-255,2902,403333,90,410029
13248,0.004426,74.125.68.0-255,5738,409071,90,410029
13249,0.004438,74.125.68.0-255,682,409753,90,410029
13250,0.004526,74.125.68.0-255,105,409858,90,410029
13251,0.006298,172.31.47.0-255,66,409924,90,410029
13252,0.0086,172.31.47.0-255,105,410029,90,410029
13253,0.0,74.125.130.0-255,152,152,90,126174
13254,2.9e-05,172.31.47.0-255,66,218,90,126174
13255,3.4e-05,74.125.130.0-255,1484,1702,90,126174
13256,3.8e-05,172.31.47.0-255,66,1768,90,126174
13257,4.4e-05,74.125.130.0-255,2902,4670,90,126174
13258,4.7e-05,172.31.47.0-255,66,4736,90,126174
13259,7.2e-05,74.125.130.0-255,5738,10474,90,126174
13260,7.7e-05,172.31.47.0-255,66,10540,90,126174
13261,9.9e-05,74.125.130.0-255,3496,14036,90,126174
13262,0.000101,172.31.47.0-255,66,14102,90,126174
13263,0.000162,74.125.130.0-255,1484,15586,90,126174
13264,0.000168,172.31.47.0-255,66,15652,90,126174
13265,0.000173,74.125.130.0-255,2902,18554,90,126174
13266,0.000175,172.31.47.0-255,66,18620,90,126174
13267,0.000197,74.125.130.0-255,4320,22940,90,126174
13268,0.000201,172.31.47.0-255,66,23006,90,126174
13269,0.000247,74.125.130.0-255,8215,31221,90,126174
13270,0.00025,172.31.47.0-255,66,31287,90,126174
13271,0.000415,74.125.130.0-255,1484,32771,90,126174
13272,0.000419,172.31.47.0-255,66,32837,90,126174
13273,0.000425,74.125.130.0-255,2902,35739,90,126174
13274,0.000428,172.31.47.0-255,66,35805,90,126174
13275,0.000453,74.125.130.0-255,4320,40125,90,126174
13276,0.000457,172.31.47.0-255,66,40191,90,126174
13277,0.000484,74.125.130.0-255,5738,45929,90,126174
13278,0.000486,172.31.47.0-255,66,45995,90,126174
13279,0.000501,74.125.130.0-255,2543,48538,90,126174
13280,0.000503,172.31.47.0-255,66,48604,90,126174
13281,0.00051,74.125.130.0-255,8574,57178,90,126174
13282,0.000512,172.31.47.0-255,66,57244,90,126174
13283,0.000538,74.125.130.0-255,7156,64400,90,126174
13284,0.000541,172.31.47.0-255,66,64466,90,126174
13285,0.000557,74.125.130.0-255,1382,65848,90,126174
13286,0.000721,172.31.47.0-255,66,65914,90,126174
13287,0.000927,74.125.130.0-255,398,66312,90,126174
13288,0.001066,74.125.130.0-255,1484,67796,90,126174
13289,0.001072,172.31.47.0-255,66,67862,90,126174
13290,0.001078,74.125.130.0-255,2902,70764,90,126174
13291,0.001082,172.31.47.0-255,66,70830,90,126174
13292,0.0011,74.125.130.0-255,1484,72314,90,126174
13293,0.001103,74.125.130.0-255,1484,73798,90,126174
13294,0.001105,172.31.47.0-255,66,73864,90,126174
13295,0.001121,74.125.130.0-255,1484,75348,90,126174
13296,0.001127,74.125.130.0-255,5738,81086,90,126174
13297,0.001129,172.31.47.0-255,66,81152,90,126174
13298,0.001145,74.125.130.0-255,2543,83695,90,126174
13299,0.001147,172.31.47.0-255,66,83761,90,126174
13300,0.001234,74.125.130.0-255,1484,85245,90,126174
13301,0.00124,74.125.130.0-255,1484,86729,90,126174
13302,0.001243,172.31.47.0-255,66,86795,90,126174
13303,0.00126,74.125.130.0-255,1484,88279,90,126174
13304,0.001265,74.125.130.0-255,2902,91181,90,126174
13305,0.001267,172.31.47.0-255,66,91247,90,126174
13306,0.001284,74.125.130.0-255,2902,94149,90,126174
13307,0.001286,172.31.47.0-255,66,94215,90,126174
13308,0.001291,74.125.130.0-255,2902,97117,90,126174
13309,0.001293,172.31.47.0-255,66,97183,90,126174
13310,0.00131,74.125.130.0-255,3961,101144,90,126174
13311,0.001312,172.31.47.0-255,66,101210,90,126174
13312,0.002283,74.125.130.0-255,1484,102694,90,126174
13313,0.002297,74.125.130.0-255,1484,104178,90,126174
13314,0.002299,172.31.47.0-255,66,104244,90,126174
13315,0.002309,74.125.130.0-255,1484,105728,90,126174
13316,0.002313,74.125.130.0-255,2902,108630,90,126174
13317,0.002315,172.31.47.0-255,66,108696,90,126174
13318,0.004592,74.125.130.0-255,1484,110180,90,126174
13319,0.004629,74.125.130.0-255,4320,114500,90,126174
13320,0.004632,172.31.47.0-255,66,114566,90,126174
13321,0.006924,74.125.130.0-255,5738,120304,90,126174
13322,0.006929,172.31.47.0-255,66,120370,90,126174
13323,0.009285,74.125.130.0-255,5738,126108,90,126174
13324,0.009292,172.31.47.0-255,66,126174,90,126174
13325,0.0,172.31.47.0-255,105,105,90,105
13326,0.0,172.31.47.0-255,66,66,90,66
13327,0.0,172.217.194.0-255,153,153,90,41346
13328,3.3e-05,172.31.47.0-255,66,219,90,41346
13329,4.1e-05,172.217.194.0-255,1484,1703,90,41346
13330,4.5e-05,172.31.47.0-255,66,1769,90,41346
13331,5e-05,172.217.194.0-255,2902,4671,90,41346
13332,6.1e-05,172.31.47.0-255,66,4737,90,41346
13333,6.8e-05,172.217.194.0-255,5738,10475,90,41346
13334,7.1e-05,172.31.47.0-255,66,10541,90,41346
13335,0.000114,172.31.47.0-255,66,10607,90,41346
13336,0.000122,172.217.194.0-255,6797,17404,90,41346
13337,0.000125,172.31.47.0-255,66,17470,90,41346
13338,0.002644,172.217.194.0-255,1484,18954,90,41346
13339,0.002652,172.31.47.0-255,66,19020,90,41346
13340,0.002662,172.217.194.0-255,2902,21922,90,41346
13341,0.002664,172.31.47.0-255,66,21988,90,41346
13342,0.002673,172.217.194.0-255,1484,23472,90,41346
13343,0.002675,172.31.47.0-255,66,23538,90,41346
13344,0.00498,172.217.194.0-255,4320,27858,90,41346
13345,0.004986,172.31.47.0-255,66,27924,90,41346
13346,0.005023,172.217.194.0-255,1484,29408,90,41346
13347,0.005026,172.31.47.0-255,66,29474,90,41346
13348,0.007322,172.217.194.0-255,4320,33794,90,41346
13349,0.00733,172.31.47.0-255,66,33860,90,41346
13350,0.007362,172.217.194.0-255,1484,35344,90,41346
13351,0.007365,172.31.47.0-255,66,35410,90,41346
13352,0.009677,172.217.194.0-255,4320,39730,90,41346
13353,0.009689,172.31.47.0-255,66,39796,90,41346
13354,0.009722,172.217.194.0-255,1484,41280,90,41346
13355,0.009726,172.31.47.0-255,66,41346,90,41346
13356,0.0,172.31.47.0-255,105,105,90,105
13357,0.0,74.125.24.0-255,153,153,90,279884
13358,1.5e-05,172.31.47.0-255,66,219,90,279884
13359,2.1e-05,74.125.24.0-255,1484,1703,90,279884
13360,2.4e-05,172.31.47.0-255,66,1769,90,279884
13361,3e-05,74.125.24.0-255,2902,4671,90,279884
13362,3.3e-05,172.31.47.0-255,66,4737,90,279884
13363,3.8e-05,74.125.24.0-255,2902,7639,90,279884
13364,4e-05,172.31.47.0-255,66,7705,90,279884
13365,6e-05,74.125.24.0-255,4320,12025,90,279884
13366,6.3e-05,172.31.47.0-255,66,12091,90,279884
13367,6.6e-05,74.125.24.0-255,1484,13575,90,279884
13368,6.7e-05,172.31.47.0-255,66,13641,90,279884
13369,8.7e-05,74.125.24.0-255,627,14268,90,279884
13370,9e-05,172.31.47.0-255,66,14334,90,279884
13371,0.000212,74.125.24.0-255,1484,15818,90,279884
13372,0.000216,172.31.47.0-255,66,15884,90,279884
13373,0.000219,74.125.24.0-255,1484,17368,90,279884
13374,0.000222,172.31.47.0-255,66,17434,90,279884
13375,0.000235,74.125.24.0-255,1484,18918,90,279884
13376,0.00024,172.31.47.0-255,66,18984,90,279884
13377,0.000257,74.125.24.0-255,5738,24722,90,279884
13378,0.000261,172.31.47.0-255,66,24788,90,279884
13379,0.000269,74.125.24.0-255,6797,31585,90,279884
13380,0.000271,172.31.47.0-255,66,31651,90,279884
13381,0.000302,74.125.24.0-255,4320,35971,90,279884
13382,0.000305,172.31.47.0-255,66,36037,90,279884
13383,0.000333,74.125.24.0-255,9992,46029,90,279884
13384,0.000336,74.125.24.0-255,2543,48572,90,279884
13385,0.000338,172.31.47.0-255,66,48638,90,279884
13386,0.000341,172.31.47.0-255,66,48704,90,279884
13387,0.000574,74.125.24.0-255,1484,50188,90,279884
13388,0.000579,172.31.47.0-255,66,50254,90,279884
13389,0.000584,74.125.24.0-255,2902,53156,90,279884
13390,0.000587,172.31.47.0-255,66,53222,90,279884
13391,0.000611,74.125.24.0-255,5738,58960,90,279884
13392,0.000614,172.31.47.0-255,66,59026,90,279884
13393,0.000617,74.125.24.0-255,1484,60510,90,279884
13394,0.000635,74.125.24.0-255,4320,64830,90,279884
13395,0.000639,172.31.47.0-255,66,64896,90,279884
13396,0.00067,74.125.24.0-255,1704,66600,90,279884
13397,0.000673,172.31.47.0-255,66,66666,90,279884
13398,0.00069,74.125.24.0-255,2902,69568,90,279884
13399,0.000692,172.31.47.0-255,66,69634,90,279884
13400,0.000718,74.125.24.0-255,7156,76790,90,279884
13401,0.000721,172.31.47.0-255,66,76856,90,279884
13402,0.000726,74.125.24.0-255,2902,79758,90,279884
13403,0.000728,172.31.47.0-255,66,79824,90,279884
13404,0.000744,74.125.24.0-255,4320,84144,90,279884
13405,0.000747,172.31.47.0-255,66,84210,90,279884
13406,0.000761,74.125.24.0-255,2902,87112,90,279884
13407,0.000764,172.31.47.0-255,66,87178,90,279884
13408,0.000799,172.31.47.0-255,66,87244,90,279884
13409,0.000802,74.125.24.0-255,766,88010,90,279884
13410,0.00089,74.125.24.0-255,1484,89494,90,279884
13411,0.000894,172.31.47.0-255,66,89560,90,279884
13412,0.000912,74.125.24.0-255,2902,92462,90,279884
13413,0.000915,172.31.47.0-255,66,92528,90,279884
13414,0.000922,74.125.24.0-255,5738,98266,90,279884
13415,0.000924,172.31.47.0-255,66,98332,90,279884
13416,0.000944,74.125.24.0-255,5738,104070,90,279884
13417,0.000947,172.31.47.0-255,66,104136,90,279884
13418,0.000964,74.125.24.0-255,7156,111292,90,279884
13419,0.000969,172.31.47.0-255,66,111358,90,279884
13420,0.000972,74.125.24.0-255,8574,119932,90,279884
13421,0.000974,172.31.47.0-255,66,119998,90,279884
13422,0.001024,74.125.24.0-255,2184,122182,90,279884
13423,0.001028,74.125.24.0-255,2902,125084,90,279884
13424,0.001028,172.31.47.0-255,66,125150,90,279884
13425,0.001031,172.31.47.0-255,66,125216,90,279884
13426,0.001039,74.125.24.0-255,1484,126700,90,279884
13427,0.001071,74.125.24.0-255,5738,132438,90,279884
13428,0.001076,172.31.47.0-255,66,132504,90,279884
13429,0.001082,74.125.24.0-255,7156,139660,90,279884
13430,0.001085,172.31.47.0-255,66,139726,90,279884
13431,0.001103,74.125.24.0-255,4320,144046,90,279884
13432,0.001107,172.31.47.0-255,66,144112,90,279884
13433,0.001144,172.31.47.0-255,66,144178,90,279884
13434,0.001147,74.125.24.0-255,766,144944,90,279884
13435,0.001162,74.125.24.0-255,2902,147846,90,279884
13436,0.001165,172.31.47.0-255,66,147912,90,279884
13437,0.001185,74.125.24.0-255,4320,152232,90,279884
13438,0.001188,172.31.47.0-255,66,152298,90,279884
13439,0.001196,74.125.24.0-255,8574,160872,90,279884
13440,0.001198,172.31.47.0-255,66,160938,90,279884
13441,0.001201,74.125.24.0-255,1484,162422,90,279884
13442,0.001243,172.31.47.0-255,66,162488,90,279884
13443,0.001246,74.125.24.0-255,766,163254,90,279884
13444,0.001589,74.125.24.0-255,1484,164738,90,279884
13445,0.001593,172.31.47.0-255,66,164804,90,279884
13446,0.001598,74.125.24.0-255,2902,167706,90,279884
13447,0.0016,172.31.47.0-255,66,167772,90,279884
13448,0.001606,74.125.24.0-255,4320,172092,90,279884
13449,0.001608,172.31.47.0-255,66,172158,90,279884
13450,0.00163,74.125.24.0-255,1484,173642,90,279884
13451,0.001637,74.125.24.0-255,5738,179380,90,279884
13452,0.001658,172.31.47.0-255,66,179446,90,279884
13453,0.00168,74.125.24.0-255,7156,186602,90,279884
13454,0.001684,172.31.47.0-255,66,186668,90,279884
13455,0.001693,74.125.24.0-255,10692,197360,90,279884
13456,0.001695,172.31.47.0-255,66,197426,90,279884
13457,0.001744,74.125.24.0-255,1484,198910,90,279884
13458,0.001766,74.125.24.0-255,2902,201812,90,279884
13459,0.001771,172.31.47.0-255,66,201878,90,279884
13460,0.00178,74.125.24.0-255,5738,207616,90,279884
13461,0.001782,172.31.47.0-255,66,207682,90,279884
13462,0.001786,74.125.24.0-255,2902,210584,90,279884
13463,0.00179,172.31.47.0-255,66,210650,90,279884
13464,0.001823,74.125.24.0-255,9992,220642,90,279884
13465,0.001827,172.31.47.0-255,66,220708,90,279884
13466,0.001835,74.125.24.0-255,9992,230700,90,279884
13467,0.001838,172.31.47.0-255,66,230766,90,279884
13468,0.001866,74.125.24.0-255,9992,240758,90,279884
13469,0.00187,172.31.47.0-255,66,240824,90,279884
13470,0.001909,172.31.47.0-255,66,240890,90,279884
13471,0.001918,74.125.24.0-255,10692,251582,90,279884
13472,0.001921,172.31.47.0-255,66,251648,90,279884
13473,0.001998,172.31.47.0-255,66,251714,90,279884
13474,0.002023,74.125.24.0-255,10692,262406,90,279884
13475,0.002027,172.31.47.0-255,66,262472,90,279884
13476,0.004085,74.125.24.0-255,5738,268210,90,279884
13477,0.004091,172.31.47.0-255,66,268276,90,279884
13478,0.006175,74.125.24.0-255,5738,274014,90,279884
13479,0.00618,172.31.47.0-255,66,274080,90,279884
13480,0.008252,74.125.24.0-255,5738,279818,90,279884
13481,0.008258,172.31.47.0-255,66,279884,90,279884
13482,0.0,172.217.194.0-255,143,143,90,231162
13483,3.5e-05,172.31.47.0-255,66,209,90,231162
13484,4.2e-05,172.217.194.0-255,1484,1693,90,231162
13485,4.7e-05,172.31.47.0-255,66,1759,90,231162
13486,5.2e-05,172.217.194.0-255,2902,4661,90,231162
13487,5.5e-05,172.31.47.0-255,66,4727,90,231162
13488,6.2e-05,172.217.194.0-255,7156,11883,90,231162
13489,6.4e-05,172.31.47.0-255,66,11949,90,231162
13490,6.9e-05,172.217.194.0-255,3395,15344,90,231162
13491,7.1e-05,172.31.47.0-255,66,15410,90,231162
13492,7.7e-05,172.217.194.0-255,5738,21148,90,231162
13493,8e-05,172.31.47.0-255,66,21214,90,231162
13494,0.000101,172.217.194.0-255,7156,28370,90,231162
13495,0.000104,172.31.47.0-255,66,28436,90,231162
13496,0.000108,172.217.194.0-255,2543,30979,90,231162
13497,0.00011,172.31.47.0-255,66,31045,90,231162
13498,0.000157,172.217.194.0-255,1484,32529,90,231162
13499,0.000161,172.31.47.0-255,66,32595,90,231162
13500,0.000166,172.217.194.0-255,2902,35497,90,231162
13501,0.000168,172.31.47.0-255,66,35563,90,231162
13502,0.000188,172.217.194.0-255,5738,41301,90,231162
13503,0.000192,172.31.47.0-255,66,41367,90,231162
13504,0.000227,172.217.194.0-255,8215,49582,90,231162
13505,0.000231,172.31.47.0-255,66,49648,90,231162
13506,0.00024,172.217.194.0-255,8574,58222,90,231162
13507,0.000242,172.31.47.0-255,66,58288,90,231162
13508,0.000262,172.217.194.0-255,6797,65085,90,231162
13509,0.000265,172.31.47.0-255,66,65151,90,231162
13510,0.000268,172.217.194.0-255,378,65529,90,231162
13511,0.00027,172.31.47.0-255,66,65595,90,231162
13512,0.000424,172.217.194.0-255,367,65962,90,231162
13513,0.000431,172.31.47.0-255,66,66028,90,231162
13514,0.000558,172.217.194.0-255,1484,67512,90,231162
13515,0.000565,172.217.194.0-255,2902,70414,90,231162
13516,0.000569,172.31.47.0-255,66,70480,90,231162
13517,0.000577,172.217.194.0-255,5738,76218,90,231162
13518,0.000579,172.31.47.0-255,66,76284,90,231162
13519,0.000629,172.31.47.0-255,66,76350,90,231162
13520,0.000633,172.217.194.0-255,10692,87042,90,231162
13521,0.000636,172.31.47.0-255,66,87108,90,231162
13522,0.000936,172.217.194.0-255,1484,88592,90,231162
13523,0.000942,172.217.194.0-255,2902,91494,90,231162
13524,0.000948,172.217.194.0-255,4320,95814,90,231162
13525,0.000949,172.31.47.0-255,66,95880,90,231162
13526,0.000954,172.31.47.0-255,66,95946,90,231162
13527,0.000963,172.217.194.0-255,1484,97430,90,231162
13528,0.000971,172.217.194.0-255,7156,104586,90,231162
13529,0.000974,172.31.47.0-255,66,104652,90,231162
13530,0.000979,172.217.194.0-255,2902,107554,90,231162
13531,0.000981,172.31.47.0-255,66,107620,90,231162
13532,0.001017,172.31.47.0-255,66,107686,90,231162
13533,0.001021,172.217.194.0-255,2184,109870,90,231162
13534,0.001024,172.31.47.0-255,66,109936,90,231162
13535,0.001593,172.217.194.0-255,1484,111420,90,231162
13536,0.001615,172.217.194.0-255,2902,114322,90,231162
13537,0.00162,172.31.47.0-255,66,114388,90,231162
13538,0.001627,172.217.194.0-255,5738,120126,90,231162
13539,0.001629,172.31.47.0-255,66,120192,90,231162
13540,0.001638,172.217.194.0-255,9992,130184,90,231162
13541,0.00164,172.31.47.0-255,66,130250,90,231162
13542,0.001652,172.31.47.0-255,66,130316,90,231162
13543,0.001716,172.217.194.0-255,5020,135336,90,231162
13544,0.001719,172.31.47.0-255,66,135402,90,231162
13545,0.001725,172.217.194.0-255,5738,141140,90,231162
13546,0.001727,172.31.47.0-255,66,141206,90,231162
13547,0.001738,172.31.47.0-255,66,141272,90,231162
13548,0.001749,172.31.47.0-255,66,141338,90,231162
13549,0.001779,172.217.194.0-255,4320,145658,90,231162
13550,0.001785,172.31.47.0-255,66,145724,90,231162
13551,0.001815,172.31.47.0-255,66,145790,90,231162
13552,0.001828,172.217.194.0-255,766,146556,90,231162
13553,0.001829,172.31.47.0-255,66,146622,90,231162
13554,0.001888,172.217.194.0-255,1484,148106,90,231162
13555,0.001891,172.31.47.0-255,66,148172,90,231162
13556,0.001896,172.217.194.0-255,2902,151074,90,231162
13557,0.001897,172.31.47.0-255,66,151140,90,231162
13558,0.0019,172.217.194.0-255,1484,152624,90,231162
13559,0.001915,172.217.194.0-255,4320,156944,90,231162
13560,0.001918,172.31.47.0-255,66,157010,90,231162
13561,0.001936,172.217.194.0-255,7156,164166,90,231162
13562,0.00194,172.31.47.0-255,66,164232,90,231162
13563,0.001963,172.217.194.0-255,5738,169970,90,231162
13564,0.001966,172.31.47.0-255,66,170036,90,231162
13565,0.001996,172.217.194.0-255,10692,180728,90,231162
13566,0.001999,172.31.47.0-255,66,180794,90,231162
13567,0.002035,172.217.194.0-255,8574,189368,90,231162
13568,0.002039,172.31.47.0-255,66,189434,90,231162
13569,0.002043,172.217.194.0-255,2902,192336,90,231162
13570,0.002045,172.31.47.0-255,66,192402,90,231162
13571,0.002063,172.217.194.0-255,7156,199558,90,231162
13572,0.002066,172.31.47.0-255,66,199624,90,231162
13573,0.002101,172.31.47.0-255,66,199690,90,231162
13574,0.00212,172.217.194.0-255,2184,201874,90,231162
13575,0.002125,172.31.47.0-255,66,201940,90,231162
13576,0.002133,172.31.47.0-255,66,202006,90,231162
13577,0.002138,172.217.194.0-255,5738,207744,90,231162
13578,0.00214,172.31.47.0-255,66,207810,90,231162
13579,0.002169,172.217.194.0-255,9992,217802,90,231162
13580,0.002173,172.31.47.0-255,66,217868,90,231162
13581,0.002196,172.217.194.0-255,5738,223606,90,231162
13582,0.002199,172.31.47.0-255,66,223672,90,231162
13583,0.00224,172.31.47.0-255,66,223738,90,231162
13584,0.002278,172.217.194.0-255,2902,226640,90,231162
13585,0.002281,172.31.47.0-255,66,226706,90,231162
13586,0.002318,172.31.47.0-255,66,226772,90,231162
13587,0.002323,172.217.194.0-255,4219,230991,90,231162
13588,0.002325,172.31.47.0-255,66,231057,90,231162
13589,0.004568,172.217.194.0-255,105,231162,90,231162
13590,0.0,172.217.194.0-255,153,153,90,208718
13591,2.4e-05,172.31.47.0-255,66,219,90,208718
13592,3.1e-05,172.217.194.0-255,1484,1703,90,208718
13593,3.6e-05,172.31.47.0-255,66,1769,90,208718
13594,4e-05,172.217.194.0-255,2902,4671,90,208718
13595,4.4e-05,172.31.47.0-255,66,4737,90,208718
13596,5.9e-05,172.217.194.0-255,5738,10475,90,208718
13597,6.2e-05,172.31.47.0-255,66,10541,90,208718
13598,9.5e-05,172.217.194.0-255,3546,14087,90,208718
13599,9.8e-05,172.31.47.0-255,66,14153,90,208718
13600,0.000145,172.217.194.0-255,1484,15637,90,208718
13601,0.00015,172.31.47.0-255,66,15703,90,208718
13602,0.000156,172.217.194.0-255,2902,18605,90,208718
13603,0.000158,172.31.47.0-255,66,18671,90,208718
13604,0.000202,172.217.194.0-255,2902,21573,90,208718
13605,0.000205,172.31.47.0-255,66,21639,90,208718
13606,0.000211,172.217.194.0-255,4320,25959,90,208718
13607,0.000213,172.31.47.0-255,66,26025,90,208718
13608,0.000235,172.217.194.0-255,5379,31404,90,208718
13609,0.000238,172.31.47.0-255,66,31470,90,208718
13610,0.000279,172.217.194.0-255,1484,32954,90,208718
13611,0.000282,172.31.47.0-255,66,33020,90,208718
13612,0.000288,172.217.194.0-255,2902,35922,90,208718
13613,0.00029,172.31.47.0-255,66,35988,90,208718
13614,0.00031,172.217.194.0-255,5738,41726,90,208718
13615,0.000317,172.31.47.0-255,66,41792,90,208718
13616,0.000359,172.31.47.0-255,66,41858,90,208718
13617,0.000387,172.217.194.0-255,5738,47596,90,208718
13618,0.000389,172.31.47.0-255,66,47662,90,208718
13619,0.000415,172.217.194.0-255,5379,53041,90,208718
13620,0.000418,172.31.47.0-255,66,53107,90,208718
13621,0.000789,172.217.194.0-255,645,53752,90,208718
13622,0.000795,172.31.47.0-255,66,53818,90,208718
13623,0.000897,172.217.194.0-255,1484,55302,90,208718
13624,0.000903,172.31.47.0-255,66,55368,90,208718
13625,0.000909,172.217.194.0-255,2902,58270,90,208718
13626,0.000911,172.31.47.0-255,66,58336,90,208718
13627,0.000947,172.217.194.0-255,5738,64074,90,208718
13628,0.000952,172.31.47.0-255,66,64140,90,208718
13629,0.000957,172.217.194.0-255,4320,68460,90,208718
13630,0.000959,172.31.47.0-255,66,68526,90,208718
13631,0.001,172.31.47.0-255,66,68592,90,208718
13632,0.001008,172.217.194.0-255,7156,75748,90,208718
13633,0.00101,172.31.47.0-255,66,75814,90,208718
13634,0.001022,172.217.194.0-255,766,76580,90,208718
13635,0.001025,172.31.47.0-255,66,76646,90,208718
13636,0.001166,172.217.194.0-255,1484,78130,90,208718
13637,0.001172,172.31.47.0-255,66,78196,90,208718
13638,0.001184,172.217.194.0-255,2902,81098,90,208718
13639,0.001188,172.31.47.0-255,66,81164,90,208718
13640,0.001197,172.217.194.0-255,1484,82648,90,208718
13641,0.001199,172.31.47.0-255,66,82714,90,208718
13642,0.001232,172.217.194.0-255,4320,87034,90,208718
13643,0.001236,172.31.47.0-255,66,87100,90,208718
13644,0.001248,172.31.47.0-255,66,87166,90,208718
13645,0.001254,172.217.194.0-255,5738,92904,90,208718
13646,0.001258,172.31.47.0-255,66,92970,90,208718
13647,0.001307,172.217.194.0-255,5020,97990,90,208718
13648,0.00131,172.31.47.0-255,66,98056,90,208718
13649,0.001595,172.217.194.0-255,1484,99540,90,208718
13650,0.001602,172.31.47.0-255,66,99606,90,208718
13651,0.001615,172.217.194.0-255,2902,102508,90,208718
13652,0.001618,172.31.47.0-255,66,102574,90,208718
13653,0.001627,172.217.194.0-255,5738,108312,90,208718
13654,0.001629,172.31.47.0-255,66,108378,90,208718
13655,0.001677,172.217.194.0-255,7156,115534,90,208718
13656,0.00168,172.31.47.0-255,66,115600,90,208718
13657,0.001688,172.217.194.0-255,8574,124174,90,208718
13658,0.00169,172.31.47.0-255,66,124240,90,208718
13659,0.001716,172.217.194.0-255,7856,132096,90,208718
13660,0.00172,172.31.47.0-255,66,132162,90,208718
13661,0.001768,172.217.194.0-255,1484,133646,90,208718
13662,0.001772,172.31.47.0-255,66,133712,90,208718
13663,0.001776,172.217.194.0-255,2902,136614,90,208718
13664,0.001779,172.31.47.0-255,66,136680,90,208718
13665,0.001797,172.217.194.0-255,1484,138164,90,208718
13666,0.0018,172.31.47.0-255,66,138230,90,208718
13667,0.001816,172.217.194.0-255,4320,142550,90,208718
13668,0.001818,172.31.47.0-255,66,142616,90,208718
13669,0.001853,172.217.194.0-255,1484,144100,90,208718
13670,0.001855,172.31.47.0-255,66,144166,90,208718
13671,0.001891,172.217.194.0-255,8574,152740,90,208718
13672,0.001902,172.217.194.0-255,2184,154924,90,208718
13673,0.001906,172.31.47.0-255,66,154990,90,208718
13674,0.001909,172.31.47.0-255,66,155056,90,208718
13675,0.001911,172.31.47.0-255,66,155122,90,208718
13676,0.001963,172.217.194.0-255,1484,156606,90,208718
13677,0.001967,172.217.194.0-255,1484,158090,90,208718
13678,0.001975,172.31.47.0-255,66,158156,90,208718
13679,0.001981,172.31.47.0-255,66,158222,90,208718
13680,0.001985,172.217.194.0-255,1484,159706,90,208718
13681,0.001987,172.31.47.0-255,66,159772,90,208718
13682,0.001992,172.217.194.0-255,4320,164092,90,208718
13683,0.001998,172.31.47.0-255,66,164158,90,208718
13684,0.002021,172.217.194.0-255,1484,165642,90,208718
13685,0.002023,172.31.47.0-255,66,165708,90,208718
13686,0.002028,172.217.194.0-255,4320,170028,90,208718
13687,0.00203,172.31.47.0-255,66,170094,90,208718
13688,0.002036,172.217.194.0-255,5738,175832,90,208718
13689,0.002041,172.217.194.0-255,1484,177316,90,208718
13690,0.002046,172.31.47.0-255,66,177382,90,208718
13691,0.002048,172.31.47.0-255,66,177448,90,208718
13692,0.002083,172.217.194.0-255,9992,187440,90,208718
13693,0.002086,172.31.47.0-255,66,187506,90,208718
13694,0.00209,172.217.194.0-255,2184,189690,90,208718
13695,0.002092,172.31.47.0-255,66,189756,90,208718
13696,0.002113,172.217.194.0-255,1484,191240,90,208718
13697,0.002116,172.31.47.0-255,66,191306,90,208718
13698,0.004188,172.217.194.0-255,5738,197044,90,208718
13699,0.004195,172.31.47.0-255,66,197110,90,208718
13700,0.006284,172.217.194.0-255,5738,202848,90,208718
13701,0.006291,172.31.47.0-255,66,202914,90,208718
13702,0.008368,172.217.194.0-255,5738,208652,90,208718
13703,0.008376,172.31.47.0-255,66,208718,90,208718
13704,0.0,74.125.24.0-255,156,156,90,285097
13705,3.1e-05,172.31.47.0-255,66,222,90,285097
13706,3.8e-05,74.125.24.0-255,1484,1706,90,285097
13707,4.2e-05,172.31.47.0-255,66,1772,90,285097
13708,6.7e-05,74.125.24.0-255,2902,4674,90,285097
13709,7e-05,172.31.47.0-255,66,4740,90,285097
13710,7.6e-05,74.125.24.0-255,4320,9060,90,285097
13711,7.8e-05,172.31.47.0-255,66,9126,90,285097
13712,0.000108,74.125.24.0-255,4320,13446,90,285097
13713,0.000111,172.31.47.0-255,66,13512,90,285097
13714,0.000117,74.125.24.0-255,4848,18360,90,285097
13715,0.000119,172.31.47.0-255,66,18426,90,285097
13716,0.000153,172.31.47.0-255,66,18492,90,285097
13717,0.000178,74.125.24.0-255,1125,19617,90,285097
13718,0.000181,172.31.47.0-255,66,19683,90,285097
13719,0.000305,74.125.24.0-255,1484,21167,90,285097
13720,0.000309,172.31.47.0-255,66,21233,90,285097
13721,0.00032,74.125.24.0-255,2902,24135,90,285097
13722,0.000327,172.31.47.0-255,66,24201,90,285097
13723,0.000352,74.125.24.0-255,4320,28521,90,285097
13724,0.000355,172.31.47.0-255,66,28587,90,285097
13725,0.000383,74.125.24.0-255,5738,34325,90,285097
13726,0.000386,172.31.47.0-255,66,34391,90,285097
13727,0.00039,74.125.24.0-255,2543,36934,90,285097
13728,0.000392,172.31.47.0-255,66,37000,90,285097
13729,0.000499,74.125.24.0-255,1484,38484,90,285097
13730,0.000503,172.31.47.0-255,66,38550,90,285097
13731,0.00052,74.125.24.0-255,2902,41452,90,285097
13732,0.000524,172.31.47.0-255,66,41518,90,285097
13733,0.000551,74.125.24.0-255,5738,47256,90,285097
13734,0.000554,172.31.47.0-255,66,47322,90,285097
13735,0.000557,74.125.24.0-255,2902,50224,90,285097
13736,0.000559,172.31.47.0-255,66,50290,90,285097
13737,0.0006,74.125.24.0-255,4258,54548,90,285097
13738,0.000602,172.31.47.0-255,66,54614,90,285097
13739,0.000914,74.125.24.0-255,132,54746,90,285097
13740,0.000975,74.125.24.0-255,1484,56230,90,285097
13741,0.000979,172.31.47.0-255,66,56296,90,285097
13742,0.000985,74.125.24.0-255,2902,59198,90,285097
13743,0.000987,172.31.47.0-255,66,59264,90,285097
13744,0.001007,74.125.24.0-255,4320,63584,90,285097
13745,0.001009,172.31.47.0-255,66,63650,90,285097
13746,0.001029,74.125.24.0-255,2902,66552,90,285097
13747,0.001031,172.31.47.0-255,66,66618,90,285097
13748,0.001048,74.125.24.0-255,2902,69520,90,285097
13749,0.00105,172.31.47.0-255,66,69586,90,285097
13750,0.001065,74.125.24.0-255,8574,78160,90,285097
13751,0.001067,172.31.47.0-255,66,78226,90,285097
13752,0.001075,74.125.24.0-255,2902,81128,90,285097
13753,0.001077,172.31.47.0-255,66,81194,90,285097
13754,0.001103,74.125.24.0-255,4320,85514,90,285097
13755,0.001105,172.31.47.0-255,66,85580,90,285097
13756,0.001139,74.125.24.0-255,3602,89182,90,285097
13757,0.001142,172.31.47.0-255,66,89248,90,285097
13758,0.001211,74.125.24.0-255,347,89595,90,285097
13759,0.001243,74.125.24.0-255,1484,91079,90,285097
13760,0.001245,172.31.47.0-255,66,91145,90,285097
13761,0.001273,74.125.24.0-255,4320,95465,90,285097
13762,0.001275,172.31.47.0-255,66,95531,90,285097
13763,0.001279,74.125.24.0-255,2902,98433,90,285097
13764,0.001281,172.31.47.0-255,66,98499,90,285097
13765,0.001288,74.125.24.0-255,8574,107073,90,285097
13766,0.00129,172.31.47.0-255,66,107139,90,285097
13767,0.001351,172.31.47.0-255,66,107205,90,285097
13768,0.001367,74.125.24.0-255,2184,109389,90,285097
13769,0.001369,172.31.47.0-255,66,109455,90,285097
13770,0.001389,74.125.24.0-255,2902,112357,90,285097
13771,0.001391,172.31.47.0-255,66,112423,90,285097
13772,0.00141,74.125.24.0-255,5738,118161,90,285097
13773,0.001412,172.31.47.0-255,66,118227,90,285097
13774,0.001436,74.125.24.0-255,7156,125383,90,285097
13775,0.001438,172.31.47.0-255,66,125449,90,285097
13776,0.001466,74.125.24.0-255,9992,135441,90,285097
13777,0.001468,172.31.47.0-255,66,135507,90,285097
13778,0.001491,74.125.24.0-255,4320,139827,90,285097
13779,0.001493,172.31.47.0-255,66,139893,90,285097
13780,0.001497,74.125.24.0-255,2902,142795,90,285097
13781,0.001498,172.31.47.0-255,66,142861,90,285097
13782,0.0015,74.125.24.0-255,766,143627,90,285097
13783,0.001702,74.125.24.0-255,1484,145111,90,285097
13784,0.001704,172.31.47.0-255,66,145177,90,285097
13785,0.001707,74.125.24.0-255,1484,146661,90,285097
13786,0.001725,74.125.24.0-255,1484,148145,90,285097
13787,0.001726,172.31.47.0-255,66,148211,90,285097
13788,0.001738,74.125.24.0-255,2902,151113,90,285097
13789,0.001743,172.31.47.0-255,66,151179,90,285097
13790,0.001767,74.125.24.0-255,2902,154081,90,285097
13791,0.001769,172.31.47.0-255,66,154147,90,285097
13792,0.001777,74.125.24.0-255,1484,155631,90,285097
13793,0.001804,74.125.24.0-255,9992,165623,90,285097
13794,0.001806,172.31.47.0-255,66,165689,90,285097
13795,0.001817,172.31.47.0-255,66,165755,90,285097
13796,0.00186,74.125.24.0-255,1484,167239,90,285097
13797,0.001869,74.125.24.0-255,2902,170141,90,285097
13798,0.001871,172.31.47.0-255,66,170207,90,285097
13799,0.001896,74.125.24.0-255,5738,175945,90,285097
13800,0.001898,172.31.47.0-255,66,176011,90,285097
13801,0.001917,74.125.24.0-255,1484,177495,90,285097
13802,0.001943,172.31.47.0-255,66,177561,90,285097
13803,0.001991,74.125.24.0-255,5738,183299,90,285097
13804,0.001993,172.31.47.0-255,66,183365,90,285097
13805,0.002019,74.125.24.0-255,5020,188385,90,285097
13806,0.002021,172.31.47.0-255,66,188451,90,285097
13807,0.002027,74.125.24.0-255,7156,195607,90,285097
13808,0.002029,172.31.47.0-255,66,195673,90,285097
13809,0.002048,74.125.24.0-255,4320,199993,90,285097
13810,0.002049,172.31.47.0-255,66,200059,90,285097
13811,0.002063,74.125.24.0-255,7156,207215,90,285097
13812,0.002065,172.31.47.0-255,66,207281,90,285097
13813,0.002093,74.125.24.0-255,9992,217273,90,285097
13814,0.002095,172.31.47.0-255,66,217339,90,285097
13815,0.002119,74.125.24.0-255,5020,222359,90,285097
13816,0.002121,172.31.47.0-255,66,222425,90,285097
13817,0.002185,74.125.24.0-255,1484,223909,90,285097
13818,0.002199,74.125.24.0-255,2902,226811,90,285097
13819,0.002201,172.31.47.0-255,66,226877,90,285097
13820,0.002205,74.125.24.0-255,4320,231197,90,285097
13821,0.002207,172.31.47.0-255,66,231263,90,285097
13822,0.002234,74.125.24.0-255,1484,232747,90,285097
13823,0.002245,172.31.47.0-255,66,232813,90,285097
13824,0.002282,74.125.24.0-255,5738,238551,90,285097
13825,0.002284,172.31.47.0-255,66,238617,90,285097
13826,0.002297,74.125.24.0-255,6438,245055,90,285097
13827,0.002302,172.31.47.0-255,66,245121,90,285097
13828,0.002432,74.125.24.0-255,1484,246605,90,285097
13829,0.002453,74.125.24.0-255,2902,249507,90,285097
13830,0.002455,172.31.47.0-255,66,249573,90,285097
13831,0.002458,74.125.24.0-255,1484,251057,90,285097
13832,0.002481,74.125.24.0-255,4320,255377,90,285097
13833,0.002483,172.31.47.0-255,66,255443,90,285097
13834,0.002489,74.125.24.0-255,7156,262599,90,285097
13835,0.002491,172.31.47.0-255,66,262665,90,285097
13836,0.002512,74.125.24.0-255,4320,266985,90,285097
13837,0.002514,172.31.47.0-255,66,267051,90,285097
13838,0.002519,74.125.24.0-255,4320,271371,90,285097
13839,0.002544,74.125.24.0-255,7856,279227,90,285097
13840,0.005889,172.31.47.0-255,66,279293,90,285097
13841,0.008446,74.125.24.0-255,5738,285031,90,285097
13842,0.008453,172.31.47.0-255,66,285097,90,285097
13843,0.0,74.125.24.0-255,153,153,90,78189
13844,3.3e-05,172.31.47.0-255,66,219,90,78189
13845,4.1e-05,74.125.24.0-255,1484,1703,90,78189
13846,4.5e-05,172.31.47.0-255,66,1769,90,78189
13847,5e-05,74.125.24.0-255,2902,4671,90,78189
13848,5.2e-05,172.31.47.0-255,66,4737,90,78189
13849,6e-05,74.125.24.0-255,7156,11893,90,78189
13850,6.3e-05,172.31.47.0-255,66,11959,90,78189
13851,0.000108,172.31.47.0-255,66,12025,90,78189
13852,0.000112,74.125.24.0-255,2543,14568,90,78189
13853,0.000114,172.31.47.0-255,66,14634,90,78189
13854,0.001531,74.125.24.0-255,1484,16118,90,78189
13855,0.001538,172.31.47.0-255,66,16184,90,78189
13856,0.001546,74.125.24.0-255,2902,19086,90,78189
13857,0.001548,172.31.47.0-255,66,19152,90,78189
13858,0.001554,74.125.24.0-255,5738,24890,90,78189
13859,0.001556,172.31.47.0-255,66,24956,90,78189
13860,0.001577,74.125.24.0-255,2902,27858,90,78189
13861,0.001579,172.31.47.0-255,66,27924,90,78189
13862,0.001599,74.125.24.0-255,8215,36139,90,78189
13863,0.001601,172.31.47.0-255,66,36205,90,78189
13864,0.001612,172.31.47.0-255,66,36271,90,78189
13865,0.001629,74.125.24.0-255,1432,37703,90,78189
13866,0.001631,172.31.47.0-255,66,37769,90,78189
13867,0.001651,74.125.24.0-255,114,37883,90,78189
13868,0.001653,172.31.47.0-255,66,37949,90,78189
13869,0.001809,74.125.24.0-255,1484,39433,90,78189
13870,0.001812,172.31.47.0-255,66,39499,90,78189
13871,0.001831,74.125.24.0-255,2902,42401,90,78189
13872,0.001833,172.31.47.0-255,66,42467,90,78189
13873,0.001836,74.125.24.0-255,1484,43951,90,78189
13874,0.001854,74.125.24.0-255,4320,48271,90,78189
13875,0.001857,172.31.47.0-255,66,48337,90,78189
13876,0.001882,172.31.47.0-255,66,48403,90,78189
13877,0.001891,74.125.24.0-255,1484,49887,90,78189
13878,0.001896,74.125.24.0-255,4320,54207,90,78189
13879,0.001898,172.31.47.0-255,66,54273,90,78189
13880,0.001917,74.125.24.0-255,6438,60711,90,78189
13881,0.001919,172.31.47.0-255,66,60777,90,78189
13882,0.004209,74.125.24.0-255,5738,66515,90,78189
13883,0.004212,172.31.47.0-255,66,66581,90,78189
13884,0.006533,74.125.24.0-255,5738,72319,90,78189
13885,0.006539,172.31.47.0-255,66,72385,90,78189
13886,0.008833,74.125.24.0-255,5738,78123,90,78189
13887,0.008839,172.31.47.0-255,66,78189,90,78189
13888,0.0,172.217.194.0-255,152,152,90,365568
13889,1.6e-05,172.31.47.0-255,66,218,90,365568
13890,2.2e-05,172.217.194.0-255,1484,1702,90,365568
13891,2.6e-05,172.31.47.0-255,66,1768,90,365568
13892,3.1e-05,172.217.194.0-255,2902,4670,90,365568
13893,3.5e-05,172.31.47.0-255,66,4736,90,365568
13894,3.9e-05,172.217.194.0-255,2902,7638,90,365568
13895,4.1e-05,172.31.47.0-255,66,7704,90,365568
13896,8.7e-05,172.217.194.0-255,4320,12024,90,365568
13897,9.1e-05,172.31.47.0-255,66,12090,90,365568
13898,0.000112,172.217.194.0-255,2081,14171,90,365568
13899,0.000114,172.31.47.0-255,66,14237,90,365568
13900,0.000121,172.217.194.0-255,7156,21393,90,365568
13901,0.000123,172.31.47.0-255,66,21459,90,365568
13902,0.000156,172.217.194.0-255,5738,27197,90,365568
13903,0.000158,172.31.47.0-255,66,27263,90,365568
13904,0.000181,172.217.194.0-255,3961,31224,90,365568
13905,0.000183,172.31.47.0-255,66,31290,90,365568
13906,0.000186,172.217.194.0-255,1484,32774,90,365568
13907,0.000187,172.31.47.0-255,66,32840,90,365568
13908,0.00019,172.217.194.0-255,1484,34324,90,365568
13909,0.000192,172.31.47.0-255,66,34390,90,365568
13910,0.00022,172.217.194.0-255,1484,35874,90,365568
13911,0.000222,172.31.47.0-255,66,35940,90,365568
13912,0.000228,172.217.194.0-255,5738,41678,90,365568
13913,0.00023,172.31.47.0-255,66,41744,90,365568
13914,0.000247,172.217.194.0-255,5738,47482,90,365568
13915,0.000249,172.31.47.0-255,66,47548,90,365568
13916,0.000277,172.217.194.0-255,8215,55763,90,365568
13917,0.000279,172.31.47.0-255,66,55829,90,365568
13918,0.000299,172.217.194.0-255,7156,62985,90,365568
13919,0.000301,172.31.47.0-255,66,63051,90,365568
13920,0.00032,172.217.194.0-255,2847,65898,90,365568
13921,0.000323,172.31.47.0-255,66,65964,90,365568
13922,0.000325,172.217.194.0-255,381,66345,90,365568
13923,0.000601,172.217.194.0-255,1484,67829,90,365568
13924,0.000607,172.31.47.0-255,66,67895,90,365568
13925,0.000612,172.217.194.0-255,2902,70797,90,365568
13926,0.000615,172.31.47.0-255,66,70863,90,365568
13927,0.00063,172.217.194.0-255,5738,76601,90,365568
13928,0.000632,172.31.47.0-255,66,76667,90,365568
13929,0.000653,172.217.194.0-255,2902,79569,90,365568
13930,0.000655,172.31.47.0-255,66,79635,90,365568
13931,0.000674,172.217.194.0-255,9992,89627,90,365568
13932,0.000676,172.31.47.0-255,66,89693,90,365568
13933,0.000693,172.217.194.0-255,1484,91177,90,365568
13934,0.00071,172.217.194.0-255,9274,100451,90,365568
13935,0.000713,172.31.47.0-255,66,100517,90,365568
13936,0.000761,172.217.194.0-255,1484,102001,90,365568
13937,0.000774,172.217.194.0-255,2902,104903,90,365568
13938,0.000776,172.31.47.0-255,66,104969,90,365568
13939,0.000793,172.217.194.0-255,1484,106453,90,365568
13940,0.000813,172.217.194.0-255,2902,109355,90,365568
13941,0.000815,172.31.47.0-255,66,109421,90,365568
13942,0.000819,172.217.194.0-255,1484,110905,90,365568
13943,0.000838,172.217.194.0-255,4320,115225,90,365568
13944,0.00084,172.31.47.0-255,66,115291,90,365568
13945,0.000843,172.217.194.0-255,1484,116775,90,365568
13946,0.000862,172.217.194.0-255,5738,122513,90,365568
13947,0.000865,172.31.47.0-255,66,122579,90,365568
13948,0.000914,172.217.194.0-255,2902,125481,90,365568
13949,0.000917,172.31.47.0-255,66,125547,90,365568
13950,0.000932,172.217.194.0-255,5738,131285,90,365568
13951,0.000935,172.31.47.0-255,66,131351,90,365568
13952,0.000965,172.217.194.0-255,3602,134953,90,365568
13953,0.000968,172.31.47.0-255,66,135019,90,365568
13954,0.000981,172.217.194.0-255,1484,136503,90,365568
13955,0.000993,172.217.194.0-255,2902,139405,90,365568
13956,0.000996,172.31.47.0-255,66,139471,90,365568
13957,0.001001,172.217.194.0-255,4320,143791,90,365568
13958,0.001003,172.31.47.0-255,66,143857,90,365568
13959,0.001018,172.217.194.0-255,1484,145341,90,365568
13960,0.001022,172.217.194.0-255,4320,149661,90,365568
13961,0.001025,172.31.47.0-255,66,149727,90,365568
13962,0.001028,172.217.194.0-255,2902,152629,90,365568
13963,0.00103,172.31.47.0-255,66,152695,90,365568
13964,0.001055,172.217.194.0-255,8574,161269,90,365568
13965,0.001058,172.31.47.0-255,66,161335,90,365568
13966,0.001072,172.217.194.0-255,5738,167073,90,365568
13967,0.001075,172.31.47.0-255,66,167139,90,365568
13968,0.001096,172.217.194.0-255,2184,169323,90,365568
13969,0.001099,172.31.47.0-255,66,169389,90,365568
13970,0.001128,172.217.194.0-255,1484,170873,90,365568
13971,0.001141,172.217.194.0-255,2902,173775,90,365568
13972,0.001144,172.31.47.0-255,66,173841,90,365568
13973,0.001147,172.217.194.0-255,1484,175325,90,365568
13974,0.001157,172.217.194.0-255,1484,176809,90,365568
13975,0.001158,172.31.47.0-255,66,176875,90,365568
13976,0.001174,172.217.194.0-255,1484,178359,90,365568
13977,0.001176,172.217.194.0-255,1484,179843,90,365568
13978,0.001179,172.31.47.0-255,66,179909,90,365568
13979,0.001199,172.217.194.0-255,4320,184229,90,365568
13980,0.001201,172.31.47.0-255,66,184295,90,365568
13981,0.001204,172.217.194.0-255,1484,185779,90,365568
13982,0.001233,172.31.47.0-255,66,185845,90,365568
13983,0.001266,172.217.194.0-255,4320,190165,90,365568
13984,0.001269,172.31.47.0-255,66,190231,90,365568
13985,0.001286,172.217.194.0-255,2184,192415,90,365568
13986,0.001288,172.31.47.0-255,66,192481,90,365568
13987,0.001319,172.217.194.0-255,1484,193965,90,365568
13988,0.001324,172.217.194.0-255,2902,196867,90,365568
13989,0.001327,172.31.47.0-255,66,196933,90,365568
13990,0.00133,172.217.194.0-255,1484,198417,90,365568
13991,0.001346,172.217.194.0-255,4320,202737,90,365568
13992,0.001348,172.31.47.0-255,66,202803,90,365568
13993,0.001401,172.217.194.0-255,8574,211377,90,365568
13994,0.001404,172.31.47.0-255,66,211443,90,365568
13995,0.001431,172.31.47.0-255,66,211509,90,365568
13996,0.00145,172.217.194.0-255,3602,215111,90,365568
13997,0.001452,172.31.47.0-255,66,215177,90,365568
13998,0.001455,172.217.194.0-255,1484,216661,90,365568
13999,0.001474,172.217.194.0-255,5738,222399,90,365568
14000,0.001477,172.31.47.0-255,66,222465,90,365568
14001,0.001479,172.217.194.0-255,1484,223949,90,365568
14002,0.001515,172.217.194.0-255,7156,231105,90,365568
14003,0.001521,172.217.194.0-255,5738,236843,90,365568
14004,0.001525,172.31.47.0-255,66,236909,90,365568
14005,0.001529,172.31.47.0-255,66,236975,90,365568
14006,0.001541,172.217.194.0-255,8574,245549,90,365568
14007,0.001543,172.31.47.0-255,66,245615,90,365568
14008,0.001558,172.217.194.0-255,1484,247099,90,365568
14009,0.001562,172.217.194.0-255,2184,249283,90,365568
14010,0.001564,172.31.47.0-255,66,249349,90,365568
14011,0.001718,172.217.194.0-255,1484,250833,90,365568
14012,0.001724,172.217.194.0-255,2902,253735,90,365568
14013,0.001728,172.31.47.0-255,66,253801,90,365568
14014,0.001734,172.217.194.0-255,4320,258121,90,365568
14015,0.001736,172.31.47.0-255,66,258187,90,365568
14016,0.001752,172.217.194.0-255,1484,259671,90,365568
14017,0.001774,172.217.194.0-255,7156,266827,90,365568
14018,0.001778,172.31.47.0-255,66,266893,90,365568
14019,0.001801,172.217.194.0-255,5738,272631,90,365568
14020,0.001804,172.31.47.0-255,66,272697,90,365568
14021,0.001827,172.217.194.0-255,4320,277017,90,365568
14022,0.001832,172.31.47.0-255,66,277083,90,365568
14023,0.001849,172.217.194.0-255,6438,283521,90,365568
14024,0.001853,172.31.47.0-255,66,283587,90,365568
14025,0.001899,172.217.194.0-255,1484,285071,90,365568
14026,0.001916,172.217.194.0-255,2902,287973,90,365568
14027,0.001919,172.31.47.0-255,66,288039,90,365568
14028,0.001923,172.217.194.0-255,1484,289523,90,365568
14029,0.00194,172.217.194.0-255,4320,293843,90,365568
14030,0.001943,172.31.47.0-255,66,293909,90,365568
14031,0.001959,172.217.194.0-255,4320,298229,90,365568
14032,0.001961,172.31.47.0-255,66,298295,90,365568
14033,0.001982,172.217.194.0-255,8574,306869,90,365568
14034,0.001985,172.31.47.0-255,66,306935,90,365568
14035,0.001988,172.217.194.0-255,1484,308419,90,365568
14036,0.002013,172.217.194.0-255,4320,312739,90,365568
14037,0.002016,172.31.47.0-255,66,312805,90,365568
14038,0.002033,172.217.194.0-255,5738,318543,90,365568
14039,0.002036,172.31.47.0-255,66,318609,90,365568
14040,0.002062,172.217.194.0-255,5020,323629,90,365568
14041,0.002065,172.31.47.0-255,66,323695,90,365568
14042,0.002076,172.31.47.0-255,66,323761,90,365568
14043,0.002079,172.217.194.0-255,1484,325245,90,365568
14044,0.002113,172.217.194.0-255,9992,335237,90,365568
14045,0.002116,172.31.47.0-255,66,335303,90,365568
14046,0.002147,172.31.47.0-255,66,335369,90,365568
14047,0.00215,172.217.194.0-255,2902,338271,90,365568
14048,0.002152,172.31.47.0-255,66,338337,90,365568
14049,0.00217,172.217.194.0-255,9992,348329,90,365568
14050,0.002173,172.31.47.0-255,66,348395,90,365568
14051,0.002198,172.217.194.0-255,1484,349879,90,365568
14052,0.002206,172.217.194.0-255,9992,359871,90,365568
14053,0.002209,172.31.47.0-255,66,359937,90,365568
14054,0.002259,172.217.194.0-255,5460,365397,90,365568
14055,0.002261,172.31.47.0-255,66,365463,90,365568
14056,0.002295,172.217.194.0-255,105,365568,90,365568
14057,0.0,74.125.24.0-255,298,298,90,315536
14058,3e-05,172.31.47.0-255,66,364,90,315536
14059,3.6e-05,74.125.24.0-255,1484,1848,90,315536
14060,4e-05,172.31.47.0-255,66,1914,90,315536
14061,4.5e-05,74.125.24.0-255,4320,6234,90,315536
14062,4.8e-05,172.31.47.0-255,66,6300,90,315536
14063,5e-05,74.125.24.0-255,1484,7784,90,315536
14064,5.2e-05,172.31.47.0-255,66,7850,90,315536
14065,7e-05,74.125.24.0-255,6205,14055,90,315536
14066,7.2e-05,172.31.47.0-255,66,14121,90,315536
14067,0.000109,74.125.24.0-255,1484,15605,90,315536
14068,0.000111,172.31.47.0-255,66,15671,90,315536
14069,0.00014,74.125.24.0-255,2902,18573,90,315536
14070,0.000143,172.31.47.0-255,66,18639,90,315536
14071,0.000149,74.125.24.0-255,5738,24377,90,315536
14072,0.000152,172.31.47.0-255,66,24443,90,315536
14073,0.000155,74.125.24.0-255,2902,27345,90,315536
14074,0.000157,172.31.47.0-255,66,27411,90,315536
14075,0.000183,74.125.24.0-255,2902,30313,90,315536
14076,0.000185,172.31.47.0-255,66,30379,90,315536
14077,0.000213,74.125.24.0-255,6797,37176,90,315536
14078,0.000216,172.31.47.0-255,66,37242,90,315536
14079,0.000229,74.125.24.0-255,4320,41562,90,315536
14080,0.000231,172.31.47.0-255,66,41628,90,315536
14081,0.000247,74.125.24.0-255,2902,44530,90,315536
14082,0.000249,172.31.47.0-255,66,44596,90,315536
14083,0.00027,74.125.24.0-255,3961,48557,90,315536
14084,0.000272,172.31.47.0-255,66,48623,90,315536
14085,0.000298,74.125.24.0-255,1484,50107,90,315536
14086,0.0003,172.31.47.0-255,66,50173,90,315536
14087,0.000315,74.125.24.0-255,2902,53075,90,315536
14088,0.000317,172.31.47.0-255,66,53141,90,315536
14089,0.000341,74.125.24.0-255,5738,58879,90,315536
14090,0.000343,172.31.47.0-255,66,58945,90,315536
14091,0.000395,74.125.24.0-255,2902,61847,90,315536
14092,0.000402,172.31.47.0-255,66,61913,90,315536
14093,0.000421,74.125.24.0-255,4254,66167,90,315536
14094,0.000424,172.31.47.0-255,66,66233,90,315536
14095,0.000683,74.125.24.0-255,383,66616,90,315536
14096,0.000714,74.125.24.0-255,1484,68100,90,315536
14097,0.000717,172.31.47.0-255,66,68166,90,315536
14098,0.000738,74.125.24.0-255,4320,72486,90,315536
14099,0.00074,172.31.47.0-255,66,72552,90,315536
14100,0.000755,74.125.24.0-255,5738,78290,90,315536
14101,0.000758,172.31.47.0-255,66,78356,90,315536
14102,0.000777,74.125.24.0-255,4320,82676,90,315536
14103,0.000779,172.31.47.0-255,66,82742,90,315536
14104,0.000782,74.125.24.0-255,1125,83867,90,315536
14105,0.000814,74.125.24.0-255,2902,86769,90,315536
14106,0.000829,172.31.47.0-255,66,86835,90,315536
14107,0.000835,74.125.24.0-255,4320,91155,90,315536
14108,0.000837,172.31.47.0-255,66,91221,90,315536
14109,0.00084,74.125.24.0-255,2902,94123,90,315536
14110,0.000842,172.31.47.0-255,66,94189,90,315536
14111,0.000867,74.125.24.0-255,5738,99927,90,315536
14112,0.00087,172.31.47.0-255,66,99993,90,315536
14113,0.000873,74.125.24.0-255,1125,101118,90,315536
14114,0.000974,172.31.47.0-255,66,101184,90,315536
14115,0.001221,74.125.24.0-255,1484,102668,90,315536
14116,0.001229,74.125.24.0-255,2902,105570,90,315536
14117,0.001232,172.31.47.0-255,66,105636,90,315536
14118,0.001238,74.125.24.0-255,5738,111374,90,315536
14119,0.00124,172.31.47.0-255,66,111440,90,315536
14120,0.001271,74.125.24.0-255,8574,120014,90,315536
14121,0.001274,172.31.47.0-255,66,120080,90,315536
14122,0.001296,74.125.24.0-255,4320,124400,90,315536
14123,0.001298,172.31.47.0-255,66,124466,90,315536
14124,0.001306,74.125.24.0-255,10692,135158,90,315536
14125,0.001308,172.31.47.0-255,66,135224,90,315536
14126,0.001375,74.125.24.0-255,1484,136708,90,315536
14127,0.00138,74.125.24.0-255,2902,139610,90,315536
14128,0.001383,172.31.47.0-255,66,139676,90,315536
14129,0.001388,74.125.24.0-255,4320,143996,90,315536
14130,0.00139,172.31.47.0-255,66,144062,90,315536
14131,0.001403,74.125.24.0-255,1484,145546,90,315536
14132,0.001421,74.125.24.0-255,5738,151284,90,315536
14133,0.001424,172.31.47.0-255,66,151350,90,315536
14134,0.001448,74.125.24.0-255,7156,158506,90,315536
14135,0.001452,172.31.47.0-255,66,158572,90,315536
14136,0.001458,74.125.24.0-255,7156,165728,90,315536
14137,0.00146,172.31.47.0-255,66,165794,90,315536
14138,0.001484,74.125.24.0-255,4320,170114,90,315536
14139,0.001489,172.31.47.0-255,66,170180,90,315536
14140,0.001519,172.31.47.0-255,66,170246,90,315536
14141,0.001547,74.125.24.0-255,2184,172430,90,315536
14142,0.001551,172.31.47.0-255,66,172496,90,315536
14143,0.001561,172.31.47.0-255,66,172562,90,315536
14144,0.001565,74.125.24.0-255,3602,176164,90,315536
14145,0.001567,172.31.47.0-255,66,176230,90,315536
14146,0.001571,74.125.24.0-255,4320,180550,90,315536
14147,0.001573,172.31.47.0-255,66,180616,90,315536
14148,0.001613,74.125.24.0-255,4320,184936,90,315536
14149,0.001618,172.31.47.0-255,66,185002,90,315536
14150,0.001645,74.125.24.0-255,5738,190740,90,315536
14151,0.001648,172.31.47.0-255,66,190806,90,315536
14152,0.001654,74.125.24.0-255,8574,199380,90,315536
14153,0.001656,172.31.47.0-255,66,199446,90,315536
14154,0.001664,74.125.24.0-255,9992,209438,90,315536
14155,0.001667,172.31.47.0-255,66,209504,90,315536
14156,0.00168,74.125.24.0-255,766,210270,90,315536
14157,0.001777,74.125.24.0-255,1484,211754,90,315536
14158,0.001781,172.31.47.0-255,66,211820,90,315536
14159,0.001785,74.125.24.0-255,2902,214722,90,315536
14160,0.001787,172.31.47.0-255,66,214788,90,315536
14161,0.001807,74.125.24.0-255,4320,219108,90,315536
14162,0.00181,172.31.47.0-255,66,219174,90,315536
14163,0.001827,74.125.24.0-255,1484,220658,90,315536
14164,0.001829,74.125.24.0-255,1484,222142,90,315536
14165,0.001831,172.31.47.0-255,66,222208,90,315536
14166,0.001854,172.31.47.0-255,66,222274,90,315536
14167,0.00186,74.125.24.0-255,5738,228012,90,315536
14168,0.001861,172.31.47.0-255,66,228078,90,315536
14169,0.001902,74.125.24.0-255,4320,232398,90,315536
14170,0.001905,172.31.47.0-255,66,232464,90,315536
14171,0.00193,172.31.47.0-255,66,232530,90,315536
14172,0.001946,74.125.24.0-255,5020,237550,90,315536
14173,0.001948,172.31.47.0-255,66,237616,90,315536
14174,0.00195,74.125.24.0-255,1484,239100,90,315536
14175,0.001991,172.31.47.0-255,66,239166,90,315536
14176,0.002469,74.125.24.0-255,1484,240650,90,315536
14177,0.00249,74.125.24.0-255,2902,243552,90,315536
14178,0.002493,172.31.47.0-255,66,243618,90,315536
14179,0.002508,74.125.24.0-255,4320,247938,90,315536
14180,0.002509,172.31.47.0-255,66,248004,90,315536
14181,0.002529,74.125.24.0-255,1484,249488,90,315536
14182,0.002542,74.125.24.0-255,5738,255226,90,315536
14183,0.002544,172.31.47.0-255,66,255292,90,315536
14184,0.002547,74.125.24.0-255,1484,256776,90,315536
14185,0.002569,74.125.24.0-255,5738,262514,90,315536
14186,0.002571,172.31.47.0-255,66,262580,90,315536
14187,0.002576,74.125.24.0-255,4320,266900,90,315536
14188,0.002577,172.31.47.0-255,66,266966,90,315536
14189,0.002593,74.125.24.0-255,4320,271286,90,315536
14190,0.002595,172.31.47.0-255,66,271352,90,315536
14191,0.002598,74.125.24.0-255,2184,273536,90,315536
14192,0.0026,172.31.47.0-255,66,273602,90,315536
14193,0.002645,74.125.24.0-255,2902,276504,90,315536
14194,0.002648,172.31.47.0-255,66,276570,90,315536
14195,0.002667,74.125.24.0-255,4320,280890,90,315536
14196,0.002669,172.31.47.0-255,66,280956,90,315536
14197,0.002688,74.125.24.0-255,8574,289530,90,315536
14198,0.00269,172.31.47.0-255,66,289596,90,315536
14199,0.002717,74.125.24.0-255,8574,298170,90,315536
14200,0.002719,172.31.47.0-255,66,298236,90,315536
14201,0.002742,74.125.24.0-255,5738,303974,90,315536
14202,0.002744,172.31.47.0-255,66,304040,90,315536
14203,0.002746,74.125.24.0-255,1484,305524,90,315536
14204,0.002773,172.31.47.0-255,66,305590,90,315536
14205,0.00278,74.125.24.0-255,766,306356,90,315536
14206,0.002785,74.125.24.0-255,5738,312094,90,315536
14207,0.002787,172.31.47.0-255,66,312160,90,315536
14208,0.002815,74.125.24.0-255,2902,315062,90,315536
14209,0.002817,172.31.47.0-255,66,315128,90,315536
14210,0.002847,172.31.47.0-255,66,315194,90,315536
14211,0.002886,74.125.24.0-255,105,315299,90,315536
14212,0.003804,172.31.47.0-255,66,315365,90,315536
14213,0.003835,172.31.47.0-255,105,315470,90,315536
14214,0.00606,74.125.24.0-255,66,315536,90,315536
14215,0.0,172.31.47.0-255,105,105,90,276
14216,0.001773,157.240.13.0-255,105,210,90,276
14217,0.001787,172.31.47.0-255,66,276,90,276
14218,0.0,74.125.200.0-255,288,288,90,250169
14219,2.4e-05,172.31.47.0-255,66,354,90,250169
14220,7.1e-05,74.125.200.0-255,1484,1838,90,250169
14221,7.5e-05,172.31.47.0-255,66,1904,90,250169
14222,8.6e-05,74.125.200.0-255,1484,3388,90,250169
14223,9.3e-05,172.31.47.0-255,66,3454,90,250169
14224,0.000117,74.125.200.0-255,2902,6356,90,250169
14225,0.00012,172.31.47.0-255,66,6422,90,250169
14226,0.000126,74.125.200.0-255,5738,12160,90,250169
14227,0.000128,172.31.47.0-255,66,12226,90,250169
14228,0.000132,74.125.200.0-255,2021,14247,90,250169
14229,0.000142,172.31.47.0-255,66,14313,90,250169
14230,0.000147,74.125.200.0-255,2902,17215,90,250169
14231,0.00015,172.31.47.0-255,66,17281,90,250169
14232,0.000185,74.125.200.0-255,7156,24437,90,250169
14233,0.000187,172.31.47.0-255,66,24503,90,250169
14234,0.000191,74.125.200.0-255,2902,27405,90,250169
14235,0.000193,172.31.47.0-255,66,27471,90,250169
14236,0.000196,74.125.200.0-255,1484,28955,90,250169
14237,0.000198,172.31.47.0-255,66,29021,90,250169
14238,0.000225,74.125.200.0-255,2543,31564,90,250169
14239,0.000228,172.31.47.0-255,66,31630,90,250169
14240,0.000326,74.125.200.0-255,1484,33114,90,250169
14241,0.00033,172.31.47.0-255,66,33180,90,250169
14242,0.000335,74.125.200.0-255,1484,34664,90,250169
14243,0.000336,172.31.47.0-255,66,34730,90,250169
14244,0.00034,74.125.200.0-255,2902,37632,90,250169
14245,0.000343,172.31.47.0-255,66,37698,90,250169
14246,0.000374,74.125.200.0-255,5738,43436,90,250169
14247,0.000377,172.31.47.0-255,66,43502,90,250169
14248,0.00038,74.125.200.0-255,1484,44986,90,250169
14249,0.000383,172.31.47.0-255,66,45052,90,250169
14250,0.000402,74.125.200.0-255,3961,49013,90,250169
14251,0.000405,172.31.47.0-255,66,49079,90,250169
14252,0.000409,74.125.200.0-255,2902,51981,90,250169
14253,0.000411,172.31.47.0-255,66,52047,90,250169
14254,0.000431,74.125.200.0-255,2902,54949,90,250169
14255,0.000434,172.31.47.0-255,66,55015,90,250169
14256,0.000438,74.125.200.0-255,2902,57917,90,250169
14257,0.00044,172.31.47.0-255,66,57983,90,250169
14258,0.000475,74.125.200.0-255,8215,66198,90,250169
14259,0.000478,172.31.47.0-255,66,66264,90,250169
14260,0.00048,74.125.200.0-255,395,66659,90,250169
14261,0.000499,74.125.200.0-255,111,66770,90,250169
14262,0.000608,74.125.200.0-255,1484,68254,90,250169
14263,0.000611,172.31.47.0-255,66,68320,90,250169
14264,0.000623,74.125.200.0-255,2902,71222,90,250169
14265,0.000629,172.31.47.0-255,66,71288,90,250169
14266,0.000652,74.125.200.0-255,2902,74190,90,250169
14267,0.000655,172.31.47.0-255,66,74256,90,250169
14268,0.000659,74.125.200.0-255,4320,78576,90,250169
14269,0.000661,172.31.47.0-255,66,78642,90,250169
14270,0.000693,74.125.200.0-255,9633,88275,90,250169
14271,0.000696,172.31.47.0-255,66,88341,90,250169
14272,0.000701,74.125.200.0-255,4320,92661,90,250169
14273,0.000703,172.31.47.0-255,66,92727,90,250169
14274,0.000748,74.125.200.0-255,2902,95629,90,250169
14275,0.000751,172.31.47.0-255,66,95695,90,250169
14276,0.000777,74.125.200.0-255,5624,101319,90,250169
14277,0.000779,172.31.47.0-255,66,101385,90,250169
14278,0.001089,74.125.200.0-255,1484,102869,90,250169
14279,0.001096,74.125.200.0-255,1484,104353,90,250169
14280,0.0011,172.31.47.0-255,66,104419,90,250169
14281,0.001157,74.125.200.0-255,2902,107321,90,250169
14282,0.00116,172.31.47.0-255,66,107387,90,250169
14283,0.001186,74.125.200.0-255,4320,111707,90,250169
14284,0.001189,172.31.47.0-255,66,111773,90,250169
14285,0.001217,74.125.200.0-255,8574,120347,90,250169
14286,0.00122,172.31.47.0-255,66,120413,90,250169
14287,0.001245,74.125.200.0-255,7156,127569,90,250169
14288,0.001248,172.31.47.0-255,66,127635,90,250169
14289,0.001271,74.125.200.0-255,2902,130537,90,250169
14290,0.001273,172.31.47.0-255,66,130603,90,250169
14291,0.001277,74.125.200.0-255,2902,133505,90,250169
14292,0.001279,172.31.47.0-255,66,133571,90,250169
14293,0.001325,74.125.200.0-255,2184,135755,90,250169
14294,0.001328,172.31.47.0-255,66,135821,90,250169
14295,0.00139,74.125.200.0-255,1484,137305,90,250169
14296,0.001407,74.125.200.0-255,2902,140207,90,250169
14297,0.001409,172.31.47.0-255,66,140273,90,250169
14298,0.001419,74.125.200.0-255,1484,141757,90,250169
14299,0.001435,74.125.200.0-255,4320,146077,90,250169
14300,0.001437,172.31.47.0-255,66,146143,90,250169
14301,0.001466,74.125.200.0-255,9992,156135,90,250169
14302,0.001469,172.31.47.0-255,66,156201,90,250169
14303,0.001494,74.125.200.0-255,1484,157685,90,250169
14304,0.001507,172.31.47.0-255,66,157751,90,250169
14305,0.001533,74.125.200.0-255,1484,159235,90,250169
14306,0.001548,74.125.200.0-255,1484,160719,90,250169
14307,0.001551,172.31.47.0-255,66,160785,90,250169
14308,0.001574,74.125.200.0-255,2902,163687,90,250169
14309,0.001576,172.31.47.0-255,66,163753,90,250169
14310,0.001581,74.125.200.0-255,2902,166655,90,250169
14311,0.001583,172.31.47.0-255,66,166721,90,250169
14312,0.001607,74.125.200.0-255,2902,169623,90,250169
14313,0.00161,172.31.47.0-255,66,169689,90,250169
14314,0.001623,74.125.200.0-255,8574,178263,90,250169
14315,0.001625,172.31.47.0-255,66,178329,90,250169
14316,0.001663,74.125.200.0-255,9992,188321,90,250169
14317,0.001667,172.31.47.0-255,66,188387,90,250169
14318,0.001672,74.125.200.0-255,3602,191989,90,250169
14319,0.001674,172.31.47.0-255,66,192055,90,250169
14320,0.001712,74.125.200.0-255,1484,193539,90,250169
14321,0.001726,74.125.200.0-255,1484,195023,90,250169
14322,0.001729,172.31.47.0-255,66,195089,90,250169
14323,0.001734,74.125.200.0-255,4320,199409,90,250169
14324,0.001736,172.31.47.0-255,66,199475,90,250169
14325,0.001752,74.125.200.0-255,4320,203795,90,250169
14326,0.001755,172.31.47.0-255,66,203861,90,250169
14327,0.001781,74.125.200.0-255,4320,208181,90,250169
14328,0.001783,172.31.47.0-255,66,208247,90,250169
14329,0.001788,74.125.200.0-255,4320,212567,90,250169
14330,0.001789,172.31.47.0-255,66,212633,90,250169
14331,0.001818,74.125.200.0-255,4320,216953,90,250169
14332,0.00182,172.31.47.0-255,66,217019,90,250169
14333,0.001854,74.125.200.0-255,9274,226293,90,250169
14334,0.001856,172.31.47.0-255,66,226359,90,250169
14335,0.002038,74.125.200.0-255,1484,227843,90,250169
14336,0.002066,74.125.200.0-255,1484,229327,90,250169
14337,0.002068,172.31.47.0-255,66,229393,90,250169
14338,0.003862,74.125.200.0-255,2902,232295,90,250169
14339,0.003864,172.31.47.0-255,66,232361,90,250169
14340,0.004075,74.125.200.0-255,2902,235263,90,250169
14341,0.004077,172.31.47.0-255,66,235329,90,250169
14342,0.005881,74.125.200.0-255,2902,238231,90,250169
14343,0.005888,172.31.47.0-255,66,238297,90,250169
14344,0.006099,74.125.200.0-255,2902,241199,90,250169
14345,0.006104,172.31.47.0-255,66,241265,90,250169
14346,0.007917,74.125.200.0-255,2902,244167,90,250169
14347,0.007926,172.31.47.0-255,66,244233,90,250169
14348,0.008111,74.125.200.0-255,2902,247135,90,250169
14349,0.008114,172.31.47.0-255,66,247201,90,250169
14350,0.009969,74.125.200.0-255,2902,250103,90,250169
14351,0.00998,172.31.47.0-255,66,250169,90,250169
14352,0.0,172.217.194.0-255,153,153,90,236067
14353,2.8e-05,172.31.47.0-255,66,219,90,236067
14354,3.4e-05,172.217.194.0-255,1484,1703,90,236067
14355,3.7e-05,172.31.47.0-255,66,1769,90,236067
14356,4.2e-05,172.217.194.0-255,2902,4671,90,236067
14357,4.5e-05,172.31.47.0-255,66,4737,90,236067
14358,5.7e-05,172.217.194.0-255,5738,10475,90,236067
14359,6e-05,172.31.47.0-255,66,10541,90,236067
14360,8.6e-05,172.217.194.0-255,3549,14090,90,236067
14361,8.8e-05,172.31.47.0-255,66,14156,90,236067
14362,9.2e-05,172.217.194.0-255,2902,17058,90,236067
14363,9.4e-05,172.31.47.0-255,66,17124,90,236067
14364,0.000123,172.217.194.0-255,1484,18608,90,236067
14365,0.000126,172.31.47.0-255,66,18674,90,236067
14366,0.000134,172.217.194.0-255,9992,28666,90,236067
14367,0.000137,172.31.47.0-255,66,28732,90,236067
14368,0.00014,172.217.194.0-255,2543,31275,90,236067
14369,0.000142,172.31.47.0-255,66,31341,90,236067
14370,0.00019,172.217.194.0-255,1484,32825,90,236067
14371,0.000193,172.31.47.0-255,66,32891,90,236067
14372,0.000196,172.217.194.0-255,1484,34375,90,236067
14373,0.000198,172.31.47.0-255,66,34441,90,236067
14374,0.000215,172.217.194.0-255,1484,35925,90,236067
14375,0.000217,172.31.47.0-255,66,35991,90,236067
14376,0.000223,172.217.194.0-255,5738,41729,90,236067
14377,0.000229,172.31.47.0-255,66,41795,90,236067
14378,0.000232,172.217.194.0-255,1484,43279,90,236067
14379,0.000233,172.31.47.0-255,66,43345,90,236067
14380,0.000255,172.217.194.0-255,2902,46247,90,236067
14381,0.000258,172.31.47.0-255,66,46313,90,236067
14382,0.000287,172.217.194.0-255,5379,51692,90,236067
14383,0.00029,172.31.47.0-255,66,51758,90,236067
14384,0.000294,172.217.194.0-255,2902,54660,90,236067
14385,0.000296,172.31.47.0-255,66,54726,90,236067
14386,0.000314,172.217.194.0-255,2902,57628,90,236067
14387,0.000318,172.31.47.0-255,66,57694,90,236067
14388,0.000345,172.217.194.0-255,8487,66181,90,236067
14389,0.000349,172.31.47.0-255,66,66247,90,236067
14390,0.000373,172.217.194.0-255,436,66683,90,236067
14391,0.00054,172.217.194.0-255,1484,68167,90,236067
14392,0.000543,172.31.47.0-255,66,68233,90,236067
14393,0.000548,172.217.194.0-255,2902,71135,90,236067
14394,0.000551,172.31.47.0-255,66,71201,90,236067
14395,0.000554,172.217.194.0-255,1484,72685,90,236067
14396,0.00058,172.217.194.0-255,4320,77005,90,236067
14397,0.000582,172.31.47.0-255,66,77071,90,236067
14398,0.000594,172.31.47.0-255,66,77137,90,236067
14399,0.000598,172.217.194.0-255,2902,80039,90,236067
14400,0.000605,172.31.47.0-255,66,80105,90,236067
14401,0.000626,172.217.194.0-255,5738,85843,90,236067
14402,0.00063,172.31.47.0-255,66,85909,90,236067
14403,0.000644,172.217.194.0-255,2184,88093,90,236067
14404,0.000647,172.31.47.0-255,66,88159,90,236067
14405,0.000745,172.217.194.0-255,1484,89643,90,236067
14406,0.00075,172.217.194.0-255,2902,92545,90,236067
14407,0.000752,172.31.47.0-255,66,92611,90,236067
14408,0.000756,172.217.194.0-255,1484,94095,90,236067
14409,0.000779,172.217.194.0-255,4320,98415,90,236067
14410,0.000782,172.31.47.0-255,66,98481,90,236067
14411,0.000792,172.31.47.0-255,66,98547,90,236067
14412,0.000826,172.217.194.0-255,1484,100031,90,236067
14413,0.000834,172.217.194.0-255,9992,110023,90,236067
14414,0.000837,172.31.47.0-255,66,110089,90,236067
14415,0.000839,172.217.194.0-255,766,110855,90,236067
14416,0.001174,172.31.47.0-255,66,110921,90,236067
14417,0.001325,172.217.194.0-255,1484,112405,90,236067
14418,0.001336,172.217.194.0-255,2902,115307,90,236067
14419,0.00134,172.31.47.0-255,66,115373,90,236067
14420,0.001346,172.217.194.0-255,2902,118275,90,236067
14421,0.001348,172.31.47.0-255,66,118341,90,236067
14422,0.00137,172.217.194.0-255,2902,121243,90,236067
14423,0.001374,172.31.47.0-255,66,121309,90,236067
14424,0.001381,172.217.194.0-255,7156,128465,90,236067
14425,0.001384,172.31.47.0-255,66,128531,90,236067
14426,0.001422,172.217.194.0-255,2902,131433,90,236067
14427,0.001425,172.31.47.0-255,66,131499,90,236067
14428,0.00146,172.31.47.0-255,66,131565,90,236067
14429,0.001464,172.217.194.0-255,2184,133749,90,236067
14430,0.001466,172.31.47.0-255,66,133815,90,236067
14431,0.001534,172.217.194.0-255,1484,135299,90,236067
14432,0.001555,172.217.194.0-255,2902,138201,90,236067
14433,0.001557,172.31.47.0-255,66,138267,90,236067
14434,0.001561,172.217.194.0-255,1484,139751,90,236067
14435,0.001589,172.217.194.0-255,1484,141235,90,236067
14436,0.001592,172.31.47.0-255,66,141301,90,236067
14437,0.001622,172.217.194.0-255,4320,145621,90,236067
14438,0.001625,172.31.47.0-255,66,145687,90,236067
14439,0.00163,172.217.194.0-255,5738,151425,90,236067
14440,0.001633,172.31.47.0-255,66,151491,90,236067
14441,0.001646,172.217.194.0-255,7156,158647,90,236067
14442,0.001648,172.31.47.0-255,66,158713,90,236067
14443,0.001681,172.217.194.0-255,9274,167987,90,236067
14444,0.001684,172.31.47.0-255,66,168053,90,236067
14445,0.001712,172.217.194.0-255,1484,169537,90,236067
14446,0.001738,172.217.194.0-255,2902,172439,90,236067
14447,0.001741,172.31.47.0-255,66,172505,90,236067
14448,0.001747,172.217.194.0-255,5738,178243,90,236067
14449,0.001751,172.217.194.0-255,1484,179727,90,236067
14450,0.001789,172.217.194.0-255,8574,188301,90,236067
14451,0.001804,172.217.194.0-255,1484,189785,90,236067
14452,0.001806,172.217.194.0-255,766,190551,90,236067
14453,0.001832,172.217.194.0-255,1484,192035,90,236067
14454,0.001849,172.217.194.0-255,4320,196355,90,236067
14455,0.001867,172.217.194.0-255,1484,197839,90,236067
14456,0.001891,172.217.194.0-255,8574,206413,90,236067
14457,0.001896,172.217.194.0-255,4320,210733,90,236067
14458,0.001919,172.217.194.0-255,7156,217889,90,236067
14459,0.001933,172.217.194.0-255,5738,223627,90,236067
14460,0.001944,172.217.194.0-255,766,224393,90,236067
14461,0.005486,172.31.47.0-255,66,224459,90,236067
14462,0.007542,172.217.194.0-255,5738,230197,90,236067
14463,0.007548,172.31.47.0-255,66,230263,90,236067
14464,0.009607,172.217.194.0-255,5738,236001,90,236067
14465,0.009614,172.31.47.0-255,66,236067,90,236067
14466,0.0,172.217.194.0-255,146,146,90,202020
14467,2.3e-05,172.31.47.0-255,66,212,90,202020
14468,3e-05,172.217.194.0-255,1484,1696,90,202020
14469,3.4e-05,172.31.47.0-255,66,1762,90,202020
14470,3.9e-05,172.217.194.0-255,2902,4664,90,202020
14471,5e-05,172.31.47.0-255,66,4730,90,202020
14472,5.8e-05,172.217.194.0-255,5738,10468,90,202020
14473,6e-05,172.31.47.0-255,66,10534,90,202020
14474,0.000103,172.217.194.0-255,4320,14854,90,202020
14475,0.000106,172.31.47.0-255,66,14920,90,202020
14476,0.000136,172.217.194.0-255,7631,22551,90,202020
14477,0.000139,172.31.47.0-255,66,22617,90,202020
14478,0.00023,172.217.194.0-255,7156,29773,90,202020
14479,0.000234,172.31.47.0-255,66,29839,90,202020
14480,0.000257,172.217.194.0-255,1125,30964,90,202020
14481,0.00026,172.31.47.0-255,66,31030,90,202020
14482,0.0004,172.217.194.0-255,1484,32514,90,202020
14483,0.000404,172.31.47.0-255,66,32580,90,202020
14484,0.00041,172.217.194.0-255,2902,35482,90,202020
14485,0.000413,172.31.47.0-255,66,35548,90,202020
14486,0.000449,172.217.194.0-255,5738,41286,90,202020
14487,0.000452,172.31.47.0-255,66,41352,90,202020
14488,0.000485,172.217.194.0-255,2902,44254,90,202020
14489,0.000488,172.31.47.0-255,66,44320,90,202020
14490,0.000509,172.217.194.0-255,2902,47222,90,202020
14491,0.000515,172.31.47.0-255,66,47288,90,202020
14492,0.000545,172.217.194.0-255,8215,55503,90,202020
14493,0.000548,172.31.47.0-255,66,55569,90,202020
14494,0.000639,172.217.194.0-255,8574,64143,90,202020
14495,0.000643,172.31.47.0-255,66,64209,90,202020
14496,0.000718,172.217.194.0-255,1125,65334,90,202020
14497,0.000722,172.31.47.0-255,66,65400,90,202020
14498,0.000726,172.217.194.0-255,650,66050,90,202020
14499,0.000727,172.31.47.0-255,66,66116,90,202020
14500,0.000789,172.217.194.0-255,1484,67600,90,202020
14501,0.000792,172.31.47.0-255,66,67666,90,202020
14502,0.000796,172.217.194.0-255,1484,69150,90,202020
14503,0.000798,172.31.47.0-255,66,69216,90,202020
14504,0.00082,172.217.194.0-255,1484,70700,90,202020
14505,0.000823,172.31.47.0-255,66,70766,90,202020
14506,0.00085,172.217.194.0-255,5738,76504,90,202020
14507,0.000853,172.31.47.0-255,66,76570,90,202020
14508,0.000883,172.217.194.0-255,6797,83367,90,202020
14509,0.000886,172.31.47.0-255,66,83433,90,202020
14510,0.000954,172.217.194.0-255,2902,86335,90,202020
14511,0.000958,172.31.47.0-255,66,86401,90,202020
14512,0.000974,172.217.194.0-255,4320,90721,90,202020
14513,0.000976,172.31.47.0-255,66,90787,90,202020
14514,0.001034,172.217.194.0-255,7156,97943,90,202020
14515,0.001038,172.31.47.0-255,66,98009,90,202020
14516,0.001066,172.217.194.0-255,2543,100552,90,202020
14517,0.001069,172.31.47.0-255,66,100618,90,202020
14518,0.001356,172.217.194.0-255,1484,102102,90,202020
14519,0.001361,172.31.47.0-255,66,102168,90,202020
14520,0.001367,172.217.194.0-255,2902,105070,90,202020
14521,0.001368,172.31.47.0-255,66,105136,90,202020
14522,0.001399,172.217.194.0-255,5738,110874,90,202020
14523,0.001401,172.31.47.0-255,66,110940,90,202020
14524,0.001448,172.217.194.0-255,7156,118096,90,202020
14525,0.001451,172.31.47.0-255,66,118162,90,202020
14526,0.001478,172.217.194.0-255,5738,123900,90,202020
14527,0.001481,172.31.47.0-255,66,123966,90,202020
14528,0.001601,172.217.194.0-255,7156,131122,90,202020
14529,0.00161,172.31.47.0-255,66,131188,90,202020
14530,0.001632,172.217.194.0-255,6438,137626,90,202020
14531,0.001644,172.31.47.0-255,66,137692,90,202020
14532,0.001712,172.217.194.0-255,5738,143430,90,202020
14533,0.001716,172.31.47.0-255,66,143496,90,202020
14534,0.00174,172.217.194.0-255,8574,152070,90,202020
14535,0.001758,172.31.47.0-255,66,152136,90,202020
14536,0.001867,172.217.194.0-255,5738,157874,90,202020
14537,0.001871,172.31.47.0-255,66,157940,90,202020
14538,0.001907,172.217.194.0-255,10692,168632,90,202020
14539,0.001912,172.31.47.0-255,66,168698,90,202020
14540,0.002044,172.217.194.0-255,9992,178690,90,202020
14541,0.002065,172.31.47.0-255,66,178756,90,202020
14542,0.002075,172.217.194.0-255,9992,188748,90,202020
14543,0.002087,172.31.47.0-255,66,188814,90,202020
14544,0.002247,172.217.194.0-255,5738,194552,90,202020
14545,0.002254,172.31.47.0-255,66,194618,90,202020
14546,0.00234,172.31.47.0-255,66,194684,90,202020
14547,0.002649,172.217.194.0-255,5738,200422,90,202020
14548,0.002653,172.31.47.0-255,66,200488,90,202020
14549,0.002751,172.217.194.0-255,1466,201954,90,202020
14550,0.007817,172.31.47.0-255,66,202020,90,202020
14551,0.0,74.125.68.0-255,153,153,90,138924
14552,2.8e-05,172.31.47.0-255,66,219,90,138924
14553,3.6e-05,74.125.68.0-255,1484,1703,90,138924
14554,4.1e-05,172.31.47.0-255,66,1769,90,138924
14555,4.8e-05,74.125.68.0-255,2902,4671,90,138924
14556,5.9e-05,172.31.47.0-255,66,4737,90,138924
14557,6.6e-05,74.125.68.0-255,5738,10475,90,138924
14558,7e-05,172.31.47.0-255,66,10541,90,138924
14559,0.000114,74.125.68.0-255,6355,16896,90,138924
14560,0.000117,172.31.47.0-255,66,16962,90,138924
14561,0.000125,74.125.68.0-255,7156,24118,90,138924
14562,0.000127,172.31.47.0-255,66,24184,90,138924
14563,0.000176,74.125.68.0-255,2902,27086,90,138924
14564,0.000179,172.31.47.0-255,66,27152,90,138924
14565,0.000196,74.125.68.0-255,1484,28636,90,138924
14566,0.000199,172.31.47.0-255,66,28702,90,138924
14567,0.000226,74.125.68.0-255,2543,31245,90,138924
14568,0.000228,172.31.47.0-255,66,31311,90,138924
14569,0.000554,74.125.68.0-255,1484,32795,90,138924
14570,0.000562,172.31.47.0-255,66,32861,90,138924
14571,0.000569,74.125.68.0-255,2902,35763,90,138924
14572,0.000571,172.31.47.0-255,66,35829,90,138924
14573,0.000582,74.125.68.0-255,5738,41567,90,138924
14574,0.000585,172.31.47.0-255,66,41633,90,138924
14575,0.000588,74.125.68.0-255,1484,43117,90,138924
14576,0.00059,172.31.47.0-255,66,43183,90,138924
14577,0.000595,74.125.68.0-255,2902,46085,90,138924
14578,0.000597,172.31.47.0-255,66,46151,90,138924
14579,0.00063,74.125.68.0-255,2543,48694,90,138924
14580,0.000633,172.31.47.0-255,66,48760,90,138924
14581,0.000657,74.125.68.0-255,2902,51662,90,138924
14582,0.00066,172.31.47.0-255,66,51728,90,138924
14583,0.000688,74.125.68.0-255,5738,57466,90,138924
14584,0.000696,74.125.68.0-255,7156,64622,90,138924
14585,0.000701,172.31.47.0-255,66,64688,90,138924
14586,0.000709,172.31.47.0-255,66,64754,90,138924
14587,0.000713,74.125.68.0-255,1434,66188,90,138924
14588,0.000761,74.125.68.0-255,112,66300,90,138924
14589,0.001235,74.125.68.0-255,1484,67784,90,138924
14590,0.00124,172.31.47.0-255,66,67850,90,138924
14591,0.001245,74.125.68.0-255,1484,69334,90,138924
14592,0.001268,74.125.68.0-255,1484,70818,90,138924
14593,0.001271,172.31.47.0-255,66,70884,90,138924
14594,0.001279,74.125.68.0-255,5738,76622,90,138924
14595,0.001281,172.31.47.0-255,66,76688,90,138924
14596,0.001286,74.125.68.0-255,4320,81008,90,138924
14597,0.001288,172.31.47.0-255,66,81074,90,138924
14598,0.001291,74.125.68.0-255,1484,82558,90,138924
14599,0.001326,74.125.68.0-255,4320,86878,90,138924
14600,0.001329,172.31.47.0-255,66,86944,90,138924
14601,0.001338,74.125.68.0-255,8574,95518,90,138924
14602,0.00134,172.31.47.0-255,66,95584,90,138924
14603,0.001367,74.125.68.0-255,1484,97068,90,138924
14604,0.001374,74.125.68.0-255,3602,100670,90,138924
14605,0.001376,172.31.47.0-255,66,100736,90,138924
14606,0.002137,74.125.68.0-255,1484,102220,90,138924
14607,0.002153,74.125.68.0-255,2902,105122,90,138924
14608,0.002159,172.31.47.0-255,66,105188,90,138924
14609,0.002166,74.125.68.0-255,2902,108090,90,138924
14610,0.002168,172.31.47.0-255,66,108156,90,138924
14611,0.002195,74.125.68.0-255,2902,111058,90,138924
14612,0.002198,172.31.47.0-255,66,111124,90,138924
14613,0.002205,74.125.68.0-255,5738,116862,90,138924
14614,0.002207,172.31.47.0-255,66,116928,90,138924
14615,0.002245,74.125.68.0-255,5738,122666,90,138924
14616,0.002247,172.31.47.0-255,66,122732,90,138924
14617,0.002262,172.31.47.0-255,66,122798,90,138924
14618,0.002346,74.125.68.0-255,1484,124282,90,138924
14619,0.004586,74.125.68.0-255,4320,128602,90,138924
14620,0.004602,172.31.47.0-255,66,128668,90,138924
14621,0.006946,74.125.68.0-255,4320,132988,90,138924
14622,0.006959,172.31.47.0-255,66,133054,90,138924
14623,0.006986,74.125.68.0-255,1484,134538,90,138924
14624,0.009288,74.125.68.0-255,4320,138858,90,138924
14625,0.009306,172.31.47.0-255,66,138924,90,138924
14626,0.0,74.125.24.0-255,162,162,90,223405
14627,1.9e-05,172.31.47.0-255,66,228,90,223405
14628,2.5e-05,74.125.24.0-255,1484,1712,90,223405
14629,2.9e-05,172.31.47.0-255,66,1778,90,223405
14630,3.3e-05,74.125.24.0-255,2902,4680,90,223405
14631,3.5e-05,172.31.47.0-255,66,4746,90,223405
14632,4.9e-05,74.125.24.0-255,7156,11902,90,223405
14633,5.2e-05,172.31.47.0-255,66,11968,90,223405
14634,9.1e-05,74.125.24.0-255,9992,21960,90,223405
14635,9.5e-05,172.31.47.0-255,66,22026,90,223405
14636,0.000116,74.125.24.0-255,6214,28240,90,223405
14637,0.000119,172.31.47.0-255,66,28306,90,223405
14638,0.000123,74.125.24.0-255,2902,31208,90,223405
14639,0.000125,172.31.47.0-255,66,31274,90,223405
14640,0.000175,172.31.47.0-255,66,31340,90,223405
14641,0.000178,74.125.24.0-255,1484,32824,90,223405
14642,0.000179,172.31.47.0-255,66,32890,90,223405
14643,0.000184,74.125.24.0-255,2902,35792,90,223405
14644,0.000186,172.31.47.0-255,66,35858,90,223405
14645,0.000198,74.125.24.0-255,5738,41596,90,223405
14646,0.000202,172.31.47.0-255,66,41662,90,223405
14647,0.000238,74.125.24.0-255,7108,48770,90,223405
14648,0.000243,172.31.47.0-255,66,48836,90,223405
14649,0.000426,74.125.24.0-255,345,49181,90,223405
14650,0.00043,172.31.47.0-255,66,49247,90,223405
14651,0.000652,74.125.24.0-255,1484,50731,90,223405
14652,0.000657,172.31.47.0-255,66,50797,90,223405
14653,0.000663,74.125.24.0-255,2902,53699,90,223405
14654,0.000665,172.31.47.0-255,66,53765,90,223405
14655,0.000695,74.125.24.0-255,5738,59503,90,223405
14656,0.0007,172.31.47.0-255,66,59569,90,223405
14657,0.000708,172.31.47.0-255,66,59635,90,223405
14658,0.000724,74.125.24.0-255,1484,61119,90,223405
14659,0.000758,74.125.24.0-255,9274,70393,90,223405
14660,0.000762,172.31.47.0-255,66,70459,90,223405
14661,0.001065,74.125.24.0-255,1484,71943,90,223405
14662,0.001083,74.125.24.0-255,2902,74845,90,223405
14663,0.001088,172.31.47.0-255,66,74911,90,223405
14664,0.001094,74.125.24.0-255,5738,80649,90,223405
14665,0.001096,172.31.47.0-255,66,80715,90,223405
14666,0.001144,74.125.24.0-255,4320,85035,90,223405
14667,0.001148,172.31.47.0-255,66,85101,90,223405
14668,0.00118,74.125.24.0-255,8574,93675,90,223405
14669,0.001185,172.31.47.0-255,66,93741,90,223405
14670,0.00122,74.125.24.0-255,10692,104433,90,223405
14671,0.001223,172.31.47.0-255,66,104499,90,223405
14672,0.001248,74.125.24.0-255,1484,105983,90,223405
14673,0.001254,74.125.24.0-255,2902,108885,90,223405
14674,0.001257,74.125.24.0-255,2902,111787,90,223405
14675,0.001257,172.31.47.0-255,66,111853,90,223405
14676,0.001261,172.31.47.0-255,66,111919,90,223405
14677,0.001282,74.125.24.0-255,2902,114821,90,223405
14678,0.00129,172.31.47.0-255,66,114887,90,223405
14679,0.001295,74.125.24.0-255,4320,119207,90,223405
14680,0.001297,74.125.24.0-255,1484,120691,90,223405
14681,0.001299,172.31.47.0-255,66,120757,90,223405
14682,0.001334,74.125.24.0-255,9992,130749,90,223405
14683,0.001338,172.31.47.0-255,66,130815,90,223405
14684,0.001345,74.125.24.0-255,5738,136553,90,223405
14685,0.001348,172.31.47.0-255,66,136619,90,223405
14686,0.001386,74.125.24.0-255,2184,138803,90,223405
14687,0.001389,172.31.47.0-255,66,138869,90,223405
14688,0.001842,74.125.24.0-255,1484,140353,90,223405
14689,0.001851,74.125.24.0-255,2902,143255,90,223405
14690,0.001854,172.31.47.0-255,66,143321,90,223405
14691,0.001881,74.125.24.0-255,5738,149059,90,223405
14692,0.001884,172.31.47.0-255,66,149125,90,223405
14693,0.001889,74.125.24.0-255,2902,152027,90,223405
14694,0.00189,172.31.47.0-255,66,152093,90,223405
14695,0.001912,74.125.24.0-255,8574,160667,90,223405
14696,0.001915,172.31.47.0-255,66,160733,90,223405
14697,0.001933,74.125.24.0-255,1484,162217,90,223405
14698,0.00194,74.125.24.0-255,7156,169373,90,223405
14699,0.001942,172.31.47.0-255,66,169439,90,223405
14700,0.00197,74.125.24.0-255,3602,173041,90,223405
14701,0.001973,172.31.47.0-255,66,173107,90,223405
14702,0.002184,74.125.24.0-255,1484,174591,90,223405
14703,0.002204,74.125.24.0-255,2902,177493,90,223405
14704,0.002207,172.31.47.0-255,66,177559,90,223405
14705,0.002213,74.125.24.0-255,4320,181879,90,223405
14706,0.002214,172.31.47.0-255,66,181945,90,223405
14707,0.002229,74.125.24.0-255,1484,183429,90,223405
14708,0.002248,74.125.24.0-255,4320,187749,90,223405
14709,0.00225,172.31.47.0-255,66,187815,90,223405
14710,0.002274,74.125.24.0-255,7156,194971,90,223405
14711,0.002276,172.31.47.0-255,66,195037,90,223405
14712,0.00228,74.125.24.0-255,4320,199357,90,223405
14713,0.002282,172.31.47.0-255,66,199423,90,223405
14714,0.002309,74.125.24.0-255,7856,207279,90,223405
14715,0.00231,172.31.47.0-255,66,207345,90,223405
14716,0.004587,74.125.24.0-255,4320,211665,90,223405
14717,0.004592,172.31.47.0-255,66,211731,90,223405
14718,0.004615,74.125.24.0-255,1484,213215,90,223405
14719,0.006876,74.125.24.0-255,4320,217535,90,223405
14720,0.006882,172.31.47.0-255,66,217601,90,223405
14721,0.00917,74.125.24.0-255,5738,223339,90,223405
14722,0.009178,172.31.47.0-255,66,223405,90,223405
14723,0.0,172.31.47.0-255,105,105,90,276
14724,0.001807,157.240.13.0-255,105,210,90,276
14725,0.001818,172.31.47.0-255,66,276,90,276
14726,0.0,74.125.68.0-255,153,153,90,226125
14727,2.8e-05,172.31.47.0-255,66,219,90,226125
14728,4.8e-05,74.125.68.0-255,1484,1703,90,226125
14729,5.2e-05,172.31.47.0-255,66,1769,90,226125
14730,5.8e-05,74.125.68.0-255,2902,4671,90,226125
14731,6.1e-05,172.31.47.0-255,66,4737,90,226125
14732,8.1e-05,74.125.68.0-255,2902,7639,90,226125
14733,8.4e-05,172.31.47.0-255,66,7705,90,226125
14734,9.7e-05,74.125.68.0-255,2902,10607,90,226125
14735,9.9e-05,172.31.47.0-255,66,10673,90,226125
14736,0.000102,74.125.68.0-255,1484,12157,90,226125
14737,0.000104,172.31.47.0-255,66,12223,90,226125
14738,0.00015,74.125.68.0-255,6463,18686,90,226125
14739,0.000153,172.31.47.0-255,66,18752,90,226125
14740,0.000181,74.125.68.0-255,7156,25908,90,226125
14741,0.000184,172.31.47.0-255,66,25974,90,226125
14742,0.000204,74.125.68.0-255,2902,28876,90,226125
14743,0.000206,172.31.47.0-255,66,28942,90,226125
14744,0.000217,74.125.68.0-255,1484,30426,90,226125
14745,0.00022,172.31.47.0-255,66,30492,90,226125
14746,0.000237,74.125.68.0-255,2902,33394,90,226125
14747,0.000239,172.31.47.0-255,66,33460,90,226125
14748,0.000266,74.125.68.0-255,7156,40616,90,226125
14749,0.000269,172.31.47.0-255,66,40682,90,226125
14750,0.000293,74.125.68.0-255,1484,42166,90,226125
14751,0.000297,172.31.47.0-255,66,42232,90,226125
14752,0.000318,74.125.68.0-255,2902,45134,90,226125
14753,0.00032,172.31.47.0-255,66,45200,90,226125
14754,0.000349,74.125.68.0-255,3602,48802,90,226125
14755,0.000353,172.31.47.0-255,66,48868,90,226125
14756,0.000668,74.125.68.0-255,1484,50352,90,226125
14757,0.000672,172.31.47.0-255,66,50418,90,226125
14758,0.000677,74.125.68.0-255,2902,53320,90,226125
14759,0.000679,172.31.47.0-255,66,53386,90,226125
14760,0.000695,74.125.68.0-255,5738,59124,90,226125
14761,0.000698,172.31.47.0-255,66,59190,90,226125
14762,0.000729,74.125.68.0-255,5738,64928,90,226125
14763,0.000732,172.31.47.0-255,66,64994,90,226125
14764,0.000749,74.125.68.0-255,1705,66699,90,226125
14765,0.000751,172.31.47.0-255,66,66765,90,226125
14766,0.000914,74.125.68.0-255,1484,68249,90,226125
14767,0.000922,74.125.68.0-255,1484,69733,90,226125
14768,0.000925,172.31.47.0-255,66,69799,90,226125
14769,0.000943,74.125.68.0-255,2902,72701,90,226125
14770,0.000946,172.31.47.0-255,66,72767,90,226125
14771,0.00095,74.125.68.0-255,1484,74251,90,226125
14772,0.000969,74.125.68.0-255,4320,78571,90,226125
14773,0.000972,172.31.47.0-255,66,78637,90,226125
14774,0.000986,74.125.68.0-255,4320,82957,90,226125
14775,0.000989,172.31.47.0-255,66,83023,90,226125
14776,0.001013,74.125.68.0-255,4320,87343,90,226125
14777,0.001016,172.31.47.0-255,66,87409,90,226125
14778,0.001023,74.125.68.0-255,7156,94565,90,226125
14779,0.001025,172.31.47.0-255,66,94631,90,226125
14780,0.001041,74.125.68.0-255,2902,97533,90,226125
14781,0.001044,172.31.47.0-255,66,97599,90,226125
14782,0.001047,74.125.68.0-255,1484,99083,90,226125
14783,0.00105,74.125.68.0-255,2184,101267,90,226125
14784,0.001052,172.31.47.0-255,66,101333,90,226125
14785,0.001111,74.125.68.0-255,1484,102817,90,226125
14786,0.001117,74.125.68.0-255,2902,105719,90,226125
14787,0.001119,172.31.47.0-255,66,105785,90,226125
14788,0.001122,74.125.68.0-255,1484,107269,90,226125
14789,0.001142,74.125.68.0-255,4320,111589,90,226125
14790,0.001145,172.31.47.0-255,66,111655,90,226125
14791,0.001152,74.125.68.0-255,7156,118811,90,226125
14792,0.001154,172.31.47.0-255,66,118877,90,226125
14793,0.001186,74.125.68.0-255,4320,123197,90,226125
14794,0.00119,172.31.47.0-255,66,123263,90,226125
14795,0.00121,74.125.68.0-255,2902,126165,90,226125
14796,0.001212,172.31.47.0-255,66,126231,90,226125
14797,0.00122,74.125.68.0-255,8574,134805,90,226125
14798,0.001222,172.31.47.0-255,66,134871,90,226125
14799,0.001225,74.125.68.0-255,766,135637,90,226125
14800,0.001257,74.125.68.0-255,1484,137121,90,226125
14801,0.001262,172.31.47.0-255,66,137187,90,226125
14802,0.001282,74.125.68.0-255,4320,141507,90,226125
14803,0.001285,172.31.47.0-255,66,141573,90,226125
14804,0.001288,74.125.68.0-255,1484,143057,90,226125
14805,0.001307,74.125.68.0-255,2902,145959,90,226125
14806,0.00131,172.31.47.0-255,66,146025,90,226125
14807,0.00133,74.125.68.0-255,5738,151763,90,226125
14808,0.001333,172.31.47.0-255,66,151829,90,226125
14809,0.001335,74.125.68.0-255,576,152405,90,226125
14810,0.001397,74.125.68.0-255,1484,153889,90,226125
14811,0.001402,172.31.47.0-255,66,153955,90,226125
14812,0.001409,74.125.68.0-255,2902,156857,90,226125
14813,0.001411,172.31.47.0-255,66,156923,90,226125
14814,0.001425,74.125.68.0-255,2902,159825,90,226125
14815,0.001427,172.31.47.0-255,66,159891,90,226125
14816,0.001442,74.125.68.0-255,2902,162793,90,226125
14817,0.001444,172.31.47.0-255,66,162859,90,226125
14818,0.001449,74.125.68.0-255,5738,168597,90,226125
14819,0.001451,172.31.47.0-255,66,168663,90,226125
14820,0.001499,74.125.68.0-255,7156,175819,90,226125
14821,0.001501,172.31.47.0-255,66,175885,90,226125
14822,0.001503,74.125.68.0-255,1484,177369,90,226125
14823,0.001516,74.125.68.0-255,2902,180271,90,226125
14824,0.001518,172.31.47.0-255,66,180337,90,226125
14825,0.001563,74.125.68.0-255,5738,186075,90,226125
14826,0.001565,172.31.47.0-255,66,186141,90,226125
14827,0.001568,74.125.68.0-255,766,186907,90,226125
14828,0.002082,74.125.68.0-255,1484,188391,90,226125
14829,0.002085,172.31.47.0-255,66,188457,90,226125
14830,0.00209,74.125.68.0-255,2902,191359,90,226125
14831,0.002092,172.31.47.0-255,66,191425,90,226125
14832,0.002102,74.125.68.0-255,1484,192909,90,226125
14833,0.002121,74.125.68.0-255,4320,197229,90,226125
14834,0.002123,172.31.47.0-255,66,197295,90,226125
14835,0.002128,74.125.68.0-255,4320,201615,90,226125
14836,0.002129,172.31.47.0-255,66,201681,90,226125
14837,0.002143,74.125.68.0-255,2902,204583,90,226125
14838,0.002145,172.31.47.0-255,66,204649,90,226125
14839,0.002161,74.125.68.0-255,1484,206133,90,226125
14840,0.002193,172.31.47.0-255,66,206199,90,226125
14841,0.002216,74.125.68.0-255,2902,209101,90,226125
14842,0.002218,172.31.47.0-255,66,209167,90,226125
14843,0.002228,74.125.68.0-255,766,209933,90,226125
14844,0.002407,172.31.47.0-255,66,209999,90,226125
14845,0.004373,74.125.68.0-255,1484,211483,90,226125
14846,0.004402,74.125.68.0-255,2902,214385,90,226125
14847,0.004405,172.31.47.0-255,66,214451,90,226125
14848,0.004595,74.125.68.0-255,1484,215935,90,226125
14849,0.006622,74.125.68.0-255,4320,220255,90,226125
14850,0.006628,172.31.47.0-255,66,220321,90,226125
14851,0.008843,74.125.68.0-255,5738,226059,90,226125
14852,0.00885,172.31.47.0-255,66,226125,90,226125
14853,0.0,172.217.194.0-255,153,153,90,94516
14854,3.2e-05,172.31.47.0-255,66,219,90,94516
14855,4.8e-05,172.217.194.0-255,1484,1703,90,94516
14856,5.2e-05,172.31.47.0-255,66,1769,90,94516
14857,6.9e-05,172.217.194.0-255,2902,4671,90,94516
14858,7.1e-05,172.31.47.0-255,66,4737,90,94516
14859,8.7e-05,172.217.194.0-255,2902,7639,90,94516
14860,8.9e-05,172.31.47.0-255,66,7705,90,94516
14861,0.000105,172.217.194.0-255,1484,9189,90,94516
14862,0.000107,172.31.47.0-255,66,9255,90,94516
14863,0.000144,172.217.194.0-255,5045,14300,90,94516
14864,0.000147,172.31.47.0-255,66,14366,90,94516
14865,0.000179,172.217.194.0-255,5738,20104,90,94516
14866,0.000181,172.31.47.0-255,66,20170,90,94516
14867,0.000222,172.31.47.0-255,66,20236,90,94516
14868,0.00027,172.217.194.0-255,1484,21720,90,94516
14869,0.000273,172.31.47.0-255,66,21786,90,94516
14870,0.00029,172.217.194.0-255,1484,23270,90,94516
14871,0.000293,172.31.47.0-255,66,23336,90,94516
14872,0.000306,172.217.194.0-255,1484,24820,90,94516
14873,0.000309,172.31.47.0-255,66,24886,90,94516
14874,0.000324,172.217.194.0-255,4320,29206,90,94516
14875,0.000327,172.31.47.0-255,66,29272,90,94516
14876,0.000361,172.217.194.0-255,4320,33592,90,94516
14877,0.000364,172.31.47.0-255,66,33658,90,94516
14878,0.000377,172.217.194.0-255,3961,37619,90,94516
14879,0.00038,172.31.47.0-255,66,37685,90,94516
14880,0.002037,172.217.194.0-255,1484,39169,90,94516
14881,0.002043,172.31.47.0-255,66,39235,90,94516
14882,0.002075,172.217.194.0-255,2902,42137,90,94516
14883,0.002077,172.31.47.0-255,66,42203,90,94516
14884,0.002096,172.217.194.0-255,2902,45105,90,94516
14885,0.002102,172.217.194.0-255,4320,49425,90,94516
14886,0.002142,172.217.194.0-255,4320,53745,90,94516
14887,0.002155,172.217.194.0-255,2543,56288,90,94516
14888,0.002157,172.217.194.0-255,1484,57772,90,94516
14889,0.002169,172.217.194.0-255,5738,63510,90,94516
14890,0.002198,172.217.194.0-255,2902,66412,90,94516
14891,0.002215,172.217.194.0-255,5738,72150,90,94516
14892,0.002227,172.217.194.0-255,4320,76470,90,94516
14893,0.002247,172.217.194.0-255,4320,80790,90,94516
14894,0.002269,172.217.194.0-255,7856,88646,90,94516
14895,0.005422,172.31.47.0-255,66,88712,90,94516
14896,0.007937,172.217.194.0-255,5738,94450,90,94516
14897,0.008007,172.31.47.0-255,66,94516,90,94516
14898,0.0,172.31.47.0-255,66,66,90,66
14899,0.0,172.31.47.0-255,171,171,90,10557
14900,2.7e-05,172.31.47.0-255,1140,1311,90,10557
14901,8.7e-05,172.31.47.0-255,1514,2825,90,10557
14902,8.9e-05,172.31.47.0-255,1514,4339,90,10557
14903,9.4e-05,172.31.47.0-255,1514,5853,90,10557
14904,9.5e-05,172.31.47.0-255,1514,7367,90,10557
14905,0.000112,172.31.47.0-255,1514,8881,90,10557
14906,0.000113,172.31.47.0-255,1412,10293,90,10557
14907,0.001548,104.244.42.0-255,66,10359,90,10557
14908,0.00156,104.244.42.0-255,66,10425,90,10557
14909,0.001606,104.244.42.0-255,66,10491,90,10557
14910,0.001651,104.244.42.0-255,66,10557,90,10557
14911,0.0,74.125.24.0-255,298,298,90,122668
14912,2.3e-05,172.31.47.0-255,66,364,90,122668
14913,2.8e-05,74.125.24.0-255,1484,1848,90,122668
14914,3.2e-05,172.31.47.0-255,66,1914,90,122668
14915,3.9e-05,74.125.24.0-255,4320,6234,90,122668
14916,4.2e-05,172.31.47.0-255,66,6300,90,122668
14917,7.8e-05,74.125.24.0-255,2902,9202,90,122668
14918,8e-05,172.31.47.0-255,66,9268,90,122668
14919,0.000102,74.125.24.0-255,4803,14071,90,122668
14920,0.000104,172.31.47.0-255,66,14137,90,122668
14921,0.000318,74.125.24.0-255,1484,15621,90,122668
14922,0.000322,172.31.47.0-255,66,15687,90,122668
14923,0.000327,74.125.24.0-255,2902,18589,90,122668
14924,0.00033,172.31.47.0-255,66,18655,90,122668
14925,0.000343,74.125.24.0-255,1484,20139,90,122668
14926,0.000345,172.31.47.0-255,66,20205,90,122668
14927,0.000357,74.125.24.0-255,1484,21689,90,122668
14928,0.000359,172.31.47.0-255,66,21755,90,122668
14929,0.000372,74.125.24.0-255,1484,23239,90,122668
14930,0.000374,172.31.47.0-255,66,23305,90,122668
14931,0.000393,74.125.24.0-255,1484,24789,90,122668
14932,0.000396,172.31.47.0-255,66,24855,90,122668
14933,0.000411,74.125.24.0-255,1484,26339,90,122668
14934,0.000413,172.31.47.0-255,66,26405,90,122668
14935,0.000436,74.125.24.0-255,5379,31784,90,122668
14936,0.000438,172.31.47.0-255,66,31850,90,122668
14937,0.00047,74.125.24.0-255,1484,33334,90,122668
14938,0.000472,172.31.47.0-255,66,33400,90,122668
14939,0.000477,74.125.24.0-255,1484,34884,90,122668
14940,0.000479,172.31.47.0-255,66,34950,90,122668
14941,0.00049,74.125.24.0-255,1484,36434,90,122668
14942,0.000492,172.31.47.0-255,66,36500,90,122668
14943,0.000497,74.125.24.0-255,4320,40820,90,122668
14944,0.000499,172.31.47.0-255,66,40886,90,122668
14945,0.00051,74.125.24.0-255,1484,42370,90,122668
14946,0.000529,74.125.24.0-255,1484,43854,90,122668
14947,0.000531,172.31.47.0-255,66,43920,90,122668
14948,0.000554,74.125.24.0-255,7156,51076,90,122668
14949,0.000556,172.31.47.0-255,66,51142,90,122668
14950,0.000577,74.125.24.0-255,5379,56521,90,122668
14951,0.00058,172.31.47.0-255,66,56587,90,122668
14952,0.000585,74.125.24.0-255,4320,60907,90,122668
14953,0.000586,172.31.47.0-255,66,60973,90,122668
14954,0.000597,74.125.24.0-255,1484,62457,90,122668
14955,0.000611,74.125.24.0-255,1484,63941,90,122668
14956,0.000613,172.31.47.0-255,66,64007,90,122668
14957,0.00063,74.125.24.0-255,2839,66846,90,122668
14958,0.000632,172.31.47.0-255,66,66912,90,122668
14959,0.00069,74.125.24.0-255,131,67043,90,122668
14960,0.000919,74.125.24.0-255,347,67390,90,122668
14961,0.00097,172.31.47.0-255,66,67456,90,122668
14962,0.00139,74.125.24.0-255,1484,68940,90,122668
14963,0.001401,74.125.24.0-255,2902,71842,90,122668
14964,0.001406,172.31.47.0-255,66,71908,90,122668
14965,0.001411,74.125.24.0-255,1484,73392,90,122668
14966,0.00143,74.125.24.0-255,4320,77712,90,122668
14967,0.001432,172.31.47.0-255,66,77778,90,122668
14968,0.001465,74.125.24.0-255,1484,79262,90,122668
14969,0.00148,74.125.24.0-255,5738,85000,90,122668
14970,0.001483,172.31.47.0-255,66,85066,90,122668
14971,0.001505,74.125.24.0-255,5738,90804,90,122668
14972,0.001508,172.31.47.0-255,66,90870,90,122668
14973,0.001518,74.125.24.0-255,9992,100862,90,122668
14974,0.00152,172.31.47.0-255,66,100928,90,122668
14975,0.001533,74.125.24.0-255,766,101694,90,122668
14976,0.001828,172.31.47.0-255,66,101760,90,122668
14977,0.003559,74.125.24.0-255,2902,104662,90,122668
14978,0.003565,172.31.47.0-255,66,104728,90,122668
14979,0.003582,74.125.24.0-255,1484,106212,90,122668
14980,0.003887,74.125.24.0-255,1484,107696,90,122668
14981,0.003891,172.31.47.0-255,66,107762,90,122668
14982,0.00563,74.125.24.0-255,2902,110664,90,122668
14983,0.005635,172.31.47.0-255,66,110730,90,122668
14984,0.005933,74.125.24.0-255,1484,112214,90,122668
14985,0.005951,74.125.24.0-255,1484,113698,90,122668
14986,0.005954,172.31.47.0-255,66,113764,90,122668
14987,0.007675,74.125.24.0-255,2902,116666,90,122668
14988,0.007681,172.31.47.0-255,66,116732,90,122668
14989,0.007998,74.125.24.0-255,2902,119634,90,122668
14990,0.008004,172.31.47.0-255,66,119700,90,122668
14991,0.009744,74.125.24.0-255,2902,122602,90,122668
14992,0.009751,172.31.47.0-255,66,122668,90,122668
14993,0.0,172.217.194.0-255,153,153,90,310382
14994,1.5e-05,172.31.47.0-255,66,219,90,310382
14995,2.1e-05,172.217.194.0-255,1484,1703,90,310382
14996,2.7e-05,172.31.47.0-255,66,1769,90,310382
14997,4e-05,172.217.194.0-255,2902,4671,90,310382
14998,4.4e-05,172.31.47.0-255,66,4737,90,310382
14999,8e-05,172.217.194.0-255,5738,10475,90,310382
15000,8.4e-05,172.31.47.0-255,66,10541,90,310382
15001,9e-05,172.217.194.0-255,4320,14861,90,310382
15002,9.2e-05,172.31.47.0-255,66,14927,90,310382
15003,0.000123,172.217.194.0-255,2093,17020,90,310382
15004,0.000125,172.31.47.0-255,66,17086,90,310382
15005,0.00013,172.217.194.0-255,2902,19988,90,310382
15006,0.000132,172.31.47.0-255,66,20054,90,310382
15007,0.000174,172.31.47.0-255,66,20120,90,310382
15008,0.000219,172.217.194.0-255,1484,21604,90,310382
15009,0.000222,172.31.47.0-255,66,21670,90,310382
15010,0.000227,172.217.194.0-255,2902,24572,90,310382
15011,0.000229,172.31.47.0-255,66,24638,90,310382
15012,0.000232,172.217.194.0-255,1484,26122,90,310382
15013,0.000235,172.31.47.0-255,66,26188,90,310382
15014,0.000264,172.217.194.0-255,4320,30508,90,310382
15015,0.000266,172.31.47.0-255,66,30574,90,310382
15016,0.000269,172.217.194.0-255,1484,32058,90,310382
15017,0.000271,172.31.47.0-255,66,32124,90,310382
15018,0.000316,172.217.194.0-255,8215,40339,90,310382
15019,0.000319,172.31.47.0-255,66,40405,90,310382
15020,0.000328,172.217.194.0-255,9992,50397,90,310382
15021,0.000336,172.31.47.0-255,66,50463,90,310382
15022,0.000341,172.217.194.0-255,4215,54678,90,310382
15023,0.000343,172.31.47.0-255,66,54744,90,310382
15024,0.000374,172.217.194.0-255,116,54860,90,310382
15025,0.00045,172.217.194.0-255,1484,56344,90,310382
15026,0.000454,172.31.47.0-255,66,56410,90,310382
15027,0.00046,172.217.194.0-255,2902,59312,90,310382
15028,0.000462,172.31.47.0-255,66,59378,90,310382
15029,0.000496,172.217.194.0-255,7156,66534,90,310382
15030,0.0005,172.31.47.0-255,66,66600,90,310382
15031,0.00053,172.217.194.0-255,4320,70920,90,310382
15032,0.000533,172.31.47.0-255,66,70986,90,310382
15033,0.000563,172.217.194.0-255,1125,72111,90,310382
15034,0.00057,172.217.194.0-255,5738,77849,90,310382
15035,0.000572,172.31.47.0-255,66,77915,90,310382
15036,0.000576,172.217.194.0-255,1484,79399,90,310382
15037,0.000604,172.217.194.0-255,9949,89348,90,310382
15038,0.000607,172.31.47.0-255,66,89414,90,310382
15039,0.00069,172.217.194.0-255,1484,90898,90,310382
15040,0.000695,172.217.194.0-255,2902,93800,90,310382
15041,0.000724,172.31.47.0-255,66,93866,90,310382
15042,0.000734,172.217.194.0-255,5738,99604,90,310382
15043,0.000736,172.31.47.0-255,66,99670,90,310382
15044,0.000746,172.217.194.0-255,7156,106826,90,310382
15045,0.000749,172.31.47.0-255,66,106892,90,310382
15046,0.000751,172.217.194.0-255,1484,108376,90,310382
15047,0.000797,172.217.194.0-255,2184,110560,90,310382
15048,0.000801,172.31.47.0-255,66,110626,90,310382
15049,0.000809,172.31.47.0-255,66,110692,90,310382
15050,0.00108,172.217.194.0-255,1484,112176,90,310382
15051,0.001085,172.217.194.0-255,2902,115078,90,310382
15052,0.001088,172.31.47.0-255,66,115144,90,310382
15053,0.001093,172.217.194.0-255,2902,118046,90,310382
15054,0.001095,172.31.47.0-255,66,118112,90,310382
15055,0.001113,172.217.194.0-255,2902,121014,90,310382
15056,0.001115,172.31.47.0-255,66,121080,90,310382
15057,0.001142,172.217.194.0-255,5738,126818,90,310382
15058,0.001144,172.31.47.0-255,66,126884,90,310382
15059,0.001172,172.217.194.0-255,7156,134040,90,310382
15060,0.001175,172.31.47.0-255,66,134106,90,310382
15061,0.001202,172.217.194.0-255,10692,144798,90,310382
15062,0.001205,172.31.47.0-255,66,144864,90,310382
15063,0.001228,172.217.194.0-255,1484,146348,90,310382
15064,0.00124,172.217.194.0-255,1484,147832,90,310382
15065,0.001242,172.31.47.0-255,66,147898,90,310382
15066,0.001254,172.217.194.0-255,1484,149382,90,310382
15067,0.001263,172.217.194.0-255,5738,155120,90,310382
15068,0.001265,172.31.47.0-255,66,155186,90,310382
15069,0.00127,172.217.194.0-255,4320,159506,90,310382
15070,0.001272,172.31.47.0-255,66,159572,90,310382
15071,0.001286,172.217.194.0-255,8574,168146,90,310382
15072,0.001294,172.31.47.0-255,66,168212,90,310382
15073,0.0013,172.217.194.0-255,5738,173950,90,310382
15074,0.001302,172.31.47.0-255,66,174016,90,310382
15075,0.001343,172.217.194.0-255,1484,175500,90,310382
15076,0.001368,172.217.194.0-255,6438,181938,90,310382
15077,0.001371,172.31.47.0-255,66,182004,90,310382
15078,0.001378,172.217.194.0-255,8574,190578,90,310382
15079,0.00138,172.31.47.0-255,66,190644,90,310382
15080,0.001424,172.31.47.0-255,66,190710,90,310382
15081,0.001429,172.217.194.0-255,3602,194312,90,310382
15082,0.001431,172.31.47.0-255,66,194378,90,310382
15083,0.001453,172.217.194.0-255,1484,195862,90,310382
15084,0.00146,172.217.194.0-255,2902,198764,90,310382
15085,0.001462,172.31.47.0-255,66,198830,90,310382
15086,0.001469,172.217.194.0-255,5738,204568,90,310382
15087,0.001471,172.31.47.0-255,66,204634,90,310382
15088,0.001504,172.217.194.0-255,7156,211790,90,310382
15089,0.001507,172.31.47.0-255,66,211856,90,310382
15090,0.001538,172.217.194.0-255,5738,217594,90,310382
15091,0.001546,172.217.194.0-255,9992,227586,90,310382
15092,0.001548,172.217.194.0-255,766,228352,90,310382
15093,0.001552,172.31.47.0-255,66,228418,90,310382
15094,0.001554,172.31.47.0-255,66,228484,90,310382
15095,0.001615,172.217.194.0-255,1484,229968,90,310382
15096,0.001618,172.31.47.0-255,66,230034,90,310382
15097,0.001623,172.217.194.0-255,2902,232936,90,310382
15098,0.001625,172.31.47.0-255,66,233002,90,310382
15099,0.001627,172.217.194.0-255,1484,234486,90,310382
15100,0.001657,172.217.194.0-255,4320,238806,90,310382
15101,0.00166,172.31.47.0-255,66,238872,90,310382
15102,0.001702,172.31.47.0-255,66,238938,90,310382
15103,0.001726,172.217.194.0-255,1484,240422,90,310382
15104,0.001735,172.217.194.0-255,10692,251114,90,310382
15105,0.001739,172.31.47.0-255,66,251180,90,310382
15106,0.001829,172.217.194.0-255,1484,252664,90,310382
15107,0.001834,172.217.194.0-255,1484,254148,90,310382
15108,0.001837,172.31.47.0-255,66,254214,90,310382
15109,0.001868,172.217.194.0-255,1484,255698,90,310382
15110,0.001875,172.217.194.0-255,5738,261436,90,310382
15111,0.001877,172.31.47.0-255,66,261502,90,310382
15112,0.001882,172.217.194.0-255,4320,265822,90,310382
15113,0.001883,172.31.47.0-255,66,265888,90,310382
15114,0.001895,172.31.47.0-255,66,265954,90,310382
15115,0.001925,172.217.194.0-255,4320,270274,90,310382
15116,0.001927,172.31.47.0-255,66,270340,90,310382
15117,0.00194,172.31.47.0-255,66,270406,90,310382
15118,0.001956,172.31.47.0-255,66,270472,90,310382
15119,0.001961,172.217.194.0-255,4320,274792,90,310382
15120,0.001963,172.31.47.0-255,66,274858,90,310382
15121,0.001991,172.217.194.0-255,6438,281296,90,310382
15122,0.001993,172.31.47.0-255,66,281362,90,310382
15123,0.001998,172.217.194.0-255,5738,287100,90,310382
15124,0.002,172.31.47.0-255,66,287166,90,310382
15125,0.003963,172.217.194.0-255,5738,292904,90,310382
15126,0.003969,172.31.47.0-255,66,292970,90,310382
15127,0.005934,172.217.194.0-255,5738,298708,90,310382
15128,0.005941,172.31.47.0-255,66,298774,90,310382
15129,0.007894,172.217.194.0-255,5738,304512,90,310382
15130,0.007899,172.31.47.0-255,66,304578,90,310382
15131,0.00985,172.217.194.0-255,5738,310316,90,310382
15132,0.009856,172.31.47.0-255,66,310382,90,310382
15133,0.0,74.125.24.0-255,153,153,90,301280
15134,2e-05,172.31.47.0-255,66,219,90,301280
15135,2.7e-05,74.125.24.0-255,1484,1703,90,301280
15136,3.2e-05,172.31.47.0-255,66,1769,90,301280
15137,4.6e-05,74.125.24.0-255,2902,4671,90,301280
15138,5e-05,172.31.47.0-255,66,4737,90,301280
15139,5.9e-05,74.125.24.0-255,7156,11893,90,301280
15140,6.2e-05,172.31.47.0-255,66,11959,90,301280
15141,6.6e-05,74.125.24.0-255,2014,13973,90,301280
15142,6.9e-05,172.31.47.0-255,66,14039,90,301280
15143,0.000275,74.125.24.0-255,1484,15523,90,301280
15144,0.000281,172.31.47.0-255,66,15589,90,301280
15145,0.000288,74.125.24.0-255,2902,18491,90,301280
15146,0.000291,172.31.47.0-255,66,18557,90,301280
15147,0.000303,74.125.24.0-255,5738,24295,90,301280
15148,0.000306,172.31.47.0-255,66,24361,90,301280
15149,0.000339,74.125.24.0-255,2902,27263,90,301280
15150,0.000342,172.31.47.0-255,66,27329,90,301280
15151,0.000378,172.31.47.0-255,66,27395,90,301280
15152,0.000383,74.125.24.0-255,4320,31715,90,301280
15153,0.000385,172.31.47.0-255,66,31781,90,301280
15154,0.000414,74.125.24.0-255,2902,34683,90,301280
15155,0.000417,172.31.47.0-255,66,34749,90,301280
15156,0.00046,172.31.47.0-255,66,34815,90,301280
15157,0.000467,74.125.24.0-255,5020,39835,90,301280
15158,0.00047,172.31.47.0-255,66,39901,90,301280
15159,0.000608,74.125.24.0-255,364,40265,90,301280
15160,0.000612,172.31.47.0-255,66,40331,90,301280
15161,0.000653,74.125.24.0-255,126,40457,90,301280
15162,0.000656,172.31.47.0-255,66,40523,90,301280
15163,0.000734,74.125.24.0-255,1484,42007,90,301280
15164,0.000741,74.125.24.0-255,2902,44909,90,301280
15165,0.000743,172.31.47.0-255,66,44975,90,301280
15166,0.000747,74.125.24.0-255,1484,46459,90,301280
15167,0.000782,74.125.24.0-255,4320,50779,90,301280
15168,0.000785,172.31.47.0-255,66,50845,90,301280
15169,0.000796,74.125.24.0-255,1484,52329,90,301280
15170,0.000823,74.125.24.0-255,7156,59485,90,301280
15171,0.000826,172.31.47.0-255,66,59551,90,301280
15172,0.000836,74.125.24.0-255,9992,69543,90,301280
15173,0.000838,172.31.47.0-255,66,69609,90,301280
15174,0.000849,74.125.24.0-255,5020,74629,90,301280
15175,0.000852,172.31.47.0-255,66,74695,90,301280
15176,0.00088,74.125.24.0-255,351,75046,90,301280
15177,0.001517,172.31.47.0-255,66,75112,90,301280
15178,0.001619,74.125.24.0-255,1484,76596,90,301280
15179,0.001627,74.125.24.0-255,2902,79498,90,301280
15180,0.00163,172.31.47.0-255,66,79564,90,301280
15181,0.001638,74.125.24.0-255,5738,85302,90,301280
15182,0.00164,172.31.47.0-255,66,85368,90,301280
15183,0.001672,74.125.24.0-255,5738,91106,90,301280
15184,0.001674,172.31.47.0-255,66,91172,90,301280
15185,0.001708,74.125.24.0-255,7156,98328,90,301280
15186,0.001711,172.31.47.0-255,66,98394,90,301280
15187,0.001719,74.125.24.0-255,8574,106968,90,301280
15188,0.001721,172.31.47.0-255,66,107034,90,301280
15189,0.001729,74.125.24.0-255,2184,109218,90,301280
15190,0.001731,172.31.47.0-255,66,109284,90,301280
15191,0.00193,74.125.24.0-255,1484,110768,90,301280
15192,0.001935,74.125.24.0-255,1484,112252,90,301280
15193,0.001938,172.31.47.0-255,66,112318,90,301280
15194,0.001968,74.125.24.0-255,1484,113802,90,301280
15195,0.001975,74.125.24.0-255,5738,119540,90,301280
15196,0.001978,172.31.47.0-255,66,119606,90,301280
15197,0.001982,74.125.24.0-255,1484,121090,90,301280
15198,0.002019,74.125.24.0-255,9992,131082,90,301280
15199,0.002022,172.31.47.0-255,66,131148,90,301280
15200,0.002031,74.125.24.0-255,8574,139722,90,301280
15201,0.002034,172.31.47.0-255,66,139788,90,301280
15202,0.002062,74.125.24.0-255,3602,143390,90,301280
15203,0.002064,172.31.47.0-255,66,143456,90,301280
15204,0.002674,74.125.24.0-255,1484,144940,90,301280
15205,0.002684,74.125.24.0-255,2902,147842,90,301280
15206,0.002689,172.31.47.0-255,66,147908,90,301280
15207,0.002693,74.125.24.0-255,1484,149392,90,301280
15208,0.002697,74.125.24.0-255,1484,150876,90,301280
15209,0.002699,172.31.47.0-255,66,150942,90,301280
15210,0.002736,74.125.24.0-255,4320,155262,90,301280
15211,0.002739,172.31.47.0-255,66,155328,90,301280
15212,0.002758,172.31.47.0-255,66,155394,90,301280
15213,0.002763,74.125.24.0-255,2902,158296,90,301280
15214,0.002765,172.31.47.0-255,66,158362,90,301280
15215,0.002802,74.125.24.0-255,5738,164100,90,301280
15216,0.002805,172.31.47.0-255,66,164166,90,301280
15217,0.002808,74.125.24.0-255,766,164932,90,301280
15218,0.002975,74.125.24.0-255,1484,166416,90,301280
15219,0.002981,172.31.47.0-255,66,166482,90,301280
15220,0.002987,74.125.24.0-255,2902,169384,90,301280
15221,0.002989,172.31.47.0-255,66,169450,90,301280
15222,0.00301,74.125.24.0-255,5738,175188,90,301280
15223,0.00302,172.31.47.0-255,66,175254,90,301280
15224,0.003027,74.125.24.0-255,4320,179574,90,301280
15225,0.00303,172.31.47.0-255,66,179640,90,301280
15226,0.003064,74.125.24.0-255,8574,188214,90,301280
15227,0.003067,172.31.47.0-255,66,188280,90,301280
15228,0.00308,74.125.24.0-255,8574,196854,90,301280
15229,0.003082,172.31.47.0-255,66,196920,90,301280
15230,0.003085,74.125.24.0-255,1484,198404,90,301280
15231,0.003088,74.125.24.0-255,766,199170,90,301280
15232,0.00309,172.31.47.0-255,66,199236,90,301280
15233,0.003315,74.125.24.0-255,1484,200720,90,301280
15234,0.003322,74.125.24.0-255,2902,203622,90,301280
15235,0.003326,172.31.47.0-255,66,203688,90,301280
15236,0.003329,74.125.24.0-255,1484,205172,90,301280
15237,0.003355,74.125.24.0-255,4320,209492,90,301280
15238,0.003357,172.31.47.0-255,66,209558,90,301280
15239,0.003361,74.125.24.0-255,2902,212460,90,301280
15240,0.003364,172.31.47.0-255,66,212526,90,301280
15241,0.003416,74.125.24.0-255,4320,216846,90,301280
15242,0.003419,172.31.47.0-255,66,216912,90,301280
15243,0.003446,74.125.24.0-255,5738,222650,90,301280
15244,0.003449,172.31.47.0-255,66,222716,90,301280
15245,0.003463,74.125.24.0-255,10692,233408,90,301280
15246,0.003465,172.31.47.0-255,66,233474,90,301280
15247,0.003608,74.125.24.0-255,1484,234958,90,301280
15248,0.00362,74.125.24.0-255,1484,236442,90,301280
15249,0.003622,172.31.47.0-255,66,236508,90,301280
15250,0.003635,74.125.24.0-255,1484,237992,90,301280
15251,0.003645,74.125.24.0-255,5738,243730,90,301280
15252,0.003648,172.31.47.0-255,66,243796,90,301280
15253,0.003655,74.125.24.0-255,5738,249534,90,301280
15254,0.003657,172.31.47.0-255,66,249600,90,301280
15255,0.003693,172.31.47.0-255,66,249666,90,301280
15256,0.003703,74.125.24.0-255,1484,251150,90,301280
15257,0.003721,74.125.24.0-255,4320,255470,90,301280
15258,0.003723,172.31.47.0-255,66,255536,90,301280
15259,0.003761,74.125.24.0-255,6438,261974,90,301280
15260,0.003764,172.31.47.0-255,66,262040,90,301280
15261,0.003777,172.31.47.0-255,66,262106,90,301280
15262,0.003797,172.31.47.0-255,66,262172,90,301280
15263,0.003802,74.125.24.0-255,4320,266492,90,301280
15264,0.003804,172.31.47.0-255,66,266558,90,301280
15265,0.003817,172.31.47.0-255,66,266624,90,301280
15266,0.003866,172.31.47.0-255,66,266690,90,301280
15267,0.003872,74.125.24.0-255,4320,271010,90,301280
15268,0.003874,172.31.47.0-255,66,271076,90,301280
15269,0.003877,74.125.24.0-255,1484,272560,90,301280
15270,0.003886,74.125.24.0-255,2902,275462,90,301280
15271,0.003889,172.31.47.0-255,66,275528,90,301280
15272,0.003927,74.125.24.0-255,8574,284102,90,301280
15273,0.00393,172.31.47.0-255,66,284168,90,301280
15274,0.003937,74.125.24.0-255,7156,291324,90,301280
15275,0.003939,172.31.47.0-255,66,291390,90,301280
15276,0.003953,74.125.24.0-255,9274,300664,90,301280
15277,0.003955,172.31.47.0-255,66,300730,90,301280
15278,0.003958,74.125.24.0-255,177,300907,90,301280
15279,0.003961,74.125.24.0-255,97,301004,90,301280
15280,0.00402,74.125.24.0-255,105,301109,90,301280
15281,0.008421,172.31.47.0-255,66,301175,90,301280
15282,0.008454,172.31.47.0-255,105,301280,90,301280
15283,0.0,172.217.26.0-255,431,431,90,141416
15284,2.2e-05,172.217.26.0-255,1484,1915,90,141416
15285,3e-05,172.31.47.0-255,66,1981,90,141416
15286,3.8e-05,172.217.26.0-255,4320,6301,90,141416
15287,4.1e-05,172.31.47.0-255,66,6367,90,141416
15288,0.000164,172.217.26.0-255,5738,12105,90,141416
15289,0.000169,172.31.47.0-255,66,12171,90,141416
15290,0.000184,172.217.26.0-255,1484,13655,90,141416
15291,0.000396,172.217.26.0-255,646,14301,90,141416
15292,0.000401,172.31.47.0-255,66,14367,90,141416
15293,0.000419,172.217.26.0-255,1484,15851,90,141416
15294,0.000474,172.217.26.0-255,4320,20171,90,141416
15295,0.000478,172.31.47.0-255,66,20237,90,141416
15296,0.000627,172.217.26.0-255,4320,24557,90,141416
15297,0.000633,172.31.47.0-255,66,24623,90,141416
15298,0.000654,172.217.26.0-255,5738,30361,90,141416
15299,0.000658,172.31.47.0-255,66,30427,90,141416
15300,0.001999,172.217.26.0-255,5738,36165,90,141416
15301,0.002124,172.217.26.0-255,4320,40485,90,141416
15302,0.002151,172.217.26.0-255,8574,49059,90,141416
15303,0.002174,172.31.47.0-255,66,49125,90,141416
15304,0.002528,172.217.26.0-255,2902,52027,90,141416
15305,0.002533,172.31.47.0-255,66,52093,90,141416
15306,0.002596,172.31.47.0-255,66,52159,90,141416
15307,0.003195,172.217.26.0-255,9992,62151,90,141416
15308,0.003201,172.31.47.0-255,66,62217,90,141416
15309,0.003224,172.217.26.0-255,8574,70791,90,141416
15310,0.003243,172.31.47.0-255,66,70857,90,141416
15311,0.003703,172.217.26.0-255,4320,75177,90,141416
15312,0.003708,172.31.47.0-255,66,75243,90,141416
15313,0.003726,172.217.26.0-255,2902,78145,90,141416
15314,0.003746,172.31.47.0-255,66,78211,90,141416
15315,0.004156,172.217.26.0-255,8574,86785,90,141416
15316,0.004176,172.217.26.0-255,2902,89687,90,141416
15317,0.004189,172.31.47.0-255,66,89753,90,141416
15318,0.00424,172.217.26.0-255,4320,94073,90,141416
15319,0.004246,172.31.47.0-255,66,94139,90,141416
15320,0.00428,172.31.47.0-255,66,94205,90,141416
15321,0.004588,172.217.26.0-255,2902,97107,90,141416
15322,0.004592,172.31.47.0-255,66,97173,90,141416
15323,0.004626,172.31.47.0-255,66,97239,90,141416
15324,0.005204,172.31.47.0-255,66,97305,90,141416
15325,0.005705,172.31.47.0-255,66,97371,90,141416
15326,0.005744,172.31.47.0-255,66,97437,90,141416
15327,0.00628,172.217.26.0-255,8574,106011,90,141416
15328,0.006287,172.31.47.0-255,66,106077,90,141416
15329,0.006333,172.31.47.0-255,66,106143,90,141416
15330,0.006589,172.217.26.0-255,5738,111881,90,141416
15331,0.006595,172.31.47.0-255,66,111947,90,141416
15332,0.006623,172.217.26.0-255,5868,117815,90,141416
15333,0.006626,172.31.47.0-255,66,117881,90,141416
15334,0.007206,172.217.26.0-255,8574,126455,90,141416
15335,0.007212,172.31.47.0-255,66,126521,90,141416
15336,0.007299,172.31.47.0-255,66,126587,90,141416
15337,0.007325,172.217.26.0-255,8574,135161,90,141416
15338,0.007328,172.31.47.0-255,66,135227,90,141416
15339,0.008611,172.31.47.0-255,66,135293,90,141416
15340,0.008648,172.217.26.0-255,5952,141245,90,141416
15341,0.008689,172.31.47.0-255,66,141311,90,141416
15342,0.009859,172.31.47.0-255,105,141416,90,141416
15343,0.0,172.31.47.0-255,105,105,90,105
15344,0.0,172.217.194.0-255,150,150,90,235755
15345,2e-05,172.31.47.0-255,66,216,90,235755
15346,2.7e-05,172.217.194.0-255,1484,1700,90,235755
15347,3.1e-05,172.31.47.0-255,66,1766,90,235755
15348,4.3e-05,172.217.194.0-255,2902,4668,90,235755
15349,4.7e-05,172.31.47.0-255,66,4734,90,235755
15350,8.8e-05,172.217.194.0-255,7156,11890,90,235755
15351,9.1e-05,172.31.47.0-255,66,11956,90,235755
15352,9.6e-05,172.217.194.0-255,2127,14083,90,235755
15353,9.8e-05,172.31.47.0-255,66,14149,90,235755
15354,0.000103,172.217.194.0-255,2902,17051,90,235755
15355,0.000111,172.31.47.0-255,66,17117,90,235755
15356,0.000148,172.217.194.0-255,8574,25691,90,235755
15357,0.000151,172.31.47.0-255,66,25757,90,235755
15358,0.000157,172.217.194.0-255,5379,31136,90,235755
15359,0.00016,172.31.47.0-255,66,31202,90,235755
15360,0.000301,172.217.194.0-255,1484,32686,90,235755
15361,0.000303,172.31.47.0-255,66,32752,90,235755
15362,0.000308,172.217.194.0-255,2902,35654,90,235755
15363,0.00031,172.31.47.0-255,66,35720,90,235755
15364,0.000333,172.217.194.0-255,1484,37204,90,235755
15365,0.000335,172.31.47.0-255,66,37270,90,235755
15366,0.00034,172.217.194.0-255,2902,40172,90,235755
15367,0.000342,172.31.47.0-255,66,40238,90,235755
15368,0.000347,172.217.194.0-255,4320,44558,90,235755
15369,0.00035,172.31.47.0-255,66,44624,90,235755
15370,0.000374,172.217.194.0-255,1484,46108,90,235755
15371,0.000376,172.31.47.0-255,66,46174,90,235755
15372,0.00039,172.31.47.0-255,66,46240,90,235755
15373,0.0004,172.217.194.0-255,6438,52678,90,235755
15374,0.000403,172.31.47.0-255,66,52744,90,235755
15375,0.000438,172.217.194.0-255,646,53390,90,235755
15376,0.000496,172.217.194.0-255,1484,54874,90,235755
15377,0.000498,172.31.47.0-255,66,54940,90,235755
15378,0.000503,172.217.194.0-255,2902,57842,90,235755
15379,0.000505,172.31.47.0-255,66,57908,90,235755
15380,0.000522,172.217.194.0-255,1484,59392,90,235755
15381,0.000532,172.217.194.0-255,5738,65130,90,235755
15382,0.000535,172.31.47.0-255,66,65196,90,235755
15383,0.000552,172.217.194.0-255,4320,69516,90,235755
15384,0.000554,172.31.47.0-255,66,69582,90,235755
15385,0.000563,172.217.194.0-255,9992,79574,90,235755
15386,0.000565,172.31.47.0-255,66,79640,90,235755
15387,0.000606,172.217.194.0-255,7856,87496,90,235755
15388,0.000609,172.31.47.0-255,66,87562,90,235755
15389,0.000644,172.217.194.0-255,2902,90464,90,235755
15390,0.000646,172.31.47.0-255,66,90530,90,235755
15391,0.000671,172.217.194.0-255,5738,96268,90,235755
15392,0.000673,172.31.47.0-255,66,96334,90,235755
15393,0.000678,172.217.194.0-255,4320,100654,90,235755
15394,0.00068,172.31.47.0-255,66,100720,90,235755
15395,0.00071,172.217.194.0-255,4320,105040,90,235755
15396,0.000712,172.31.47.0-255,66,105106,90,235755
15397,0.00075,172.217.194.0-255,4320,109426,90,235755
15398,0.000753,172.31.47.0-255,66,109492,90,235755
15399,0.000788,172.31.47.0-255,66,109558,90,235755
15400,0.000801,172.31.47.0-255,66,109624,90,235755
15401,0.000811,172.217.194.0-255,5738,115362,90,235755
15402,0.000814,172.31.47.0-255,66,115428,90,235755
15403,0.00082,172.217.194.0-255,7156,122584,90,235755
15404,0.000822,172.31.47.0-255,66,122650,90,235755
15405,0.000888,172.31.47.0-255,66,122716,90,235755
15406,0.000892,172.217.194.0-255,2902,125618,90,235755
15407,0.000894,172.31.47.0-255,66,125684,90,235755
15408,0.000913,172.217.194.0-255,3602,129286,90,235755
15409,0.000915,172.31.47.0-255,66,129352,90,235755
15410,0.000969,172.217.194.0-255,1484,130836,90,235755
15411,0.000985,172.217.194.0-255,2902,133738,90,235755
15412,0.000987,172.31.47.0-255,66,133804,90,235755
15413,0.001011,172.217.194.0-255,4320,138124,90,235755
15414,0.001014,172.31.47.0-255,66,138190,90,235755
15415,0.001019,172.217.194.0-255,5738,143928,90,235755
15416,0.001021,172.31.47.0-255,66,143994,90,235755
15417,0.001049,172.217.194.0-255,7156,151150,90,235755
15418,0.001052,172.31.47.0-255,66,151216,90,235755
15419,0.001081,172.217.194.0-255,4320,155536,90,235755
15420,0.001083,172.31.47.0-255,66,155602,90,235755
15421,0.001104,172.217.194.0-255,7856,163458,90,235755
15422,0.001107,172.31.47.0-255,66,163524,90,235755
15423,0.00122,172.217.194.0-255,1484,165008,90,235755
15424,0.001238,172.217.194.0-255,2902,167910,90,235755
15425,0.001241,172.31.47.0-255,66,167976,90,235755
15426,0.001247,172.217.194.0-255,5738,173714,90,235755
15427,0.00125,172.31.47.0-255,66,173780,90,235755
15428,0.001252,172.217.194.0-255,1484,175264,90,235755
15429,0.00129,172.31.47.0-255,66,175330,90,235755
15430,0.001312,172.217.194.0-255,1484,176814,90,235755
15431,0.001323,172.217.194.0-255,1484,178298,90,235755
15432,0.001326,172.31.47.0-255,66,178364,90,235755
15433,0.001352,172.217.194.0-255,6438,184802,90,235755
15434,0.001355,172.31.47.0-255,66,184868,90,235755
15435,0.001409,172.217.194.0-255,1484,186352,90,235755
15436,0.001425,172.217.194.0-255,2902,189254,90,235755
15437,0.001428,172.31.47.0-255,66,189320,90,235755
15438,0.001453,172.217.194.0-255,5738,195058,90,235755
15439,0.001456,172.31.47.0-255,66,195124,90,235755
15440,0.001462,172.217.194.0-255,5738,200862,90,235755
15441,0.001464,172.31.47.0-255,66,200928,90,235755
15442,0.001491,172.217.194.0-255,4320,205248,90,235755
15443,0.001493,172.31.47.0-255,66,205314,90,235755
15444,0.001497,172.217.194.0-255,2902,208216,90,235755
15445,0.001499,172.31.47.0-255,66,208282,90,235755
15446,0.001546,172.31.47.0-255,66,208348,90,235755
15447,0.001564,172.31.47.0-255,66,208414,90,235755
15448,0.001567,172.217.194.0-255,1484,209898,90,235755
15449,0.001613,172.31.47.0-255,66,209964,90,235755
15450,0.00164,172.31.47.0-255,66,210030,90,235755
15451,0.001646,172.217.194.0-255,5020,215050,90,235755
15452,0.001648,172.31.47.0-255,66,215116,90,235755
15453,0.001742,172.31.47.0-255,66,215182,90,235755
15454,0.001752,172.217.194.0-255,10692,225874,90,235755
15455,0.001759,172.31.47.0-255,66,225940,90,235755
15456,0.001769,172.217.194.0-255,9644,235584,90,235755
15457,0.001771,172.31.47.0-255,66,235650,90,235755
15458,0.001774,172.217.194.0-255,105,235755,90,235755
15459,0.0,74.125.68.0-255,153,153,90,141270
15460,2.7e-05,172.31.47.0-255,66,219,90,141270
15461,7.8e-05,74.125.68.0-255,1484,1703,90,141270
15462,8.3e-05,172.31.47.0-255,66,1769,90,141270
15463,0.000107,74.125.68.0-255,2902,4671,90,141270
15464,0.000111,172.31.47.0-255,66,4737,90,141270
15465,0.000136,74.125.68.0-255,1484,6221,90,141270
15466,0.000139,172.31.47.0-255,66,6287,90,141270
15467,0.000172,74.125.68.0-255,2902,9189,90,141270
15468,0.000177,172.31.47.0-255,66,9255,90,141270
15469,0.000213,74.125.68.0-255,4944,14199,90,141270
15470,0.000217,172.31.47.0-255,66,14265,90,141270
15471,0.00022,74.125.68.0-255,1484,15749,90,141270
15472,0.000222,172.31.47.0-255,66,15815,90,141270
15473,0.000264,74.125.68.0-255,2902,18717,90,141270
15474,0.000267,172.31.47.0-255,66,18783,90,141270
15475,0.000272,74.125.68.0-255,2902,21685,90,141270
15476,0.000274,172.31.47.0-255,66,21751,90,141270
15477,0.000292,74.125.68.0-255,2902,24653,90,141270
15478,0.000294,172.31.47.0-255,66,24719,90,141270
15479,0.000322,74.125.68.0-255,6797,31516,90,141270
15480,0.000328,172.31.47.0-255,66,31582,90,141270
15481,0.000417,74.125.68.0-255,1484,33066,90,141270
15482,0.00042,172.31.47.0-255,66,33132,90,141270
15483,0.000424,74.125.68.0-255,1484,34616,90,141270
15484,0.000426,172.31.47.0-255,66,34682,90,141270
15485,0.000458,74.125.68.0-255,1484,36166,90,141270
15486,0.000465,172.31.47.0-255,66,36232,90,141270
15487,0.000471,74.125.68.0-255,5738,41970,90,141270
15488,0.000474,172.31.47.0-255,66,42036,90,141270
15489,0.0005,74.125.68.0-255,8574,50610,90,141270
15490,0.000504,172.31.47.0-255,66,50676,90,141270
15491,0.000536,74.125.68.0-255,1484,52160,90,141270
15492,0.000539,172.31.47.0-255,66,52226,90,141270
15493,0.000552,172.31.47.0-255,66,52292,90,141270
15494,0.000556,74.125.68.0-255,2184,54476,90,141270
15495,0.000559,172.31.47.0-255,66,54542,90,141270
15496,0.000561,74.125.68.0-255,398,54940,90,141270
15497,0.000564,172.31.47.0-255,66,55006,90,141270
15498,0.000618,74.125.68.0-255,112,55118,90,141270
15499,0.000622,172.31.47.0-255,66,55184,90,141270
15500,0.000836,74.125.68.0-255,1484,56668,90,141270
15501,0.000841,172.31.47.0-255,66,56734,90,141270
15502,0.000849,74.125.68.0-255,2902,59636,90,141270
15503,0.000851,172.31.47.0-255,66,59702,90,141270
15504,0.00086,74.125.68.0-255,1484,61186,90,141270
15505,0.000863,172.31.47.0-255,66,61252,90,141270
15506,0.000888,74.125.68.0-255,4320,65572,90,141270
15507,0.000891,172.31.47.0-255,66,65638,90,141270
15508,0.000898,74.125.68.0-255,5738,71376,90,141270
15509,0.0009,172.31.47.0-255,66,71442,90,141270
15510,0.000936,74.125.68.0-255,2902,74344,90,141270
15511,0.000939,172.31.47.0-255,66,74410,90,141270
15512,0.000948,74.125.68.0-255,9992,84402,90,141270
15513,0.00095,172.31.47.0-255,66,84468,90,141270
15514,0.000956,74.125.68.0-255,5020,89488,90,141270
15515,0.000958,172.31.47.0-255,66,89554,90,141270
15516,0.002219,74.125.68.0-255,1484,91038,90,141270
15517,0.002242,74.125.68.0-255,2902,93940,90,141270
15518,0.002247,172.31.47.0-255,66,94006,90,141270
15519,0.002254,74.125.68.0-255,5738,99744,90,141270
15520,0.002256,172.31.47.0-255,66,99810,90,141270
15521,0.002291,74.125.68.0-255,7156,106966,90,141270
15522,0.002294,172.31.47.0-255,66,107032,90,141270
15523,0.002322,74.125.68.0-255,5738,112770,90,141270
15524,0.002326,74.125.68.0-255,2902,115672,90,141270
15525,0.002327,172.31.47.0-255,66,115738,90,141270
15526,0.002329,74.125.68.0-255,2902,118640,90,141270
15527,0.00233,172.31.47.0-255,66,118706,90,141270
15528,0.002332,172.31.47.0-255,66,118772,90,141270
15529,0.002355,74.125.68.0-255,5020,123792,90,141270
15530,0.002362,172.31.47.0-255,66,123858,90,141270
15531,0.004673,74.125.68.0-255,5738,129596,90,141270
15532,0.004678,172.31.47.0-255,66,129662,90,141270
15533,0.007003,74.125.68.0-255,5738,135400,90,141270
15534,0.007007,172.31.47.0-255,66,135466,90,141270
15535,0.009327,74.125.68.0-255,5738,141204,90,141270
15536,0.009336,172.31.47.0-255,66,141270,90,141270
15537,0.0,172.31.47.0-255,105,105,90,105
15538,0.0,74.125.200.0-255,153,153,90,209364
15539,2.4e-05,172.31.47.0-255,66,219,90,209364
15540,3e-05,74.125.200.0-255,1484,1703,90,209364
15541,3.4e-05,172.31.47.0-255,66,1769,90,209364
15542,3.8e-05,74.125.200.0-255,2902,4671,90,209364
15543,4e-05,172.31.47.0-255,66,4737,90,209364
15544,4.2e-05,74.125.200.0-255,1484,6221,90,209364
15545,4.5e-05,172.31.47.0-255,66,6287,90,209364
15546,6.5e-05,74.125.200.0-255,4320,10607,90,209364
15547,6.8e-05,172.31.47.0-255,66,10673,90,209364
15548,7.2e-05,74.125.200.0-255,3636,14309,90,209364
15549,7.3e-05,172.31.47.0-255,66,14375,90,209364
15550,0.000175,74.125.200.0-255,1484,15859,90,209364
15551,0.000179,172.31.47.0-255,66,15925,90,209364
15552,0.000183,74.125.200.0-255,2902,18827,90,209364
15553,0.000185,172.31.47.0-255,66,18893,90,209364
15554,0.000187,74.125.200.0-255,1484,20377,90,209364
15555,0.000189,172.31.47.0-255,66,20443,90,209364
15556,0.000204,74.125.200.0-255,4320,24763,90,209364
15557,0.000206,172.31.47.0-255,66,24829,90,209364
15558,0.00022,74.125.200.0-255,2902,27731,90,209364
15559,0.000222,172.31.47.0-255,66,27797,90,209364
15560,0.000233,74.125.200.0-255,3961,31758,90,209364
15561,0.000235,172.31.47.0-255,66,31824,90,209364
15562,0.000249,74.125.200.0-255,2902,34726,90,209364
15563,0.000252,172.31.47.0-255,66,34792,90,209364
15564,0.000272,74.125.200.0-255,4320,39112,90,209364
15565,0.000274,172.31.47.0-255,66,39178,90,209364
15566,0.000279,74.125.200.0-255,4320,43498,90,209364
15567,0.000281,172.31.47.0-255,66,43564,90,209364
15568,0.000294,74.125.200.0-255,2902,46466,90,209364
15569,0.000296,172.31.47.0-255,66,46532,90,209364
15570,0.000313,74.125.200.0-255,2543,49075,90,209364
15571,0.000319,172.31.47.0-255,66,49141,90,209364
15572,0.000592,74.125.200.0-255,1484,50625,90,209364
15573,0.000598,74.125.200.0-255,2902,53527,90,209364
15574,0.000601,172.31.47.0-255,66,53593,90,209364
15575,0.000636,74.125.200.0-255,5738,59331,90,209364
15576,0.000642,74.125.200.0-255,5738,65069,90,209364
15577,0.000647,172.31.47.0-255,66,65135,90,209364
15578,0.000654,74.125.200.0-255,1125,66260,90,209364
15579,0.00068,74.125.200.0-255,7156,73416,90,209364
15580,0.000685,172.31.47.0-255,66,73482,90,209364
15581,0.000688,74.125.200.0-255,1484,74966,90,209364
15582,0.000709,74.125.200.0-255,8796,83762,90,209364
15583,0.000715,172.31.47.0-255,66,83828,90,209364
15584,0.000765,74.125.200.0-255,1484,85312,90,209364
15585,0.00078,74.125.200.0-255,2902,88214,90,209364
15586,0.000783,172.31.47.0-255,66,88280,90,209364
15587,0.000803,74.125.200.0-255,5738,94018,90,209364
15588,0.000808,172.31.47.0-255,66,94084,90,209364
15589,0.000824,74.125.200.0-255,5738,99822,90,209364
15590,0.00083,172.31.47.0-255,66,99888,90,209364
15591,0.000842,74.125.200.0-255,7156,107044,90,209364
15592,0.000857,172.31.47.0-255,66,107110,90,209364
15593,0.000874,74.125.200.0-255,1484,108594,90,209364
15594,0.000903,74.125.200.0-255,8609,117203,90,209364
15595,0.000912,172.31.47.0-255,66,117269,90,209364
15596,0.000949,74.125.200.0-255,1484,118753,90,209364
15597,0.000964,74.125.200.0-255,2902,121655,90,209364
15598,0.000966,172.31.47.0-255,66,121721,90,209364
15599,0.00097,74.125.200.0-255,2902,124623,90,209364
15600,0.000982,172.31.47.0-255,66,124689,90,209364
15601,0.000983,74.125.200.0-255,1484,126173,90,209364
15602,0.000988,74.125.200.0-255,5738,131911,90,209364
15603,0.000995,172.31.47.0-255,66,131977,90,209364
15604,0.001018,74.125.200.0-255,2902,134879,90,209364
15605,0.001025,172.31.47.0-255,66,134945,90,209364
15606,0.001048,74.125.200.0-255,8911,143856,90,209364
15607,0.001053,74.125.200.0-255,4320,148176,90,209364
15608,0.001057,172.31.47.0-255,66,148242,90,209364
15609,0.001074,74.125.200.0-255,8574,156816,90,209364
15610,0.001079,74.125.200.0-255,4320,161136,90,209364
15611,0.001079,172.31.47.0-255,66,161202,90,209364
15612,0.001083,172.31.47.0-255,66,161268,90,209364
15613,0.001103,74.125.200.0-255,4320,165588,90,209364
15614,0.001111,172.31.47.0-255,66,165654,90,209364
15615,0.001127,74.125.200.0-255,3602,169256,90,209364
15616,0.00113,172.31.47.0-255,66,169322,90,209364
15617,0.001654,74.125.200.0-255,1484,170806,90,209364
15618,0.001672,74.125.200.0-255,2902,173708,90,209364
15619,0.001676,172.31.47.0-255,66,173774,90,209364
15620,0.001699,74.125.200.0-255,5738,179512,90,209364
15621,0.001702,74.125.200.0-255,1484,180996,90,209364
15622,0.001705,74.125.200.0-255,2902,183898,90,209364
15623,0.001718,74.125.200.0-255,5738,189636,90,209364
15624,0.001721,74.125.200.0-255,1484,191120,90,209364
15625,0.001733,74.125.200.0-255,1484,192604,90,209364
15626,0.001744,74.125.200.0-255,1484,194088,90,209364
15627,0.001761,74.125.200.0-255,4320,198408,90,209364
15628,0.001773,74.125.200.0-255,1484,199892,90,209364
15629,0.001778,74.125.200.0-255,3602,203494,90,209364
15630,0.006019,172.31.47.0-255,66,203560,90,209364
15631,0.008289,74.125.200.0-255,5738,209298,90,209364
15632,0.008295,172.31.47.0-255,66,209364,90,209364
15633,0.0,172.31.47.0-255,105,105,90,552
15634,3.1e-05,172.31.47.0-255,105,210,90,552
15635,0.001481,157.240.13.0-255,105,315,90,552
15636,0.00149,172.31.47.0-255,66,381,90,552
15637,0.001745,157.240.13.0-255,105,486,90,552
15638,0.001749,172.31.47.0-255,66,552,90,552
15639,0.0,172.217.194.0-255,153,153,90,127878
15640,3.5e-05,172.31.47.0-255,66,219,90,127878
15641,4.2e-05,172.217.194.0-255,1484,1703,90,127878
15642,4.6e-05,172.31.47.0-255,66,1769,90,127878
15643,5.1e-05,172.217.194.0-255,2902,4671,90,127878
15644,5.5e-05,172.31.47.0-255,66,4737,90,127878
15645,5.8e-05,172.217.194.0-255,1484,6221,90,127878
15646,6e-05,172.31.47.0-255,66,6287,90,127878
15647,9e-05,172.217.194.0-255,5738,12025,90,127878
15648,9.3e-05,172.31.47.0-255,66,12091,90,127878
15649,0.000164,172.217.194.0-255,4899,16990,90,127878
15650,0.000168,172.31.47.0-255,66,17056,90,127878
15651,0.00023,172.217.194.0-255,8574,25630,90,127878
15652,0.000234,172.31.47.0-255,66,25696,90,127878
15653,0.000253,172.217.194.0-255,5379,31075,90,127878
15654,0.000255,172.31.47.0-255,66,31141,90,127878
15655,0.000425,172.217.194.0-255,7156,38297,90,127878
15656,0.000431,172.31.47.0-255,66,38363,90,127878
15657,0.000521,172.217.194.0-255,8574,46937,90,127878
15658,0.000525,172.31.47.0-255,66,47003,90,127878
15659,0.000643,172.217.194.0-255,8574,55577,90,127878
15660,0.000647,172.31.47.0-255,66,55643,90,127878
15661,0.000672,172.217.194.0-255,8574,64217,90,127878
15662,0.000675,172.31.47.0-255,66,64283,90,127878
15663,0.000873,172.217.194.0-255,1377,65660,90,127878
15664,0.000877,172.31.47.0-255,66,65726,90,127878
15665,0.000885,172.217.194.0-255,1484,67210,90,127878
15666,0.000887,172.31.47.0-255,66,67276,90,127878
15667,0.000912,172.31.47.0-255,66,67342,90,127878
15668,0.000929,172.217.194.0-255,5738,73080,90,127878
15669,0.000932,172.31.47.0-255,66,73146,90,127878
15670,0.001185,172.217.194.0-255,9992,83138,90,127878
15671,0.00119,172.31.47.0-255,66,83204,90,127878
15672,0.001211,172.217.194.0-255,3602,86806,90,127878
15673,0.001213,172.31.47.0-255,66,86872,90,127878
15674,0.001351,172.217.194.0-255,5738,92610,90,127878
15675,0.001357,172.31.47.0-255,66,92676,90,127878
15676,0.001403,172.31.47.0-255,66,92742,90,127878
15677,0.001845,172.31.47.0-255,66,92808,90,127878
15678,0.001884,172.31.47.0-255,66,92874,90,127878
15679,0.002265,172.217.194.0-255,5738,98612,90,127878
15680,0.002268,172.31.47.0-255,66,98678,90,127878
15681,0.002297,172.31.47.0-255,66,98744,90,127878
15682,0.00252,172.217.194.0-255,1484,100228,90,127878
15683,0.002552,172.31.47.0-255,66,100294,90,127878
15684,0.002589,172.31.47.0-255,66,100360,90,127878
15685,0.002608,172.217.194.0-255,7138,107498,90,127878
15686,0.00261,172.31.47.0-255,66,107564,90,127878
15687,0.003303,172.217.194.0-255,8574,116138,90,127878
15688,0.003309,172.31.47.0-255,66,116204,90,127878
15689,0.003383,172.31.47.0-255,66,116270,90,127878
15690,0.005711,172.217.194.0-255,5738,122008,90,127878
15691,0.005722,172.31.47.0-255,66,122074,90,127878
15692,0.008028,172.217.194.0-255,5738,127812,90,127878
15693,0.008033,172.31.47.0-255,66,127878,90,127878
15694,0.0,172.217.194.0-255,152,152,90,91665
15695,3.3e-05,172.31.47.0-255,66,218,90,91665
15696,4e-05,172.217.194.0-255,1484,1702,90,91665
15697,4.3e-05,172.31.47.0-255,66,1768,90,91665
15698,4.8e-05,172.217.194.0-255,2902,4670,90,91665
15699,5.1e-05,172.31.47.0-255,66,4736,90,91665
15700,0.000129,172.217.194.0-255,7156,11892,90,91665
15701,0.000134,172.31.47.0-255,66,11958,90,91665
15702,0.000316,172.217.194.0-255,2063,14021,90,91665
15703,0.000322,172.31.47.0-255,66,14087,90,91665
15704,0.000383,172.217.194.0-255,8574,22661,90,91665
15705,0.000386,172.31.47.0-255,66,22727,90,91665
15706,0.000406,172.217.194.0-255,2902,25629,90,91665
15707,0.000409,172.31.47.0-255,66,25695,90,91665
15708,0.000704,172.217.194.0-255,5379,31074,90,91665
15709,0.00071,172.31.47.0-255,66,31140,90,91665
15710,0.000862,172.217.194.0-255,5738,36878,90,91665
15711,0.000867,172.31.47.0-255,66,36944,90,91665
15712,0.000899,172.31.47.0-255,66,37010,90,91665
15713,0.001357,172.217.194.0-255,1484,38494,90,91665
15714,0.001363,172.31.47.0-255,66,38560,90,91665
15715,0.001383,172.217.194.0-255,2902,41462,90,91665
15716,0.001386,172.31.47.0-255,66,41528,90,91665
15717,0.001459,172.217.194.0-255,1484,43012,90,91665
15718,0.001461,172.31.47.0-255,66,43078,90,91665
15719,0.001477,172.217.194.0-255,4320,47398,90,91665
15720,0.00148,172.31.47.0-255,66,47464,90,91665
15721,0.00162,172.217.194.0-255,1484,48948,90,91665
15722,0.001622,172.31.47.0-255,66,49014,90,91665
15723,0.001643,172.31.47.0-255,66,49080,90,91665
15724,0.001993,172.217.194.0-255,2902,51982,90,91665
15725,0.002004,172.217.194.0-255,2902,54884,90,91665
15726,0.002155,172.217.194.0-255,1484,56368,90,91665
15727,0.002194,172.217.194.0-255,1125,57493,90,91665
15728,0.002717,172.217.194.0-255,1484,58977,90,91665
15729,0.003301,172.217.194.0-255,2902,61879,90,91665
15730,0.003338,172.217.194.0-255,9992,71871,90,91665
15731,0.003356,172.217.194.0-255,7856,79727,90,91665
15732,0.004523,172.31.47.0-255,66,79793,90,91665
15733,0.006824,172.217.194.0-255,2902,82695,90,91665
15734,0.00683,172.31.47.0-255,66,82761,90,91665
15735,0.006856,172.217.194.0-255,2902,85663,90,91665
15736,0.006871,172.31.47.0-255,66,85729,90,91665
15737,0.009115,172.217.194.0-255,2902,88631,90,91665
15738,0.009121,172.31.47.0-255,66,88697,90,91665
15739,0.009151,172.217.194.0-255,2902,91599,90,91665
15740,0.009166,172.31.47.0-255,66,91665,90,91665
15741,0.0,172.217.194.0-255,153,153,90,159833
15742,2.4e-05,172.31.47.0-255,66,219,90,159833
15743,3e-05,172.217.194.0-255,1484,1703,90,159833
15744,3.3e-05,172.31.47.0-255,66,1769,90,159833
15745,3.8e-05,172.217.194.0-255,2902,4671,90,159833
15746,4e-05,172.31.47.0-255,66,4737,90,159833
15747,4.7e-05,172.217.194.0-255,7156,11893,90,159833
15748,4.9e-05,172.31.47.0-255,66,11959,90,159833
15749,7.6e-05,172.217.194.0-255,7156,19115,90,159833
15750,7.9e-05,172.31.47.0-255,66,19181,90,159833
15751,0.000103,172.217.194.0-255,9219,28400,90,159833
15752,0.000105,172.31.47.0-255,66,28466,90,159833
15753,0.000107,172.217.194.0-255,1484,29950,90,159833
15754,0.000109,172.31.47.0-255,66,30016,90,159833
15755,0.000112,172.217.194.0-255,1125,31141,90,159833
15756,0.000115,172.31.47.0-255,66,31207,90,159833
15757,0.000136,172.217.194.0-255,1484,32691,90,159833
15758,0.000138,172.31.47.0-255,66,32757,90,159833
15759,0.000157,172.217.194.0-255,4320,37077,90,159833
15760,0.00016,172.31.47.0-255,66,37143,90,159833
15761,0.000162,172.217.194.0-255,1484,38627,90,159833
15762,0.000163,172.31.47.0-255,66,38693,90,159833
15763,0.000178,172.217.194.0-255,7156,45849,90,159833
15764,0.00018,172.31.47.0-255,66,45915,90,159833
15765,0.000202,172.217.194.0-255,1484,47399,90,159833
15766,0.000204,172.31.47.0-255,66,47465,90,159833
15767,0.000214,172.31.47.0-255,66,47531,90,159833
15768,0.000219,172.217.194.0-255,4320,51851,90,159833
15769,0.000221,172.31.47.0-255,66,51917,90,159833
15770,0.000244,172.217.194.0-255,2543,54460,90,159833
15771,0.000247,172.31.47.0-255,66,54526,90,159833
15772,0.000552,172.217.194.0-255,647,55173,90,159833
15773,0.000623,172.31.47.0-255,66,55239,90,159833
15774,0.000638,172.217.194.0-255,1484,56723,90,159833
15775,0.000641,172.217.194.0-255,1484,58207,90,159833
15776,0.000643,172.31.47.0-255,66,58273,90,159833
15777,0.000661,172.217.194.0-255,1484,59757,90,159833
15778,0.000666,172.217.194.0-255,5738,65495,90,159833
15779,0.000668,172.31.47.0-255,66,65561,90,159833
15780,0.000679,172.217.194.0-255,2902,68463,90,159833
15781,0.000681,172.31.47.0-255,66,68529,90,159833
15782,0.000697,172.217.194.0-255,3961,72490,90,159833
15783,0.0007,172.31.47.0-255,66,72556,90,159833
15784,0.000705,172.217.194.0-255,5738,78294,90,159833
15785,0.000708,172.31.47.0-255,66,78360,90,159833
15786,0.000725,172.217.194.0-255,1484,79844,90,159833
15787,0.000739,172.217.194.0-255,2902,82746,90,159833
15788,0.000741,172.31.47.0-255,66,82812,90,159833
15789,0.000762,172.217.194.0-255,6797,89609,90,159833
15790,0.000764,172.31.47.0-255,66,89675,90,159833
15791,0.001244,172.217.194.0-255,1484,91159,90,159833
15792,0.001255,172.217.194.0-255,2902,94061,90,159833
15793,0.00126,172.31.47.0-255,66,94127,90,159833
15794,0.001267,172.217.194.0-255,5738,99865,90,159833
15795,0.001269,172.31.47.0-255,66,99931,90,159833
15796,0.001285,172.217.194.0-255,5738,105669,90,159833
15797,0.001288,172.31.47.0-255,66,105735,90,159833
15798,0.001309,172.217.194.0-255,7156,112891,90,159833
15799,0.001311,172.31.47.0-255,66,112957,90,159833
15800,0.001321,172.217.194.0-255,9992,122949,90,159833
15801,0.001324,172.31.47.0-255,66,123015,90,159833
15802,0.001327,172.217.194.0-255,766,123781,90,159833
15803,0.002104,172.217.194.0-255,1484,125265,90,159833
15804,0.002108,172.31.47.0-255,66,125331,90,159833
15805,0.002114,172.217.194.0-255,2902,128233,90,159833
15806,0.002115,172.31.47.0-255,66,128299,90,159833
15807,0.002128,172.217.194.0-255,1484,129783,90,159833
15808,0.002139,172.217.194.0-255,4320,134103,90,159833
15809,0.002141,172.31.47.0-255,66,134169,90,159833
15810,0.002169,172.31.47.0-255,66,134235,90,159833
15811,0.002178,172.217.194.0-255,9992,144227,90,159833
15812,0.002179,172.31.47.0-255,66,144293,90,159833
15813,0.002195,172.217.194.0-255,766,145059,90,159833
15814,0.003641,172.31.47.0-255,66,145125,90,159833
15815,0.004416,172.217.194.0-255,4320,149445,90,159833
15816,0.004421,172.31.47.0-255,66,149511,90,159833
15817,0.00588,172.217.194.0-255,1484,150995,90,159833
15818,0.006659,172.217.194.0-255,2902,153897,90,159833
15819,0.006664,172.31.47.0-255,66,153963,90,159833
15820,0.006688,172.217.194.0-255,1484,155447,90,159833
15821,0.008901,172.217.194.0-255,4320,159767,90,159833
15822,0.008908,172.31.47.0-255,66,159833,90,159833
15823,0.0,172.31.47.0-255,105,105,90,105
15824,0.0,172.31.47.0-255,105,105,90,276
15825,0.002229,157.240.13.0-255,105,210,90,276
15826,0.00224,172.31.47.0-255,66,276,90,276
15827,0.0,31.13.82.0-255,105,105,90,105
15828,0.0,74.125.24.0-255,153,153,90,196644
15829,4.2e-05,172.31.47.0-255,66,219,90,196644
15830,5.2e-05,74.125.24.0-255,1484,1703,90,196644
15831,5.7e-05,172.31.47.0-255,66,1769,90,196644
15832,7e-05,74.125.24.0-255,2902,4671,90,196644
15833,7.3e-05,172.31.47.0-255,66,4737,90,196644
15834,8.3e-05,74.125.24.0-255,7156,11893,90,196644
15835,8.7e-05,172.31.47.0-255,66,11959,90,196644
15836,9.1e-05,74.125.24.0-255,2064,14023,90,196644
15837,9.4e-05,172.31.47.0-255,66,14089,90,196644
15838,0.000122,74.125.24.0-255,2902,16991,90,196644
15839,0.000125,172.31.47.0-255,66,17057,90,196644
15840,0.000128,74.125.24.0-255,1484,18541,90,196644
15841,0.000134,172.31.47.0-255,66,18607,90,196644
15842,0.000144,74.125.24.0-255,5738,24345,90,196644
15843,0.000148,172.31.47.0-255,66,24411,90,196644
15844,0.000182,74.125.24.0-255,6797,31208,90,196644
15845,0.000185,172.31.47.0-255,66,31274,90,196644
15846,0.000216,74.125.24.0-255,7156,38430,90,196644
15847,0.00022,172.31.47.0-255,66,38496,90,196644
15848,0.000229,74.125.24.0-255,5738,44234,90,196644
15849,0.000231,172.31.47.0-255,66,44300,90,196644
15850,0.000277,74.125.24.0-255,3961,48261,90,196644
15851,0.000281,172.31.47.0-255,66,48327,90,196644
15852,0.000314,74.125.24.0-255,4320,52647,90,196644
15853,0.000317,172.31.47.0-255,66,52713,90,196644
15854,0.000347,74.125.24.0-255,4320,57033,90,196644
15855,0.00035,172.31.47.0-255,66,57099,90,196644
15856,0.000378,74.125.24.0-255,5738,62837,90,196644
15857,0.000381,172.31.47.0-255,66,62903,90,196644
15858,0.000387,74.125.24.0-255,3153,66056,90,196644
15859,0.000389,172.31.47.0-255,66,66122,90,196644
15860,0.000437,74.125.24.0-255,1484,67606,90,196644
15861,0.000455,74.125.24.0-255,2902,70508,90,196644
15862,0.000459,172.31.47.0-255,66,70574,90,196644
15863,0.000465,74.125.24.0-255,2902,73476,90,196644
15864,0.000467,172.31.47.0-255,66,73542,90,196644
15865,0.000496,74.125.24.0-255,2902,76444,90,196644
15866,0.000499,172.31.47.0-255,66,76510,90,196644
15867,0.000507,74.125.24.0-255,5738,82248,90,196644
15868,0.000509,172.31.47.0-255,66,82314,90,196644
15869,0.000518,74.125.24.0-255,1125,83439,90,196644
15870,0.000557,74.125.24.0-255,1484,84923,90,196644
15871,0.000561,172.31.47.0-255,66,84989,90,196644
15872,0.000567,74.125.24.0-255,2902,87891,90,196644
15873,0.00057,172.31.47.0-255,66,87957,90,196644
15874,0.000598,74.125.24.0-255,1484,89441,90,196644
15875,0.000604,74.125.24.0-255,4320,93761,90,196644
15876,0.000606,172.31.47.0-255,66,93827,90,196644
15877,0.000633,74.125.24.0-255,4320,98147,90,196644
15878,0.000636,172.31.47.0-255,66,98213,90,196644
15879,0.000663,74.125.24.0-255,2543,100756,90,196644
15880,0.000666,172.31.47.0-255,66,100822,90,196644
15881,0.000814,74.125.24.0-255,1484,102306,90,196644
15882,0.000829,74.125.24.0-255,2902,105208,90,196644
15883,0.000833,172.31.47.0-255,66,105274,90,196644
15884,0.000841,74.125.24.0-255,5738,111012,90,196644
15885,0.000843,172.31.47.0-255,66,111078,90,196644
15886,0.000858,74.125.24.0-255,1484,112562,90,196644
15887,0.000899,172.31.47.0-255,66,112628,90,196644
15888,0.000905,74.125.24.0-255,5738,118366,90,196644
15889,0.00091,172.31.47.0-255,66,118432,90,196644
15890,0.000935,74.125.24.0-255,2902,121334,90,196644
15891,0.000938,172.31.47.0-255,66,121400,90,196644
15892,0.000958,74.125.24.0-255,2184,123584,90,196644
15893,0.000961,172.31.47.0-255,66,123650,90,196644
15894,0.000994,74.125.24.0-255,1484,125134,90,196644
15895,0.000998,74.125.24.0-255,1484,126618,90,196644
15896,0.001001,172.31.47.0-255,66,126684,90,196644
15897,0.00103,74.125.24.0-255,1484,128168,90,196644
15898,0.001037,74.125.24.0-255,5738,133906,90,196644
15899,0.00104,74.125.24.0-255,1484,135390,90,196644
15900,0.001042,172.31.47.0-255,66,135456,90,196644
15901,0.001078,172.31.47.0-255,66,135522,90,196644
15902,0.001086,74.125.24.0-255,8574,144096,90,196644
15903,0.001095,172.31.47.0-255,66,144162,90,196644
15904,0.001099,74.125.24.0-255,2184,146346,90,196644
15905,0.001102,172.31.47.0-255,66,146412,90,196644
15906,0.002062,74.125.24.0-255,1484,147896,90,196644
15907,0.002078,74.125.24.0-255,2902,150798,90,196644
15908,0.002085,172.31.47.0-255,66,150864,90,196644
15909,0.002094,74.125.24.0-255,5738,156602,90,196644
15910,0.002096,172.31.47.0-255,66,156668,90,196644
15911,0.002116,74.125.24.0-255,5738,162406,90,196644
15912,0.002118,172.31.47.0-255,66,162472,90,196644
15913,0.002149,74.125.24.0-255,7156,169628,90,196644
15914,0.002152,172.31.47.0-255,66,169694,90,196644
15915,0.002157,74.125.24.0-255,4320,174014,90,196644
15916,0.002159,172.31.47.0-255,66,174080,90,196644
15917,0.002185,74.125.24.0-255,5738,179818,90,196644
15918,0.002187,172.31.47.0-255,66,179884,90,196644
15919,0.002213,74.125.24.0-255,766,180650,90,196644
15920,0.004337,74.125.24.0-255,4320,184970,90,196644
15921,0.004357,172.31.47.0-255,66,185036,90,196644
15922,0.006472,74.125.24.0-255,5738,190774,90,196644
15923,0.006484,172.31.47.0-255,66,190840,90,196644
15924,0.008631,74.125.24.0-255,5738,196578,90,196644
15925,0.008647,172.31.47.0-255,66,196644,90,196644
15926,0.0,172.217.194.0-255,153,153,90,289820
15927,2e-05,172.31.47.0-255,66,219,90,289820
15928,2.7e-05,172.217.194.0-255,1484,1703,90,289820
15929,3.1e-05,172.31.47.0-255,66,1769,90,289820
15930,4.3e-05,172.217.194.0-255,2902,4671,90,289820
15931,4.5e-05,172.31.47.0-255,66,4737,90,289820
15932,5.2e-05,172.217.194.0-255,7156,11893,90,289820
15933,5.4e-05,172.31.47.0-255,66,11959,90,289820
15934,5.9e-05,172.217.194.0-255,4320,16279,90,289820
15935,6.1e-05,172.31.47.0-255,66,16345,90,289820
15936,8.7e-05,172.217.194.0-255,547,16892,90,289820
15937,0.000104,172.31.47.0-255,66,16958,90,289820
15938,0.000122,172.31.47.0-255,66,17024,90,289820
15939,0.000162,172.217.194.0-255,1484,18508,90,289820
15940,0.000164,172.31.47.0-255,66,18574,90,289820
15941,0.000169,172.217.194.0-255,2902,21476,90,289820
15942,0.000171,172.31.47.0-255,66,21542,90,289820
15943,0.000174,172.217.194.0-255,1484,23026,90,289820
15944,0.000176,172.31.47.0-255,66,23092,90,289820
15945,0.000206,172.217.194.0-255,4320,27412,90,289820
15946,0.000208,172.31.47.0-255,66,27478,90,289820
15947,0.000216,172.217.194.0-255,9992,37470,90,289820
15948,0.000218,172.31.47.0-255,66,37536,90,289820
15949,0.000242,172.217.194.0-255,3961,41497,90,289820
15950,0.000244,172.31.47.0-255,66,41563,90,289820
15951,0.000251,172.217.194.0-255,8574,50137,90,289820
15952,0.000253,172.31.47.0-255,66,50203,90,289820
15953,0.00028,172.217.194.0-255,1413,51616,90,289820
15954,0.000282,172.31.47.0-255,66,51682,90,289820
15955,0.000285,172.217.194.0-255,99,51781,90,289820
15956,0.000286,172.31.47.0-255,66,51847,90,289820
15957,0.000315,172.217.194.0-255,1484,53331,90,289820
15958,0.000339,172.217.194.0-255,2902,56233,90,289820
15959,0.000341,172.31.47.0-255,66,56299,90,289820
15960,0.000371,172.217.194.0-255,7156,63455,90,289820
15961,0.000374,172.31.47.0-255,66,63521,90,289820
15962,0.000378,172.217.194.0-255,2902,66423,90,289820
15963,0.00038,172.31.47.0-255,66,66489,90,289820
15964,0.00041,172.217.194.0-255,2543,69032,90,289820
15965,0.000412,172.31.47.0-255,66,69098,90,289820
15966,0.000418,172.217.194.0-255,5738,74836,90,289820
15967,0.00042,172.31.47.0-255,66,74902,90,289820
15968,0.000423,172.217.194.0-255,2902,77804,90,289820
15969,0.000439,172.31.47.0-255,66,77870,90,289820
15970,0.000464,172.217.194.0-255,8215,86085,90,289820
15971,0.000469,172.31.47.0-255,66,86151,90,289820
15972,0.00049,172.217.194.0-255,1484,87635,90,289820
15973,0.000507,172.217.194.0-255,2902,90537,90,289820
15974,0.00051,172.31.47.0-255,66,90603,90,289820
15975,0.000538,172.217.194.0-255,5738,96341,90,289820
15976,0.00054,172.31.47.0-255,66,96407,90,289820
15977,0.000546,172.217.194.0-255,7156,103563,90,289820
15978,0.000548,172.31.47.0-255,66,103629,90,289820
15979,0.000563,172.217.194.0-255,9992,113621,90,289820
15980,0.000565,172.31.47.0-255,66,113687,90,289820
15981,0.000589,172.217.194.0-255,4320,118007,90,289820
15982,0.000592,172.31.47.0-255,66,118073,90,289820
15983,0.0006,172.217.194.0-255,2184,120257,90,289820
15984,0.000603,172.31.47.0-255,66,120323,90,289820
15985,0.000606,172.217.194.0-255,2902,123225,90,289820
15986,0.000608,172.31.47.0-255,66,123291,90,289820
15987,0.000613,172.217.194.0-255,4320,127611,90,289820
15988,0.000615,172.31.47.0-255,66,127677,90,289820
15989,0.000649,172.217.194.0-255,2902,130579,90,289820
15990,0.000652,172.31.47.0-255,66,130645,90,289820
15991,0.000659,172.217.194.0-255,7156,137801,90,289820
15992,0.000662,172.31.47.0-255,66,137867,90,289820
15993,0.000682,172.31.47.0-255,66,137933,90,289820
15994,0.000685,172.217.194.0-255,766,138699,90,289820
15995,0.000688,172.217.194.0-255,1484,140183,90,289820
15996,0.00069,172.31.47.0-255,66,140249,90,289820
15997,0.000693,172.217.194.0-255,1484,141733,90,289820
15998,0.000719,172.217.194.0-255,2902,144635,90,289820
15999,0.000722,172.31.47.0-255,66,144701,90,289820
16000,0.000731,172.217.194.0-255,9992,154693,90,289820
16001,0.000733,172.31.47.0-255,66,154759,90,289820
16002,0.000746,172.217.194.0-255,8574,163333,90,289820
16003,0.000749,172.31.47.0-255,66,163399,90,289820
16004,0.000824,172.217.194.0-255,9274,172673,90,289820
16005,0.000826,172.31.47.0-255,66,172739,90,289820
16006,0.000868,172.217.194.0-255,3201,175940,90,289820
16007,0.000871,172.31.47.0-255,66,176006,90,289820
16008,0.000876,172.217.194.0-255,4320,180326,90,289820
16009,0.000878,172.31.47.0-255,66,180392,90,289820
16010,0.000896,172.217.194.0-255,5738,186130,90,289820
16011,0.000898,172.31.47.0-255,66,186196,90,289820
16012,0.000921,172.217.194.0-255,4320,190516,90,289820
16013,0.000924,172.31.47.0-255,66,190582,90,289820
16014,0.000937,172.217.194.0-255,8574,199156,90,289820
16015,0.000941,172.31.47.0-255,66,199222,90,289820
16016,0.000971,172.217.194.0-255,7156,206378,90,289820
16017,0.000974,172.31.47.0-255,66,206444,90,289820
16018,0.000977,172.217.194.0-255,766,207210,90,289820
16019,0.001009,172.217.194.0-255,1484,208694,90,289820
16020,0.001012,172.31.47.0-255,66,208760,90,289820
16021,0.001016,172.217.194.0-255,2902,211662,90,289820
16022,0.001019,172.31.47.0-255,66,211728,90,289820
16023,0.001023,172.217.194.0-255,2902,214630,90,289820
16024,0.00103,172.31.47.0-255,66,214696,90,289820
16025,0.001058,172.217.194.0-255,2902,217598,90,289820
16026,0.001061,172.31.47.0-255,66,217664,90,289820
16027,0.001079,172.31.47.0-255,66,217730,90,289820
16028,0.001089,172.217.194.0-255,10692,228422,90,289820
16029,0.001091,172.31.47.0-255,66,228488,90,289820
16030,0.001208,172.217.194.0-255,1484,229972,90,289820
16031,0.001214,172.217.194.0-255,2902,232874,90,289820
16032,0.001217,172.31.47.0-255,66,232940,90,289820
16033,0.001249,172.217.194.0-255,5738,238678,90,289820
16034,0.001253,172.31.47.0-255,66,238744,90,289820
16035,0.001272,172.31.47.0-255,66,238810,90,289820
16036,0.001278,172.217.194.0-255,5738,244548,90,289820
16037,0.00128,172.31.47.0-255,66,244614,90,289820
16038,0.001303,172.217.194.0-255,5020,249634,90,289820
16039,0.001306,172.31.47.0-255,66,249700,90,289820
16040,0.001334,172.217.194.0-255,8574,258274,90,289820
16041,0.001336,172.31.47.0-255,66,258340,90,289820
16042,0.001345,172.217.194.0-255,8574,266914,90,289820
16043,0.001347,172.31.47.0-255,66,266980,90,289820
16044,0.001368,172.217.194.0-255,1484,268464,90,289820
16045,0.001373,172.217.194.0-255,2902,271366,90,289820
16046,0.001379,172.31.47.0-255,66,271432,90,289820
16047,0.001422,172.31.47.0-255,66,271498,90,289820
16048,0.001431,172.217.194.0-255,8574,280072,90,289820
16049,0.001433,172.31.47.0-255,66,280138,90,289820
16050,0.001477,172.217.194.0-255,6438,286576,90,289820
16051,0.001513,172.217.194.0-255,2902,289478,90,289820
16052,0.001524,172.31.47.0-255,66,289544,90,289820
16053,0.001556,172.217.194.0-255,105,289649,90,289820
16054,0.001568,172.31.47.0-255,66,289715,90,289820
16055,0.009738,172.31.47.0-255,105,289820,90,289820
16056,0.0,74.125.24.0-255,154,154,90,350067
16057,2.6e-05,172.31.47.0-255,66,220,90,350067
16058,3.1e-05,74.125.24.0-255,1484,1704,90,350067
16059,3.5e-05,172.31.47.0-255,66,1770,90,350067
16060,3.9e-05,74.125.24.0-255,2902,4672,90,350067
16061,4.1e-05,172.31.47.0-255,66,4738,90,350067
16062,6e-05,74.125.24.0-255,7156,11894,90,350067
16063,6.2e-05,172.31.47.0-255,66,11960,90,350067
16064,8.4e-05,74.125.24.0-255,2092,14052,90,350067
16065,8.6e-05,172.31.47.0-255,66,14118,90,350067
16066,0.0002,74.125.24.0-255,1484,15602,90,350067
16067,0.000204,172.31.47.0-255,66,15668,90,350067
16068,0.000208,74.125.24.0-255,2902,18570,90,350067
16069,0.000211,172.31.47.0-255,66,18636,90,350067
16070,0.000232,74.125.24.0-255,5738,24374,90,350067
16071,0.000237,172.31.47.0-255,66,24440,90,350067
16072,0.000268,74.125.24.0-255,5738,30178,90,350067
16073,0.000271,172.31.47.0-255,66,30244,90,350067
16074,0.000295,74.125.24.0-255,8215,38459,90,350067
16075,0.000298,172.31.47.0-255,66,38525,90,350067
16076,0.000303,74.125.24.0-255,5738,44263,90,350067
16077,0.000305,172.31.47.0-255,66,44329,90,350067
16078,0.00032,74.125.24.0-255,4320,48649,90,350067
16079,0.000324,172.31.47.0-255,66,48715,90,350067
16080,0.000334,74.125.24.0-255,2902,51617,90,350067
16081,0.000337,172.31.47.0-255,66,51683,90,350067
16082,0.000372,172.31.47.0-255,66,51749,90,350067
16083,0.000386,74.125.24.0-255,362,52111,90,350067
16084,0.000388,172.31.47.0-255,66,52177,90,350067
16085,0.000607,74.125.24.0-255,381,52558,90,350067
16086,0.000611,172.31.47.0-255,66,52624,90,350067
16087,0.000658,74.125.24.0-255,1484,54108,90,350067
16088,0.000682,74.125.24.0-255,4320,58428,90,350067
16089,0.000684,172.31.47.0-255,66,58494,90,350067
16090,0.000714,74.125.24.0-255,7156,65650,90,350067
16091,0.000717,172.31.47.0-255,66,65716,90,350067
16092,0.000755,172.31.47.0-255,66,65782,90,350067
16093,0.000774,74.125.24.0-255,4320,70102,90,350067
16094,0.000776,172.31.47.0-255,66,70168,90,350067
16095,0.000797,74.125.24.0-255,5020,75188,90,350067
16096,0.0008,172.31.47.0-255,66,75254,90,350067
16097,0.000831,74.125.24.0-255,1484,76738,90,350067
16098,0.000835,74.125.24.0-255,2902,79640,90,350067
16099,0.000837,172.31.47.0-255,66,79706,90,350067
16100,0.000856,74.125.24.0-255,5738,85444,90,350067
16101,0.00086,172.31.47.0-255,66,85510,90,350067
16102,0.000901,74.125.24.0-255,2902,88412,90,350067
16103,0.000904,172.31.47.0-255,66,88478,90,350067
16104,0.00092,74.125.24.0-255,9992,98470,90,350067
16105,0.000923,172.31.47.0-255,66,98536,90,350067
16106,0.00093,74.125.24.0-255,8574,107110,90,350067
16107,0.000932,172.31.47.0-255,66,107176,90,350067
16108,0.000944,74.125.24.0-255,2184,109360,90,350067
16109,0.000947,172.31.47.0-255,66,109426,90,350067
16110,0.00097,74.125.24.0-255,2902,112328,90,350067
16111,0.000972,172.31.47.0-255,66,112394,90,350067
16112,0.000977,74.125.24.0-255,4320,116714,90,350067
16113,0.000979,172.31.47.0-255,66,116780,90,350067
16114,0.000993,74.125.24.0-255,2902,119682,90,350067
16115,0.000995,172.31.47.0-255,66,119748,90,350067
16116,0.001,74.125.24.0-255,4320,124068,90,350067
16117,0.001003,172.31.47.0-255,66,124134,90,350067
16118,0.001026,74.125.24.0-255,5738,129872,90,350067
16119,0.001028,172.31.47.0-255,66,129938,90,350067
16120,0.001045,74.125.24.0-255,2902,132840,90,350067
16121,0.001047,172.31.47.0-255,66,132906,90,350067
16122,0.001077,74.125.24.0-255,10692,143598,90,350067
16123,0.00108,172.31.47.0-255,66,143664,90,350067
16124,0.001415,74.125.24.0-255,1484,145148,90,350067
16125,0.001422,74.125.24.0-255,1484,146632,90,350067
16126,0.001425,172.31.47.0-255,66,146698,90,350067
16127,0.001444,74.125.24.0-255,1484,148182,90,350067
16128,0.001447,74.125.24.0-255,1484,149666,90,350067
16129,0.001449,172.31.47.0-255,66,149732,90,350067
16130,0.001468,74.125.24.0-255,4320,154052,90,350067
16131,0.001471,172.31.47.0-255,66,154118,90,350067
16132,0.001478,74.125.24.0-255,7156,161274,90,350067
16133,0.00148,172.31.47.0-255,66,161340,90,350067
16134,0.001505,74.125.24.0-255,2902,164242,90,350067
16135,0.001508,172.31.47.0-255,66,164308,90,350067
16136,0.001519,172.31.47.0-255,66,164374,90,350067
16137,0.001522,74.125.24.0-255,2184,166558,90,350067
16138,0.001524,172.31.47.0-255,66,166624,90,350067
16139,0.001949,74.125.24.0-255,1484,168108,90,350067
16140,0.001965,74.125.24.0-255,1484,169592,90,350067
16141,0.001969,172.31.47.0-255,66,169658,90,350067
16142,0.001984,74.125.24.0-255,1484,171142,90,350067
16143,0.00199,74.125.24.0-255,5738,176880,90,350067
16144,0.001992,172.31.47.0-255,66,176946,90,350067
16145,0.001995,74.125.24.0-255,2902,179848,90,350067
16146,0.001997,172.31.47.0-255,66,179914,90,350067
16147,0.002012,74.125.24.0-255,7156,187070,90,350067
16148,0.002014,172.31.47.0-255,66,187136,90,350067
16149,0.002037,74.125.24.0-255,2902,190038,90,350067
16150,0.002038,172.31.47.0-255,66,190104,90,350067
16151,0.002046,74.125.24.0-255,10692,200796,90,350067
16152,0.002048,172.31.47.0-255,66,200862,90,350067
16153,0.002079,74.125.24.0-255,4320,205182,90,350067
16154,0.002081,172.31.47.0-255,66,205248,90,350067
16155,0.002103,74.125.24.0-255,7156,212404,90,350067
16156,0.002104,172.31.47.0-255,66,212470,90,350067
16157,0.002114,74.125.24.0-255,7156,219626,90,350067
16158,0.002116,172.31.47.0-255,66,219692,90,350067
16159,0.002134,74.125.24.0-255,2902,222594,90,350067
16160,0.002135,172.31.47.0-255,66,222660,90,350067
16161,0.00215,74.125.24.0-255,1484,224144,90,350067
16162,0.002174,74.125.24.0-255,10692,234836,90,350067
16163,0.002176,172.31.47.0-255,66,234902,90,350067
16164,0.002285,74.125.24.0-255,1484,236386,90,350067
16165,0.002298,74.125.24.0-255,2902,239288,90,350067
16166,0.0023,172.31.47.0-255,66,239354,90,350067
16167,0.002315,74.125.24.0-255,1484,240838,90,350067
16168,0.002338,74.125.24.0-255,5738,246576,90,350067
16169,0.00234,172.31.47.0-255,66,246642,90,350067
16170,0.002358,74.125.24.0-255,2902,249544,90,350067
16171,0.00236,172.31.47.0-255,66,249610,90,350067
16172,0.002363,74.125.24.0-255,2902,252512,90,350067
16173,0.002364,172.31.47.0-255,66,252578,90,350067
16174,0.002378,74.125.24.0-255,5738,258316,90,350067
16175,0.00238,172.31.47.0-255,66,258382,90,350067
16176,0.002394,74.125.24.0-255,2902,261284,90,350067
16177,0.002396,172.31.47.0-255,66,261350,90,350067
16178,0.002398,74.125.24.0-255,1484,262834,90,350067
16179,0.002402,74.125.24.0-255,2902,265736,90,350067
16180,0.002404,172.31.47.0-255,66,265802,90,350067
16181,0.002451,74.125.24.0-255,1484,267286,90,350067
16182,0.002454,74.125.24.0-255,2184,269470,90,350067
16183,0.002456,172.31.47.0-255,66,269536,90,350067
16184,0.002685,74.125.24.0-255,1484,271020,90,350067
16185,0.002706,74.125.24.0-255,2902,273922,90,350067
16186,0.002708,172.31.47.0-255,66,273988,90,350067
16187,0.002724,74.125.24.0-255,4320,278308,90,350067
16188,0.002726,172.31.47.0-255,66,278374,90,350067
16189,0.00274,74.125.24.0-255,1484,279858,90,350067
16190,0.002758,74.125.24.0-255,2902,282760,90,350067
16191,0.00276,172.31.47.0-255,66,282826,90,350067
16192,0.002773,74.125.24.0-255,7156,289982,90,350067
16193,0.002775,172.31.47.0-255,66,290048,90,350067
16194,0.002789,74.125.24.0-255,2902,292950,90,350067
16195,0.002791,172.31.47.0-255,66,293016,90,350067
16196,0.002793,74.125.24.0-255,1484,294500,90,350067
16197,0.002808,74.125.24.0-255,8574,303074,90,350067
16198,0.00281,172.31.47.0-255,66,303140,90,350067
16199,0.002826,74.125.24.0-255,3602,306742,90,350067
16200,0.002828,172.31.47.0-255,66,306808,90,350067
16201,0.002835,74.125.24.0-255,9992,316800,90,350067
16202,0.002837,172.31.47.0-255,66,316866,90,350067
16203,0.002866,74.125.24.0-255,4320,321186,90,350067
16204,0.002868,172.31.47.0-255,66,321252,90,350067
16205,0.002893,172.31.47.0-255,66,321318,90,350067
16206,0.002909,74.125.24.0-255,3602,324920,90,350067
16207,0.002911,172.31.47.0-255,66,324986,90,350067
16208,0.002921,74.125.24.0-255,2902,327888,90,350067
16209,0.002923,172.31.47.0-255,66,327954,90,350067
16210,0.002938,74.125.24.0-255,4320,332274,90,350067
16211,0.00294,172.31.47.0-255,66,332340,90,350067
16212,0.002946,74.125.24.0-255,8574,340914,90,350067
16213,0.002948,172.31.47.0-255,66,340980,90,350067
16214,0.002968,74.125.24.0-255,4320,345300,90,350067
16215,0.00297,172.31.47.0-255,66,345366,90,350067
16216,0.002995,172.31.47.0-255,66,345432,90,350067
16217,0.002997,74.125.24.0-255,766,346198,90,350067
16218,0.003022,74.125.24.0-255,3461,349659,90,350067
16219,0.003023,172.31.47.0-255,66,349725,90,350067
16220,0.003087,74.125.24.0-255,105,349830,90,350067
16221,0.007311,172.31.47.0-255,66,349896,90,350067
16222,0.007333,172.31.47.0-255,105,350001,90,350067
16223,0.009617,74.125.24.0-255,66,350067,90,350067
16224,0.0,74.125.24.0-255,66,66,90,66
16225,0.0,172.31.47.0-255,105,105,90,105
16226,0.0,74.125.200.0-255,144,144,90,344045
16227,3e-05,172.31.47.0-255,66,210,90,344045
16228,3.6e-05,74.125.200.0-255,1484,1694,90,344045
16229,4e-05,172.31.47.0-255,66,1760,90,344045
16230,4.5e-05,74.125.200.0-255,2902,4662,90,344045
16231,4.7e-05,172.31.47.0-255,66,4728,90,344045
16232,6.8e-05,74.125.200.0-255,7156,11884,90,344045
16233,7.1e-05,172.31.47.0-255,66,11950,90,344045
16234,7.4e-05,74.125.200.0-255,2138,14088,90,344045
16235,7.6e-05,172.31.47.0-255,66,14154,90,344045
16236,0.000125,74.125.200.0-255,1484,15638,90,344045
16237,0.000129,172.31.47.0-255,66,15704,90,344045
16238,0.00014,74.125.200.0-255,2902,18606,90,344045
16239,0.000142,172.31.47.0-255,66,18672,90,344045
16240,0.000172,74.125.200.0-255,5738,24410,90,344045
16241,0.000174,172.31.47.0-255,66,24476,90,344045
16242,0.000177,74.125.200.0-255,1484,25960,90,344045
16243,0.000178,172.31.47.0-255,66,26026,90,344045
16244,0.000182,74.125.200.0-255,2902,28928,90,344045
16245,0.000184,172.31.47.0-255,66,28994,90,344045
16246,0.000223,74.125.200.0-255,2543,31537,90,344045
16247,0.000225,172.31.47.0-255,66,31603,90,344045
16248,0.000291,74.125.200.0-255,1484,33087,90,344045
16249,0.000295,172.31.47.0-255,66,33153,90,344045
16250,0.000298,74.125.200.0-255,1484,34637,90,344045
16251,0.0003,172.31.47.0-255,66,34703,90,344045
16252,0.000312,74.125.200.0-255,1484,36187,90,344045
16253,0.000314,172.31.47.0-255,66,36253,90,344045
16254,0.000318,74.125.200.0-255,2902,39155,90,344045
16255,0.00032,172.31.47.0-255,66,39221,90,344045
16256,0.000337,74.125.200.0-255,2902,42123,90,344045
16257,0.000339,172.31.47.0-255,66,42189,90,344045
16258,0.000345,74.125.200.0-255,5738,47927,90,344045
16259,0.000347,172.31.47.0-255,66,47993,90,344045
16260,0.000365,74.125.200.0-255,1125,49118,90,344045
16261,0.000411,74.125.200.0-255,2902,52020,90,344045
16262,0.000414,172.31.47.0-255,66,52086,90,344045
16263,0.000438,74.125.200.0-255,9992,62078,90,344045
16264,0.000441,172.31.47.0-255,66,62144,90,344045
16265,0.000446,74.125.200.0-255,4272,66416,90,344045
16266,0.000447,172.31.47.0-255,66,66482,90,344045
16267,0.00045,74.125.200.0-255,109,66591,90,344045
16268,0.000471,74.125.200.0-255,334,66925,90,344045
16269,0.000699,172.31.47.0-255,66,66991,90,344045
16270,0.000707,74.125.200.0-255,1484,68475,90,344045
16271,0.000711,74.125.200.0-255,1484,69959,90,344045
16272,0.000714,172.31.47.0-255,66,70025,90,344045
16273,0.000736,74.125.200.0-255,1484,71509,90,344045
16274,0.00074,74.125.200.0-255,4320,75829,90,344045
16275,0.000744,172.31.47.0-255,66,75895,90,344045
16276,0.000753,74.125.200.0-255,4320,80215,90,344045
16277,0.000755,172.31.47.0-255,66,80281,90,344045
16278,0.000771,74.125.200.0-255,4320,84601,90,344045
16279,0.000773,172.31.47.0-255,66,84667,90,344045
16280,0.000777,74.125.200.0-255,2902,87569,90,344045
16281,0.000779,172.31.47.0-255,66,87635,90,344045
16282,0.000804,74.125.200.0-255,7156,94791,90,344045
16283,0.000806,172.31.47.0-255,66,94857,90,344045
16284,0.000843,74.125.200.0-255,6438,101295,90,344045
16285,0.000846,172.31.47.0-255,66,101361,90,344045
16286,0.001142,74.125.200.0-255,1484,102845,90,344045
16287,0.00115,74.125.200.0-255,2902,105747,90,344045
16288,0.001154,172.31.47.0-255,66,105813,90,344045
16289,0.001169,74.125.200.0-255,5738,111551,90,344045
16290,0.001173,172.31.47.0-255,66,111617,90,344045
16291,0.001176,74.125.200.0-255,1484,113101,90,344045
16292,0.001199,74.125.200.0-255,2902,116003,90,344045
16293,0.001201,172.31.47.0-255,66,116069,90,344045
16294,0.001207,74.125.200.0-255,5738,121807,90,344045
16295,0.001208,172.31.47.0-255,66,121873,90,344045
16296,0.001218,74.125.200.0-255,1484,123357,90,344045
16297,0.001239,74.125.200.0-255,8574,131931,90,344045
16298,0.001241,172.31.47.0-255,66,131997,90,344045
16299,0.001257,74.125.200.0-255,1484,133481,90,344045
16300,0.001261,74.125.200.0-255,2184,135665,90,344045
16301,0.001262,172.31.47.0-255,66,135731,90,344045
16302,0.001445,74.125.200.0-255,1484,137215,90,344045
16303,0.001458,74.125.200.0-255,1484,138699,90,344045
16304,0.001461,172.31.47.0-255,66,138765,90,344045
16305,0.001472,74.125.200.0-255,1484,140249,90,344045
16306,0.001491,74.125.200.0-255,5738,145987,90,344045
16307,0.001493,172.31.47.0-255,66,146053,90,344045
16308,0.001497,74.125.200.0-255,4320,150373,90,344045
16309,0.0015,172.31.47.0-255,66,150439,90,344045
16310,0.001522,74.125.200.0-255,2902,153341,90,344045
16311,0.001525,172.31.47.0-255,66,153407,90,344045
16312,0.001546,74.125.200.0-255,8574,161981,90,344045
16313,0.001548,172.31.47.0-255,66,162047,90,344045
16314,0.001553,74.125.200.0-255,5738,167785,90,344045
16315,0.001554,172.31.47.0-255,66,167851,90,344045
16316,0.001587,74.125.200.0-255,2184,170035,90,344045
16317,0.001589,172.31.47.0-255,66,170101,90,344045
16318,0.001678,74.125.200.0-255,1484,171585,90,344045
16319,0.001696,74.125.200.0-255,2902,174487,90,344045
16320,0.001698,172.31.47.0-255,66,174553,90,344045
16321,0.0017,74.125.200.0-255,1484,176037,90,344045
16322,0.001721,74.125.200.0-255,4320,180357,90,344045
16323,0.001723,172.31.47.0-255,66,180423,90,344045
16324,0.001763,172.31.47.0-255,66,180489,90,344045
16325,0.001791,74.125.200.0-255,2902,183391,90,344045
16326,0.001793,172.31.47.0-255,66,183457,90,344045
16327,0.001818,74.125.200.0-255,10692,194149,90,344045
16328,0.00182,172.31.47.0-255,66,194215,90,344045
16329,0.001825,74.125.200.0-255,5738,199953,90,344045
16330,0.001828,172.31.47.0-255,66,200019,90,344045
16331,0.001845,74.125.200.0-255,1484,201503,90,344045
16332,0.00186,74.125.200.0-255,7156,208659,90,344045
16333,0.001862,172.31.47.0-255,66,208725,90,344045
16334,0.001887,172.31.47.0-255,66,208791,90,344045
16335,0.001891,74.125.200.0-255,3602,212393,90,344045
16336,0.001892,172.31.47.0-255,66,212459,90,344045
16337,0.001968,74.125.200.0-255,1484,213943,90,344045
16338,0.00197,74.125.200.0-255,1484,215427,90,344045
16339,0.001973,172.31.47.0-255,66,215493,90,344045
16340,0.001984,74.125.200.0-255,1484,216977,90,344045
16341,0.002001,74.125.200.0-255,5738,222715,90,344045
16342,0.002003,172.31.47.0-255,66,222781,90,344045
16343,0.002005,74.125.200.0-255,1484,224265,90,344045
16344,0.002034,74.125.200.0-255,2902,227167,90,344045
16345,0.002036,172.31.47.0-255,66,227233,90,344045
16346,0.002041,74.125.200.0-255,5738,232971,90,344045
16347,0.002043,172.31.47.0-255,66,233037,90,344045
16348,0.002045,74.125.200.0-255,1484,234521,90,344045
16349,0.002068,74.125.200.0-255,9992,244513,90,344045
16350,0.00207,172.31.47.0-255,66,244579,90,344045
16351,0.002073,74.125.200.0-255,2184,246763,90,344045
16352,0.002074,172.31.47.0-255,66,246829,90,344045
16353,0.002135,74.125.200.0-255,1484,248313,90,344045
16354,0.002138,74.125.200.0-255,1484,249797,90,344045
16355,0.00214,172.31.47.0-255,66,249863,90,344045
16356,0.002157,74.125.200.0-255,1484,251347,90,344045
16357,0.002163,74.125.200.0-255,5738,257085,90,344045
16358,0.002165,172.31.47.0-255,66,257151,90,344045
16359,0.002168,74.125.200.0-255,2902,260053,90,344045
16360,0.00217,172.31.47.0-255,66,260119,90,344045
16361,0.002191,74.125.200.0-255,1484,261603,90,344045
16362,0.002216,74.125.200.0-255,8574,270177,90,344045
16363,0.002218,172.31.47.0-255,66,270243,90,344045
16364,0.002222,74.125.200.0-255,4320,274563,90,344045
16365,0.002224,172.31.47.0-255,66,274629,90,344045
16366,0.00224,74.125.200.0-255,6438,281067,90,344045
16367,0.002242,172.31.47.0-255,66,281133,90,344045
16368,0.002276,172.31.47.0-255,66,281199,90,344045
16369,0.002282,74.125.200.0-255,5738,286937,90,344045
16370,0.002284,172.31.47.0-255,66,287003,90,344045
16371,0.00231,74.125.200.0-255,7156,294159,90,344045
16372,0.002313,172.31.47.0-255,66,294225,90,344045
16373,0.002315,74.125.200.0-255,1484,295709,90,344045
16374,0.002331,74.125.200.0-255,4320,300029,90,344045
16375,0.002334,172.31.47.0-255,66,300095,90,344045
16376,0.002378,74.125.200.0-255,6438,306533,90,344045
16377,0.00238,172.31.47.0-255,66,306599,90,344045
16378,0.002403,74.125.200.0-255,7156,313755,90,344045
16379,0.002405,172.31.47.0-255,66,313821,90,344045
16380,0.002421,74.125.200.0-255,1484,315305,90,344045
16381,0.002454,172.31.47.0-255,66,315371,90,344045
16382,0.00247,74.125.200.0-255,2902,318273,90,344045
16383,0.002472,172.31.47.0-255,66,318339,90,344045
16384,0.002498,172.31.47.0-255,66,318405,90,344045
16385,0.002521,74.125.200.0-255,1484,319889,90,344045
16386,0.002536,74.125.200.0-255,5738,325627,90,344045
16387,0.002538,172.31.47.0-255,66,325693,90,344045
16388,0.002555,74.125.200.0-255,8574,334267,90,344045
16389,0.002558,172.31.47.0-255,66,334333,90,344045
16390,0.002586,74.125.200.0-255,9510,343843,90,344045
16391,0.002589,172.31.47.0-255,66,343909,90,344045
16392,0.005108,74.125.200.0-255,136,344045,90,344045
16393,0.0,74.125.24.0-255,152,152,90,229522
16394,1.4e-05,172.31.47.0-255,66,218,90,229522
16395,2.1e-05,74.125.24.0-255,1484,1702,90,229522
16396,2.5e-05,172.31.47.0-255,66,1768,90,229522
16397,3.8e-05,74.125.24.0-255,2902,4670,90,229522
16398,4.1e-05,172.31.47.0-255,66,4736,90,229522
16399,4.7e-05,74.125.24.0-255,4320,9056,90,229522
16400,4.9e-05,172.31.47.0-255,66,9122,90,229522
16401,9e-05,74.125.24.0-255,4974,14096,90,229522
16402,9.3e-05,172.31.47.0-255,66,14162,90,229522
16403,0.000248,74.125.24.0-255,1484,15646,90,229522
16404,0.000253,172.31.47.0-255,66,15712,90,229522
16405,0.000259,74.125.24.0-255,2902,18614,90,229522
16406,0.000261,172.31.47.0-255,66,18680,90,229522
16407,0.000298,74.125.24.0-255,5738,24418,90,229522
16408,0.000302,172.31.47.0-255,66,24484,90,229522
16409,0.000309,74.125.24.0-255,6797,31281,90,229522
16410,0.000312,172.31.47.0-255,66,31347,90,229522
16411,0.00036,172.31.47.0-255,66,31413,90,229522
16412,0.000377,172.31.47.0-255,66,31479,90,229522
16413,0.000402,74.125.24.0-255,5738,37217,90,229522
16414,0.000405,172.31.47.0-255,66,37283,90,229522
16415,0.000442,74.125.24.0-255,2561,39844,90,229522
16416,0.000445,172.31.47.0-255,66,39910,90,229522
16417,0.000498,74.125.24.0-255,1484,41394,90,229522
16418,0.0005,172.31.47.0-255,66,41460,90,229522
16419,0.000505,74.125.24.0-255,2902,44362,90,229522
16420,0.000507,172.31.47.0-255,66,44428,90,229522
16421,0.00051,74.125.24.0-255,1484,45912,90,229522
16422,0.000513,172.31.47.0-255,66,45978,90,229522
16423,0.000546,74.125.24.0-255,4320,50298,90,229522
16424,0.000549,172.31.47.0-255,66,50364,90,229522
16425,0.000566,172.31.47.0-255,66,50430,90,229522
16426,0.000574,74.125.24.0-255,8574,59004,90,229522
16427,0.000577,172.31.47.0-255,66,59070,90,229522
16428,0.0006,74.125.24.0-255,2451,61521,90,229522
16429,0.000603,172.31.47.0-255,66,61587,90,229522
16430,0.000871,74.125.24.0-255,1484,63071,90,229522
16431,0.000882,74.125.24.0-255,2902,65973,90,229522
16432,0.000886,172.31.47.0-255,66,66039,90,229522
16433,0.00093,74.125.24.0-255,4320,70359,90,229522
16434,0.000932,172.31.47.0-255,66,70425,90,229522
16435,0.000953,74.125.24.0-255,1484,71909,90,229522
16436,0.000959,74.125.24.0-255,7156,79065,90,229522
16437,0.000961,172.31.47.0-255,66,79131,90,229522
16438,0.000967,74.125.24.0-255,5738,84869,90,229522
16439,0.000969,172.31.47.0-255,66,84935,90,229522
16440,0.000996,74.125.24.0-255,8574,93509,90,229522
16441,0.000999,172.31.47.0-255,66,93575,90,229522
16442,0.001011,74.125.24.0-255,2184,95759,90,229522
16443,0.001016,172.31.47.0-255,66,95825,90,229522
16444,0.001114,74.125.24.0-255,1484,97309,90,229522
16445,0.001118,74.125.24.0-255,1484,98793,90,229522
16446,0.001121,172.31.47.0-255,66,98859,90,229522
16447,0.001143,74.125.24.0-255,1484,100343,90,229522
16448,0.001149,74.125.24.0-255,5738,106081,90,229522
16449,0.001158,172.31.47.0-255,66,106147,90,229522
16450,0.00116,74.125.24.0-255,1484,107631,90,229522
16451,0.001194,172.31.47.0-255,66,107697,90,229522
16452,0.001201,74.125.24.0-255,8574,116271,90,229522
16453,0.001203,172.31.47.0-255,66,116337,90,229522
16454,0.001231,74.125.24.0-255,2184,118521,90,229522
16455,0.001233,172.31.47.0-255,66,118587,90,229522
16456,0.001269,74.125.24.0-255,1484,120071,90,229522
16457,0.001272,74.125.24.0-255,1484,121555,90,229522
16458,0.001275,172.31.47.0-255,66,121621,90,229522
16459,0.001285,74.125.24.0-255,1484,123105,90,229522
16460,0.001294,74.125.24.0-255,5738,128843,90,229522
16461,0.001296,172.31.47.0-255,66,128909,90,229522
16462,0.00133,172.31.47.0-255,66,128975,90,229522
16463,0.001337,74.125.24.0-255,8574,137549,90,229522
16464,0.001339,172.31.47.0-255,66,137615,90,229522
16465,0.001389,172.31.47.0-255,66,137681,90,229522
16466,0.001418,74.125.24.0-255,9274,146955,90,229522
16467,0.001421,172.31.47.0-255,66,147021,90,229522
16468,0.001442,172.31.47.0-255,66,147087,90,229522
16469,0.001447,74.125.24.0-255,4320,151407,90,229522
16470,0.001449,172.31.47.0-255,66,151473,90,229522
16471,0.001497,172.31.47.0-255,66,151539,90,229522
16472,0.001505,74.125.24.0-255,9274,160813,90,229522
16473,0.001507,172.31.47.0-255,66,160879,90,229522
16474,0.001537,74.125.24.0-255,9992,170871,90,229522
16475,0.00154,172.31.47.0-255,66,170937,90,229522
16476,0.001545,74.125.24.0-255,5738,176675,90,229522
16477,0.001547,172.31.47.0-255,66,176741,90,229522
16478,0.001591,172.31.47.0-255,66,176807,90,229522
16479,0.001593,74.125.24.0-255,766,177573,90,229522
16480,0.002019,74.125.24.0-255,1484,179057,90,229522
16481,0.002023,172.31.47.0-255,66,179123,90,229522
16482,0.002028,74.125.24.0-255,2902,182025,90,229522
16483,0.002029,172.31.47.0-255,66,182091,90,229522
16484,0.002033,74.125.24.0-255,2902,184993,90,229522
16485,0.002035,172.31.47.0-255,66,185059,90,229522
16486,0.002064,74.125.24.0-255,2902,187961,90,229522
16487,0.00207,74.125.24.0-255,7156,195117,90,229522
16488,0.002074,172.31.47.0-255,66,195183,90,229522
16489,0.002076,172.31.47.0-255,66,195249,90,229522
16490,0.002086,74.125.24.0-255,5738,200987,90,229522
16491,0.002091,172.31.47.0-255,66,201053,90,229522
16492,0.002097,74.125.24.0-255,7156,208209,90,229522
16493,0.002099,172.31.47.0-255,66,208275,90,229522
16494,0.002129,74.125.24.0-255,3602,211877,90,229522
16495,0.002132,172.31.47.0-255,66,211943,90,229522
16496,0.002454,172.31.47.0-255,101,212044,90,229522
16497,0.0044,74.125.24.0-255,5738,217782,90,229522
16498,0.004409,172.31.47.0-255,66,217848,90,229522
16499,0.004681,74.125.24.0-255,66,217914,90,229522
16500,0.006718,74.125.24.0-255,5738,223652,90,229522
16501,0.006731,172.31.47.0-255,66,223718,90,229522
16502,0.00901,74.125.24.0-255,5738,229456,90,229522
16503,0.009018,172.31.47.0-255,66,229522,90,229522
16504,0.0,172.31.47.0-255,105,105,90,276
16505,0.001852,157.240.7.0-255,105,210,90,276
16506,0.001864,172.31.47.0-255,66,276,90,276
16507,0.0,172.217.194.0-255,151,151,90,289160
16508,2.2e-05,172.31.47.0-255,66,217,90,289160
16509,2.9e-05,172.217.194.0-255,1484,1701,90,289160
16510,3.2e-05,172.31.47.0-255,66,1767,90,289160
16511,3.8e-05,172.217.194.0-255,2902,4669,90,289160
16512,4e-05,172.31.47.0-255,66,4735,90,289160
16513,4.7e-05,172.217.194.0-255,7156,11891,90,289160
16514,5e-05,172.31.47.0-255,66,11957,90,289160
16515,5.3e-05,172.217.194.0-255,2065,14022,90,289160
16516,5.6e-05,172.31.47.0-255,66,14088,90,289160
16517,9.3e-05,172.217.194.0-255,5738,19826,90,289160
16518,9.6e-05,172.31.47.0-255,66,19892,90,289160
16519,0.000117,172.217.194.0-255,5738,25630,90,289160
16520,0.000119,172.31.47.0-255,66,25696,90,289160
16521,0.000124,172.217.194.0-255,5379,31075,90,289160
16522,0.000127,172.31.47.0-255,66,31141,90,289160
16523,0.000268,172.217.194.0-255,1484,32625,90,289160
16524,0.000271,172.31.47.0-255,66,32691,90,289160
16525,0.00029,172.217.194.0-255,2902,35593,90,289160
16526,0.000292,172.31.47.0-255,66,35659,90,289160
16527,0.000297,172.217.194.0-255,5738,41397,90,289160
16528,0.000299,172.31.47.0-255,66,41463,90,289160
16529,0.000335,172.31.47.0-255,66,41529,90,289160
16530,0.000359,172.217.194.0-255,1484,43013,90,289160
16531,0.000363,172.31.47.0-255,66,43079,90,289160
16532,0.000386,172.31.47.0-255,66,43145,90,289160
16533,0.000449,172.217.194.0-255,376,43521,90,289160
16534,0.000453,172.31.47.0-255,66,43587,90,289160
16535,0.000584,172.31.47.0-255,101,43688,90,289160
16536,0.000961,172.217.194.0-255,366,44054,90,289160
16537,0.001503,172.217.194.0-255,1484,45538,90,289160
16538,0.001508,172.31.47.0-255,66,45604,90,289160
16539,0.001528,172.217.194.0-255,2902,48506,90,289160
16540,0.00153,172.31.47.0-255,66,48572,90,289160
16541,0.001537,172.217.194.0-255,5738,54310,90,289160
16542,0.001538,172.31.47.0-255,66,54376,90,289160
16543,0.001544,172.217.194.0-255,5738,60114,90,289160
16544,0.001545,172.31.47.0-255,66,60180,90,289160
16545,0.001569,172.217.194.0-255,8574,68754,90,289160
16546,0.001571,172.31.47.0-255,66,68820,90,289160
16547,0.001594,172.217.194.0-255,4320,73140,90,289160
16548,0.001596,172.31.47.0-255,66,73206,90,289160
16549,0.001602,172.217.194.0-255,5020,78226,90,289160
16550,0.001604,172.31.47.0-255,66,78292,90,289160
16551,0.00198,172.217.194.0-255,1484,79776,90,289160
16552,0.001997,172.217.194.0-255,1484,81260,90,289160
16553,0.002,172.31.47.0-255,66,81326,90,289160
16554,0.002021,172.217.194.0-255,1484,82810,90,289160
16555,0.002028,172.217.194.0-255,5738,88548,90,289160
16556,0.00203,172.217.194.0-255,1484,90032,90,289160
16557,0.002031,172.31.47.0-255,66,90098,90,289160
16558,0.002071,172.31.47.0-255,66,90164,90,289160
16559,0.002078,172.217.194.0-255,8574,98738,90,289160
16560,0.00208,172.31.47.0-255,66,98804,90,289160
16561,0.002101,172.217.194.0-255,2184,100988,90,289160
16562,0.002104,172.31.47.0-255,66,101054,90,289160
16563,0.002108,172.217.194.0-255,2902,103956,90,289160
16564,0.002109,172.31.47.0-255,66,104022,90,289160
16565,0.002125,172.217.194.0-255,7156,111178,90,289160
16566,0.002128,172.31.47.0-255,66,111244,90,289160
16567,0.002151,172.217.194.0-255,7156,118400,90,289160
16568,0.002155,172.31.47.0-255,66,118466,90,289160
16569,0.002176,172.217.194.0-255,2902,121368,90,289160
16570,0.002178,172.31.47.0-255,66,121434,90,289160
16571,0.002189,172.31.47.0-255,66,121500,90,289160
16572,0.002209,172.217.194.0-255,2184,123684,90,289160
16573,0.002211,172.31.47.0-255,66,123750,90,289160
16574,0.002249,172.217.194.0-255,2902,126652,90,289160
16575,0.002252,172.31.47.0-255,66,126718,90,289160
16576,0.002255,172.217.194.0-255,1484,128202,90,289160
16577,0.002258,172.217.194.0-255,1484,129686,90,289160
16578,0.002259,172.31.47.0-255,66,129752,90,289160
16579,0.002275,172.217.194.0-255,4320,134072,90,289160
16580,0.002277,172.31.47.0-255,66,134138,90,289160
16581,0.002302,172.217.194.0-255,2902,137040,90,289160
16582,0.002304,172.31.47.0-255,66,137106,90,289160
16583,0.002328,172.217.194.0-255,9992,147098,90,289160
16584,0.00233,172.31.47.0-255,66,147164,90,289160
16585,0.002351,172.217.194.0-255,2902,150066,90,289160
16586,0.002353,172.31.47.0-255,66,150132,90,289160
16587,0.002381,172.217.194.0-255,7856,157988,90,289160
16588,0.002383,172.31.47.0-255,66,158054,90,289160
16589,0.002407,172.217.194.0-255,1484,159538,90,289160
16590,0.002412,172.217.194.0-255,2902,162440,90,289160
16591,0.002413,172.31.47.0-255,66,162506,90,289160
16592,0.002419,172.217.194.0-255,5738,168244,90,289160
16593,0.002421,172.31.47.0-255,66,168310,90,289160
16594,0.00244,172.217.194.0-255,2902,171212,90,289160
16595,0.002444,172.31.47.0-255,66,171278,90,289160
16596,0.002471,172.217.194.0-255,9992,181270,90,289160
16597,0.002474,172.31.47.0-255,66,181336,90,289160
16598,0.002479,172.217.194.0-255,5738,187074,90,289160
16599,0.002481,172.31.47.0-255,66,187140,90,289160
16600,0.0025,172.217.194.0-255,1484,188624,90,289160
16601,0.002521,172.217.194.0-255,3602,192226,90,289160
16602,0.002523,172.31.47.0-255,66,192292,90,289160
16603,0.002529,172.217.194.0-255,5738,198030,90,289160
16604,0.002531,172.31.47.0-255,66,198096,90,289160
16605,0.002558,172.217.194.0-255,2902,200998,90,289160
16606,0.002561,172.31.47.0-255,66,201064,90,289160
16607,0.00258,172.217.194.0-255,5738,206802,90,289160
16608,0.002584,172.31.47.0-255,66,206868,90,289160
16609,0.002596,172.217.194.0-255,9992,216860,90,289160
16610,0.002599,172.31.47.0-255,66,216926,90,289160
16611,0.002661,172.217.194.0-255,10692,227618,90,289160
16612,0.002664,172.31.47.0-255,66,227684,90,289160
16613,0.002675,172.31.47.0-255,66,227750,90,289160
16614,0.002687,172.31.47.0-255,66,227816,90,289160
16615,0.002714,172.217.194.0-255,1484,229300,90,289160
16616,0.002722,172.217.194.0-255,7856,237156,90,289160
16617,0.002725,172.31.47.0-255,66,237222,90,289160
16618,0.002737,172.31.47.0-255,66,237288,90,289160
16619,0.002739,172.217.194.0-255,1484,238772,90,289160
16620,0.002775,172.31.47.0-255,66,238838,90,289160
16621,0.002781,172.217.194.0-255,6438,245276,90,289160
16622,0.002783,172.31.47.0-255,66,245342,90,289160
16623,0.003089,172.217.194.0-255,66,245408,90,289160
16624,0.003223,172.217.194.0-255,1484,246892,90,289160
16625,0.003226,172.217.194.0-255,1484,248376,90,289160
16626,0.003229,172.31.47.0-255,66,248442,90,289160
16627,0.003249,172.217.194.0-255,1484,249926,90,289160
16628,0.003254,172.217.194.0-255,4320,254246,90,289160
16629,0.003256,172.31.47.0-255,66,254312,90,289160
16630,0.003275,172.217.194.0-255,1484,255796,90,289160
16631,0.003284,172.217.194.0-255,9992,265788,90,289160
16632,0.003295,172.31.47.0-255,66,265854,90,289160
16633,0.003339,172.217.194.0-255,4320,270174,90,289160
16634,0.003342,172.31.47.0-255,66,270240,90,289160
16635,0.003368,172.217.194.0-255,9274,279514,90,289160
16636,0.003371,172.31.47.0-255,66,279580,90,289160
16637,0.003384,172.31.47.0-255,66,279646,90,289160
16638,0.00339,172.217.194.0-255,7156,286802,90,289160
16639,0.003392,172.31.47.0-255,66,286868,90,289160
16640,0.003433,172.31.47.0-255,66,286934,90,289160
16641,0.003437,172.217.194.0-255,1950,288884,90,289160
16642,0.003438,172.31.47.0-255,66,288950,90,289160
16643,0.003493,172.217.194.0-255,105,289055,90,289160
16644,0.004298,172.31.47.0-255,105,289160,90,289160
16645,0.0,172.217.24.0-255,143,143,90,111919
16646,2.1e-05,172.31.47.0-255,66,209,90,111919
16647,2.7e-05,172.217.24.0-255,1484,1693,90,111919
16648,3.1e-05,172.31.47.0-255,66,1759,90,111919
16649,3.6e-05,172.217.24.0-255,2902,4661,90,111919
16650,4.5e-05,172.31.47.0-255,66,4727,90,111919
16651,5e-05,172.217.24.0-255,2902,7629,90,111919
16652,5.3e-05,172.31.47.0-255,66,7695,90,111919
16653,8.7e-05,172.217.24.0-255,4320,12015,90,111919
16654,9e-05,172.31.47.0-255,66,12081,90,111919
16655,9.8e-05,172.217.24.0-255,7882,19963,90,111919
16656,0.0001,172.31.47.0-255,66,20029,90,111919
16657,0.000141,172.217.24.0-255,1484,21513,90,111919
16658,0.000142,172.31.47.0-255,66,21579,90,111919
16659,0.000186,172.217.24.0-255,9633,31212,90,111919
16660,0.000188,172.31.47.0-255,66,31278,90,111919
16661,0.000211,172.217.24.0-255,1484,32762,90,111919
16662,0.000213,172.31.47.0-255,66,32828,90,111919
16663,0.000217,172.217.24.0-255,2902,35730,90,111919
16664,0.00022,172.31.47.0-255,66,35796,90,111919
16665,0.000237,172.217.24.0-255,5738,41534,90,111919
16666,0.000239,172.31.47.0-255,66,41600,90,111919
16667,0.000302,172.217.24.0-255,6797,48397,90,111919
16668,0.000305,172.31.47.0-255,66,48463,90,111919
16669,0.000478,172.217.24.0-255,1484,49947,90,111919
16670,0.000483,172.31.47.0-255,66,50013,90,111919
16671,0.000487,172.217.24.0-255,2902,52915,90,111919
16672,0.000489,172.31.47.0-255,66,52981,90,111919
16673,0.000494,172.217.24.0-255,4320,57301,90,111919
16674,0.000497,172.31.47.0-255,66,57367,90,111919
16675,0.000523,172.217.24.0-255,1484,58851,90,111919
16676,0.000525,172.31.47.0-255,66,58917,90,111919
16677,0.000532,172.217.24.0-255,7086,66003,90,111919
16678,0.000563,172.31.47.0-255,66,66069,90,111919
16679,0.001258,172.217.24.0-255,136,66205,90,111919
16680,0.001357,172.217.24.0-255,1484,67689,90,111919
16681,0.001362,172.31.47.0-255,66,67755,90,111919
16682,0.001369,172.217.24.0-255,2902,70657,90,111919
16683,0.001374,172.217.24.0-255,2902,73559,90,111919
16684,0.001385,172.217.24.0-255,4320,77879,90,111919
16685,0.001424,172.217.24.0-255,5379,83258,90,111919
16686,0.001472,172.217.24.0-255,5738,88996,90,111919
16687,0.001476,172.217.24.0-255,1484,90480,90,111919
16688,0.001496,172.217.24.0-255,1484,91964,90,111919
16689,0.001502,172.217.24.0-255,4320,96284,90,111919
16690,0.001544,172.217.24.0-255,3961,100245,90,111919
16691,0.005765,172.31.47.0-255,66,100311,90,111919
16692,0.007737,172.217.24.0-255,5738,106049,90,111919
16693,0.007751,172.31.47.0-255,66,106115,90,111919
16694,0.009713,172.217.24.0-255,5738,111853,90,111919
16695,0.00973,172.31.47.0-255,66,111919,90,111919
16696,0.0,74.125.24.0-255,152,152,90,326889
16697,3.1e-05,172.31.47.0-255,66,218,90,326889
16698,3.9e-05,74.125.24.0-255,1484,1702,90,326889
16699,4.3e-05,172.31.47.0-255,66,1768,90,326889
16700,4.9e-05,74.125.24.0-255,2902,4670,90,326889
16701,6e-05,172.31.47.0-255,66,4736,90,326889
16702,6.4e-05,74.125.24.0-255,2902,7638,90,326889
16703,6.7e-05,172.31.47.0-255,66,7704,90,326889
16704,7.2e-05,74.125.24.0-255,4320,12024,90,326889
16705,7.5e-05,172.31.47.0-255,66,12090,90,326889
16706,0.000108,74.125.24.0-255,2254,14344,90,326889
16707,0.000111,172.31.47.0-255,66,14410,90,326889
16708,0.00016,74.125.24.0-255,1484,15894,90,326889
16709,0.000163,172.31.47.0-255,66,15960,90,326889
16710,0.000169,74.125.24.0-255,2902,18862,90,326889
16711,0.000171,172.31.47.0-255,66,18928,90,326889
16712,0.000198,74.125.24.0-255,5738,24666,90,326889
16713,0.000201,172.31.47.0-255,66,24732,90,326889
16714,0.000208,74.125.24.0-255,6797,31529,90,326889
16715,0.00021,172.31.47.0-255,66,31595,90,326889
16716,0.000343,74.125.24.0-255,1484,33079,90,326889
16717,0.000347,172.31.47.0-255,66,33145,90,326889
16718,0.000352,74.125.24.0-255,2902,36047,90,326889
16719,0.000355,172.31.47.0-255,66,36113,90,326889
16720,0.000359,74.125.24.0-255,2902,39015,90,326889
16721,0.000362,172.31.47.0-255,66,39081,90,326889
16722,0.000388,74.125.24.0-255,2902,41983,90,326889
16723,0.000391,172.31.47.0-255,66,42049,90,326889
16724,0.000414,74.125.24.0-255,2902,44951,90,326889
16725,0.000417,172.31.47.0-255,66,45017,90,326889
16726,0.000451,74.125.24.0-255,3961,48978,90,326889
16727,0.000456,172.31.47.0-255,66,49044,90,326889
16728,0.000463,74.125.24.0-255,7156,56200,90,326889
16729,0.000468,172.31.47.0-255,66,56266,90,326889
16730,0.000508,74.125.24.0-255,9926,66192,90,326889
16731,0.000512,172.31.47.0-255,66,66258,90,326889
16732,0.000515,74.125.24.0-255,133,66391,90,326889
16733,0.000808,172.31.47.0-255,66,66457,90,326889
16734,0.000861,74.125.24.0-255,348,66805,90,326889
16735,0.000879,172.31.47.0-255,66,66871,90,326889
16736,0.001477,74.125.24.0-255,1484,68355,90,326889
16737,0.001489,74.125.24.0-255,2902,71257,90,326889
16738,0.001494,172.31.47.0-255,66,71323,90,326889
16739,0.001502,74.125.24.0-255,5738,77061,90,326889
16740,0.001504,172.31.47.0-255,66,77127,90,326889
16741,0.001527,172.31.47.0-255,66,77193,90,326889
16742,0.001574,74.125.24.0-255,10692,87885,90,326889
16743,0.001578,172.31.47.0-255,66,87951,90,326889
16744,0.001768,74.125.24.0-255,1484,89435,90,326889
16745,0.001781,74.125.24.0-255,2902,92337,90,326889
16746,0.001783,172.31.47.0-255,66,92403,90,326889
16747,0.001786,74.125.24.0-255,1484,93887,90,326889
16748,0.001803,74.125.24.0-255,4320,98207,90,326889
16749,0.001805,172.31.47.0-255,66,98273,90,326889
16750,0.001811,74.125.24.0-255,5738,104011,90,326889
16751,0.001812,172.31.47.0-255,66,104077,90,326889
16752,0.001842,74.125.24.0-255,7156,111233,90,326889
16753,0.001846,172.31.47.0-255,66,111299,90,326889
16754,0.001855,74.125.24.0-255,10692,121991,90,326889
16755,0.001857,172.31.47.0-255,66,122057,90,326889
16756,0.002024,74.125.24.0-255,1484,123541,90,326889
16757,0.002055,74.125.24.0-255,2902,126443,90,326889
16758,0.002058,172.31.47.0-255,66,126509,90,326889
16759,0.002061,74.125.24.0-255,1484,127993,90,326889
16760,0.002085,74.125.24.0-255,4320,132313,90,326889
16761,0.002087,172.31.47.0-255,66,132379,90,326889
16762,0.002095,74.125.24.0-255,8574,140953,90,326889
16763,0.002097,172.31.47.0-255,66,141019,90,326889
16764,0.002131,74.125.24.0-255,7156,148175,90,326889
16765,0.002134,172.31.47.0-255,66,148241,90,326889
16766,0.002137,74.125.24.0-255,1484,149725,90,326889
16767,0.002139,74.125.24.0-255,1484,151209,90,326889
16768,0.002141,172.31.47.0-255,66,151275,90,326889
16769,0.002145,74.125.24.0-255,2902,154177,90,326889
16770,0.002147,172.31.47.0-255,66,154243,90,326889
16771,0.00215,74.125.24.0-255,1484,155727,90,326889
16772,0.002176,74.125.24.0-255,766,156493,90,326889
16773,0.002178,172.31.47.0-255,66,156559,90,326889
16774,0.002221,74.125.24.0-255,1484,158043,90,326889
16775,0.002235,74.125.24.0-255,2902,160945,90,326889
16776,0.002237,172.31.47.0-255,66,161011,90,326889
16777,0.002262,74.125.24.0-255,5738,166749,90,326889
16778,0.002264,172.31.47.0-255,66,166815,90,326889
16779,0.002267,74.125.24.0-255,1484,168299,90,326889
16780,0.002295,172.31.47.0-255,66,168365,90,326889
16781,0.002302,74.125.24.0-255,8574,176939,90,326889
16782,0.002304,172.31.47.0-255,66,177005,90,326889
16783,0.002333,74.125.24.0-255,1484,178489,90,326889
16784,0.002349,74.125.24.0-255,766,179255,90,326889
16785,0.002351,172.31.47.0-255,66,179321,90,326889
16786,0.002379,74.125.24.0-255,2902,182223,90,326889
16787,0.002381,172.31.47.0-255,66,182289,90,326889
16788,0.002402,74.125.24.0-255,1484,183773,90,326889
16789,0.002408,74.125.24.0-255,5738,189511,90,326889
16790,0.00241,172.31.47.0-255,66,189577,90,326889
16791,0.002448,74.125.24.0-255,9992,199569,90,326889
16792,0.002451,172.31.47.0-255,66,199635,90,326889
16793,0.002458,74.125.24.0-255,8574,208209,90,326889
16794,0.00246,172.31.47.0-255,66,208275,90,326889
16795,0.002463,74.125.24.0-255,2902,211177,90,326889
16796,0.00247,172.31.47.0-255,66,211243,90,326889
16797,0.002474,74.125.24.0-255,2184,213427,90,326889
16798,0.002476,172.31.47.0-255,66,213493,90,326889
16799,0.002956,74.125.24.0-255,1484,214977,90,326889
16800,0.002974,74.125.24.0-255,2902,217879,90,326889
16801,0.002977,172.31.47.0-255,66,217945,90,326889
16802,0.002983,74.125.24.0-255,5738,223683,90,326889
16803,0.002985,172.31.47.0-255,66,223749,90,326889
16804,0.002988,74.125.24.0-255,1484,225233,90,326889
16805,0.003026,74.125.24.0-255,8574,233807,90,326889
16806,0.003029,172.31.47.0-255,66,233873,90,326889
16807,0.003055,74.125.24.0-255,2902,236775,90,326889
16808,0.003058,172.31.47.0-255,66,236841,90,326889
16809,0.003089,74.125.24.0-255,10692,247533,90,326889
16810,0.003093,172.31.47.0-255,66,247599,90,326889
16811,0.003115,74.125.24.0-255,1484,249083,90,326889
16812,0.003119,74.125.24.0-255,1484,250567,90,326889
16813,0.003133,74.125.24.0-255,1484,252051,90,326889
16814,0.003151,74.125.24.0-255,4320,256371,90,326889
16815,0.003169,74.125.24.0-255,1484,257855,90,326889
16816,0.003173,74.125.24.0-255,2902,260757,90,326889
16817,0.003192,74.125.24.0-255,4320,265077,90,326889
16818,0.003207,74.125.24.0-255,4320,269397,90,326889
16819,0.003223,74.125.24.0-255,9992,279389,90,326889
16820,0.003247,74.125.24.0-255,9274,288663,90,326889
16821,0.003252,74.125.24.0-255,4320,292983,90,326889
16822,0.003273,74.125.24.0-255,5738,298721,90,326889
16823,0.003291,74.125.24.0-255,2902,301623,90,326889
16824,0.003318,74.125.24.0-255,4320,305943,90,326889
16825,0.003534,74.125.24.0-255,1484,307427,90,326889
16826,0.003544,74.125.24.0-255,2902,310329,90,326889
16827,0.003557,74.125.24.0-255,5738,316067,90,326889
16828,0.003561,74.125.24.0-255,1484,317551,90,326889
16829,0.003586,74.125.24.0-255,8574,326125,90,326889
16830,0.003641,74.125.24.0-255,391,326516,90,326889
16831,0.003645,74.125.24.0-255,97,326613,90,326889
16832,0.003679,74.125.24.0-255,105,326718,90,326889
16833,0.005825,172.31.47.0-255,66,326784,90,326889
16834,0.008322,172.31.47.0-255,105,326889,90,326889
16835,0.0,74.125.200.0-255,431,431,90,161306
16836,2.5e-05,74.125.200.0-255,1484,1915,90,161306
16837,3.5e-05,172.31.47.0-255,66,1981,90,161306
16838,4.3e-05,74.125.200.0-255,4320,6301,90,161306
16839,4.6e-05,172.31.47.0-255,66,6367,90,161306
16840,0.000157,74.125.200.0-255,2902,9269,90,161306
16841,0.000161,172.31.47.0-255,66,9335,90,161306
16842,0.000256,74.125.200.0-255,2902,12237,90,161306
16843,0.000262,172.31.47.0-255,66,12303,90,161306
16844,0.00027,74.125.200.0-255,1484,13787,90,161306
16845,0.000417,74.125.200.0-255,5738,19525,90,161306
16846,0.000422,172.31.47.0-255,66,19591,90,161306
16847,0.000459,74.125.200.0-255,3404,22995,90,161306
16848,0.000463,172.31.47.0-255,66,23061,90,161306
16849,0.000738,74.125.200.0-255,7156,30217,90,161306
16850,0.000744,172.31.47.0-255,66,30283,90,161306
16851,0.002306,74.125.200.0-255,5738,36021,90,161306
16852,0.002312,172.31.47.0-255,66,36087,90,161306
16853,0.0024,74.125.200.0-255,5738,41825,90,161306
16854,0.00242,74.125.200.0-255,7156,48981,90,161306
16855,0.002433,172.31.47.0-255,66,49047,90,161306
16856,0.002854,74.125.200.0-255,5738,54785,90,161306
16857,0.002857,172.31.47.0-255,66,54851,90,161306
16858,0.002918,172.31.47.0-255,66,54917,90,161306
16859,0.00354,74.125.200.0-255,9992,64909,90,161306
16860,0.003545,172.31.47.0-255,66,64975,90,161306
16861,0.003577,74.125.200.0-255,8574,73549,90,161306
16862,0.003591,172.31.47.0-255,66,73615,90,161306
16863,0.004138,74.125.200.0-255,7156,80771,90,161306
16864,0.004141,172.31.47.0-255,66,80837,90,161306
16865,0.004555,74.125.200.0-255,5738,86575,90,161306
16866,0.004558,172.31.47.0-255,66,86641,90,161306
16867,0.004576,74.125.200.0-255,5738,92379,90,161306
16868,0.004597,172.31.47.0-255,66,92445,90,161306
16869,0.00468,74.125.200.0-255,4320,96765,90,161306
16870,0.004692,74.125.200.0-255,2902,99667,90,161306
16871,0.004698,172.31.47.0-255,66,99733,90,161306
16872,0.004709,74.125.200.0-255,9992,109725,90,161306
16873,0.004725,74.125.200.0-255,1484,111209,90,161306
16874,0.004728,172.31.47.0-255,66,111275,90,161306
16875,0.005171,74.125.200.0-255,5738,117013,90,161306
16876,0.005177,172.31.47.0-255,66,117079,90,161306
16877,0.005224,172.31.47.0-255,66,117145,90,161306
16878,0.005249,74.125.200.0-255,1484,118629,90,161306
16879,0.006403,74.125.200.0-255,7156,125785,90,161306
16880,0.006409,172.31.47.0-255,66,125851,90,161306
16881,0.006454,172.31.47.0-255,66,125917,90,161306
16882,0.006479,74.125.200.0-255,5738,131655,90,161306
16883,0.006483,172.31.47.0-255,66,131721,90,161306
16884,0.006992,172.31.47.0-255,66,131787,90,161306
16885,0.007047,172.31.47.0-255,66,131853,90,161306
16886,0.007443,74.125.200.0-255,7156,139009,90,161306
16887,0.007449,172.31.47.0-255,66,139075,90,161306
16888,0.00749,74.125.200.0-255,3032,142107,90,161306
16889,0.007495,172.31.47.0-255,66,142173,90,161306
16890,0.00754,172.31.47.0-255,66,142239,90,161306
16891,0.007627,172.31.47.0-255,66,142305,90,161306
16892,0.00872,74.125.200.0-255,9992,152297,90,161306
16893,0.008729,172.31.47.0-255,66,152363,90,161306
16894,0.008797,172.31.47.0-255,66,152429,90,161306
16895,0.008834,74.125.200.0-255,8574,161003,90,161306
16896,0.008839,172.31.47.0-255,66,161069,90,161306
16897,0.008936,172.31.47.0-255,66,161135,90,161306
16898,0.008997,172.31.47.0-255,66,161201,90,161306
16899,0.009821,172.31.47.0-255,105,161306,90,161306
16900,0.0,172.31.47.0-255,105,105,90,276
16901,0.00147,157.240.13.0-255,105,210,90,276
16902,0.001481,172.31.47.0-255,66,276,90,276
16903,0.0,74.125.24.0-255,153,153,90,291438
16904,1.7e-05,172.31.47.0-255,66,219,90,291438
16905,2.5e-05,74.125.24.0-255,1484,1703,90,291438
16906,2.9e-05,172.31.47.0-255,66,1769,90,291438
16907,3.5e-05,74.125.24.0-255,2902,4671,90,291438
16908,4.7e-05,172.31.47.0-255,66,4737,90,291438
16909,5.5e-05,74.125.24.0-255,7156,11893,90,291438
16910,5.8e-05,172.31.47.0-255,66,11959,90,291438
16911,6.3e-05,74.125.24.0-255,2038,13997,90,291438
16912,6.5e-05,172.31.47.0-255,66,14063,90,291438
16913,8.2e-05,74.125.24.0-255,1484,15547,90,291438
16914,8.4e-05,172.31.47.0-255,66,15613,90,291438
16915,0.000119,74.125.24.0-255,9992,25605,90,291438
16916,0.000122,172.31.47.0-255,66,25671,90,291438
16917,0.000128,74.125.24.0-255,5379,31050,90,291438
16918,0.000131,172.31.47.0-255,66,31116,90,291438
16919,0.000218,74.125.24.0-255,1484,32600,90,291438
16920,0.000221,172.31.47.0-255,66,32666,90,291438
16921,0.000226,74.125.24.0-255,2902,35568,90,291438
16922,0.000229,172.31.47.0-255,66,35634,90,291438
16923,0.00027,74.125.24.0-255,5738,41372,90,291438
16924,0.000273,172.31.47.0-255,66,41438,90,291438
16925,0.000278,74.125.24.0-255,2902,44340,90,291438
16926,0.00028,172.31.47.0-255,66,44406,90,291438
16927,0.000321,172.31.47.0-255,66,44472,90,291438
16928,0.000328,74.125.24.0-255,7156,51628,90,291438
16929,0.00033,172.31.47.0-255,66,51694,90,291438
16930,0.000352,74.125.24.0-255,2543,54237,90,291438
16931,0.000354,172.31.47.0-255,66,54303,90,291438
16932,0.000539,74.125.24.0-255,648,54951,90,291438
16933,0.000545,172.31.47.0-255,66,55017,90,291438
16934,0.000739,74.125.24.0-255,1484,56501,90,291438
16935,0.000753,74.125.24.0-255,2902,59403,90,291438
16936,0.000759,74.125.24.0-255,4320,63723,90,291438
16937,0.000772,74.125.24.0-255,1484,65207,90,291438
16938,0.000779,74.125.24.0-255,7156,72363,90,291438
16939,0.000791,172.31.47.0-255,66,72429,90,291438
16940,0.000834,74.125.24.0-255,2184,74613,90,291438
16941,0.000852,172.31.47.0-255,66,74679,90,291438
16942,0.000986,74.125.24.0-255,1484,76163,90,291438
16943,0.000991,74.125.24.0-255,1484,77647,90,291438
16944,0.000994,172.31.47.0-255,66,77713,90,291438
16945,0.001022,74.125.24.0-255,1484,79197,90,291438
16946,0.001029,74.125.24.0-255,5738,84935,90,291438
16947,0.001034,74.125.24.0-255,4320,89255,90,291438
16948,0.00104,74.125.24.0-255,5738,94993,90,291438
16949,0.001053,74.125.24.0-255,4320,99313,90,291438
16950,0.001072,74.125.24.0-255,7156,106469,90,291438
16951,0.001076,74.125.24.0-255,2184,108653,90,291438
16952,0.001081,74.125.24.0-255,2902,111555,90,291438
16953,0.001089,172.31.47.0-255,66,111621,90,291438
16954,0.00111,74.125.24.0-255,7156,118777,90,291438
16955,0.001116,74.125.24.0-255,2902,121679,90,291438
16956,0.001128,172.31.47.0-255,66,121745,90,291438
16957,0.00117,172.31.47.0-255,66,121811,90,291438
16958,0.001187,74.125.24.0-255,7856,129667,90,291438
16959,0.001227,172.31.47.0-255,66,129733,90,291438
16960,0.001237,74.125.24.0-255,1484,131217,90,291438
16961,0.001246,74.125.24.0-255,2902,134119,90,291438
16962,0.001251,74.125.24.0-255,4320,138439,90,291438
16963,0.001294,74.125.24.0-255,1484,139923,90,291438
16964,0.001301,74.125.24.0-255,5738,145661,90,291438
16965,0.001308,74.125.24.0-255,7156,152817,90,291438
16966,0.001327,74.125.24.0-255,5738,158555,90,291438
16967,0.001343,74.125.24.0-255,5020,163575,90,291438
16968,0.001413,74.125.24.0-255,1484,165059,90,291438
16969,0.001419,74.125.24.0-255,2902,167961,90,291438
16970,0.001422,74.125.24.0-255,1484,169445,90,291438
16971,0.001436,74.125.24.0-255,4320,173765,90,291438
16972,0.00145,74.125.24.0-255,1484,175249,90,291438
16973,0.001469,74.125.24.0-255,8574,183823,90,291438
16974,0.001492,74.125.24.0-255,2902,186725,90,291438
16975,0.001503,74.125.24.0-255,10692,197417,90,291438
16976,0.001523,74.125.24.0-255,1484,198901,90,291438
16977,0.001576,74.125.24.0-255,2902,201803,90,291438
16978,0.001597,74.125.24.0-255,5020,206823,90,291438
16979,0.001613,74.125.24.0-255,4320,211143,90,291438
16980,0.001626,74.125.24.0-255,4320,215463,90,291438
16981,0.001634,74.125.24.0-255,8574,224037,90,291438
16982,0.00173,74.125.24.0-255,3602,227639,90,291438
16983,0.001737,74.125.24.0-255,8574,236213,90,291438
16984,0.001767,74.125.24.0-255,9992,246205,90,291438
16985,0.001775,74.125.24.0-255,8574,254779,90,291438
16986,0.001803,74.125.24.0-255,1484,256263,90,291438
16987,0.001881,74.125.24.0-255,7856,264119,90,291438
16988,0.001894,74.125.24.0-255,1484,265603,90,291438
16989,0.001898,74.125.24.0-255,2902,268505,90,291438
16990,0.001913,74.125.24.0-255,5738,274243,90,291438
16991,0.001936,74.125.24.0-255,2902,277145,90,291438
16992,0.001952,74.125.24.0-255,7156,284301,90,291438
16993,0.001963,74.125.24.0-255,1484,285785,90,291438
16994,0.002015,74.125.24.0-255,1484,287269,90,291438
16995,0.002033,74.125.24.0-255,2902,290171,90,291438
16996,0.002073,74.125.24.0-255,991,291162,90,291438
16997,0.002107,74.125.24.0-255,105,291267,90,291438
16998,0.005586,172.31.47.0-255,66,291333,90,291438
16999,0.007986,172.31.47.0-255,105,291438,90,291438
17000,0.0,172.31.47.0-255,105,105,90,210
17001,0.0015,157.240.13.0-255,105,210,90,210
17002,0.0,172.217.194.0-255,153,153,90,312946
17003,2.8e-05,172.31.47.0-255,66,219,90,312946
17004,3.5e-05,172.217.194.0-255,1484,1703,90,312946
17005,3.9e-05,172.31.47.0-255,66,1769,90,312946
17006,5e-05,172.217.194.0-255,2902,4671,90,312946
17007,5.3e-05,172.31.47.0-255,66,4737,90,312946
17008,6.1e-05,172.217.194.0-255,5738,10475,90,312946
17009,6.4e-05,172.31.47.0-255,66,10541,90,312946
17010,9.2e-05,172.217.194.0-255,1484,12025,90,312946
17011,9.5e-05,172.31.47.0-255,66,12091,90,312946
17012,0.0001,172.217.194.0-255,2210,14301,90,312946
17013,0.000102,172.31.47.0-255,66,14367,90,312946
17014,0.000174,172.217.194.0-255,1484,15851,90,312946
17015,0.000179,172.31.47.0-255,66,15917,90,312946
17016,0.000185,172.217.194.0-255,2902,18819,90,312946
17017,0.000187,172.31.47.0-255,66,18885,90,312946
17018,0.000217,172.217.194.0-255,5738,24623,90,312946
17019,0.000221,172.31.47.0-255,66,24689,90,312946
17020,0.000224,172.217.194.0-255,1484,26173,90,312946
17021,0.000226,172.31.47.0-255,66,26239,90,312946
17022,0.000263,172.31.47.0-255,66,26305,90,312946
17023,0.000272,172.217.194.0-255,8574,34879,90,312946
17024,0.000274,172.31.47.0-255,66,34945,90,312946
17025,0.000309,172.217.194.0-255,4320,39265,90,312946
17026,0.000312,172.31.47.0-255,66,39331,90,312946
17027,0.000321,172.217.194.0-255,9992,49323,90,312946
17028,0.000325,172.31.47.0-255,66,49389,90,312946
17029,0.000353,172.217.194.0-255,3931,53320,90,312946
17030,0.000357,172.31.47.0-255,66,53386,90,312946
17031,0.000359,172.217.194.0-255,380,53766,90,312946
17032,0.000362,172.31.47.0-255,66,53832,90,312946
17033,0.00049,172.217.194.0-255,1484,55316,90,312946
17034,0.000495,172.217.194.0-255,1484,56800,90,312946
17035,0.000498,172.31.47.0-255,66,56866,90,312946
17036,0.000531,172.217.194.0-255,1484,58350,90,312946
17037,0.000538,172.217.194.0-255,5738,64088,90,312946
17038,0.000541,172.31.47.0-255,66,64154,90,312946
17039,0.000548,172.217.194.0-255,7156,71310,90,312946
17040,0.00055,172.31.47.0-255,66,71376,90,312946
17041,0.000581,172.217.194.0-255,5738,77114,90,312946
17042,0.000585,172.31.47.0-255,66,77180,90,312946
17043,0.000593,172.217.194.0-255,8574,85754,90,312946
17044,0.000596,172.31.47.0-255,66,85820,90,312946
17045,0.0006,172.217.194.0-255,2184,88004,90,312946
17046,0.000602,172.31.47.0-255,66,88070,90,312946
17047,0.000723,172.217.194.0-255,1484,89554,90,312946
17048,0.000728,172.217.194.0-255,2902,92456,90,312946
17049,0.000731,172.31.47.0-255,66,92522,90,312946
17050,0.000759,172.217.194.0-255,5738,98260,90,312946
17051,0.000763,172.31.47.0-255,66,98326,90,312946
17052,0.000795,172.217.194.0-255,9992,108318,90,312946
17053,0.000798,172.31.47.0-255,66,108384,90,312946
17054,0.000833,172.31.47.0-255,66,108450,90,312946
17055,0.00086,172.217.194.0-255,2184,110634,90,312946
17056,0.000863,172.31.47.0-255,66,110700,90,312946
17057,0.000866,172.217.194.0-255,1484,112184,90,312946
17058,0.00087,172.217.194.0-255,2902,115086,90,312946
17059,0.000872,172.31.47.0-255,66,115152,90,312946
17060,0.000877,172.217.194.0-255,4320,119472,90,312946
17061,0.000879,172.31.47.0-255,66,119538,90,312946
17062,0.000907,172.217.194.0-255,1484,121022,90,312946
17063,0.000914,172.217.194.0-255,7156,128178,90,312946
17064,0.000917,172.31.47.0-255,66,128244,90,312946
17065,0.000946,172.217.194.0-255,5738,133982,90,312946
17066,0.000949,172.31.47.0-255,66,134048,90,312946
17067,0.000982,172.217.194.0-255,10692,144740,90,312946
17068,0.000989,172.31.47.0-255,66,144806,90,312946
17069,0.000997,172.217.194.0-255,7156,151962,90,312946
17070,0.000999,172.31.47.0-255,66,152028,90,312946
17071,0.001032,172.217.194.0-255,4320,156348,90,312946
17072,0.001036,172.31.47.0-255,66,156414,90,312946
17073,0.001044,172.31.47.0-255,66,156480,90,312946
17074,0.001108,172.217.194.0-255,9274,165754,90,312946
17075,0.001113,172.31.47.0-255,66,165820,90,312946
17076,0.001219,172.217.194.0-255,1484,167304,90,312946
17077,0.001223,172.217.194.0-255,1484,168788,90,312946
17078,0.001226,172.31.47.0-255,66,168854,90,312946
17079,0.001249,172.217.194.0-255,1484,170338,90,312946
17080,0.001256,172.217.194.0-255,5738,176076,90,312946
17081,0.001259,172.31.47.0-255,66,176142,90,312946
17082,0.001265,172.217.194.0-255,5738,181880,90,312946
17083,0.001267,172.31.47.0-255,66,181946,90,312946
17084,0.001299,172.217.194.0-255,2902,184848,90,312946
17085,0.001302,172.31.47.0-255,66,184914,90,312946
17086,0.001335,172.217.194.0-255,5738,190652,90,312946
17087,0.001339,172.31.47.0-255,66,190718,90,312946
17088,0.001366,172.217.194.0-255,9274,199992,90,312946
17089,0.00137,172.31.47.0-255,66,200058,90,312946
17090,0.001397,172.217.194.0-255,1484,201542,90,312946
17091,0.001402,172.217.194.0-255,2902,204444,90,312946
17092,0.001405,172.31.47.0-255,66,204510,90,312946
17093,0.001411,172.217.194.0-255,5738,210248,90,312946
17094,0.001414,172.31.47.0-255,66,210314,90,312946
17095,0.001465,172.31.47.0-255,66,210380,90,312946
17096,0.001473,172.217.194.0-255,8574,218954,90,312946
17097,0.001476,172.31.47.0-255,66,219020,90,312946
17098,0.0015,172.217.194.0-255,1634,220654,90,312946
17099,0.001503,172.31.47.0-255,66,220720,90,312946
17100,0.001512,172.217.194.0-255,2902,223622,90,312946
17101,0.001515,172.31.47.0-255,66,223688,90,312946
17102,0.001518,172.217.194.0-255,1484,225172,90,312946
17103,0.001531,172.217.194.0-255,2902,228074,90,312946
17104,0.001534,172.31.47.0-255,66,228140,90,312946
17105,0.001567,172.217.194.0-255,8574,236714,90,312946
17106,0.001571,172.31.47.0-255,66,236780,90,312946
17107,0.00158,172.217.194.0-255,9992,246772,90,312946
17108,0.001582,172.31.47.0-255,66,246838,90,312946
17109,0.001613,172.217.194.0-255,5738,252576,90,312946
17110,0.001616,172.217.194.0-255,1484,254060,90,312946
17111,0.001618,172.31.47.0-255,66,254126,90,312946
17112,0.001661,172.217.194.0-255,7156,261282,90,312946
17113,0.001668,172.31.47.0-255,66,261348,90,312946
17114,0.001691,172.217.194.0-255,6797,268145,90,312946
17115,0.001698,172.217.194.0-255,4320,272465,90,312946
17116,0.001702,172.31.47.0-255,66,272531,90,312946
17117,0.001728,172.217.194.0-255,3961,276492,90,312946
17118,0.001739,172.31.47.0-255,66,276558,90,312946
17119,0.001761,172.217.194.0-255,1484,278042,90,312946
17120,0.001766,172.217.194.0-255,2902,280944,90,312946
17121,0.001769,172.31.47.0-255,66,281010,90,312946
17122,0.001776,172.217.194.0-255,5738,286748,90,312946
17123,0.001788,172.31.47.0-255,66,286814,90,312946
17124,0.001793,172.31.47.0-255,66,286880,90,312946
17125,0.001822,172.217.194.0-255,5738,292618,90,312946
17126,0.001834,172.31.47.0-255,66,292684,90,312946
17127,0.001862,172.31.47.0-255,66,292750,90,312946
17128,0.001927,172.217.194.0-255,9633,302383,90,312946
17129,0.001937,172.217.194.0-255,9992,312375,90,312946
17130,0.001941,172.31.47.0-255,66,312441,90,312946
17131,0.001948,172.217.194.0-255,97,312538,90,312946
17132,0.001955,172.31.47.0-255,66,312604,90,312946
17133,0.001975,172.217.194.0-255,105,312709,90,312946
17134,0.003479,172.31.47.0-255,66,312775,90,312946
17135,0.003506,172.31.47.0-255,105,312880,90,312946
17136,0.005728,172.217.194.0-255,66,312946,90,312946
17137,0.0,74.125.200.0-255,160,160,90,188267
17138,3.7e-05,172.31.47.0-255,66,226,90,188267
17139,4.3e-05,74.125.200.0-255,1484,1710,90,188267
17140,4.8e-05,172.31.47.0-255,66,1776,90,188267
17141,5.2e-05,74.125.200.0-255,2902,4678,90,188267
17142,6.1e-05,172.31.47.0-255,66,4744,90,188267
17143,6.7e-05,74.125.200.0-255,4320,9064,90,188267
17144,7e-05,172.31.47.0-255,66,9130,90,188267
17145,9.3e-05,74.125.200.0-255,2902,12032,90,188267
17146,9.8e-05,172.31.47.0-255,66,12098,90,188267
17147,0.000118,74.125.200.0-255,2127,14225,90,188267
17148,0.000122,172.31.47.0-255,66,14291,90,188267
17149,0.000335,74.125.200.0-255,1484,15775,90,188267
17150,0.00034,172.31.47.0-255,66,15841,90,188267
17151,0.000375,74.125.200.0-255,2902,18743,90,188267
17152,0.000379,172.31.47.0-255,66,18809,90,188267
17153,0.0004,74.125.200.0-255,4320,23129,90,188267
17154,0.000403,172.31.47.0-255,66,23195,90,188267
17155,0.000407,74.125.200.0-255,2902,26097,90,188267
17156,0.000409,172.31.47.0-255,66,26163,90,188267
17157,0.000434,74.125.200.0-255,2902,29065,90,188267
17158,0.000438,172.31.47.0-255,66,29131,90,188267
17159,0.000441,74.125.200.0-255,2543,31674,90,188267
17160,0.000449,172.31.47.0-255,66,31740,90,188267
17161,0.000779,74.125.200.0-255,1484,33224,90,188267
17162,0.000784,172.31.47.0-255,66,33290,90,188267
17163,0.000792,74.125.200.0-255,1484,34774,90,188267
17164,0.000795,172.31.47.0-255,66,34840,90,188267
17165,0.000807,74.125.200.0-255,2902,37742,90,188267
17166,0.00081,172.31.47.0-255,66,37808,90,188267
17167,0.000835,74.125.200.0-255,2902,40710,90,188267
17168,0.000844,172.31.47.0-255,66,40776,90,188267
17169,0.00085,74.125.200.0-255,2902,43678,90,188267
17170,0.000853,172.31.47.0-255,66,43744,90,188267
17171,0.000871,74.125.200.0-255,1484,45228,90,188267
17172,0.000894,74.125.200.0-255,3961,49189,90,188267
17173,0.000898,172.31.47.0-255,66,49255,90,188267
17174,0.000933,74.125.200.0-255,4320,53575,90,188267
17175,0.000936,172.31.47.0-255,66,53641,90,188267
17176,0.000941,74.125.200.0-255,2902,56543,90,188267
17177,0.000943,172.31.47.0-255,66,56609,90,188267
17178,0.000991,74.125.200.0-255,4320,60929,90,188267
17179,0.000995,172.31.47.0-255,66,60995,90,188267
17180,0.001002,74.125.200.0-255,5379,66374,90,188267
17181,0.001005,172.31.47.0-255,66,66440,90,188267
17182,0.001074,74.125.200.0-255,645,67085,90,188267
17183,0.001166,74.125.200.0-255,1484,68569,90,188267
17184,0.001171,172.31.47.0-255,66,68635,90,188267
17185,0.001175,74.125.200.0-255,1484,70119,90,188267
17186,0.0012,74.125.200.0-255,1484,71603,90,188267
17187,0.001203,172.31.47.0-255,66,71669,90,188267
17188,0.001208,74.125.200.0-255,2902,74571,90,188267
17189,0.00121,172.31.47.0-255,66,74637,90,188267
17190,0.001215,74.125.200.0-255,4320,78957,90,188267
17191,0.001224,172.31.47.0-255,66,79023,90,188267
17192,0.001255,74.125.200.0-255,5379,84402,90,188267
17193,0.001264,172.31.47.0-255,66,84468,90,188267
17194,0.001297,74.125.200.0-255,1484,85952,90,188267
17195,0.001324,74.125.200.0-255,2902,88854,90,188267
17196,0.001326,172.31.47.0-255,66,88920,90,188267
17197,0.001331,74.125.200.0-255,2902,91822,90,188267
17198,0.001333,172.31.47.0-255,66,91888,90,188267
17199,0.001361,74.125.200.0-255,2902,94790,90,188267
17200,0.001363,172.31.47.0-255,66,94856,90,188267
17201,0.001367,74.125.200.0-255,2902,97758,90,188267
17202,0.001369,172.31.47.0-255,66,97824,90,188267
17203,0.001398,74.125.200.0-255,3961,101785,90,188267
17204,0.0014,172.31.47.0-255,66,101851,90,188267
17205,0.001446,74.125.200.0-255,1484,103335,90,188267
17206,0.001465,74.125.200.0-255,2902,106237,90,188267
17207,0.001468,172.31.47.0-255,66,106303,90,188267
17208,0.001494,74.125.200.0-255,5738,112041,90,188267
17209,0.001496,172.31.47.0-255,66,112107,90,188267
17210,0.001522,74.125.200.0-255,4320,116427,90,188267
17211,0.001525,172.31.47.0-255,66,116493,90,188267
17212,0.001545,74.125.200.0-255,2902,119395,90,188267
17213,0.001548,172.31.47.0-255,66,119461,90,188267
17214,0.001555,74.125.200.0-255,7156,126617,90,188267
17215,0.001557,172.31.47.0-255,66,126683,90,188267
17216,0.001584,74.125.200.0-255,2902,129585,90,188267
17217,0.001586,172.31.47.0-255,66,129651,90,188267
17218,0.001613,74.125.200.0-255,6438,136089,90,188267
17219,0.001615,172.31.47.0-255,66,136155,90,188267
17220,0.001684,74.125.200.0-255,1484,137639,90,188267
17221,0.001697,74.125.200.0-255,1484,139123,90,188267
17222,0.001699,172.31.47.0-255,66,139189,90,188267
17223,0.001702,74.125.200.0-255,1484,140673,90,188267
17224,0.001725,74.125.200.0-255,1484,142157,90,188267
17225,0.001727,172.31.47.0-255,66,142223,90,188267
17226,0.001733,74.125.200.0-255,5738,147961,90,188267
17227,0.001735,172.31.47.0-255,66,148027,90,188267
17228,0.001762,74.125.200.0-255,9992,158019,90,188267
17229,0.001764,172.31.47.0-255,66,158085,90,188267
17230,0.001787,74.125.200.0-255,1484,159569,90,188267
17231,0.001804,74.125.200.0-255,4320,163889,90,188267
17232,0.001806,172.31.47.0-255,66,163955,90,188267
17233,0.00183,74.125.200.0-255,6438,170393,90,188267
17234,0.001833,172.31.47.0-255,66,170459,90,188267
17235,0.004024,74.125.200.0-255,2902,173361,90,188267
17236,0.004026,172.31.47.0-255,66,173427,90,188267
17237,0.004049,74.125.200.0-255,2902,176329,90,188267
17238,0.004051,172.31.47.0-255,66,176395,90,188267
17239,0.006224,74.125.200.0-255,2902,179297,90,188267
17240,0.00623,172.31.47.0-255,66,179363,90,188267
17241,0.006255,74.125.200.0-255,2902,182265,90,188267
17242,0.006258,172.31.47.0-255,66,182331,90,188267
17243,0.00843,74.125.200.0-255,2902,185233,90,188267
17244,0.008439,172.31.47.0-255,66,185299,90,188267
17245,0.008474,74.125.200.0-255,2902,188201,90,188267
17246,0.008477,172.31.47.0-255,66,188267,90,188267
17247,0.0,74.125.130.0-255,153,153,90,360851
17248,2.8e-05,172.31.47.0-255,66,219,90,360851
17249,3.5e-05,74.125.130.0-255,1484,1703,90,360851
17250,3.9e-05,172.31.47.0-255,66,1769,90,360851
17251,4.2e-05,74.125.130.0-255,2902,4671,90,360851
17252,4.5e-05,172.31.47.0-255,66,4737,90,360851
17253,5e-05,74.125.130.0-255,5738,10475,90,360851
17254,5.2e-05,172.31.47.0-255,66,10541,90,360851
17255,9.6e-05,74.125.130.0-255,1484,12025,90,360851
17256,9.8e-05,172.31.47.0-255,66,12091,90,360851
17257,0.000116,74.125.130.0-255,2172,14263,90,360851
17258,0.000119,172.31.47.0-255,66,14329,90,360851
17259,0.000191,74.125.130.0-255,1484,15813,90,360851
17260,0.000194,172.31.47.0-255,66,15879,90,360851
17261,0.000197,74.125.130.0-255,1484,17363,90,360851
17262,0.000199,172.31.47.0-255,66,17429,90,360851
17263,0.000213,74.125.130.0-255,1484,18913,90,360851
17264,0.000215,172.31.47.0-255,66,18979,90,360851
17265,0.000218,74.125.130.0-255,1484,20463,90,360851
17266,0.000219,172.31.47.0-255,66,20529,90,360851
17267,0.000238,74.125.130.0-255,4320,24849,90,360851
17268,0.000241,172.31.47.0-255,66,24915,90,360851
17269,0.000253,74.125.130.0-255,1484,26399,90,360851
17270,0.000256,172.31.47.0-255,66,26465,90,360851
17271,0.000276,74.125.130.0-255,5379,31844,90,360851
17272,0.000279,172.31.47.0-255,66,31910,90,360851
17273,0.000285,74.125.130.0-255,7156,39066,90,360851
17274,0.000289,172.31.47.0-255,66,39132,90,360851
17275,0.000313,74.125.130.0-255,8574,47706,90,360851
17276,0.000317,172.31.47.0-255,66,47772,90,360851
17277,0.000333,74.125.130.0-255,1125,48897,90,360851
17278,0.000336,172.31.47.0-255,66,48963,90,360851
17279,0.000352,74.125.130.0-255,1484,50447,90,360851
17280,0.000357,74.125.130.0-255,2902,53349,90,360851
17281,0.000368,172.31.47.0-255,66,53415,90,360851
17282,0.000379,74.125.130.0-255,5738,59153,90,360851
17283,0.000393,172.31.47.0-255,66,59219,90,360851
17284,0.000396,74.125.130.0-255,1484,60703,90,360851
17285,0.000414,74.125.130.0-255,5379,66082,90,360851
17286,0.000427,172.31.47.0-255,66,66148,90,360851
17287,0.000476,74.125.130.0-255,380,66528,90,360851
17288,0.000533,74.125.130.0-255,363,66891,90,360851
17289,0.000712,172.31.47.0-255,66,66957,90,360851
17290,0.000744,74.125.130.0-255,1484,68441,90,360851
17291,0.00075,74.125.130.0-255,2902,71343,90,360851
17292,0.000761,74.125.130.0-255,4320,75663,90,360851
17293,0.000771,172.31.47.0-255,66,75729,90,360851
17294,0.000771,74.125.130.0-255,1484,77213,90,360851
17295,0.000789,74.125.130.0-255,7156,84369,90,360851
17296,0.000803,172.31.47.0-255,66,84435,90,360851
17297,0.00081,74.125.130.0-255,5738,90173,90,360851
17298,0.000816,172.31.47.0-255,66,90239,90,360851
17299,0.000817,74.125.130.0-255,8574,98813,90,360851
17300,0.000827,172.31.47.0-255,66,98879,90,360851
17301,0.000829,74.125.130.0-255,2184,101063,90,360851
17302,0.000841,172.31.47.0-255,66,101129,90,360851
17303,0.001199,74.125.130.0-255,1484,102613,90,360851
17304,0.001208,74.125.130.0-255,2902,105515,90,360851
17305,0.001211,172.31.47.0-255,66,105581,90,360851
17306,0.001217,74.125.130.0-255,4320,109901,90,360851
17307,0.00123,74.125.130.0-255,1484,111385,90,360851
17308,0.001264,74.125.130.0-255,2902,114287,90,360851
17309,0.001278,74.125.130.0-255,4320,118607,90,360851
17310,0.001305,74.125.130.0-255,5020,123627,90,360851
17311,0.00132,74.125.130.0-255,1484,125111,90,360851
17312,0.001324,74.125.130.0-255,2902,128013,90,360851
17313,0.001345,74.125.130.0-255,5738,133751,90,360851
17314,0.001356,74.125.130.0-255,1484,135235,90,360851
17315,0.001386,74.125.130.0-255,8574,143809,90,360851
17316,0.001422,74.125.130.0-255,2184,145993,90,360851
17317,0.001441,74.125.130.0-255,2902,148895,90,360851
17318,0.001445,74.125.130.0-255,2902,151797,90,360851
17319,0.001461,74.125.130.0-255,4320,156117,90,360851
17320,0.00148,74.125.130.0-255,8574,164691,90,360851
17321,0.001491,74.125.130.0-255,4320,169011,90,360851
17322,0.001523,74.125.130.0-255,2902,171913,90,360851
17323,0.001546,74.125.130.0-255,7856,179769,90,360851
17324,0.001592,74.125.130.0-255,1484,181253,90,360851
17325,0.00161,74.125.130.0-255,2902,184155,90,360851
17326,0.001615,74.125.130.0-255,4320,188475,90,360851
17327,0.001631,74.125.130.0-255,1484,189959,90,360851
17328,0.001633,74.125.130.0-255,1484,191443,90,360851
17329,0.001636,74.125.130.0-255,2902,194345,90,360851
17330,0.001655,74.125.130.0-255,5738,200083,90,360851
17331,0.001682,74.125.130.0-255,4320,204403,90,360851
17332,0.001706,74.125.130.0-255,9274,213677,90,360851
17333,0.001716,74.125.130.0-255,1484,215161,90,360851
17334,0.001728,74.125.130.0-255,2902,218063,90,360851
17335,0.001733,74.125.130.0-255,4320,222383,90,360851
17336,0.00174,74.125.130.0-255,1484,223867,90,360851
17337,0.00176,74.125.130.0-255,5738,229605,90,360851
17338,0.001778,74.125.130.0-255,5738,235343,90,360851
17339,0.001785,74.125.130.0-255,8574,243917,90,360851
17340,0.001799,74.125.130.0-255,3602,247519,90,360851
17341,0.001838,74.125.130.0-255,1484,249003,90,360851
17342,0.00185,74.125.130.0-255,1484,250487,90,360851
17343,0.001857,74.125.130.0-255,1484,251971,90,360851
17344,0.001872,74.125.130.0-255,5738,257709,90,360851
17345,0.001876,74.125.130.0-255,2902,260611,90,360851
17346,0.001883,74.125.130.0-255,1484,262095,90,360851
17347,0.001887,74.125.130.0-255,4320,266415,90,360851
17348,0.001895,74.125.130.0-255,1484,267899,90,360851
17349,0.001922,74.125.130.0-255,2902,270801,90,360851
17350,0.001947,74.125.130.0-255,8574,279375,90,360851
17351,0.00195,74.125.130.0-255,2184,281559,90,360851
17352,0.002023,74.125.130.0-255,1484,283043,90,360851
17353,0.002035,74.125.130.0-255,2902,285945,90,360851
17354,0.002055,74.125.130.0-255,5738,291683,90,360851
17355,0.002074,74.125.130.0-255,2902,294585,90,360851
17356,0.002102,74.125.130.0-255,9992,304577,90,360851
17357,0.002109,74.125.130.0-255,9992,314569,90,360851
17358,0.002122,74.125.130.0-255,766,315335,90,360851
17359,0.002152,74.125.130.0-255,1484,316819,90,360851
17360,0.002172,74.125.130.0-255,4320,321139,90,360851
17361,0.002195,74.125.130.0-255,9992,331131,90,360851
17362,0.002201,74.125.130.0-255,7156,338287,90,360851
17363,0.002212,74.125.130.0-255,1484,339771,90,360851
17364,0.002234,74.125.130.0-255,7156,346927,90,360851
17365,0.002238,74.125.130.0-255,3602,350529,90,360851
17366,0.004168,172.31.47.0-255,66,350595,90,360851
17367,0.006385,74.125.130.0-255,4320,354915,90,360851
17368,0.00639,172.31.47.0-255,66,354981,90,360851
17369,0.006406,74.125.130.0-255,1484,356465,90,360851
17370,0.008591,74.125.130.0-255,4320,360785,90,360851
17371,0.008596,172.31.47.0-255,66,360851,90,360851
17372,0.0,74.125.130.0-255,153,153,90,254448
17373,2.9e-05,172.31.47.0-255,66,219,90,254448
17374,3.6e-05,74.125.130.0-255,1484,1703,90,254448
17375,4.1e-05,172.31.47.0-255,66,1769,90,254448
17376,4.6e-05,74.125.130.0-255,2902,4671,90,254448
17377,4.8e-05,172.31.47.0-255,66,4737,90,254448
17378,6.1e-05,74.125.130.0-255,4320,9057,90,254448
17379,6.3e-05,172.31.47.0-255,66,9123,90,254448
17380,0.0001,74.125.130.0-255,4984,14107,90,254448
17381,0.000104,172.31.47.0-255,66,14173,90,254448
17382,0.00011,74.125.130.0-255,5738,19911,90,254448
17383,0.000112,172.31.47.0-255,66,19977,90,254448
17384,0.000144,74.125.130.0-255,7156,27133,90,254448
17385,0.000148,172.31.47.0-255,66,27199,90,254448
17386,0.000167,74.125.130.0-255,3961,31160,90,254448
17387,0.000171,172.31.47.0-255,66,31226,90,254448
17388,0.000322,74.125.130.0-255,1484,32710,90,254448
17389,0.000327,172.31.47.0-255,66,32776,90,254448
17390,0.000332,74.125.130.0-255,2902,35678,90,254448
17391,0.000335,172.31.47.0-255,66,35744,90,254448
17392,0.000362,74.125.130.0-255,5738,41482,90,254448
17393,0.000366,172.31.47.0-255,66,41548,90,254448
17394,0.00037,74.125.130.0-255,2902,44450,90,254448
17395,0.000372,172.31.47.0-255,66,44516,90,254448
17396,0.000376,74.125.130.0-255,4320,48836,90,254448
17397,0.000379,172.31.47.0-255,66,48902,90,254448
17398,0.000425,74.125.130.0-255,7156,56058,90,254448
17399,0.000429,172.31.47.0-255,66,56124,90,254448
17400,0.000457,74.125.130.0-255,4320,60444,90,254448
17401,0.000462,172.31.47.0-255,66,60510,90,254448
17402,0.00047,74.125.130.0-255,4320,64830,90,254448
17403,0.000472,172.31.47.0-255,66,64896,90,254448
17404,0.000478,74.125.130.0-255,766,65662,90,254448
17405,0.000499,74.125.130.0-255,341,66003,90,254448
17406,0.000502,74.125.130.0-255,403,66406,90,254448
17407,0.000702,74.125.130.0-255,1484,67890,90,254448
17408,0.000706,172.31.47.0-255,66,67956,90,254448
17409,0.000717,74.125.130.0-255,1484,69440,90,254448
17410,0.000733,74.125.130.0-255,1484,70924,90,254448
17411,0.000736,172.31.47.0-255,66,70990,90,254448
17412,0.000759,74.125.130.0-255,5738,76728,90,254448
17413,0.000761,172.31.47.0-255,66,76794,90,254448
17414,0.000765,74.125.130.0-255,2902,79696,90,254448
17415,0.000767,172.31.47.0-255,66,79762,90,254448
17416,0.000792,74.125.130.0-255,4320,84082,90,254448
17417,0.000797,172.31.47.0-255,66,84148,90,254448
17418,0.00082,74.125.130.0-255,2902,87050,90,254448
17419,0.000822,172.31.47.0-255,66,87116,90,254448
17420,0.000846,74.125.130.0-255,4320,91436,90,254448
17421,0.000849,172.31.47.0-255,66,91502,90,254448
17422,0.000854,74.125.130.0-255,4320,95822,90,254448
17423,0.000856,172.31.47.0-255,66,95888,90,254448
17424,0.000884,74.125.130.0-255,4320,100208,90,254448
17425,0.000887,172.31.47.0-255,66,100274,90,254448
17426,0.000889,74.125.130.0-255,766,101040,90,254448
17427,0.001012,74.125.130.0-255,1484,102524,90,254448
17428,0.001015,172.31.47.0-255,66,102590,90,254448
17429,0.001019,74.125.130.0-255,1484,104074,90,254448
17430,0.00104,74.125.130.0-255,1484,105558,90,254448
17431,0.001043,172.31.47.0-255,66,105624,90,254448
17432,0.001049,74.125.130.0-255,5738,111362,90,254448
17433,0.001051,172.31.47.0-255,66,111428,90,254448
17434,0.001071,74.125.130.0-255,2902,114330,90,254448
17435,0.001073,172.31.47.0-255,66,114396,90,254448
17436,0.001103,74.125.130.0-255,9992,124388,90,254448
17437,0.001105,172.31.47.0-255,66,124454,90,254448
17438,0.001134,74.125.130.0-255,10692,135146,90,254448
17439,0.001138,172.31.47.0-255,66,135212,90,254448
17440,0.001544,74.125.130.0-255,1484,136696,90,254448
17441,0.001553,74.125.130.0-255,2902,139598,90,254448
17442,0.001557,172.31.47.0-255,66,139664,90,254448
17443,0.001561,74.125.130.0-255,1484,141148,90,254448
17444,0.001587,74.125.130.0-255,4320,145468,90,254448
17445,0.001589,172.31.47.0-255,66,145534,90,254448
17446,0.001593,74.125.130.0-255,2902,148436,90,254448
17447,0.001596,172.31.47.0-255,66,148502,90,254448
17448,0.001605,74.125.130.0-255,4320,152822,90,254448
17449,0.001607,172.31.47.0-255,66,152888,90,254448
17450,0.001634,74.125.130.0-255,4320,157208,90,254448
17451,0.001636,172.31.47.0-255,66,157274,90,254448
17452,0.001656,74.125.130.0-255,4320,161594,90,254448
17453,0.001662,172.31.47.0-255,66,161660,90,254448
17454,0.001665,74.125.130.0-255,1484,163144,90,254448
17455,0.001693,74.125.130.0-255,4320,167464,90,254448
17456,0.001695,172.31.47.0-255,66,167530,90,254448
17457,0.00172,74.125.130.0-255,2184,169714,90,254448
17458,0.001722,172.31.47.0-255,66,169780,90,254448
17459,0.002087,74.125.130.0-255,1484,171264,90,254448
17460,0.002104,74.125.130.0-255,2902,174166,90,254448
17461,0.002107,172.31.47.0-255,66,174232,90,254448
17462,0.002113,74.125.130.0-255,2902,177134,90,254448
17463,0.002114,172.31.47.0-255,66,177200,90,254448
17464,0.002137,74.125.130.0-255,2902,180102,90,254448
17465,0.002139,172.31.47.0-255,66,180168,90,254448
17466,0.002146,74.125.130.0-255,7156,187324,90,254448
17467,0.002147,172.31.47.0-255,66,187390,90,254448
17468,0.002155,74.125.130.0-255,1484,188874,90,254448
17469,0.002184,74.125.130.0-255,7156,196030,90,254448
17470,0.002186,172.31.47.0-255,66,196096,90,254448
17471,0.00219,74.125.130.0-255,2902,198998,90,254448
17472,0.002192,172.31.47.0-255,66,199064,90,254448
17473,0.002214,74.125.130.0-255,5020,204084,90,254448
17474,0.002217,172.31.47.0-255,66,204150,90,254448
17475,0.002246,74.125.130.0-255,8574,212724,90,254448
17476,0.002248,172.31.47.0-255,66,212790,90,254448
17477,0.002255,74.125.130.0-255,7156,219946,90,254448
17478,0.002257,172.31.47.0-255,66,220012,90,254448
17479,0.002267,74.125.130.0-255,5738,225750,90,254448
17480,0.002269,172.31.47.0-255,66,225816,90,254448
17481,0.002294,74.125.130.0-255,2902,228718,90,254448
17482,0.002296,172.31.47.0-255,66,228784,90,254448
17483,0.002302,74.125.130.0-255,7156,235940,90,254448
17484,0.002304,172.31.47.0-255,66,236006,90,254448
17485,0.002322,74.125.130.0-255,2184,238190,90,254448
17486,0.002324,172.31.47.0-255,66,238256,90,254448
17487,0.004551,74.125.130.0-255,2902,241158,90,254448
17488,0.004555,172.31.47.0-255,66,241224,90,254448
17489,0.004579,74.125.130.0-255,2902,244126,90,254448
17490,0.004581,172.31.47.0-255,66,244192,90,254448
17491,0.006813,74.125.130.0-255,4320,248512,90,254448
17492,0.006822,172.31.47.0-255,66,248578,90,254448
17493,0.006856,74.125.130.0-255,1484,250062,90,254448
17494,0.009086,74.125.130.0-255,4320,254382,90,254448
17495,0.009094,172.31.47.0-255,66,254448,90,254448
17496,0.0,74.125.24.0-255,153,153,90,269816
17497,2.1e-05,172.31.47.0-255,66,219,90,269816
17498,2.8e-05,74.125.24.0-255,1484,1703,90,269816
17499,3.2e-05,172.31.47.0-255,66,1769,90,269816
17500,3.5e-05,74.125.24.0-255,1484,3253,90,269816
17501,3.8e-05,172.31.47.0-255,66,3319,90,269816
17502,4.5e-05,74.125.24.0-255,4320,7639,90,269816
17503,4.8e-05,172.31.47.0-255,66,7705,90,269816
17504,8.9e-05,74.125.24.0-255,2902,10607,90,269816
17505,9.2e-05,172.31.47.0-255,66,10673,90,269816
17506,0.000122,74.125.24.0-255,7878,18551,90,269816
17507,0.000124,172.31.47.0-255,66,18617,90,269816
17508,0.000135,172.31.47.0-255,66,18683,90,269816
17509,0.000137,74.125.24.0-255,1125,19808,90,269816
17510,0.00014,172.31.47.0-255,66,19874,90,269816
17511,0.000219,74.125.24.0-255,1484,21358,90,269816
17512,0.000222,172.31.47.0-255,66,21424,90,269816
17513,0.000234,74.125.24.0-255,2902,24326,90,269816
17514,0.000236,172.31.47.0-255,66,24392,90,269816
17515,0.000239,74.125.24.0-255,1484,25876,90,269816
17516,0.000241,172.31.47.0-255,66,25942,90,269816
17517,0.000255,74.125.24.0-255,4320,30262,90,269816
17518,0.000258,172.31.47.0-255,66,30328,90,269816
17519,0.000285,74.125.24.0-255,2902,33230,90,269816
17520,0.000287,172.31.47.0-255,66,33296,90,269816
17521,0.000303,74.125.24.0-255,9992,43288,90,269816
17522,0.000306,172.31.47.0-255,66,43354,90,269816
17523,0.000326,74.125.24.0-255,1125,44479,90,269816
17524,0.000328,172.31.47.0-255,66,44545,90,269816
17525,0.000344,74.125.24.0-255,4320,48865,90,269816
17526,0.000346,172.31.47.0-255,66,48931,90,269816
17527,0.000366,74.125.24.0-255,5653,54584,90,269816
17528,0.000368,172.31.47.0-255,66,54650,90,269816
17529,0.000371,74.125.24.0-255,134,54784,90,269816
17530,0.000437,74.125.24.0-255,1484,56268,90,269816
17531,0.000439,172.31.47.0-255,66,56334,90,269816
17532,0.000443,74.125.24.0-255,1484,57818,90,269816
17533,0.000457,74.125.24.0-255,1484,59302,90,269816
17534,0.000458,172.31.47.0-255,66,59368,90,269816
17535,0.000464,74.125.24.0-255,5738,65106,90,269816
17536,0.000466,172.31.47.0-255,66,65172,90,269816
17537,0.000522,172.31.47.0-255,66,65238,90,269816
17538,0.00053,74.125.24.0-255,9633,74871,90,269816
17539,0.000532,172.31.47.0-255,66,74937,90,269816
17540,0.000534,74.125.24.0-255,344,75281,90,269816
17541,0.000774,74.125.24.0-255,1484,76765,90,269816
17542,0.000778,172.31.47.0-255,66,76831,90,269816
17543,0.000784,74.125.24.0-255,2902,79733,90,269816
17544,0.000785,172.31.47.0-255,66,79799,90,269816
17545,0.000796,74.125.24.0-255,1484,81283,90,269816
17546,0.000814,74.125.24.0-255,4320,85603,90,269816
17547,0.000817,172.31.47.0-255,66,85669,90,269816
17548,0.000822,74.125.24.0-255,5738,91407,90,269816
17549,0.000824,172.31.47.0-255,66,91473,90,269816
17550,0.000852,74.125.24.0-255,7156,98629,90,269816
17551,0.000855,172.31.47.0-255,66,98695,90,269816
17552,0.000863,74.125.24.0-255,9992,108687,90,269816
17553,0.000865,172.31.47.0-255,66,108753,90,269816
17554,0.000868,74.125.24.0-255,766,109519,90,269816
17555,0.001142,74.125.24.0-255,1484,111003,90,269816
17556,0.001146,172.31.47.0-255,66,111069,90,269816
17557,0.001151,74.125.24.0-255,2902,113971,90,269816
17558,0.001152,172.31.47.0-255,66,114037,90,269816
17559,0.001167,74.125.24.0-255,2902,116939,90,269816
17560,0.001169,172.31.47.0-255,66,117005,90,269816
17561,0.001181,74.125.24.0-255,2902,119907,90,269816
17562,0.001182,172.31.47.0-255,66,119973,90,269816
17563,0.001187,74.125.24.0-255,4320,124293,90,269816
17564,0.001189,172.31.47.0-255,66,124359,90,269816
17565,0.001225,74.125.24.0-255,8574,132933,90,269816
17566,0.001228,172.31.47.0-255,66,132999,90,269816
17567,0.001238,74.125.24.0-255,1484,134483,90,269816
17568,0.001258,74.125.24.0-255,9274,143757,90,269816
17569,0.00126,172.31.47.0-255,66,143823,90,269816
17570,0.001275,74.125.24.0-255,5738,149561,90,269816
17571,0.001277,172.31.47.0-255,66,149627,90,269816
17572,0.001301,74.125.24.0-255,5738,155365,90,269816
17573,0.001304,172.31.47.0-255,66,155431,90,269816
17574,0.001316,172.31.47.0-255,66,155497,90,269816
17575,0.001331,74.125.24.0-255,1484,156981,90,269816
17576,0.001346,74.125.24.0-255,4320,161301,90,269816
17577,0.001349,172.31.47.0-255,66,161367,90,269816
17578,0.001375,74.125.24.0-255,3602,164969,90,269816
17579,0.001377,172.31.47.0-255,66,165035,90,269816
17580,0.001384,74.125.24.0-255,8574,173609,90,269816
17581,0.001387,172.31.47.0-255,66,173675,90,269816
17582,0.001389,74.125.24.0-255,1484,175159,90,269816
17583,0.001425,172.31.47.0-255,66,175225,90,269816
17584,0.001428,74.125.24.0-255,1484,176709,90,269816
17585,0.001461,74.125.24.0-255,5020,181729,90,269816
17586,0.001465,172.31.47.0-255,66,181795,90,269816
17587,0.001493,74.125.24.0-255,5738,187533,90,269816
17588,0.001496,172.31.47.0-255,66,187599,90,269816
17589,0.00153,74.125.24.0-255,9992,197591,90,269816
17590,0.001533,172.31.47.0-255,66,197657,90,269816
17591,0.001578,172.31.47.0-255,66,197723,90,269816
17592,0.00162,74.125.24.0-255,766,198489,90,269816
17593,0.001694,74.125.24.0-255,1484,199973,90,269816
17594,0.001697,172.31.47.0-255,66,200039,90,269816
17595,0.001702,74.125.24.0-255,2902,202941,90,269816
17596,0.001703,172.31.47.0-255,66,203007,90,269816
17597,0.001709,74.125.24.0-255,5738,208745,90,269816
17598,0.001711,172.31.47.0-255,66,208811,90,269816
17599,0.001742,74.125.24.0-255,8574,217385,90,269816
17600,0.001744,172.31.47.0-255,66,217451,90,269816
17601,0.00177,74.125.24.0-255,4320,221771,90,269816
17602,0.001772,172.31.47.0-255,66,221837,90,269816
17603,0.00178,74.125.24.0-255,9992,231829,90,269816
17604,0.001782,172.31.47.0-255,66,231895,90,269816
17605,0.001784,74.125.24.0-255,766,232661,90,269816
17606,0.001803,74.125.24.0-255,1484,234145,90,269816
17607,0.001805,172.31.47.0-255,66,234211,90,269816
17608,0.00181,74.125.24.0-255,4320,238531,90,269816
17609,0.001811,172.31.47.0-255,66,238597,90,269816
17610,0.001833,74.125.24.0-255,9992,248589,90,269816
17611,0.001835,172.31.47.0-255,66,248655,90,269816
17612,0.00184,74.125.24.0-255,4320,252975,90,269816
17613,0.001842,172.31.47.0-255,66,253041,90,269816
17614,0.001865,74.125.24.0-255,4320,257361,90,269816
17615,0.001869,172.31.47.0-255,66,257427,90,269816
17616,0.001882,74.125.24.0-255,4320,261747,90,269816
17617,0.001884,172.31.47.0-255,66,261813,90,269816
17618,0.001911,172.31.47.0-255,66,261879,90,269816
17619,0.001922,172.31.47.0-255,66,261945,90,269816
17620,0.001953,74.125.24.0-255,4320,266265,90,269816
17621,0.001956,172.31.47.0-255,66,266331,90,269816
17622,0.00198,172.31.47.0-255,66,266397,90,269816
17623,0.002007,74.125.24.0-255,2184,268581,90,269816
17624,0.00201,172.31.47.0-255,66,268647,90,269816
17625,0.002029,172.31.47.0-255,66,268713,90,269816
17626,0.002031,74.125.24.0-255,827,269540,90,269816
17627,0.002047,74.125.24.0-255,105,269645,90,269816
17628,0.008483,172.31.47.0-255,66,269711,90,269816
17629,0.008524,172.31.47.0-255,105,269816,90,269816
17630,0.0,172.31.47.0-255,105,105,90,105
17631,0.0,74.125.130.0-255,297,297,90,278870
17632,2.8e-05,172.31.47.0-255,66,363,90,278870
17633,3.4e-05,74.125.130.0-255,1484,1847,90,278870
17634,3.8e-05,172.31.47.0-255,66,1913,90,278870
17635,4.2e-05,74.125.130.0-255,2902,4815,90,278870
17636,4.4e-05,172.31.47.0-255,66,4881,90,278870
17637,5e-05,74.125.130.0-255,5738,10619,90,278870
17638,5.2e-05,172.31.47.0-255,66,10685,90,278870
17639,9.1e-05,74.125.130.0-255,3391,14076,90,278870
17640,9.4e-05,172.31.47.0-255,66,14142,90,278870
17641,0.000191,74.125.130.0-255,1484,15626,90,278870
17642,0.000197,172.31.47.0-255,66,15692,90,278870
17643,0.0002,74.125.130.0-255,1484,17176,90,278870
17644,0.000202,172.31.47.0-255,66,17242,90,278870
17645,0.000215,74.125.130.0-255,1484,18726,90,278870
17646,0.000218,172.31.47.0-255,66,18792,90,278870
17647,0.000223,74.125.130.0-255,4320,23112,90,278870
17648,0.000226,172.31.47.0-255,66,23178,90,278870
17649,0.000242,74.125.130.0-255,5738,28916,90,278870
17650,0.000244,172.31.47.0-255,66,28982,90,278870
17651,0.000273,74.125.130.0-255,2543,31525,90,278870
17652,0.000275,172.31.47.0-255,66,31591,90,278870
17653,0.000279,74.125.130.0-255,2902,34493,90,278870
17654,0.000281,172.31.47.0-255,66,34559,90,278870
17655,0.00031,74.125.130.0-255,4320,38879,90,278870
17656,0.000314,172.31.47.0-255,66,38945,90,278870
17657,0.000333,74.125.130.0-255,2902,41847,90,278870
17658,0.000336,172.31.47.0-255,66,41913,90,278870
17659,0.00034,74.125.130.0-255,4320,46233,90,278870
17660,0.000343,172.31.47.0-255,66,46299,90,278870
17661,0.000371,74.125.130.0-255,2543,48842,90,278870
17662,0.000373,172.31.47.0-255,66,48908,90,278870
17663,0.000419,74.125.130.0-255,1484,50392,90,278870
17664,0.000432,74.125.130.0-255,2902,53294,90,278870
17665,0.000439,172.31.47.0-255,66,53360,90,278870
17666,0.000458,74.125.130.0-255,5738,59098,90,278870
17667,0.000463,172.31.47.0-255,66,59164,90,278870
17668,0.000475,74.125.130.0-255,4320,63484,90,278870
17669,0.000479,172.31.47.0-255,66,63550,90,278870
17670,0.00049,74.125.130.0-255,2543,66093,90,278870
17671,0.000493,172.31.47.0-255,66,66159,90,278870
17672,0.000645,74.125.130.0-255,379,66538,90,278870
17673,0.000691,74.125.130.0-255,1484,68022,90,278870
17674,0.000694,172.31.47.0-255,66,68088,90,278870
17675,0.000706,74.125.130.0-255,2902,70990,90,278870
17676,0.000717,172.31.47.0-255,66,71056,90,278870
17677,0.000727,74.125.130.0-255,2902,73958,90,278870
17678,0.000731,172.31.47.0-255,66,74024,90,278870
17679,0.000739,74.125.130.0-255,1484,75508,90,278870
17680,0.000742,74.125.130.0-255,1484,76992,90,278870
17681,0.000751,172.31.47.0-255,66,77058,90,278870
17682,0.000755,74.125.130.0-255,2902,79960,90,278870
17683,0.000762,172.31.47.0-255,66,80026,90,278870
17684,0.000766,74.125.130.0-255,1484,81510,90,278870
17685,0.000791,74.125.130.0-255,2819,84329,90,278870
17686,0.000796,172.31.47.0-255,66,84395,90,278870
17687,0.000842,74.125.130.0-255,1484,85879,90,278870
17688,0.000857,74.125.130.0-255,1484,87363,90,278870
17689,0.000866,172.31.47.0-255,66,87429,90,278870
17690,0.000869,74.125.130.0-255,1484,88913,90,278870
17691,0.000873,74.125.130.0-255,2902,91815,90,278870
17692,0.000877,172.31.47.0-255,66,91881,90,278870
17693,0.000885,74.125.130.0-255,2902,94783,90,278870
17694,0.000889,74.125.130.0-255,2902,97685,90,278870
17695,0.000891,172.31.47.0-255,66,97751,90,278870
17696,0.000893,74.125.130.0-255,3961,101712,90,278870
17697,0.000895,172.31.47.0-255,66,101778,90,278870
17698,0.000994,74.125.130.0-255,1484,103262,90,278870
17699,0.001,74.125.130.0-255,2902,106164,90,278870
17700,0.001026,74.125.130.0-255,4320,110484,90,278870
17701,0.001037,74.125.130.0-255,1484,111968,90,278870
17702,0.001041,74.125.130.0-255,2902,114870,90,278870
17703,0.001043,74.125.130.0-255,1484,116354,90,278870
17704,0.001059,74.125.130.0-255,2902,119256,90,278870
17705,0.001062,74.125.130.0-255,2902,122158,90,278870
17706,0.001082,74.125.130.0-255,5738,127896,90,278870
17707,0.001089,74.125.130.0-255,7156,135052,90,278870
17708,0.001115,74.125.130.0-255,766,135818,90,278870
17709,0.001173,74.125.130.0-255,1484,137302,90,278870
17710,0.001185,74.125.130.0-255,1484,138786,90,278870
17711,0.001188,74.125.130.0-255,1484,140270,90,278870
17712,0.001196,74.125.130.0-255,1484,141754,90,278870
17713,0.001212,74.125.130.0-255,2902,144656,90,278870
17714,0.001224,74.125.130.0-255,2902,147558,90,278870
17715,0.001244,74.125.130.0-255,4320,151878,90,278870
17716,0.001267,74.125.130.0-255,4320,156198,90,278870
17717,0.001274,74.125.130.0-255,9992,166190,90,278870
17718,0.001277,74.125.130.0-255,1484,167674,90,278870
17719,0.001292,74.125.130.0-255,2184,169858,90,278870
17720,0.001356,74.125.130.0-255,1484,171342,90,278870
17721,0.001367,74.125.130.0-255,2902,174244,90,278870
17722,0.001376,74.125.130.0-255,1484,175728,90,278870
17723,0.001389,74.125.130.0-255,2902,178630,90,278870
17724,0.001392,74.125.130.0-255,1484,180114,90,278870
17725,0.001411,74.125.130.0-255,4320,184434,90,278870
17726,0.001433,74.125.130.0-255,2902,187336,90,278870
17727,0.001449,74.125.130.0-255,8574,195910,90,278870
17728,0.001491,74.125.130.0-255,1484,197394,90,278870
17729,0.001505,74.125.130.0-255,6438,203832,90,278870
17730,0.002011,74.125.130.0-255,1484,205316,90,278870
17731,0.002017,74.125.130.0-255,2902,208218,90,278870
17732,0.002046,74.125.130.0-255,5738,213956,90,278870
17733,0.002065,74.125.130.0-255,7156,221112,90,278870
17734,0.002092,74.125.130.0-255,2902,224014,90,278870
17735,0.002117,74.125.130.0-255,9992,234006,90,278870
17736,0.002162,74.125.130.0-255,3602,237608,90,278870
17737,0.002401,74.125.130.0-255,1484,239092,90,278870
17738,0.002422,74.125.130.0-255,2902,241994,90,278870
17739,0.002445,74.125.130.0-255,5738,247732,90,278870
17740,0.002449,74.125.130.0-255,2902,250634,90,278870
17741,0.002476,74.125.130.0-255,4320,254954,90,278870
17742,0.002498,74.125.130.0-255,5738,260692,90,278870
17743,0.002508,74.125.130.0-255,2902,263594,90,278870
17744,0.00251,74.125.130.0-255,1484,265078,90,278870
17745,0.002545,74.125.130.0-255,2902,267980,90,278870
17746,0.002563,74.125.130.0-255,5020,273000,90,278870
17747,0.006372,172.31.47.0-255,66,273066,90,278870
17748,0.008935,74.125.130.0-255,5738,278804,90,278870
17749,0.008941,172.31.47.0-255,66,278870,90,278870
17750,0.0,172.217.194.0-255,150,150,90,135521
17751,2.3e-05,172.31.47.0-255,66,216,90,135521
17752,3e-05,172.217.194.0-255,1484,1700,90,135521
17753,3.3e-05,172.31.47.0-255,66,1766,90,135521
17754,3.8e-05,172.217.194.0-255,2902,4668,90,135521
17755,4e-05,172.31.47.0-255,66,4734,90,135521
17756,6.8e-05,172.217.194.0-255,2902,7636,90,135521
17757,7.1e-05,172.31.47.0-255,66,7702,90,135521
17758,9.1e-05,172.217.194.0-255,4320,12022,90,135521
17759,9.4e-05,172.31.47.0-255,66,12088,90,135521
17760,9.8e-05,172.217.194.0-255,2065,14153,90,135521
17761,0.0001,172.31.47.0-255,66,14219,90,135521
17762,0.000108,172.217.194.0-255,2902,17121,90,135521
17763,0.00011,172.31.47.0-255,66,17187,90,135521
17764,0.000113,172.217.194.0-255,1484,18671,90,135521
17765,0.000115,172.31.47.0-255,66,18737,90,135521
17766,0.000138,172.217.194.0-255,5738,24475,90,135521
17767,0.000141,172.31.47.0-255,66,24541,90,135521
17768,0.000152,172.217.194.0-255,5738,30279,90,135521
17769,0.000156,172.31.47.0-255,66,30345,90,135521
17770,0.000159,172.217.194.0-255,1125,31470,90,135521
17771,0.000163,172.31.47.0-255,66,31536,90,135521
17772,0.000234,172.217.194.0-255,1484,33020,90,135521
17773,0.000237,172.31.47.0-255,66,33086,90,135521
17774,0.000241,172.217.194.0-255,1484,34570,90,135521
17775,0.000242,172.31.47.0-255,66,34636,90,135521
17776,0.000264,172.217.194.0-255,1484,36120,90,135521
17777,0.000271,172.31.47.0-255,66,36186,90,135521
17778,0.000277,172.217.194.0-255,5738,41924,90,135521
17779,0.000279,172.31.47.0-255,66,41990,90,135521
17780,0.000281,172.217.194.0-255,1484,43474,90,135521
17781,0.000283,172.31.47.0-255,66,43540,90,135521
17782,0.000317,172.217.194.0-255,5379,48919,90,135521
17783,0.00032,172.31.47.0-255,66,48985,90,135521
17784,0.000334,172.217.194.0-255,2902,51887,90,135521
17785,0.000341,172.31.47.0-255,66,51953,90,135521
17786,0.000377,172.31.47.0-255,66,52019,90,135521
17787,0.000381,172.217.194.0-255,2543,54562,90,135521
17788,0.000383,172.31.47.0-255,66,54628,90,135521
17789,0.000385,172.217.194.0-255,380,55008,90,135521
17790,0.000592,172.217.194.0-255,363,55371,90,135521
17791,0.000694,172.31.47.0-255,66,55437,90,135521
17792,0.000925,172.217.194.0-255,1484,56921,90,135521
17793,0.000932,172.217.194.0-255,1484,58405,90,135521
17794,0.000936,172.31.47.0-255,66,58471,90,135521
17795,0.000967,172.217.194.0-255,1484,59955,90,135521
17796,0.000974,172.217.194.0-255,5738,65693,90,135521
17797,0.000976,172.31.47.0-255,66,65759,90,135521
17798,0.000986,172.31.47.0-255,66,65825,90,135521
17799,0.001008,172.217.194.0-255,5738,71563,90,135521
17800,0.00101,172.31.47.0-255,66,71629,90,135521
17801,0.00103,172.217.194.0-255,6438,78067,90,135521
17802,0.001033,172.31.47.0-255,66,78133,90,135521
17803,0.001456,172.217.194.0-255,1484,79617,90,135521
17804,0.001463,172.217.194.0-255,2902,82519,90,135521
17805,0.001467,172.31.47.0-255,66,82585,90,135521
17806,0.001473,172.217.194.0-255,4320,86905,90,135521
17807,0.001475,172.31.47.0-255,66,86971,90,135521
17808,0.001497,172.217.194.0-255,1484,88455,90,135521
17809,0.001503,172.217.194.0-255,5738,94193,90,135521
17810,0.001505,172.31.47.0-255,66,94259,90,135521
17811,0.001533,172.217.194.0-255,7156,101415,90,135521
17812,0.001535,172.31.47.0-255,66,101481,90,135521
17813,0.001549,172.217.194.0-255,10692,112173,90,135521
17814,0.001552,172.31.47.0-255,66,112239,90,135521
17815,0.003527,172.217.194.0-255,1484,113723,90,135521
17816,0.003545,172.217.194.0-255,4320,118043,90,135521
17817,0.003548,172.31.47.0-255,66,118109,90,135521
17818,0.00556,172.217.194.0-255,5738,123847,90,135521
17819,0.005569,172.31.47.0-255,66,123913,90,135521
17820,0.007605,172.217.194.0-255,5738,129651,90,135521
17821,0.007612,172.31.47.0-255,66,129717,90,135521
17822,0.009621,172.217.194.0-255,5738,135455,90,135521
17823,0.009627,172.31.47.0-255,66,135521,90,135521
17824,0.0,172.217.194.0-255,150,150,90,140886
17825,2.4e-05,172.31.47.0-255,66,216,90,140886
17826,3e-05,172.217.194.0-255,1484,1700,90,140886
17827,3.4e-05,172.31.47.0-255,66,1766,90,140886
17828,3.8e-05,172.217.194.0-255,2902,4668,90,140886
17829,4.8e-05,172.31.47.0-255,66,4734,90,140886
17830,5.5e-05,172.217.194.0-255,7156,11890,90,140886
17831,5.8e-05,172.31.47.0-255,66,11956,90,140886
17832,9e-05,172.217.194.0-255,2251,14207,90,140886
17833,9.3e-05,172.31.47.0-255,66,14273,90,140886
17834,0.000119,172.217.194.0-255,2902,17175,90,140886
17835,0.000123,172.31.47.0-255,66,17241,90,140886
17836,0.000128,172.217.194.0-255,4320,21561,90,140886
17837,0.000131,172.31.47.0-255,66,21627,90,140886
17838,0.000194,172.217.194.0-255,8574,30201,90,140886
17839,0.000197,172.31.47.0-255,66,30267,90,140886
17840,0.0002,172.217.194.0-255,1125,31392,90,140886
17841,0.000202,172.31.47.0-255,66,31458,90,140886
17842,0.000289,172.217.194.0-255,1484,32942,90,140886
17843,0.000293,172.31.47.0-255,66,33008,90,140886
17844,0.000297,172.217.194.0-255,2902,35910,90,140886
17845,0.000299,172.31.47.0-255,66,35976,90,140886
17846,0.000303,172.217.194.0-255,2902,38878,90,140886
17847,0.000305,172.31.47.0-255,66,38944,90,140886
17848,0.000343,172.217.194.0-255,2902,41846,90,140886
17849,0.000346,172.31.47.0-255,66,41912,90,140886
17850,0.000353,172.217.194.0-255,6797,48709,90,140886
17851,0.000355,172.31.47.0-255,66,48775,90,140886
17852,0.000374,172.31.47.0-255,66,48841,90,140886
17853,0.000378,172.217.194.0-255,2543,51384,90,140886
17854,0.000381,172.31.47.0-255,66,51450,90,140886
17855,0.000632,172.217.194.0-255,646,52096,90,140886
17856,0.00068,172.31.47.0-255,66,52162,90,140886
17857,0.001038,172.217.194.0-255,1484,53646,90,140886
17858,0.001049,172.217.194.0-255,2902,56548,90,140886
17859,0.001054,172.31.47.0-255,66,56614,90,140886
17860,0.001061,172.217.194.0-255,5738,62352,90,140886
17861,0.001063,172.31.47.0-255,66,62418,90,140886
17862,0.001107,172.31.47.0-255,66,62484,90,140886
17863,0.001116,172.217.194.0-255,8574,71058,90,140886
17864,0.001118,172.31.47.0-255,66,71124,90,140886
17865,0.001144,172.217.194.0-255,2184,73308,90,140886
17866,0.001151,172.31.47.0-255,66,73374,90,140886
17867,0.001212,172.217.194.0-255,1484,74858,90,140886
17868,0.001218,172.217.194.0-255,2902,77760,90,140886
17869,0.001222,172.31.47.0-255,66,77826,90,140886
17870,0.001227,172.217.194.0-255,2902,80728,90,140886
17871,0.001229,172.31.47.0-255,66,80794,90,140886
17872,0.001268,172.217.194.0-255,2902,83696,90,140886
17873,0.001272,172.31.47.0-255,66,83762,90,140886
17874,0.00128,172.217.194.0-255,8574,92336,90,140886
17875,0.001282,172.31.47.0-255,66,92402,90,140886
17876,0.001329,172.31.47.0-255,66,92468,90,140886
17877,0.001332,172.217.194.0-255,1484,93952,90,140886
17878,0.001341,172.217.194.0-255,9992,103944,90,140886
17879,0.001347,172.31.47.0-255,66,104010,90,140886
17880,0.001379,172.217.194.0-255,9992,114002,90,140886
17881,0.001382,172.31.47.0-255,66,114068,90,140886
17882,0.001392,172.217.194.0-255,10692,124760,90,140886
17883,0.001399,172.31.47.0-255,66,124826,90,140886
17884,0.003718,172.217.194.0-255,4320,129146,90,140886
17885,0.003722,172.31.47.0-255,66,129212,90,140886
17886,0.003738,172.217.194.0-255,1484,130696,90,140886
17887,0.006052,172.217.194.0-255,4320,135016,90,140886
17888,0.006058,172.31.47.0-255,66,135082,90,140886
17889,0.008403,172.217.194.0-255,5738,140820,90,140886
17890,0.008411,172.31.47.0-255,66,140886,90,140886
17891,0.0,172.31.47.0-255,105,105,90,276
17892,0.00246,157.240.13.0-255,105,210,90,276
17893,0.002476,172.31.47.0-255,66,276,90,276
17894,0.0,172.31.47.0-255,105,105,90,276
17895,0.002121,157.240.7.0-255,105,210,90,276
17896,0.002136,172.31.47.0-255,66,276,90,276
17897,0.0,172.217.194.0-255,153,153,90,289395
17898,3.3e-05,172.31.47.0-255,66,219,90,289395
17899,3.9e-05,172.217.194.0-255,1484,1703,90,289395
17900,4.3e-05,172.31.47.0-255,66,1769,90,289395
17901,4.9e-05,172.217.194.0-255,2902,4671,90,289395
17902,5.9e-05,172.31.47.0-255,66,4737,90,289395
17903,6.6e-05,172.217.194.0-255,7156,11893,90,289395
17904,6.9e-05,172.31.47.0-255,66,11959,90,289395
17905,9.6e-05,172.217.194.0-255,2164,14123,90,289395
17906,9.9e-05,172.31.47.0-255,66,14189,90,289395
17907,0.000117,172.217.194.0-255,1484,15673,90,289395
17908,0.000119,172.31.47.0-255,66,15739,90,289395
17909,0.00015,172.217.194.0-255,4320,20059,90,289395
17910,0.000154,172.31.47.0-255,66,20125,90,289395
17911,0.000161,172.217.194.0-255,7156,27281,90,289395
17912,0.000163,172.31.47.0-255,66,27347,90,289395
17913,0.000195,172.217.194.0-255,3961,31308,90,289395
17914,0.000198,172.31.47.0-255,66,31374,90,289395
17915,0.000281,172.217.194.0-255,1484,32858,90,289395
17916,0.000285,172.31.47.0-255,66,32924,90,289395
17917,0.000291,172.217.194.0-255,2902,35826,90,289395
17918,0.000293,172.31.47.0-255,66,35892,90,289395
17919,0.000298,172.217.194.0-255,2902,38794,90,289395
17920,0.0003,172.31.47.0-255,66,38860,90,289395
17921,0.000333,172.217.194.0-255,2902,41762,90,289395
17922,0.000337,172.31.47.0-255,66,41828,90,289395
17923,0.000344,172.217.194.0-255,7156,48984,90,289395
17924,0.000346,172.31.47.0-255,66,49050,90,289395
17925,0.000373,172.217.194.0-255,6797,55847,90,289395
17926,0.000377,172.31.47.0-255,66,55913,90,289395
17927,0.00038,172.217.194.0-255,1484,57397,90,289395
17928,0.000383,172.31.47.0-255,66,57463,90,289395
17929,0.000391,172.217.194.0-255,8489,65952,90,289395
17930,0.000394,172.31.47.0-255,66,66018,90,289395
17931,0.000423,172.217.194.0-255,403,66421,90,289395
17932,0.00064,172.217.194.0-255,1484,67905,90,289395
17933,0.000644,172.31.47.0-255,66,67971,90,289395
17934,0.000649,172.217.194.0-255,2902,70873,90,289395
17935,0.000652,172.31.47.0-255,66,70939,90,289395
17936,0.000688,172.217.194.0-255,4320,75259,90,289395
17937,0.000693,172.31.47.0-255,66,75325,90,289395
17938,0.000709,172.217.194.0-255,1484,76809,90,289395
17939,0.000723,172.31.47.0-255,66,76875,90,289395
17940,0.000732,172.217.194.0-255,9992,86867,90,289395
17941,0.000734,172.31.47.0-255,66,86933,90,289395
17942,0.000737,172.217.194.0-255,766,87699,90,289395
17943,0.000867,172.217.194.0-255,1484,89183,90,289395
17944,0.000871,172.31.47.0-255,66,89249,90,289395
17945,0.000876,172.217.194.0-255,2902,92151,90,289395
17946,0.000878,172.31.47.0-255,66,92217,90,289395
17947,0.000884,172.217.194.0-255,4320,96537,90,289395
17948,0.000893,172.31.47.0-255,66,96603,90,289395
17949,0.000918,172.217.194.0-255,1484,98087,90,289395
17950,0.000935,172.217.194.0-255,5738,103825,90,289395
17951,0.000938,172.31.47.0-255,66,103891,90,289395
17952,0.000951,172.31.47.0-255,66,103957,90,289395
17953,0.000956,172.217.194.0-255,5020,108977,90,289395
17954,0.000959,172.31.47.0-255,66,109043,90,289395
17955,0.001094,172.217.194.0-255,1484,110527,90,289395
17956,0.001108,172.217.194.0-255,2902,113429,90,289395
17957,0.001112,172.31.47.0-255,66,113495,90,289395
17958,0.001117,172.217.194.0-255,2902,116397,90,289395
17959,0.001119,172.31.47.0-255,66,116463,90,289395
17960,0.00114,172.217.194.0-255,1484,117947,90,289395
17961,0.001148,172.217.194.0-255,8574,126521,90,289395
17962,0.00115,172.31.47.0-255,66,126587,90,289395
17963,0.001204,172.31.47.0-255,66,126653,90,289395
17964,0.001229,172.217.194.0-255,2184,128837,90,289395
17965,0.001232,172.31.47.0-255,66,128903,90,289395
17966,0.001306,172.217.194.0-255,1484,130387,90,289395
17967,0.001319,172.217.194.0-255,2902,133289,90,289395
17968,0.001322,172.31.47.0-255,66,133355,90,289395
17969,0.001325,172.217.194.0-255,1484,134839,90,289395
17970,0.001352,172.217.194.0-255,4320,139159,90,289395
17971,0.001355,172.31.47.0-255,66,139225,90,289395
17972,0.001378,172.31.47.0-255,66,139291,90,289395
17973,0.001392,172.217.194.0-255,10692,149983,90,289395
17974,0.001395,172.31.47.0-255,66,150049,90,289395
17975,0.001704,172.217.194.0-255,1484,151533,90,289395
17976,0.001717,172.217.194.0-255,2902,154435,90,289395
17977,0.001721,172.31.47.0-255,66,154501,90,289395
17978,0.001727,172.217.194.0-255,5738,160239,90,289395
17979,0.001729,172.31.47.0-255,66,160305,90,289395
17980,0.00177,172.217.194.0-255,2902,163207,90,289395
17981,0.001771,172.31.47.0-255,66,163273,90,289395
17982,0.001774,172.31.47.0-255,66,163339,90,289395
17983,0.001804,172.217.194.0-255,7856,171195,90,289395
17984,0.001808,172.31.47.0-255,66,171261,90,289395
17985,0.001835,172.217.194.0-255,1484,172745,90,289395
17986,0.001841,172.217.194.0-255,2902,175647,90,289395
17987,0.001843,172.31.47.0-255,66,175713,90,289395
17988,0.001849,172.217.194.0-255,5738,181451,90,289395
17989,0.001851,172.31.47.0-255,66,181517,90,289395
17990,0.001854,172.217.194.0-255,1484,183001,90,289395
17991,0.001883,172.217.194.0-255,4320,187321,90,289395
17992,0.001886,172.31.47.0-255,66,187387,90,289395
17993,0.001905,172.31.47.0-255,66,187453,90,289395
17994,0.001971,172.217.194.0-255,5020,192473,90,289395
17995,0.001974,172.31.47.0-255,66,192539,90,289395
17996,0.002015,172.217.194.0-255,1484,194023,90,289395
17997,0.002029,172.217.194.0-255,2902,196925,90,289395
17998,0.002032,172.31.47.0-255,66,196991,90,289395
17999,0.00206,172.217.194.0-255,5738,202729,90,289395
18000,0.002063,172.31.47.0-255,66,202795,90,289395
18001,0.002068,172.217.194.0-255,2902,205697,90,289395
18002,0.002071,172.31.47.0-255,66,205763,90,289395
18003,0.0021,172.217.194.0-255,8574,214337,90,289395
18004,0.002103,172.31.47.0-255,66,214403,90,289395
18005,0.002128,172.217.194.0-255,7156,221559,90,289395
18006,0.002131,172.31.47.0-255,66,221625,90,289395
18007,0.002159,172.217.194.0-255,5020,226645,90,289395
18008,0.002162,172.31.47.0-255,66,226711,90,289395
18009,0.002202,172.217.194.0-255,1484,228195,90,289395
18010,0.002218,172.217.194.0-255,2902,231097,90,289395
18011,0.002221,172.31.47.0-255,66,231163,90,289395
18012,0.002224,172.217.194.0-255,1484,232647,90,289395
18013,0.002254,172.217.194.0-255,4320,236967,90,289395
18014,0.002257,172.31.47.0-255,66,237033,90,289395
18015,0.002263,172.217.194.0-255,4320,241353,90,289395
18016,0.002266,172.31.47.0-255,66,241419,90,289395
18017,0.002285,172.217.194.0-255,5738,247157,90,289395
18018,0.002293,172.31.47.0-255,66,247223,90,289395
18019,0.002323,172.217.194.0-255,2902,250125,90,289395
18020,0.002326,172.31.47.0-255,66,250191,90,289395
18021,0.002336,172.217.194.0-255,10692,260883,90,289395
18022,0.002339,172.31.47.0-255,66,260949,90,289395
18023,0.002341,172.217.194.0-255,1484,262433,90,289395
18024,0.002374,172.31.47.0-255,66,262499,90,289395
18025,0.002402,172.217.194.0-255,9992,272491,90,289395
18026,0.002405,172.31.47.0-255,66,272557,90,289395
18027,0.002413,172.217.194.0-255,9274,281831,90,289395
18028,0.002416,172.31.47.0-255,66,281897,90,289395
18029,0.002462,172.217.194.0-255,5738,287635,90,289395
18030,0.002466,172.31.47.0-255,66,287701,90,289395
18031,0.002532,172.31.47.0-255,66,287767,90,289395
18032,0.002535,172.217.194.0-255,1286,289053,90,289395
18033,0.002538,172.217.194.0-255,105,289158,90,289395
18034,0.003479,172.31.47.0-255,66,289224,90,289395
18035,0.003505,172.31.47.0-255,105,289329,90,289395
18036,0.006081,172.217.194.0-255,66,289395,90,289395
18037,0.0,74.125.200.0-255,153,153,90,226805
18038,3.4e-05,172.31.47.0-255,66,219,90,226805
18039,4.1e-05,74.125.200.0-255,1484,1703,90,226805
18040,4.5e-05,172.31.47.0-255,66,1769,90,226805
18041,5.8e-05,74.125.200.0-255,2902,4671,90,226805
18042,6.1e-05,172.31.47.0-255,66,4737,90,226805
18043,6.6e-05,74.125.200.0-255,4320,9057,90,226805
18044,6.8e-05,172.31.47.0-255,66,9123,90,226805
18045,0.000104,74.125.200.0-255,9064,18187,90,226805
18046,0.000107,172.31.47.0-255,66,18253,90,226805
18047,0.000136,74.125.200.0-255,2902,21155,90,226805
18048,0.000139,172.31.47.0-255,66,21221,90,226805
18049,0.000156,74.125.200.0-255,1484,22705,90,226805
18050,0.000158,172.31.47.0-255,66,22771,90,226805
18051,0.000167,74.125.200.0-255,8215,30986,90,226805
18052,0.00017,172.31.47.0-255,66,31052,90,226805
18053,0.000293,74.125.200.0-255,1484,32536,90,226805
18054,0.000297,172.31.47.0-255,66,32602,90,226805
18055,0.000301,74.125.200.0-255,1484,34086,90,226805
18056,0.000305,74.125.200.0-255,2902,36988,90,226805
18057,0.000305,172.31.47.0-255,66,37054,90,226805
18058,0.00031,172.31.47.0-255,66,37120,90,226805
18059,0.000341,74.125.200.0-255,5738,42858,90,226805
18060,0.000345,172.31.47.0-255,66,42924,90,226805
18061,0.000368,74.125.200.0-255,6797,49721,90,226805
18062,0.000372,172.31.47.0-255,66,49787,90,226805
18063,0.000404,74.125.200.0-255,7156,56943,90,226805
18064,0.000408,172.31.47.0-255,66,57009,90,226805
18065,0.000412,74.125.200.0-255,1484,58493,90,226805
18066,0.000414,172.31.47.0-255,66,58559,90,226805
18067,0.00045,74.125.200.0-255,7108,65667,90,226805
18068,0.000454,172.31.47.0-255,66,65733,90,226805
18069,0.000552,74.125.200.0-255,111,65844,90,226805
18070,0.000715,74.125.200.0-255,1484,67328,90,226805
18071,0.000719,172.31.47.0-255,66,67394,90,226805
18072,0.000724,74.125.200.0-255,2902,70296,90,226805
18073,0.000726,172.31.47.0-255,66,70362,90,226805
18074,0.00073,74.125.200.0-255,1484,71846,90,226805
18075,0.00074,74.125.200.0-255,2902,74748,90,226805
18076,0.000742,172.31.47.0-255,66,74814,90,226805
18077,0.000777,74.125.200.0-255,5738,80552,90,226805
18078,0.00078,172.31.47.0-255,66,80618,90,226805
18079,0.000808,74.125.200.0-255,8215,88833,90,226805
18080,0.000811,172.31.47.0-255,66,88899,90,226805
18081,0.000856,74.125.200.0-255,8574,97473,90,226805
18082,0.00086,172.31.47.0-255,66,97539,90,226805
18083,0.000864,74.125.200.0-255,2543,100082,90,226805
18084,0.000866,172.31.47.0-255,66,100148,90,226805
18085,0.000901,74.125.200.0-255,331,100479,90,226805
18086,0.000999,172.31.47.0-255,66,100545,90,226805
18087,0.001113,74.125.200.0-255,1484,102029,90,226805
18088,0.001133,74.125.200.0-255,2902,104931,90,226805
18089,0.001137,172.31.47.0-255,66,104997,90,226805
18090,0.001142,74.125.200.0-255,1484,106481,90,226805
18091,0.001165,74.125.200.0-255,1484,107965,90,226805
18092,0.001169,172.31.47.0-255,66,108031,90,226805
18093,0.001174,74.125.200.0-255,4320,112351,90,226805
18094,0.001177,172.31.47.0-255,66,112417,90,226805
18095,0.001182,74.125.200.0-255,4320,116737,90,226805
18096,0.001184,172.31.47.0-255,66,116803,90,226805
18097,0.001219,74.125.200.0-255,4320,121123,90,226805
18098,0.001222,172.31.47.0-255,66,121189,90,226805
18099,0.001231,74.125.200.0-255,8574,129763,90,226805
18100,0.00124,172.31.47.0-255,66,129829,90,226805
18101,0.001245,74.125.200.0-255,2902,132731,90,226805
18102,0.001247,172.31.47.0-255,66,132797,90,226805
18103,0.001279,74.125.200.0-255,2184,134981,90,226805
18104,0.001282,172.31.47.0-255,66,135047,90,226805
18105,0.001441,74.125.200.0-255,1484,136531,90,226805
18106,0.001447,74.125.200.0-255,2902,139433,90,226805
18107,0.001451,172.31.47.0-255,66,139499,90,226805
18108,0.001455,74.125.200.0-255,1484,140983,90,226805
18109,0.001481,74.125.200.0-255,4320,145303,90,226805
18110,0.001484,172.31.47.0-255,66,145369,90,226805
18111,0.001491,74.125.200.0-255,8574,153943,90,226805
18112,0.001493,172.31.47.0-255,66,154009,90,226805
18113,0.001497,74.125.200.0-255,4320,158329,90,226805
18114,0.001506,172.31.47.0-255,66,158395,90,226805
18115,0.00154,74.125.200.0-255,5738,164133,90,226805
18116,0.001543,172.31.47.0-255,66,164199,90,226805
18117,0.001549,74.125.200.0-255,5020,169219,90,226805
18118,0.001553,172.31.47.0-255,66,169285,90,226805
18119,0.001895,74.125.200.0-255,1484,170769,90,226805
18120,0.001923,74.125.200.0-255,2902,173671,90,226805
18121,0.001927,172.31.47.0-255,66,173737,90,226805
18122,0.001933,74.125.200.0-255,5738,179475,90,226805
18123,0.001935,172.31.47.0-255,66,179541,90,226805
18124,0.001939,74.125.200.0-255,2902,182443,90,226805
18125,0.001941,172.31.47.0-255,66,182509,90,226805
18126,0.00195,74.125.200.0-255,4320,186829,90,226805
18127,0.001953,172.31.47.0-255,66,186895,90,226805
18128,0.001958,74.125.200.0-255,5738,192633,90,226805
18129,0.001961,172.31.47.0-255,66,192699,90,226805
18130,0.001988,74.125.200.0-255,2902,195601,90,226805
18131,0.00199,172.31.47.0-255,66,195667,90,226805
18132,0.001997,74.125.200.0-255,7856,203523,90,226805
18133,0.002005,172.31.47.0-255,66,203589,90,226805
18134,0.003974,74.125.200.0-255,5738,209327,90,226805
18135,0.003977,172.31.47.0-255,66,209393,90,226805
18136,0.005949,74.125.200.0-255,5738,215131,90,226805
18137,0.005955,172.31.47.0-255,66,215197,90,226805
18138,0.007949,74.125.200.0-255,5738,220935,90,226805
18139,0.007955,172.31.47.0-255,66,221001,90,226805
18140,0.009942,74.125.200.0-255,5738,226739,90,226805
18141,0.009948,172.31.47.0-255,66,226805,90,226805
18142,0.0,172.217.194.0-255,153,153,90,230006
18143,2.9e-05,172.31.47.0-255,66,219,90,230006
18144,3.5e-05,172.217.194.0-255,1484,1703,90,230006
18145,3.9e-05,172.31.47.0-255,66,1769,90,230006
18146,4.4e-05,172.217.194.0-255,2902,4671,90,230006
18147,4.7e-05,172.31.47.0-255,66,4737,90,230006
18148,6.2e-05,172.217.194.0-255,7156,11893,90,230006
18149,6.4e-05,172.31.47.0-255,66,11959,90,230006
18150,0.000109,172.31.47.0-255,66,12025,90,230006
18151,0.000114,172.217.194.0-255,2543,14568,90,230006
18152,0.000117,172.31.47.0-255,66,14634,90,230006
18153,0.000157,172.217.194.0-255,1484,16118,90,230006
18154,0.000163,172.31.47.0-255,66,16184,90,230006
18155,0.000169,172.217.194.0-255,2902,19086,90,230006
18156,0.000171,172.31.47.0-255,66,19152,90,230006
18157,0.000177,172.217.194.0-255,5738,24890,90,230006
18158,0.000184,172.31.47.0-255,66,24956,90,230006
18159,0.000191,172.217.194.0-255,5738,30694,90,230006
18160,0.000194,172.31.47.0-255,66,30760,90,230006
18161,0.000264,172.31.47.0-255,66,30826,90,230006
18162,0.000271,172.217.194.0-255,4216,35042,90,230006
18163,0.000274,172.31.47.0-255,66,35108,90,230006
18164,0.000277,172.217.194.0-255,114,35222,90,230006
18165,0.000279,172.31.47.0-255,66,35288,90,230006
18166,0.00031,172.217.194.0-255,384,35672,90,230006
18167,0.000313,172.31.47.0-255,66,35738,90,230006
18168,0.000596,172.217.194.0-255,1484,37222,90,230006
18169,0.0006,172.31.47.0-255,66,37288,90,230006
18170,0.000607,172.217.194.0-255,2902,40190,90,230006
18171,0.00061,172.31.47.0-255,66,40256,90,230006
18172,0.000622,172.217.194.0-255,5738,45994,90,230006
18173,0.000629,172.31.47.0-255,66,46060,90,230006
18174,0.000657,172.31.47.0-255,66,46126,90,230006
18175,0.000662,172.217.194.0-255,10692,56818,90,230006
18176,0.00069,172.31.47.0-255,66,56884,90,230006
18177,0.000951,172.217.194.0-255,1484,58368,90,230006
18178,0.000958,172.217.194.0-255,2902,61270,90,230006
18179,0.000961,172.31.47.0-255,66,61336,90,230006
18180,0.000968,172.217.194.0-255,5738,67074,90,230006
18181,0.000976,172.31.47.0-255,66,67140,90,230006
18182,0.000988,172.217.194.0-255,2902,70042,90,230006
18183,0.000994,172.31.47.0-255,66,70108,90,230006
18184,0.00103,172.217.194.0-255,9992,80100,90,230006
18185,0.001034,172.31.47.0-255,66,80166,90,230006
18186,0.001042,172.217.194.0-255,9992,90158,90,230006
18187,0.001047,172.31.47.0-255,66,90224,90,230006
18188,0.001064,172.217.194.0-255,4320,94544,90,230006
18189,0.001072,172.31.47.0-255,66,94610,90,230006
18190,0.001118,172.31.47.0-255,66,94676,90,230006
18191,0.001122,172.217.194.0-255,9274,103950,90,230006
18192,0.001134,172.31.47.0-255,66,104016,90,230006
18193,0.001433,172.217.194.0-255,1484,105500,90,230006
18194,0.001437,172.217.194.0-255,1484,106984,90,230006
18195,0.00144,172.31.47.0-255,66,107050,90,230006
18196,0.001464,172.217.194.0-255,1484,108534,90,230006
18197,0.001471,172.217.194.0-255,5738,114272,90,230006
18198,0.001475,172.217.194.0-255,4320,118592,90,230006
18199,0.001477,172.31.47.0-255,66,118658,90,230006
18200,0.001483,172.31.47.0-255,66,118724,90,230006
18201,0.001497,172.217.194.0-255,8574,127298,90,230006
18202,0.001509,172.31.47.0-255,66,127364,90,230006
18203,0.001557,172.217.194.0-255,10692,138056,90,230006
18204,0.001567,172.217.194.0-255,9992,148048,90,230006
18205,0.001571,172.31.47.0-255,66,148114,90,230006
18206,0.001597,172.217.194.0-255,1484,149598,90,230006
18207,0.001614,172.31.47.0-255,66,149664,90,230006
18208,0.001644,172.217.194.0-255,10692,160356,90,230006
18209,0.001649,172.31.47.0-255,66,160422,90,230006
18210,0.001703,172.217.194.0-255,1484,161906,90,230006
18211,0.001709,172.217.194.0-255,2902,164808,90,230006
18212,0.001715,172.217.194.0-255,5738,170546,90,230006
18213,0.00172,172.31.47.0-255,66,170612,90,230006
18214,0.001728,172.217.194.0-255,9992,180604,90,230006
18215,0.001734,172.31.47.0-255,66,180670,90,230006
18216,0.001772,172.217.194.0-255,2902,183572,90,230006
18217,0.001777,172.31.47.0-255,66,183638,90,230006
18218,0.001782,172.217.194.0-255,10692,194330,90,230006
18219,0.001793,172.31.47.0-255,66,194396,90,230006
18220,0.001864,172.217.194.0-255,1484,195880,90,230006
18221,0.00187,172.217.194.0-255,2902,198782,90,230006
18222,0.001874,172.31.47.0-255,66,198848,90,230006
18223,0.001879,172.217.194.0-255,2902,201750,90,230006
18224,0.001892,172.31.47.0-255,66,201816,90,230006
18225,0.001906,172.217.194.0-255,2902,204718,90,230006
18226,0.001916,172.31.47.0-255,66,204784,90,230006
18227,0.001921,172.31.47.0-255,66,204850,90,230006
18228,0.001942,172.217.194.0-255,5738,210588,90,230006
18229,0.00195,172.31.47.0-255,66,210654,90,230006
18230,0.001993,172.31.47.0-255,66,210720,90,230006
18231,0.002009,172.31.47.0-255,66,210786,90,230006
18232,0.002015,172.217.194.0-255,7856,218642,90,230006
18233,0.002032,172.31.47.0-255,66,218708,90,230006
18234,0.002057,172.31.47.0-255,66,218774,90,230006
18235,0.002093,172.31.47.0-255,66,218840,90,230006
18236,0.002097,172.217.194.0-255,10692,229532,90,230006
18237,0.002109,172.31.47.0-255,66,229598,90,230006
18238,0.002144,172.31.47.0-255,66,229664,90,230006
18239,0.002173,172.217.194.0-255,105,229769,90,230006
18240,0.002188,172.31.47.0-255,66,229835,90,230006
18241,0.0036,172.31.47.0-255,105,229940,90,230006
18242,0.006146,172.217.194.0-255,66,230006,90,230006
18243,0.0,172.217.160.0-255,153,153,90,184106
18244,3e-05,172.31.47.0-255,66,219,90,184106
18245,3.6e-05,172.217.160.0-255,1484,1703,90,184106
18246,3.9e-05,172.31.47.0-255,66,1769,90,184106
18247,4.3e-05,172.217.160.0-255,2902,4671,90,184106
18248,4.5e-05,172.31.47.0-255,66,4737,90,184106
18249,4.8e-05,172.217.160.0-255,1484,6221,90,184106
18250,5e-05,172.31.47.0-255,66,6287,90,184106
18251,9.4e-05,172.217.160.0-255,4320,10607,90,184106
18252,9.7e-05,172.31.47.0-255,66,10673,90,184106
18253,0.000117,172.217.160.0-255,4984,15657,90,184106
18254,0.000119,172.31.47.0-255,66,15723,90,184106
18255,0.000127,172.217.160.0-255,7156,22879,90,184106
18256,0.000129,172.31.47.0-255,66,22945,90,184106
18257,0.000147,172.217.160.0-255,8215,31160,90,184106
18258,0.000149,172.31.47.0-255,66,31226,90,184106
18259,0.000172,172.217.160.0-255,1484,32710,90,184106
18260,0.000175,172.31.47.0-255,66,32776,90,184106
18261,0.000178,172.217.160.0-255,2902,35678,90,184106
18262,0.00018,172.31.47.0-255,66,35744,90,184106
18263,0.000185,172.217.160.0-255,5738,41482,90,184106
18264,0.000187,172.31.47.0-255,66,41548,90,184106
18265,0.000211,172.217.160.0-255,8215,49763,90,184106
18266,0.000214,172.31.47.0-255,66,49829,90,184106
18267,0.000234,172.217.160.0-255,7156,56985,90,184106
18268,0.000236,172.31.47.0-255,66,57051,90,184106
18269,0.000261,172.217.160.0-255,7156,64207,90,184106
18270,0.000264,172.31.47.0-255,66,64273,90,184106
18271,0.000279,172.217.160.0-255,1373,65646,90,184106
18272,0.000282,172.31.47.0-255,66,65712,90,184106
18273,0.00075,172.217.160.0-255,121,65833,90,184106
18274,0.000755,172.31.47.0-255,66,65899,90,184106
18275,0.000791,172.217.160.0-255,1484,67383,90,184106
18276,0.000796,172.217.160.0-255,2902,70285,90,184106
18277,0.000799,172.31.47.0-255,66,70351,90,184106
18278,0.000833,172.217.160.0-255,5738,76089,90,184106
18279,0.000836,172.31.47.0-255,66,76155,90,184106
18280,0.00084,172.217.160.0-255,1484,77639,90,184106
18281,0.00087,172.217.160.0-255,1484,79123,90,184106
18282,0.000873,172.31.47.0-255,66,79189,90,184106
18283,0.000891,172.217.160.0-255,7156,86345,90,184106
18284,0.000894,172.31.47.0-255,66,86411,90,184106
18285,0.000897,172.217.160.0-255,1484,87895,90,184106
18286,0.000926,172.31.47.0-255,66,87961,90,184106
18287,0.001008,172.217.160.0-255,1484,89445,90,184106
18288,0.001014,172.217.160.0-255,2902,92347,90,184106
18289,0.001017,172.31.47.0-255,66,92413,90,184106
18290,0.001024,172.217.160.0-255,5738,98151,90,184106
18291,0.001026,172.31.47.0-255,66,98217,90,184106
18292,0.001052,172.217.160.0-255,8574,106791,90,184106
18293,0.001054,172.31.47.0-255,66,106857,90,184106
18294,0.001077,172.217.160.0-255,4320,111177,90,184106
18295,0.001079,172.31.47.0-255,66,111243,90,184106
18296,0.001086,172.217.160.0-255,5738,116981,90,184106
18297,0.001088,172.31.47.0-255,66,117047,90,184106
18298,0.001105,172.217.160.0-255,4320,121367,90,184106
18299,0.001108,172.31.47.0-255,66,121433,90,184106
18300,0.00112,172.217.160.0-255,503,121936,90,184106
18301,0.001171,172.217.160.0-255,2902,124838,90,184106
18302,0.001175,172.31.47.0-255,66,124904,90,184106
18303,0.001192,172.217.160.0-255,2902,127806,90,184106
18304,0.001196,172.31.47.0-255,66,127872,90,184106
18305,0.001202,172.217.160.0-255,5738,133610,90,184106
18306,0.001204,172.31.47.0-255,66,133676,90,184106
18307,0.001213,172.217.160.0-255,8574,142250,90,184106
18308,0.001216,172.31.47.0-255,66,142316,90,184106
18309,0.001248,172.217.160.0-255,4320,146636,90,184106
18310,0.001251,172.31.47.0-255,66,146702,90,184106
18311,0.001275,172.217.160.0-255,7156,153858,90,184106
18312,0.001279,172.31.47.0-255,66,153924,90,184106
18313,0.001301,172.217.160.0-255,2184,156108,90,184106
18314,0.001305,172.31.47.0-255,66,156174,90,184106
18315,0.002893,172.217.160.0-255,1484,157658,90,184106
18316,0.002906,172.217.160.0-255,1484,159142,90,184106
18317,0.002908,172.31.47.0-255,66,159208,90,184106
18318,0.002926,172.217.160.0-255,1484,160692,90,184106
18319,0.00294,172.217.160.0-255,1484,162176,90,184106
18320,0.002942,172.31.47.0-255,66,162242,90,184106
18321,0.004552,172.217.160.0-255,4320,166562,90,184106
18322,0.004555,172.31.47.0-255,66,166628,90,184106
18323,0.004568,172.217.160.0-255,1484,168112,90,184106
18324,0.006182,172.217.160.0-255,4320,172432,90,184106
18325,0.006187,172.31.47.0-255,66,172498,90,184106
18326,0.007823,172.217.160.0-255,5738,178236,90,184106
18327,0.007829,172.31.47.0-255,66,178302,90,184106
18328,0.009449,172.217.160.0-255,5738,184040,90,184106
18329,0.009459,172.31.47.0-255,66,184106,90,184106
18330,0.0,172.217.194.0-255,153,153,90,202662
18331,3.6e-05,172.31.47.0-255,66,219,90,202662
18332,4.3e-05,172.217.194.0-255,1484,1703,90,202662
18333,4.7e-05,172.31.47.0-255,66,1769,90,202662
18334,5.1e-05,172.217.194.0-255,2902,4671,90,202662
18335,5.4e-05,172.31.47.0-255,66,4737,90,202662
18336,6.9e-05,172.217.194.0-255,7156,11893,90,202662
18337,7.2e-05,172.31.47.0-255,66,11959,90,202662
18338,7.6e-05,172.217.194.0-255,2109,14068,90,202662
18339,7.9e-05,172.31.47.0-255,66,14134,90,202662
18340,0.000123,172.217.194.0-255,2902,17036,90,202662
18341,0.000127,172.31.47.0-255,66,17102,90,202662
18342,0.000132,172.217.194.0-255,4320,21422,90,202662
18343,0.000134,172.31.47.0-255,66,21488,90,202662
18344,0.000141,172.217.194.0-255,5738,27226,90,202662
18345,0.000148,172.31.47.0-255,66,27292,90,202662
18346,0.000183,172.217.194.0-255,2902,30194,90,202662
18347,0.000186,172.31.47.0-255,66,30260,90,202662
18348,0.000189,172.217.194.0-255,1125,31385,90,202662
18349,0.000191,172.31.47.0-255,66,31451,90,202662
18350,0.000357,172.217.194.0-255,1484,32935,90,202662
18351,0.000361,172.31.47.0-255,66,33001,90,202662
18352,0.000367,172.217.194.0-255,2902,35903,90,202662
18353,0.00037,172.31.47.0-255,66,35969,90,202662
18354,0.000402,172.217.194.0-255,5738,41707,90,202662
18355,0.000406,172.31.47.0-255,66,41773,90,202662
18356,0.000409,172.217.194.0-255,1484,43257,90,202662
18357,0.000411,172.31.47.0-255,66,43323,90,202662
18358,0.000452,172.31.47.0-255,66,43389,90,202662
18359,0.000462,172.217.194.0-255,9633,53022,90,202662
18360,0.00047,172.31.47.0-255,66,53088,90,202662
18361,0.000473,172.217.194.0-255,379,53467,90,202662
18362,0.000749,172.217.194.0-255,365,53832,90,202662
18363,0.000855,172.31.47.0-255,66,53898,90,202662
18364,0.000931,172.217.194.0-255,1484,55382,90,202662
18365,0.000951,172.217.194.0-255,2902,58284,90,202662
18366,0.000955,172.31.47.0-255,66,58350,90,202662
18367,0.000961,172.217.194.0-255,5738,64088,90,202662
18368,0.000963,172.31.47.0-255,66,64154,90,202662
18369,0.000966,172.217.194.0-255,1484,65638,90,202662
18370,0.001004,172.31.47.0-255,66,65704,90,202662
18371,0.001014,172.217.194.0-255,10692,76396,90,202662
18372,0.001016,172.31.47.0-255,66,76462,90,202662
18373,0.001144,172.217.194.0-255,1484,77946,90,202662
18374,0.001149,172.217.194.0-255,2902,80848,90,202662
18375,0.001155,172.31.47.0-255,66,80914,90,202662
18376,0.001185,172.217.194.0-255,5738,86652,90,202662
18377,0.001189,172.31.47.0-255,66,86718,90,202662
18378,0.001203,172.31.47.0-255,66,86784,90,202662
18379,0.00121,172.217.194.0-255,5738,92522,90,202662
18380,0.001213,172.31.47.0-255,66,92588,90,202662
18381,0.00124,172.217.194.0-255,1484,94072,90,202662
18382,0.001247,172.217.194.0-255,3602,97674,90,202662
18383,0.001249,172.31.47.0-255,66,97740,90,202662
18384,0.001268,172.217.194.0-255,4320,102060,90,202662
18385,0.00127,172.31.47.0-255,66,102126,90,202662
18386,0.001302,172.217.194.0-255,9992,112118,90,202662
18387,0.001306,172.31.47.0-255,66,112184,90,202662
18388,0.001307,172.217.194.0-255,4320,116504,90,202662
18389,0.001309,172.31.47.0-255,66,116570,90,202662
18390,0.001337,172.217.194.0-255,4320,120890,90,202662
18391,0.00134,172.31.47.0-255,66,120956,90,202662
18392,0.001372,172.217.194.0-255,10692,131648,90,202662
18393,0.001375,172.31.47.0-255,66,131714,90,202662
18394,0.001391,172.31.47.0-255,66,131780,90,202662
18395,0.001445,172.31.47.0-255,66,131846,90,202662
18396,0.001697,172.217.194.0-255,1484,133330,90,202662
18397,0.00171,172.217.194.0-255,2902,136232,90,202662
18398,0.001713,172.31.47.0-255,66,136298,90,202662
18399,0.001717,172.217.194.0-255,1484,137782,90,202662
18400,0.001745,172.217.194.0-255,4320,142102,90,202662
18401,0.001749,172.31.47.0-255,66,142168,90,202662
18402,0.001766,172.217.194.0-255,4320,146488,90,202662
18403,0.00177,172.31.47.0-255,66,146554,90,202662
18404,0.001803,172.217.194.0-255,7156,153710,90,202662
18405,0.001806,172.31.47.0-255,66,153776,90,202662
18406,0.001834,172.31.47.0-255,66,153842,90,202662
18407,0.001924,172.217.194.0-255,1484,155326,90,202662
18408,0.001945,172.217.194.0-255,2902,158228,90,202662
18409,0.001948,172.31.47.0-255,66,158294,90,202662
18410,0.001953,172.217.194.0-255,2902,161196,90,202662
18411,0.001955,172.31.47.0-255,66,161262,90,202662
18412,0.001988,172.217.194.0-255,2902,164164,90,202662
18413,0.001992,172.31.47.0-255,66,164230,90,202662
18414,0.001998,172.217.194.0-255,5738,169968,90,202662
18415,0.002006,172.31.47.0-255,66,170034,90,202662
18416,0.00203,172.31.47.0-255,66,170100,90,202662
18417,0.002105,172.31.47.0-255,66,170166,90,202662
18418,0.002122,172.31.47.0-255,66,170232,90,202662
18419,0.002145,172.217.194.0-255,7156,177388,90,202662
18420,0.002148,172.31.47.0-255,66,177454,90,202662
18421,0.002197,172.31.47.0-255,66,177520,90,202662
18422,0.002209,172.31.47.0-255,66,177586,90,202662
18423,0.002224,172.217.194.0-255,4320,181906,90,202662
18424,0.002229,172.217.194.0-255,4320,186226,90,202662
18425,0.002243,172.31.47.0-255,66,186292,90,202662
18426,0.00227,172.31.47.0-255,66,186358,90,202662
18427,0.002291,172.31.47.0-255,66,186424,90,202662
18428,0.0023,172.217.194.0-255,8574,194998,90,202662
18429,0.002305,172.31.47.0-255,66,195064,90,202662
18430,0.002328,172.217.194.0-255,7427,202491,90,202662
18431,0.002331,172.217.194.0-255,105,202596,90,202662
18432,0.002341,172.31.47.0-255,66,202662,90,202662
18433,0.0,74.125.68.0-255,145,145,90,152621
18434,1.5e-05,172.31.47.0-255,66,211,90,152621
18435,2e-05,74.125.68.0-255,1484,1695,90,152621
18436,2.4e-05,172.31.47.0-255,66,1761,90,152621
18437,2.7e-05,74.125.68.0-255,1484,3245,90,152621
18438,2.9e-05,172.31.47.0-255,66,3311,90,152621
18439,4.2e-05,74.125.68.0-255,2902,6213,90,152621
18440,4.5e-05,172.31.47.0-255,66,6279,90,152621
18441,7.1e-05,74.125.68.0-255,4320,10599,90,152621
18442,7.4e-05,172.31.47.0-255,66,10665,90,152621
18443,9.8e-05,74.125.68.0-255,1484,12149,90,152621
18444,0.0001,172.31.47.0-255,66,12215,90,152621
18445,0.000127,74.125.68.0-255,1992,14207,90,152621
18446,0.000129,172.31.47.0-255,66,14273,90,152621
18447,0.000239,74.125.68.0-255,1484,15757,90,152621
18448,0.000243,172.31.47.0-255,66,15823,90,152621
18449,0.000248,74.125.68.0-255,2902,18725,90,152621
18450,0.000249,172.31.47.0-255,66,18791,90,152621
18451,0.00027,74.125.68.0-255,5738,24529,90,152621
18452,0.000272,172.31.47.0-255,66,24595,90,152621
18453,0.000276,74.125.68.0-255,2902,27497,90,152621
18454,0.000281,172.31.47.0-255,66,27563,90,152621
18455,0.00033,74.125.68.0-255,3961,31524,90,152621
18456,0.000333,172.31.47.0-255,66,31590,90,152621
18457,0.000336,74.125.68.0-255,1484,33074,90,152621
18458,0.000337,172.31.47.0-255,66,33140,90,152621
18459,0.000354,74.125.68.0-255,1484,34624,90,152621
18460,0.000356,172.31.47.0-255,66,34690,90,152621
18461,0.000361,74.125.68.0-255,4320,39010,90,152621
18462,0.000363,172.31.47.0-255,66,39076,90,152621
18463,0.00037,74.125.68.0-255,1484,40560,90,152621
18464,0.000371,172.31.47.0-255,66,40626,90,152621
18465,0.000402,74.125.68.0-255,7156,47782,90,152621
18466,0.000404,172.31.47.0-255,66,47848,90,152621
18467,0.000407,74.125.68.0-255,1125,48973,90,152621
18468,0.000443,74.125.68.0-255,1484,50457,90,152621
18469,0.000446,172.31.47.0-255,66,50523,90,152621
18470,0.000472,74.125.68.0-255,2902,53425,90,152621
18471,0.000475,172.31.47.0-255,66,53491,90,152621
18472,0.000496,74.125.68.0-255,2902,56393,90,152621
18473,0.000498,172.31.47.0-255,66,56459,90,152621
18474,0.000503,74.125.68.0-255,4320,60779,90,152621
18475,0.000505,172.31.47.0-255,66,60845,90,152621
18476,0.000542,74.125.68.0-255,2902,63747,90,152621
18477,0.000545,172.31.47.0-255,66,63813,90,152621
18478,0.000568,74.125.68.0-255,2820,66633,90,152621
18479,0.00057,172.31.47.0-255,66,66699,90,152621
18480,0.000573,74.125.68.0-255,132,66831,90,152621
18481,0.00071,74.125.68.0-255,1484,68315,90,152621
18482,0.000714,172.31.47.0-255,66,68381,90,152621
18483,0.000734,74.125.68.0-255,2902,71283,90,152621
18484,0.000737,172.31.47.0-255,66,71349,90,152621
18485,0.000739,74.125.68.0-255,1484,72833,90,152621
18486,0.000742,74.125.68.0-255,1484,74317,90,152621
18487,0.000744,172.31.47.0-255,66,74383,90,152621
18488,0.000765,74.125.68.0-255,1484,75867,90,152621
18489,0.000772,74.125.68.0-255,5738,81605,90,152621
18490,0.000774,172.31.47.0-255,66,81671,90,152621
18491,0.000783,74.125.68.0-255,4320,85991,90,152621
18492,0.000785,172.31.47.0-255,66,86057,90,152621
18493,0.000801,74.125.68.0-255,2543,88600,90,152621
18494,0.000803,172.31.47.0-255,66,88666,90,152621
18495,0.000809,74.125.68.0-255,7156,95822,90,152621
18496,0.000811,172.31.47.0-255,66,95888,90,152621
18497,0.000836,74.125.68.0-255,1484,97372,90,152621
18498,0.000851,74.125.68.0-255,2902,100274,90,152621
18499,0.000854,172.31.47.0-255,66,100340,90,152621
18500,0.000878,74.125.68.0-255,1125,101465,90,152621
18501,0.001379,172.31.47.0-255,66,101531,90,152621
18502,0.001713,74.125.68.0-255,1484,103015,90,152621
18503,0.001746,74.125.68.0-255,1484,104499,90,152621
18504,0.00175,172.31.47.0-255,66,104565,90,152621
18505,0.001775,74.125.68.0-255,2902,107467,90,152621
18506,0.001778,172.31.47.0-255,66,107533,90,152621
18507,0.001783,74.125.68.0-255,5738,113271,90,152621
18508,0.001785,172.31.47.0-255,66,113337,90,152621
18509,0.001841,74.125.68.0-255,2902,116239,90,152621
18510,0.001844,172.31.47.0-255,66,116305,90,152621
18511,0.001865,74.125.68.0-255,1484,117789,90,152621
18512,0.001899,74.125.68.0-255,2902,120691,90,152621
18513,0.001902,172.31.47.0-255,66,120757,90,152621
18514,0.001938,74.125.68.0-255,1484,122241,90,152621
18515,0.001955,74.125.68.0-255,2902,125143,90,152621
18516,0.001957,172.31.47.0-255,66,125209,90,152621
18517,0.001984,74.125.68.0-255,5738,130947,90,152621
18518,0.001987,172.31.47.0-255,66,131013,90,152621
18519,0.001996,74.125.68.0-255,1484,132497,90,152621
18520,0.002011,74.125.68.0-255,1484,133981,90,152621
18521,0.002013,172.31.47.0-255,66,134047,90,152621
18522,0.002038,74.125.68.0-255,2184,136231,90,152621
18523,0.00204,172.31.47.0-255,66,136297,90,152621
18524,0.004039,74.125.68.0-255,4320,140617,90,152621
18525,0.004045,172.31.47.0-255,66,140683,90,152621
18526,0.004071,74.125.68.0-255,1484,142167,90,152621
18527,0.006045,74.125.68.0-255,1484,143651,90,152621
18528,0.006048,172.31.47.0-255,66,143717,90,152621
18529,0.006072,74.125.68.0-255,2902,146619,90,152621
18530,0.006074,172.31.47.0-255,66,146685,90,152621
18531,0.008055,74.125.68.0-255,2902,149587,90,152621
18532,0.008061,172.31.47.0-255,66,149653,90,152621
18533,0.008087,74.125.68.0-255,2902,152555,90,152621
18534,0.00809,172.31.47.0-255,66,152621,90,152621
18535,0.0,74.125.24.0-255,150,150,90,75515
18536,3.1e-05,172.31.47.0-255,66,216,90,75515
18537,3.7e-05,74.125.24.0-255,1484,1700,90,75515
18538,4.1e-05,172.31.47.0-255,66,1766,90,75515
18539,4.5e-05,74.125.24.0-255,2902,4668,90,75515
18540,4.7e-05,172.31.47.0-255,66,4734,90,75515
18541,6e-05,74.125.24.0-255,7156,11890,90,75515
18542,6.2e-05,172.31.47.0-255,66,11956,90,75515
18543,0.000108,172.31.47.0-255,66,12022,90,75515
18544,0.000112,74.125.24.0-255,2902,14924,90,75515
18545,0.000114,172.31.47.0-255,66,14990,90,75515
18546,0.000138,74.125.24.0-255,3961,18951,90,75515
18547,0.000145,172.31.47.0-255,66,19017,90,75515
18548,0.000467,74.125.24.0-255,1484,20501,90,75515
18549,0.000471,172.31.47.0-255,66,20567,90,75515
18550,0.000474,74.125.24.0-255,1484,22051,90,75515
18551,0.000478,172.31.47.0-255,66,22117,90,75515
18552,0.000495,74.125.24.0-255,1484,23601,90,75515
18553,0.000497,172.31.47.0-255,66,23667,90,75515
18554,0.000503,74.125.24.0-255,4320,27987,90,75515
18555,0.000505,172.31.47.0-255,66,28053,90,75515
18556,0.000523,74.125.24.0-255,1484,29537,90,75515
18557,0.000526,172.31.47.0-255,66,29603,90,75515
18558,0.000531,74.125.24.0-255,4320,33923,90,75515
18559,0.000533,172.31.47.0-255,66,33989,90,75515
18560,0.00056,74.125.24.0-255,3961,37950,90,75515
18561,0.000563,172.31.47.0-255,66,38016,90,75515
18562,0.00057,74.125.24.0-255,8574,46590,90,75515
18563,0.000571,172.31.47.0-255,66,46656,90,75515
18564,0.000587,74.125.24.0-255,1484,48140,90,75515
18565,0.000589,172.31.47.0-255,66,48206,90,75515
18566,0.000614,74.125.24.0-255,5379,53585,90,75515
18567,0.000617,172.31.47.0-255,66,53651,90,75515
18568,0.002691,74.125.24.0-255,5738,59389,90,75515
18569,0.002696,172.31.47.0-255,66,59455,90,75515
18570,0.004772,74.125.24.0-255,5738,65193,90,75515
18571,0.004775,172.31.47.0-255,66,65259,90,75515
18572,0.006867,74.125.24.0-255,4320,69579,90,75515
18573,0.006873,172.31.47.0-255,66,69645,90,75515
18574,0.006898,74.125.24.0-255,1484,71129,90,75515
18575,0.008991,74.125.24.0-255,4320,75449,90,75515
18576,0.009004,172.31.47.0-255,66,75515,90,75515
18577,0.0,74.125.24.0-255,153,153,90,252426
18578,3e-05,172.31.47.0-255,66,219,90,252426
18579,3.6e-05,74.125.24.0-255,1484,1703,90,252426
18580,4e-05,172.31.47.0-255,66,1769,90,252426
18581,4.4e-05,74.125.24.0-255,2902,4671,90,252426
18582,4.7e-05,172.31.47.0-255,66,4737,90,252426
18583,4.9e-05,74.125.24.0-255,1484,6221,90,252426
18584,5.1e-05,172.31.47.0-255,66,6287,90,252426
18585,8.3e-05,74.125.24.0-255,5738,12025,90,252426
18586,8.5e-05,172.31.47.0-255,66,12091,90,252426
18587,9e-05,74.125.24.0-255,2064,14155,90,252426
18588,9.2e-05,172.31.47.0-255,66,14221,90,252426
18589,9.4e-05,74.125.24.0-255,1484,15705,90,252426
18590,9.6e-05,172.31.47.0-255,66,15771,90,252426
18591,0.000117,74.125.24.0-255,1484,17255,90,252426
18592,0.000121,172.31.47.0-255,66,17321,90,252426
18593,0.000128,74.125.24.0-255,7156,24477,90,252426
18594,0.00013,172.31.47.0-255,66,24543,90,252426
18595,0.000142,74.125.24.0-255,6797,31340,90,252426
18596,0.000143,172.31.47.0-255,66,31406,90,252426
18597,0.000246,74.125.24.0-255,1484,32890,90,252426
18598,0.000249,172.31.47.0-255,66,32956,90,252426
18599,0.000254,74.125.24.0-255,2902,35858,90,252426
18600,0.000256,172.31.47.0-255,66,35924,90,252426
18601,0.000292,74.125.24.0-255,5738,41662,90,252426
18602,0.000295,172.31.47.0-255,66,41728,90,252426
18603,0.000301,74.125.24.0-255,6797,48525,90,252426
18604,0.000303,172.31.47.0-255,66,48591,90,252426
18605,0.000308,74.125.24.0-255,5738,54329,90,252426
18606,0.00031,172.31.47.0-255,66,54395,90,252426
18607,0.000344,74.125.24.0-255,8574,62969,90,252426
18608,0.000349,172.31.47.0-255,66,63035,90,252426
18609,0.000353,74.125.24.0-255,2852,65887,90,252426
18610,0.000357,172.31.47.0-255,66,65953,90,252426
18611,0.000381,74.125.24.0-255,112,66065,90,252426
18612,0.000471,74.125.24.0-255,331,66396,90,252426
18613,0.000658,172.31.47.0-255,66,66462,90,252426
18614,0.000731,74.125.24.0-255,1484,67946,90,252426
18615,0.000739,74.125.24.0-255,2902,70848,90,252426
18616,0.000742,172.31.47.0-255,66,70914,90,252426
18617,0.000772,74.125.24.0-255,5738,76652,90,252426
18618,0.000775,172.31.47.0-255,66,76718,90,252426
18619,0.000783,74.125.24.0-255,8574,85292,90,252426
18620,0.000785,172.31.47.0-255,66,85358,90,252426
18621,0.000803,74.125.24.0-255,4320,89678,90,252426
18622,0.000806,172.31.47.0-255,66,89744,90,252426
18623,0.000825,74.125.24.0-255,7156,96900,90,252426
18624,0.000828,172.31.47.0-255,66,96966,90,252426
18625,0.000845,74.125.24.0-255,3602,100568,90,252426
18626,0.000851,172.31.47.0-255,66,100634,90,252426
18627,0.001341,74.125.24.0-255,1484,102118,90,252426
18628,0.001351,74.125.24.0-255,2902,105020,90,252426
18629,0.001354,172.31.47.0-255,66,105086,90,252426
18630,0.001362,74.125.24.0-255,5738,110824,90,252426
18631,0.001364,172.31.47.0-255,66,110890,90,252426
18632,0.001416,172.31.47.0-255,66,110956,90,252426
18633,0.001424,74.125.24.0-255,9992,120948,90,252426
18634,0.001425,172.31.47.0-255,66,121014,90,252426
18635,0.001432,74.125.24.0-255,766,121780,90,252426
18636,0.001475,74.125.24.0-255,1484,123264,90,252426
18637,0.001477,172.31.47.0-255,66,123330,90,252426
18638,0.001482,74.125.24.0-255,4320,127650,90,252426
18639,0.001483,172.31.47.0-255,66,127716,90,252426
18640,0.001521,74.125.24.0-255,9992,137708,90,252426
18641,0.001524,172.31.47.0-255,66,137774,90,252426
18642,0.00153,74.125.24.0-255,7156,144930,90,252426
18643,0.001531,172.31.47.0-255,66,144996,90,252426
18644,0.001572,74.125.24.0-255,8574,153570,90,252426
18645,0.001574,172.31.47.0-255,66,153636,90,252426
18646,0.0016,74.125.24.0-255,2184,155820,90,252426
18647,0.001602,172.31.47.0-255,66,155886,90,252426
18648,0.001639,74.125.24.0-255,1484,157370,90,252426
18649,0.001642,74.125.24.0-255,1484,158854,90,252426
18650,0.001644,172.31.47.0-255,66,158920,90,252426
18651,0.00166,74.125.24.0-255,1484,160404,90,252426
18652,0.001663,74.125.24.0-255,1484,161888,90,252426
18653,0.001664,172.31.47.0-255,66,161954,90,252426
18654,0.001689,74.125.24.0-255,4320,166274,90,252426
18655,0.001692,172.31.47.0-255,66,166340,90,252426
18656,0.001697,74.125.24.0-255,7156,173496,90,252426
18657,0.001699,172.31.47.0-255,66,173562,90,252426
18658,0.001733,74.125.24.0-255,5738,179300,90,252426
18659,0.001735,172.31.47.0-255,66,179366,90,252426
18660,0.001742,74.125.24.0-255,8574,187940,90,252426
18661,0.001744,172.31.47.0-255,66,188006,90,252426
18662,0.001747,74.125.24.0-255,2184,190190,90,252426
18663,0.001749,172.31.47.0-255,66,190256,90,252426
18664,0.001837,74.125.24.0-255,1484,191740,90,252426
18665,0.00184,74.125.24.0-255,1484,193224,90,252426
18666,0.001842,172.31.47.0-255,66,193290,90,252426
18667,0.001853,74.125.24.0-255,1484,194774,90,252426
18668,0.001861,74.125.24.0-255,2902,197676,90,252426
18669,0.001863,172.31.47.0-255,66,197742,90,252426
18670,0.001893,74.125.24.0-255,2902,200644,90,252426
18671,0.001895,172.31.47.0-255,66,200710,90,252426
18672,0.001901,74.125.24.0-255,7156,207866,90,252426
18673,0.001903,172.31.47.0-255,66,207932,90,252426
18674,0.001914,172.31.47.0-255,66,207998,90,252426
18675,0.001917,74.125.24.0-255,2184,210182,90,252426
18676,0.001919,172.31.47.0-255,66,210248,90,252426
18677,0.001983,74.125.24.0-255,1484,211732,90,252426
18678,0.001987,74.125.24.0-255,2902,214634,90,252426
18679,0.001989,172.31.47.0-255,66,214700,90,252426
18680,0.002025,74.125.24.0-255,5738,220438,90,252426
18681,0.002036,74.125.24.0-255,9992,230430,90,252426
18682,0.002041,74.125.24.0-255,5738,236168,90,252426
18683,0.002044,172.31.47.0-255,66,236234,90,252426
18684,0.002052,172.31.47.0-255,66,236300,90,252426
18685,0.002055,172.31.47.0-255,66,236366,90,252426
18686,0.004036,74.125.24.0-255,5738,242104,90,252426
18687,0.00404,172.31.47.0-255,66,242170,90,252426
18688,0.006023,74.125.24.0-255,4320,246490,90,252426
18689,0.006028,172.31.47.0-255,66,246556,90,252426
18690,0.006056,74.125.24.0-255,1484,248040,90,252426
18691,0.008025,74.125.24.0-255,4320,252360,90,252426
18692,0.008031,172.31.47.0-255,66,252426,90,252426
18693,0.0,74.125.68.0-255,153,153,90,175717
18694,2.6e-05,172.31.47.0-255,66,219,90,175717
18695,3.3e-05,74.125.68.0-255,1484,1703,90,175717
18696,3.6e-05,172.31.47.0-255,66,1769,90,175717
18697,3.9e-05,74.125.68.0-255,1484,3253,90,175717
18698,4.2e-05,172.31.47.0-255,66,3319,90,175717
18699,7.8e-05,74.125.68.0-255,2902,6221,90,175717
18700,8.1e-05,172.31.47.0-255,66,6287,90,175717
18701,8.9e-05,74.125.68.0-255,5738,12025,90,175717
18702,9.1e-05,172.31.47.0-255,66,12091,90,175717
18703,0.0001,74.125.68.0-255,2139,14230,90,175717
18704,0.000102,172.31.47.0-255,66,14296,90,175717
18705,0.000144,74.125.68.0-255,1484,15780,90,175717
18706,0.000148,172.31.47.0-255,66,15846,90,175717
18707,0.000167,74.125.68.0-255,2902,18748,90,175717
18708,0.000171,172.31.47.0-255,66,18814,90,175717
18709,0.000177,74.125.68.0-255,5738,24552,90,175717
18710,0.000179,172.31.47.0-255,66,24618,90,175717
18711,0.000205,74.125.68.0-255,4320,28938,90,175717
18712,0.000208,172.31.47.0-255,66,29004,90,175717
18713,0.000242,74.125.68.0-255,2543,31547,90,175717
18714,0.000245,172.31.47.0-255,66,31613,90,175717
18715,0.000314,74.125.68.0-255,1484,33097,90,175717
18716,0.000318,172.31.47.0-255,66,33163,90,175717
18717,0.000323,74.125.68.0-255,2902,36065,90,175717
18718,0.000326,172.31.47.0-255,66,36131,90,175717
18719,0.000358,74.125.68.0-255,5738,41869,90,175717
18720,0.000362,172.31.47.0-255,66,41935,90,175717
18721,0.000369,74.125.68.0-255,6797,48732,90,175717
18722,0.000372,172.31.47.0-255,66,48798,90,175717
18723,0.000428,74.125.68.0-255,7156,55954,90,175717
18724,0.000432,172.31.47.0-255,66,56020,90,175717
18725,0.00044,74.125.68.0-255,8574,64594,90,175717
18726,0.000443,172.31.47.0-255,66,64660,90,175717
18727,0.000445,74.125.68.0-255,1399,66059,90,175717
18728,0.000471,74.125.68.0-255,129,66188,90,175717
18729,0.000475,74.125.68.0-255,351,66539,90,175717
18730,0.00048,172.31.47.0-255,66,66605,90,175717
18731,0.000786,74.125.68.0-255,1484,68089,90,175717
18732,0.000801,74.125.68.0-255,2902,70991,90,175717
18733,0.000805,172.31.47.0-255,66,71057,90,175717
18734,0.000833,74.125.68.0-255,5738,76795,90,175717
18735,0.000837,172.31.47.0-255,66,76861,90,175717
18736,0.000881,74.125.68.0-255,9992,86853,90,175717
18737,0.000885,172.31.47.0-255,66,86919,90,175717
18738,0.000924,172.31.47.0-255,66,86985,90,175717
18739,0.000952,74.125.68.0-255,2184,89169,90,175717
18740,0.000955,172.31.47.0-255,66,89235,90,175717
18741,0.001534,74.125.68.0-255,1484,90719,90,175717
18742,0.00156,74.125.68.0-255,2902,93621,90,175717
18743,0.001566,172.31.47.0-255,66,93687,90,175717
18744,0.001573,74.125.68.0-255,5738,99425,90,175717
18745,0.001575,172.31.47.0-255,66,99491,90,175717
18746,0.001583,74.125.68.0-255,1484,100975,90,175717
18747,0.001587,74.125.68.0-255,2902,103877,90,175717
18748,0.00159,172.31.47.0-255,66,103943,90,175717
18749,0.001659,74.125.68.0-255,5738,109681,90,175717
18750,0.001662,172.31.47.0-255,66,109747,90,175717
18751,0.001668,74.125.68.0-255,5738,115485,90,175717
18752,0.00167,172.31.47.0-255,66,115551,90,175717
18753,0.001681,74.125.68.0-255,7156,122707,90,175717
18754,0.001683,172.31.47.0-255,66,122773,90,175717
18755,0.001685,74.125.68.0-255,766,123539,90,175717
18756,0.001888,74.125.68.0-255,1484,125023,90,175717
18757,0.001891,172.31.47.0-255,66,125089,90,175717
18758,0.001901,74.125.68.0-255,1484,126573,90,175717
18759,0.001918,74.125.68.0-255,1484,128057,90,175717
18760,0.00192,172.31.47.0-255,66,128123,90,175717
18761,0.001941,74.125.68.0-255,5738,133861,90,175717
18762,0.001944,172.31.47.0-255,66,133927,90,175717
18763,0.001977,74.125.68.0-255,2902,136829,90,175717
18764,0.00198,172.31.47.0-255,66,136895,90,175717
18765,0.002006,74.125.68.0-255,2902,139797,90,175717
18766,0.002008,172.31.47.0-255,66,139863,90,175717
18767,0.002012,74.125.68.0-255,1484,141347,90,175717
18768,0.00204,74.125.68.0-255,5738,147085,90,175717
18769,0.002043,172.31.47.0-255,66,147151,90,175717
18770,0.002046,74.125.68.0-255,2902,150053,90,175717
18771,0.002048,172.31.47.0-255,66,150119,90,175717
18772,0.002076,74.125.68.0-255,4320,154439,90,175717
18773,0.002078,172.31.47.0-255,66,154505,90,175717
18774,0.002099,74.125.68.0-255,1484,155989,90,175717
18775,0.002113,74.125.68.0-255,2184,158173,90,175717
18776,0.002115,172.31.47.0-255,66,158239,90,175717
18777,0.002301,74.125.68.0-255,1484,159723,90,175717
18778,0.004378,74.125.68.0-255,4320,164043,90,175717
18779,0.004381,172.31.47.0-255,66,164109,90,175717
18780,0.006657,74.125.68.0-255,5738,169847,90,175717
18781,0.006662,172.31.47.0-255,66,169913,90,175717
18782,0.008933,74.125.68.0-255,5738,175651,90,175717
18783,0.00894,172.31.47.0-255,66,175717,90,175717
18784,0.0,74.125.68.0-255,143,143,90,159484
18785,2.3e-05,172.31.47.0-255,66,209,90,159484
18786,2.9e-05,74.125.68.0-255,1484,1693,90,159484
18787,3.2e-05,172.31.47.0-255,66,1759,90,159484
18788,4.8e-05,74.125.68.0-255,2902,4661,90,159484
18789,5.1e-05,172.31.47.0-255,66,4727,90,159484
18790,5.3e-05,74.125.68.0-255,1484,6211,90,159484
18791,5.5e-05,172.31.47.0-255,66,6277,90,159484
18792,5.9e-05,74.125.68.0-255,2902,9179,90,159484
18793,6.1e-05,172.31.47.0-255,66,9245,90,159484
18794,9.9e-05,74.125.68.0-255,5738,14983,90,159484
18795,0.000102,172.31.47.0-255,66,15049,90,159484
18796,0.000119,74.125.68.0-255,798,15847,90,159484
18797,0.000121,172.31.47.0-255,66,15913,90,159484
18798,0.000124,74.125.68.0-255,2902,18815,90,159484
18799,0.000126,172.31.47.0-255,66,18881,90,159484
18800,0.000131,74.125.68.0-255,4320,23201,90,159484
18801,0.000133,172.31.47.0-255,66,23267,90,159484
18802,0.000164,74.125.68.0-255,5738,29005,90,159484
18803,0.000167,172.31.47.0-255,66,29071,90,159484
18804,0.000186,74.125.68.0-255,2543,31614,90,159484
18805,0.000188,172.31.47.0-255,66,31680,90,159484
18806,0.000297,74.125.68.0-255,1484,33164,90,159484
18807,0.000304,172.31.47.0-255,66,33230,90,159484
18808,0.000309,74.125.68.0-255,2902,36132,90,159484
18809,0.000311,172.31.47.0-255,66,36198,90,159484
18810,0.000332,74.125.68.0-255,4320,40518,90,159484
18811,0.000335,172.31.47.0-255,66,40584,90,159484
18812,0.000395,74.125.68.0-255,8215,48799,90,159484
18813,0.000399,172.31.47.0-255,66,48865,90,159484
18814,0.000407,74.125.68.0-255,8574,57439,90,159484
18815,0.000409,172.31.47.0-255,66,57505,90,159484
18816,0.000415,74.125.68.0-255,4320,61825,90,159484
18817,0.000417,172.31.47.0-255,66,61891,90,159484
18818,0.000433,74.125.68.0-255,2902,64793,90,159484
18819,0.000435,172.31.47.0-255,66,64859,90,159484
18820,0.000453,74.125.68.0-255,1436,66295,90,159484
18821,0.000482,74.125.68.0-255,110,66405,90,159484
18822,0.000593,74.125.68.0-255,1484,67889,90,159484
18823,0.000598,172.31.47.0-255,66,67955,90,159484
18824,0.000603,74.125.68.0-255,2902,70857,90,159484
18825,0.000606,172.31.47.0-255,66,70923,90,159484
18826,0.000609,74.125.68.0-255,1484,72407,90,159484
18827,0.000629,74.125.68.0-255,2902,75309,90,159484
18828,0.000632,172.31.47.0-255,66,75375,90,159484
18829,0.000651,74.125.68.0-255,2902,78277,90,159484
18830,0.000654,172.31.47.0-255,66,78343,90,159484
18831,0.000673,74.125.68.0-255,7156,85499,90,159484
18832,0.000676,172.31.47.0-255,66,85565,90,159484
18833,0.000702,74.125.68.0-255,5738,91303,90,159484
18834,0.000705,172.31.47.0-255,66,91369,90,159484
18835,0.000726,74.125.68.0-255,8574,99943,90,159484
18836,0.00073,172.31.47.0-255,66,100009,90,159484
18837,0.00075,74.125.68.0-255,1031,101040,90,159484
18838,0.001337,74.125.68.0-255,1484,102524,90,159484
18839,0.001344,172.31.47.0-255,66,102590,90,159484
18840,0.001349,74.125.68.0-255,1484,104074,90,159484
18841,0.001366,74.125.68.0-255,1484,105558,90,159484
18842,0.001369,172.31.47.0-255,66,105624,90,159484
18843,0.001372,74.125.68.0-255,1484,107108,90,159484
18844,0.001388,74.125.68.0-255,2902,110010,90,159484
18845,0.001392,172.31.47.0-255,66,110076,90,159484
18846,0.001414,74.125.68.0-255,5738,115814,90,159484
18847,0.001417,172.31.47.0-255,66,115880,90,159484
18848,0.001421,74.125.68.0-255,1484,117364,90,159484
18849,0.001437,74.125.68.0-255,2902,120266,90,159484
18850,0.001439,172.31.47.0-255,66,120332,90,159484
18851,0.001457,74.125.68.0-255,5738,126070,90,159484
18852,0.001459,172.31.47.0-255,66,126136,90,159484
18853,0.001463,74.125.68.0-255,2902,129038,90,159484
18854,0.001465,172.31.47.0-255,66,129104,90,159484
18855,0.001486,74.125.68.0-255,4320,133424,90,159484
18856,0.001488,172.31.47.0-255,66,133490,90,159484
18857,0.001512,74.125.68.0-255,2184,135674,90,159484
18858,0.001515,172.31.47.0-255,66,135740,90,159484
18859,0.00345,74.125.68.0-255,2902,138642,90,159484
18860,0.003456,172.31.47.0-255,66,138708,90,159484
18861,0.003477,74.125.68.0-255,2902,141610,90,159484
18862,0.00348,172.31.47.0-255,66,141676,90,159484
18863,0.005482,74.125.68.0-255,2902,144578,90,159484
18864,0.005488,172.31.47.0-255,66,144644,90,159484
18865,0.005507,74.125.68.0-255,2902,147546,90,159484
18866,0.005509,172.31.47.0-255,66,147612,90,159484
18867,0.00746,74.125.68.0-255,2902,150514,90,159484
18868,0.007467,172.31.47.0-255,66,150580,90,159484
18869,0.007487,74.125.68.0-255,2902,153482,90,159484
18870,0.00749,172.31.47.0-255,66,153548,90,159484
18871,0.009435,74.125.68.0-255,2902,156450,90,159484
18872,0.009442,172.31.47.0-255,66,156516,90,159484
18873,0.00947,74.125.68.0-255,2902,159418,90,159484
18874,0.009474,172.31.47.0-255,66,159484,90,159484
18875,0.0,74.125.24.0-255,152,152,90,319117
18876,2.8e-05,172.31.47.0-255,66,218,90,319117
18877,3.5e-05,74.125.24.0-255,1484,1702,90,319117
18878,3.8e-05,172.31.47.0-255,66,1768,90,319117
18879,4.2e-05,74.125.24.0-255,2902,4670,90,319117
18880,4.4e-05,172.31.47.0-255,66,4736,90,319117
18881,4.8e-05,74.125.24.0-255,4320,9056,90,319117
18882,5.1e-05,172.31.47.0-255,66,9122,90,319117
18883,6.7e-05,74.125.24.0-255,2902,12024,90,319117
18884,6.9e-05,172.31.47.0-255,66,12090,90,319117
18885,7.2e-05,74.125.24.0-255,2064,14154,90,319117
18886,7.4e-05,172.31.47.0-255,66,14220,90,319117
18887,0.0001,74.125.24.0-255,1484,15704,90,319117
18888,0.000102,172.31.47.0-255,66,15770,90,319117
18889,0.000123,74.125.24.0-255,5738,21508,90,319117
18890,0.000125,172.31.47.0-255,66,21574,90,319117
18891,0.00013,74.125.24.0-255,2902,24476,90,319117
18892,0.000131,172.31.47.0-255,66,24542,90,319117
18893,0.000152,74.125.24.0-255,5738,30280,90,319117
18894,0.000154,172.31.47.0-255,66,30346,90,319117
18895,0.000174,74.125.24.0-255,1125,31471,90,319117
18896,0.000176,172.31.47.0-255,66,31537,90,319117
18897,0.00018,74.125.24.0-255,1484,33021,90,319117
18898,0.000182,172.31.47.0-255,66,33087,90,319117
18899,0.000188,74.125.24.0-255,4320,37407,90,319117
18900,0.00019,172.31.47.0-255,66,37473,90,319117
18901,0.000193,74.125.24.0-255,1484,38957,90,319117
18902,0.000195,172.31.47.0-255,66,39023,90,319117
18903,0.000215,74.125.24.0-255,8574,47597,90,319117
18904,0.000218,172.31.47.0-255,66,47663,90,319117
18905,0.00022,74.125.24.0-255,1125,48788,90,319117
18906,0.000222,172.31.47.0-255,66,48854,90,319117
18907,0.00027,74.125.24.0-255,1484,50338,90,319117
18908,0.000276,74.125.24.0-255,2902,53240,90,319117
18909,0.000279,172.31.47.0-255,66,53306,90,319117
18910,0.000283,74.125.24.0-255,2902,56208,90,319117
18911,0.000285,172.31.47.0-255,66,56274,90,319117
18912,0.000301,74.125.24.0-255,2902,59176,90,319117
18913,0.000304,172.31.47.0-255,66,59242,90,319117
18914,0.000322,74.125.24.0-255,4320,63562,90,319117
18915,0.000326,172.31.47.0-255,66,63628,90,319117
18916,0.000349,74.125.24.0-255,2876,66504,90,319117
18917,0.000352,172.31.47.0-255,66,66570,90,319117
18918,0.000355,74.125.24.0-255,110,66680,90,319117
18919,0.000413,74.125.24.0-255,331,67011,90,319117
18920,0.00059,74.125.24.0-255,1484,68495,90,319117
18921,0.000595,74.125.24.0-255,2902,71397,90,319117
18922,0.000596,172.31.47.0-255,66,71463,90,319117
18923,0.0006,172.31.47.0-255,66,71529,90,319117
18924,0.000619,74.125.24.0-255,5738,77267,90,319117
18925,0.000622,172.31.47.0-255,66,77333,90,319117
18926,0.000627,74.125.24.0-255,2902,80235,90,319117
18927,0.00063,172.31.47.0-255,66,80301,90,319117
18928,0.000659,74.125.24.0-255,2902,83203,90,319117
18929,0.000662,172.31.47.0-255,66,83269,90,319117
18930,0.000671,172.31.47.0-255,66,83335,90,319117
18931,0.000678,74.125.24.0-255,5020,88355,90,319117
18932,0.00068,172.31.47.0-255,66,88421,90,319117
18933,0.000975,74.125.24.0-255,1484,89905,90,319117
18934,0.000979,74.125.24.0-255,1484,91389,90,319117
18935,0.000983,172.31.47.0-255,66,91455,90,319117
18936,0.001005,74.125.24.0-255,1484,92939,90,319117
18937,0.001012,74.125.24.0-255,5738,98677,90,319117
18938,0.001014,172.31.47.0-255,66,98743,90,319117
18939,0.001023,74.125.24.0-255,9992,108735,90,319117
18940,0.001025,172.31.47.0-255,66,108801,90,319117
18941,0.001046,74.125.24.0-255,2902,111703,90,319117
18942,0.001049,172.31.47.0-255,66,111769,90,319117
18943,0.001058,74.125.24.0-255,10692,122461,90,319117
18944,0.00106,172.31.47.0-255,66,122527,90,319117
18945,0.001092,74.125.24.0-255,4320,126847,90,319117
18946,0.001095,172.31.47.0-255,66,126913,90,319117
18947,0.001101,74.125.24.0-255,5738,132651,90,319117
18948,0.001103,172.31.47.0-255,66,132717,90,319117
18949,0.001148,172.31.47.0-255,66,132783,90,319117
18950,0.001155,74.125.24.0-255,7156,139939,90,319117
18951,0.001157,172.31.47.0-255,66,140005,90,319117
18952,0.001178,74.125.24.0-255,5020,145025,90,319117
18953,0.001181,172.31.47.0-255,66,145091,90,319117
18954,0.001202,74.125.24.0-255,1484,146575,90,319117
18955,0.001255,74.125.24.0-255,4320,150895,90,319117
18956,0.001258,172.31.47.0-255,66,150961,90,319117
18957,0.001279,74.125.24.0-255,4320,155281,90,319117
18958,0.001282,172.31.47.0-255,66,155347,90,319117
18959,0.001293,172.31.47.0-255,66,155413,90,319117
18960,0.001324,172.31.47.0-255,66,155479,90,319117
18961,0.001327,74.125.24.0-255,1484,156963,90,319117
18962,0.001347,74.125.24.0-255,2902,159865,90,319117
18963,0.00135,172.31.47.0-255,66,159931,90,319117
18964,0.001356,74.125.24.0-255,5738,165669,90,319117
18965,0.001362,172.31.47.0-255,66,165735,90,319117
18966,0.001367,172.31.47.0-255,66,165801,90,319117
18967,0.001374,74.125.24.0-255,7156,172957,90,319117
18968,0.001376,172.31.47.0-255,66,173023,90,319117
18969,0.001398,74.125.24.0-255,5020,178043,90,319117
18970,0.001402,172.31.47.0-255,66,178109,90,319117
18971,0.001636,74.125.24.0-255,1484,179593,90,319117
18972,0.001642,74.125.24.0-255,2902,182495,90,319117
18973,0.001645,172.31.47.0-255,66,182561,90,319117
18974,0.001664,74.125.24.0-255,5738,188299,90,319117
18975,0.001667,172.31.47.0-255,66,188365,90,319117
18976,0.001692,74.125.24.0-255,2902,191267,90,319117
18977,0.001695,172.31.47.0-255,66,191333,90,319117
18978,0.001718,74.125.24.0-255,7156,198489,90,319117
18979,0.001721,172.31.47.0-255,66,198555,90,319117
18980,0.001728,74.125.24.0-255,5738,204293,90,319117
18981,0.001731,172.31.47.0-255,66,204359,90,319117
18982,0.001767,74.125.24.0-255,4320,208679,90,319117
18983,0.00177,172.31.47.0-255,66,208745,90,319117
18984,0.001788,74.125.24.0-255,3602,212347,90,319117
18985,0.001791,172.31.47.0-255,66,212413,90,319117
18986,0.002058,74.125.24.0-255,1484,213897,90,319117
18987,0.002087,74.125.24.0-255,2902,216799,90,319117
18988,0.00209,172.31.47.0-255,66,216865,90,319117
18989,0.002097,74.125.24.0-255,5738,222603,90,319117
18990,0.002099,172.31.47.0-255,66,222669,90,319117
18991,0.002107,74.125.24.0-255,8574,231243,90,319117
18992,0.002109,172.31.47.0-255,66,231309,90,319117
18993,0.00214,74.125.24.0-255,4320,235629,90,319117
18994,0.002144,172.31.47.0-255,66,235695,90,319117
18995,0.002148,74.125.24.0-255,10692,246387,90,319117
18996,0.002151,172.31.47.0-255,66,246453,90,319117
18997,0.002189,74.125.24.0-255,1484,247937,90,319117
18998,0.002207,74.125.24.0-255,2902,250839,90,319117
18999,0.00221,172.31.47.0-255,66,250905,90,319117
19000,0.002217,74.125.24.0-255,5738,256643,90,319117
19001,0.002219,172.31.47.0-255,66,256709,90,319117
19002,0.002224,74.125.24.0-255,5738,262447,90,319117
19003,0.002228,172.31.47.0-255,66,262513,90,319117
19004,0.002258,172.31.47.0-255,66,262579,90,319117
19005,0.002276,74.125.24.0-255,5020,267599,90,319117
19006,0.002279,172.31.47.0-255,66,267665,90,319117
19007,0.002282,74.125.24.0-255,1484,269149,90,319117
19008,0.002308,74.125.24.0-255,4320,273469,90,319117
19009,0.002311,172.31.47.0-255,66,273535,90,319117
19010,0.002316,74.125.24.0-255,4320,277855,90,319117
19011,0.002318,172.31.47.0-255,66,277921,90,319117
19012,0.00234,74.125.24.0-255,8574,286495,90,319117
19013,0.002344,172.31.47.0-255,66,286561,90,319117
19014,0.002382,74.125.24.0-255,7156,293717,90,319117
19015,0.002385,172.31.47.0-255,66,293783,90,319117
19016,0.00241,74.125.24.0-255,7856,301639,90,319117
19017,0.002413,172.31.47.0-255,66,301705,90,319117
19018,0.004747,74.125.24.0-255,5738,307443,90,319117
19019,0.004754,172.31.47.0-255,66,307509,90,319117
19020,0.007081,74.125.24.0-255,5738,313247,90,319117
19021,0.007087,172.31.47.0-255,66,313313,90,319117
19022,0.009423,74.125.24.0-255,5738,319051,90,319117
19023,0.009428,172.31.47.0-255,66,319117,90,319117
19024,0.0,172.217.194.0-255,297,297,90,207682
19025,2.2e-05,172.31.47.0-255,66,363,90,207682
19026,2.7e-05,172.217.194.0-255,1484,1847,90,207682
19027,3.1e-05,172.31.47.0-255,66,1913,90,207682
19028,3.7e-05,172.217.194.0-255,4320,6233,90,207682
19029,4.7e-05,172.31.47.0-255,66,6299,90,207682
19030,7.3e-05,172.217.194.0-255,7156,13455,90,207682
19031,7.5e-05,172.31.47.0-255,66,13521,90,207682
19032,8.5e-05,172.217.194.0-255,413,13934,90,207682
19033,8.8e-05,172.31.47.0-255,66,14000,90,207682
19034,0.000113,172.217.194.0-255,1484,15484,90,207682
19035,0.000115,172.31.47.0-255,66,15550,90,207682
19036,0.000131,172.217.194.0-255,2902,18452,90,207682
19037,0.000133,172.31.47.0-255,66,18518,90,207682
19038,0.000139,172.217.194.0-255,5738,24256,90,207682
19039,0.000141,172.31.47.0-255,66,24322,90,207682
19040,0.000173,172.217.194.0-255,6797,31119,90,207682
19041,0.000176,172.31.47.0-255,66,31185,90,207682
19042,0.000221,172.217.194.0-255,1484,32669,90,207682
19043,0.000223,172.31.47.0-255,66,32735,90,207682
19044,0.000228,172.217.194.0-255,2902,35637,90,207682
19045,0.00023,172.31.47.0-255,66,35703,90,207682
19046,0.000256,172.217.194.0-255,5738,41441,90,207682
19047,0.000259,172.31.47.0-255,66,41507,90,207682
19048,0.000265,172.217.194.0-255,5738,47245,90,207682
19049,0.000267,172.31.47.0-255,66,47311,90,207682
19050,0.000295,172.217.194.0-255,1125,48436,90,207682
19051,0.000297,172.31.47.0-255,66,48502,90,207682
19052,0.000318,172.217.194.0-255,1484,49986,90,207682
19053,0.00032,172.31.47.0-255,66,50052,90,207682
19054,0.000323,172.217.194.0-255,1484,51536,90,207682
19055,0.000324,172.31.47.0-255,66,51602,90,207682
19056,0.000359,172.217.194.0-255,2902,54504,90,207682
19057,0.000371,172.217.194.0-255,9992,64496,90,207682
19058,0.000374,172.217.194.0-255,1125,65621,90,207682
19059,0.000521,172.31.47.0-255,66,65687,90,207682
19060,0.000545,172.217.194.0-255,645,66332,90,207682
19061,0.000831,172.217.194.0-255,1484,67816,90,207682
19062,0.000835,172.31.47.0-255,66,67882,90,207682
19063,0.000839,172.217.194.0-255,1484,69366,90,207682
19064,0.000861,172.217.194.0-255,1484,70850,90,207682
19065,0.000865,172.217.194.0-255,2902,73752,90,207682
19066,0.000876,172.31.47.0-255,66,73818,90,207682
19067,0.000887,172.217.194.0-255,2902,76720,90,207682
19068,0.000894,172.217.194.0-255,2902,79622,90,207682
19069,0.000902,172.217.194.0-255,8574,88196,90,207682
19070,0.000912,172.217.194.0-255,1484,89680,90,207682
19071,0.00092,172.31.47.0-255,66,89746,90,207682
19072,0.000943,172.217.194.0-255,10144,99890,90,207682
19073,0.000963,172.31.47.0-255,66,99956,90,207682
19074,0.001174,172.217.194.0-255,1484,101440,90,207682
19075,0.001192,172.217.194.0-255,2902,104342,90,207682
19076,0.001195,172.31.47.0-255,66,104408,90,207682
19077,0.001221,172.217.194.0-255,5738,110146,90,207682
19078,0.001225,172.217.194.0-255,2902,113048,90,207682
19079,0.001248,172.217.194.0-255,5738,118786,90,207682
19080,0.00125,172.31.47.0-255,66,118852,90,207682
19081,0.001255,172.31.47.0-255,66,118918,90,207682
19082,0.001276,172.217.194.0-255,4320,123238,90,207682
19083,0.001285,172.217.194.0-255,4320,127558,90,207682
19084,0.001297,172.217.194.0-255,6438,133996,90,207682
19085,0.001304,172.31.47.0-255,66,134062,90,207682
19086,0.001645,172.217.194.0-255,1484,135546,90,207682
19087,0.001686,172.217.194.0-255,2902,138448,90,207682
19088,0.00169,172.31.47.0-255,66,138514,90,207682
19089,0.001696,172.217.194.0-255,5738,144252,90,207682
19090,0.001705,172.217.194.0-255,5738,149990,90,207682
19091,0.00171,172.217.194.0-255,4320,154310,90,207682
19092,0.001738,172.217.194.0-255,8574,162884,90,207682
19093,0.001758,172.217.194.0-255,5020,167904,90,207682
19094,0.002379,172.217.194.0-255,1484,169388,90,207682
19095,0.002387,172.217.194.0-255,2902,172290,90,207682
19096,0.002412,172.217.194.0-255,2902,175192,90,207682
19097,0.002428,172.217.194.0-255,2902,178094,90,207682
19098,0.00243,172.217.194.0-255,1484,179578,90,207682
19099,0.002451,172.217.194.0-255,7156,186734,90,207682
19100,0.002465,172.217.194.0-255,4320,191054,90,207682
19101,0.002472,172.217.194.0-255,8574,199628,90,207682
19102,0.002512,172.217.194.0-255,2184,201812,90,207682
19103,0.006223,172.31.47.0-255,66,201878,90,207682
19104,0.008779,172.217.194.0-255,5738,207616,90,207682
19105,0.008786,172.31.47.0-255,66,207682,90,207682
19106,0.0,74.125.24.0-255,153,153,90,300904
19107,2.9e-05,172.31.47.0-255,66,219,90,300904
19108,3.6e-05,74.125.24.0-255,1484,1703,90,300904
19109,3.9e-05,172.31.47.0-255,66,1769,90,300904
19110,4.4e-05,74.125.24.0-255,2902,4671,90,300904
19111,4.7e-05,172.31.47.0-255,66,4737,90,300904
19112,5.3e-05,74.125.24.0-255,7156,11893,90,300904
19113,5.5e-05,172.31.47.0-255,66,11959,90,300904
19114,6.1e-05,74.125.24.0-255,6269,18228,90,300904
19115,6.3e-05,172.31.47.0-255,66,18294,90,300904
19116,0.000105,74.125.24.0-255,4320,22614,90,300904
19117,0.000107,172.31.47.0-255,66,22680,90,300904
19118,0.000131,74.125.24.0-255,8215,30895,90,300904
19119,0.000134,172.31.47.0-255,66,30961,90,300904
19120,0.000161,74.125.24.0-255,1484,32445,90,300904
19121,0.000163,172.31.47.0-255,66,32511,90,300904
19122,0.000169,74.125.24.0-255,2902,35413,90,300904
19123,0.000171,172.31.47.0-255,66,35479,90,300904
19124,0.000175,74.125.24.0-255,1484,36963,90,300904
19125,0.000177,172.31.47.0-255,66,37029,90,300904
19126,0.000197,74.125.24.0-255,4320,41349,90,300904
19127,0.0002,172.31.47.0-255,66,41415,90,300904
19128,0.000207,74.125.24.0-255,8215,49630,90,300904
19129,0.000209,172.31.47.0-255,66,49696,90,300904
19130,0.000225,74.125.24.0-255,2902,52598,90,300904
19131,0.000227,172.31.47.0-255,66,52664,90,300904
19132,0.000242,74.125.24.0-255,5738,58402,90,300904
19133,0.000244,172.31.47.0-255,66,58468,90,300904
19134,0.00026,74.125.24.0-255,7069,65537,90,300904
19135,0.000263,172.31.47.0-255,66,65603,90,300904
19136,0.000266,74.125.24.0-255,135,65738,90,300904
19137,0.000269,172.31.47.0-255,66,65804,90,300904
19138,0.0003,74.125.24.0-255,348,66152,90,300904
19139,0.000555,74.125.24.0-255,1484,67636,90,300904
19140,0.000559,172.31.47.0-255,66,67702,90,300904
19141,0.000565,74.125.24.0-255,2902,70604,90,300904
19142,0.000567,172.31.47.0-255,66,70670,90,300904
19143,0.000579,74.125.24.0-255,2902,73572,90,300904
19144,0.000582,172.31.47.0-255,66,73638,90,300904
19145,0.000593,74.125.24.0-255,2902,76540,90,300904
19146,0.000595,172.31.47.0-255,66,76606,90,300904
19147,0.000601,74.125.24.0-255,4320,80926,90,300904
19148,0.000602,172.31.47.0-255,66,80992,90,300904
19149,0.000623,74.125.24.0-255,8574,89566,90,300904
19150,0.000626,172.31.47.0-255,66,89632,90,300904
19151,0.000628,74.125.24.0-255,1484,91116,90,300904
19152,0.000666,74.125.24.0-255,9274,100390,90,300904
19153,0.000669,172.31.47.0-255,66,100456,90,300904
19154,0.000956,74.125.24.0-255,1484,101940,90,300904
19155,0.000963,74.125.24.0-255,2902,104842,90,300904
19156,0.000967,172.31.47.0-255,66,104908,90,300904
19157,0.00097,74.125.24.0-255,1484,106392,90,300904
19158,0.000985,74.125.24.0-255,4320,110712,90,300904
19159,0.000987,172.31.47.0-255,66,110778,90,300904
19160,0.00101,74.125.24.0-255,7156,117934,90,300904
19161,0.001014,172.31.47.0-255,66,118000,90,300904
19162,0.001037,74.125.24.0-255,5738,123738,90,300904
19163,0.00104,172.31.47.0-255,66,123804,90,300904
19164,0.001046,74.125.24.0-255,7156,130960,90,300904
19165,0.001048,172.31.47.0-255,66,131026,90,300904
19166,0.001066,74.125.24.0-255,3602,134628,90,300904
19167,0.001069,172.31.47.0-255,66,134694,90,300904
19168,0.001227,74.125.24.0-255,1484,136178,90,300904
19169,0.001234,74.125.24.0-255,2902,139080,90,300904
19170,0.001237,172.31.47.0-255,66,139146,90,300904
19171,0.001257,74.125.24.0-255,5738,144884,90,300904
19172,0.001259,172.31.47.0-255,66,144950,90,300904
19173,0.001264,74.125.24.0-255,4320,149270,90,300904
19174,0.001265,172.31.47.0-255,66,149336,90,300904
19175,0.001292,74.125.24.0-255,8574,157910,90,300904
19176,0.001294,172.31.47.0-255,66,157976,90,300904
19177,0.001297,74.125.24.0-255,1484,159460,90,300904
19178,0.001359,74.125.24.0-255,9274,168734,90,300904
19179,0.001362,172.31.47.0-255,66,168800,90,300904
19180,0.00137,74.125.24.0-255,9992,178792,90,300904
19181,0.001373,172.31.47.0-255,66,178858,90,300904
19182,0.001379,74.125.24.0-255,7156,186014,90,300904
19183,0.001381,172.31.47.0-255,66,186080,90,300904
19184,0.001421,172.31.47.0-255,66,186146,90,300904
19185,0.001425,74.125.24.0-255,2184,188330,90,300904
19186,0.001426,172.31.47.0-255,66,188396,90,300904
19187,0.001535,74.125.24.0-255,1484,189880,90,300904
19188,0.001541,74.125.24.0-255,2902,192782,90,300904
19189,0.001545,172.31.47.0-255,66,192848,90,300904
19190,0.001551,74.125.24.0-255,5738,198586,90,300904
19191,0.001553,172.31.47.0-255,66,198652,90,300904
19192,0.001589,74.125.24.0-255,8574,207226,90,300904
19193,0.001592,172.31.47.0-255,66,207292,90,300904
19194,0.001599,74.125.24.0-255,9992,217284,90,300904
19195,0.001602,172.31.47.0-255,66,217350,90,300904
19196,0.001626,74.125.24.0-255,5020,222370,90,300904
19197,0.001629,172.31.47.0-255,66,222436,90,300904
19198,0.001702,74.125.24.0-255,1484,223920,90,300904
19199,0.001717,74.125.24.0-255,2902,226822,90,300904
19200,0.00172,172.31.47.0-255,66,226888,90,300904
19201,0.001725,74.125.24.0-255,4320,231208,90,300904
19202,0.001728,172.31.47.0-255,66,231274,90,300904
19203,0.001741,74.125.24.0-255,1484,232758,90,300904
19204,0.001752,74.125.24.0-255,7156,239914,90,300904
19205,0.001754,172.31.47.0-255,66,239980,90,300904
19206,0.00177,74.125.24.0-255,5738,245718,90,300904
19207,0.001771,172.31.47.0-255,66,245784,90,300904
19208,0.001775,74.125.24.0-255,2902,248686,90,300904
19209,0.001776,172.31.47.0-255,66,248752,90,300904
19210,0.001803,74.125.24.0-255,7856,256608,90,300904
19211,0.001805,172.31.47.0-255,66,256674,90,300904
19212,0.001838,74.125.24.0-255,1484,258158,90,300904
19213,0.001842,74.125.24.0-255,2902,261060,90,300904
19214,0.00186,74.125.24.0-255,5738,266798,90,300904
19215,0.001863,74.125.24.0-255,1484,268282,90,300904
19216,0.001878,74.125.24.0-255,5738,274020,90,300904
19217,0.001898,74.125.24.0-255,2902,276922,90,300904
19218,0.001918,74.125.24.0-255,9992,286914,90,300904
19219,0.001927,74.125.24.0-255,1484,288398,90,300904
19220,0.00193,74.125.24.0-255,2184,290582,90,300904
19221,0.005324,172.31.47.0-255,66,290648,90,300904
19222,0.007272,74.125.24.0-255,4320,294968,90,300904
19223,0.007277,172.31.47.0-255,66,295034,90,300904
19224,0.007291,74.125.24.0-255,1484,296518,90,300904
19225,0.009206,74.125.24.0-255,4320,300838,90,300904
19226,0.009211,172.31.47.0-255,66,300904,90,300904
19227,0.0,172.217.194.0-255,153,153,90,306664
19228,2.4e-05,172.31.47.0-255,66,219,90,306664
19229,3.1e-05,172.217.194.0-255,1484,1703,90,306664
19230,3.6e-05,172.31.47.0-255,66,1769,90,306664
19231,4.2e-05,172.217.194.0-255,2902,4671,90,306664
19232,5.4e-05,172.31.47.0-255,66,4737,90,306664
19233,6.2e-05,172.217.194.0-255,7156,11893,90,306664
19234,6.4e-05,172.31.47.0-255,66,11959,90,306664
19235,7.2e-05,172.217.194.0-255,7156,19115,90,306664
19236,7.5e-05,172.31.47.0-255,66,19181,90,306664
19237,9.9e-05,172.217.194.0-255,6388,25569,90,306664
19238,0.000102,172.31.47.0-255,66,25635,90,306664
19239,0.000128,172.217.194.0-255,2902,28537,90,306664
19240,0.00013,172.31.47.0-255,66,28603,90,306664
19241,0.000156,172.217.194.0-255,2543,31146,90,306664
19242,0.000159,172.31.47.0-255,66,31212,90,306664
19243,0.000163,172.217.194.0-255,1484,32696,90,306664
19244,0.000165,172.31.47.0-255,66,32762,90,306664
19245,0.000169,172.217.194.0-255,1484,34246,90,306664
19246,0.000171,172.31.47.0-255,66,34312,90,306664
19247,0.0002,172.217.194.0-255,1484,35796,90,306664
19248,0.000203,172.31.47.0-255,66,35862,90,306664
19249,0.00021,172.217.194.0-255,5738,41600,90,306664
19250,0.000212,172.31.47.0-255,66,41666,90,306664
19251,0.000225,172.31.47.0-255,66,41732,90,306664
19252,0.000255,172.217.194.0-255,2543,44275,90,306664
19253,0.000257,172.31.47.0-255,66,44341,90,306664
19254,0.00026,172.217.194.0-255,1484,45825,90,306664
19255,0.000262,172.31.47.0-255,66,45891,90,306664
19256,0.00029,172.217.194.0-255,8540,54431,90,306664
19257,0.000294,172.31.47.0-255,66,54497,90,306664
19258,0.000317,172.217.194.0-255,1484,55981,90,306664
19259,0.000338,172.217.194.0-255,2902,58883,90,306664
19260,0.00034,172.31.47.0-255,66,58949,90,306664
19261,0.000346,172.217.194.0-255,4320,63269,90,306664
19262,0.000349,172.31.47.0-255,66,63335,90,306664
19263,0.000366,172.217.194.0-255,1484,64819,90,306664
19264,0.000374,172.217.194.0-255,7156,71975,90,306664
19265,0.000377,172.31.47.0-255,66,72041,90,306664
19266,0.00041,172.217.194.0-255,6797,78838,90,306664
19267,0.000413,172.31.47.0-255,66,78904,90,306664
19268,0.000419,172.217.194.0-255,4320,83224,90,306664
19269,0.000421,172.31.47.0-255,66,83290,90,306664
19270,0.000452,172.217.194.0-255,5094,88384,90,306664
19271,0.000454,172.31.47.0-255,66,88450,90,306664
19272,0.000465,172.217.194.0-255,9992,98442,90,306664
19273,0.000467,172.31.47.0-255,66,98508,90,306664
19274,0.000474,172.217.194.0-255,5738,104246,90,306664
19275,0.000478,172.31.47.0-255,66,104312,90,306664
19276,0.000494,172.217.194.0-255,8215,112527,90,306664
19277,0.000496,172.31.47.0-255,66,112593,90,306664
19278,0.000556,172.217.194.0-255,9633,122226,90,306664
19279,0.000559,172.31.47.0-255,66,122292,90,306664
19280,0.000624,172.217.194.0-255,1484,123776,90,306664
19281,0.000629,172.217.194.0-255,2902,126678,90,306664
19282,0.000632,172.31.47.0-255,66,126744,90,306664
19283,0.000655,172.217.194.0-255,5738,132482,90,306664
19284,0.000658,172.31.47.0-255,66,132548,90,306664
19285,0.000664,172.217.194.0-255,4320,136868,90,306664
19286,0.000667,172.31.47.0-255,66,136934,90,306664
19287,0.000709,172.217.194.0-255,8574,145508,90,306664
19288,0.000712,172.31.47.0-255,66,145574,90,306664
19289,0.000721,172.217.194.0-255,8574,154148,90,306664
19290,0.000723,172.31.47.0-255,66,154214,90,306664
19291,0.000748,172.217.194.0-255,10692,164906,90,306664
19292,0.000751,172.31.47.0-255,66,164972,90,306664
19293,0.000757,172.217.194.0-255,4320,169292,90,306664
19294,0.000759,172.31.47.0-255,66,169358,90,306664
19295,0.000784,172.217.194.0-255,7156,176514,90,306664
19296,0.000795,172.31.47.0-255,66,176580,90,306664
19297,0.000809,172.31.47.0-255,66,176646,90,306664
19298,0.00082,172.217.194.0-255,2184,178830,90,306664
19299,0.000822,172.31.47.0-255,66,178896,90,306664
19300,0.000847,172.217.194.0-255,1484,180380,90,306664
19301,0.000852,172.217.194.0-255,2902,183282,90,306664
19302,0.000854,172.31.47.0-255,66,183348,90,306664
19303,0.000861,172.217.194.0-255,5738,189086,90,306664
19304,0.000863,172.31.47.0-255,66,189152,90,306664
19305,0.000935,172.31.47.0-255,66,189218,90,306664
19306,0.000944,172.217.194.0-255,8574,197792,90,306664
19307,0.000946,172.31.47.0-255,66,197858,90,306664
19308,0.00095,172.217.194.0-255,2184,200042,90,306664
19309,0.000952,172.31.47.0-255,66,200108,90,306664
19310,0.001081,172.217.194.0-255,1484,201592,90,306664
19311,0.001088,172.217.194.0-255,2902,204494,90,306664
19312,0.001091,172.31.47.0-255,66,204560,90,306664
19313,0.001098,172.217.194.0-255,5738,210298,90,306664
19314,0.0011,172.31.47.0-255,66,210364,90,306664
19315,0.001145,172.31.47.0-255,66,210430,90,306664
19316,0.001161,172.217.194.0-255,10692,221122,90,306664
19317,0.001164,172.31.47.0-255,66,221188,90,306664
19318,0.001198,172.217.194.0-255,9992,231180,90,306664
19319,0.001201,172.31.47.0-255,66,231246,90,306664
19320,0.001226,172.217.194.0-255,1484,232730,90,306664
19321,0.001229,172.217.194.0-255,1484,234214,90,306664
19322,0.001231,172.31.47.0-255,66,234280,90,306664
19323,0.001247,172.31.47.0-255,66,234346,90,306664
19324,0.001253,172.217.194.0-255,4320,238666,90,306664
19325,0.001256,172.31.47.0-255,66,238732,90,306664
19326,0.001282,172.217.194.0-255,2184,240916,90,306664
19327,0.001285,172.31.47.0-255,66,240982,90,306664
19328,0.001289,172.217.194.0-255,1484,242466,90,306664
19329,0.001315,172.217.194.0-255,4320,246786,90,306664
19330,0.001318,172.31.47.0-255,66,246852,90,306664
19331,0.001325,172.217.194.0-255,7156,254008,90,306664
19332,0.001327,172.31.47.0-255,66,254074,90,306664
19333,0.001332,172.217.194.0-255,2902,256976,90,306664
19334,0.001334,172.31.47.0-255,66,257042,90,306664
19335,0.001371,172.31.47.0-255,66,257108,90,306664
19336,0.001378,172.217.194.0-255,6438,263546,90,306664
19337,0.00138,172.31.47.0-255,66,263612,90,306664
19338,0.001412,172.217.194.0-255,7156,270768,90,306664
19339,0.001415,172.31.47.0-255,66,270834,90,306664
19340,0.00145,172.217.194.0-255,7156,277990,90,306664
19341,0.001453,172.31.47.0-255,66,278056,90,306664
19342,0.001473,172.31.47.0-255,66,278122,90,306664
19343,0.001479,172.217.194.0-255,3602,281724,90,306664
19344,0.001481,172.31.47.0-255,66,281790,90,306664
19345,0.001515,172.31.47.0-255,66,281856,90,306664
19346,0.001551,172.217.194.0-255,9992,291848,90,306664
19347,0.001555,172.31.47.0-255,66,291914,90,306664
19348,0.001601,172.217.194.0-255,9992,301906,90,306664
19349,0.001603,172.31.47.0-255,66,301972,90,306664
19350,0.001634,172.217.194.0-255,2184,304156,90,306664
19351,0.001637,172.31.47.0-255,66,304222,90,306664
19352,0.001641,172.217.194.0-255,2034,306256,90,306664
19353,0.001643,172.31.47.0-255,66,306322,90,306664
19354,0.001646,172.217.194.0-255,105,306427,90,306664
19355,0.004622,172.31.47.0-255,66,306493,90,306664
19356,0.004661,172.31.47.0-255,105,306598,90,306664
19357,0.00691,172.217.194.0-255,66,306664,90,306664
19358,0.0,172.31.47.0-255,105,105,90,276
19359,0.002061,157.240.13.0-255,105,210,90,276
19360,0.00207,172.31.47.0-255,66,276,90,276
19361,0.0,74.125.68.0-255,291,291,90,106271
19362,3.2e-05,172.31.47.0-255,66,357,90,106271
19363,3.9e-05,74.125.68.0-255,1484,1841,90,106271
19364,4.4e-05,172.31.47.0-255,66,1907,90,106271
19365,7.1e-05,74.125.68.0-255,2902,4809,90,106271
19366,7.4e-05,172.31.47.0-255,66,4875,90,106271
19367,7.9e-05,74.125.68.0-255,2902,7777,90,106271
19368,8.1e-05,172.31.47.0-255,66,7843,90,106271
19369,0.000114,74.125.68.0-255,1484,9327,90,106271
19370,0.000117,172.31.47.0-255,66,9393,90,106271
19371,0.00013,74.125.68.0-255,2902,12295,90,106271
19372,0.000133,172.31.47.0-255,66,12361,90,106271
19373,0.000147,74.125.68.0-255,4320,16681,90,106271
19374,0.000151,172.31.47.0-255,66,16747,90,106271
19375,0.000168,74.125.68.0-255,1805,18552,90,106271
19376,0.000171,172.31.47.0-255,66,18618,90,106271
19377,0.000216,74.125.68.0-255,2902,21520,90,106271
19378,0.000219,172.31.47.0-255,66,21586,90,106271
19379,0.000241,74.125.68.0-255,1484,23070,90,106271
19380,0.000244,172.31.47.0-255,66,23136,90,106271
19381,0.000264,74.125.68.0-255,2902,26038,90,106271
19382,0.000267,172.31.47.0-255,66,26104,90,106271
19383,0.000304,74.125.68.0-255,5379,31483,90,106271
19384,0.000307,172.31.47.0-255,66,31549,90,106271
19385,0.000371,74.125.68.0-255,1484,33033,90,106271
19386,0.000376,172.31.47.0-255,66,33099,90,106271
19387,0.000381,74.125.68.0-255,2902,36001,90,106271
19388,0.000386,172.31.47.0-255,66,36067,90,106271
19389,0.000413,74.125.68.0-255,4320,40387,90,106271
19390,0.000416,172.31.47.0-255,66,40453,90,106271
19391,0.00043,74.125.68.0-255,1484,41937,90,106271
19392,0.000433,172.31.47.0-255,66,42003,90,106271
19393,0.000474,74.125.68.0-255,4320,46323,90,106271
19394,0.000481,172.31.47.0-255,66,46389,90,106271
19395,0.000498,74.125.68.0-255,5738,52127,90,106271
19396,0.000511,172.31.47.0-255,66,52193,90,106271
19397,0.000588,74.125.68.0-255,2902,55095,90,106271
19398,0.000592,172.31.47.0-255,66,55161,90,106271
19399,0.00062,74.125.68.0-255,8574,63735,90,106271
19400,0.000629,172.31.47.0-255,66,63801,90,106271
19401,0.000714,74.125.68.0-255,2518,66319,90,106271
19402,0.000719,172.31.47.0-255,66,66385,90,106271
19403,0.001011,74.125.68.0-255,108,66493,90,106271
19404,0.001173,74.125.68.0-255,1484,67977,90,106271
19405,0.001178,172.31.47.0-255,66,68043,90,106271
19406,0.001211,74.125.68.0-255,2902,70945,90,106271
19407,0.00124,74.125.68.0-255,5738,76683,90,106271
19408,0.00129,74.125.68.0-255,4320,81003,90,106271
19409,0.001307,74.125.68.0-255,2902,83905,90,106271
19410,0.001371,74.125.68.0-255,8574,92479,90,106271
19411,0.001393,74.125.68.0-255,5738,98217,90,106271
19412,0.001517,74.125.68.0-255,2184,100401,90,106271
19413,0.007447,172.31.47.0-255,66,100467,90,106271
19414,0.009498,74.125.68.0-255,5738,106205,90,106271
19415,0.009506,172.31.47.0-255,66,106271,90,106271
19416,0.0,172.217.194.0-255,291,291,90,265407
19417,2.6e-05,172.31.47.0-255,66,357,90,265407
19418,3.2e-05,172.217.194.0-255,1484,1841,90,265407
19419,3.6e-05,172.31.47.0-255,66,1907,90,265407
19420,4e-05,172.217.194.0-255,4320,6227,90,265407
19421,4.3e-05,172.31.47.0-255,66,6293,90,265407
19422,8.5e-05,172.217.194.0-255,7156,13449,90,265407
19423,8.8e-05,172.31.47.0-255,66,13515,90,265407
19424,0.000106,172.217.194.0-255,360,13875,90,265407
19425,0.000108,172.31.47.0-255,66,13941,90,265407
19426,0.000135,172.217.194.0-255,1484,15425,90,265407
19427,0.000137,172.31.47.0-255,66,15491,90,265407
19428,0.000141,172.217.194.0-255,2902,18393,90,265407
19429,0.000144,172.31.47.0-255,66,18459,90,265407
19430,0.000166,172.217.194.0-255,5738,24197,90,265407
19431,0.000171,172.31.47.0-255,66,24263,90,265407
19432,0.000184,172.217.194.0-255,1484,25747,90,265407
19433,0.000186,172.31.47.0-255,66,25813,90,265407
19434,0.000229,172.31.47.0-255,66,25879,90,265407
19435,0.000241,172.31.47.0-255,66,25945,90,265407
19436,0.000255,172.31.47.0-255,66,26011,90,265407
19437,0.000373,172.217.194.0-255,98,26109,90,265407
19438,0.000377,172.31.47.0-255,66,26175,90,265407
19439,0.000529,172.217.194.0-255,1484,27659,90,265407
19440,0.000534,172.31.47.0-255,66,27725,90,265407
19441,0.000548,172.217.194.0-255,2902,30627,90,265407
19442,0.000553,172.31.47.0-255,66,30693,90,265407
19443,0.000577,172.217.194.0-255,5738,36431,90,265407
19444,0.00058,172.31.47.0-255,66,36497,90,265407
19445,0.000587,172.217.194.0-255,5738,42235,90,265407
19446,0.000589,172.31.47.0-255,66,42301,90,265407
19447,0.000607,172.217.194.0-255,7156,49457,90,265407
19448,0.00061,172.31.47.0-255,66,49523,90,265407
19449,0.000619,172.217.194.0-255,10692,60215,90,265407
19450,0.000622,172.31.47.0-255,66,60281,90,265407
19451,0.001306,172.217.194.0-255,1484,61765,90,265407
19452,0.001314,172.217.194.0-255,2902,64667,90,265407
19453,0.001318,172.31.47.0-255,66,64733,90,265407
19454,0.001326,172.217.194.0-255,5738,70471,90,265407
19455,0.001327,172.31.47.0-255,66,70537,90,265407
19456,0.001345,172.217.194.0-255,7156,77693,90,265407
19457,0.001347,172.31.47.0-255,66,77759,90,265407
19458,0.00137,172.217.194.0-255,5738,83497,90,265407
19459,0.001372,172.31.47.0-255,66,83563,90,265407
19460,0.00138,172.217.194.0-255,9992,93555,90,265407
19461,0.001382,172.31.47.0-255,66,93621,90,265407
19462,0.001398,172.217.194.0-255,766,94387,90,265407
19463,0.001409,172.217.194.0-255,1484,95871,90,265407
19464,0.00141,172.31.47.0-255,66,95937,90,265407
19465,0.00143,172.217.194.0-255,4320,100257,90,265407
19466,0.001432,172.31.47.0-255,66,100323,90,265407
19467,0.001435,172.217.194.0-255,1484,101807,90,265407
19468,0.001458,172.217.194.0-255,8574,110381,90,265407
19469,0.001461,172.31.47.0-255,66,110447,90,265407
19470,0.001468,172.217.194.0-255,9992,120439,90,265407
19471,0.00147,172.31.47.0-255,66,120505,90,265407
19472,0.001483,172.217.194.0-255,5738,126243,90,265407
19473,0.001485,172.31.47.0-255,66,126309,90,265407
19474,0.0015,172.217.194.0-255,1484,127793,90,265407
19475,0.00151,172.217.194.0-255,766,128559,90,265407
19476,0.001512,172.31.47.0-255,66,128625,90,265407
19477,0.001664,172.217.194.0-255,1484,130109,90,265407
19478,0.001669,172.217.194.0-255,2902,133011,90,265407
19479,0.001672,172.31.47.0-255,66,133077,90,265407
19480,0.00171,172.217.194.0-255,4320,137397,90,265407
19481,0.001714,172.31.47.0-255,66,137463,90,265407
19482,0.001737,172.217.194.0-255,1484,138947,90,265407
19483,0.001751,172.31.47.0-255,66,139013,90,265407
19484,0.001758,172.217.194.0-255,9992,149005,90,265407
19485,0.00176,172.31.47.0-255,66,149071,90,265407
19486,0.001794,172.217.194.0-255,7856,156927,90,265407
19487,0.001797,172.31.47.0-255,66,156993,90,265407
19488,0.001805,172.217.194.0-255,8574,165567,90,265407
19489,0.001808,172.31.47.0-255,66,165633,90,265407
19490,0.001818,172.217.194.0-255,8574,174207,90,265407
19491,0.001819,172.31.47.0-255,66,174273,90,265407
19492,0.001842,172.217.194.0-255,9274,183547,90,265407
19493,0.001845,172.31.47.0-255,66,183613,90,265407
19494,0.001957,172.217.194.0-255,1484,185097,90,265407
19495,0.001969,172.217.194.0-255,2902,187999,90,265407
19496,0.001971,172.31.47.0-255,66,188065,90,265407
19497,0.001988,172.217.194.0-255,4320,192385,90,265407
19498,0.00199,172.31.47.0-255,66,192451,90,265407
19499,0.002003,172.217.194.0-255,1484,193935,90,265407
19500,0.002011,172.217.194.0-255,1484,195419,90,265407
19501,0.002013,172.31.47.0-255,66,195485,90,265407
19502,0.002044,172.31.47.0-255,66,195551,90,265407
19503,0.002051,172.217.194.0-255,9992,205543,90,265407
19504,0.002053,172.31.47.0-255,66,205609,90,265407
19505,0.002055,172.217.194.0-255,766,206375,90,265407
19506,0.002125,172.217.194.0-255,1484,207859,90,265407
19507,0.002129,172.31.47.0-255,66,207925,90,265407
19508,0.002134,172.217.194.0-255,2902,210827,90,265407
19509,0.002136,172.31.47.0-255,66,210893,90,265407
19510,0.002141,172.217.194.0-255,5738,216631,90,265407
19511,0.002143,172.31.47.0-255,66,216697,90,265407
19512,0.002165,172.217.194.0-255,5738,222435,90,265407
19513,0.002167,172.31.47.0-255,66,222501,90,265407
19514,0.002186,172.217.194.0-255,7156,229657,90,265407
19515,0.002188,172.31.47.0-255,66,229723,90,265407
19516,0.002193,172.217.194.0-255,4320,234043,90,265407
19517,0.002195,172.31.47.0-255,66,234109,90,265407
19518,0.002214,172.217.194.0-255,5738,239847,90,265407
19519,0.002217,172.31.47.0-255,66,239913,90,265407
19520,0.002233,172.217.194.0-255,766,240679,90,265407
19521,0.002237,172.217.194.0-255,2902,243581,90,265407
19522,0.002239,172.31.47.0-255,66,243647,90,265407
19523,0.002271,172.31.47.0-255,66,243713,90,265407
19524,0.002274,172.217.194.0-255,1484,245197,90,265407
19525,0.002303,172.31.47.0-255,66,245263,90,265407
19526,0.002331,172.217.194.0-255,2184,247447,90,265407
19527,0.002334,172.31.47.0-255,66,247513,90,265407
19528,0.002348,172.31.47.0-255,66,247579,90,265407
19529,0.002382,172.217.194.0-255,4320,251899,90,265407
19530,0.002385,172.31.47.0-255,66,251965,90,265407
19531,0.002408,172.31.47.0-255,66,252031,90,265407
19532,0.002419,172.31.47.0-255,66,252097,90,265407
19533,0.002436,172.217.194.0-255,10692,262789,90,265407
19534,0.002439,172.31.47.0-255,66,262855,90,265407
19535,0.002443,172.217.194.0-255,2144,264999,90,265407
19536,0.002444,172.31.47.0-255,66,265065,90,265407
19537,0.002488,172.217.194.0-255,105,265170,90,265407
19538,0.004707,172.31.47.0-255,66,265236,90,265407
19539,0.00473,172.31.47.0-255,105,265341,90,265407
19540,0.007286,172.217.194.0-255,66,265407,90,265407
19541,0.0,172.253.118.0-255,153,153,90,304130
19542,1.9e-05,172.31.47.0-255,66,219,90,304130
19543,2.6e-05,172.253.118.0-255,1484,1703,90,304130
19544,3e-05,172.31.47.0-255,66,1769,90,304130
19545,3.4e-05,172.253.118.0-255,2902,4671,90,304130
19546,3.7e-05,172.31.47.0-255,66,4737,90,304130
19547,5.1e-05,172.253.118.0-255,7156,11893,90,304130
19548,5.4e-05,172.31.47.0-255,66,11959,90,304130
19549,7.9e-05,172.253.118.0-255,2101,14060,90,304130
19550,8.3e-05,172.31.47.0-255,66,14126,90,304130
19551,0.000127,172.253.118.0-255,1484,15610,90,304130
19552,0.000131,172.31.47.0-255,66,15676,90,304130
19553,0.000161,172.253.118.0-255,2902,18578,90,304130
19554,0.000165,172.31.47.0-255,66,18644,90,304130
19555,0.00017,172.253.118.0-255,5738,24382,90,304130
19556,0.000172,172.31.47.0-255,66,24448,90,304130
19557,0.000176,172.253.118.0-255,4320,28768,90,304130
19558,0.000183,172.31.47.0-255,66,28834,90,304130
19559,0.000211,172.253.118.0-255,2543,31377,90,304130
19560,0.000214,172.31.47.0-255,66,31443,90,304130
19561,0.000347,172.253.118.0-255,1484,32927,90,304130
19562,0.000353,172.31.47.0-255,66,32993,90,304130
19563,0.000358,172.253.118.0-255,2902,35895,90,304130
19564,0.00036,172.31.47.0-255,66,35961,90,304130
19565,0.000363,172.253.118.0-255,1484,37445,90,304130
19566,0.000364,172.31.47.0-255,66,37511,90,304130
19567,0.0004,172.253.118.0-255,4320,41831,90,304130
19568,0.000404,172.31.47.0-255,66,41897,90,304130
19569,0.000409,172.253.118.0-255,4320,46217,90,304130
19570,0.00041,172.31.47.0-255,66,46283,90,304130
19571,0.000425,172.31.47.0-255,66,46349,90,304130
19572,0.00043,172.253.118.0-255,4320,50669,90,304130
19573,0.000433,172.31.47.0-255,66,50735,90,304130
19574,0.000461,172.253.118.0-255,2543,53278,90,304130
19575,0.000465,172.31.47.0-255,66,53344,90,304130
19576,0.000467,172.253.118.0-255,395,53739,90,304130
19577,0.000519,172.253.118.0-255,347,54086,90,304130
19578,0.000666,172.253.118.0-255,1484,55570,90,304130
19579,0.000671,172.31.47.0-255,66,55636,90,304130
19580,0.000676,172.253.118.0-255,2902,58538,90,304130
19581,0.000678,172.31.47.0-255,66,58604,90,304130
19582,0.000682,172.253.118.0-255,2902,61506,90,304130
19583,0.000683,172.31.47.0-255,66,61572,90,304130
19584,0.000715,172.253.118.0-255,2902,64474,90,304130
19585,0.000719,172.31.47.0-255,66,64540,90,304130
19586,0.000728,172.253.118.0-255,9992,74532,90,304130
19587,0.00073,172.31.47.0-255,66,74598,90,304130
19588,0.000767,172.253.118.0-255,2902,77500,90,304130
19589,0.00077,172.31.47.0-255,66,77566,90,304130
19590,0.000777,172.253.118.0-255,9992,87558,90,304130
19591,0.000779,172.31.47.0-255,66,87624,90,304130
19592,0.000785,172.253.118.0-255,218,87842,90,304130
19593,0.000874,172.253.118.0-255,1484,89326,90,304130
19594,0.000878,172.31.47.0-255,66,89392,90,304130
19595,0.000905,172.253.118.0-255,2902,92294,90,304130
19596,0.000908,172.31.47.0-255,66,92360,90,304130
19597,0.000912,172.253.118.0-255,2902,95262,90,304130
19598,0.000913,172.31.47.0-255,66,95328,90,304130
19599,0.000937,172.253.118.0-255,2902,98230,90,304130
19600,0.000941,172.31.47.0-255,66,98296,90,304130
19601,0.00095,172.253.118.0-255,6797,105093,90,304130
19602,0.000952,172.31.47.0-255,66,105159,90,304130
19603,0.001528,172.253.118.0-255,1484,106643,90,304130
19604,0.001535,172.253.118.0-255,1484,108127,90,304130
19605,0.001538,172.31.47.0-255,66,108193,90,304130
19606,0.001562,172.253.118.0-255,1484,109677,90,304130
19607,0.001568,172.253.118.0-255,5738,115415,90,304130
19608,0.00157,172.31.47.0-255,66,115481,90,304130
19609,0.001607,172.253.118.0-255,5738,121219,90,304130
19610,0.00161,172.31.47.0-255,66,121285,90,304130
19611,0.001636,172.253.118.0-255,5738,127023,90,304130
19612,0.001638,172.31.47.0-255,66,127089,90,304130
19613,0.001668,172.253.118.0-255,5738,132827,90,304130
19614,0.001669,172.31.47.0-255,66,132893,90,304130
19615,0.001693,172.253.118.0-255,6438,139331,90,304130
19616,0.001695,172.31.47.0-255,66,139397,90,304130
19617,0.00185,172.253.118.0-255,1484,140881,90,304130
19618,0.001855,172.253.118.0-255,2902,143783,90,304130
19619,0.001857,172.31.47.0-255,66,143849,90,304130
19620,0.001882,172.253.118.0-255,5738,149587,90,304130
19621,0.001884,172.31.47.0-255,66,149653,90,304130
19622,0.001925,172.31.47.0-255,66,149719,90,304130
19623,0.001932,172.253.118.0-255,9992,159711,90,304130
19624,0.001934,172.31.47.0-255,66,159777,90,304130
19625,0.001953,172.253.118.0-255,766,160543,90,304130
19626,0.00205,172.253.118.0-255,1484,162027,90,304130
19627,0.002054,172.31.47.0-255,66,162093,90,304130
19628,0.002059,172.253.118.0-255,2902,164995,90,304130
19629,0.002061,172.31.47.0-255,66,165061,90,304130
19630,0.002093,172.253.118.0-255,5738,170799,90,304130
19631,0.002096,172.31.47.0-255,66,170865,90,304130
19632,0.002129,172.31.47.0-255,66,170931,90,304130
19633,0.002155,172.253.118.0-255,1484,172415,90,304130
19634,0.00216,172.253.118.0-255,4320,176735,90,304130
19635,0.002162,172.31.47.0-255,66,176801,90,304130
19636,0.002188,172.253.118.0-255,2902,179703,90,304130
19637,0.00219,172.31.47.0-255,66,179769,90,304130
19638,0.002208,172.253.118.0-255,3602,183371,90,304130
19639,0.00221,172.31.47.0-255,66,183437,90,304130
19640,0.002299,172.253.118.0-255,1484,184921,90,304130
19641,0.002317,172.253.118.0-255,2902,187823,90,304130
19642,0.002321,172.31.47.0-255,66,187889,90,304130
19643,0.002324,172.253.118.0-255,1484,189373,90,304130
19644,0.002346,172.253.118.0-255,4320,193693,90,304130
19645,0.00235,172.31.47.0-255,66,193759,90,304130
19646,0.002373,172.253.118.0-255,2902,196661,90,304130
19647,0.002375,172.31.47.0-255,66,196727,90,304130
19648,0.002408,172.253.118.0-255,8574,205301,90,304130
19649,0.00241,172.31.47.0-255,66,205367,90,304130
19650,0.002413,172.253.118.0-255,1484,206851,90,304130
19651,0.002416,172.253.118.0-255,1484,208335,90,304130
19652,0.002418,172.31.47.0-255,66,208401,90,304130
19653,0.002443,172.253.118.0-255,4320,212721,90,304130
19654,0.002446,172.31.47.0-255,66,212787,90,304130
19655,0.002489,172.253.118.0-255,5020,217807,90,304130
19656,0.002492,172.31.47.0-255,66,217873,90,304130
19657,0.002623,172.253.118.0-255,1484,219357,90,304130
19658,0.002645,172.253.118.0-255,2902,222259,90,304130
19659,0.002649,172.31.47.0-255,66,222325,90,304130
19660,0.002655,172.253.118.0-255,4320,226645,90,304130
19661,0.002657,172.31.47.0-255,66,226711,90,304130
19662,0.002682,172.253.118.0-255,1484,228195,90,304130
19663,0.00269,172.253.118.0-255,1484,229679,90,304130
19664,0.002693,172.31.47.0-255,66,229745,90,304130
19665,0.002697,172.253.118.0-255,1484,231229,90,304130
19666,0.002699,172.253.118.0-255,1484,232713,90,304130
19667,0.002701,172.31.47.0-255,66,232779,90,304130
19668,0.002704,172.253.118.0-255,1484,234263,90,304130
19669,0.002742,172.253.118.0-255,5738,240001,90,304130
19670,0.002746,172.31.47.0-255,66,240067,90,304130
19671,0.002752,172.253.118.0-255,5738,245805,90,304130
19672,0.002755,172.31.47.0-255,66,245871,90,304130
19673,0.002803,172.253.118.0-255,1484,247355,90,304130
19674,0.002823,172.253.118.0-255,5020,252375,90,304130
19675,0.002827,172.31.47.0-255,66,252441,90,304130
19676,0.002902,172.253.118.0-255,1484,253925,90,304130
19677,0.002908,172.253.118.0-255,2902,256827,90,304130
19678,0.00291,172.31.47.0-255,66,256893,90,304130
19679,0.00294,172.253.118.0-255,1484,258377,90,304130
19680,0.002944,172.253.118.0-255,2902,261279,90,304130
19681,0.002947,172.31.47.0-255,66,261345,90,304130
19682,0.002964,172.253.118.0-255,4320,265665,90,304130
19683,0.002966,172.31.47.0-255,66,265731,90,304130
19684,0.002972,172.253.118.0-255,5738,271469,90,304130
19685,0.002974,172.31.47.0-255,66,271535,90,304130
19686,0.002976,172.253.118.0-255,1484,273019,90,304130
19687,0.003029,172.31.47.0-255,66,273085,90,304130
19688,0.003043,172.31.47.0-255,66,273151,90,304130
19689,0.003055,172.253.118.0-255,9992,283143,90,304130
19690,0.003057,172.31.47.0-255,66,283209,90,304130
19691,0.003061,172.253.118.0-255,2902,286111,90,304130
19692,0.003063,172.31.47.0-255,66,286177,90,304130
19693,0.003107,172.253.118.0-255,1484,287661,90,304130
19694,0.00311,172.31.47.0-255,78,287739,90,304130
19695,0.003128,172.31.47.0-255,66,287805,90,304130
19696,0.003141,172.31.47.0-255,66,287871,90,304130
19697,0.003168,172.253.118.0-255,5738,293609,90,304130
19698,0.003175,172.31.47.0-255,66,293675,90,304130
19699,0.003181,172.253.118.0-255,5020,298695,90,304130
19700,0.003183,172.31.47.0-255,66,298761,90,304130
19701,0.003197,172.31.47.0-255,66,298827,90,304130
19702,0.003203,172.253.118.0-255,4895,303722,90,304130
19703,0.003205,172.31.47.0-255,66,303788,90,304130
19704,0.003242,172.253.118.0-255,105,303893,90,304130
19705,0.00437,172.31.47.0-255,66,303959,90,304130
19706,0.004399,172.31.47.0-255,105,304064,90,304130
19707,0.006651,172.253.118.0-255,66,304130,90,304130
19708,0.0,74.125.130.0-255,152,152,90,244413
19709,2.5e-05,172.31.47.0-255,66,218,90,244413
19710,3.1e-05,74.125.130.0-255,1484,1702,90,244413
19711,3.5e-05,172.31.47.0-255,66,1768,90,244413
19712,6.8e-05,74.125.130.0-255,2902,4670,90,244413
19713,7.2e-05,172.31.47.0-255,66,4736,90,244413
19714,7.5e-05,74.125.130.0-255,1484,6220,90,244413
19715,7.7e-05,172.31.47.0-255,66,6286,90,244413
19716,0.000115,74.125.130.0-255,2902,9188,90,244413
19717,0.000118,172.31.47.0-255,66,9254,90,244413
19718,0.000142,74.125.130.0-255,4899,14153,90,244413
19719,0.000144,172.31.47.0-255,66,14219,90,244413
19720,0.000174,74.125.130.0-255,1484,15703,90,244413
19721,0.000177,172.31.47.0-255,66,15769,90,244413
19722,0.000204,74.125.130.0-255,2902,18671,90,244413
19723,0.000206,172.31.47.0-255,66,18737,90,244413
19724,0.000226,74.125.130.0-255,1484,20221,90,244413
19725,0.000229,172.31.47.0-255,66,20287,90,244413
19726,0.000233,74.125.130.0-255,2902,23189,90,244413
19727,0.000235,172.31.47.0-255,66,23255,90,244413
19728,0.000271,74.125.130.0-255,5738,28993,90,244413
19729,0.000274,172.31.47.0-255,66,29059,90,244413
19730,0.000278,74.125.130.0-255,2543,31602,90,244413
19731,0.000281,172.31.47.0-255,66,31668,90,244413
19732,0.000414,74.125.130.0-255,1484,33152,90,244413
19733,0.000417,172.31.47.0-255,66,33218,90,244413
19734,0.00042,74.125.130.0-255,1484,34702,90,244413
19735,0.000422,172.31.47.0-255,66,34768,90,244413
19736,0.000454,74.125.130.0-255,2902,37670,90,244413
19737,0.000457,172.31.47.0-255,66,37736,90,244413
19738,0.000463,74.125.130.0-255,5738,43474,90,244413
19739,0.000465,172.31.47.0-255,66,43540,90,244413
19740,0.0005,74.125.130.0-255,6797,50337,90,244413
19741,0.000503,172.31.47.0-255,66,50403,90,244413
19742,0.00051,74.125.130.0-255,7156,57559,90,244413
19743,0.000512,172.31.47.0-255,66,57625,90,244413
19744,0.000549,74.125.130.0-255,8505,66130,90,244413
19745,0.000552,172.31.47.0-255,66,66196,90,244413
19746,0.000571,74.125.130.0-255,365,66561,90,244413
19747,0.000694,74.125.130.0-255,1484,68045,90,244413
19748,0.000697,172.31.47.0-255,66,68111,90,244413
19749,0.000713,74.125.130.0-255,2902,71013,90,244413
19750,0.000715,172.31.47.0-255,66,71079,90,244413
19751,0.000726,74.125.130.0-255,5738,76817,90,244413
19752,0.000728,172.31.47.0-255,66,76883,90,244413
19753,0.000732,74.125.130.0-255,2902,79785,90,244413
19754,0.000734,172.31.47.0-255,66,79851,90,244413
19755,0.00076,74.125.130.0-255,1484,81335,90,244413
19756,0.000767,74.125.130.0-255,5738,87073,90,244413
19757,0.000769,172.31.47.0-255,66,87139,90,244413
19758,0.000798,74.125.130.0-255,9992,97131,90,244413
19759,0.0008,172.31.47.0-255,66,97197,90,244413
19760,0.000835,74.125.130.0-255,3602,100799,90,244413
19761,0.000838,172.31.47.0-255,66,100865,90,244413
19762,0.000915,74.125.130.0-255,1484,102349,90,244413
19763,0.000932,74.125.130.0-255,2902,105251,90,244413
19764,0.000935,172.31.47.0-255,66,105317,90,244413
19765,0.000961,74.125.130.0-255,4320,109637,90,244413
19766,0.000964,172.31.47.0-255,66,109703,90,244413
19767,0.000967,74.125.130.0-255,1484,111187,90,244413
19768,0.000993,74.125.130.0-255,7156,118343,90,244413
19769,0.000997,172.31.47.0-255,66,118409,90,244413
19770,0.001,74.125.130.0-255,7156,125565,90,244413
19771,0.001002,172.31.47.0-255,66,125631,90,244413
19772,0.001019,74.125.130.0-255,5738,131369,90,244413
19773,0.001022,172.31.47.0-255,66,131435,90,244413
19774,0.001045,74.125.130.0-255,2902,134337,90,244413
19775,0.001048,172.31.47.0-255,66,134403,90,244413
19776,0.001051,74.125.130.0-255,766,135169,90,244413
19777,0.001107,74.125.130.0-255,1484,136653,90,244413
19778,0.00111,172.31.47.0-255,66,136719,90,244413
19779,0.001132,74.125.130.0-255,2902,139621,90,244413
19780,0.001135,172.31.47.0-255,66,139687,90,244413
19781,0.00114,74.125.130.0-255,4320,144007,90,244413
19782,0.001142,172.31.47.0-255,66,144073,90,244413
19783,0.001147,74.125.130.0-255,2902,146975,90,244413
19784,0.001148,172.31.47.0-255,66,147041,90,244413
19785,0.001175,74.125.130.0-255,2902,149943,90,244413
19786,0.001177,172.31.47.0-255,66,150009,90,244413
19787,0.001189,172.31.47.0-255,66,150075,90,244413
19788,0.001192,74.125.130.0-255,1484,151559,90,244413
19789,0.001223,74.125.130.0-255,2902,154461,90,244413
19790,0.001226,172.31.47.0-255,66,154527,90,244413
19791,0.001236,74.125.130.0-255,3602,158129,90,244413
19792,0.001243,172.31.47.0-255,66,158195,90,244413
19793,0.001297,74.125.130.0-255,1484,159679,90,244413
19794,0.001328,74.125.130.0-255,2902,162581,90,244413
19795,0.001331,172.31.47.0-255,66,162647,90,244413
19796,0.001354,74.125.130.0-255,2902,165549,90,244413
19797,0.001356,172.31.47.0-255,66,165615,90,244413
19798,0.001361,74.125.130.0-255,4320,169935,90,244413
19799,0.001363,172.31.47.0-255,66,170001,90,244413
19800,0.00139,74.125.130.0-255,8574,178575,90,244413
19801,0.001393,172.31.47.0-255,66,178641,90,244413
19802,0.001433,74.125.130.0-255,4320,182961,90,244413
19803,0.001437,172.31.47.0-255,66,183027,90,244413
19804,0.001448,74.125.130.0-255,1484,184511,90,244413
19805,0.001459,74.125.130.0-255,7856,192367,90,244413
19806,0.001461,172.31.47.0-255,66,192433,90,244413
19807,0.002074,74.125.130.0-255,1484,193917,90,244413
19808,0.002084,74.125.130.0-255,2902,196819,90,244413
19809,0.002088,172.31.47.0-255,66,196885,90,244413
19810,0.002094,74.125.130.0-255,2902,199787,90,244413
19811,0.002096,172.31.47.0-255,66,199853,90,244413
19812,0.002113,74.125.130.0-255,1484,201337,90,244413
19813,0.002115,74.125.130.0-255,1484,202821,90,244413
19814,0.002121,172.31.47.0-255,66,202887,90,244413
19815,0.002148,74.125.130.0-255,4320,207207,90,244413
19816,0.002151,172.31.47.0-255,66,207273,90,244413
19817,0.002156,74.125.130.0-255,4320,211593,90,244413
19818,0.002157,172.31.47.0-255,66,211659,90,244413
19819,0.002191,74.125.130.0-255,7156,218815,90,244413
19820,0.002193,172.31.47.0-255,66,218881,90,244413
19821,0.002198,74.125.130.0-255,4320,223201,90,244413
19822,0.0022,172.31.47.0-255,66,223267,90,244413
19823,0.002204,74.125.130.0-255,3602,226869,90,244413
19824,0.002211,172.31.47.0-255,66,226935,90,244413
19825,0.00225,74.125.130.0-255,1484,228419,90,244413
19826,0.004438,74.125.130.0-255,4320,232739,90,244413
19827,0.004444,172.31.47.0-255,66,232805,90,244413
19828,0.006683,74.125.130.0-255,5738,238543,90,244413
19829,0.006688,172.31.47.0-255,66,238609,90,244413
19830,0.008934,74.125.130.0-255,5738,244347,90,244413
19831,0.008941,172.31.47.0-255,66,244413,90,244413
19832,0.0,172.253.118.0-255,153,153,90,190458
19833,2.9e-05,172.31.47.0-255,66,219,90,190458
19834,3.6e-05,172.253.118.0-255,1484,1703,90,190458
19835,4e-05,172.31.47.0-255,66,1769,90,190458
19836,4.5e-05,172.253.118.0-255,2902,4671,90,190458
19837,4.8e-05,172.31.47.0-255,66,4737,90,190458
19838,6.2e-05,172.253.118.0-255,7156,11893,90,190458
19839,6.5e-05,172.31.47.0-255,66,11959,90,190458
19840,0.000111,172.253.118.0-255,9101,21060,90,190458
19841,0.000115,172.31.47.0-255,66,21126,90,190458
19842,0.000123,172.253.118.0-255,9633,30759,90,190458
19843,0.000126,172.31.47.0-255,66,30825,90,190458
19844,0.000178,172.253.118.0-255,1484,32309,90,190458
19845,0.000182,172.31.47.0-255,66,32375,90,190458
19846,0.000189,172.253.118.0-255,2902,35277,90,190458
19847,0.000191,172.31.47.0-255,66,35343,90,190458
19848,0.000228,172.253.118.0-255,4320,39663,90,190458
19849,0.000232,172.31.47.0-255,66,39729,90,190458
19850,0.000244,172.253.118.0-255,1484,41213,90,190458
19851,0.000247,172.31.47.0-255,66,41279,90,190458
19852,0.000253,172.253.118.0-255,4320,45599,90,190458
19853,0.00026,172.31.47.0-255,66,45665,90,190458
19854,0.000288,172.253.118.0-255,4320,49985,90,190458
19855,0.000294,172.31.47.0-255,66,50051,90,190458
19856,0.000303,172.253.118.0-255,9992,60043,90,190458
19857,0.000307,172.31.47.0-255,66,60109,90,190458
19858,0.000331,172.253.118.0-255,1484,61593,90,190458
19859,0.000334,172.31.47.0-255,66,61659,90,190458
19860,0.000363,172.253.118.0-255,3900,65559,90,190458
19861,0.000367,172.31.47.0-255,66,65625,90,190458
19862,0.00037,172.253.118.0-255,133,65758,90,190458
19863,0.000374,172.31.47.0-255,66,65824,90,190458
19864,0.000419,172.253.118.0-255,1484,67308,90,190458
19865,0.000427,172.253.118.0-255,2902,70210,90,190458
19866,0.00043,172.31.47.0-255,66,70276,90,190458
19867,0.000433,172.253.118.0-255,1484,71760,90,190458
19868,0.000458,172.253.118.0-255,4320,76080,90,190458
19869,0.000464,172.31.47.0-255,66,76146,90,190458
19870,0.000465,172.253.118.0-255,6494,82640,90,190458
19871,0.000468,172.31.47.0-255,66,82706,90,190458
19872,0.000601,172.253.118.0-255,1484,84190,90,190458
19873,0.000624,172.253.118.0-255,2902,87092,90,190458
19874,0.000628,172.31.47.0-255,66,87158,90,190458
19875,0.000635,172.253.118.0-255,5738,92896,90,190458
19876,0.000637,172.31.47.0-255,66,92962,90,190458
19877,0.000673,172.253.118.0-255,7156,100118,90,190458
19878,0.000676,172.253.118.0-255,1484,101602,90,190458
19879,0.000681,172.31.47.0-255,66,101668,90,190458
19880,0.000693,172.253.118.0-255,5738,107406,90,190458
19881,0.000696,172.31.47.0-255,66,107472,90,190458
19882,0.000732,172.253.118.0-255,7156,114628,90,190458
19883,0.000736,172.31.47.0-255,66,114694,90,190458
19884,0.00074,172.253.118.0-255,2184,116878,90,190458
19885,0.000742,172.31.47.0-255,66,116944,90,190458
19886,0.001487,172.253.118.0-255,1484,118428,90,190458
19887,0.001496,172.253.118.0-255,2902,121330,90,190458
19888,0.001501,172.31.47.0-255,66,121396,90,190458
19889,0.001534,172.253.118.0-255,5738,127134,90,190458
19890,0.001537,172.31.47.0-255,66,127200,90,190458
19891,0.001542,172.253.118.0-255,2902,130102,90,190458
19892,0.001544,172.31.47.0-255,66,130168,90,190458
19893,0.00157,172.253.118.0-255,8574,138742,90,190458
19894,0.001573,172.31.47.0-255,66,138808,90,190458
19895,0.001588,172.31.47.0-255,66,138874,90,190458
19896,0.002011,172.253.118.0-255,1484,140358,90,190458
19897,0.002019,172.253.118.0-255,2902,143260,90,190458
19898,0.002023,172.31.47.0-255,66,143326,90,190458
19899,0.00203,172.253.118.0-255,5738,149064,90,190458
19900,0.002031,172.31.47.0-255,66,149130,90,190458
19901,0.002054,172.253.118.0-255,2902,152032,90,190458
19902,0.002056,172.31.47.0-255,66,152098,90,190458
19903,0.002089,172.253.118.0-255,9992,162090,90,190458
19904,0.002091,172.31.47.0-255,66,162156,90,190458
19905,0.002136,172.253.118.0-255,2902,165058,90,190458
19906,0.002137,172.31.47.0-255,66,165124,90,190458
19907,0.002167,172.253.118.0-255,7856,172980,90,190458
19908,0.002169,172.31.47.0-255,66,173046,90,190458
19909,0.004386,172.253.118.0-255,5738,178784,90,190458
19910,0.004389,172.31.47.0-255,66,178850,90,190458
19911,0.006625,172.253.118.0-255,5738,184588,90,190458
19912,0.006631,172.31.47.0-255,66,184654,90,190458
19913,0.008879,172.253.118.0-255,5738,190392,90,190458
19914,0.008887,172.31.47.0-255,66,190458,90,190458
19915,0.0,172.217.194.0-255,153,153,90,287695
19916,2.7e-05,172.31.47.0-255,66,219,90,287695
19917,3.4e-05,172.217.194.0-255,1484,1703,90,287695
19918,3.8e-05,172.31.47.0-255,66,1769,90,287695
19919,5e-05,172.217.194.0-255,2902,4671,90,287695
19920,5.3e-05,172.31.47.0-255,66,4737,90,287695
19921,6e-05,172.217.194.0-255,7156,11893,90,287695
19922,6.3e-05,172.31.47.0-255,66,11959,90,287695
19923,0.000101,172.217.194.0-255,2005,13964,90,287695
19924,0.000104,172.31.47.0-255,66,14030,90,287695
19925,0.0003,172.217.194.0-255,1484,15514,90,287695
19926,0.000305,172.31.47.0-255,66,15580,90,287695
19927,0.00031,172.217.194.0-255,2902,18482,90,287695
19928,0.000313,172.31.47.0-255,66,18548,90,287695
19929,0.000338,172.217.194.0-255,5738,24286,90,287695
19930,0.000341,172.31.47.0-255,66,24352,90,287695
19931,0.000346,172.217.194.0-255,4320,28672,90,287695
19932,0.000355,172.31.47.0-255,66,28738,90,287695
19933,0.000402,172.217.194.0-255,2543,31281,90,287695
19934,0.000406,172.31.47.0-255,66,31347,90,287695
19935,0.000531,172.217.194.0-255,1484,32831,90,287695
19936,0.000535,172.31.47.0-255,66,32897,90,287695
19937,0.000541,172.217.194.0-255,2902,35799,90,287695
19938,0.000543,172.31.47.0-255,66,35865,90,287695
19939,0.000574,172.217.194.0-255,5738,41603,90,287695
19940,0.000576,172.31.47.0-255,66,41669,90,287695
19941,0.000599,172.217.194.0-255,1484,43153,90,287695
19942,0.000604,172.31.47.0-255,66,43219,90,287695
19943,0.000615,172.217.194.0-255,4320,47539,90,287695
19944,0.000622,172.31.47.0-255,66,47605,90,287695
19945,0.000662,172.217.194.0-255,8215,55820,90,287695
19946,0.000666,172.31.47.0-255,66,55886,90,287695
19947,0.000689,172.217.194.0-255,9633,65519,90,287695
19948,0.000693,172.31.47.0-255,66,65585,90,287695
19949,0.001158,172.217.194.0-255,646,66231,90,287695
19950,0.001164,172.31.47.0-255,66,66297,90,287695
19951,0.001282,172.217.194.0-255,1484,67781,90,287695
19952,0.001289,172.217.194.0-255,2902,70683,90,287695
19953,0.001293,172.31.47.0-255,66,70749,90,287695
19954,0.001297,172.217.194.0-255,1484,72233,90,287695
19955,0.001325,172.217.194.0-255,4320,76553,90,287695
19956,0.00133,172.31.47.0-255,66,76619,90,287695
19957,0.001338,172.217.194.0-255,8574,85193,90,287695
19958,0.00134,172.31.47.0-255,66,85259,90,287695
19959,0.001377,172.217.194.0-255,4320,89579,90,287695
19960,0.001381,172.31.47.0-255,66,89645,90,287695
19961,0.001417,172.217.194.0-255,10692,100337,90,287695
19962,0.00142,172.31.47.0-255,66,100403,90,287695
19963,0.001498,172.217.194.0-255,1484,101887,90,287695
19964,0.001503,172.217.194.0-255,2902,104789,90,287695
19965,0.001506,172.31.47.0-255,66,104855,90,287695
19966,0.00151,172.217.194.0-255,2902,107757,90,287695
19967,0.001512,172.31.47.0-255,66,107823,90,287695
19968,0.00154,172.217.194.0-255,2902,110725,90,287695
19969,0.001543,172.31.47.0-255,66,110791,90,287695
19970,0.00155,172.217.194.0-255,7156,117947,90,287695
19971,0.001551,172.31.47.0-255,66,118013,90,287695
19972,0.001556,172.217.194.0-255,4320,122333,90,287695
19973,0.001562,172.31.47.0-255,66,122399,90,287695
19974,0.001596,172.217.194.0-255,9992,132391,90,287695
19975,0.001599,172.31.47.0-255,66,132457,90,287695
19976,0.001602,172.217.194.0-255,2184,134641,90,287695
19977,0.001604,172.31.47.0-255,66,134707,90,287695
19978,0.001748,172.217.194.0-255,1484,136191,90,287695
19979,0.001754,172.217.194.0-255,2902,139093,90,287695
19980,0.00176,172.31.47.0-255,66,139159,90,287695
19981,0.001788,172.217.194.0-255,5738,144897,90,287695
19982,0.001793,172.31.47.0-255,66,144963,90,287695
19983,0.001801,172.217.194.0-255,8574,153537,90,287695
19984,0.001803,172.31.47.0-255,66,153603,90,287695
19985,0.001875,172.31.47.0-255,66,153669,90,287695
19986,0.0019,172.217.194.0-255,2184,155853,90,287695
19987,0.001904,172.31.47.0-255,66,155919,90,287695
19988,0.002304,172.217.194.0-255,1484,157403,90,287695
19989,0.002312,172.217.194.0-255,2902,160305,90,287695
19990,0.002316,172.31.47.0-255,66,160371,90,287695
19991,0.002345,172.217.194.0-255,5738,166109,90,287695
19992,0.002348,172.31.47.0-255,66,166175,90,287695
19993,0.002352,172.217.194.0-255,2902,169077,90,287695
19994,0.002355,172.31.47.0-255,66,169143,90,287695
19995,0.002376,172.217.194.0-255,2902,172045,90,287695
19996,0.002379,172.31.47.0-255,66,172111,90,287695
19997,0.002395,172.31.47.0-255,66,172177,90,287695
19998,0.002399,172.217.194.0-255,2902,175079,90,287695
19999,0.002401,172.31.47.0-255,66,175145,90,287695
20000,0.002441,172.217.194.0-255,3602,178747,90,287695
20001,0.002445,172.31.47.0-255,66,178813,90,287695
20002,0.002521,172.217.194.0-255,1484,180297,90,287695
20003,0.002546,172.217.194.0-255,2902,183199,90,287695
20004,0.00255,172.31.47.0-255,66,183265,90,287695
20005,0.002556,172.217.194.0-255,5738,189003,90,287695
20006,0.002559,172.31.47.0-255,66,189069,90,287695
20007,0.002563,172.217.194.0-255,2902,191971,90,287695
20008,0.002572,172.31.47.0-255,66,192037,90,287695
20009,0.00261,172.217.194.0-255,9992,202029,90,287695
20010,0.002613,172.31.47.0-255,66,202095,90,287695
20011,0.002616,172.217.194.0-255,1484,203579,90,287695
20012,0.00262,172.217.194.0-255,2902,206481,90,287695
20013,0.002623,172.31.47.0-255,78,206559,90,287695
20014,0.002643,172.31.47.0-255,66,206625,90,287695
20015,0.002649,172.217.194.0-255,5738,212363,90,287695
20016,0.002651,172.31.47.0-255,66,212429,90,287695
20017,0.002654,172.217.194.0-255,766,213195,90,287695
20018,0.002657,172.31.47.0-255,78,213273,90,287695
20019,0.002682,172.217.194.0-255,9992,223265,90,287695
20020,0.002687,172.31.47.0-255,78,223343,90,287695
20021,0.002731,172.31.47.0-255,66,223409,90,287695
20022,0.002737,172.217.194.0-255,5738,229147,90,287695
20023,0.002739,172.31.47.0-255,66,229213,90,287695
20024,0.002743,172.217.194.0-255,2902,232115,90,287695
20025,0.002745,172.31.47.0-255,66,232181,90,287695
20026,0.002758,172.217.194.0-255,7156,239337,90,287695
20027,0.002761,172.31.47.0-255,66,239403,90,287695
20028,0.002773,172.31.47.0-255,66,239469,90,287695
20029,0.002787,172.31.47.0-255,66,239535,90,287695
20030,0.00284,172.217.194.0-255,2902,242437,90,287695
20031,0.002921,172.217.194.0-255,5020,247457,90,287695
20032,0.002941,172.217.194.0-255,1484,248941,90,287695
20033,0.002943,172.217.194.0-255,1484,250425,90,287695
20034,0.002947,172.31.47.0-255,78,250503,90,287695
20035,0.002975,172.217.194.0-255,8574,259077,90,287695
20036,0.003,172.217.194.0-255,5020,264097,90,287695
20037,0.003008,172.217.194.0-255,6018,270115,90,287695
20038,0.003023,172.217.194.0-255,105,270220,90,287695
20039,0.007276,172.31.47.0-255,66,270286,90,287695
20040,0.008724,172.31.47.0-255,105,270391,90,287695
20041,0.00905,172.217.194.0-255,8574,278965,90,287695
20042,0.009056,172.31.47.0-255,78,279043,90,287695
20043,0.009094,172.217.194.0-255,8574,287617,90,287695
20044,0.009097,172.31.47.0-255,78,287695,90,287695
20045,0.0,74.125.200.0-255,289,289,90,284769
20046,2.6e-05,172.31.47.0-255,66,355,90,284769
20047,3.2e-05,74.125.200.0-255,1484,1839,90,284769
20048,3.6e-05,172.31.47.0-255,66,1905,90,284769
20049,4.1e-05,74.125.200.0-255,4320,6225,90,284769
20050,4.9e-05,172.31.47.0-255,66,6291,90,284769
20051,8.3e-05,74.125.200.0-255,7156,13447,90,284769
20052,8.6e-05,172.31.47.0-255,66,13513,90,284769
20053,0.000123,74.125.200.0-255,7683,21196,90,284769
20054,0.000126,172.31.47.0-255,66,21262,90,284769
20055,0.000129,74.125.200.0-255,1484,22746,90,284769
20056,0.000131,172.31.47.0-255,66,22812,90,284769
20057,0.000158,74.125.200.0-255,1484,24296,90,284769
20058,0.00016,172.31.47.0-255,66,24362,90,284769
20059,0.000188,74.125.200.0-255,6797,31159,90,284769
20060,0.000191,172.31.47.0-255,66,31225,90,284769
20061,0.000243,74.125.200.0-255,1484,32709,90,284769
20062,0.000245,172.31.47.0-255,66,32775,90,284769
20063,0.000258,74.125.200.0-255,1484,34259,90,284769
20064,0.000264,172.31.47.0-255,66,34325,90,284769
20065,0.000286,74.125.200.0-255,1484,35809,90,284769
20066,0.000289,172.31.47.0-255,66,35875,90,284769
20067,0.000292,74.125.200.0-255,1484,37359,90,284769
20068,0.000294,172.31.47.0-255,66,37425,90,284769
20069,0.000298,74.125.200.0-255,2902,40327,90,284769
20070,0.0003,172.31.47.0-255,66,40393,90,284769
20071,0.000305,74.125.200.0-255,5738,46131,90,284769
20072,0.000307,172.31.47.0-255,66,46197,90,284769
20073,0.000356,74.125.200.0-255,6797,52994,90,284769
20074,0.000359,172.31.47.0-255,66,53060,90,284769
20075,0.000365,74.125.200.0-255,7156,60216,90,284769
20076,0.000368,172.31.47.0-255,66,60282,90,284769
20077,0.000372,74.125.200.0-255,4320,64602,90,284769
20078,0.000376,172.31.47.0-255,66,64668,90,284769
20079,0.000394,74.125.200.0-255,1395,66063,90,284769
20080,0.000398,74.125.200.0-255,134,66197,90,284769
20081,0.000494,74.125.200.0-255,1484,67681,90,284769
20082,0.000498,172.31.47.0-255,66,67747,90,284769
20083,0.000516,74.125.200.0-255,2902,70649,90,284769
20084,0.000527,172.31.47.0-255,66,70715,90,284769
20085,0.000553,74.125.200.0-255,4320,75035,90,284769
20086,0.000559,172.31.47.0-255,66,75101,90,284769
20087,0.000567,74.125.200.0-255,2902,78003,90,284769
20088,0.000572,172.31.47.0-255,66,78069,90,284769
20089,0.000591,74.125.200.0-255,5738,83807,90,284769
20090,0.000597,172.31.47.0-255,66,83873,90,284769
20091,0.000607,74.125.200.0-255,2902,86775,90,284769
20092,0.000609,172.31.47.0-255,66,86841,90,284769
20093,0.000637,74.125.200.0-255,7156,93997,90,284769
20094,0.000641,74.125.200.0-255,2902,96899,90,284769
20095,0.000642,172.31.47.0-255,66,96965,90,284769
20096,0.000646,172.31.47.0-255,66,97031,90,284769
20097,0.000666,74.125.200.0-255,1484,98515,90,284769
20098,0.000684,74.125.200.0-255,2466,100981,90,284769
20099,0.000694,172.31.47.0-255,66,101047,90,284769
20100,0.000757,74.125.200.0-255,1484,102531,90,284769
20101,0.000768,74.125.200.0-255,1484,104015,90,284769
20102,0.000771,172.31.47.0-255,66,104081,90,284769
20103,0.000774,74.125.200.0-255,1484,105565,90,284769
20104,0.000794,74.125.200.0-255,1484,107049,90,284769
20105,0.000799,172.31.47.0-255,66,107115,90,284769
20106,0.000807,74.125.200.0-255,2902,110017,90,284769
20107,0.00081,172.31.47.0-255,66,110083,90,284769
20108,0.000827,74.125.200.0-255,2902,112985,90,284769
20109,0.000831,172.31.47.0-255,66,113051,90,284769
20110,0.000831,74.125.200.0-255,2902,115953,90,284769
20111,0.000833,172.31.47.0-255,66,116019,90,284769
20112,0.000858,74.125.200.0-255,4320,120339,90,284769
20113,0.000864,172.31.47.0-255,66,120405,90,284769
20114,0.000891,74.125.200.0-255,5738,126143,90,284769
20115,0.000898,74.125.200.0-255,7156,133299,90,284769
20116,0.000898,172.31.47.0-255,66,133365,90,284769
20117,0.000902,172.31.47.0-255,66,133431,90,284769
20118,0.000928,74.125.200.0-255,2184,135615,90,284769
20119,0.000931,172.31.47.0-255,66,135681,90,284769
20120,0.000979,74.125.200.0-255,1484,137165,90,284769
20121,0.000995,74.125.200.0-255,2902,140067,90,284769
20122,0.000999,172.31.47.0-255,66,140133,90,284769
20123,0.001031,74.125.200.0-255,5738,145871,90,284769
20124,0.001046,172.31.47.0-255,66,145937,90,284769
20125,0.001047,74.125.200.0-255,2902,148839,90,284769
20126,0.00105,172.31.47.0-255,66,148905,90,284769
20127,0.001075,74.125.200.0-255,4320,153225,90,284769
20128,0.001081,74.125.200.0-255,5738,158963,90,284769
20129,0.00108,172.31.47.0-255,66,159029,90,284769
20130,0.001087,172.31.47.0-255,66,159095,90,284769
20131,0.001116,74.125.200.0-255,5738,164833,90,284769
20132,0.001124,172.31.47.0-255,66,164899,90,284769
20133,0.001143,74.125.200.0-255,5020,169919,90,284769
20134,0.001147,172.31.47.0-255,66,169985,90,284769
20135,0.001312,74.125.200.0-255,1484,171469,90,284769
20136,0.001326,74.125.200.0-255,1484,172953,90,284769
20137,0.001329,172.31.47.0-255,66,173019,90,284769
20138,0.001346,74.125.200.0-255,2902,175921,90,284769
20139,0.001352,172.31.47.0-255,66,175987,90,284769
20140,0.00136,74.125.200.0-255,1484,177471,90,284769
20141,0.001377,74.125.200.0-255,4320,181791,90,284769
20142,0.00138,74.125.200.0-255,2902,184693,90,284769
20143,0.00138,172.31.47.0-255,66,184759,90,284769
20144,0.001385,172.31.47.0-255,66,184825,90,284769
20145,0.001413,74.125.200.0-255,4320,189145,90,284769
20146,0.001421,74.125.200.0-255,8574,197719,90,284769
20147,0.001421,172.31.47.0-255,66,197785,90,284769
20148,0.001423,74.125.200.0-255,1484,199269,90,284769
20149,0.001425,172.31.47.0-255,66,199335,90,284769
20150,0.001451,74.125.200.0-255,5020,204355,90,284769
20151,0.001454,172.31.47.0-255,66,204421,90,284769
20152,0.001655,74.125.200.0-255,1484,205905,90,284769
20153,0.001669,74.125.200.0-255,2902,208807,90,284769
20154,0.001672,172.31.47.0-255,66,208873,90,284769
20155,0.001675,74.125.200.0-255,1484,210357,90,284769
20156,0.001695,74.125.200.0-255,1484,211841,90,284769
20157,0.001699,74.125.200.0-255,2902,214743,90,284769
20158,0.0017,172.31.47.0-255,66,214809,90,284769
20159,0.001704,172.31.47.0-255,66,214875,90,284769
20160,0.001712,74.125.200.0-255,1484,216359,90,284769
20161,0.001738,74.125.200.0-255,8574,224933,90,284769
20162,0.001742,74.125.200.0-255,2902,227835,90,284769
20163,0.001742,172.31.47.0-255,66,227901,90,284769
20164,0.001745,172.31.47.0-255,66,227967,90,284769
20165,0.001818,74.125.200.0-255,2902,230869,90,284769
20166,0.001822,172.31.47.0-255,66,230935,90,284769
20167,0.001856,74.125.200.0-255,7856,238791,90,284769
20168,0.00186,172.31.47.0-255,66,238857,90,284769
20169,0.001877,74.125.200.0-255,1484,240341,90,284769
20170,0.001877,172.31.47.0-255,66,240407,90,284769
20171,0.001879,74.125.200.0-255,1484,241891,90,284769
20172,0.001892,172.31.47.0-255,66,241957,90,284769
20173,0.001923,74.125.200.0-255,2902,244859,90,284769
20174,0.001928,172.31.47.0-255,66,244925,90,284769
20175,0.00195,74.125.200.0-255,3602,248527,90,284769
20176,0.001955,172.31.47.0-255,66,248593,90,284769
20177,0.001965,74.125.200.0-255,4320,252913,90,284769
20178,0.001977,172.31.47.0-255,66,252979,90,284769
20179,0.00199,74.125.200.0-255,4320,257299,90,284769
20180,0.001997,172.31.47.0-255,66,257365,90,284769
20181,0.002012,74.125.200.0-255,5738,263103,90,284769
20182,0.002017,172.31.47.0-255,66,263169,90,284769
20183,0.002037,74.125.200.0-255,9992,273161,90,284769
20184,0.002041,172.31.47.0-255,66,273227,90,284769
20185,0.004038,74.125.200.0-255,5738,278965,90,284769
20186,0.004043,172.31.47.0-255,66,279031,90,284769
20187,0.006038,74.125.200.0-255,5738,284769,90,284769
20188,0.0,172.31.47.0-255,66,66,90,66
20189,0.0,172.31.47.0-255,105,105,90,276
20190,0.001871,157.240.13.0-255,105,210,90,276
20191,0.00189,172.31.47.0-255,66,276,90,276
20192,0.0,172.31.47.0-255,105,105,90,276
20193,0.002099,157.240.13.0-255,105,210,90,276
20194,0.002109,172.31.47.0-255,66,276,90,276
20195,0.0,74.125.24.0-255,153,153,90,264089
20196,2.3e-05,172.31.47.0-255,66,219,90,264089
20197,3e-05,74.125.24.0-255,1484,1703,90,264089
20198,3.3e-05,172.31.47.0-255,66,1769,90,264089
20199,3.9e-05,74.125.24.0-255,2902,4671,90,264089
20200,4.2e-05,172.31.47.0-255,66,4737,90,264089
20201,5.5e-05,74.125.24.0-255,7156,11893,90,264089
20202,5.8e-05,172.31.47.0-255,66,11959,90,264089
20203,6.2e-05,74.125.24.0-255,2127,14086,90,264089
20204,6.4e-05,172.31.47.0-255,66,14152,90,264089
20205,6.9e-05,74.125.24.0-255,2902,17054,90,264089
20206,7.1e-05,172.31.47.0-255,66,17120,90,264089
20207,0.000108,74.125.24.0-255,8574,25694,90,264089
20208,0.000111,172.31.47.0-255,66,25760,90,264089
20209,0.000117,74.125.24.0-255,5379,31139,90,264089
20210,0.000119,172.31.47.0-255,66,31205,90,264089
20211,0.000176,74.125.24.0-255,1484,32689,90,264089
20212,0.000178,172.31.47.0-255,66,32755,90,264089
20213,0.000197,74.125.24.0-255,2902,35657,90,264089
20214,0.000202,74.125.24.0-255,5738,41395,90,264089
20215,0.000207,172.31.47.0-255,66,41461,90,264089
20216,0.000213,172.31.47.0-255,66,41527,90,264089
20217,0.000235,74.125.24.0-255,5738,47265,90,264089
20218,0.000237,172.31.47.0-255,66,47331,90,264089
20219,0.00026,74.125.24.0-255,8215,55546,90,264089
20220,0.000263,172.31.47.0-255,66,55612,90,264089
20221,0.000271,74.125.24.0-255,9945,65557,90,264089
20222,0.000273,172.31.47.0-255,66,65623,90,264089
20223,0.000276,74.125.24.0-255,374,65997,90,264089
20224,0.000277,172.31.47.0-255,66,66063,90,264089
20225,0.000554,74.125.24.0-255,1484,67547,90,264089
20226,0.000559,172.31.47.0-255,66,67613,90,264089
20227,0.000564,74.125.24.0-255,2902,70515,90,264089
20228,0.000566,172.31.47.0-255,66,70581,90,264089
20229,0.000569,74.125.24.0-255,1484,72065,90,264089
20230,0.000598,74.125.24.0-255,4320,76385,90,264089
20231,0.000601,172.31.47.0-255,66,76451,90,264089
20232,0.000606,74.125.24.0-255,4320,80771,90,264089
20233,0.000608,172.31.47.0-255,66,80837,90,264089
20234,0.00064,74.125.24.0-255,7156,87993,90,264089
20235,0.000643,172.31.47.0-255,66,88059,90,264089
20236,0.000654,172.31.47.0-255,66,88125,90,264089
20237,0.00083,74.125.24.0-255,1484,89609,90,264089
20238,0.000835,74.125.24.0-255,2902,92511,90,264089
20239,0.000838,172.31.47.0-255,66,92577,90,264089
20240,0.000863,74.125.24.0-255,5738,98315,90,264089
20241,0.000866,172.31.47.0-255,66,98381,90,264089
20242,0.00089,74.125.24.0-255,4320,102701,90,264089
20243,0.000892,172.31.47.0-255,66,102767,90,264089
20244,0.000926,74.125.24.0-255,8574,111341,90,264089
20245,0.000929,172.31.47.0-255,66,111407,90,264089
20246,0.000938,74.125.24.0-255,10692,122099,90,264089
20247,0.000944,172.31.47.0-255,66,122165,90,264089
20248,0.000993,74.125.24.0-255,1484,123649,90,264089
20249,0.001008,74.125.24.0-255,2902,126551,90,264089
20250,0.001011,172.31.47.0-255,66,126617,90,264089
20251,0.001014,74.125.24.0-255,1484,128101,90,264089
20252,0.001037,74.125.24.0-255,4320,132421,90,264089
20253,0.00104,172.31.47.0-255,66,132487,90,264089
20254,0.001052,172.31.47.0-255,66,132553,90,264089
20255,0.001092,74.125.24.0-255,10692,143245,90,264089
20256,0.001095,172.31.47.0-255,66,143311,90,264089
20257,0.001117,74.125.24.0-255,1484,144795,90,264089
20258,0.001122,74.125.24.0-255,2902,147697,90,264089
20259,0.001123,172.31.47.0-255,66,147763,90,264089
20260,0.001149,74.125.24.0-255,5738,153501,90,264089
20261,0.001152,172.31.47.0-255,66,153567,90,264089
20262,0.001155,74.125.24.0-255,2902,156469,90,264089
20263,0.001157,172.31.47.0-255,66,156535,90,264089
20264,0.001189,74.125.24.0-255,9992,166527,90,264089
20265,0.001192,172.31.47.0-255,66,166593,90,264089
20266,0.0012,74.125.24.0-255,9992,176585,90,264089
20267,0.001202,172.31.47.0-255,66,176651,90,264089
20268,0.001204,74.125.24.0-255,766,177417,90,264089
20269,0.001556,74.125.24.0-255,1484,178901,90,264089
20270,0.00156,172.31.47.0-255,66,178967,90,264089
20271,0.001565,74.125.24.0-255,2902,181869,90,264089
20272,0.001567,172.31.47.0-255,66,181935,90,264089
20273,0.001595,74.125.24.0-255,5738,187673,90,264089
20274,0.001598,172.31.47.0-255,66,187739,90,264089
20275,0.001604,74.125.24.0-255,5738,193477,90,264089
20276,0.001606,172.31.47.0-255,66,193543,90,264089
20277,0.001621,74.125.24.0-255,7156,200699,90,264089
20278,0.001623,172.31.47.0-255,66,200765,90,264089
20279,0.001629,74.125.24.0-255,5738,206503,90,264089
20280,0.00163,172.31.47.0-255,66,206569,90,264089
20281,0.001662,74.125.24.0-255,5020,211589,90,264089
20282,0.001665,172.31.47.0-255,66,211655,90,264089
20283,0.001856,74.125.24.0-255,1484,213139,90,264089
20284,0.001861,74.125.24.0-255,2902,216041,90,264089
20285,0.001864,172.31.47.0-255,66,216107,90,264089
20286,0.001867,74.125.24.0-255,1484,217591,90,264089
20287,0.001886,74.125.24.0-255,4320,221911,90,264089
20288,0.001888,172.31.47.0-255,66,221977,90,264089
20289,0.001891,74.125.24.0-255,1484,223461,90,264089
20290,0.001942,172.31.47.0-255,66,223527,90,264089
20291,0.001958,172.31.47.0-255,66,223593,90,264089
20292,0.002008,172.31.47.0-255,66,223659,90,264089
20293,0.002016,74.125.24.0-255,9992,233651,90,264089
20294,0.002018,172.31.47.0-255,66,233717,90,264089
20295,0.002093,172.31.47.0-255,66,233783,90,264089
20296,0.002099,74.125.24.0-255,5738,239521,90,264089
20297,0.002101,172.31.47.0-255,66,239587,90,264089
20298,0.002128,172.31.47.0-255,66,239653,90,264089
20299,0.00214,172.31.47.0-255,66,239719,90,264089
20300,0.002165,74.125.24.0-255,7156,246875,90,264089
20301,0.002168,172.31.47.0-255,66,246941,90,264089
20302,0.002176,74.125.24.0-255,9274,256215,90,264089
20303,0.002178,172.31.47.0-255,66,256281,90,264089
20304,0.002198,74.125.24.0-255,1484,257765,90,264089
20305,0.002236,172.31.47.0-255,66,257831,90,264089
20306,0.00227,172.31.47.0-255,66,257897,90,264089
20307,0.002277,74.125.24.0-255,5955,263852,90,264089
20308,0.002279,172.31.47.0-255,66,263918,90,264089
20309,0.002301,74.125.24.0-255,105,264023,90,264089
20310,0.009981,172.31.47.0-255,66,264089,90,264089
20311,0.0,172.31.47.0-255,105,105,90,276
20312,0.002108,157.240.13.0-255,105,210,90,276
20313,0.00212,172.31.47.0-255,66,276,90,276
20314,0.0,74.125.24.0-255,153,153,90,101915
20315,3.7e-05,172.31.47.0-255,66,219,90,101915
20316,4.3e-05,74.125.24.0-255,1484,1703,90,101915
20317,4.8e-05,172.31.47.0-255,66,1769,90,101915
20318,5.3e-05,74.125.24.0-255,2902,4671,90,101915
20319,6.3e-05,172.31.47.0-255,66,4737,90,101915
20320,7e-05,74.125.24.0-255,7156,11893,90,101915
20321,7.2e-05,172.31.47.0-255,66,11959,90,101915
20322,7.6e-05,74.125.24.0-255,1967,13926,90,101915
20323,7.9e-05,172.31.47.0-255,66,13992,90,101915
20324,0.000496,74.125.24.0-255,1484,15476,90,101915
20325,0.000502,172.31.47.0-255,66,15542,90,101915
20326,0.00051,74.125.24.0-255,2902,18444,90,101915
20327,0.000513,172.31.47.0-255,66,18510,90,101915
20328,0.000525,74.125.24.0-255,5738,24248,90,101915
20329,0.000527,172.31.47.0-255,66,24314,90,101915
20330,0.00056,74.125.24.0-255,6797,31111,90,101915
20331,0.000564,172.31.47.0-255,66,31177,90,101915
20332,0.000593,74.125.24.0-255,7156,38333,90,101915
20333,0.000596,172.31.47.0-255,66,38399,90,101915
20334,0.000599,74.125.24.0-255,1484,39883,90,101915
20335,0.000602,172.31.47.0-255,66,39949,90,101915
20336,0.000627,74.125.24.0-255,5738,45687,90,101915
20337,0.000635,172.31.47.0-255,66,45753,90,101915
20338,0.000658,74.125.24.0-255,2543,48296,90,101915
20339,0.000661,172.31.47.0-255,66,48362,90,101915
20340,0.001625,74.125.24.0-255,1484,49846,90,101915
20341,0.001632,172.31.47.0-255,66,49912,90,101915
20342,0.001637,74.125.24.0-255,2902,52814,90,101915
20343,0.001639,172.31.47.0-255,66,52880,90,101915
20344,0.001644,74.125.24.0-255,5738,58618,90,101915
20345,0.00165,172.31.47.0-255,66,58684,90,101915
20346,0.001672,74.125.24.0-255,4320,63004,90,101915
20347,0.001674,172.31.47.0-255,66,63070,90,101915
20348,0.00171,74.125.24.0-255,9633,72703,90,101915
20349,0.001712,172.31.47.0-255,66,72769,90,101915
20350,0.001724,172.31.47.0-255,66,72835,90,101915
20351,0.001727,74.125.24.0-255,4320,77155,90,101915
20352,0.001729,172.31.47.0-255,66,77221,90,101915
20353,0.001753,74.125.24.0-255,7856,85077,90,101915
20354,0.001755,172.31.47.0-255,66,85143,90,101915
20355,0.001757,74.125.24.0-255,646,85789,90,101915
20356,0.003822,74.125.24.0-255,4320,90109,90,101915
20357,0.003824,172.31.47.0-255,66,90175,90,101915
20358,0.003828,172.31.47.0-255,66,90241,90,101915
20359,0.005876,74.125.24.0-255,1484,91725,90,101915
20360,0.005917,74.125.24.0-255,4320,96045,90,101915
20361,0.005924,172.31.47.0-255,66,96111,90,101915
20362,0.008012,74.125.24.0-255,5738,101849,90,101915
20363,0.00802,172.31.47.0-255,66,101915,90,101915
20364,0.0,74.125.24.0-255,153,153,90,242614
20365,1.2e-05,172.31.47.0-255,66,219,90,242614
20366,4.6e-05,74.125.24.0-255,1484,1703,90,242614
20367,5.1e-05,172.31.47.0-255,66,1769,90,242614
20368,5.6e-05,74.125.24.0-255,2902,4671,90,242614
20369,5.9e-05,172.31.47.0-255,66,4737,90,242614
20370,7.1e-05,74.125.24.0-255,7156,11893,90,242614
20371,7.5e-05,172.31.47.0-255,66,11959,90,242614
20372,8e-05,74.125.24.0-255,4996,16955,90,242614
20373,8.4e-05,172.31.47.0-255,66,17021,90,242614
20374,0.0001,74.125.24.0-255,4320,21341,90,242614
20375,0.000102,172.31.47.0-255,66,21407,90,242614
20376,0.000135,74.125.24.0-255,9633,31040,90,242614
20377,0.000138,172.31.47.0-255,66,31106,90,242614
20378,0.000158,74.125.24.0-255,1484,32590,90,242614
20379,0.00016,172.31.47.0-255,66,32656,90,242614
20380,0.000164,74.125.24.0-255,2902,35558,90,242614
20381,0.000166,172.31.47.0-255,66,35624,90,242614
20382,0.000171,74.125.24.0-255,2902,38526,90,242614
20383,0.000173,172.31.47.0-255,66,38592,90,242614
20384,0.000204,74.125.24.0-255,2902,41494,90,242614
20385,0.000207,172.31.47.0-255,66,41560,90,242614
20386,0.000211,74.125.24.0-255,1484,43044,90,242614
20387,0.000212,172.31.47.0-255,66,43110,90,242614
20388,0.000237,74.125.24.0-255,5379,48489,90,242614
20389,0.00024,172.31.47.0-255,66,48555,90,242614
20390,0.000733,74.125.24.0-255,1484,50039,90,242614
20391,0.000738,172.31.47.0-255,66,50105,90,242614
20392,0.000745,74.125.24.0-255,2902,53007,90,242614
20393,0.000747,172.31.47.0-255,66,53073,90,242614
20394,0.000779,74.125.24.0-255,5738,58811,90,242614
20395,0.000782,172.31.47.0-255,66,58877,90,242614
20396,0.000787,74.125.24.0-255,4320,63197,90,242614
20397,0.000789,172.31.47.0-255,66,63263,90,242614
20398,0.000804,74.125.24.0-255,2543,65806,90,242614
20399,0.000807,172.31.47.0-255,66,65872,90,242614
20400,0.000827,74.125.24.0-255,1484,67356,90,242614
20401,0.000862,172.31.47.0-255,66,67422,90,242614
20402,0.000891,74.125.24.0-255,10213,77635,90,242614
20403,0.000894,172.31.47.0-255,66,77701,90,242614
20404,0.000939,74.125.24.0-255,4320,82021,90,242614
20405,0.000943,172.31.47.0-255,66,82087,90,242614
20406,0.000969,74.125.24.0-255,5379,87466,90,242614
20407,0.000973,172.31.47.0-255,66,87532,90,242614
20408,0.001157,74.125.24.0-255,1484,89016,90,242614
20409,0.00117,74.125.24.0-255,2902,91918,90,242614
20410,0.001173,172.31.47.0-255,66,91984,90,242614
20411,0.001177,74.125.24.0-255,1484,93468,90,242614
20412,0.001206,74.125.24.0-255,4320,97788,90,242614
20413,0.001209,172.31.47.0-255,66,97854,90,242614
20414,0.001211,74.125.24.0-255,1484,99338,90,242614
20415,0.00122,74.125.24.0-255,8574,107912,90,242614
20416,0.001227,172.31.47.0-255,66,107978,90,242614
20417,0.001254,74.125.24.0-255,4320,112298,90,242614
20418,0.001257,172.31.47.0-255,66,112364,90,242614
20419,0.001264,74.125.24.0-255,9274,121638,90,242614
20420,0.001266,172.31.47.0-255,66,121704,90,242614
20421,0.001298,74.125.24.0-255,1484,123188,90,242614
20422,0.001324,74.125.24.0-255,2902,126090,90,242614
20423,0.001327,172.31.47.0-255,66,126156,90,242614
20424,0.001332,74.125.24.0-255,5738,131894,90,242614
20425,0.001335,172.31.47.0-255,66,131960,90,242614
20426,0.001352,172.31.47.0-255,66,132026,90,242614
20427,0.001388,74.125.24.0-255,1484,133510,90,242614
20428,0.001407,74.125.24.0-255,9274,142784,90,242614
20429,0.00141,172.31.47.0-255,66,142850,90,242614
20430,0.001468,74.125.24.0-255,1484,144334,90,242614
20431,0.001484,74.125.24.0-255,2902,147236,90,242614
20432,0.001487,172.31.47.0-255,66,147302,90,242614
20433,0.001507,74.125.24.0-255,5738,153040,90,242614
20434,0.00151,172.31.47.0-255,66,153106,90,242614
20435,0.001515,74.125.24.0-255,5738,158844,90,242614
20436,0.001517,172.31.47.0-255,66,158910,90,242614
20437,0.001545,74.125.24.0-255,7156,166066,90,242614
20438,0.001547,172.31.47.0-255,66,166132,90,242614
20439,0.001554,74.125.24.0-255,8574,174706,90,242614
20440,0.001555,172.31.47.0-255,66,174772,90,242614
20441,0.001573,74.125.24.0-255,2184,176956,90,242614
20442,0.001575,172.31.47.0-255,66,177022,90,242614
20443,0.001664,74.125.24.0-255,1484,178506,90,242614
20444,0.001711,74.125.24.0-255,2902,181408,90,242614
20445,0.001713,172.31.47.0-255,66,181474,90,242614
20446,0.001719,74.125.24.0-255,5738,187212,90,242614
20447,0.00172,172.31.47.0-255,66,187278,90,242614
20448,0.00175,74.125.24.0-255,9992,197270,90,242614
20449,0.001752,172.31.47.0-255,66,197336,90,242614
20450,0.001788,74.125.24.0-255,1484,198820,90,242614
20451,0.001819,172.31.47.0-255,66,198886,90,242614
20452,0.001958,74.125.24.0-255,1484,200370,90,242614
20453,0.00197,74.125.24.0-255,2902,203272,90,242614
20454,0.001972,172.31.47.0-255,66,203338,90,242614
20455,0.001974,74.125.24.0-255,1484,204822,90,242614
20456,0.002002,74.125.24.0-255,4320,209142,90,242614
20457,0.002004,172.31.47.0-255,66,209208,90,242614
20458,0.00202,74.125.24.0-255,4320,213528,90,242614
20459,0.002023,172.31.47.0-255,66,213594,90,242614
20460,0.002031,74.125.24.0-255,4320,217914,90,242614
20461,0.002032,172.31.47.0-255,66,217980,90,242614
20462,0.002058,74.125.24.0-255,7156,225136,90,242614
20463,0.002064,172.31.47.0-255,66,225202,90,242614
20464,0.004029,74.125.24.0-255,5738,230940,90,242614
20465,0.004034,172.31.47.0-255,66,231006,90,242614
20466,0.006033,74.125.24.0-255,5738,236744,90,242614
20467,0.006038,172.31.47.0-255,66,236810,90,242614
20468,0.008016,74.125.24.0-255,5738,242548,90,242614
20469,0.008024,172.31.47.0-255,66,242614,90,242614
20470,0.0,172.31.47.0-255,105,105,90,276
20471,0.002041,157.240.13.0-255,105,210,90,276
20472,0.002052,172.31.47.0-255,66,276,90,276
20473,0.0,172.217.194.0-255,145,145,90,197271
20474,2.2e-05,172.31.47.0-255,66,211,90,197271
20475,2.9e-05,172.217.194.0-255,1484,1695,90,197271
20476,3.3e-05,172.31.47.0-255,66,1761,90,197271
20477,3.8e-05,172.217.194.0-255,2902,4663,90,197271
20478,4.2e-05,172.31.47.0-255,66,4729,90,197271
20479,4.9e-05,172.217.194.0-255,7156,11885,90,197271
20480,5.2e-05,172.31.47.0-255,66,11951,90,197271
20481,5.5e-05,172.217.194.0-255,2212,14163,90,197271
20482,5.8e-05,172.31.47.0-255,66,14229,90,197271
20483,9e-05,172.217.194.0-255,2902,17131,90,197271
20484,9.4e-05,172.31.47.0-255,66,17197,90,197271
20485,0.0001,172.217.194.0-255,4320,21517,90,197271
20486,0.000102,172.31.47.0-255,66,21583,90,197271
20487,0.000117,172.217.194.0-255,2902,24485,90,197271
20488,0.000119,172.31.47.0-255,66,24551,90,197271
20489,0.000124,172.217.194.0-255,5738,30289,90,197271
20490,0.000127,172.31.47.0-255,66,30355,90,197271
20491,0.000143,172.217.194.0-255,1125,31480,90,197271
20492,0.000145,172.31.47.0-255,66,31546,90,197271
20493,0.000284,172.217.194.0-255,1484,33030,90,197271
20494,0.000289,172.31.47.0-255,66,33096,90,197271
20495,0.000295,172.217.194.0-255,2902,35998,90,197271
20496,0.000297,172.31.47.0-255,66,36064,90,197271
20497,0.000317,172.217.194.0-255,5738,41802,90,197271
20498,0.00032,172.31.47.0-255,66,41868,90,197271
20499,0.000348,172.217.194.0-255,9992,51860,90,197271
20500,0.000351,172.31.47.0-255,66,51926,90,197271
20501,0.000372,172.217.194.0-255,1125,53051,90,197271
20502,0.000375,172.31.47.0-255,66,53117,90,197271
20503,0.000383,172.217.194.0-255,9992,63109,90,197271
20504,0.000385,172.31.47.0-255,66,63175,90,197271
20505,0.000405,172.217.194.0-255,2543,65718,90,197271
20506,0.000407,172.31.47.0-255,66,65784,90,197271
20507,0.00041,172.217.194.0-255,337,66121,90,197271
20508,0.000463,172.217.194.0-255,122,66243,90,197271
20509,0.000528,172.217.194.0-255,382,66625,90,197271
20510,0.000988,172.31.47.0-255,66,66691,90,197271
20511,0.001082,172.217.194.0-255,1484,68175,90,197271
20512,0.00109,172.217.194.0-255,2902,71077,90,197271
20513,0.001093,172.31.47.0-255,66,71143,90,197271
20514,0.001097,172.217.194.0-255,2902,74045,90,197271
20515,0.001099,172.31.47.0-255,66,74111,90,197271
20516,0.001113,172.217.194.0-255,2902,77013,90,197271
20517,0.001115,172.31.47.0-255,66,77079,90,197271
20518,0.001136,172.217.194.0-255,7156,84235,90,197271
20519,0.001138,172.31.47.0-255,66,84301,90,197271
20520,0.001181,172.31.47.0-255,66,84367,90,197271
20521,0.001202,172.217.194.0-255,1484,85851,90,197271
20522,0.001206,172.217.194.0-255,2184,88035,90,197271
20523,0.001208,172.31.47.0-255,66,88101,90,197271
20524,0.001543,172.217.194.0-255,1484,89585,90,197271
20525,0.00155,172.217.194.0-255,2902,92487,90,197271
20526,0.001552,172.31.47.0-255,66,92553,90,197271
20527,0.001557,172.217.194.0-255,2902,95455,90,197271
20528,0.001558,172.31.47.0-255,66,95521,90,197271
20529,0.001573,172.217.194.0-255,2902,98423,90,197271
20530,0.001575,172.31.47.0-255,66,98489,90,197271
20531,0.00158,172.217.194.0-255,5738,104227,90,197271
20532,0.001582,172.31.47.0-255,66,104293,90,197271
20533,0.001613,172.217.194.0-255,8574,112867,90,197271
20534,0.001615,172.31.47.0-255,66,112933,90,197271
20535,0.001639,172.217.194.0-255,4320,117253,90,197271
20536,0.001642,172.31.47.0-255,66,117319,90,197271
20537,0.001646,172.217.194.0-255,5020,122339,90,197271
20538,0.001648,172.31.47.0-255,66,122405,90,197271
20539,0.001716,172.217.194.0-255,1484,123889,90,197271
20540,0.001743,172.217.194.0-255,2902,126791,90,197271
20541,0.001745,172.31.47.0-255,66,126857,90,197271
20542,0.001751,172.217.194.0-255,5738,132595,90,197271
20543,0.001753,172.31.47.0-255,66,132661,90,197271
20544,0.001777,172.217.194.0-255,4320,136981,90,197271
20545,0.00178,172.31.47.0-255,66,137047,90,197271
20546,0.001791,172.217.194.0-255,2902,139949,90,197271
20547,0.001793,172.31.47.0-255,66,140015,90,197271
20548,0.0018,172.217.194.0-255,8574,148589,90,197271
20549,0.001802,172.31.47.0-255,66,148655,90,197271
20550,0.001836,172.217.194.0-255,7856,156511,90,197271
20551,0.001838,172.31.47.0-255,66,156577,90,197271
20552,0.001974,172.217.194.0-255,1484,158061,90,197271
20553,0.001989,172.217.194.0-255,2902,160963,90,197271
20554,0.001992,172.31.47.0-255,66,161029,90,197271
20555,0.001998,172.217.194.0-255,5738,166767,90,197271
20556,0.001999,172.31.47.0-255,66,166833,90,197271
20557,0.002022,172.217.194.0-255,7156,173989,90,197271
20558,0.002024,172.31.47.0-255,66,174055,90,197271
20559,0.002045,172.217.194.0-255,5738,179793,90,197271
20560,0.002047,172.31.47.0-255,66,179859,90,197271
20561,0.004028,172.217.194.0-255,5738,185597,90,197271
20562,0.004032,172.31.47.0-255,66,185663,90,197271
20563,0.006007,172.217.194.0-255,5738,191401,90,197271
20564,0.006013,172.31.47.0-255,66,191467,90,197271
20565,0.008182,172.217.194.0-255,5738,197205,90,197271
20566,0.008239,172.31.47.0-255,66,197271,90,197271
20567,0.0,172.217.194.0-255,153,153,90,218166
20568,1.6e-05,172.31.47.0-255,66,219,90,218166
20569,2.2e-05,172.217.194.0-255,1484,1703,90,218166
20570,2.6e-05,172.31.47.0-255,66,1769,90,218166
20571,3.1e-05,172.217.194.0-255,2902,4671,90,218166
20572,3.5e-05,172.31.47.0-255,66,4737,90,218166
20573,6.8e-05,172.217.194.0-255,7156,11893,90,218166
20574,7e-05,172.31.47.0-255,66,11959,90,218166
20575,7.7e-05,172.217.194.0-255,6319,18278,90,218166
20576,8e-05,172.31.47.0-255,66,18344,90,218166
20577,8.6e-05,172.217.194.0-255,7156,25500,90,218166
20578,8.8e-05,172.31.47.0-255,66,25566,90,218166
20579,0.000123,172.217.194.0-255,5379,30945,90,218166
20580,0.000125,172.31.47.0-255,66,31011,90,218166
20581,0.000172,172.217.194.0-255,1484,32495,90,218166
20582,0.000174,172.31.47.0-255,66,32561,90,218166
20583,0.000189,172.217.194.0-255,2902,35463,90,218166
20584,0.000192,172.31.47.0-255,66,35529,90,218166
20585,0.000197,172.217.194.0-255,5738,41267,90,218166
20586,0.000199,172.31.47.0-255,66,41333,90,218166
20587,0.000212,172.217.194.0-255,1484,42817,90,218166
20588,0.000214,172.31.47.0-255,66,42883,90,218166
20589,0.000246,172.31.47.0-255,66,42949,90,218166
20590,0.000253,172.217.194.0-255,7156,50105,90,218166
20591,0.000255,172.31.47.0-255,66,50171,90,218166
20592,0.000291,172.217.194.0-255,3915,54086,90,218166
20593,0.000293,172.31.47.0-255,66,54152,90,218166
20594,0.000318,172.217.194.0-255,364,54516,90,218166
20595,0.000321,172.31.47.0-255,66,54582,90,218166
20596,0.000382,172.217.194.0-255,1484,56066,90,218166
20597,0.000385,172.31.47.0-255,66,56132,90,218166
20598,0.00039,172.217.194.0-255,2902,59034,90,218166
20599,0.00042,172.217.194.0-255,5738,64772,90,218166
20600,0.000458,172.31.47.0-255,66,64838,90,218166
20601,0.000465,172.217.194.0-255,1484,66322,90,218166
20602,0.000471,172.217.194.0-255,7156,73478,90,218166
20603,0.000477,172.31.47.0-255,66,73544,90,218166
20604,0.000491,172.217.194.0-255,1484,75028,90,218166
20605,0.000508,172.217.194.0-255,2184,77212,90,218166
20606,0.000521,172.217.194.0-255,4320,81532,90,218166
20607,0.000528,172.31.47.0-255,66,81598,90,218166
20608,0.000535,172.217.194.0-255,1484,83082,90,218166
20609,0.000557,172.217.194.0-255,8574,91656,90,218166
20610,0.00056,172.217.194.0-255,1484,93140,90,218166
20611,0.000566,172.31.47.0-255,66,93206,90,218166
20612,0.000598,172.217.194.0-255,3602,96808,90,218166
20613,0.000605,172.31.47.0-255,66,96874,90,218166
20614,0.000888,172.217.194.0-255,1484,98358,90,218166
20615,0.000901,172.217.194.0-255,2902,101260,90,218166
20616,0.000904,172.217.194.0-255,1484,102744,90,218166
20617,0.000908,172.31.47.0-255,66,102810,90,218166
20618,0.000919,172.217.194.0-255,4320,107130,90,218166
20619,0.00094,172.31.47.0-255,66,107196,90,218166
20620,0.000955,172.217.194.0-255,5738,112934,90,218166
20621,0.000959,172.31.47.0-255,66,113000,90,218166
20622,0.000979,172.217.194.0-255,2902,115902,90,218166
20623,0.000999,172.217.194.0-255,2184,118086,90,218166
20624,0.001007,172.31.47.0-255,66,118152,90,218166
20625,0.001148,172.217.194.0-255,1484,119636,90,218166
20626,0.001152,172.217.194.0-255,2902,122538,90,218166
20627,0.001155,172.31.47.0-255,66,122604,90,218166
20628,0.001176,172.217.194.0-255,5738,128342,90,218166
20629,0.001212,172.31.47.0-255,66,128408,90,218166
20630,0.001239,172.217.194.0-255,9992,138400,90,218166
20631,0.001241,172.217.194.0-255,766,139166,90,218166
20632,0.00125,172.31.47.0-255,66,139232,90,218166
20633,0.00134,172.217.194.0-255,1484,140716,90,218166
20634,0.001343,172.217.194.0-255,1484,142200,90,218166
20635,0.00135,172.31.47.0-255,66,142266,90,218166
20636,0.001357,172.217.194.0-255,1484,143750,90,218166
20637,0.001363,172.217.194.0-255,5738,149488,90,218166
20638,0.001372,172.31.47.0-255,66,149554,90,218166
20639,0.001411,172.217.194.0-255,4320,153874,90,218166
20640,0.001447,172.217.194.0-255,6438,160312,90,218166
20641,0.001614,172.217.194.0-255,1484,161796,90,218166
20642,0.001618,172.217.194.0-255,1484,163280,90,218166
20643,0.001635,172.217.194.0-255,1484,164764,90,218166
20644,0.001637,172.217.194.0-255,1484,166248,90,218166
20645,0.001657,172.217.194.0-255,4320,170568,90,218166
20646,0.001663,172.217.194.0-255,4320,174888,90,218166
20647,0.0017,172.217.194.0-255,7156,182044,90,218166
20648,0.00172,172.217.194.0-255,4320,186364,90,218166
20649,0.001727,172.217.194.0-255,7156,193520,90,218166
20650,0.001761,172.217.194.0-255,5738,199258,90,218166
20651,0.001835,172.217.194.0-255,7156,206414,90,218166
20652,0.001884,172.217.194.0-255,5738,212152,90,218166
20653,0.001965,172.217.194.0-255,5738,217890,90,218166
20654,0.002009,172.217.194.0-255,105,217995,90,218166
20655,0.005732,172.31.47.0-255,66,218061,90,218166
20656,0.007761,172.31.47.0-255,105,218166,90,218166
20657,0.0,172.217.194.0-255,145,145,90,256639
20658,2.8e-05,172.31.47.0-255,66,211,90,256639
20659,3.4e-05,172.217.194.0-255,1484,1695,90,256639
20660,3.8e-05,172.31.47.0-255,66,1761,90,256639
20661,4.3e-05,172.217.194.0-255,2902,4663,90,256639
20662,4.6e-05,172.31.47.0-255,66,4729,90,256639
20663,6e-05,172.217.194.0-255,7156,11885,90,256639
20664,6.4e-05,172.31.47.0-255,66,11951,90,256639
20665,0.000117,172.31.47.0-255,66,12017,90,256639
20666,0.000121,172.217.194.0-255,2543,14560,90,256639
20667,0.000123,172.31.47.0-255,66,14626,90,256639
20668,0.000222,172.217.194.0-255,1484,16110,90,256639
20669,0.000227,172.31.47.0-255,66,16176,90,256639
20670,0.000231,172.217.194.0-255,2902,19078,90,256639
20671,0.000234,172.31.47.0-255,66,19144,90,256639
20672,0.000238,172.217.194.0-255,2902,22046,90,256639
20673,0.000246,172.31.47.0-255,66,22112,90,256639
20674,0.000281,172.217.194.0-255,7156,29268,90,256639
20675,0.000285,172.31.47.0-255,66,29334,90,256639
20676,0.000288,172.217.194.0-255,1484,30818,90,256639
20677,0.00029,172.31.47.0-255,66,30884,90,256639
20678,0.000337,172.31.47.0-255,66,30950,90,256639
20679,0.000379,172.217.194.0-255,2902,33852,90,256639
20680,0.000382,172.31.47.0-255,66,33918,90,256639
20681,0.000409,172.217.194.0-255,2866,36784,90,256639
20682,0.000412,172.31.47.0-255,66,36850,90,256639
20683,0.000416,172.217.194.0-255,363,37213,90,256639
20684,0.000419,172.31.47.0-255,66,37279,90,256639
20685,0.00055,172.217.194.0-255,1484,38763,90,256639
20686,0.000554,172.31.47.0-255,66,38829,90,256639
20687,0.000559,172.217.194.0-255,2902,41731,90,256639
20688,0.000562,172.31.47.0-255,66,41797,90,256639
20689,0.000565,172.217.194.0-255,1484,43281,90,256639
20690,0.000595,172.217.194.0-255,4320,47601,90,256639
20691,0.000599,172.31.47.0-255,66,47667,90,256639
20692,0.000607,172.217.194.0-255,8574,56241,90,256639
20693,0.00061,172.31.47.0-255,66,56307,90,256639
20694,0.00064,172.217.194.0-255,4320,60627,90,256639
20695,0.000643,172.31.47.0-255,66,60693,90,256639
20696,0.00066,172.217.194.0-255,8574,69267,90,256639
20697,0.000668,172.31.47.0-255,66,69333,90,256639
20698,0.000686,172.217.194.0-255,2184,71517,90,256639
20699,0.000689,172.31.47.0-255,66,71583,90,256639
20700,0.00122,172.217.194.0-255,1484,73067,90,256639
20701,0.00123,172.217.194.0-255,2902,75969,90,256639
20702,0.001234,172.31.47.0-255,66,76035,90,256639
20703,0.001265,172.217.194.0-255,5738,81773,90,256639
20704,0.00127,172.31.47.0-255,66,81839,90,256639
20705,0.001288,172.31.47.0-255,66,81905,90,256639
20706,0.001318,172.217.194.0-255,7156,89061,90,256639
20707,0.001322,172.31.47.0-255,66,89127,90,256639
20708,0.001351,172.217.194.0-255,2902,92029,90,256639
20709,0.001359,172.217.194.0-255,8574,100603,90,256639
20710,0.001364,172.31.47.0-255,66,100669,90,256639
20711,0.001368,172.31.47.0-255,66,100735,90,256639
20712,0.001397,172.217.194.0-255,2184,102919,90,256639
20713,0.001401,172.31.47.0-255,66,102985,90,256639
20714,0.001408,172.217.194.0-255,5738,108723,90,256639
20715,0.00141,172.31.47.0-255,66,108789,90,256639
20716,0.001463,172.31.47.0-255,66,108855,90,256639
20717,0.001467,172.217.194.0-255,766,109621,90,256639
20718,0.001505,172.217.194.0-255,1484,111105,90,256639
20719,0.001509,172.217.194.0-255,2902,114007,90,256639
20720,0.001514,172.31.47.0-255,66,114073,90,256639
20721,0.001523,172.31.47.0-255,66,114139,90,256639
20722,0.00153,172.217.194.0-255,1484,115623,90,256639
20723,0.001557,172.217.194.0-255,5738,121361,90,256639
20724,0.00156,172.31.47.0-255,66,121427,90,256639
20725,0.001595,172.217.194.0-255,8574,130001,90,256639
20726,0.001599,172.31.47.0-255,66,130067,90,256639
20727,0.001627,172.217.194.0-255,1484,131551,90,256639
20728,0.001642,172.31.47.0-255,66,131617,90,256639
20729,0.001645,172.217.194.0-255,766,132383,90,256639
20730,0.001801,172.217.194.0-255,1484,133867,90,256639
20731,0.001806,172.31.47.0-255,66,133933,90,256639
20732,0.001811,172.217.194.0-255,2902,136835,90,256639
20733,0.001814,172.31.47.0-255,66,136901,90,256639
20734,0.001844,172.217.194.0-255,5738,142639,90,256639
20735,0.001847,172.31.47.0-255,66,142705,90,256639
20736,0.001871,172.217.194.0-255,5738,148443,90,256639
20737,0.001874,172.31.47.0-255,66,148509,90,256639
20738,0.001901,172.217.194.0-255,1484,149993,90,256639
20739,0.00191,172.217.194.0-255,9992,159985,90,256639
20740,0.001912,172.31.47.0-255,66,160051,90,256639
20741,0.001945,172.217.194.0-255,2902,162953,90,256639
20742,0.001948,172.31.47.0-255,66,163019,90,256639
20743,0.001977,172.217.194.0-255,3602,166621,90,256639
20744,0.001979,172.31.47.0-255,66,166687,90,256639
20745,0.001987,172.217.194.0-255,7156,173843,90,256639
20746,0.001989,172.31.47.0-255,66,173909,90,256639
20747,0.00202,172.217.194.0-255,7156,181065,90,256639
20748,0.002023,172.31.47.0-255,66,181131,90,256639
20749,0.002099,172.31.47.0-255,66,181197,90,256639
20750,0.002102,172.217.194.0-255,1484,182681,90,256639
20751,0.002106,172.217.194.0-255,2184,184865,90,256639
20752,0.002108,172.31.47.0-255,66,184931,90,256639
20753,0.002173,172.217.194.0-255,1484,186415,90,256639
20754,0.002193,172.217.194.0-255,2902,189317,90,256639
20755,0.002197,172.31.47.0-255,66,189383,90,256639
20756,0.002202,172.217.194.0-255,2902,192285,90,256639
20757,0.002204,172.31.47.0-255,66,192351,90,256639
20758,0.002225,172.217.194.0-255,2902,195253,90,256639
20759,0.002232,172.31.47.0-255,66,195319,90,256639
20760,0.002244,172.31.47.0-255,66,195385,90,256639
20761,0.00225,172.217.194.0-255,5738,201123,90,256639
20762,0.002252,172.31.47.0-255,66,201189,90,256639
20763,0.002278,172.217.194.0-255,1484,202673,90,256639
20764,0.002282,172.217.194.0-255,1484,204157,90,256639
20765,0.002285,172.31.47.0-255,66,204223,90,256639
20766,0.002301,172.217.194.0-255,2184,206407,90,256639
20767,0.002304,172.31.47.0-255,66,206473,90,256639
20768,0.002308,172.217.194.0-255,2902,209375,90,256639
20769,0.002311,172.31.47.0-255,66,209441,90,256639
20770,0.002344,172.217.194.0-255,1484,210925,90,256639
20771,0.002353,172.217.194.0-255,9992,220917,90,256639
20772,0.002356,172.31.47.0-255,66,220983,90,256639
20773,0.002362,172.217.194.0-255,5738,226721,90,256639
20774,0.002364,172.31.47.0-255,66,226787,90,256639
20775,0.002388,172.217.194.0-255,2902,229689,90,256639
20776,0.00239,172.31.47.0-255,66,229755,90,256639
20777,0.002393,172.217.194.0-255,1484,231239,90,256639
20778,0.002422,172.217.194.0-255,9274,240513,90,256639
20779,0.002425,172.31.47.0-255,66,240579,90,256639
20780,0.00473,172.217.194.0-255,4320,244899,90,256639
20781,0.004736,172.31.47.0-255,66,244965,90,256639
20782,0.004766,172.217.194.0-255,1484,246449,90,256639
20783,0.007081,172.217.194.0-255,4320,250769,90,256639
20784,0.007087,172.31.47.0-255,66,250835,90,256639
20785,0.009426,172.217.194.0-255,5738,256573,90,256639
20786,0.009434,172.31.47.0-255,66,256639,90,256639
20787,0.0,172.217.194.0-255,152,152,90,263799
20788,2.4e-05,172.31.47.0-255,66,218,90,263799
20789,3e-05,172.217.194.0-255,1484,1702,90,263799
20790,3.4e-05,172.31.47.0-255,66,1768,90,263799
20791,3.8e-05,172.217.194.0-255,2902,4670,90,263799
20792,4.1e-05,172.31.47.0-255,66,4736,90,263799
20793,4.4e-05,172.217.194.0-255,1484,6220,90,263799
20794,4.7e-05,172.31.47.0-255,66,6286,90,263799
20795,5.2e-05,172.217.194.0-255,4320,10606,90,263799
20796,5.4e-05,172.31.47.0-255,66,10672,90,263799
20797,7.2e-05,172.217.194.0-255,1484,12156,90,263799
20798,7.4e-05,172.31.47.0-255,66,12222,90,263799
20799,0.000103,172.31.47.0-255,66,12288,90,263799
20800,0.000121,172.217.194.0-255,2039,14327,90,263799
20801,0.000123,172.31.47.0-255,66,14393,90,263799
20802,0.000128,172.217.194.0-255,5379,19772,90,263799
20803,0.00013,172.31.47.0-255,66,19838,90,263799
20804,0.000168,172.217.194.0-255,1484,21322,90,263799
20805,0.00017,172.31.47.0-255,66,21388,90,263799
20806,0.000175,172.217.194.0-255,2902,24290,90,263799
20807,0.000176,172.31.47.0-255,66,24356,90,263799
20808,0.000183,172.217.194.0-255,5738,30094,90,263799
20809,0.000185,172.31.47.0-255,66,30160,90,263799
20810,0.000187,172.217.194.0-255,1484,31644,90,263799
20811,0.000189,172.31.47.0-255,66,31710,90,263799
20812,0.000215,172.217.194.0-255,5379,37089,90,263799
20813,0.000217,172.31.47.0-255,66,37155,90,263799
20814,0.000226,172.217.194.0-255,9992,47147,90,263799
20815,0.000228,172.31.47.0-255,66,47213,90,263799
20816,0.000243,172.217.194.0-255,4320,51533,90,263799
20817,0.000246,172.31.47.0-255,66,51599,90,263799
20818,0.00025,172.217.194.0-255,2902,54501,90,263799
20819,0.000255,172.31.47.0-255,66,54567,90,263799
20820,0.000265,172.217.194.0-255,297,54864,90,263799
20821,0.000378,172.217.194.0-255,1484,56348,90,263799
20822,0.000384,172.31.47.0-255,66,56414,90,263799
20823,0.000394,172.217.194.0-255,2902,59316,90,263799
20824,0.0004,172.31.47.0-255,66,59382,90,263799
20825,0.0004,172.217.194.0-255,5738,65120,90,263799
20826,0.000404,172.31.47.0-255,66,65186,90,263799
20827,0.000424,172.217.194.0-255,5738,70924,90,263799
20828,0.000435,172.31.47.0-255,66,70990,90,263799
20829,0.000442,172.217.194.0-255,7156,78146,90,263799
20830,0.000451,172.31.47.0-255,66,78212,90,263799
20831,0.000468,172.217.194.0-255,5738,83950,90,263799
20832,0.00048,172.31.47.0-255,66,84016,90,263799
20833,0.000487,172.217.194.0-255,5020,89036,90,263799
20834,0.000493,172.31.47.0-255,66,89102,90,263799
20835,0.000667,172.217.194.0-255,1484,90586,90,263799
20836,0.000672,172.217.194.0-255,1484,92070,90,263799
20837,0.000675,172.31.47.0-255,66,92136,90,263799
20838,0.000695,172.217.194.0-255,1484,93620,90,263799
20839,0.000702,172.217.194.0-255,5738,99358,90,263799
20840,0.000707,172.31.47.0-255,66,99424,90,263799
20841,0.000739,172.217.194.0-255,1484,100908,90,263799
20842,0.000758,172.217.194.0-255,8574,109482,90,263799
20843,0.000767,172.217.194.0-255,8574,118056,90,263799
20844,0.000774,172.31.47.0-255,66,118122,90,263799
20845,0.000785,172.217.194.0-255,5020,123142,90,263799
20846,0.000788,172.31.47.0-255,66,123208,90,263799
20847,0.000805,172.31.47.0-255,66,123274,90,263799
20848,0.000809,172.217.194.0-255,2902,126176,90,263799
20849,0.000813,172.217.194.0-255,2902,129078,90,263799
20850,0.00083,172.31.47.0-255,66,129144,90,263799
20851,0.000856,172.217.194.0-255,1484,130628,90,263799
20852,0.00086,172.217.194.0-255,2902,133530,90,263799
20853,0.000866,172.31.47.0-255,66,133596,90,263799
20854,0.000881,172.217.194.0-255,5738,139334,90,263799
20855,0.000888,172.31.47.0-255,66,139400,90,263799
20856,0.000924,172.217.194.0-255,10692,150092,90,263799
20857,0.000924,172.31.47.0-255,66,150158,90,263799
20858,0.000929,172.31.47.0-255,66,150224,90,263799
20859,0.000975,172.217.194.0-255,1484,151708,90,263799
20860,0.000979,172.217.194.0-255,1484,153192,90,263799
20861,0.000989,172.31.47.0-255,66,153258,90,263799
20862,0.000993,172.217.194.0-255,1484,154742,90,263799
20863,0.000997,172.217.194.0-255,2902,157644,90,263799
20864,0.001006,172.31.47.0-255,66,157710,90,263799
20865,0.001011,172.217.194.0-255,2902,160612,90,263799
20866,0.001014,172.217.194.0-255,1484,162096,90,263799
20867,0.001022,172.31.47.0-255,66,162162,90,263799
20868,0.001044,172.217.194.0-255,2902,165064,90,263799
20869,0.00105,172.217.194.0-255,5738,170802,90,263799
20870,0.001056,172.31.47.0-255,66,170868,90,263799
20871,0.001063,172.217.194.0-255,2184,173052,90,263799
20872,0.001069,172.31.47.0-255,66,173118,90,263799
20873,0.001102,172.217.194.0-255,2902,176020,90,263799
20874,0.001106,172.217.194.0-255,1484,177504,90,263799
20875,0.001114,172.31.47.0-255,66,177570,90,263799
20876,0.001126,172.217.194.0-255,5738,183308,90,263799
20877,0.001139,172.217.194.0-255,2902,186210,90,263799
20878,0.001139,172.31.47.0-255,66,186276,90,263799
20879,0.001143,172.31.47.0-255,66,186342,90,263799
20880,0.00115,172.217.194.0-255,2902,189244,90,263799
20881,0.001156,172.31.47.0-255,66,189310,90,263799
20882,0.001187,172.217.194.0-255,7156,196466,90,263799
20883,0.001192,172.31.47.0-255,66,196532,90,263799
20884,0.001197,172.217.194.0-255,10692,207224,90,263799
20885,0.001204,172.31.47.0-255,66,207290,90,263799
20886,0.001269,172.217.194.0-255,1484,208774,90,263799
20887,0.001274,172.217.194.0-255,2902,211676,90,263799
20888,0.001284,172.217.194.0-255,1484,213160,90,263799
20889,0.001285,172.31.47.0-255,66,213226,90,263799
20890,0.001302,172.217.194.0-255,4320,217546,90,263799
20891,0.001305,172.217.194.0-255,1484,219030,90,263799
20892,0.00131,172.31.47.0-255,66,219096,90,263799
20893,0.001345,172.217.194.0-255,5738,224834,90,263799
20894,0.001345,172.31.47.0-255,66,224900,90,263799
20895,0.00135,172.31.47.0-255,66,224966,90,263799
20896,0.00143,172.31.47.0-255,66,225032,90,263799
20897,0.001434,172.217.194.0-255,6438,231470,90,263799
20898,0.001436,172.31.47.0-255,66,231536,90,263799
20899,0.001438,172.217.194.0-255,4320,235856,90,263799
20900,0.001449,172.31.47.0-255,66,235922,90,263799
20901,0.001453,172.217.194.0-255,2902,238824,90,263799
20902,0.001456,172.217.194.0-255,1484,240308,90,263799
20903,0.001462,172.31.47.0-255,66,240374,90,263799
20904,0.001494,172.217.194.0-255,6438,246812,90,263799
20905,0.001495,172.31.47.0-255,66,246878,90,263799
20906,0.001499,172.31.47.0-255,66,246944,90,263799
20907,0.001522,172.217.194.0-255,1484,248428,90,263799
20908,0.00156,172.31.47.0-255,66,248494,90,263799
20909,0.001573,172.217.194.0-255,8574,257068,90,263799
20910,0.00158,172.217.194.0-255,6323,263391,90,263799
20911,0.001587,172.31.47.0-255,66,263457,90,263799
20912,0.001631,172.217.194.0-255,105,263562,90,263799
20913,0.003207,172.31.47.0-255,66,263628,90,263799
20914,0.003231,172.31.47.0-255,105,263733,90,263799
20915,0.005714,172.217.194.0-255,66,263799,90,263799
20916,0.0,172.31.47.0-255,105,105,90,105
20917,0.0,74.125.24.0-255,153,153,90,258932
20918,1.3e-05,172.31.47.0-255,66,219,90,258932
20919,4.6e-05,74.125.24.0-255,1484,1703,90,258932
20920,5e-05,172.31.47.0-255,66,1769,90,258932
20921,5.5e-05,74.125.24.0-255,2902,4671,90,258932
20922,5.9e-05,172.31.47.0-255,66,4737,90,258932
20923,6.4e-05,74.125.24.0-255,4320,9057,90,258932
20924,6.6e-05,172.31.47.0-255,66,9123,90,258932
20925,7.5e-05,74.125.24.0-255,1484,10607,90,258932
20926,7.7e-05,172.31.47.0-255,66,10673,90,258932
20927,0.00011,74.125.24.0-255,7854,18527,90,258932
20928,0.000112,172.31.47.0-255,66,18593,90,258932
20929,0.000138,74.125.24.0-255,8574,27167,90,258932
20930,0.000141,172.31.47.0-255,66,27233,90,258932
20931,0.000157,172.31.47.0-255,66,27299,90,258932
20932,0.000177,74.125.24.0-255,1484,28783,90,258932
20933,0.000179,172.31.47.0-255,66,28849,90,258932
20934,0.000182,74.125.24.0-255,2184,31033,90,258932
20935,0.000184,172.31.47.0-255,66,31099,90,258932
20936,0.000226,172.31.47.0-255,66,31165,90,258932
20937,0.000424,74.125.24.0-255,1484,32649,90,258932
20938,0.000429,172.31.47.0-255,66,32715,90,258932
20939,0.000434,74.125.24.0-255,2902,35617,90,258932
20940,0.000436,172.31.47.0-255,66,35683,90,258932
20941,0.00044,74.125.24.0-255,4320,40003,90,258932
20942,0.000442,172.31.47.0-255,66,40069,90,258932
20943,0.000467,74.125.24.0-255,1484,41553,90,258932
20944,0.000469,172.31.47.0-255,66,41619,90,258932
20945,0.000481,172.31.47.0-255,66,41685,90,258932
20946,0.000506,74.125.24.0-255,1484,43169,90,258932
20947,0.000534,74.125.24.0-255,9274,52443,90,258932
20948,0.000537,172.31.47.0-255,66,52509,90,258932
20949,0.000685,74.125.24.0-255,1484,53993,90,258932
20950,0.000689,74.125.24.0-255,1484,55477,90,258932
20951,0.000691,172.31.47.0-255,66,55543,90,258932
20952,0.000713,74.125.24.0-255,1484,57027,90,258932
20953,0.000719,74.125.24.0-255,5738,62765,90,258932
20954,0.00072,172.31.47.0-255,66,62831,90,258932
20955,0.000725,74.125.24.0-255,4320,67151,90,258932
20956,0.000726,172.31.47.0-255,66,67217,90,258932
20957,0.000761,74.125.24.0-255,8574,75791,90,258932
20958,0.000763,172.31.47.0-255,66,75857,90,258932
20959,0.00077,74.125.24.0-255,9992,85849,90,258932
20960,0.000772,172.31.47.0-255,66,85915,90,258932
20961,0.000774,74.125.24.0-255,766,86681,90,258932
20962,0.000886,74.125.24.0-255,1484,88165,90,258932
20963,0.000889,172.31.47.0-255,66,88231,90,258932
20964,0.000892,74.125.24.0-255,2902,91133,90,258932
20965,0.000894,172.31.47.0-255,66,91199,90,258932
20966,0.000925,74.125.24.0-255,5738,96937,90,258932
20967,0.000927,172.31.47.0-255,66,97003,90,258932
20968,0.000963,172.31.47.0-255,66,97069,90,258932
20969,0.000968,74.125.24.0-255,5738,102807,90,258932
20970,0.00097,172.31.47.0-255,66,102873,90,258932
20971,0.00099,74.125.24.0-255,5020,107893,90,258932
20972,0.000992,172.31.47.0-255,66,107959,90,258932
20973,0.001526,74.125.24.0-255,1484,109443,90,258932
20974,0.001532,74.125.24.0-255,2902,112345,90,258932
20975,0.001535,172.31.47.0-255,66,112411,90,258932
20976,0.00154,74.125.24.0-255,2902,115313,90,258932
20977,0.001541,172.31.47.0-255,66,115379,90,258932
20978,0.001564,74.125.24.0-255,2902,118281,90,258932
20979,0.001566,172.31.47.0-255,66,118347,90,258932
20980,0.00157,74.125.24.0-255,2902,121249,90,258932
20981,0.001572,172.31.47.0-255,66,121315,90,258932
20982,0.001601,74.125.24.0-255,4320,125635,90,258932
20983,0.001603,172.31.47.0-255,66,125701,90,258932
20984,0.001612,74.125.24.0-255,9992,135693,90,258932
20985,0.001614,172.31.47.0-255,66,135759,90,258932
20986,0.001646,74.125.24.0-255,4320,140079,90,258932
20987,0.001649,172.31.47.0-255,66,140145,90,258932
20988,0.001653,74.125.24.0-255,2184,142329,90,258932
20989,0.001654,172.31.47.0-255,66,142395,90,258932
20990,0.001854,74.125.24.0-255,1484,143879,90,258932
20991,0.001857,74.125.24.0-255,1484,145363,90,258932
20992,0.001861,172.31.47.0-255,66,145429,90,258932
20993,0.001885,74.125.24.0-255,1484,146913,90,258932
20994,0.001891,74.125.24.0-255,5738,152651,90,258932
20995,0.001893,172.31.47.0-255,66,152717,90,258932
20996,0.001896,74.125.24.0-255,1484,154201,90,258932
20997,0.001929,172.31.47.0-255,66,154267,90,258932
20998,0.001936,74.125.24.0-255,7156,161423,90,258932
20999,0.001938,172.31.47.0-255,66,161489,90,258932
21000,0.00196,74.125.24.0-255,1484,162973,90,258932
21001,0.001978,74.125.24.0-255,4320,167293,90,258932
21002,0.00198,172.31.47.0-255,66,167359,90,258932
21003,0.002029,172.31.47.0-255,66,167425,90,258932
21004,0.002038,74.125.24.0-255,9992,177417,90,258932
21005,0.002039,172.31.47.0-255,66,177483,90,258932
21006,0.002049,74.125.24.0-255,5020,182503,90,258932
21007,0.002051,172.31.47.0-255,66,182569,90,258932
21008,0.002057,74.125.24.0-255,5738,188307,90,258932
21009,0.002059,172.31.47.0-255,66,188373,90,258932
21010,0.002063,74.125.24.0-255,2902,191275,90,258932
21011,0.002064,172.31.47.0-255,66,191341,90,258932
21012,0.002097,74.125.24.0-255,9992,201333,90,258932
21013,0.0021,172.31.47.0-255,66,201399,90,258932
21014,0.002105,74.125.24.0-255,5738,207137,90,258932
21015,0.002107,172.31.47.0-255,66,207203,90,258932
21016,0.002134,74.125.24.0-255,4320,211523,90,258932
21017,0.002137,172.31.47.0-255,66,211589,90,258932
21018,0.002164,74.125.24.0-255,6438,218027,90,258932
21019,0.002167,172.31.47.0-255,66,218093,90,258932
21020,0.002173,74.125.24.0-255,7156,225249,90,258932
21021,0.002176,172.31.47.0-255,66,225315,90,258932
21022,0.0022,74.125.24.0-255,4320,229635,90,258932
21023,0.002202,172.31.47.0-255,66,229701,90,258932
21024,0.00224,172.31.47.0-255,66,229767,90,258932
21025,0.002272,74.125.24.0-255,9274,239041,90,258932
21026,0.002275,172.31.47.0-255,66,239107,90,258932
21027,0.002291,172.31.47.0-255,66,239173,90,258932
21028,0.002298,74.125.24.0-255,9992,249165,90,258932
21029,0.0023,172.31.47.0-255,66,249231,90,258932
21030,0.002315,172.31.47.0-255,66,249297,90,258932
21031,0.00232,74.125.24.0-255,4320,253617,90,258932
21032,0.002322,172.31.47.0-255,66,253683,90,258932
21033,0.002363,172.31.47.0-255,66,253749,90,258932
21034,0.002368,74.125.24.0-255,4678,258427,90,258932
21035,0.002371,172.31.47.0-255,66,258493,90,258932
21036,0.002386,74.125.24.0-255,97,258590,90,258932
21037,0.002389,74.125.24.0-255,105,258695,90,258932
21038,0.004274,172.31.47.0-255,66,258761,90,258932
21039,0.004311,172.31.47.0-255,105,258866,90,258932
21040,0.006631,74.125.24.0-255,66,258932,90,258932
21041,0.0,172.217.194.0-255,146,146,90,264285
21042,2.3e-05,172.31.47.0-255,66,212,90,264285
21043,3e-05,172.217.194.0-255,1484,1696,90,264285
21044,3.6e-05,172.31.47.0-255,66,1762,90,264285
21045,4.2e-05,172.217.194.0-255,2902,4664,90,264285
21046,4.5e-05,172.31.47.0-255,66,4730,90,264285
21047,5.1e-05,172.217.194.0-255,4320,9050,90,264285
21048,5.4e-05,172.31.47.0-255,66,9116,90,264285
21049,6e-05,172.217.194.0-255,4964,14080,90,264285
21050,6.3e-05,172.31.47.0-255,66,14146,90,264285
21051,0.000109,172.217.194.0-255,9992,24138,90,264285
21052,0.000112,172.31.47.0-255,66,24204,90,264285
21053,0.000143,172.217.194.0-255,2902,27106,90,264285
21054,0.000146,172.31.47.0-255,66,27172,90,264285
21055,0.000166,172.217.194.0-255,3961,31133,90,264285
21056,0.000168,172.31.47.0-255,66,31199,90,264285
21057,0.000237,172.217.194.0-255,1484,32683,90,264285
21058,0.00024,172.31.47.0-255,66,32749,90,264285
21059,0.000261,172.217.194.0-255,2902,35651,90,264285
21060,0.000264,172.31.47.0-255,66,35717,90,264285
21061,0.00027,172.217.194.0-255,5738,41455,90,264285
21062,0.000272,172.31.47.0-255,66,41521,90,264285
21063,0.000286,172.217.194.0-255,1484,43005,90,264285
21064,0.000288,172.31.47.0-255,66,43071,90,264285
21065,0.000315,172.217.194.0-255,5379,48450,90,264285
21066,0.000318,172.31.47.0-255,66,48516,90,264285
21067,0.000367,172.217.194.0-255,1484,50000,90,264285
21068,0.000371,172.31.47.0-255,66,50066,90,264285
21069,0.000376,172.217.194.0-255,2902,52968,90,264285
21070,0.000378,172.31.47.0-255,66,53034,90,264285
21071,0.00039,172.217.194.0-255,2902,55936,90,264285
21072,0.000392,172.31.47.0-255,66,56002,90,264285
21073,0.000412,172.217.194.0-255,1484,57486,90,264285
21074,0.000418,172.217.194.0-255,2902,60388,90,264285
21075,0.000434,172.217.194.0-255,5678,66066,90,264285
21076,0.000437,172.217.194.0-255,377,66443,90,264285
21077,0.000494,172.31.47.0-255,66,66509,90,264285
21078,0.000628,172.217.194.0-255,1484,67993,90,264285
21079,0.000633,172.217.194.0-255,2902,70895,90,264285
21080,0.000642,172.31.47.0-255,66,70961,90,264285
21081,0.000653,172.217.194.0-255,4320,75281,90,264285
21082,0.000666,172.217.194.0-255,4320,79601,90,264285
21083,0.000678,172.31.47.0-255,66,79667,90,264285
21084,0.000687,172.217.194.0-255,4320,83987,90,264285
21085,0.000691,172.31.47.0-255,66,84053,90,264285
21086,0.000712,172.217.194.0-255,5738,89791,90,264285
21087,0.000719,172.31.47.0-255,66,89857,90,264285
21088,0.000731,172.217.194.0-255,9992,99849,90,264285
21089,0.00074,172.217.194.0-255,766,100615,90,264285
21090,0.000741,172.31.47.0-255,66,100681,90,264285
21091,0.001255,172.31.47.0-255,66,100747,90,264285
21092,0.001495,172.217.194.0-255,1484,102231,90,264285
21093,0.001504,172.217.194.0-255,2902,105133,90,264285
21094,0.001519,172.217.194.0-255,4320,109453,90,264285
21095,0.001528,172.217.194.0-255,1484,110937,90,264285
21096,0.00153,172.217.194.0-255,1484,112421,90,264285
21097,0.001543,172.217.194.0-255,5738,118159,90,264285
21098,0.001566,172.217.194.0-255,5738,123897,90,264285
21099,0.001572,172.217.194.0-255,5738,129635,90,264285
21100,0.001585,172.217.194.0-255,4320,133955,90,264285
21101,0.001602,172.217.194.0-255,766,134721,90,264285
21102,0.001874,172.217.194.0-255,1484,136205,90,264285
21103,0.001881,172.217.194.0-255,2902,139107,90,264285
21104,0.001924,172.217.194.0-255,1484,140591,90,264285
21105,0.001941,172.217.194.0-255,4320,144911,90,264285
21106,0.001947,172.217.194.0-255,8574,153485,90,264285
21107,0.001955,172.217.194.0-255,9992,163477,90,264285
21108,0.001976,172.217.194.0-255,5020,168497,90,264285
21109,0.002002,172.217.194.0-255,1484,169981,90,264285
21110,0.002015,172.217.194.0-255,2902,172883,90,264285
21111,0.00204,172.217.194.0-255,5738,178621,90,264285
21112,0.002045,172.217.194.0-255,4320,182941,90,264285
21113,0.002059,172.217.194.0-255,5738,188679,90,264285
21114,0.002085,172.217.194.0-255,1484,190163,90,264285
21115,0.00213,172.217.194.0-255,2184,192347,90,264285
21116,0.002154,172.217.194.0-255,4320,196667,90,264285
21117,0.002175,172.217.194.0-255,7156,203823,90,264285
21118,0.002196,172.217.194.0-255,6438,210261,90,264285
21119,0.0022,172.217.194.0-255,2902,213163,90,264285
21120,0.002243,172.217.194.0-255,4320,217483,90,264285
21121,0.00225,172.217.194.0-255,2902,220385,90,264285
21122,0.00227,172.217.194.0-255,9992,230377,90,264285
21123,0.002283,172.217.194.0-255,6438,236815,90,264285
21124,0.002288,172.217.194.0-255,4320,241135,90,264285
21125,0.002309,172.217.194.0-255,8574,249709,90,264285
21126,0.002313,172.217.194.0-255,2902,252611,90,264285
21127,0.004407,172.31.47.0-255,66,252677,90,264285
21128,0.006962,172.217.194.0-255,5738,258415,90,264285
21129,0.006967,172.31.47.0-255,66,258481,90,264285
21130,0.009519,172.217.194.0-255,5738,264219,90,264285
21131,0.009529,172.31.47.0-255,66,264285,90,264285
21132,0.0,172.31.47.0-255,66,66,90,66
21133,0.0,172.31.47.0-255,105,105,90,210
21134,0.001857,157.240.13.0-255,105,210,90,210
21135,0.0,172.31.47.0-255,105,105,90,105
21136,0.0,172.31.47.0-255,105,105,90,276
21137,0.001771,157.240.13.0-255,105,210,90,276
21138,0.001783,172.31.47.0-255,66,276,90,276
21139,0.0,74.125.200.0-255,298,298,90,210401
21140,2.4e-05,172.31.47.0-255,66,364,90,210401
21141,5.6e-05,74.125.200.0-255,1484,1848,90,210401
21142,6e-05,172.31.47.0-255,66,1914,90,210401
21143,0.000101,74.125.200.0-255,1484,3398,90,210401
21144,0.000104,172.31.47.0-255,66,3464,90,210401
21145,0.000123,74.125.200.0-255,2902,6366,90,210401
21146,0.000126,172.31.47.0-255,66,6432,90,210401
21147,0.000152,74.125.200.0-255,5738,12170,90,210401
21148,0.000154,172.31.47.0-255,66,12236,90,210401
21149,0.000158,74.125.200.0-255,2902,15138,90,210401
21150,0.000161,172.31.47.0-255,66,15204,90,210401
21151,0.000191,74.125.200.0-255,3332,18536,90,210401
21152,0.000194,172.31.47.0-255,66,18602,90,210401
21153,0.0002,74.125.200.0-255,7156,25758,90,210401
21154,0.000202,172.31.47.0-255,66,25824,90,210401
21155,0.000205,74.125.200.0-255,1484,27308,90,210401
21156,0.000207,172.31.47.0-255,66,27374,90,210401
21157,0.000239,74.125.200.0-255,3961,31335,90,210401
21158,0.000241,172.31.47.0-255,66,31401,90,210401
21159,0.0003,74.125.200.0-255,1484,32885,90,210401
21160,0.000304,172.31.47.0-255,66,32951,90,210401
21161,0.000309,74.125.200.0-255,1484,34435,90,210401
21162,0.000311,172.31.47.0-255,66,34501,90,210401
21163,0.000332,74.125.200.0-255,2902,37403,90,210401
21164,0.00034,74.125.200.0-255,2902,40305,90,210401
21165,0.00034,172.31.47.0-255,66,40371,90,210401
21166,0.000343,172.31.47.0-255,66,40437,90,210401
21167,0.000355,74.125.200.0-255,2902,43339,90,210401
21168,0.00036,172.31.47.0-255,66,43405,90,210401
21169,0.000366,74.125.200.0-255,5379,48784,90,210401
21170,0.000368,172.31.47.0-255,66,48850,90,210401
21171,0.0004,74.125.200.0-255,5738,54588,90,210401
21172,0.000403,172.31.47.0-255,66,54654,90,210401
21173,0.000415,74.125.200.0-255,2902,57556,90,210401
21174,0.000417,172.31.47.0-255,66,57622,90,210401
21175,0.00045,74.125.200.0-255,8521,66143,90,210401
21176,0.000453,74.125.200.0-255,110,66253,90,210401
21177,0.000454,172.31.47.0-255,66,66319,90,210401
21178,0.000475,74.125.200.0-255,336,66655,90,210401
21179,0.000737,172.31.47.0-255,66,66721,90,210401
21180,0.000748,74.125.200.0-255,1484,68205,90,210401
21181,0.000751,74.125.200.0-255,1484,69689,90,210401
21182,0.000757,172.31.47.0-255,66,69755,90,210401
21183,0.000782,74.125.200.0-255,1484,71239,90,210401
21184,0.000786,74.125.200.0-255,2902,74141,90,210401
21185,0.000788,172.31.47.0-255,66,74207,90,210401
21186,0.000793,74.125.200.0-255,4320,78527,90,210401
21187,0.000794,172.31.47.0-255,66,78593,90,210401
21188,0.000819,74.125.200.0-255,8574,87167,90,210401
21189,0.000822,172.31.47.0-255,66,87233,90,210401
21190,0.000826,74.125.200.0-255,2902,90135,90,210401
21191,0.000827,172.31.47.0-255,66,90201,90,210401
21192,0.000832,74.125.200.0-255,4320,94521,90,210401
21193,0.000833,172.31.47.0-255,66,94587,90,210401
21194,0.000875,74.125.200.0-255,6438,101025,90,210401
21195,0.000879,172.31.47.0-255,66,101091,90,210401
21196,0.001342,74.125.200.0-255,1484,102575,90,210401
21197,0.00135,74.125.200.0-255,2902,105477,90,210401
21198,0.001353,172.31.47.0-255,66,105543,90,210401
21199,0.001387,74.125.200.0-255,5738,111281,90,210401
21200,0.00139,172.31.47.0-255,66,111347,90,210401
21201,0.001394,74.125.200.0-255,2902,114249,90,210401
21202,0.001396,172.31.47.0-255,66,114315,90,210401
21203,0.0014,74.125.200.0-255,4320,118635,90,210401
21204,0.001407,172.31.47.0-255,66,118701,90,210401
21205,0.001435,74.125.200.0-255,2902,121603,90,210401
21206,0.001438,172.31.47.0-255,66,121669,90,210401
21207,0.001464,74.125.200.0-255,4320,125989,90,210401
21208,0.001467,172.31.47.0-255,66,126055,90,210401
21209,0.001473,74.125.200.0-255,5738,131793,90,210401
21210,0.001474,172.31.47.0-255,66,131859,90,210401
21211,0.0015,74.125.200.0-255,2902,134761,90,210401
21212,0.001502,172.31.47.0-255,66,134827,90,210401
21213,0.001505,74.125.200.0-255,766,135593,90,210401
21214,0.001527,74.125.200.0-255,1484,137077,90,210401
21215,0.001529,172.31.47.0-255,66,137143,90,210401
21216,0.001546,74.125.200.0-255,2902,140045,90,210401
21217,0.001548,172.31.47.0-255,66,140111,90,210401
21218,0.001574,74.125.200.0-255,1484,141595,90,210401
21219,0.001596,74.125.200.0-255,4320,145915,90,210401
21220,0.001599,172.31.47.0-255,66,145981,90,210401
21221,0.001606,74.125.200.0-255,9992,155973,90,210401
21222,0.001609,172.31.47.0-255,66,156039,90,210401
21223,0.001649,172.31.47.0-255,66,156105,90,210401
21224,0.001652,74.125.200.0-255,2184,158289,90,210401
21225,0.001654,172.31.47.0-255,66,158355,90,210401
21226,0.001849,74.125.200.0-255,1484,159839,90,210401
21227,0.001866,74.125.200.0-255,2902,162741,90,210401
21228,0.001869,172.31.47.0-255,66,162807,90,210401
21229,0.001894,74.125.200.0-255,2902,165709,90,210401
21230,0.001896,172.31.47.0-255,66,165775,90,210401
21231,0.001918,74.125.200.0-255,4320,170095,90,210401
21232,0.00192,172.31.47.0-255,66,170161,90,210401
21233,0.001948,74.125.200.0-255,8574,178735,90,210401
21234,0.001949,172.31.47.0-255,66,178801,90,210401
21235,0.001953,74.125.200.0-255,4320,183121,90,210401
21236,0.001955,172.31.47.0-255,66,183187,90,210401
21237,0.001991,74.125.200.0-255,1484,184671,90,210401
21238,0.002014,74.125.200.0-255,7856,192527,90,210401
21239,0.002016,172.31.47.0-255,66,192593,90,210401
21240,0.004265,74.125.200.0-255,2902,195495,90,210401
21241,0.004269,172.31.47.0-255,66,195561,90,210401
21242,0.004292,74.125.200.0-255,2902,198463,90,210401
21243,0.004294,172.31.47.0-255,66,198529,90,210401
21244,0.006526,74.125.200.0-255,2902,201431,90,210401
21245,0.006533,172.31.47.0-255,66,201497,90,210401
21246,0.006562,74.125.200.0-255,2902,204399,90,210401
21247,0.006566,172.31.47.0-255,66,204465,90,210401
21248,0.00879,74.125.200.0-255,2902,207367,90,210401
21249,0.008797,172.31.47.0-255,66,207433,90,210401
21250,0.00883,74.125.200.0-255,2902,210335,90,210401
21251,0.008834,172.31.47.0-255,66,210401,90,210401
21252,0.0,172.217.194.0-255,153,153,90,140466
21253,2.3e-05,172.31.47.0-255,66,219,90,140466
21254,3.1e-05,172.217.194.0-255,1484,1703,90,140466
21255,3.5e-05,172.31.47.0-255,66,1769,90,140466
21256,4.1e-05,172.217.194.0-255,2902,4671,90,140466
21257,5.1e-05,172.31.47.0-255,66,4737,90,140466
21258,5.8e-05,172.217.194.0-255,5738,10475,90,140466
21259,6.1e-05,172.31.47.0-255,66,10541,90,140466
21260,6.4e-05,172.217.194.0-255,1484,12025,90,140466
21261,6.7e-05,172.31.47.0-255,66,12091,90,140466
21262,0.0001,172.217.194.0-255,2097,14188,90,140466
21263,0.000103,172.31.47.0-255,66,14254,90,140466
21264,0.000214,172.217.194.0-255,1484,15738,90,140466
21265,0.000218,172.31.47.0-255,66,15804,90,140466
21266,0.000224,172.217.194.0-255,2902,18706,90,140466
21267,0.000226,172.31.47.0-255,66,18772,90,140466
21268,0.000229,172.217.194.0-255,1484,20256,90,140466
21269,0.000231,172.31.47.0-255,66,20322,90,140466
21270,0.000255,172.217.194.0-255,4320,24642,90,140466
21271,0.000258,172.31.47.0-255,66,24708,90,140466
21272,0.000288,172.217.194.0-255,6797,31505,90,140466
21273,0.000291,172.31.47.0-255,66,31571,90,140466
21274,0.000331,172.217.194.0-255,1484,33055,90,140466
21275,0.000333,172.31.47.0-255,66,33121,90,140466
21276,0.000338,172.217.194.0-255,2902,36023,90,140466
21277,0.00034,172.31.47.0-255,66,36089,90,140466
21278,0.00037,172.217.194.0-255,5738,41827,90,140466
21279,0.000373,172.31.47.0-255,66,41893,90,140466
21280,0.000381,172.217.194.0-255,6797,48690,90,140466
21281,0.000383,172.31.47.0-255,66,48756,90,140466
21282,0.00048,172.217.194.0-255,1484,50240,90,140466
21283,0.000484,172.31.47.0-255,66,50306,90,140466
21284,0.000511,172.217.194.0-255,2902,53208,90,140466
21285,0.00052,172.217.194.0-255,5738,58946,90,140466
21286,0.000527,172.217.194.0-255,6797,65743,90,140466
21287,0.000553,172.217.194.0-255,345,66088,90,140466
21288,0.000568,172.31.47.0-255,66,66154,90,140466
21289,0.000585,172.217.194.0-255,428,66582,90,140466
21290,0.000886,172.217.194.0-255,1484,68066,90,140466
21291,0.00089,172.217.194.0-255,1484,69550,90,140466
21292,0.000895,172.31.47.0-255,66,69616,90,140466
21293,0.000905,172.217.194.0-255,1484,71100,90,140466
21294,0.000922,172.217.194.0-255,5738,76838,90,140466
21295,0.000947,172.217.194.0-255,1484,78322,90,140466
21296,0.000959,172.217.194.0-255,4320,82642,90,140466
21297,0.000964,172.217.194.0-255,4320,86962,90,140466
21298,0.000979,172.31.47.0-255,66,87028,90,140466
21299,0.001,172.217.194.0-255,8574,95602,90,140466
21300,0.001007,172.217.194.0-255,5020,100622,90,140466
21301,0.001026,172.31.47.0-255,66,100688,90,140466
21302,0.002085,172.217.194.0-255,1484,102172,90,140466
21303,0.002096,172.217.194.0-255,2902,105074,90,140466
21304,0.0021,172.31.47.0-255,66,105140,90,140466
21305,0.002108,172.217.194.0-255,5738,110878,90,140466
21306,0.002119,172.217.194.0-255,4320,115198,90,140466
21307,0.002126,172.217.194.0-255,7156,122354,90,140466
21308,0.002143,172.217.194.0-255,4320,126674,90,140466
21309,0.00216,172.217.194.0-255,2902,129576,90,140466
21310,0.002181,172.217.194.0-255,5020,134596,90,140466
21311,0.006724,172.31.47.0-255,66,134662,90,140466
21312,0.008864,172.217.194.0-255,5738,140400,90,140466
21313,0.008877,172.31.47.0-255,66,140466,90,140466
21314,0.0,172.217.194.0-255,153,153,90,173005
21315,2.9e-05,172.31.47.0-255,66,219,90,173005
21316,3.7e-05,172.217.194.0-255,1484,1703,90,173005
21317,4.1e-05,172.31.47.0-255,66,1769,90,173005
21318,4.7e-05,172.217.194.0-255,2902,4671,90,173005
21319,4.9e-05,172.31.47.0-255,66,4737,90,173005
21320,6.4e-05,172.217.194.0-255,7156,11893,90,173005
21321,6.7e-05,172.31.47.0-255,66,11959,90,173005
21322,7.3e-05,172.217.194.0-255,5738,17697,90,173005
21323,7.5e-05,172.31.47.0-255,66,17763,90,173005
21324,0.000114,172.217.194.0-255,6396,24159,90,173005
21325,0.000117,172.31.47.0-255,66,24225,90,173005
21326,0.000124,172.217.194.0-255,6797,31022,90,173005
21327,0.000127,172.31.47.0-255,66,31088,90,173005
21328,0.000173,172.217.194.0-255,7156,38244,90,173005
21329,0.000176,172.31.47.0-255,66,38310,90,173005
21330,0.000183,172.217.194.0-255,7156,45466,90,173005
21331,0.000185,172.31.47.0-255,66,45532,90,173005
21332,0.000216,172.217.194.0-255,6797,52329,90,173005
21333,0.000219,172.31.47.0-255,66,52395,90,173005
21334,0.000226,172.217.194.0-255,7156,59551,90,173005
21335,0.000228,172.31.47.0-255,66,59617,90,173005
21336,0.00025,172.217.194.0-255,1484,61101,90,173005
21337,0.000255,172.31.47.0-255,66,61167,90,173005
21338,0.000264,172.217.194.0-255,3961,65128,90,173005
21339,0.000266,172.31.47.0-255,66,65194,90,173005
21340,0.00041,172.217.194.0-255,645,65839,90,173005
21341,0.000414,172.31.47.0-255,66,65905,90,173005
21342,0.001038,172.217.194.0-255,1484,67389,90,173005
21343,0.001044,172.31.47.0-255,66,67455,90,173005
21344,0.001053,172.217.194.0-255,2902,70357,90,173005
21345,0.001056,172.31.47.0-255,66,70423,90,173005
21346,0.001062,172.217.194.0-255,5738,76161,90,173005
21347,0.001064,172.31.47.0-255,66,76227,90,173005
21348,0.001079,172.217.194.0-255,8574,84801,90,173005
21349,0.001082,172.31.47.0-255,66,84867,90,173005
21350,0.001134,172.217.194.0-255,4320,89187,90,173005
21351,0.001138,172.31.47.0-255,66,89253,90,173005
21352,0.001174,172.217.194.0-255,10692,99945,90,173005
21353,0.001177,172.31.47.0-255,66,100011,90,173005
21354,0.001338,172.217.194.0-255,1484,101495,90,173005
21355,0.001345,172.217.194.0-255,2902,104397,90,173005
21356,0.001348,172.31.47.0-255,66,104463,90,173005
21357,0.001388,172.217.194.0-255,4320,108783,90,173005
21358,0.00139,172.31.47.0-255,66,108849,90,173005
21359,0.001409,172.217.194.0-255,1484,110333,90,173005
21360,0.001421,172.31.47.0-255,66,110399,90,173005
21361,0.001424,172.217.194.0-255,1484,111883,90,173005
21362,0.00145,172.217.194.0-255,5738,117621,90,173005
21363,0.001452,172.31.47.0-255,66,117687,90,173005
21364,0.001483,172.217.194.0-255,3602,121289,90,173005
21365,0.001485,172.31.47.0-255,66,121355,90,173005
21366,0.001512,172.217.194.0-255,1484,122839,90,173005
21367,0.001517,172.217.194.0-255,2902,125741,90,173005
21368,0.001519,172.31.47.0-255,66,125807,90,173005
21369,0.001522,172.217.194.0-255,1484,127291,90,173005
21370,0.001547,172.217.194.0-255,4320,131611,90,173005
21371,0.001549,172.31.47.0-255,66,131677,90,173005
21372,0.001555,172.217.194.0-255,5738,137415,90,173005
21373,0.001557,172.31.47.0-255,66,137481,90,173005
21374,0.001591,172.217.194.0-255,7156,144637,90,173005
21375,0.001593,172.31.47.0-255,66,144703,90,173005
21376,0.001598,172.217.194.0-255,4320,149023,90,173005
21377,0.0016,172.31.47.0-255,66,149089,90,173005
21378,0.001619,172.217.194.0-255,6438,155527,90,173005
21379,0.001622,172.31.47.0-255,66,155593,90,173005
21380,0.003883,172.217.194.0-255,5738,161331,90,173005
21381,0.003886,172.31.47.0-255,66,161397,90,173005
21382,0.006146,172.217.194.0-255,5738,167135,90,173005
21383,0.006151,172.31.47.0-255,66,167201,90,173005
21384,0.00841,172.217.194.0-255,5738,172939,90,173005
21385,0.008418,172.31.47.0-255,66,173005,90,173005
21386,0.0,74.125.200.0-255,373,373,90,55136
21387,1.9e-05,172.31.47.0-255,66,439,90,55136
21388,2.5e-05,74.125.200.0-255,1484,1923,90,55136
21389,2.9e-05,172.31.47.0-255,66,1989,90,55136
21390,6e-05,74.125.200.0-255,4320,6309,90,55136
21391,6.3e-05,172.31.47.0-255,66,6375,90,55136
21392,0.000235,74.125.200.0-255,2902,9277,90,55136
21393,0.00024,172.31.47.0-255,66,9343,90,55136
21394,0.000271,74.125.200.0-255,4806,14149,90,55136
21395,0.000275,172.31.47.0-255,66,14215,90,55136
21396,0.000572,74.125.200.0-255,5738,19953,90,55136
21397,0.000577,172.31.47.0-255,66,20019,90,55136
21398,0.0006,74.125.200.0-255,8574,28593,90,55136
21399,0.000602,172.31.47.0-255,66,28659,90,55136
21400,0.001208,74.125.200.0-255,2667,31326,90,55136
21401,0.001215,172.31.47.0-255,66,31392,90,55136
21402,0.002629,74.125.200.0-255,2902,34294,90,55136
21403,0.002636,172.31.47.0-255,66,34360,90,55136
21404,0.003249,74.125.200.0-255,2902,37262,90,55136
21405,0.003253,172.31.47.0-255,66,37328,90,55136
21406,0.004672,74.125.200.0-255,2902,40230,90,55136
21407,0.004676,172.31.47.0-255,66,40296,90,55136
21408,0.005278,74.125.200.0-255,2902,43198,90,55136
21409,0.005284,172.31.47.0-255,66,43264,90,55136
21410,0.006709,74.125.200.0-255,2902,46166,90,55136
21411,0.006716,172.31.47.0-255,66,46232,90,55136
21412,0.007307,74.125.200.0-255,2902,49134,90,55136
21413,0.007314,172.31.47.0-255,66,49200,90,55136
21414,0.008738,74.125.200.0-255,2902,52102,90,55136
21415,0.008745,172.31.47.0-255,66,52168,90,55136
21416,0.009335,74.125.200.0-255,2902,55070,90,55136
21417,0.009341,172.31.47.0-255,66,55136,90,55136
21418,0.0,74.125.200.0-255,153,153,90,151870
21419,1.7e-05,172.31.47.0-255,66,219,90,151870
21420,2.3e-05,74.125.200.0-255,1484,1703,90,151870
21421,2.7e-05,172.31.47.0-255,66,1769,90,151870
21422,4.4e-05,74.125.200.0-255,2902,4671,90,151870
21423,4.9e-05,172.31.47.0-255,66,4737,90,151870
21424,5.5e-05,74.125.200.0-255,5738,10475,90,151870
21425,5.7e-05,172.31.47.0-255,66,10541,90,151870
21426,9e-05,74.125.200.0-255,3636,14177,90,151870
21427,9.3e-05,172.31.47.0-255,66,14243,90,151870
21428,0.000435,74.125.200.0-255,1484,15727,90,151870
21429,0.000441,172.31.47.0-255,66,15793,90,151870
21430,0.000447,74.125.200.0-255,2902,18695,90,151870
21431,0.000449,172.31.47.0-255,66,18761,90,151870
21432,0.000453,74.125.200.0-255,2902,21663,90,151870
21433,0.000461,172.31.47.0-255,66,21729,90,151870
21434,0.000492,74.125.200.0-255,2902,24631,90,151870
21435,0.000495,172.31.47.0-255,66,24697,90,151870
21436,0.000503,74.125.200.0-255,6797,31494,90,151870
21437,0.000512,172.31.47.0-255,66,31560,90,151870
21438,0.000642,74.125.200.0-255,1484,33044,90,151870
21439,0.000646,172.31.47.0-255,66,33110,90,151870
21440,0.000667,74.125.200.0-255,2902,36012,90,151870
21441,0.000669,172.31.47.0-255,66,36078,90,151870
21442,0.000674,74.125.200.0-255,5738,41816,90,151870
21443,0.000676,172.31.47.0-255,66,41882,90,151870
21444,0.000678,74.125.200.0-255,1484,43366,90,151870
21445,0.000681,74.125.200.0-255,1484,44850,90,151870
21446,0.000681,172.31.47.0-255,66,44916,90,151870
21447,0.000684,172.31.47.0-255,66,44982,90,151870
21448,0.000713,74.125.200.0-255,1484,46466,90,151870
21449,0.000716,172.31.47.0-255,66,46532,90,151870
21450,0.000745,74.125.200.0-255,2543,49075,90,151870
21451,0.000748,172.31.47.0-255,66,49141,90,151870
21452,0.000774,74.125.200.0-255,2902,52043,90,151870
21453,0.000778,172.31.47.0-255,66,52109,90,151870
21454,0.000808,74.125.200.0-255,4320,56429,90,151870
21455,0.000812,172.31.47.0-255,66,56495,90,151870
21456,0.00082,74.125.200.0-255,8574,65069,90,151870
21457,0.000823,172.31.47.0-255,66,65135,90,151870
21458,0.000826,74.125.200.0-255,1125,66260,90,151870
21459,0.000984,172.31.47.0-255,66,66326,90,151870
21460,0.001029,74.125.200.0-255,410,66736,90,151870
21461,0.001069,74.125.200.0-255,334,67070,90,151870
21462,0.001073,172.31.47.0-255,66,67136,90,151870
21463,0.001103,172.31.47.0-255,66,67202,90,151870
21464,0.001542,74.125.200.0-255,1484,68686,90,151870
21465,0.001553,74.125.200.0-255,2902,71588,90,151870
21466,0.001557,172.31.47.0-255,66,71654,90,151870
21467,0.001588,74.125.200.0-255,5738,77392,90,151870
21468,0.00159,172.31.47.0-255,66,77458,90,151870
21469,0.001593,74.125.200.0-255,1484,78942,90,151870
21470,0.001622,74.125.200.0-255,1484,80426,90,151870
21471,0.001624,172.31.47.0-255,66,80492,90,151870
21472,0.001653,74.125.200.0-255,7156,87648,90,151870
21473,0.001655,172.31.47.0-255,66,87714,90,151870
21474,0.001658,74.125.200.0-255,1484,89198,90,151870
21475,0.001677,74.125.200.0-255,4320,93518,90,151870
21476,0.001679,172.31.47.0-255,66,93584,90,151870
21477,0.001707,74.125.200.0-255,7156,100740,90,151870
21478,0.001709,172.31.47.0-255,66,100806,90,151870
21479,0.001711,74.125.200.0-255,766,101572,90,151870
21480,0.001869,74.125.200.0-255,1484,103056,90,151870
21481,0.001871,172.31.47.0-255,66,103122,90,151870
21482,0.001893,74.125.200.0-255,2902,106024,90,151870
21483,0.001894,172.31.47.0-255,66,106090,90,151870
21484,0.001913,74.125.200.0-255,4320,110410,90,151870
21485,0.001915,172.31.47.0-255,66,110476,90,151870
21486,0.001941,74.125.200.0-255,8574,119050,90,151870
21487,0.001943,172.31.47.0-255,66,119116,90,151870
21488,0.001948,74.125.200.0-255,4320,123436,90,151870
21489,0.00195,172.31.47.0-255,66,123502,90,151870
21490,0.00197,74.125.200.0-255,2902,126404,90,151870
21491,0.001972,172.31.47.0-255,66,126470,90,151870
21492,0.001982,74.125.200.0-255,8574,135044,90,151870
21493,0.001985,172.31.47.0-255,66,135110,90,151870
21494,0.001987,74.125.200.0-255,766,135876,90,151870
21495,0.004004,74.125.200.0-255,4320,140196,90,151870
21496,0.004008,172.31.47.0-255,66,140262,90,151870
21497,0.006026,74.125.200.0-255,5738,146000,90,151870
21498,0.006032,172.31.47.0-255,66,146066,90,151870
21499,0.008066,74.125.200.0-255,5738,151804,90,151870
21500,0.008076,172.31.47.0-255,66,151870,90,151870
21501,0.0,172.31.47.0-255,105,105,90,276
21502,0.001822,157.240.13.0-255,105,210,90,276
21503,0.001837,172.31.47.0-255,66,276,90,276
21504,0.0,172.31.47.0-255,105,105,90,276
21505,0.001781,157.240.13.0-255,105,210,90,276
21506,0.001795,172.31.47.0-255,66,276,90,276
21507,0.0,172.217.194.0-255,298,298,90,228156
21508,3.3e-05,172.31.47.0-255,66,364,90,228156
21509,3.9e-05,172.217.194.0-255,1484,1848,90,228156
21510,4.3e-05,172.31.47.0-255,66,1914,90,228156
21511,5e-05,172.217.194.0-255,4320,6234,90,228156
21512,5.9e-05,172.31.47.0-255,66,6300,90,228156
21513,8.2e-05,172.217.194.0-255,2902,9202,90,228156
21514,8.7e-05,172.31.47.0-255,66,9268,90,228156
21515,0.000113,172.217.194.0-255,4739,14007,90,228156
21516,0.000116,172.31.47.0-255,66,14073,90,228156
21517,0.000203,172.217.194.0-255,1484,15557,90,228156
21518,0.000206,172.31.47.0-255,66,15623,90,228156
21519,0.000212,172.217.194.0-255,2902,18525,90,228156
21520,0.000215,172.31.47.0-255,66,18591,90,228156
21521,0.000237,172.217.194.0-255,5738,24329,90,228156
21522,0.00024,172.31.47.0-255,66,24395,90,228156
21523,0.000281,172.217.194.0-255,4320,28715,90,228156
21524,0.000284,172.31.47.0-255,66,28781,90,228156
21525,0.000309,172.217.194.0-255,2543,31324,90,228156
21526,0.000311,172.31.47.0-255,66,31390,90,228156
21527,0.000317,172.217.194.0-255,7156,38546,90,228156
21528,0.00032,172.217.194.0-255,2902,41448,90,228156
21529,0.000321,172.31.47.0-255,66,41514,90,228156
21530,0.000324,172.31.47.0-255,66,41580,90,228156
21531,0.000338,172.217.194.0-255,2902,44482,90,228156
21532,0.000345,172.31.47.0-255,66,44548,90,228156
21533,0.00037,172.217.194.0-255,3961,48509,90,228156
21534,0.000373,172.31.47.0-255,66,48575,90,228156
21535,0.000701,172.217.194.0-255,1484,50059,90,228156
21536,0.000706,172.31.47.0-255,66,50125,90,228156
21537,0.000739,172.217.194.0-255,2902,53027,90,228156
21538,0.000742,172.31.47.0-255,66,53093,90,228156
21539,0.000771,172.217.194.0-255,5738,58831,90,228156
21540,0.000778,172.217.194.0-255,5738,64569,90,228156
21541,0.000811,172.217.194.0-255,1125,65694,90,228156
21542,0.000903,172.217.194.0-255,1484,67178,90,228156
21543,0.000909,172.217.194.0-255,2902,70080,90,228156
21544,0.000913,172.217.194.0-255,2902,72982,90,228156
21545,0.000934,172.217.194.0-255,2902,75884,90,228156
21546,0.00094,172.217.194.0-255,4320,80204,90,228156
21547,0.000966,172.217.194.0-255,4320,84524,90,228156
21548,0.00099,172.217.194.0-255,8215,92739,90,228156
21549,0.000993,172.217.194.0-255,1484,94223,90,228156
21550,0.001016,172.217.194.0-255,5959,100182,90,228156
21551,0.001438,172.217.194.0-255,1484,101666,90,228156
21552,0.001446,172.217.194.0-255,2902,104568,90,228156
21553,0.001459,172.217.194.0-255,2902,107470,90,228156
21554,0.001479,172.217.194.0-255,1484,108954,90,228156
21555,0.001485,172.217.194.0-255,4320,113274,90,228156
21556,0.00151,172.217.194.0-255,4320,117594,90,228156
21557,0.001537,172.217.194.0-255,2902,120496,90,228156
21558,0.00159,172.217.194.0-255,1484,121980,90,228156
21559,0.001594,172.217.194.0-255,2902,124882,90,228156
21560,0.001599,172.217.194.0-255,5738,130620,90,228156
21561,0.001654,172.217.194.0-255,7156,137776,90,228156
21562,0.001674,172.217.194.0-255,4320,142096,90,228156
21563,0.00169,172.217.194.0-255,8574,150670,90,228156
21564,0.001699,172.217.194.0-255,1484,152154,90,228156
21565,0.001701,172.217.194.0-255,1484,153638,90,228156
21566,0.001713,172.217.194.0-255,2184,155822,90,228156
21567,0.001763,172.217.194.0-255,1484,157306,90,228156
21568,0.001811,172.217.194.0-255,2902,160208,90,228156
21569,0.001817,172.217.194.0-255,5738,165946,90,228156
21570,0.001831,172.217.194.0-255,2902,168848,90,228156
21571,0.001854,172.217.194.0-255,3602,172450,90,228156
21572,0.001896,172.217.194.0-255,1484,173934,90,228156
21573,0.001908,172.217.194.0-255,2902,176836,90,228156
21574,0.001922,172.217.194.0-255,4320,181156,90,228156
21575,0.001935,172.217.194.0-255,1484,182640,90,228156
21576,0.001947,172.217.194.0-255,1484,184124,90,228156
21577,0.001969,172.217.194.0-255,8574,192698,90,228156
21578,0.001998,172.217.194.0-255,1484,194182,90,228156
21579,0.002003,172.217.194.0-255,4320,198502,90,228156
21580,0.00201,172.217.194.0-255,7856,206358,90,228156
21581,0.002021,172.217.194.0-255,1484,207842,90,228156
21582,0.00203,172.217.194.0-255,1484,209326,90,228156
21583,0.002036,172.217.194.0-255,4320,213646,90,228156
21584,0.002044,172.217.194.0-255,1484,215130,90,228156
21585,0.002061,172.217.194.0-255,7156,222286,90,228156
21586,0.007084,172.31.47.0-255,66,222352,90,228156
21587,0.009092,172.217.194.0-255,5738,228090,90,228156
21588,0.0091,172.31.47.0-255,66,228156,90,228156
21589,0.0,74.125.68.0-255,143,143,90,355340
21590,1.5e-05,172.31.47.0-255,66,209,90,355340
21591,2.1e-05,74.125.68.0-255,1484,1693,90,355340
21592,2.5e-05,172.31.47.0-255,66,1759,90,355340
21593,3e-05,74.125.68.0-255,2902,4661,90,355340
21594,4.2e-05,172.31.47.0-255,66,4727,90,355340
21595,4.7e-05,74.125.68.0-255,4320,9047,90,355340
21596,5e-05,172.31.47.0-255,66,9113,90,355340
21597,6.6e-05,74.125.68.0-255,1484,10597,90,355340
21598,7.3e-05,172.31.47.0-255,66,10663,90,355340
21599,7.6e-05,74.125.68.0-255,1484,12147,90,355340
21600,7.8e-05,172.31.47.0-255,66,12213,90,355340
21601,0.000116,74.125.68.0-255,6382,18595,90,355340
21602,0.000119,172.31.47.0-255,66,18661,90,355340
21603,0.000126,74.125.68.0-255,8574,27235,90,355340
21604,0.000128,172.31.47.0-255,66,27301,90,355340
21605,0.000133,74.125.68.0-255,3961,31262,90,355340
21606,0.000134,172.31.47.0-255,66,31328,90,355340
21607,0.000212,74.125.68.0-255,1484,32812,90,355340
21608,0.000215,172.31.47.0-255,66,32878,90,355340
21609,0.000245,74.125.68.0-255,2902,35780,90,355340
21610,0.000248,172.31.47.0-255,66,35846,90,355340
21611,0.000275,74.125.68.0-255,5738,41584,90,355340
21612,0.000277,172.31.47.0-255,66,41650,90,355340
21613,0.000281,74.125.68.0-255,2902,44552,90,355340
21614,0.000283,172.31.47.0-255,66,44618,90,355340
21615,0.000302,74.125.68.0-255,4320,48938,90,355340
21616,0.000304,172.31.47.0-255,66,49004,90,355340
21617,0.000346,74.125.68.0-255,8574,57578,90,355340
21618,0.00035,172.31.47.0-255,66,57644,90,355340
21619,0.000401,74.125.68.0-255,7156,64800,90,355340
21620,0.000406,172.31.47.0-255,66,64866,90,355340
21621,0.000432,74.125.68.0-255,766,65632,90,355340
21622,0.000436,74.125.68.0-255,402,66034,90,355340
21623,0.00045,74.125.68.0-255,108,66142,90,355340
21624,0.000798,74.125.68.0-255,1484,67626,90,355340
21625,0.000804,172.31.47.0-255,66,67692,90,355340
21626,0.000811,74.125.68.0-255,2902,70594,90,355340
21627,0.000813,172.31.47.0-255,66,70660,90,355340
21628,0.000851,74.125.68.0-255,5738,76398,90,355340
21629,0.000856,172.31.47.0-255,66,76464,90,355340
21630,0.000861,74.125.68.0-255,4320,80784,90,355340
21631,0.000863,172.31.47.0-255,66,80850,90,355340
21632,0.00087,74.125.68.0-255,5738,86588,90,355340
21633,0.000872,172.31.47.0-255,66,86654,90,355340
21634,0.000913,74.125.68.0-255,4320,90974,90,355340
21635,0.000917,172.31.47.0-255,66,91040,90,355340
21636,0.000951,74.125.68.0-255,7156,98196,90,355340
21637,0.000955,172.31.47.0-255,66,98262,90,355340
21638,0.000959,74.125.68.0-255,2184,100446,90,355340
21639,0.000961,172.31.47.0-255,66,100512,90,355340
21640,0.001132,74.125.68.0-255,1484,101996,90,355340
21641,0.001162,74.125.68.0-255,2902,104898,90,355340
21642,0.001168,172.31.47.0-255,66,104964,90,355340
21643,0.001197,74.125.68.0-255,5738,110702,90,355340
21644,0.0012,172.31.47.0-255,66,110768,90,355340
21645,0.001205,74.125.68.0-255,4320,115088,90,355340
21646,0.001207,172.31.47.0-255,66,115154,90,355340
21647,0.001213,74.125.68.0-255,5738,120892,90,355340
21648,0.001215,172.31.47.0-255,66,120958,90,355340
21649,0.001266,172.31.47.0-255,66,121024,90,355340
21650,0.00127,74.125.68.0-255,2184,123208,90,355340
21651,0.001271,172.31.47.0-255,66,123274,90,355340
21652,0.001293,74.125.68.0-255,5738,129012,90,355340
21653,0.001295,172.31.47.0-255,66,129078,90,355340
21654,0.00132,74.125.68.0-255,9992,139070,90,355340
21655,0.001322,172.31.47.0-255,66,139136,90,355340
21656,0.001328,74.125.68.0-255,5738,144874,90,355340
21657,0.001332,172.31.47.0-255,66,144940,90,355340
21658,0.001387,172.31.47.0-255,66,145006,90,355340
21659,0.001458,74.125.68.0-255,1484,146490,90,355340
21660,0.001475,74.125.68.0-255,2902,149392,90,355340
21661,0.001478,172.31.47.0-255,66,149458,90,355340
21662,0.001481,74.125.68.0-255,1484,150942,90,355340
21663,0.0015,74.125.68.0-255,4320,155262,90,355340
21664,0.001502,172.31.47.0-255,66,155328,90,355340
21665,0.001506,74.125.68.0-255,2902,158230,90,355340
21666,0.001508,172.31.47.0-255,66,158296,90,355340
21667,0.001544,74.125.68.0-255,4320,162616,90,355340
21668,0.001548,172.31.47.0-255,66,162682,90,355340
21669,0.001556,74.125.68.0-255,8574,171256,90,355340
21670,0.001558,172.31.47.0-255,66,171322,90,355340
21671,0.001563,74.125.68.0-255,5738,177060,90,355340
21672,0.001566,172.31.47.0-255,66,177126,90,355340
21673,0.001595,74.125.68.0-255,2184,179310,90,355340
21674,0.001598,172.31.47.0-255,66,179376,90,355340
21675,0.001628,74.125.68.0-255,1484,180860,90,355340
21676,0.001642,74.125.68.0-255,2902,183762,90,355340
21677,0.001645,172.31.47.0-255,66,183828,90,355340
21678,0.001663,74.125.68.0-255,4320,188148,90,355340
21679,0.001665,172.31.47.0-255,66,188214,90,355340
21680,0.00167,74.125.68.0-255,4320,192534,90,355340
21681,0.001672,172.31.47.0-255,66,192600,90,355340
21682,0.001697,74.125.68.0-255,1484,194084,90,355340
21683,0.001707,74.125.68.0-255,9992,204076,90,355340
21684,0.001716,172.31.47.0-255,66,204142,90,355340
21685,0.001741,74.125.68.0-255,1484,205626,90,355340
21686,0.001746,74.125.68.0-255,4320,209946,90,355340
21687,0.001749,172.31.47.0-255,66,210012,90,355340
21688,0.001769,74.125.68.0-255,6438,216450,90,355340
21689,0.001772,172.31.47.0-255,66,216516,90,355340
21690,0.001799,74.125.68.0-255,7156,223672,90,355340
21691,0.001802,172.31.47.0-255,66,223738,90,355340
21692,0.001829,74.125.68.0-255,2902,226640,90,355340
21693,0.001831,172.31.47.0-255,66,226706,90,355340
21694,0.001841,74.125.68.0-255,4320,231026,90,355340
21695,0.001847,172.31.47.0-255,66,231092,90,355340
21696,0.001853,74.125.68.0-255,4320,235412,90,355340
21697,0.001855,172.31.47.0-255,66,235478,90,355340
21698,0.001886,74.125.68.0-255,4320,239798,90,355340
21699,0.001889,172.31.47.0-255,66,239864,90,355340
21700,0.001893,74.125.68.0-255,4320,244184,90,355340
21701,0.001896,172.31.47.0-255,66,244250,90,355340
21702,0.001921,74.125.68.0-255,3602,247852,90,355340
21703,0.001923,172.31.47.0-255,66,247918,90,355340
21704,0.001946,74.125.68.0-255,1484,249402,90,355340
21705,0.001967,74.125.68.0-255,2902,252304,90,355340
21706,0.00197,172.31.47.0-255,66,252370,90,355340
21707,0.001974,74.125.68.0-255,1484,253854,90,355340
21708,0.001978,74.125.68.0-255,2902,256756,90,355340
21709,0.00198,172.31.47.0-255,66,256822,90,355340
21710,0.00202,74.125.68.0-255,1484,258306,90,355340
21711,0.002046,74.125.68.0-255,4320,262626,90,355340
21712,0.002049,172.31.47.0-255,66,262692,90,355340
21713,0.002055,74.125.68.0-255,7156,269848,90,355340
21714,0.002057,172.31.47.0-255,66,269914,90,355340
21715,0.002065,74.125.68.0-255,8574,278488,90,355340
21716,0.002067,172.31.47.0-255,66,278554,90,355340
21717,0.002072,74.125.68.0-255,3602,282156,90,355340
21718,0.002074,172.31.47.0-255,66,282222,90,355340
21719,0.00211,74.125.68.0-255,4320,286542,90,355340
21720,0.002113,172.31.47.0-255,66,286608,90,355340
21721,0.00212,74.125.68.0-255,7156,293764,90,355340
21722,0.002122,172.31.47.0-255,66,293830,90,355340
21723,0.002151,74.125.68.0-255,1484,295314,90,355340
21724,0.002159,74.125.68.0-255,9992,305306,90,355340
21725,0.002162,172.31.47.0-255,66,305372,90,355340
21726,0.002193,74.125.68.0-255,10692,316064,90,355340
21727,0.002196,172.31.47.0-255,66,316130,90,355340
21728,0.002223,74.125.68.0-255,8574,324704,90,355340
21729,0.002225,172.31.47.0-255,66,324770,90,355340
21730,0.002271,74.125.68.0-255,2902,327672,90,355340
21731,0.002274,172.31.47.0-255,66,327738,90,355340
21732,0.002302,74.125.68.0-255,5738,333476,90,355340
21733,0.002305,172.31.47.0-255,66,333542,90,355340
21734,0.002311,74.125.68.0-255,4320,337862,90,355340
21735,0.002313,172.31.47.0-255,66,337928,90,355340
21736,0.004602,74.125.68.0-255,5738,343666,90,355340
21737,0.004622,172.31.47.0-255,66,343732,90,355340
21738,0.006905,74.125.68.0-255,5738,349470,90,355340
21739,0.006918,172.31.47.0-255,66,349536,90,355340
21740,0.009203,74.125.68.0-255,5738,355274,90,355340
21741,0.009206,172.31.47.0-255,66,355340,90,355340
21742,0.0,172.31.47.0-255,105,105,90,276
21743,0.00176,157.240.13.0-255,105,210,90,276
21744,0.00177,172.31.47.0-255,66,276,90,276
21745,0.0,172.31.47.0-255,105,105,90,105
21746,0.0,74.125.200.0-255,152,152,90,151802
21747,2.5e-05,172.31.47.0-255,66,218,90,151802
21748,3.2e-05,74.125.200.0-255,1484,1702,90,151802
21749,3.6e-05,172.31.47.0-255,66,1768,90,151802
21750,4.1e-05,74.125.200.0-255,2902,4670,90,151802
21751,4.5e-05,172.31.47.0-255,66,4736,90,151802
21752,4.9e-05,74.125.200.0-255,2902,7638,90,151802
21753,5.2e-05,172.31.47.0-255,66,7704,90,151802
21754,7.2e-05,74.125.200.0-255,4320,12024,90,151802
21755,7.5e-05,172.31.47.0-255,66,12090,90,151802
21756,7.9e-05,74.125.200.0-255,2173,14263,90,151802
21757,8.1e-05,172.31.47.0-255,66,14329,90,151802
21758,0.0001,74.125.200.0-255,1484,15813,90,151802
21759,0.000102,172.31.47.0-255,66,15879,90,151802
21760,0.000125,74.125.200.0-255,1484,17363,90,151802
21761,0.000128,172.31.47.0-255,66,17429,90,151802
21762,0.000131,74.125.200.0-255,1484,18913,90,151802
21763,0.000134,172.31.47.0-255,66,18979,90,151802
21764,0.000138,74.125.200.0-255,2902,21881,90,151802
21765,0.000141,172.31.47.0-255,66,21947,90,151802
21766,0.000156,74.125.200.0-255,5738,27685,90,151802
21767,0.000159,172.31.47.0-255,66,27751,90,151802
21768,0.000164,74.125.200.0-255,4320,32071,90,151802
21769,0.000167,172.31.47.0-255,66,32137,90,151802
21770,0.000196,74.125.200.0-255,5738,37875,90,151802
21771,0.000199,172.31.47.0-255,66,37941,90,151802
21772,0.000216,74.125.200.0-255,1484,39425,90,151802
21773,0.000218,172.31.47.0-255,66,39491,90,151802
21774,0.000238,74.125.200.0-255,9274,48765,90,151802
21775,0.000241,172.31.47.0-255,66,48831,90,151802
21776,0.000256,74.125.200.0-255,1484,50315,90,151802
21777,0.000259,172.31.47.0-255,66,50381,90,151802
21778,0.000278,74.125.200.0-255,2902,53283,90,151802
21779,0.000281,172.31.47.0-255,66,53349,90,151802
21780,0.000287,74.125.200.0-255,4320,57669,90,151802
21781,0.000289,172.31.47.0-255,66,57735,90,151802
21782,0.000305,74.125.200.0-255,1484,59219,90,151802
21783,0.000332,74.125.200.0-255,7123,66342,90,151802
21784,0.000337,172.31.47.0-255,66,66408,90,151802
21785,0.000354,74.125.200.0-255,330,66738,90,151802
21786,0.000618,74.125.200.0-255,1484,68222,90,151802
21787,0.000624,172.31.47.0-255,66,68288,90,151802
21788,0.000628,74.125.200.0-255,1484,69772,90,151802
21789,0.000643,74.125.200.0-255,1484,71256,90,151802
21790,0.000646,172.31.47.0-255,66,71322,90,151802
21791,0.00065,74.125.200.0-255,1484,72806,90,151802
21792,0.00067,74.125.200.0-255,4320,77126,90,151802
21793,0.000674,172.31.47.0-255,66,77192,90,151802
21794,0.00068,74.125.200.0-255,5738,82930,90,151802
21795,0.000682,172.31.47.0-255,66,82996,90,151802
21796,0.000687,74.125.200.0-255,4320,87316,90,151802
21797,0.00069,172.31.47.0-255,66,87382,90,151802
21798,0.000708,74.125.200.0-255,2902,90284,90,151802
21799,0.000711,172.31.47.0-255,66,90350,90,151802
21800,0.000738,74.125.200.0-255,4320,94670,90,151802
21801,0.000741,172.31.47.0-255,66,94736,90,151802
21802,0.000766,74.125.200.0-255,6438,101174,90,151802
21803,0.000771,172.31.47.0-255,66,101240,90,151802
21804,0.00188,74.125.200.0-255,1484,102724,90,151802
21805,0.00189,74.125.200.0-255,2902,105626,90,151802
21806,0.001893,172.31.47.0-255,66,105692,90,151802
21807,0.001897,74.125.200.0-255,1484,107176,90,151802
21808,0.001911,74.125.200.0-255,4320,111496,90,151802
21809,0.001913,172.31.47.0-255,66,111562,90,151802
21810,0.001939,74.125.200.0-255,7156,118718,90,151802
21811,0.001941,172.31.47.0-255,66,118784,90,151802
21812,0.001946,74.125.200.0-255,5738,124522,90,151802
21813,0.001948,172.31.47.0-255,66,124588,90,151802
21814,0.001959,74.125.200.0-255,2902,127490,90,151802
21815,0.001961,172.31.47.0-255,66,127556,90,151802
21816,0.001974,74.125.200.0-255,2902,130458,90,151802
21817,0.001976,172.31.47.0-255,66,130524,90,151802
21818,0.001996,74.125.200.0-255,5020,135544,90,151802
21819,0.001998,172.31.47.0-255,66,135610,90,151802
21820,0.004293,74.125.200.0-255,4320,139930,90,151802
21821,0.004298,172.31.47.0-255,66,139996,90,151802
21822,0.004313,74.125.200.0-255,1484,141480,90,151802
21823,0.006587,74.125.200.0-255,4320,145800,90,151802
21824,0.006593,172.31.47.0-255,66,145866,90,151802
21825,0.008887,74.125.200.0-255,2902,148768,90,151802
21826,0.008894,172.31.47.0-255,66,148834,90,151802
21827,0.008915,74.125.200.0-255,2902,151736,90,151802
21828,0.008919,172.31.47.0-255,66,151802,90,151802
21829,0.0,172.31.47.0-255,105,105,90,276
21830,0.001464,157.240.13.0-255,105,210,90,276
21831,0.001474,172.31.47.0-255,66,276,90,276
21832,0.0,74.125.24.0-255,153,153,90,294296
21833,2e-05,172.31.47.0-255,66,219,90,294296
21834,2.6e-05,74.125.24.0-255,1484,1703,90,294296
21835,3e-05,172.31.47.0-255,66,1769,90,294296
21836,3.5e-05,74.125.24.0-255,2902,4671,90,294296
21837,3.9e-05,172.31.47.0-255,66,4737,90,294296
21838,4.6e-05,74.125.24.0-255,7156,11893,90,294296
21839,4.9e-05,172.31.47.0-255,66,11959,90,294296
21840,5.2e-05,74.125.24.0-255,1484,13443,90,294296
21841,5.4e-05,172.31.47.0-255,66,13509,90,294296
21842,7.5e-05,74.125.24.0-255,738,14247,90,294296
21843,7.7e-05,172.31.47.0-255,66,14313,90,294296
21844,9.5e-05,74.125.24.0-255,2902,17215,90,294296
21845,9.7e-05,172.31.47.0-255,66,17281,90,294296
21846,0.000101,74.125.24.0-255,2902,20183,90,294296
21847,0.000103,172.31.47.0-255,66,20249,90,294296
21848,0.000113,74.125.24.0-255,1484,21733,90,294296
21849,0.000115,172.31.47.0-255,66,21799,90,294296
21850,0.000138,74.125.24.0-255,4320,26119,90,294296
21851,0.000141,172.31.47.0-255,66,26185,90,294296
21852,0.000161,74.125.24.0-255,4320,30505,90,294296
21853,0.000163,172.31.47.0-255,66,30571,90,294296
21854,0.000166,74.125.24.0-255,1125,31696,90,294296
21855,0.000167,172.31.47.0-255,66,31762,90,294296
21856,0.00017,74.125.24.0-255,1484,33246,90,294296
21857,0.000172,172.31.47.0-255,66,33312,90,294296
21858,0.000175,74.125.24.0-255,1484,34796,90,294296
21859,0.000177,172.31.47.0-255,66,34862,90,294296
21860,0.000202,74.125.24.0-255,2902,37764,90,294296
21861,0.000205,172.31.47.0-255,66,37830,90,294296
21862,0.000213,74.125.24.0-255,9992,47822,90,294296
21863,0.000215,172.31.47.0-255,66,47888,90,294296
21864,0.000217,74.125.24.0-255,1125,49013,90,294296
21865,0.00029,74.125.24.0-255,1484,50497,90,294296
21866,0.000293,172.31.47.0-255,66,50563,90,294296
21867,0.000298,74.125.24.0-255,2902,53465,90,294296
21868,0.0003,172.31.47.0-255,66,53531,90,294296
21869,0.000316,74.125.24.0-255,5738,59269,90,294296
21870,0.000318,172.31.47.0-255,66,59335,90,294296
21871,0.000369,74.125.24.0-255,4320,63655,90,294296
21872,0.000372,172.31.47.0-255,66,63721,90,294296
21873,0.000392,74.125.24.0-255,2839,66560,90,294296
21874,0.000394,172.31.47.0-255,66,66626,90,294296
21875,0.000397,74.125.24.0-255,132,66758,90,294296
21876,0.000409,74.125.24.0-255,348,67106,90,294296
21877,0.000644,74.125.24.0-255,1484,68590,90,294296
21878,0.000649,172.31.47.0-255,66,68656,90,294296
21879,0.000653,74.125.24.0-255,1484,70140,90,294296
21880,0.000667,74.125.24.0-255,1484,71624,90,294296
21881,0.000669,172.31.47.0-255,66,71690,90,294296
21882,0.000675,74.125.24.0-255,5738,77428,90,294296
21883,0.000677,172.31.47.0-255,66,77494,90,294296
21884,0.000697,74.125.24.0-255,2902,80396,90,294296
21885,0.000699,172.31.47.0-255,66,80462,90,294296
21886,0.000725,74.125.24.0-255,9992,90454,90,294296
21887,0.000727,172.31.47.0-255,66,90520,90,294296
21888,0.000736,74.125.24.0-255,10692,101212,90,294296
21889,0.000738,172.31.47.0-255,66,101278,90,294296
21890,0.000917,74.125.24.0-255,1484,102762,90,294296
21891,0.000923,74.125.24.0-255,2902,105664,90,294296
21892,0.000925,172.31.47.0-255,66,105730,90,294296
21893,0.000944,74.125.24.0-255,5738,111468,90,294296
21894,0.000946,172.31.47.0-255,66,111534,90,294296
21895,0.000974,74.125.24.0-255,9992,121526,90,294296
21896,0.000977,172.31.47.0-255,66,121592,90,294296
21897,0.000998,74.125.24.0-255,2902,124494,90,294296
21898,0.001001,172.31.47.0-255,66,124560,90,294296
21899,0.00101,74.125.24.0-255,10692,135252,90,294296
21900,0.001012,172.31.47.0-255,66,135318,90,294296
21901,0.001034,74.125.24.0-255,1484,136802,90,294296
21902,0.001038,74.125.24.0-255,2902,139704,90,294296
21903,0.00104,172.31.47.0-255,66,139770,90,294296
21904,0.001046,74.125.24.0-255,5738,145508,90,294296
21905,0.001048,172.31.47.0-255,66,145574,90,294296
21906,0.00107,74.125.24.0-255,5738,151312,90,294296
21907,0.001073,172.31.47.0-255,66,151378,90,294296
21908,0.001097,74.125.24.0-255,7156,158534,90,294296
21909,0.001099,172.31.47.0-255,66,158600,90,294296
21910,0.001105,74.125.24.0-255,5738,164338,90,294296
21911,0.001108,172.31.47.0-255,66,164404,90,294296
21912,0.001166,74.125.24.0-255,5020,169424,90,294296
21913,0.001169,172.31.47.0-255,66,169490,90,294296
21914,0.001319,74.125.24.0-255,1484,170974,90,294296
21915,0.001333,74.125.24.0-255,2902,173876,90,294296
21916,0.001337,74.125.24.0-255,4320,178196,90,294296
21917,0.001341,172.31.47.0-255,66,178262,90,294296
21918,0.001344,172.31.47.0-255,66,178328,90,294296
21919,0.001357,74.125.24.0-255,1484,179812,90,294296
21920,0.001376,74.125.24.0-255,9992,189804,90,294296
21921,0.001378,172.31.47.0-255,66,189870,90,294296
21922,0.001397,74.125.24.0-255,2902,192772,90,294296
21923,0.001405,74.125.24.0-255,10692,203464,90,294296
21924,0.001409,172.31.47.0-255,66,203530,90,294296
21925,0.001415,172.31.47.0-255,66,203596,90,294296
21926,0.00143,74.125.24.0-255,1484,205080,90,294296
21927,0.001433,74.125.24.0-255,1484,206564,90,294296
21928,0.001435,172.31.47.0-255,66,206630,90,294296
21929,0.001452,74.125.24.0-255,1484,208114,90,294296
21930,0.001458,74.125.24.0-255,5738,213852,90,294296
21931,0.00146,172.31.47.0-255,66,213918,90,294296
21932,0.001515,172.31.47.0-255,66,213984,90,294296
21933,0.001521,74.125.24.0-255,5738,219722,90,294296
21934,0.001522,172.31.47.0-255,66,219788,90,294296
21935,0.001532,74.125.24.0-255,1484,221272,90,294296
21936,0.001544,74.125.24.0-255,3602,224874,90,294296
21937,0.001546,172.31.47.0-255,66,224940,90,294296
21938,0.001712,74.125.24.0-255,1484,226424,90,294296
21939,0.001715,74.125.24.0-255,1484,227908,90,294296
21940,0.001718,172.31.47.0-255,66,227974,90,294296
21941,0.001736,74.125.24.0-255,1484,229458,90,294296
21942,0.001741,74.125.24.0-255,5738,235196,90,294296
21943,0.001743,172.31.47.0-255,66,235262,90,294296
21944,0.001746,74.125.24.0-255,1484,236746,90,294296
21945,0.001748,74.125.24.0-255,1484,238230,90,294296
21946,0.00175,172.31.47.0-255,66,238296,90,294296
21947,0.001781,74.125.24.0-255,7156,245452,90,294296
21948,0.001783,172.31.47.0-255,66,245518,90,294296
21949,0.00181,172.31.47.0-255,66,245584,90,294296
21950,0.001893,74.125.24.0-255,1484,247068,90,294296
21951,0.001897,74.125.24.0-255,2902,249970,90,294296
21952,0.001899,172.31.47.0-255,66,250036,90,294296
21953,0.001902,74.125.24.0-255,1484,251520,90,294296
21954,0.00192,74.125.24.0-255,4320,255840,90,294296
21955,0.001922,172.31.47.0-255,66,255906,90,294296
21956,0.001926,74.125.24.0-255,2902,258808,90,294296
21957,0.001928,172.31.47.0-255,66,258874,90,294296
21958,0.001949,74.125.24.0-255,9992,268866,90,294296
21959,0.001952,172.31.47.0-255,66,268932,90,294296
21960,0.001958,74.125.24.0-255,7156,276088,90,294296
21961,0.00196,172.31.47.0-255,66,276154,90,294296
21962,0.001981,74.125.24.0-255,2902,279056,90,294296
21963,0.001983,172.31.47.0-255,66,279122,90,294296
21964,0.00201,172.31.47.0-255,66,279188,90,294296
21965,0.002036,74.125.24.0-255,2184,281372,90,294296
21966,0.002039,172.31.47.0-255,66,281438,90,294296
21967,0.002057,172.31.47.0-255,66,281504,90,294296
21968,0.002089,172.31.47.0-255,66,281570,90,294296
21969,0.002107,74.125.24.0-255,5020,286590,90,294296
21970,0.00217,172.31.47.0-255,66,286656,90,294296
21971,0.00219,74.125.24.0-255,7469,294125,90,294296
21972,0.002193,74.125.24.0-255,105,294230,90,294296
21973,0.002201,172.31.47.0-255,66,294296,90,294296
21974,0.0,74.125.24.0-255,153,153,90,240896
21975,2.2e-05,172.31.47.0-255,66,219,90,240896
21976,2.9e-05,74.125.24.0-255,1484,1703,90,240896
21977,3.3e-05,172.31.47.0-255,66,1769,90,240896
21978,4.5e-05,74.125.24.0-255,2902,4671,90,240896
21979,4.9e-05,172.31.47.0-255,66,4737,90,240896
21980,8.4e-05,74.125.24.0-255,5738,10475,90,240896
21981,8.7e-05,172.31.47.0-255,66,10541,90,240896
21982,9.2e-05,74.125.24.0-255,2902,13443,90,240896
21983,9.3e-05,172.31.47.0-255,66,13509,90,240896
21984,0.000121,74.125.24.0-255,10609,24118,90,240896
21985,0.000124,172.31.47.0-255,66,24184,90,240896
21986,0.000128,74.125.24.0-255,4320,28504,90,240896
21987,0.000131,172.31.47.0-255,66,28570,90,240896
21988,0.00018,74.125.24.0-255,2543,31113,90,240896
21989,0.000182,172.31.47.0-255,66,31179,90,240896
21990,0.000409,74.125.24.0-255,1484,32663,90,240896
21991,0.000414,172.31.47.0-255,66,32729,90,240896
21992,0.00042,74.125.24.0-255,2902,35631,90,240896
21993,0.000422,172.31.47.0-255,66,35697,90,240896
21994,0.000433,74.125.24.0-255,5738,41435,90,240896
21995,0.000435,172.31.47.0-255,66,41501,90,240896
21996,0.000441,74.125.24.0-255,5738,47239,90,240896
21997,0.000443,172.31.47.0-255,66,47305,90,240896
21998,0.00049,74.125.24.0-255,5738,53043,90,240896
21999,0.000495,172.31.47.0-255,66,53109,90,240896
22000,0.000516,74.125.24.0-255,8215,61324,90,240896
22001,0.000519,172.31.47.0-255,66,61390,90,240896
22002,0.000523,74.125.24.0-255,2902,64292,90,240896
22003,0.000525,172.31.47.0-255,66,64358,90,240896
22004,0.000535,74.125.24.0-255,1400,65758,90,240896
22005,0.000536,172.31.47.0-255,66,65824,90,240896
22006,0.000564,74.125.24.0-255,130,65954,90,240896
22007,0.000682,74.125.24.0-255,1484,67438,90,240896
22008,0.000686,172.31.47.0-255,66,67504,90,240896
22009,0.000692,74.125.24.0-255,2902,70406,90,240896
22010,0.000694,172.31.47.0-255,66,70472,90,240896
22011,0.000721,74.125.24.0-255,5738,76210,90,240896
22012,0.000725,172.31.47.0-255,66,76276,90,240896
22013,0.000736,74.125.24.0-255,2902,79178,90,240896
22014,0.000744,172.31.47.0-255,66,79244,90,240896
22015,0.000776,74.125.24.0-255,9992,89236,90,240896
22016,0.000779,172.31.47.0-255,66,89302,90,240896
22017,0.000785,74.125.24.0-255,7156,96458,90,240896
22018,0.000787,172.31.47.0-255,66,96524,90,240896
22019,0.00082,74.125.24.0-255,3602,100126,90,240896
22020,0.000823,172.31.47.0-255,66,100192,90,240896
22021,0.001565,74.125.24.0-255,1484,101676,90,240896
22022,0.001574,74.125.24.0-255,2902,104578,90,240896
22023,0.001578,172.31.47.0-255,66,104644,90,240896
22024,0.001582,74.125.24.0-255,1484,106128,90,240896
22025,0.001607,74.125.24.0-255,4320,110448,90,240896
22026,0.001609,172.31.47.0-255,66,110514,90,240896
22027,0.001615,74.125.24.0-255,4320,114834,90,240896
22028,0.001617,172.31.47.0-255,66,114900,90,240896
22029,0.001645,74.125.24.0-255,8574,123474,90,240896
22030,0.001647,172.31.47.0-255,66,123540,90,240896
22031,0.001673,74.125.24.0-255,8574,132114,90,240896
22032,0.001675,172.31.47.0-255,66,132180,90,240896
22033,0.001698,74.125.24.0-255,2184,134364,90,240896
22034,0.001701,172.31.47.0-255,66,134430,90,240896
22035,0.00173,172.31.47.0-255,66,134496,90,240896
22036,0.001735,74.125.24.0-255,2902,137398,90,240896
22037,0.001736,172.31.47.0-255,66,137464,90,240896
22038,0.001768,74.125.24.0-255,9992,147456,90,240896
22039,0.00177,172.31.47.0-255,66,147522,90,240896
22040,0.001801,74.125.24.0-255,2902,150424,90,240896
22041,0.001802,172.31.47.0-255,66,150490,90,240896
22042,0.001829,74.125.24.0-255,6438,156928,90,240896
22043,0.001831,172.31.47.0-255,66,156994,90,240896
22044,0.001975,74.125.24.0-255,1484,158478,90,240896
22045,0.001994,74.125.24.0-255,2902,161380,90,240896
22046,0.001997,172.31.47.0-255,66,161446,90,240896
22047,0.002003,74.125.24.0-255,5738,167184,90,240896
22048,0.002005,172.31.47.0-255,66,167250,90,240896
22049,0.002033,74.125.24.0-255,8574,175824,90,240896
22050,0.002035,172.31.47.0-255,66,175890,90,240896
22051,0.002057,74.125.24.0-255,2902,178792,90,240896
22052,0.002059,172.31.47.0-255,66,178858,90,240896
22053,0.002098,172.31.47.0-255,66,178924,90,240896
22054,0.002187,74.125.24.0-255,1484,180408,90,240896
22055,0.002191,74.125.24.0-255,1484,181892,90,240896
22056,0.002194,172.31.47.0-255,66,181958,90,240896
22057,0.002211,74.125.24.0-255,1484,183442,90,240896
22058,0.002217,74.125.24.0-255,5738,189180,90,240896
22059,0.00222,172.31.47.0-255,66,189246,90,240896
22060,0.002225,74.125.24.0-255,5738,194984,90,240896
22061,0.002227,172.31.47.0-255,66,195050,90,240896
22062,0.002261,74.125.24.0-255,8574,203624,90,240896
22063,0.002264,172.31.47.0-255,66,203690,90,240896
22064,0.002289,74.125.24.0-255,4320,208010,90,240896
22065,0.002291,172.31.47.0-255,66,208076,90,240896
22066,0.002297,74.125.24.0-255,5020,213096,90,240896
22067,0.002299,172.31.47.0-255,66,213162,90,240896
22068,0.002326,74.125.24.0-255,1484,214646,90,240896
22069,0.00233,74.125.24.0-255,2902,217548,90,240896
22070,0.002332,172.31.47.0-255,66,217614,90,240896
22071,0.002363,74.125.24.0-255,5738,223352,90,240896
22072,0.002366,172.31.47.0-255,66,223418,90,240896
22073,0.002368,74.125.24.0-255,1484,224902,90,240896
22074,0.004631,74.125.24.0-255,4320,229222,90,240896
22075,0.004639,172.31.47.0-255,66,229288,90,240896
22076,0.006901,74.125.24.0-255,5738,235026,90,240896
22077,0.006907,172.31.47.0-255,66,235092,90,240896
22078,0.009233,74.125.24.0-255,5738,240830,90,240896
22079,0.009242,172.31.47.0-255,66,240896,90,240896
22080,0.0,172.31.47.0-255,105,105,90,105
22081,0.0,172.217.27.0-255,143,143,90,200087
22082,3.5e-05,172.31.47.0-255,66,209,90,200087
22083,4.2e-05,172.217.27.0-255,1484,1693,90,200087
22084,4.5e-05,172.31.47.0-255,66,1759,90,200087
22085,5e-05,172.217.27.0-255,2902,4661,90,200087
22086,5.2e-05,172.31.47.0-255,66,4727,90,200087
22087,5.7e-05,172.217.27.0-255,5738,10465,90,200087
22088,6e-05,172.31.47.0-255,66,10531,90,200087
22089,8.3e-05,172.217.27.0-255,3591,14122,90,200087
22090,8.6e-05,172.31.47.0-255,66,14188,90,200087
22091,8.9e-05,172.217.27.0-255,1484,15672,90,200087
22092,9.3e-05,172.31.47.0-255,66,15738,90,200087
22093,0.000102,172.217.27.0-255,2902,18640,90,200087
22094,0.000104,172.31.47.0-255,66,18706,90,200087
22095,0.000139,172.217.27.0-255,4320,23026,90,200087
22096,0.000142,172.31.47.0-255,66,23092,90,200087
22097,0.000148,172.217.27.0-255,5738,28830,90,200087
22098,0.00015,172.31.47.0-255,66,28896,90,200087
22099,0.000155,172.217.27.0-255,5738,34634,90,200087
22100,0.000157,172.31.47.0-255,66,34700,90,200087
22101,0.000173,172.217.27.0-255,1484,36184,90,200087
22102,0.000175,172.31.47.0-255,66,36250,90,200087
22103,0.000179,172.217.27.0-255,2902,39152,90,200087
22104,0.000181,172.31.47.0-255,66,39218,90,200087
22105,0.000213,172.31.47.0-255,66,39284,90,200087
22106,0.000236,172.217.27.0-255,1484,40768,90,200087
22107,0.000238,172.31.47.0-255,66,40834,90,200087
22108,0.000255,172.217.27.0-255,8574,49408,90,200087
22109,0.000258,172.31.47.0-255,66,49474,90,200087
22110,0.000272,172.217.27.0-255,4229,53703,90,200087
22111,0.000276,172.31.47.0-255,66,53769,90,200087
22112,0.000621,172.217.27.0-255,132,53901,90,200087
22113,0.000711,172.31.47.0-255,66,53967,90,200087
22114,0.001106,172.217.27.0-255,1484,55451,90,200087
22115,0.001117,172.217.27.0-255,2902,58353,90,200087
22116,0.001121,172.31.47.0-255,66,58419,90,200087
22117,0.001128,172.217.27.0-255,4320,62739,90,200087
22118,0.00113,172.31.47.0-255,66,62805,90,200087
22119,0.001146,172.217.27.0-255,1484,64289,90,200087
22120,0.001151,172.217.27.0-255,4320,68609,90,200087
22121,0.001153,172.31.47.0-255,66,68675,90,200087
22122,0.001159,172.217.27.0-255,2902,71577,90,200087
22123,0.00116,172.31.47.0-255,66,71643,90,200087
22124,0.00119,172.217.27.0-255,8574,80217,90,200087
22125,0.001193,172.31.47.0-255,66,80283,90,200087
22126,0.001201,172.217.27.0-255,7856,88139,90,200087
22127,0.001203,172.31.47.0-255,66,88205,90,200087
22128,0.001291,172.217.27.0-255,1484,89689,90,200087
22129,0.001333,172.217.27.0-255,1484,91173,90,200087
22130,0.001338,172.31.47.0-255,66,91239,90,200087
22131,0.001341,172.217.27.0-255,1484,92723,90,200087
22132,0.001345,172.217.27.0-255,2902,95625,90,200087
22133,0.001347,172.31.47.0-255,66,95691,90,200087
22134,0.00135,172.217.27.0-255,1484,97175,90,200087
22135,0.001375,172.217.27.0-255,4320,101495,90,200087
22136,0.001377,172.31.47.0-255,66,101561,90,200087
22137,0.00138,172.217.27.0-255,1484,103045,90,200087
22138,0.001384,172.217.27.0-255,2902,105947,90,200087
22139,0.001387,172.31.47.0-255,66,106013,90,200087
22140,0.001391,172.217.27.0-255,2902,108915,90,200087
22141,0.001392,172.31.47.0-255,66,108981,90,200087
22142,0.00141,172.217.27.0-255,4320,113301,90,200087
22143,0.001412,172.31.47.0-255,66,113367,90,200087
22144,0.001417,172.217.27.0-255,4320,117687,90,200087
22145,0.001419,172.31.47.0-255,66,117753,90,200087
22146,0.001446,172.217.27.0-255,4320,122073,90,200087
22147,0.00145,172.31.47.0-255,66,122139,90,200087
22148,0.001455,172.217.27.0-255,3602,125741,90,200087
22149,0.001457,172.31.47.0-255,66,125807,90,200087
22150,0.001461,172.217.27.0-255,4320,130127,90,200087
22151,0.001463,172.31.47.0-255,66,130193,90,200087
22152,0.001466,172.217.27.0-255,1484,131677,90,200087
22153,0.001489,172.217.27.0-255,8574,140251,90,200087
22154,0.001491,172.31.47.0-255,66,140317,90,200087
22155,0.001498,172.217.27.0-255,5738,146055,90,200087
22156,0.001499,172.31.47.0-255,66,146121,90,200087
22157,0.001522,172.217.27.0-255,7156,153277,90,200087
22158,0.001524,172.31.47.0-255,66,153343,90,200087
22159,0.001538,172.217.27.0-255,3602,156945,90,200087
22160,0.00154,172.31.47.0-255,66,157011,90,200087
22161,0.00159,172.217.27.0-255,1484,158495,90,200087
22162,0.001605,172.217.27.0-255,2902,161397,90,200087
22163,0.001607,172.31.47.0-255,66,161463,90,200087
22164,0.001609,172.217.27.0-255,1484,162947,90,200087
22165,0.001627,172.217.27.0-255,4320,167267,90,200087
22166,0.001629,172.31.47.0-255,66,167333,90,200087
22167,0.001661,172.31.47.0-255,66,167399,90,200087
22168,0.001703,172.217.27.0-255,1484,168883,90,200087
22169,0.00173,172.217.27.0-255,9274,178157,90,200087
22170,0.001733,172.31.47.0-255,66,178223,90,200087
22171,0.003427,172.217.27.0-255,5738,183961,90,200087
22172,0.003432,172.31.47.0-255,66,184027,90,200087
22173,0.005199,172.217.27.0-255,4320,188347,90,200087
22174,0.005203,172.31.47.0-255,66,188413,90,200087
22175,0.005219,172.217.27.0-255,1484,189897,90,200087
22176,0.006881,172.217.27.0-255,4320,194217,90,200087
22177,0.006885,172.31.47.0-255,66,194283,90,200087
22178,0.00857,172.217.27.0-255,5738,200021,90,200087
22179,0.008577,172.31.47.0-255,66,200087,90,200087
22180,0.0,74.125.130.0-255,152,152,90,217012
22181,2.7e-05,172.31.47.0-255,66,218,90,217012
22182,3.3e-05,74.125.130.0-255,1484,1702,90,217012
22183,3.7e-05,172.31.47.0-255,66,1768,90,217012
22184,4.1e-05,74.125.130.0-255,2902,4670,90,217012
22185,4.4e-05,172.31.47.0-255,66,4736,90,217012
22186,6.9e-05,74.125.130.0-255,5738,10474,90,217012
22187,7.2e-05,172.31.47.0-255,66,10540,90,217012
22188,0.000102,74.125.130.0-255,3593,14133,90,217012
22189,0.000105,172.31.47.0-255,66,14199,90,217012
22190,0.000251,74.125.130.0-255,1484,15683,90,217012
22191,0.000255,172.31.47.0-255,66,15749,90,217012
22192,0.000259,74.125.130.0-255,1484,17233,90,217012
22193,0.00026,172.31.47.0-255,66,17299,90,217012
22194,0.000282,74.125.130.0-255,1484,18783,90,217012
22195,0.000284,172.31.47.0-255,66,18849,90,217012
22196,0.000289,74.125.130.0-255,4320,23169,90,217012
22197,0.000294,172.31.47.0-255,66,23235,90,217012
22198,0.000306,74.125.130.0-255,1484,24719,90,217012
22199,0.000308,172.31.47.0-255,66,24785,90,217012
22200,0.000315,74.125.130.0-255,6797,31582,90,217012
22201,0.000317,172.31.47.0-255,66,31648,90,217012
22202,0.000501,74.125.130.0-255,1484,33132,90,217012
22203,0.000505,172.31.47.0-255,66,33198,90,217012
22204,0.000512,74.125.130.0-255,2902,36100,90,217012
22205,0.000514,172.31.47.0-255,66,36166,90,217012
22206,0.000553,74.125.130.0-255,5738,41904,90,217012
22207,0.000555,172.31.47.0-255,66,41970,90,217012
22208,0.00056,74.125.130.0-255,2902,44872,90,217012
22209,0.000561,172.31.47.0-255,66,44938,90,217012
22210,0.000565,74.125.130.0-255,3961,48899,90,217012
22211,0.000572,172.31.47.0-255,66,48965,90,217012
22212,0.000607,74.125.130.0-255,8574,57539,90,217012
22213,0.000612,74.125.130.0-255,2902,60441,90,217012
22214,0.00064,74.125.130.0-255,1484,61925,90,217012
22215,0.000657,74.125.130.0-255,4237,66162,90,217012
22216,0.000713,74.125.130.0-255,114,66276,90,217012
22217,0.000881,74.125.130.0-255,1484,67760,90,217012
22218,0.000896,74.125.130.0-255,2902,70662,90,217012
22219,0.000917,74.125.130.0-255,4320,74982,90,217012
22220,0.000954,74.125.130.0-255,4320,79302,90,217012
22221,0.000975,74.125.130.0-255,3961,83263,90,217012
22222,0.000981,74.125.130.0-255,5738,89001,90,217012
22223,0.001001,74.125.130.0-255,2902,91903,90,217012
22224,0.001006,74.125.130.0-255,4320,96223,90,217012
22225,0.001018,74.125.130.0-255,3961,100184,90,217012
22226,0.00144,74.125.130.0-255,1484,101668,90,217012
22227,0.001449,74.125.130.0-255,1484,103152,90,217012
22228,0.001462,74.125.130.0-255,2902,106054,90,217012
22229,0.001474,74.125.130.0-255,1484,107538,90,217012
22230,0.00149,74.125.130.0-255,4320,111858,90,217012
22231,0.001504,74.125.130.0-255,4320,116178,90,217012
22232,0.00152,74.125.130.0-255,4320,120498,90,217012
22233,0.001534,74.125.130.0-255,1484,121982,90,217012
22234,0.001544,74.125.130.0-255,2902,124884,90,217012
22235,0.001562,74.125.130.0-255,5738,130622,90,217012
22236,0.001567,74.125.130.0-255,3602,134224,90,217012
22237,0.001738,74.125.130.0-255,1484,135708,90,217012
22238,0.001758,74.125.130.0-255,2902,138610,90,217012
22239,0.001769,74.125.130.0-255,1484,140094,90,217012
22240,0.001785,74.125.130.0-255,4320,144414,90,217012
22241,0.00181,74.125.130.0-255,5738,150152,90,217012
22242,0.001823,74.125.130.0-255,5738,155890,90,217012
22243,0.001832,74.125.130.0-255,1484,157374,90,217012
22244,0.001864,74.125.130.0-255,4320,161694,90,217012
22245,0.001886,74.125.130.0-255,6438,168132,90,217012
22246,0.002099,74.125.130.0-255,1484,169616,90,217012
22247,0.002119,74.125.130.0-255,1484,171100,90,217012
22248,0.002135,74.125.130.0-255,2902,174002,90,217012
22249,0.002146,74.125.130.0-255,1484,175486,90,217012
22250,0.002161,74.125.130.0-255,4320,179806,90,217012
22251,0.002181,74.125.130.0-255,1484,181290,90,217012
22252,0.002202,74.125.130.0-255,2902,184192,90,217012
22253,0.00222,74.125.130.0-255,2902,187094,90,217012
22254,0.002231,74.125.130.0-255,1484,188578,90,217012
22255,0.002245,74.125.130.0-255,2902,191480,90,217012
22256,0.002261,74.125.130.0-255,1484,192964,90,217012
22257,0.002274,74.125.130.0-255,2902,195866,90,217012
22258,0.00231,74.125.130.0-255,5738,201604,90,217012
22259,0.002313,74.125.130.0-255,766,202370,90,217012
22260,0.002544,74.125.130.0-255,1484,203854,90,217012
22261,0.002555,74.125.130.0-255,1484,205338,90,217012
22262,0.004827,172.31.47.0-255,66,205404,90,217012
22263,0.007391,74.125.130.0-255,5738,211142,90,217012
22264,0.007397,172.31.47.0-255,66,211208,90,217012
22265,0.009945,74.125.130.0-255,5738,216946,90,217012
22266,0.009953,172.31.47.0-255,66,217012,90,217012
22267,0.0,172.31.47.0-255,66,66,90,66
22268,0.0,172.217.194.0-255,153,153,90,311146
22269,3.1e-05,172.31.47.0-255,66,219,90,311146
22270,3.9e-05,172.217.194.0-255,1484,1703,90,311146
22271,4.3e-05,172.31.47.0-255,66,1769,90,311146
22272,5.5e-05,172.217.194.0-255,2902,4671,90,311146
22273,5.9e-05,172.31.47.0-255,66,4737,90,311146
22274,6.5e-05,172.217.194.0-255,4320,9057,90,311146
22275,6.8e-05,172.31.47.0-255,66,9123,90,311146
22276,9.3e-05,172.217.194.0-255,1484,10607,90,311146
22277,9.6e-05,172.31.47.0-255,66,10673,90,311146
22278,0.000103,172.217.194.0-255,3374,14047,90,311146
22279,0.000106,172.31.47.0-255,66,14113,90,311146
22280,0.000195,172.217.194.0-255,1484,15597,90,311146
22281,0.000199,172.31.47.0-255,66,15663,90,311146
22282,0.000205,172.217.194.0-255,2902,18565,90,311146
22283,0.000207,172.31.47.0-255,66,18631,90,311146
22284,0.000242,172.217.194.0-255,2902,21533,90,311146
22285,0.000245,172.31.47.0-255,66,21599,90,311146
22286,0.000267,172.217.194.0-255,4320,25919,90,311146
22287,0.00027,172.31.47.0-255,66,25985,90,311146
22288,0.000297,172.217.194.0-255,4320,30305,90,311146
22289,0.000301,172.31.47.0-255,66,30371,90,311146
22290,0.000331,172.217.194.0-255,5379,35750,90,311146
22291,0.000335,172.31.47.0-255,66,35816,90,311146
22292,0.000343,172.217.194.0-255,9992,45808,90,311146
22293,0.000346,172.31.47.0-255,66,45874,90,311146
22294,0.000365,172.31.47.0-255,66,45940,90,311146
22295,0.000415,172.217.194.0-255,5020,50960,90,311146
22296,0.000419,172.31.47.0-255,66,51026,90,311146
22297,0.000422,172.217.194.0-255,648,51674,90,311146
22298,0.000425,172.31.47.0-255,66,51740,90,311146
22299,0.000441,172.217.194.0-255,1484,53224,90,311146
22300,0.000464,172.217.194.0-255,4320,57544,90,311146
22301,0.000467,172.31.47.0-255,66,57610,90,311146
22302,0.000472,172.217.194.0-255,2902,60512,90,311146
22303,0.000474,172.31.47.0-255,66,60578,90,311146
22304,0.000502,172.217.194.0-255,7156,67734,90,311146
22305,0.000505,172.31.47.0-255,66,67800,90,311146
22306,0.00051,172.217.194.0-255,4320,72120,90,311146
22307,0.000513,172.31.47.0-255,66,72186,90,311146
22308,0.000537,172.217.194.0-255,1484,73670,90,311146
22309,0.000544,172.217.194.0-255,5738,79408,90,311146
22310,0.000547,172.31.47.0-255,66,79474,90,311146
22311,0.000576,172.217.194.0-255,6438,85912,90,311146
22312,0.00058,172.31.47.0-255,66,85978,90,311146
22313,0.000609,172.217.194.0-255,1484,87462,90,311146
22314,0.000614,172.217.194.0-255,1484,88946,90,311146
22315,0.000616,172.31.47.0-255,66,89012,90,311146
22316,0.000638,172.217.194.0-255,1484,90496,90,311146
22317,0.000645,172.217.194.0-255,5738,96234,90,311146
22318,0.000648,172.31.47.0-255,66,96300,90,311146
22319,0.000652,172.217.194.0-255,1484,97784,90,311146
22320,0.000674,172.217.194.0-255,4320,102104,90,311146
22321,0.000677,172.31.47.0-255,66,102170,90,311146
22322,0.000692,172.31.47.0-255,66,102236,90,311146
22323,0.000715,172.217.194.0-255,1484,103720,90,311146
22324,0.000722,172.217.194.0-255,5020,108740,90,311146
22325,0.000724,172.31.47.0-255,66,108806,90,311146
22326,0.000871,172.217.194.0-255,1484,110290,90,311146
22327,0.000877,172.217.194.0-255,2902,113192,90,311146
22328,0.000879,172.31.47.0-255,66,113258,90,311146
22329,0.000885,172.217.194.0-255,5738,118996,90,311146
22330,0.000888,172.31.47.0-255,66,119062,90,311146
22331,0.00092,172.217.194.0-255,5738,124800,90,311146
22332,0.000923,172.31.47.0-255,66,124866,90,311146
22333,0.000942,172.217.194.0-255,7156,132022,90,311146
22334,0.000945,172.31.47.0-255,66,132088,90,311146
22335,0.000974,172.217.194.0-255,5738,137826,90,311146
22336,0.000976,172.31.47.0-255,66,137892,90,311146
22337,0.000981,172.217.194.0-255,5020,142912,90,311146
22338,0.000983,172.31.47.0-255,66,142978,90,311146
22339,0.001117,172.217.194.0-255,1484,144462,90,311146
22340,0.001133,172.217.194.0-255,2902,147364,90,311146
22341,0.001136,172.31.47.0-255,66,147430,90,311146
22342,0.00116,172.217.194.0-255,4320,151750,90,311146
22343,0.001162,172.31.47.0-255,66,151816,90,311146
22344,0.001167,172.217.194.0-255,2902,154718,90,311146
22345,0.001168,172.31.47.0-255,66,154784,90,311146
22346,0.001194,172.217.194.0-255,2902,157686,90,311146
22347,0.001197,172.31.47.0-255,66,157752,90,311146
22348,0.00122,172.217.194.0-255,7156,164908,90,311146
22349,0.001223,172.31.47.0-255,66,164974,90,311146
22350,0.00125,172.217.194.0-255,4320,169294,90,311146
22351,0.001252,172.31.47.0-255,66,169360,90,311146
22352,0.001258,172.217.194.0-255,5738,175098,90,311146
22353,0.00126,172.31.47.0-255,66,175164,90,311146
22354,0.001306,172.217.194.0-255,2902,178066,90,311146
22355,0.001309,172.31.47.0-255,66,178132,90,311146
22356,0.001335,172.31.47.0-255,66,178198,90,311146
22357,0.001361,172.217.194.0-255,5020,183218,90,311146
22358,0.001364,172.31.47.0-255,66,183284,90,311146
22359,0.001369,172.217.194.0-255,7156,190440,90,311146
22360,0.001371,172.31.47.0-255,66,190506,90,311146
22361,0.001412,172.31.47.0-255,66,190572,90,311146
22362,0.001447,172.217.194.0-255,8574,199146,90,311146
22363,0.00145,172.31.47.0-255,66,199212,90,311146
22364,0.001483,172.31.47.0-255,66,199278,90,311146
22365,0.001489,172.217.194.0-255,8574,207852,90,311146
22366,0.001492,172.31.47.0-255,66,207918,90,311146
22367,0.001496,172.217.194.0-255,2902,210820,90,311146
22368,0.001509,172.31.47.0-255,66,210886,90,311146
22369,0.001542,172.217.194.0-255,7856,218742,90,311146
22370,0.001547,172.31.47.0-255,66,218808,90,311146
22371,0.001558,172.31.47.0-255,66,218874,90,311146
22372,0.001563,172.217.194.0-255,8574,227448,90,311146
22373,0.001566,172.31.47.0-255,66,227514,90,311146
22374,0.001594,172.217.194.0-255,10692,238206,90,311146
22375,0.001597,172.31.47.0-255,66,238272,90,311146
22376,0.001602,172.217.194.0-255,5738,244010,90,311146
22377,0.001604,172.31.47.0-255,66,244076,90,311146
22378,0.001639,172.217.194.0-255,5738,249814,90,311146
22379,0.001642,172.31.47.0-255,66,249880,90,311146
22380,0.001653,172.31.47.0-255,66,249946,90,311146
22381,0.001657,172.217.194.0-255,1484,251430,90,311146
22382,0.001679,172.217.194.0-255,7856,259286,90,311146
22383,0.001682,172.31.47.0-255,66,259352,90,311146
22384,0.001689,172.217.194.0-255,9992,269344,90,311146
22385,0.001692,172.31.47.0-255,66,269410,90,311146
22386,0.001696,172.217.194.0-255,5738,275148,90,311146
22387,0.001698,172.31.47.0-255,66,275214,90,311146
22388,0.001704,172.217.194.0-255,7156,282370,90,311146
22389,0.001706,172.31.47.0-255,66,282436,90,311146
22390,0.001746,172.217.194.0-255,6438,288874,90,311146
22391,0.00175,172.31.47.0-255,66,288940,90,311146
22392,0.001753,172.217.194.0-255,1484,290424,90,311146
22393,0.001779,172.217.194.0-255,5738,296162,90,311146
22394,0.001784,172.31.47.0-255,66,296228,90,311146
22395,0.001786,172.217.194.0-255,9992,306220,90,311146
22396,0.001789,172.31.47.0-255,66,306286,90,311146
22397,0.001807,172.217.194.0-255,1484,307770,90,311146
22398,0.001829,172.217.194.0-255,2902,310672,90,311146
22399,0.001833,172.31.47.0-255,66,310738,90,311146
22400,0.001867,172.31.47.0-255,66,310804,90,311146
22401,0.00187,172.217.194.0-255,105,310909,90,311146
22402,0.002947,172.31.47.0-255,66,310975,90,311146
22403,0.00297,172.31.47.0-255,105,311080,90,311146
22404,0.004955,172.217.194.0-255,66,311146,90,311146
22405,0.0,172.31.47.0-255,66,66,90,66
22406,0.0,172.31.47.0-255,105,105,90,105
22407,0.0,74.125.68.0-255,153,153,90,237696
22408,1.7e-05,172.31.47.0-255,66,219,90,237696
22409,4.2e-05,74.125.68.0-255,1484,1703,90,237696
22410,4.8e-05,172.31.47.0-255,66,1769,90,237696
22411,7.7e-05,74.125.68.0-255,2902,4671,90,237696
22412,8.1e-05,172.31.47.0-255,66,4737,90,237696
22413,0.000114,74.125.68.0-255,4320,9057,90,237696
22414,0.000117,172.31.47.0-255,66,9123,90,237696
22415,0.000124,74.125.68.0-255,5046,14169,90,237696
22416,0.000127,172.31.47.0-255,66,14235,90,237696
22417,0.00023,74.125.68.0-255,1484,15719,90,237696
22418,0.000234,172.31.47.0-255,66,15785,90,237696
22419,0.000264,74.125.68.0-255,2902,18687,90,237696
22420,0.000267,172.31.47.0-255,66,18753,90,237696
22421,0.000271,74.125.68.0-255,1484,20237,90,237696
22422,0.000273,172.31.47.0-255,66,20303,90,237696
22423,0.000278,74.125.68.0-255,2902,23205,90,237696
22424,0.000281,172.31.47.0-255,66,23271,90,237696
22425,0.000292,74.125.68.0-255,5738,29009,90,237696
22426,0.000295,172.31.47.0-255,66,29075,90,237696
22427,0.000299,74.125.68.0-255,2543,31618,90,237696
22428,0.000302,172.31.47.0-255,66,31684,90,237696
22429,0.000329,74.125.68.0-255,1484,33168,90,237696
22430,0.000345,172.31.47.0-255,66,33234,90,237696
22431,0.000373,74.125.68.0-255,1484,34718,90,237696
22432,0.000376,172.31.47.0-255,66,34784,90,237696
22433,0.000382,74.125.68.0-255,4320,39104,90,237696
22434,0.000385,172.31.47.0-255,66,39170,90,237696
22435,0.000415,74.125.68.0-255,1484,40654,90,237696
22436,0.000418,172.31.47.0-255,66,40720,90,237696
22437,0.000423,74.125.68.0-255,2902,43622,90,237696
22438,0.000425,172.31.47.0-255,66,43688,90,237696
22439,0.000443,74.125.68.0-255,1484,45172,90,237696
22440,0.000484,74.125.68.0-255,2902,48074,90,237696
22441,0.000487,172.31.47.0-255,66,48140,90,237696
22442,0.000544,74.125.68.0-255,4320,52460,90,237696
22443,0.000548,172.31.47.0-255,66,52526,90,237696
22444,0.000593,74.125.68.0-255,5738,58264,90,237696
22445,0.000596,172.31.47.0-255,66,58330,90,237696
22446,0.000625,74.125.68.0-255,7156,65486,90,237696
22447,0.000628,172.31.47.0-255,66,65552,90,237696
22448,0.000631,74.125.68.0-255,766,66318,90,237696
22449,0.000731,74.125.68.0-255,356,66674,90,237696
22450,0.000773,74.125.68.0-255,136,66810,90,237696
22451,0.001029,74.125.68.0-255,1484,68294,90,237696
22452,0.001034,172.31.47.0-255,66,68360,90,237696
22453,0.00104,74.125.68.0-255,2902,71262,90,237696
22454,0.001042,172.31.47.0-255,66,71328,90,237696
22455,0.00107,74.125.68.0-255,4320,75648,90,237696
22456,0.001072,172.31.47.0-255,66,75714,90,237696
22457,0.001075,74.125.68.0-255,1484,77198,90,237696
22458,0.001106,74.125.68.0-255,7156,84354,90,237696
22459,0.001109,74.125.68.0-255,1484,85838,90,237696
22460,0.001113,172.31.47.0-255,66,85904,90,237696
22461,0.001152,74.125.68.0-255,1484,87388,90,237696
22462,0.001155,172.31.47.0-255,66,87454,90,237696
22463,0.001185,74.125.68.0-255,2902,90356,90,237696
22464,0.001187,172.31.47.0-255,66,90422,90,237696
22465,0.001215,74.125.68.0-255,1484,91906,90,237696
22466,0.00125,74.125.68.0-255,1484,93390,90,237696
22467,0.001253,172.31.47.0-255,66,93456,90,237696
22468,0.00127,74.125.68.0-255,2902,96358,90,237696
22469,0.001272,172.31.47.0-255,66,96424,90,237696
22470,0.001298,74.125.68.0-255,2902,99326,90,237696
22471,0.0013,172.31.47.0-255,66,99392,90,237696
22472,0.001322,74.125.68.0-255,2184,101576,90,237696
22473,0.001325,172.31.47.0-255,66,101642,90,237696
22474,0.00175,74.125.68.0-255,1484,103126,90,237696
22475,0.001767,74.125.68.0-255,2902,106028,90,237696
22476,0.00177,172.31.47.0-255,66,106094,90,237696
22477,0.001773,74.125.68.0-255,1484,107578,90,237696
22478,0.001797,74.125.68.0-255,4320,111898,90,237696
22479,0.0018,172.31.47.0-255,66,111964,90,237696
22480,0.001832,74.125.68.0-255,5738,117702,90,237696
22481,0.001834,172.31.47.0-255,66,117768,90,237696
22482,0.001841,74.125.68.0-255,7156,124924,90,237696
22483,0.001843,172.31.47.0-255,66,124990,90,237696
22484,0.001871,74.125.68.0-255,8574,133564,90,237696
22485,0.001873,172.31.47.0-255,66,133630,90,237696
22486,0.001901,74.125.68.0-255,5738,139368,90,237696
22487,0.001903,172.31.47.0-255,66,139434,90,237696
22488,0.001927,74.125.68.0-255,3602,143036,90,237696
22489,0.00193,172.31.47.0-255,66,143102,90,237696
22490,0.001933,74.125.68.0-255,1484,144586,90,237696
22491,0.001937,74.125.68.0-255,2902,147488,90,237696
22492,0.001938,172.31.47.0-255,66,147554,90,237696
22493,0.001968,74.125.68.0-255,5738,153292,90,237696
22494,0.00197,172.31.47.0-255,66,153358,90,237696
22495,0.001976,74.125.68.0-255,5738,159096,90,237696
22496,0.001978,172.31.47.0-255,66,159162,90,237696
22497,0.001982,74.125.68.0-255,2902,162064,90,237696
22498,0.001984,172.31.47.0-255,66,162130,90,237696
22499,0.002013,74.125.68.0-255,4320,166450,90,237696
22500,0.002016,172.31.47.0-255,66,166516,90,237696
22501,0.002022,74.125.68.0-255,3602,170118,90,237696
22502,0.002024,172.31.47.0-255,66,170184,90,237696
22503,0.002058,74.125.68.0-255,2902,173086,90,237696
22504,0.00206,172.31.47.0-255,66,173152,90,237696
22505,0.00208,74.125.68.0-255,1484,174636,90,237696
22506,0.00209,74.125.68.0-255,9992,184628,90,237696
22507,0.002093,172.31.47.0-255,66,184694,90,237696
22508,0.002099,74.125.68.0-255,4320,189014,90,237696
22509,0.002101,172.31.47.0-255,66,189080,90,237696
22510,0.002151,172.31.47.0-255,66,189146,90,237696
22511,0.002179,74.125.68.0-255,8574,197720,90,237696
22512,0.002182,172.31.47.0-255,66,197786,90,237696
22513,0.002217,74.125.68.0-255,7156,204942,90,237696
22514,0.002223,74.125.68.0-255,5738,210680,90,237696
22515,0.002228,172.31.47.0-255,66,210746,90,237696
22516,0.002236,172.31.47.0-255,66,210812,90,237696
22517,0.002244,74.125.68.0-255,7156,217968,90,237696
22518,0.00225,172.31.47.0-255,66,218034,90,237696
22519,0.002286,74.125.68.0-255,7856,225890,90,237696
22520,0.002309,74.125.68.0-255,5738,231628,90,237696
22521,0.002311,74.125.68.0-255,1484,233112,90,237696
22522,0.002318,172.31.47.0-255,66,233178,90,237696
22523,0.007111,172.31.47.0-255,66,233244,90,237696
22524,0.007117,172.31.47.0-255,66,233310,90,237696
22525,0.009394,74.125.68.0-255,4320,237630,90,237696
22526,0.0094,172.31.47.0-255,66,237696,90,237696
22527,0.0,172.31.47.0-255,165,165,90,231
22528,0.007301,74.125.24.0-255,66,231,90,231
22529,0.0,172.217.194.0-255,154,154,90,220164
22530,2.6e-05,172.31.47.0-255,66,220,90,220164
22531,3.2e-05,172.217.194.0-255,1484,1704,90,220164
22532,3.6e-05,172.31.47.0-255,66,1770,90,220164
22533,4e-05,172.217.194.0-255,2902,4672,90,220164
22534,4.2e-05,172.31.47.0-255,66,4738,90,220164
22535,4.5e-05,172.217.194.0-255,2902,7640,90,220164
22536,4.8e-05,172.31.47.0-255,66,7706,90,220164
22537,0.000101,172.217.194.0-255,4320,12026,90,220164
22538,0.000104,172.31.47.0-255,66,12092,90,220164
22539,0.000114,172.217.194.0-255,2171,14263,90,220164
22540,0.000117,172.31.47.0-255,66,14329,90,220164
22541,0.000262,172.217.194.0-255,1484,15813,90,220164
22542,0.000265,172.31.47.0-255,66,15879,90,220164
22543,0.000271,172.217.194.0-255,2902,18781,90,220164
22544,0.000273,172.31.47.0-255,66,18847,90,220164
22545,0.000287,172.217.194.0-255,5738,24585,90,220164
22546,0.00029,172.31.47.0-255,66,24651,90,220164
22547,0.000315,172.217.194.0-255,6797,31448,90,220164
22548,0.000318,172.31.47.0-255,66,31514,90,220164
22549,0.000321,172.217.194.0-255,1484,32998,90,220164
22550,0.000323,172.31.47.0-255,66,33064,90,220164
22551,0.000352,172.31.47.0-255,66,33130,90,220164
22552,0.000355,172.217.194.0-255,2902,36032,90,220164
22553,0.000357,172.31.47.0-255,66,36098,90,220164
22554,0.000403,172.31.47.0-255,66,36164,90,220164
22555,0.000507,172.217.194.0-255,377,36541,90,220164
22556,0.000511,172.31.47.0-255,66,36607,90,220164
22557,0.000738,172.217.194.0-255,1484,38091,90,220164
22558,0.000742,172.31.47.0-255,66,38157,90,220164
22559,0.000746,172.217.194.0-255,1484,39641,90,220164
22560,0.00076,172.217.194.0-255,1484,41125,90,220164
22561,0.000761,172.31.47.0-255,66,41191,90,220164
22562,0.000774,172.217.194.0-255,1484,42675,90,220164
22563,0.000787,172.217.194.0-255,4320,46995,90,220164
22564,0.00079,172.31.47.0-255,66,47061,90,220164
22565,0.000802,172.217.194.0-255,1484,48545,90,220164
22566,0.000831,172.31.47.0-255,66,48611,90,220164
22567,0.00084,172.217.194.0-255,10412,59023,90,220164
22568,0.000843,172.31.47.0-255,66,59089,90,220164
22569,0.000875,172.217.194.0-255,1484,60573,90,220164
22570,0.000878,172.217.194.0-255,1484,62057,90,220164
22571,0.000881,172.31.47.0-255,66,62123,90,220164
22572,0.000898,172.217.194.0-255,1484,63607,90,220164
22573,0.000903,172.217.194.0-255,5738,69345,90,220164
22574,0.000905,172.31.47.0-255,66,69411,90,220164
22575,0.000917,172.217.194.0-255,2902,72313,90,220164
22576,0.00092,172.31.47.0-255,66,72379,90,220164
22577,0.000942,172.217.194.0-255,9992,82371,90,220164
22578,0.000944,172.31.47.0-255,66,82437,90,220164
22579,0.000946,172.217.194.0-255,1484,83921,90,220164
22580,0.000975,172.217.194.0-255,2902,86823,90,220164
22581,0.000978,172.31.47.0-255,66,86889,90,220164
22582,0.001,172.217.194.0-255,6438,93327,90,220164
22583,0.001002,172.31.47.0-255,66,93393,90,220164
22584,0.001374,172.217.194.0-255,1484,94877,90,220164
22585,0.001381,172.217.194.0-255,1484,96361,90,220164
22586,0.001384,172.31.47.0-255,66,96427,90,220164
22587,0.0014,172.217.194.0-255,1484,97911,90,220164
22588,0.001406,172.217.194.0-255,5738,103649,90,220164
22589,0.001408,172.31.47.0-255,66,103715,90,220164
22590,0.001447,172.31.47.0-255,66,103781,90,220164
22591,0.00145,172.217.194.0-255,1484,105265,90,220164
22592,0.001465,172.217.194.0-255,7156,112421,90,220164
22593,0.001467,172.31.47.0-255,66,112487,90,220164
22594,0.001481,172.217.194.0-255,3602,116089,90,220164
22595,0.001483,172.31.47.0-255,66,116155,90,220164
22596,0.001806,172.217.194.0-255,1484,117639,90,220164
22597,0.00181,172.217.194.0-255,1484,119123,90,220164
22598,0.001813,172.31.47.0-255,66,119189,90,220164
22599,0.001828,172.217.194.0-255,1484,120673,90,220164
22600,0.001832,172.217.194.0-255,4320,124993,90,220164
22601,0.001834,172.31.47.0-255,66,125059,90,220164
22602,0.001851,172.217.194.0-255,1484,126543,90,220164
22603,0.001867,172.217.194.0-255,7156,133699,90,220164
22604,0.001869,172.31.47.0-255,66,133765,90,220164
22605,0.001934,172.217.194.0-255,5738,139503,90,220164
22606,0.001936,172.31.47.0-255,66,139569,90,220164
22607,0.001965,172.217.194.0-255,10692,150261,90,220164
22608,0.001966,172.31.47.0-255,66,150327,90,220164
22609,0.001979,172.31.47.0-255,66,150393,90,220164
22610,0.001989,172.31.47.0-255,66,150459,90,220164
22611,0.001992,172.217.194.0-255,1484,151943,90,220164
22612,0.002028,172.31.47.0-255,66,152009,90,220164
22613,0.002039,172.217.194.0-255,9992,162001,90,220164
22614,0.002041,172.31.47.0-255,66,162067,90,220164
22615,0.002069,172.217.194.0-255,8574,170641,90,220164
22616,0.002071,172.31.47.0-255,66,170707,90,220164
22617,0.002073,172.217.194.0-255,766,171473,90,220164
22618,0.002087,172.217.194.0-255,2902,174375,90,220164
22619,0.002089,172.31.47.0-255,66,174441,90,220164
22620,0.002125,172.31.47.0-255,66,174507,90,220164
22621,0.002129,172.217.194.0-255,4320,178827,90,220164
22622,0.002131,172.31.47.0-255,66,178893,90,220164
22623,0.002134,172.217.194.0-255,2902,181795,90,220164
22624,0.002136,172.31.47.0-255,66,181861,90,220164
22625,0.002168,172.217.194.0-255,5738,187599,90,220164
22626,0.00217,172.31.47.0-255,66,187665,90,220164
22627,0.002193,172.31.47.0-255,66,187731,90,220164
22628,0.002206,172.217.194.0-255,2184,189915,90,220164
22629,0.002208,172.31.47.0-255,66,189981,90,220164
22630,0.00222,172.31.47.0-255,66,190047,90,220164
22631,0.002222,172.217.194.0-255,766,190813,90,220164
22632,0.002229,172.217.194.0-255,9992,200805,90,220164
22633,0.002246,172.217.194.0-255,2902,203707,90,220164
22634,0.002263,172.217.194.0-255,2902,206609,90,220164
22635,0.002276,172.217.194.0-255,7156,213765,90,220164
22636,0.002328,172.217.194.0-255,1484,215249,90,220164
22637,0.002358,172.217.194.0-255,4573,219822,90,220164
22638,0.002361,172.217.194.0-255,105,219927,90,220164
22639,0.004527,172.31.47.0-255,66,219993,90,220164
22640,0.006618,172.31.47.0-255,105,220098,90,220164
22641,0.008642,172.217.194.0-255,66,220164,90,220164
22642,0.0,74.125.24.0-255,153,153,90,284818
22643,2.7e-05,172.31.47.0-255,66,219,90,284818
22644,3.4e-05,74.125.24.0-255,1484,1703,90,284818
22645,3.7e-05,172.31.47.0-255,66,1769,90,284818
22646,5.2e-05,74.125.24.0-255,2902,4671,90,284818
22647,5.6e-05,172.31.47.0-255,66,4737,90,284818
22648,6.3e-05,74.125.24.0-255,7156,11893,90,284818
22649,6.6e-05,172.31.47.0-255,66,11959,90,284818
22650,7e-05,74.125.24.0-255,2108,14067,90,284818
22651,7.2e-05,172.31.47.0-255,66,14133,90,284818
22652,0.000159,74.125.24.0-255,1484,15617,90,284818
22653,0.000162,172.31.47.0-255,66,15683,90,284818
22654,0.000179,74.125.24.0-255,2902,18585,90,284818
22655,0.000184,172.31.47.0-255,66,18651,90,284818
22656,0.000194,74.125.24.0-255,4320,22971,90,284818
22657,0.000201,172.31.47.0-255,66,23037,90,284818
22658,0.00021,74.125.24.0-255,1484,24521,90,284818
22659,0.000212,172.31.47.0-255,66,24587,90,284818
22660,0.000222,74.125.24.0-255,5738,30325,90,284818
22661,0.000225,172.31.47.0-255,66,30391,90,284818
22662,0.000261,74.125.24.0-255,4320,34711,90,284818
22663,0.000263,172.31.47.0-255,66,34777,90,284818
22664,0.00029,74.125.24.0-255,2543,37320,90,284818
22665,0.000292,172.31.47.0-255,66,37386,90,284818
22666,0.000299,74.125.24.0-255,7156,44542,90,284818
22667,0.000301,172.31.47.0-255,66,44608,90,284818
22668,0.000309,74.125.24.0-255,3961,48569,90,284818
22669,0.000312,172.31.47.0-255,66,48635,90,284818
22670,0.000543,74.125.24.0-255,1484,50119,90,284818
22671,0.000549,172.31.47.0-255,66,50185,90,284818
22672,0.000555,74.125.24.0-255,2902,53087,90,284818
22673,0.000557,172.31.47.0-255,66,53153,90,284818
22674,0.000567,74.125.24.0-255,2902,56055,90,284818
22675,0.00057,172.31.47.0-255,66,56121,90,284818
22676,0.000595,74.125.24.0-255,1484,57605,90,284818
22677,0.000599,74.125.24.0-255,1484,59089,90,284818
22678,0.000602,172.31.47.0-255,66,59155,90,284818
22679,0.000631,74.125.24.0-255,7131,66286,90,284818
22680,0.000634,172.31.47.0-255,66,66352,90,284818
22681,0.000678,74.125.24.0-255,342,66694,90,284818
22682,0.000713,74.125.24.0-255,1484,68178,90,284818
22683,0.000717,172.31.47.0-255,66,68244,90,284818
22684,0.000724,74.125.24.0-255,4320,72564,90,284818
22685,0.000727,172.31.47.0-255,66,72630,90,284818
22686,0.000761,74.125.24.0-255,8574,81204,90,284818
22687,0.000764,172.31.47.0-255,66,81270,90,284818
22688,0.000788,74.125.24.0-255,1484,82754,90,284818
22689,0.000795,74.125.24.0-255,5738,88492,90,284818
22690,0.000797,172.31.47.0-255,66,88558,90,284818
22691,0.000804,74.125.24.0-255,7156,95714,90,284818
22692,0.000806,172.31.47.0-255,66,95780,90,284818
22693,0.000843,74.125.24.0-255,5020,100800,90,284818
22694,0.000848,172.31.47.0-255,66,100866,90,284818
22695,0.000859,74.125.24.0-255,1484,102350,90,284818
22696,0.000868,74.125.24.0-255,2902,105252,90,284818
22697,0.000871,172.31.47.0-255,66,105318,90,284818
22698,0.000892,74.125.24.0-255,5738,111056,90,284818
22699,0.000896,172.31.47.0-255,66,111122,90,284818
22700,0.000903,74.125.24.0-255,7156,118278,90,284818
22701,0.000905,172.31.47.0-255,66,118344,90,284818
22702,0.000954,74.125.24.0-255,5738,124082,90,284818
22703,0.000959,172.31.47.0-255,66,124148,90,284818
22704,0.000966,74.125.24.0-255,7156,131304,90,284818
22705,0.00097,172.31.47.0-255,66,131370,90,284818
22706,0.000974,74.125.24.0-255,3602,134972,90,284818
22707,0.000976,172.31.47.0-255,66,135038,90,284818
22708,0.001007,74.125.24.0-255,4320,139358,90,284818
22709,0.001011,172.31.47.0-255,66,139424,90,284818
22710,0.00102,74.125.24.0-255,9992,149416,90,284818
22711,0.001022,172.31.47.0-255,66,149482,90,284818
22712,0.001027,74.125.24.0-255,5738,155220,90,284818
22713,0.001029,172.31.47.0-255,66,155286,90,284818
22714,0.0011,172.31.47.0-255,66,155352,90,284818
22715,0.001105,74.125.24.0-255,2902,158254,90,284818
22716,0.001107,172.31.47.0-255,66,158320,90,284818
22717,0.001157,172.31.47.0-255,66,158386,90,284818
22718,0.001164,74.125.24.0-255,7156,165542,90,284818
22719,0.001167,172.31.47.0-255,66,165608,90,284818
22720,0.001171,74.125.24.0-255,2902,168510,90,284818
22721,0.001173,172.31.47.0-255,66,168576,90,284818
22722,0.001215,74.125.24.0-255,9274,177850,90,284818
22723,0.001219,172.31.47.0-255,66,177916,90,284818
22724,0.001231,172.31.47.0-255,66,177982,90,284818
22725,0.001282,74.125.24.0-255,1484,179466,90,284818
22726,0.001297,74.125.24.0-255,2902,182368,90,284818
22727,0.0013,172.31.47.0-255,66,182434,90,284818
22728,0.001329,74.125.24.0-255,5738,188172,90,284818
22729,0.001332,172.31.47.0-255,66,188238,90,284818
22730,0.001337,74.125.24.0-255,4320,192558,90,284818
22731,0.001339,172.31.47.0-255,66,192624,90,284818
22732,0.001395,74.125.24.0-255,6438,199062,90,284818
22733,0.0014,172.31.47.0-255,66,199128,90,284818
22734,0.001603,74.125.24.0-255,1484,200612,90,284818
22735,0.001611,74.125.24.0-255,2902,203514,90,284818
22736,0.001625,172.31.47.0-255,66,203580,90,284818
22737,0.001634,74.125.24.0-255,5738,209318,90,284818
22738,0.001636,172.31.47.0-255,66,209384,90,284818
22739,0.001643,74.125.24.0-255,1484,210868,90,284818
22740,0.001676,74.125.24.0-255,5738,216606,90,284818
22741,0.001679,172.31.47.0-255,66,216672,90,284818
22742,0.001685,74.125.24.0-255,4320,220992,90,284818
22743,0.001687,172.31.47.0-255,66,221058,90,284818
22744,0.001723,74.125.24.0-255,9992,231050,90,284818
22745,0.001727,172.31.47.0-255,66,231116,90,284818
22746,0.001732,74.125.24.0-255,2184,233300,90,284818
22747,0.001734,172.31.47.0-255,66,233366,90,284818
22748,0.001971,74.125.24.0-255,1484,234850,90,284818
22749,0.001979,74.125.24.0-255,2902,237752,90,284818
22750,0.001983,172.31.47.0-255,66,237818,90,284818
22751,0.001991,74.125.24.0-255,5738,243556,90,284818
22752,0.001994,172.31.47.0-255,66,243622,90,284818
22753,0.002004,74.125.24.0-255,2902,246524,90,284818
22754,0.002007,172.31.47.0-255,66,246590,90,284818
22755,0.002049,74.125.24.0-255,9992,256582,90,284818
22756,0.002054,172.31.47.0-255,66,256648,90,284818
22757,0.002065,74.125.24.0-255,10692,267340,90,284818
22758,0.002068,172.31.47.0-255,66,267406,90,284818
22759,0.004114,74.125.24.0-255,5738,273144,90,284818
22760,0.004131,172.31.47.0-255,66,273210,90,284818
22761,0.0062,74.125.24.0-255,5738,278948,90,284818
22762,0.006224,172.31.47.0-255,66,279014,90,284818
22763,0.008286,74.125.24.0-255,5738,284752,90,284818
22764,0.008308,172.31.47.0-255,66,284818,90,284818
22765,0.0,172.217.194.0-255,298,298,90,165634
22766,2.4e-05,172.31.47.0-255,66,364,90,165634
22767,2.9e-05,172.217.194.0-255,1484,1848,90,165634
22768,3.3e-05,172.31.47.0-255,66,1914,90,165634
22769,3.8e-05,172.217.194.0-255,4320,6234,90,165634
22770,4e-05,172.31.47.0-255,66,6300,90,165634
22771,7.2e-05,172.217.194.0-255,7449,13749,90,165634
22772,7.5e-05,172.31.47.0-255,66,13815,90,165634
22773,0.000118,172.217.194.0-255,5738,19553,90,165634
22774,0.000121,172.31.47.0-255,66,19619,90,165634
22775,0.000138,172.217.194.0-255,2902,22521,90,165634
22776,0.00014,172.31.47.0-255,66,22587,90,165634
22777,0.000147,172.217.194.0-255,8215,30802,90,165634
22778,0.000149,172.31.47.0-255,66,30868,90,165634
22779,0.000151,172.217.194.0-255,1484,32352,90,165634
22780,0.000153,172.31.47.0-255,66,32418,90,165634
22781,0.000184,172.217.194.0-255,5738,38156,90,165634
22782,0.000187,172.31.47.0-255,66,38222,90,165634
22783,0.000194,172.217.194.0-255,8574,46796,90,165634
22784,0.000196,172.31.47.0-255,66,46862,90,165634
22785,0.0002,172.217.194.0-255,4320,51182,90,165634
22786,0.000206,172.31.47.0-255,66,51248,90,165634
22787,0.000247,172.31.47.0-255,66,51314,90,165634
22788,0.000249,172.217.194.0-255,766,52080,90,165634
22789,0.000251,172.31.47.0-255,66,52146,90,165634
22790,0.000253,172.217.194.0-255,412,52558,90,165634
22791,0.000255,172.31.47.0-255,66,52624,90,165634
22792,0.000439,172.217.194.0-255,362,52986,90,165634
22793,0.000443,172.31.47.0-255,66,53052,90,165634
22794,0.001078,172.217.194.0-255,1484,54536,90,165634
22795,0.001084,172.31.47.0-255,66,54602,90,165634
22796,0.001113,172.217.194.0-255,2902,57504,90,165634
22797,0.001116,172.31.47.0-255,66,57570,90,165634
22798,0.001135,172.217.194.0-255,4320,61890,90,165634
22799,0.001138,172.31.47.0-255,66,61956,90,165634
22800,0.00116,172.217.194.0-255,1484,63440,90,165634
22801,0.001173,172.31.47.0-255,66,63506,90,165634
22802,0.001179,172.217.194.0-255,5738,69244,90,165634
22803,0.001181,172.31.47.0-255,66,69310,90,165634
22804,0.001205,172.217.194.0-255,5020,74330,90,165634
22805,0.001207,172.31.47.0-255,66,74396,90,165634
22806,0.001685,172.217.194.0-255,1484,75880,90,165634
22807,0.001699,172.217.194.0-255,2902,78782,90,165634
22808,0.001702,172.31.47.0-255,66,78848,90,165634
22809,0.00173,172.217.194.0-255,5738,84586,90,165634
22810,0.001732,172.31.47.0-255,66,84652,90,165634
22811,0.001735,172.217.194.0-255,1484,86136,90,165634
22812,0.001765,172.31.47.0-255,66,86202,90,165634
22813,0.00177,172.217.194.0-255,5738,91940,90,165634
22814,0.001772,172.31.47.0-255,66,92006,90,165634
22815,0.001789,172.217.194.0-255,4320,96326,90,165634
22816,0.001794,172.31.47.0-255,66,96392,90,165634
22817,0.00181,172.217.194.0-255,4320,100712,90,165634
22818,0.001813,172.31.47.0-255,66,100778,90,165634
22819,0.00184,172.217.194.0-255,3602,104380,90,165634
22820,0.001843,172.31.47.0-255,66,104446,90,165634
22821,0.001849,172.217.194.0-255,8574,113020,90,165634
22822,0.001851,172.31.47.0-255,66,113086,90,165634
22823,0.001865,172.31.47.0-255,66,113152,90,165634
22824,0.001895,172.217.194.0-255,6438,119590,90,165634
22825,0.001897,172.31.47.0-255,66,119656,90,165634
22826,0.002379,172.217.194.0-255,1484,121140,90,165634
22827,0.00239,172.217.194.0-255,2902,124042,90,165634
22828,0.002392,172.31.47.0-255,66,124108,90,165634
22829,0.002396,172.217.194.0-255,2902,127010,90,165634
22830,0.002398,172.31.47.0-255,66,127076,90,165634
22831,0.002424,172.217.194.0-255,2902,129978,90,165634
22832,0.002426,172.31.47.0-255,66,130044,90,165634
22833,0.00243,172.217.194.0-255,2902,132946,90,165634
22834,0.002432,172.31.47.0-255,66,133012,90,165634
22835,0.00246,172.217.194.0-255,9992,143004,90,165634
22836,0.002462,172.31.47.0-255,66,143070,90,165634
22837,0.002485,172.217.194.0-255,7156,150226,90,165634
22838,0.002487,172.31.47.0-255,66,150292,90,165634
22839,0.002505,172.217.194.0-255,3602,153894,90,165634
22840,0.002507,172.31.47.0-255,66,153960,90,165634
22841,0.005075,172.217.194.0-255,5738,159698,90,165634
22842,0.005081,172.31.47.0-255,66,159764,90,165634
22843,0.007627,172.217.194.0-255,4320,164084,90,165634
22844,0.007635,172.31.47.0-255,66,164150,90,165634
22845,0.007665,172.217.194.0-255,1484,165634,90,165634
22846,0.0,74.125.24.0-255,146,146,90,316734
22847,1.9e-05,172.31.47.0-255,66,212,90,316734
22848,2.4e-05,74.125.24.0-255,1484,1696,90,316734
22849,2.7e-05,172.31.47.0-255,66,1762,90,316734
22850,3.2e-05,74.125.24.0-255,2902,4664,90,316734
22851,3.8e-05,172.31.47.0-255,66,4730,90,316734
22852,7.3e-05,74.125.24.0-255,7156,11886,90,316734
22853,7.6e-05,172.31.47.0-255,66,11952,90,316734
22854,8.1e-05,74.125.24.0-255,2173,14125,90,316734
22855,8.3e-05,172.31.47.0-255,66,14191,90,316734
22856,0.000124,172.31.47.0-255,66,14257,90,316734
22857,0.000128,74.125.24.0-255,4320,18577,90,316734
22858,0.00013,172.31.47.0-255,66,18643,90,316734
22859,0.000145,74.125.24.0-255,1125,19768,90,316734
22860,0.000148,172.31.47.0-255,66,19834,90,316734
22861,0.00019,74.125.24.0-255,1484,21318,90,316734
22862,0.000192,172.31.47.0-255,66,21384,90,316734
22863,0.000197,74.125.24.0-255,4320,25704,90,316734
22864,0.000199,172.31.47.0-255,66,25770,90,316734
22865,0.000231,74.125.24.0-255,5738,31508,90,316734
22866,0.000236,172.31.47.0-255,66,31574,90,316734
22867,0.000237,74.125.24.0-255,6797,38371,90,316734
22868,0.000239,172.31.47.0-255,66,38437,90,316734
22869,0.000283,172.31.47.0-255,66,38503,90,316734
22870,0.000286,74.125.24.0-255,1434,39937,90,316734
22871,0.000287,172.31.47.0-255,66,40003,90,316734
22872,0.00029,74.125.24.0-255,115,40118,90,316734
22873,0.000291,172.31.47.0-255,66,40184,90,316734
22874,0.000349,74.125.24.0-255,1484,41668,90,316734
22875,0.000352,172.31.47.0-255,66,41734,90,316734
22876,0.000369,74.125.24.0-255,2902,44636,90,316734
22877,0.000371,172.31.47.0-255,66,44702,90,316734
22878,0.000374,74.125.24.0-255,1484,46186,90,316734
22879,0.000393,74.125.24.0-255,5738,51924,90,316734
22880,0.000396,172.31.47.0-255,66,51990,90,316734
22881,0.000423,74.125.24.0-255,2902,54892,90,316734
22882,0.000425,172.31.47.0-255,66,54958,90,316734
22883,0.000429,74.125.24.0-255,2543,57501,90,316734
22884,0.00043,172.31.47.0-255,66,57567,90,316734
22885,0.00052,74.125.24.0-255,1484,59051,90,316734
22886,0.000534,74.125.24.0-255,2902,61953,90,316734
22887,0.000536,74.125.24.0-255,1484,63437,90,316734
22888,0.000538,172.31.47.0-255,66,63503,90,316734
22889,0.000546,74.125.24.0-255,4320,67823,90,316734
22890,0.000548,172.31.47.0-255,66,67889,90,316734
22891,0.000581,74.125.24.0-255,5738,73627,90,316734
22892,0.000584,172.31.47.0-255,66,73693,90,316734
22893,0.000609,74.125.24.0-255,1390,75083,90,316734
22894,0.000706,74.125.24.0-255,1484,76567,90,316734
22895,0.000709,172.31.47.0-255,66,76633,90,316734
22896,0.000737,74.125.24.0-255,2902,79535,90,316734
22897,0.00074,172.31.47.0-255,66,79601,90,316734
22898,0.000745,74.125.24.0-255,5738,85339,90,316734
22899,0.000748,172.31.47.0-255,66,85405,90,316734
22900,0.000762,74.125.24.0-255,2902,88307,90,316734
22901,0.000764,172.31.47.0-255,66,88373,90,316734
22902,0.000791,74.125.24.0-255,9992,98365,90,316734
22903,0.000793,172.31.47.0-255,66,98431,90,316734
22904,0.000801,74.125.24.0-255,9992,108423,90,316734
22905,0.000803,172.31.47.0-255,66,108489,90,316734
22906,0.000823,74.125.24.0-255,766,109255,90,316734
22907,0.000827,74.125.24.0-255,1484,110739,90,316734
22908,0.000829,172.31.47.0-255,66,110805,90,316734
22909,0.000862,74.125.24.0-255,4320,115125,90,316734
22910,0.000864,172.31.47.0-255,66,115191,90,316734
22911,0.000871,74.125.24.0-255,9992,125183,90,316734
22912,0.000874,172.31.47.0-255,66,125249,90,316734
22913,0.000912,74.125.24.0-255,9992,135241,90,316734
22914,0.000915,172.31.47.0-255,66,135307,90,316734
22915,0.000938,74.125.24.0-255,5738,141045,90,316734
22916,0.000941,172.31.47.0-255,66,141111,90,316734
22917,0.000969,74.125.24.0-255,2184,143295,90,316734
22918,0.000972,172.31.47.0-255,66,143361,90,316734
22919,0.000978,74.125.24.0-255,8574,151935,90,316734
22920,0.000981,172.31.47.0-255,66,152001,90,316734
22921,0.000985,74.125.24.0-255,2902,154903,90,316734
22922,0.000986,172.31.47.0-255,66,154969,90,316734
22923,0.001033,172.31.47.0-255,66,155035,90,316734
22924,0.00104,74.125.24.0-255,6438,161473,90,316734
22925,0.001042,172.31.47.0-255,66,161539,90,316734
22926,0.001157,74.125.24.0-255,1484,163023,90,316734
22927,0.001173,74.125.24.0-255,2902,165925,90,316734
22928,0.001177,172.31.47.0-255,66,165991,90,316734
22929,0.001182,74.125.24.0-255,5738,171729,90,316734
22930,0.001184,172.31.47.0-255,66,171795,90,316734
22931,0.001212,74.125.24.0-255,9992,181787,90,316734
22932,0.001215,172.31.47.0-255,66,181853,90,316734
22933,0.001245,74.125.24.0-255,4320,186173,90,316734
22934,0.001248,172.31.47.0-255,66,186239,90,316734
22935,0.001281,74.125.24.0-255,9274,195513,90,316734
22936,0.001284,172.31.47.0-255,66,195579,90,316734
22937,0.001354,74.125.24.0-255,1484,197063,90,316734
22938,0.001358,74.125.24.0-255,1484,198547,90,316734
22939,0.00136,172.31.47.0-255,66,198613,90,316734
22940,0.001372,74.125.24.0-255,1484,200097,90,316734
22941,0.001381,74.125.24.0-255,5738,205835,90,316734
22942,0.001384,172.31.47.0-255,66,205901,90,316734
22943,0.001388,74.125.24.0-255,4320,210221,90,316734
22944,0.00139,172.31.47.0-255,66,210287,90,316734
22945,0.001441,172.31.47.0-255,66,210353,90,316734
22946,0.001443,74.125.24.0-255,7156,217509,90,316734
22947,0.001444,172.31.47.0-255,66,217575,90,316734
22948,0.001463,74.125.24.0-255,766,218341,90,316734
22949,0.001544,74.125.24.0-255,1484,219825,90,316734
22950,0.001547,172.31.47.0-255,66,219891,90,316734
22951,0.001552,74.125.24.0-255,2902,222793,90,316734
22952,0.001554,172.31.47.0-255,66,222859,90,316734
22953,0.001597,74.125.24.0-255,5738,228597,90,316734
22954,0.0016,172.31.47.0-255,66,228663,90,316734
22955,0.001605,74.125.24.0-255,4320,232983,90,316734
22956,0.001607,172.31.47.0-255,66,233049,90,316734
22957,0.00163,74.125.24.0-255,4320,237369,90,316734
22958,0.001633,172.31.47.0-255,66,237435,90,316734
22959,0.001668,74.125.24.0-255,7156,244591,90,316734
22960,0.001672,172.31.47.0-255,66,244657,90,316734
22961,0.001673,74.125.24.0-255,5738,250395,90,316734
22962,0.001675,172.31.47.0-255,66,250461,90,316734
22963,0.001702,74.125.24.0-255,2184,252645,90,316734
22964,0.001705,172.31.47.0-255,66,252711,90,316734
22965,0.001743,74.125.24.0-255,2902,255613,90,316734
22966,0.001747,74.125.24.0-255,4320,259933,90,316734
22967,0.001747,172.31.47.0-255,66,259999,90,316734
22968,0.00175,172.31.47.0-255,66,260065,90,316734
22969,0.001783,74.125.24.0-255,8574,268639,90,316734
22970,0.001785,172.31.47.0-255,66,268705,90,316734
22971,0.001812,74.125.24.0-255,9992,278697,90,316734
22972,0.001816,172.31.47.0-255,66,278763,90,316734
22973,0.001831,74.125.24.0-255,7856,286619,90,316734
22974,0.001839,172.31.47.0-255,66,286685,90,316734
22975,0.001843,74.125.24.0-255,9992,296677,90,316734
22976,0.001858,172.31.47.0-255,66,296743,90,316734
22977,0.001868,74.125.24.0-255,8574,305317,90,316734
22978,0.001873,172.31.47.0-255,66,305383,90,316734
22979,0.001894,172.31.47.0-255,66,305449,90,316734
22980,0.001919,74.125.24.0-255,5738,311187,90,316734
22981,0.001923,172.31.47.0-255,66,311253,90,316734
22982,0.001966,172.31.47.0-255,66,311319,90,316734
22983,0.002011,74.125.24.0-255,5007,316326,90,316734
22984,0.002014,74.125.24.0-255,105,316431,90,316734
22985,0.002016,172.31.47.0-255,66,316497,90,316734
22986,0.003061,172.31.47.0-255,66,316563,90,316734
22987,0.003089,172.31.47.0-255,105,316668,90,316734
22988,0.005026,74.125.24.0-255,66,316734,90,316734
22989,0.0,172.31.47.0-255,105,105,90,381
22990,4.9e-05,172.31.47.0-255,105,210,90,381
22991,0.001799,157.240.13.0-255,105,315,90,381
22992,0.001807,172.31.47.0-255,66,381,90,381
22993,0.0,172.31.47.0-255,66,66,90,66
22994,0.0,74.125.130.0-255,160,160,90,106897
22995,1.9e-05,172.31.47.0-255,66,226,90,106897
22996,2.6e-05,74.125.130.0-255,1484,1710,90,106897
22997,3.1e-05,172.31.47.0-255,66,1776,90,106897
22998,4.4e-05,74.125.130.0-255,2902,4678,90,106897
22999,4.8e-05,172.31.47.0-255,66,4744,90,106897
23000,5.4e-05,74.125.130.0-255,7156,11900,90,106897
23001,5.7e-05,172.31.47.0-255,66,11966,90,106897
23002,0.000135,74.125.130.0-255,2008,13974,90,106897
23003,0.000138,172.31.47.0-255,66,14040,90,106897
23004,0.000353,74.125.130.0-255,1484,15524,90,106897
23005,0.000358,172.31.47.0-255,66,15590,90,106897
23006,0.000363,74.125.130.0-255,2902,18492,90,106897
23007,0.000365,172.31.47.0-255,66,18558,90,106897
23008,0.000391,74.125.130.0-255,5738,24296,90,106897
23009,0.000393,172.31.47.0-255,66,24362,90,106897
23010,0.000461,74.125.130.0-255,4320,28682,90,106897
23011,0.000465,172.31.47.0-255,66,28748,90,106897
23012,0.000491,74.125.130.0-255,2543,31291,90,106897
23013,0.000493,172.31.47.0-255,66,31357,90,106897
23014,0.000558,74.125.130.0-255,1484,32841,90,106897
23015,0.000561,172.31.47.0-255,66,32907,90,106897
23016,0.000566,74.125.130.0-255,2902,35809,90,106897
23017,0.000568,172.31.47.0-255,66,35875,90,106897
23018,0.000603,74.125.130.0-255,5738,41613,90,106897
23019,0.000606,172.31.47.0-255,66,41679,90,106897
23020,0.000678,74.125.130.0-255,4320,45999,90,106897
23021,0.000685,172.31.47.0-255,66,46065,90,106897
23022,0.000693,74.125.130.0-255,2543,48608,90,106897
23023,0.000695,172.31.47.0-255,66,48674,90,106897
23024,0.000772,172.31.47.0-255,66,48740,90,106897
23025,0.000797,74.125.130.0-255,2902,51642,90,106897
23026,0.0008,172.31.47.0-255,66,51708,90,106897
23027,0.000953,74.125.130.0-255,2543,54251,90,106897
23028,0.000957,172.31.47.0-255,66,54317,90,106897
23029,0.00096,74.125.130.0-255,346,54663,90,106897
23030,0.000963,74.125.130.0-255,122,54785,90,106897
23031,0.001065,172.31.47.0-255,66,54851,90,106897
23032,0.001489,74.125.130.0-255,1484,56335,90,106897
23033,0.001499,74.125.130.0-255,2902,59237,90,106897
23034,0.001504,172.31.47.0-255,66,59303,90,106897
23035,0.001534,74.125.130.0-255,5738,65041,90,106897
23036,0.001536,172.31.47.0-255,66,65107,90,106897
23037,0.001593,74.125.130.0-255,6797,71904,90,106897
23038,0.001597,172.31.47.0-255,66,71970,90,106897
23039,0.001683,74.125.130.0-255,7156,79126,90,106897
23040,0.001687,172.31.47.0-255,66,79192,90,106897
23041,0.00172,74.125.130.0-255,7156,86348,90,106897
23042,0.001722,172.31.47.0-255,66,86414,90,106897
23043,0.001861,74.125.130.0-255,2543,88957,90,106897
23044,0.001865,172.31.47.0-255,66,89023,90,106897
23045,0.003994,74.125.130.0-255,2902,91925,90,106897
23046,0.003997,172.31.47.0-255,66,91991,90,106897
23047,0.004141,74.125.130.0-255,1484,93475,90,106897
23048,0.004155,74.125.130.0-255,1484,94959,90,106897
23049,0.004157,172.31.47.0-255,66,95025,90,106897
23050,0.006273,74.125.130.0-255,2902,97927,90,106897
23051,0.006279,172.31.47.0-255,66,97993,90,106897
23052,0.006419,74.125.130.0-255,2902,100895,90,106897
23053,0.006425,172.31.47.0-255,66,100961,90,106897
23054,0.008573,74.125.130.0-255,2902,103863,90,106897
23055,0.008588,172.31.47.0-255,66,103929,90,106897
23056,0.008687,74.125.130.0-255,2902,106831,90,106897
23057,0.008693,172.31.47.0-255,66,106897,90,106897
23058,0.0,172.31.47.0-255,105,105,90,276
23059,0.001811,157.240.7.0-255,105,210,90,276
23060,0.001833,172.31.47.0-255,66,276,90,276
23061,0.0,74.125.130.0-255,152,152,90,78507
23062,3e-05,172.31.47.0-255,66,218,90,78507
23063,3.6e-05,74.125.130.0-255,1484,1702,90,78507
23064,4e-05,172.31.47.0-255,66,1768,90,78507
23065,4.5e-05,74.125.130.0-255,2902,4670,90,78507
23066,5.4e-05,172.31.47.0-255,66,4736,90,78507
23067,5.8e-05,74.125.130.0-255,4320,9056,90,78507
23068,6e-05,172.31.47.0-255,66,9122,90,78507
23069,8.7e-05,74.125.130.0-255,2902,12024,90,78507
23070,8.9e-05,172.31.47.0-255,66,12090,90,78507
23071,9.4e-05,74.125.130.0-255,2013,14103,90,78507
23072,9.5e-05,172.31.47.0-255,66,14169,90,78507
23073,0.000787,74.125.130.0-255,1484,15653,90,78507
23074,0.000793,172.31.47.0-255,66,15719,90,78507
23075,0.000803,74.125.130.0-255,2902,18621,90,78507
23076,0.000813,172.31.47.0-255,66,18687,90,78507
23077,0.000818,74.125.130.0-255,5738,24425,90,78507
23078,0.00082,172.31.47.0-255,66,24491,90,78507
23079,0.000823,74.125.130.0-255,1484,25975,90,78507
23080,0.000827,172.31.47.0-255,66,26041,90,78507
23081,0.000836,74.125.130.0-255,2902,28943,90,78507
23082,0.000837,172.31.47.0-255,66,29009,90,78507
23083,0.000861,74.125.130.0-255,2543,31552,90,78507
23084,0.000865,172.31.47.0-255,66,31618,90,78507
23085,0.001402,74.125.130.0-255,1484,33102,90,78507
23086,0.001405,172.31.47.0-255,66,33168,90,78507
23087,0.00143,74.125.130.0-255,2902,36070,90,78507
23088,0.001432,172.31.47.0-255,66,36136,90,78507
23089,0.001454,74.125.130.0-255,1484,37620,90,78507
23090,0.001455,172.31.47.0-255,66,37686,90,78507
23091,0.001484,74.125.130.0-255,2902,40588,90,78507
23092,0.001486,172.31.47.0-255,66,40654,90,78507
23093,0.001506,74.125.130.0-255,1484,42138,90,78507
23094,0.001538,74.125.130.0-255,1484,43622,90,78507
23095,0.001558,74.125.130.0-255,2902,46524,90,78507
23096,0.001589,74.125.130.0-255,2543,49067,90,78507
23097,0.001613,74.125.130.0-255,1484,50551,90,78507
23098,0.001625,74.125.130.0-255,1484,52035,90,78507
23099,0.001635,74.125.130.0-255,1484,53519,90,78507
23100,0.001644,74.125.130.0-255,2902,56421,90,78507
23101,0.001666,74.125.130.0-255,4320,60741,90,78507
23102,0.00168,74.125.130.0-255,1484,62225,90,78507
23103,0.001704,74.125.130.0-255,3961,66186,90,78507
23104,0.002446,74.125.130.0-255,647,66833,90,78507
23105,0.002615,172.31.47.0-255,66,66899,90,78507
23106,0.005267,74.125.130.0-255,5738,72637,90,78507
23107,0.005273,172.31.47.0-255,66,72703,90,78507
23108,0.007865,74.125.130.0-255,5738,78441,90,78507
23109,0.007874,172.31.47.0-255,66,78507,90,78507
23110,0.0,172.31.47.0-255,105,105,90,276
23111,0.002045,157.240.13.0-255,105,210,90,276
23112,0.002057,172.31.47.0-255,66,276,90,276
23113,0.0,172.253.118.0-255,153,153,90,162774
23114,3e-05,172.31.47.0-255,66,219,90,162774
23115,3.6e-05,172.253.118.0-255,1484,1703,90,162774
23116,4e-05,172.31.47.0-255,66,1769,90,162774
23117,4.5e-05,172.253.118.0-255,2902,4671,90,162774
23118,5.3e-05,172.31.47.0-255,66,4737,90,162774
23119,5.9e-05,172.253.118.0-255,7156,11893,90,162774
23120,6.2e-05,172.31.47.0-255,66,11959,90,162774
23121,8.5e-05,172.253.118.0-255,2171,14130,90,162774
23122,8.7e-05,172.31.47.0-255,66,14196,90,162774
23123,0.000301,172.253.118.0-255,1484,15680,90,162774
23124,0.000306,172.31.47.0-255,66,15746,90,162774
23125,0.000311,172.253.118.0-255,2902,18648,90,162774
23126,0.000313,172.31.47.0-255,66,18714,90,162774
23127,0.000345,172.253.118.0-255,5738,24452,90,162774
23128,0.000348,172.31.47.0-255,66,24518,90,162774
23129,0.000353,172.253.118.0-255,4320,28838,90,162774
23130,0.000355,172.31.47.0-255,66,28904,90,162774
23131,0.000392,172.253.118.0-255,1484,30388,90,162774
23132,0.000395,172.31.47.0-255,66,30454,90,162774
23133,0.000429,172.31.47.0-255,66,30520,90,162774
23134,0.000434,172.253.118.0-255,5738,36258,90,162774
23135,0.000437,172.31.47.0-255,66,36324,90,162774
23136,0.000445,172.253.118.0-255,1125,37449,90,162774
23137,0.000447,172.31.47.0-255,66,37515,90,162774
23138,0.000744,172.253.118.0-255,1484,38999,90,162774
23139,0.000749,172.31.47.0-255,66,39065,90,162774
23140,0.000778,172.253.118.0-255,2902,41967,90,162774
23141,0.000782,172.31.47.0-255,66,42033,90,162774
23142,0.000787,172.253.118.0-255,5738,47771,90,162774
23143,0.000789,172.31.47.0-255,66,47837,90,162774
23144,0.000802,172.253.118.0-255,7127,54964,90,162774
23145,0.000882,172.253.118.0-255,1484,56448,90,162774
23146,0.000886,172.253.118.0-255,1484,57932,90,162774
23147,0.000899,172.253.118.0-255,1484,59416,90,162774
23148,0.000905,172.253.118.0-255,4320,63736,90,162774
23149,0.000919,172.253.118.0-255,1484,65220,90,162774
23150,0.000922,172.253.118.0-255,1484,66704,90,162774
23151,0.000942,172.253.118.0-255,5738,72442,90,162774
23152,0.000959,172.253.118.0-255,5738,78180,90,162774
23153,0.000968,172.253.118.0-255,10692,88872,90,162774
23154,0.000971,172.253.118.0-255,348,89220,90,162774
23155,0.001742,172.253.118.0-255,1484,90704,90,162774
23156,0.001749,172.253.118.0-255,2902,93606,90,162774
23157,0.001768,172.253.118.0-255,5738,99344,90,162774
23158,0.001784,172.253.118.0-255,4320,103664,90,162774
23159,0.001802,172.253.118.0-255,8574,112238,90,162774
23160,0.001806,172.253.118.0-255,2902,115140,90,162774
23161,0.001824,172.253.118.0-255,7156,122296,90,162774
23162,0.001839,172.253.118.0-255,766,123062,90,162774
23163,0.002047,172.253.118.0-255,1484,124546,90,162774
23164,0.002057,172.253.118.0-255,2902,127448,90,162774
23165,0.002069,172.253.118.0-255,5738,133186,90,162774
23166,0.002083,172.253.118.0-255,1484,134670,90,162774
23167,0.002128,172.253.118.0-255,4320,138990,90,162774
23168,0.002145,172.253.118.0-255,7156,146146,90,162774
23169,0.002152,172.253.118.0-255,9992,156138,90,162774
23170,0.002154,172.253.118.0-255,766,156904,90,162774
23171,0.005436,172.31.47.0-255,66,156970,90,162774
23172,0.007759,172.253.118.0-255,5738,162708,90,162774
23173,0.007767,172.31.47.0-255,66,162774,90,162774
23174,0.0,74.125.130.0-255,152,152,90,128787
23175,1.5e-05,172.31.47.0-255,66,218,90,128787
23176,2.3e-05,74.125.130.0-255,1484,1702,90,128787
23177,2.7e-05,172.31.47.0-255,66,1768,90,128787
23178,3.3e-05,74.125.130.0-255,2902,4670,90,128787
23179,3.7e-05,172.31.47.0-255,66,4736,90,128787
23180,4.3e-05,74.125.130.0-255,4320,9056,90,128787
23181,4.7e-05,172.31.47.0-255,66,9122,90,128787
23182,6.7e-05,74.125.130.0-255,2902,12024,90,128787
23183,7e-05,172.31.47.0-255,66,12090,90,128787
23184,7.4e-05,74.125.130.0-255,2221,14311,90,128787
23185,7.7e-05,172.31.47.0-255,66,14377,90,128787
23186,0.000228,74.125.130.0-255,1484,15861,90,128787
23187,0.000233,172.31.47.0-255,66,15927,90,128787
23188,0.000239,74.125.130.0-255,2902,18829,90,128787
23189,0.000242,172.31.47.0-255,66,18895,90,128787
23190,0.000247,74.125.130.0-255,2902,21797,90,128787
23191,0.000249,172.31.47.0-255,66,21863,90,128787
23192,0.000277,74.125.130.0-255,2902,24765,90,128787
23193,0.000279,172.31.47.0-255,66,24831,90,128787
23194,0.000287,74.125.130.0-255,6797,31628,90,128787
23195,0.000289,172.31.47.0-255,66,31694,90,128787
23196,0.000399,74.125.130.0-255,1484,33178,90,128787
23197,0.000403,172.31.47.0-255,66,33244,90,128787
23198,0.000409,74.125.130.0-255,2902,36146,90,128787
23199,0.000412,172.31.47.0-255,66,36212,90,128787
23200,0.000417,74.125.130.0-255,4320,40532,90,128787
23201,0.00042,172.31.47.0-255,66,40598,90,128787
23202,0.000432,74.125.130.0-255,1484,42082,90,128787
23203,0.000434,172.31.47.0-255,66,42148,90,128787
23204,0.000464,74.125.130.0-255,8574,50722,90,128787
23205,0.000467,172.31.47.0-255,66,50788,90,128787
23206,0.000491,74.125.130.0-255,5379,56167,90,128787
23207,0.000494,172.31.47.0-255,66,56233,90,128787
23208,0.000501,74.125.130.0-255,8574,64807,90,128787
23209,0.000503,172.31.47.0-255,66,64873,90,128787
23210,0.000521,74.125.130.0-255,1419,66292,90,128787
23211,0.00069,74.125.130.0-255,383,66675,90,128787
23212,0.000694,172.31.47.0-255,66,66741,90,128787
23213,0.001014,74.125.130.0-255,1484,68225,90,128787
23214,0.001023,74.125.130.0-255,2902,71127,90,128787
23215,0.001027,172.31.47.0-255,66,71193,90,128787
23216,0.001032,74.125.130.0-255,2902,74095,90,128787
23217,0.001034,172.31.47.0-255,66,74161,90,128787
23218,0.001048,74.125.130.0-255,2902,77063,90,128787
23219,0.00105,172.31.47.0-255,66,77129,90,128787
23220,0.001078,172.31.47.0-255,66,77195,90,128787
23221,0.001086,74.125.130.0-255,8574,85769,90,128787
23222,0.001088,172.31.47.0-255,66,85835,90,128787
23223,0.00113,74.125.130.0-255,2184,88019,90,128787
23224,0.001133,172.31.47.0-255,66,88085,90,128787
23225,0.001898,74.125.130.0-255,1484,89569,90,128787
23226,0.001905,74.125.130.0-255,2902,92471,90,128787
23227,0.001909,172.31.47.0-255,66,92537,90,128787
23228,0.001914,74.125.130.0-255,2902,95439,90,128787
23229,0.001916,172.31.47.0-255,66,95505,90,128787
23230,0.00193,74.125.130.0-255,2902,98407,90,128787
23231,0.001932,172.31.47.0-255,66,98473,90,128787
23232,0.001935,74.125.130.0-255,2902,101375,90,128787
23233,0.001937,172.31.47.0-255,66,101441,90,128787
23234,0.001958,74.125.130.0-255,7156,108597,90,128787
23235,0.00196,172.31.47.0-255,66,108663,90,128787
23236,0.001971,172.31.47.0-255,66,108729,90,128787
23237,0.001994,74.125.130.0-255,2184,110913,90,128787
23238,0.001996,172.31.47.0-255,66,110979,90,128787
23239,0.00404,74.125.130.0-255,2902,113881,90,128787
23240,0.004045,172.31.47.0-255,66,113947,90,128787
23241,0.004067,74.125.130.0-255,2902,116849,90,128787
23242,0.00407,172.31.47.0-255,66,116915,90,128787
23243,0.006116,74.125.130.0-255,2902,119817,90,128787
23244,0.006121,172.31.47.0-255,66,119883,90,128787
23245,0.006137,74.125.130.0-255,2902,122785,90,128787
23246,0.006139,172.31.47.0-255,66,122851,90,128787
23247,0.00819,74.125.130.0-255,2902,125753,90,128787
23248,0.008196,172.31.47.0-255,66,125819,90,128787
23249,0.008216,74.125.130.0-255,2902,128721,90,128787
23250,0.008218,172.31.47.0-255,66,128787,90,128787
23251,0.0,172.217.194.0-255,153,153,90,260295
23252,2.3e-05,172.31.47.0-255,66,219,90,260295
23253,2.9e-05,172.217.194.0-255,1484,1703,90,260295
23254,3.3e-05,172.31.47.0-255,66,1769,90,260295
23255,3.9e-05,172.217.194.0-255,2902,4671,90,260295
23256,4.2e-05,172.31.47.0-255,66,4737,90,260295
23257,4.7e-05,172.217.194.0-255,5738,10475,90,260295
23258,5e-05,172.31.47.0-255,66,10541,90,260295
23259,5.6e-05,172.217.194.0-255,6367,16908,90,260295
23260,5.8e-05,172.31.47.0-255,66,16974,90,260295
23261,6.1e-05,172.217.194.0-255,1484,18458,90,260295
23262,6.3e-05,172.31.47.0-255,66,18524,90,260295
23263,0.000106,172.31.47.0-255,66,18590,90,260295
23264,0.000194,172.217.194.0-255,1484,20074,90,260295
23265,0.000198,172.31.47.0-255,66,20140,90,260295
23266,0.000203,172.217.194.0-255,2902,23042,90,260295
23267,0.000204,172.31.47.0-255,66,23108,90,260295
23268,0.000233,172.217.194.0-255,5738,28846,90,260295
23269,0.000236,172.31.47.0-255,66,28912,90,260295
23270,0.00024,172.217.194.0-255,2902,31814,90,260295
23271,0.000241,172.31.47.0-255,66,31880,90,260295
23272,0.000257,172.217.194.0-255,2902,34782,90,260295
23273,0.000259,172.31.47.0-255,66,34848,90,260295
23274,0.000269,172.217.194.0-255,1484,36332,90,260295
23275,0.000271,172.31.47.0-255,66,36398,90,260295
23276,0.000305,172.31.47.0-255,66,36464,90,260295
23277,0.000309,172.217.194.0-255,4248,40712,90,260295
23278,0.000311,172.31.47.0-255,66,40778,90,260295
23279,0.000409,172.217.194.0-255,100,40878,90,260295
23280,0.000412,172.31.47.0-255,66,40944,90,260295
23281,0.000538,172.217.194.0-255,364,41308,90,260295
23282,0.000698,172.217.194.0-255,1484,42792,90,260295
23283,0.000703,172.217.194.0-255,2902,45694,90,260295
23284,0.000708,172.31.47.0-255,66,45760,90,260295
23285,0.000728,172.217.194.0-255,5738,51498,90,260295
23286,0.000738,172.31.47.0-255,66,51564,90,260295
23287,0.000746,172.217.194.0-255,2902,54466,90,260295
23288,0.000749,172.31.47.0-255,66,54532,90,260295
23289,0.000766,172.217.194.0-255,9992,64524,90,260295
23290,0.000771,172.217.194.0-255,4320,68844,90,260295
23291,0.000785,172.217.194.0-255,5738,74582,90,260295
23292,0.000793,172.31.47.0-255,66,74648,90,260295
23293,0.0008,172.217.194.0-255,766,75414,90,260295
23294,0.000991,172.217.194.0-255,1484,76898,90,260295
23295,0.000994,172.31.47.0-255,66,76964,90,260295
23296,0.000999,172.217.194.0-255,2902,79866,90,260295
23297,0.001014,172.217.194.0-255,5738,85604,90,260295
23298,0.001042,172.31.47.0-255,66,85670,90,260295
23299,0.00108,172.217.194.0-255,10692,96362,90,260295
23300,0.0011,172.31.47.0-255,66,96428,90,260295
23301,0.001104,172.217.194.0-255,4320,100748,90,260295
23302,0.001108,172.31.47.0-255,66,100814,90,260295
23303,0.001124,172.217.194.0-255,7156,107970,90,260295
23304,0.001133,172.217.194.0-255,8574,116544,90,260295
23305,0.001153,172.31.47.0-255,66,116610,90,260295
23306,0.001174,172.217.194.0-255,8574,125184,90,260295
23307,0.001189,172.217.194.0-255,5020,130204,90,260295
23308,0.001216,172.217.194.0-255,8574,138778,90,260295
23309,0.001219,172.31.47.0-255,66,138844,90,260295
23310,0.001224,172.31.47.0-255,66,138910,90,260295
23311,0.00124,172.217.194.0-255,5738,144648,90,260295
23312,0.00125,172.217.194.0-255,8574,153222,90,260295
23313,0.001268,172.31.47.0-255,66,153288,90,260295
23314,0.001299,172.217.194.0-255,4320,157608,90,260295
23315,0.001317,172.31.47.0-255,66,157674,90,260295
23316,0.001324,172.217.194.0-255,6438,164112,90,260295
23317,0.001334,172.31.47.0-255,66,164178,90,260295
23318,0.001743,172.217.194.0-255,1484,165662,90,260295
23319,0.001763,172.217.194.0-255,2902,168564,90,260295
23320,0.001766,172.31.47.0-255,66,168630,90,260295
23321,0.001771,172.217.194.0-255,2902,171532,90,260295
23322,0.001777,172.31.47.0-255,66,171598,90,260295
23323,0.001788,172.217.194.0-255,2902,174500,90,260295
23324,0.00179,172.217.194.0-255,1484,175984,90,260295
23325,0.001794,172.31.47.0-255,66,176050,90,260295
23326,0.001807,172.217.194.0-255,1484,177534,90,260295
23327,0.001824,172.217.194.0-255,7156,184690,90,260295
23328,0.00183,172.31.47.0-255,66,184756,90,260295
23329,0.001852,172.217.194.0-255,4320,189076,90,260295
23330,0.00186,172.217.194.0-255,9274,198350,90,260295
23331,0.001867,172.31.47.0-255,66,198416,90,260295
23332,0.001885,172.217.194.0-255,1484,199900,90,260295
23333,0.001888,172.217.194.0-255,1484,201384,90,260295
23334,0.001898,172.31.47.0-255,66,201450,90,260295
23335,0.001906,172.217.194.0-255,1484,202934,90,260295
23336,0.001908,172.217.194.0-255,1484,204418,90,260295
23337,0.001913,172.31.47.0-255,66,204484,90,260295
23338,0.001927,172.217.194.0-255,4320,208804,90,260295
23339,0.001933,172.217.194.0-255,5738,214542,90,260295
23340,0.001955,172.217.194.0-255,7156,221698,90,260295
23341,0.001959,172.217.194.0-255,1484,223182,90,260295
23342,0.001966,172.31.47.0-255,66,223248,90,260295
23343,0.002002,172.217.194.0-255,5738,228986,90,260295
23344,0.002018,172.217.194.0-255,7156,236142,90,260295
23345,0.002023,172.31.47.0-255,66,236208,90,260295
23346,0.002034,172.217.194.0-255,1484,237692,90,260295
23347,0.0021,172.31.47.0-255,66,237758,90,260295
23348,0.00219,172.217.194.0-255,2902,240660,90,260295
23349,0.002193,172.217.194.0-255,1484,242144,90,260295
23350,0.002213,172.217.194.0-255,7856,250000,90,260295
23351,0.002218,172.31.47.0-255,66,250066,90,260295
23352,0.00224,172.217.194.0-255,9992,260058,90,260295
23353,0.002255,172.31.47.0-255,66,260124,90,260295
23354,0.002282,172.217.194.0-255,105,260229,90,260295
23355,0.002305,172.31.47.0-255,66,260295,90,260295
23356,0.0,172.217.194.0-255,298,298,90,208967
23357,3.5e-05,172.31.47.0-255,66,364,90,208967
23358,4.2e-05,172.217.194.0-255,1484,1848,90,208967
23359,4.6e-05,172.31.47.0-255,66,1914,90,208967
23360,5.2e-05,172.217.194.0-255,4320,6234,90,208967
23361,5.4e-05,172.31.47.0-255,66,6300,90,208967
23362,7.1e-05,172.217.194.0-255,8937,15237,90,208967
23363,7.3e-05,172.31.47.0-255,66,15303,90,208967
23364,8.2e-05,172.217.194.0-255,9992,25295,90,208967
23365,8.6e-05,172.31.47.0-255,66,25361,90,208967
23366,0.000111,172.217.194.0-255,1484,26845,90,208967
23367,0.000114,172.31.47.0-255,66,26911,90,208967
23368,0.000138,172.217.194.0-255,3961,30872,90,208967
23369,0.000142,172.31.47.0-255,66,30938,90,208967
23370,0.000167,172.217.194.0-255,1484,32422,90,208967
23371,0.000171,172.31.47.0-255,66,32488,90,208967
23372,0.000175,172.217.194.0-255,2902,35390,90,208967
23373,0.000177,172.31.47.0-255,66,35456,90,208967
23374,0.000206,172.217.194.0-255,5738,41194,90,208967
23375,0.000214,172.31.47.0-255,66,41260,90,208967
23376,0.000217,172.217.194.0-255,1484,42744,90,208967
23377,0.000218,172.31.47.0-255,66,42810,90,208967
23378,0.000261,172.217.194.0-255,8215,51025,90,208967
23379,0.000265,172.31.47.0-255,66,51091,90,208967
23380,0.000273,172.217.194.0-255,9992,61083,90,208967
23381,0.000275,172.31.47.0-255,66,61149,90,208967
23382,0.000285,172.217.194.0-255,4250,65399,90,208967
23383,0.000288,172.217.194.0-255,98,65497,90,208967
23384,0.00029,172.31.47.0-255,66,65563,90,208967
23385,0.000293,172.31.47.0-255,66,65629,90,208967
23386,0.000851,172.217.194.0-255,364,65993,90,208967
23387,0.000856,172.31.47.0-255,66,66059,90,208967
23388,0.000948,172.217.194.0-255,1484,67543,90,208967
23389,0.000955,172.217.194.0-255,2902,70445,90,208967
23390,0.000958,172.31.47.0-255,66,70511,90,208967
23391,0.000963,172.217.194.0-255,1484,71995,90,208967
23392,0.000994,172.217.194.0-255,4320,76315,90,208967
23393,0.000998,172.31.47.0-255,66,76381,90,208967
23394,0.001016,172.31.47.0-255,66,76447,90,208967
23395,0.001047,172.217.194.0-255,5738,82185,90,208967
23396,0.00105,172.31.47.0-255,66,82251,90,208967
23397,0.001071,172.217.194.0-255,5890,88141,90,208967
23398,0.001075,172.31.47.0-255,66,88207,90,208967
23399,0.001169,172.217.194.0-255,1484,89691,90,208967
23400,0.001176,172.217.194.0-255,2902,92593,90,208967
23401,0.00118,172.31.47.0-255,66,92659,90,208967
23402,0.001187,172.217.194.0-255,5738,98397,90,208967
23403,0.001189,172.31.47.0-255,66,98463,90,208967
23404,0.00123,172.31.47.0-255,66,98529,90,208967
23405,0.001291,172.217.194.0-255,10692,109221,90,208967
23406,0.001296,172.31.47.0-255,66,109287,90,208967
23407,0.001723,172.217.194.0-255,1484,110771,90,208967
23408,0.001729,172.217.194.0-255,2902,113673,90,208967
23409,0.001732,172.31.47.0-255,66,113739,90,208967
23410,0.00174,172.217.194.0-255,5738,119477,90,208967
23411,0.001741,172.31.47.0-255,66,119543,90,208967
23412,0.001745,172.217.194.0-255,2902,122445,90,208967
23413,0.001753,172.31.47.0-255,66,122511,90,208967
23414,0.001791,172.217.194.0-255,2902,125413,90,208967
23415,0.001794,172.31.47.0-255,66,125479,90,208967
23416,0.001812,172.31.47.0-255,66,125545,90,208967
23417,0.001817,172.217.194.0-255,5020,130565,90,208967
23418,0.00182,172.31.47.0-255,66,130631,90,208967
23419,0.002079,172.217.194.0-255,1484,132115,90,208967
23420,0.002085,172.217.194.0-255,2902,135017,90,208967
23421,0.002089,172.31.47.0-255,66,135083,90,208967
23422,0.002096,172.217.194.0-255,5738,140821,90,208967
23423,0.002098,172.31.47.0-255,66,140887,90,208967
23424,0.002117,172.217.194.0-255,4320,145207,90,208967
23425,0.002121,172.31.47.0-255,66,145273,90,208967
23426,0.002164,172.217.194.0-255,8574,153847,90,208967
23427,0.002168,172.31.47.0-255,66,153913,90,208967
23428,0.002177,172.217.194.0-255,10692,164605,90,208967
23429,0.002185,172.31.47.0-255,66,164671,90,208967
23430,0.002229,172.31.47.0-255,66,164737,90,208967
23431,0.002241,172.31.47.0-255,66,164803,90,208967
23432,0.002266,172.217.194.0-255,4320,169123,90,208967
23433,0.002269,172.31.47.0-255,66,169189,90,208967
23434,0.002275,172.217.194.0-255,6438,175627,90,208967
23435,0.002282,172.31.47.0-255,66,175693,90,208967
23436,0.002318,172.217.194.0-255,7156,182849,90,208967
23437,0.002322,172.31.47.0-255,66,182915,90,208967
23438,0.002328,172.217.194.0-255,8574,191489,90,208967
23439,0.002331,172.31.47.0-255,66,191555,90,208967
23440,0.004655,172.217.194.0-255,5738,197293,90,208967
23441,0.004661,172.31.47.0-255,66,197359,90,208967
23442,0.007015,172.217.194.0-255,5738,203097,90,208967
23443,0.007021,172.31.47.0-255,66,203163,90,208967
23444,0.009312,172.217.194.0-255,5738,208901,90,208967
23445,0.009319,172.31.47.0-255,66,208967,90,208967
23446,0.0,172.217.194.0-255,153,153,90,327776
23447,2.6e-05,172.31.47.0-255,66,219,90,327776
23448,3.2e-05,172.217.194.0-255,1484,1703,90,327776
23449,3.5e-05,172.31.47.0-255,66,1769,90,327776
23450,4e-05,172.217.194.0-255,2902,4671,90,327776
23451,4.2e-05,172.31.47.0-255,66,4737,90,327776
23452,4.9e-05,172.217.194.0-255,7156,11893,90,327776
23453,5.1e-05,172.31.47.0-255,66,11959,90,327776
23454,0.000114,172.31.47.0-255,66,12025,90,327776
23455,0.000118,172.217.194.0-255,2543,14568,90,327776
23456,0.00012,172.31.47.0-255,66,14634,90,327776
23457,0.000176,172.217.194.0-255,1484,16118,90,327776
23458,0.000178,172.31.47.0-255,66,16184,90,327776
23459,0.000181,172.217.194.0-255,1484,17668,90,327776
23460,0.000183,172.31.47.0-255,66,17734,90,327776
23461,0.000196,172.217.194.0-255,1484,19218,90,327776
23462,0.000198,172.31.47.0-255,66,19284,90,327776
23463,0.000203,172.217.194.0-255,4320,23604,90,327776
23464,0.000205,172.31.47.0-255,66,23670,90,327776
23465,0.000227,172.217.194.0-255,1484,25154,90,327776
23466,0.00023,172.31.47.0-255,66,25220,90,327776
23467,0.000243,172.217.194.0-255,2902,28122,90,327776
23468,0.000246,172.31.47.0-255,66,28188,90,327776
23469,0.000264,172.217.194.0-255,4320,32508,90,327776
23470,0.000267,172.31.47.0-255,66,32574,90,327776
23471,0.000299,172.217.194.0-255,6797,39371,90,327776
23472,0.000302,172.31.47.0-255,66,39437,90,327776
23473,0.000309,172.217.194.0-255,8574,48011,90,327776
23474,0.000311,172.31.47.0-255,66,48077,90,327776
23475,0.000313,172.217.194.0-255,1413,49490,90,327776
23476,0.000316,172.31.47.0-255,66,49556,90,327776
23477,0.000331,172.217.194.0-255,99,49655,90,327776
23478,0.000383,172.217.194.0-255,1484,51139,90,327776
23479,0.000389,172.31.47.0-255,66,51205,90,327776
23480,0.000403,172.217.194.0-255,2902,54107,90,327776
23481,0.000406,172.31.47.0-255,66,54173,90,327776
23482,0.000412,172.217.194.0-255,5738,59911,90,327776
23483,0.000414,172.31.47.0-255,66,59977,90,327776
23484,0.000438,172.217.194.0-255,7156,67133,90,327776
23485,0.00044,172.31.47.0-255,66,67199,90,327776
23486,0.000467,172.217.194.0-255,6797,73996,90,327776
23487,0.00047,172.31.47.0-255,66,74062,90,327776
23488,0.000478,172.217.194.0-255,9633,83695,90,327776
23489,0.00048,172.31.47.0-255,66,83761,90,327776
23490,0.000824,172.217.194.0-255,1484,85245,90,327776
23491,0.000829,172.217.194.0-255,2902,88147,90,327776
23492,0.000832,172.31.47.0-255,66,88213,90,327776
23493,0.000835,172.217.194.0-255,1484,89697,90,327776
23494,0.000856,172.217.194.0-255,4320,94017,90,327776
23495,0.000858,172.31.47.0-255,66,94083,90,327776
23496,0.000865,172.217.194.0-255,7156,101239,90,327776
23497,0.000867,172.31.47.0-255,66,101305,90,327776
23498,0.000884,172.217.194.0-255,1484,102789,90,327776
23499,0.000912,172.217.194.0-255,1484,104273,90,327776
23500,0.000915,172.31.47.0-255,66,104339,90,327776
23501,0.000943,172.31.47.0-255,66,104405,90,327776
23502,0.00095,172.217.194.0-255,8574,112979,90,327776
23503,0.000952,172.31.47.0-255,66,113045,90,327776
23504,0.000979,172.217.194.0-255,7156,120201,90,327776
23505,0.000982,172.31.47.0-255,66,120267,90,327776
23506,0.000995,172.31.47.0-255,66,120333,90,327776
23507,0.001014,172.217.194.0-255,2184,122517,90,327776
23508,0.001017,172.31.47.0-255,66,122583,90,327776
23509,0.001187,172.217.194.0-255,1484,124067,90,327776
23510,0.001201,172.217.194.0-255,2902,126969,90,327776
23511,0.001205,172.31.47.0-255,66,127035,90,327776
23512,0.001224,172.217.194.0-255,5738,132773,90,327776
23513,0.001226,172.31.47.0-255,66,132839,90,327776
23514,0.001231,172.217.194.0-255,4320,137159,90,327776
23515,0.001233,172.31.47.0-255,66,137225,90,327776
23516,0.001249,172.217.194.0-255,8574,145799,90,327776
23517,0.001252,172.31.47.0-255,66,145865,90,327776
23518,0.001266,172.217.194.0-255,1484,147349,90,327776
23519,0.001287,172.217.194.0-255,9274,156623,90,327776
23520,0.00129,172.31.47.0-255,66,156689,90,327776
23521,0.001372,172.217.194.0-255,1484,158173,90,327776
23522,0.001377,172.217.194.0-255,2902,161075,90,327776
23523,0.00138,172.31.47.0-255,66,161141,90,327776
23524,0.001384,172.217.194.0-255,2902,164043,90,327776
23525,0.001386,172.31.47.0-255,66,164109,90,327776
23526,0.001408,172.217.194.0-255,2902,167011,90,327776
23527,0.00141,172.31.47.0-255,66,167077,90,327776
23528,0.001421,172.31.47.0-255,66,167143,90,327776
23529,0.001427,172.217.194.0-255,5738,172881,90,327776
23530,0.001429,172.31.47.0-255,66,172947,90,327776
23531,0.001449,172.217.194.0-255,2902,175849,90,327776
23532,0.001451,172.31.47.0-255,66,175915,90,327776
23533,0.001468,172.217.194.0-255,1484,177399,90,327776
23534,0.001486,172.217.194.0-255,7856,185255,90,327776
23535,0.001488,172.31.47.0-255,66,185321,90,327776
23536,0.001495,172.217.194.0-255,7156,192477,90,327776
23537,0.001496,172.31.47.0-255,66,192543,90,327776
23538,0.001514,172.217.194.0-255,2902,195445,90,327776
23539,0.001517,172.31.47.0-255,66,195511,90,327776
23540,0.001521,172.217.194.0-255,2902,198413,90,327776
23541,0.001523,172.31.47.0-255,66,198479,90,327776
23542,0.001559,172.217.194.0-255,9992,208471,90,327776
23543,0.001562,172.31.47.0-255,66,208537,90,327776
23544,0.001579,172.217.194.0-255,7856,216393,90,327776
23545,0.001582,172.31.47.0-255,66,216459,90,327776
23546,0.001587,172.217.194.0-255,5738,222197,90,327776
23547,0.00159,172.31.47.0-255,66,222263,90,327776
23548,0.001613,172.31.47.0-255,66,222329,90,327776
23549,0.001635,172.217.194.0-255,1484,223813,90,327776
23550,0.001643,172.217.194.0-255,7856,231669,90,327776
23551,0.001646,172.31.47.0-255,66,231735,90,327776
23552,0.001649,172.217.194.0-255,1484,233219,90,327776
23553,0.001666,172.217.194.0-255,2902,236121,90,327776
23554,0.001668,172.31.47.0-255,66,236187,90,327776
23555,0.001673,172.217.194.0-255,5738,241925,90,327776
23556,0.001676,172.31.47.0-255,66,241991,90,327776
23557,0.001678,172.217.194.0-255,1484,243475,90,327776
23558,0.001713,172.31.47.0-255,66,243541,90,327776
23559,0.001717,172.217.194.0-255,2902,246443,90,327776
23560,0.001719,172.31.47.0-255,66,246509,90,327776
23561,0.001742,172.217.194.0-255,7856,254365,90,327776
23562,0.001745,172.31.47.0-255,66,254431,90,327776
23563,0.001763,172.217.194.0-255,1484,255915,90,327776
23564,0.001782,172.217.194.0-255,1484,257399,90,327776
23565,0.001784,172.31.47.0-255,66,257465,90,327776
23566,0.001789,172.217.194.0-255,4320,261785,90,327776
23567,0.001792,172.31.47.0-255,66,261851,90,327776
23568,0.001795,172.217.194.0-255,2902,264753,90,327776
23569,0.001796,172.31.47.0-255,66,264819,90,327776
23570,0.001812,172.217.194.0-255,5738,270557,90,327776
23571,0.001814,172.31.47.0-255,66,270623,90,327776
23572,0.001835,172.217.194.0-255,7156,277779,90,327776
23573,0.001838,172.31.47.0-255,66,277845,90,327776
23574,0.001856,172.217.194.0-255,10692,288537,90,327776
23575,0.001859,172.31.47.0-255,66,288603,90,327776
23576,0.001862,172.217.194.0-255,1484,290087,90,327776
23577,0.001891,172.217.194.0-255,9992,300079,90,327776
23578,0.001894,172.31.47.0-255,66,300145,90,327776
23579,0.001922,172.217.194.0-255,7156,307301,90,327776
23580,0.001925,172.31.47.0-255,66,307367,90,327776
23581,0.00196,172.217.194.0-255,8574,315941,90,327776
23582,0.001962,172.31.47.0-255,66,316007,90,327776
23583,0.001975,172.217.194.0-255,1484,317491,90,327776
23584,0.001983,172.217.194.0-255,9877,327368,90,327776
23585,0.001985,172.31.47.0-255,66,327434,90,327776
23586,0.001987,172.217.194.0-255,105,327539,90,327776
23587,0.007121,172.31.47.0-255,66,327605,90,327776
23588,0.007144,172.31.47.0-255,105,327710,90,327776
23589,0.009134,172.217.194.0-255,66,327776,90,327776
23590,0.0,172.217.194.0-255,153,153,90,117143
23591,3e-05,172.31.47.0-255,66,219,90,117143
23592,3.7e-05,172.217.194.0-255,1484,1703,90,117143
23593,4.1e-05,172.31.47.0-255,66,1769,90,117143
23594,4.6e-05,172.217.194.0-255,2902,4671,90,117143
23595,5.5e-05,172.31.47.0-255,66,4737,90,117143
23596,6.2e-05,172.217.194.0-255,7156,11893,90,117143
23597,6.5e-05,172.31.47.0-255,66,11959,90,117143
23598,0.000108,172.31.47.0-255,66,12025,90,117143
23599,0.000115,172.217.194.0-255,6797,18822,90,117143
23600,0.000117,172.31.47.0-255,66,18888,90,117143
23601,0.000284,172.217.194.0-255,1484,20372,90,117143
23602,0.000288,172.31.47.0-255,66,20438,90,117143
23603,0.000294,172.217.194.0-255,2902,23340,90,117143
23604,0.000296,172.31.47.0-255,66,23406,90,117143
23605,0.000299,172.217.194.0-255,1484,24890,90,117143
23606,0.000306,172.31.47.0-255,66,24956,90,117143
23607,0.00034,172.217.194.0-255,4320,29276,90,117143
23608,0.000344,172.31.47.0-255,66,29342,90,117143
23609,0.000351,172.217.194.0-255,6797,36139,90,117143
23610,0.000353,172.31.47.0-255,66,36205,90,117143
23611,0.000366,172.217.194.0-255,8574,44779,90,117143
23612,0.000369,172.31.47.0-255,66,44845,90,117143
23613,0.000401,172.217.194.0-255,5738,50583,90,117143
23614,0.000404,172.31.47.0-255,66,50649,90,117143
23615,0.000408,172.217.194.0-255,2864,53513,90,117143
23616,0.000411,172.31.47.0-255,66,53579,90,117143
23617,0.000414,172.217.194.0-255,364,53943,90,117143
23618,0.000418,172.31.47.0-255,66,54009,90,117143
23619,0.000633,172.217.194.0-255,1484,55493,90,117143
23620,0.000637,172.31.47.0-255,66,55559,90,117143
23621,0.000667,172.217.194.0-255,2902,58461,90,117143
23622,0.00067,172.31.47.0-255,66,58527,90,117143
23623,0.000676,172.217.194.0-255,5738,64265,90,117143
23624,0.00068,172.217.194.0-255,4320,68585,90,117143
23625,0.000681,172.31.47.0-255,66,68651,90,117143
23626,0.000683,172.31.47.0-255,66,68717,90,117143
23627,0.000706,172.217.194.0-255,1484,70201,90,117143
23628,0.000737,172.217.194.0-255,1484,71685,90,117143
23629,0.00074,172.31.47.0-255,66,71751,90,117143
23630,0.000774,172.31.47.0-255,66,71817,90,117143
23631,0.000781,172.217.194.0-255,5020,76837,90,117143
23632,0.000783,172.31.47.0-255,66,76903,90,117143
23633,0.001933,172.217.194.0-255,1484,78387,90,117143
23634,0.001944,172.217.194.0-255,2902,81289,90,117143
23635,0.001949,172.31.47.0-255,66,81355,90,117143
23636,0.001957,172.217.194.0-255,5738,87093,90,117143
23637,0.001959,172.31.47.0-255,66,87159,90,117143
23638,0.001991,172.31.47.0-255,66,87225,90,117143
23639,0.002029,172.217.194.0-255,1484,88709,90,117143
23640,0.002039,172.217.194.0-255,10692,99401,90,117143
23641,0.002042,172.31.47.0-255,66,99467,90,117143
23642,0.004622,172.217.194.0-255,2902,102369,90,117143
23643,0.004626,172.31.47.0-255,66,102435,90,117143
23644,0.004651,172.217.194.0-255,2902,105337,90,117143
23645,0.004654,172.31.47.0-255,66,105403,90,117143
23646,0.00722,172.217.194.0-255,2902,108305,90,117143
23647,0.007225,172.31.47.0-255,66,108371,90,117143
23648,0.007269,172.217.194.0-255,2902,111273,90,117143
23649,0.007273,172.31.47.0-255,66,111339,90,117143
23650,0.00992,172.217.194.0-255,5738,117077,90,117143
23651,0.009928,172.31.47.0-255,66,117143,90,117143
23652,0.0,74.125.130.0-255,150,150,90,168691
23653,1.5e-05,172.31.47.0-255,66,216,90,168691
23654,2.1e-05,74.125.130.0-255,1484,1700,90,168691
23655,2.5e-05,172.31.47.0-255,66,1766,90,168691
23656,3e-05,74.125.130.0-255,2902,4668,90,168691
23657,4.2e-05,172.31.47.0-255,66,4734,90,168691
23658,4.9e-05,74.125.130.0-255,7156,11890,90,168691
23659,5.2e-05,172.31.47.0-255,66,11956,90,168691
23660,5.6e-05,74.125.130.0-255,2175,14131,90,168691
23661,5.9e-05,172.31.47.0-255,66,14197,90,168691
23662,6.3e-05,74.125.130.0-255,2902,17099,90,168691
23663,6.6e-05,172.31.47.0-255,66,17165,90,168691
23664,8.9e-05,74.125.130.0-255,7156,24321,90,168691
23665,9.5e-05,172.31.47.0-255,66,24387,90,168691
23666,0.000103,74.125.130.0-255,6797,31184,90,168691
23667,0.000105,172.31.47.0-255,66,31250,90,168691
23668,0.000225,74.125.130.0-255,1484,32734,90,168691
23669,0.000229,172.31.47.0-255,66,32800,90,168691
23670,0.000234,74.125.130.0-255,2902,35702,90,168691
23671,0.000235,172.31.47.0-255,66,35768,90,168691
23672,0.000261,74.125.130.0-255,4320,40088,90,168691
23673,0.000264,172.31.47.0-255,66,40154,90,168691
23674,0.000269,74.125.130.0-255,5738,45892,90,168691
23675,0.000271,172.31.47.0-255,66,45958,90,168691
23676,0.000303,172.31.47.0-255,66,46024,90,168691
23677,0.00032,74.125.130.0-255,1125,47149,90,168691
23678,0.000322,172.31.47.0-255,66,47215,90,168691
23679,0.000328,74.125.130.0-255,5738,52953,90,168691
23680,0.000331,172.31.47.0-255,66,53019,90,168691
23681,0.000345,74.125.130.0-255,1378,54397,90,168691
23682,0.000347,172.31.47.0-255,66,54463,90,168691
23683,0.000434,74.125.130.0-255,118,54581,90,168691
23684,0.000487,74.125.130.0-255,382,54963,90,168691
23685,0.000682,74.125.130.0-255,1484,56447,90,168691
23686,0.000698,74.125.130.0-255,2902,59349,90,168691
23687,0.000705,172.31.47.0-255,66,59415,90,168691
23688,0.000714,74.125.130.0-255,2902,62317,90,168691
23689,0.000734,74.125.130.0-255,1484,63801,90,168691
23690,0.000742,74.125.130.0-255,8574,72375,90,168691
23691,0.000745,74.125.130.0-255,2902,75277,90,168691
23692,0.000756,74.125.130.0-255,2902,78179,90,168691
23693,0.000772,74.125.130.0-255,4320,82499,90,168691
23694,0.000775,172.31.47.0-255,66,82565,90,168691
23695,0.000779,172.31.47.0-255,66,82631,90,168691
23696,0.00079,74.125.130.0-255,2902,85533,90,168691
23697,0.000816,74.125.130.0-255,3602,89135,90,168691
23698,0.000839,172.31.47.0-255,66,89201,90,168691
23699,0.001371,74.125.130.0-255,1484,90685,90,168691
23700,0.001379,74.125.130.0-255,2902,93587,90,168691
23701,0.001382,172.31.47.0-255,66,93653,90,168691
23702,0.001412,74.125.130.0-255,2902,96555,90,168691
23703,0.001426,74.125.130.0-255,2902,99457,90,168691
23704,0.001431,74.125.130.0-255,5738,105195,90,168691
23705,0.001436,74.125.130.0-255,7156,112351,90,168691
23706,0.001464,74.125.130.0-255,1484,113835,90,168691
23707,0.001484,74.125.130.0-255,9274,123109,90,168691
23708,0.001551,74.125.130.0-255,1484,124593,90,168691
23709,0.001557,74.125.130.0-255,2902,127495,90,168691
23710,0.001575,74.125.130.0-255,5738,133233,90,168691
23711,0.0016,74.125.130.0-255,2902,136135,90,168691
23712,0.001615,74.125.130.0-255,7156,143291,90,168691
23713,0.001626,74.125.130.0-255,2902,146193,90,168691
23714,0.00163,74.125.130.0-255,2902,149095,90,168691
23715,0.001647,74.125.130.0-255,2902,151997,90,168691
23716,0.001667,74.125.130.0-255,5020,157017,90,168691
23717,0.003664,172.31.47.0-255,66,157083,90,168691
23718,0.00601,74.125.130.0-255,5738,162821,90,168691
23719,0.006015,172.31.47.0-255,66,162887,90,168691
23720,0.008367,74.125.130.0-255,5738,168625,90,168691
23721,0.008375,172.31.47.0-255,66,168691,90,168691
23722,0.0,172.31.47.0-255,105,105,90,276
23723,0.001786,157.240.13.0-255,105,210,90,276
23724,0.001798,172.31.47.0-255,66,276,90,276
23725,0.0,172.31.47.0-255,105,105,90,276
23726,0.002072,157.240.13.0-255,105,210,90,276
23727,0.002081,172.31.47.0-255,66,276,90,276
23728,0.0,74.125.24.0-255,153,153,90,138437
23729,2.3e-05,172.31.47.0-255,66,219,90,138437
23730,2.9e-05,74.125.24.0-255,1484,1703,90,138437
23731,3.3e-05,172.31.47.0-255,66,1769,90,138437
23732,3.7e-05,74.125.24.0-255,2902,4671,90,138437
23733,3.9e-05,172.31.47.0-255,66,4737,90,138437
23734,5e-05,74.125.24.0-255,4320,9057,90,138437
23735,5.3e-05,172.31.47.0-255,66,9123,90,138437
23736,9.6e-05,74.125.24.0-255,4946,14069,90,138437
23737,9.9e-05,172.31.47.0-255,66,14135,90,138437
23738,0.000208,74.125.24.0-255,1484,15619,90,138437
23739,0.000211,172.31.47.0-255,66,15685,90,138437
23740,0.000215,74.125.24.0-255,2902,18587,90,138437
23741,0.000217,172.31.47.0-255,66,18653,90,138437
23742,0.000238,74.125.24.0-255,5738,24391,90,138437
23743,0.000241,172.31.47.0-255,66,24457,90,138437
23744,0.000249,74.125.24.0-255,4320,28777,90,138437
23745,0.000251,172.31.47.0-255,66,28843,90,138437
23746,0.00027,74.125.24.0-255,1484,30327,90,138437
23747,0.000273,172.31.47.0-255,66,30393,90,138437
23748,0.000285,74.125.24.0-255,1125,31518,90,138437
23749,0.000287,172.31.47.0-255,66,31584,90,138437
23750,0.00033,74.125.24.0-255,1484,33068,90,138437
23751,0.000333,172.31.47.0-255,66,33134,90,138437
23752,0.000357,74.125.24.0-255,2902,36036,90,138437
23753,0.000363,74.125.24.0-255,5738,41774,90,138437
23754,0.000362,172.31.47.0-255,66,41840,90,138437
23755,0.000365,172.31.47.0-255,66,41906,90,138437
23756,0.000386,74.125.24.0-255,4320,46226,90,138437
23757,0.000388,172.31.47.0-255,66,46292,90,138437
23758,0.000418,74.125.24.0-255,9633,55925,90,138437
23759,0.000421,172.31.47.0-255,66,55991,90,138437
23760,0.000428,74.125.24.0-255,8574,64565,90,138437
23761,0.000429,172.31.47.0-255,66,64631,90,138437
23762,0.000432,74.125.24.0-255,1125,65756,90,138437
23763,0.000473,74.125.24.0-255,397,66153,90,138437
23764,0.00052,74.125.24.0-255,112,66265,90,138437
23765,0.000524,172.31.47.0-255,66,66331,90,138437
23766,0.000644,74.125.24.0-255,332,66663,90,138437
23767,0.000739,172.31.47.0-255,66,66729,90,138437
23768,0.000967,74.125.24.0-255,1484,68213,90,138437
23769,0.000985,74.125.24.0-255,2902,71115,90,138437
23770,0.000989,172.31.47.0-255,66,71181,90,138437
23771,0.001017,74.125.24.0-255,5738,76919,90,138437
23772,0.00102,172.31.47.0-255,66,76985,90,138437
23773,0.001025,74.125.24.0-255,4320,81305,90,138437
23774,0.001026,172.31.47.0-255,66,81371,90,138437
23775,0.001032,74.125.24.0-255,4320,85691,90,138437
23776,0.001033,172.31.47.0-255,66,85757,90,138437
23777,0.001055,74.125.24.0-255,7156,92913,90,138437
23778,0.001057,172.31.47.0-255,66,92979,90,138437
23779,0.001063,74.125.24.0-255,5738,98717,90,138437
23780,0.001065,172.31.47.0-255,66,98783,90,138437
23781,0.00109,74.125.24.0-255,2184,100967,90,138437
23782,0.001093,172.31.47.0-255,66,101033,90,138437
23783,0.002006,74.125.24.0-255,1484,102517,90,138437
23784,0.002026,74.125.24.0-255,2902,105419,90,138437
23785,0.002029,172.31.47.0-255,66,105485,90,138437
23786,0.002035,74.125.24.0-255,4320,109805,90,138437
23787,0.002037,172.31.47.0-255,66,109871,90,138437
23788,0.002057,74.125.24.0-255,1484,111355,90,138437
23789,0.00209,172.31.47.0-255,66,111421,90,138437
23790,0.002122,74.125.24.0-255,1484,112905,90,138437
23791,0.002139,74.125.24.0-255,4320,117225,90,138437
23792,0.002142,172.31.47.0-255,66,117291,90,138437
23793,0.002159,74.125.24.0-255,5020,122311,90,138437
23794,0.002161,172.31.47.0-255,66,122377,90,138437
23795,0.004456,74.125.24.0-255,5738,128115,90,138437
23796,0.004463,172.31.47.0-255,66,128181,90,138437
23797,0.006738,74.125.24.0-255,4320,132501,90,138437
23798,0.006743,172.31.47.0-255,66,132567,90,138437
23799,0.006768,74.125.24.0-255,1484,134051,90,138437
23800,0.009042,74.125.24.0-255,4320,138371,90,138437
23801,0.00905,172.31.47.0-255,66,138437,90,138437
23802,0.0,172.31.47.0-255,105,105,90,105
23803,0.0,74.125.24.0-255,226,226,90,180852
23804,3.4e-05,172.31.47.0-255,66,292,90,180852
23805,4.1e-05,74.125.24.0-255,1484,1776,90,180852
23806,4.5e-05,172.31.47.0-255,66,1842,90,180852
23807,4.8e-05,74.125.24.0-255,1484,3326,90,180852
23808,5.1e-05,172.31.47.0-255,66,3392,90,180852
23809,0.000105,74.125.24.0-255,2902,6294,90,180852
23810,0.000109,172.31.47.0-255,66,6360,90,180852
23811,0.000243,74.125.24.0-255,5738,12098,90,180852
23812,0.000249,172.31.47.0-255,66,12164,90,180852
23813,0.000478,74.125.24.0-255,2125,14289,90,180852
23814,0.000484,172.31.47.0-255,66,14355,90,180852
23815,0.000562,74.125.24.0-255,2902,17257,90,180852
23816,0.000566,172.31.47.0-255,66,17323,90,180852
23817,0.000589,74.125.24.0-255,7156,24479,90,180852
23818,0.000592,172.31.47.0-255,66,24545,90,180852
23819,0.000986,74.125.24.0-255,4320,28865,90,180852
23820,0.000992,172.31.47.0-255,66,28931,90,180852
23821,0.001016,74.125.24.0-255,2543,31474,90,180852
23822,0.001019,172.31.47.0-255,66,31540,90,180852
23823,0.002045,74.125.24.0-255,5600,37140,90,180852
23824,0.002052,172.31.47.0-255,66,37206,90,180852
23825,0.002144,74.125.24.0-255,4428,41634,90,180852
23826,0.002147,172.31.47.0-255,66,41700,90,180852
23827,0.002329,74.125.24.0-255,2902,44602,90,180852
23828,0.002331,172.31.47.0-255,66,44668,90,180852
23829,0.002348,74.125.24.0-255,1514,46182,90,180852
23830,0.00235,172.31.47.0-255,66,46248,90,180852
23831,0.002512,74.125.24.0-255,1484,47732,90,180852
23832,0.002514,172.31.47.0-255,66,47798,90,180852
23833,0.00253,74.125.24.0-255,1484,49282,90,180852
23834,0.002532,172.31.47.0-255,66,49348,90,180852
23835,0.002629,74.125.24.0-255,1484,50832,90,180852
23836,0.002632,172.31.47.0-255,66,50898,90,180852
23837,0.002658,74.125.24.0-255,9992,60890,90,180852
23838,0.003113,74.125.24.0-255,5738,66628,90,180852
23839,0.003353,74.125.24.0-255,5738,72366,90,180852
23840,0.00359,74.125.24.0-255,2902,75268,90,180852
23841,0.004101,74.125.24.0-255,2902,78170,90,180852
23842,0.004183,74.125.24.0-255,2902,81072,90,180852
23843,0.004203,74.125.24.0-255,5738,86810,90,180852
23844,0.00421,172.31.47.0-255,66,86876,90,180852
23845,0.004214,74.125.24.0-255,2902,89778,90,180852
23846,0.004218,172.31.47.0-255,66,89844,90,180852
23847,0.00455,74.125.24.0-255,2902,92746,90,180852
23848,0.004558,172.31.47.0-255,66,92812,90,180852
23849,0.004601,74.125.24.0-255,4320,97132,90,180852
23850,0.004605,172.31.47.0-255,66,97198,90,180852
23851,0.004627,74.125.24.0-255,9992,107190,90,180852
23852,0.004639,172.31.47.0-255,66,107256,90,180852
23853,0.006215,74.125.24.0-255,6670,113926,90,180852
23854,0.006222,172.31.47.0-255,66,113992,90,180852
23855,0.006618,74.125.24.0-255,7642,121634,90,180852
23856,0.006623,172.31.47.0-255,66,121700,90,180852
23857,0.006663,74.125.24.0-255,2902,124602,90,180852
23858,0.006667,172.31.47.0-255,66,124668,90,180852
23859,0.006701,172.31.47.0-255,66,124734,90,180852
23860,0.006724,74.125.24.0-255,5738,130472,90,180852
23861,0.006728,172.31.47.0-255,66,130538,90,180852
23862,0.006963,74.125.24.0-255,5738,136276,90,180852
23863,0.006968,172.31.47.0-255,66,136342,90,180852
23864,0.007055,172.31.47.0-255,66,136408,90,180852
23865,0.007268,74.125.24.0-255,9992,146400,90,180852
23866,0.007274,172.31.47.0-255,66,146466,90,180852
23867,0.007309,172.31.47.0-255,66,146532,90,180852
23868,0.008215,74.125.24.0-255,3552,150084,90,180852
23869,0.008221,172.31.47.0-255,66,150150,90,180852
23870,0.00861,74.125.24.0-255,7156,157306,90,180852
23871,0.008615,172.31.47.0-255,66,157372,90,180852
23872,0.008647,172.31.47.0-255,66,157438,90,180852
23873,0.008673,74.125.24.0-255,7156,164594,90,180852
23874,0.008677,172.31.47.0-255,66,164660,90,180852
23875,0.008742,74.125.24.0-255,2902,167562,90,180852
23876,0.008746,172.31.47.0-255,66,167628,90,180852
23877,0.008797,172.31.47.0-255,66,167694,90,180852
23878,0.00911,74.125.24.0-255,8574,176268,90,180852
23879,0.009116,172.31.47.0-255,66,176334,90,180852
23880,0.009171,172.31.47.0-255,66,176400,90,180852
23881,0.009178,74.125.24.0-255,4320,180720,90,180852
23882,0.009186,172.31.47.0-255,66,180786,90,180852
23883,0.009588,172.31.47.0-255,66,180852,90,180852
23884,0.0,74.125.24.0-255,153,153,90,175554
23885,2.1e-05,172.31.47.0-255,66,219,90,175554
23886,2.8e-05,74.125.24.0-255,1484,1703,90,175554
23887,3.3e-05,172.31.47.0-255,66,1769,90,175554
23888,4.6e-05,74.125.24.0-255,2902,4671,90,175554
23889,4.9e-05,172.31.47.0-255,66,4737,90,175554
23890,5.8e-05,74.125.24.0-255,7156,11893,90,175554
23891,6.1e-05,172.31.47.0-255,66,11959,90,175554
23892,6.5e-05,74.125.24.0-255,2256,14215,90,175554
23893,6.7e-05,172.31.47.0-255,66,14281,90,175554
23894,0.000103,74.125.24.0-255,2902,17183,90,175554
23895,0.000106,172.31.47.0-255,66,17249,90,175554
23896,0.000133,74.125.24.0-255,4320,21569,90,175554
23897,0.000135,172.31.47.0-255,66,21635,90,175554
23898,0.000143,74.125.24.0-255,8574,30209,90,175554
23899,0.000145,172.31.47.0-255,66,30275,90,175554
23900,0.000148,74.125.24.0-255,1125,31400,90,175554
23901,0.000149,172.31.47.0-255,66,31466,90,175554
23902,0.000249,74.125.24.0-255,1484,32950,90,175554
23903,0.000253,172.31.47.0-255,66,33016,90,175554
23904,0.000256,74.125.24.0-255,1484,34500,90,175554
23905,0.000258,172.31.47.0-255,66,34566,90,175554
23906,0.000288,74.125.24.0-255,1484,36050,90,175554
23907,0.00029,172.31.47.0-255,66,36116,90,175554
23908,0.000296,74.125.24.0-255,5738,41854,90,175554
23909,0.000298,172.31.47.0-255,66,41920,90,175554
23910,0.000301,74.125.24.0-255,2902,44822,90,175554
23911,0.000303,172.31.47.0-255,66,44888,90,175554
23912,0.00034,172.31.47.0-255,66,44954,90,175554
23913,0.000349,74.125.24.0-255,9633,54587,90,175554
23914,0.000351,172.31.47.0-255,66,54653,90,175554
23915,0.000353,74.125.24.0-255,361,55014,90,175554
23916,0.000419,74.125.24.0-255,129,55143,90,175554
23917,0.000523,74.125.24.0-255,1484,56627,90,175554
23918,0.000527,172.31.47.0-255,66,56693,90,175554
23919,0.000533,74.125.24.0-255,2902,59595,90,175554
23920,0.000536,172.31.47.0-255,66,59661,90,175554
23921,0.000547,74.125.24.0-255,5738,65399,90,175554
23922,0.00055,172.31.47.0-255,66,65465,90,175554
23923,0.000585,74.125.24.0-255,6797,72262,90,175554
23924,0.000588,172.31.47.0-255,66,72328,90,175554
23925,0.000614,74.125.24.0-255,2902,75230,90,175554
23926,0.000616,172.31.47.0-255,66,75296,90,175554
23927,0.000641,74.125.24.0-255,2902,78198,90,175554
23928,0.000643,172.31.47.0-255,66,78264,90,175554
23929,0.000652,74.125.24.0-255,7156,85420,90,175554
23930,0.000659,172.31.47.0-255,66,85486,90,175554
23931,0.000663,74.125.24.0-255,2902,88388,90,175554
23932,0.000665,172.31.47.0-255,66,88454,90,175554
23933,0.000693,74.125.24.0-255,1410,89864,90,175554
23934,0.001227,74.125.24.0-255,1484,91348,90,175554
23935,0.001232,172.31.47.0-255,66,91414,90,175554
23936,0.001237,74.125.24.0-255,2902,94316,90,175554
23937,0.001239,172.31.47.0-255,66,94382,90,175554
23938,0.00125,74.125.24.0-255,5738,100120,90,175554
23939,0.001253,172.31.47.0-255,66,100186,90,175554
23940,0.001257,74.125.24.0-255,2902,103088,90,175554
23941,0.001259,172.31.47.0-255,66,103154,90,175554
23942,0.001289,74.125.24.0-255,9992,113146,90,175554
23943,0.001292,172.31.47.0-255,66,113212,90,175554
23944,0.001302,74.125.24.0-255,10692,123904,90,175554
23945,0.001304,172.31.47.0-255,66,123970,90,175554
23946,0.002044,74.125.24.0-255,1484,125454,90,175554
23947,0.002055,74.125.24.0-255,2902,128356,90,175554
23948,0.002059,172.31.47.0-255,66,128422,90,175554
23949,0.002067,74.125.24.0-255,5738,134160,90,175554
23950,0.002069,172.31.47.0-255,66,134226,90,175554
23951,0.002109,74.125.24.0-255,8574,142800,90,175554
23952,0.002111,172.31.47.0-255,66,142866,90,175554
23953,0.002143,74.125.24.0-255,4320,147186,90,175554
23954,0.002145,172.31.47.0-255,66,147252,90,175554
23955,0.002152,74.125.24.0-255,7156,154408,90,175554
23956,0.002153,172.31.47.0-255,66,154474,90,175554
23957,0.002158,74.125.24.0-255,3602,158076,90,175554
23958,0.002159,172.31.47.0-255,66,158142,90,175554
23959,0.004444,74.125.24.0-255,5738,163880,90,175554
23960,0.004451,172.31.47.0-255,66,163946,90,175554
23961,0.00676,74.125.24.0-255,5738,169684,90,175554
23962,0.006766,172.31.47.0-255,66,169750,90,175554
23963,0.009025,74.125.24.0-255,5738,175488,90,175554
23964,0.009031,172.31.47.0-255,66,175554,90,175554
23965,0.0,74.125.130.0-255,157,157,90,386993
23966,1.6e-05,172.31.47.0-255,66,223,90,386993
23967,2.2e-05,74.125.130.0-255,1484,1707,90,386993
23968,2.6e-05,172.31.47.0-255,66,1773,90,386993
23969,5.7e-05,74.125.130.0-255,2902,4675,90,386993
23970,6e-05,172.31.47.0-255,66,4741,90,386993
23971,6.6e-05,74.125.130.0-255,5738,10479,90,386993
23972,6.9e-05,172.31.47.0-255,66,10545,90,386993
23973,9.1e-05,74.125.130.0-255,3511,14056,90,386993
23974,9.4e-05,172.31.47.0-255,66,14122,90,386993
23975,0.000153,74.125.130.0-255,1484,15606,90,386993
23976,0.000157,172.31.47.0-255,66,15672,90,386993
23977,0.000184,74.125.130.0-255,2902,18574,90,386993
23978,0.000187,172.31.47.0-255,66,18640,90,386993
23979,0.000193,74.125.130.0-255,5738,24378,90,386993
23980,0.000195,172.31.47.0-255,66,24444,90,386993
23981,0.000225,74.125.130.0-255,6797,31241,90,386993
23982,0.000228,172.31.47.0-255,66,31307,90,386993
23983,0.00058,74.125.130.0-255,1484,32791,90,386993
23984,0.000585,172.31.47.0-255,66,32857,90,386993
23985,0.000592,74.125.130.0-255,2902,35759,90,386993
23986,0.000594,172.31.47.0-255,66,35825,90,386993
23987,0.000597,74.125.130.0-255,1484,37309,90,386993
23988,0.000598,172.31.47.0-255,66,37375,90,386993
23989,0.000625,74.125.130.0-255,2902,40277,90,386993
23990,0.000628,172.31.47.0-255,66,40343,90,386993
23991,0.000632,74.125.130.0-255,2902,43245,90,386993
23992,0.000635,172.31.47.0-255,66,43311,90,386993
23993,0.000663,74.125.130.0-255,6797,50108,90,386993
23994,0.000666,172.31.47.0-255,66,50174,90,386993
23995,0.00067,74.125.130.0-255,2902,53076,90,386993
23996,0.000672,172.31.47.0-255,66,53142,90,386993
23997,0.000706,74.125.130.0-255,5738,58880,90,386993
23998,0.000709,172.31.47.0-255,66,58946,90,386993
23999,0.000736,74.125.130.0-255,6797,65743,90,386993
24000,0.000739,172.31.47.0-255,66,65809,90,386993
24001,0.000741,74.125.130.0-255,363,66172,90,386993
24002,0.000786,74.125.130.0-255,380,66552,90,386993
24003,0.000991,74.125.130.0-255,1484,68036,90,386993
24004,0.000995,172.31.47.0-255,66,68102,90,386993
24005,0.001012,74.125.130.0-255,2902,71004,90,386993
24006,0.001014,172.31.47.0-255,66,71070,90,386993
24007,0.00102,74.125.130.0-255,4320,75390,90,386993
24008,0.001022,172.31.47.0-255,66,75456,90,386993
24009,0.001034,74.125.130.0-255,1484,76940,90,386993
24010,0.001083,74.125.130.0-255,9992,86932,90,386993
24011,0.001086,172.31.47.0-255,66,86998,90,386993
24012,0.001095,74.125.130.0-255,2902,89900,90,386993
24013,0.001097,172.31.47.0-255,66,89966,90,386993
24014,0.001104,74.125.130.0-255,2902,92868,90,386993
24015,0.001106,172.31.47.0-255,66,92934,90,386993
24016,0.001139,74.125.130.0-255,7856,100790,90,386993
24017,0.001142,172.31.47.0-255,66,100856,90,386993
24018,0.001863,74.125.130.0-255,1484,102340,90,386993
24019,0.001873,74.125.130.0-255,2902,105242,90,386993
24020,0.001878,172.31.47.0-255,66,105308,90,386993
24021,0.001885,74.125.130.0-255,2902,108210,90,386993
24022,0.001887,172.31.47.0-255,66,108276,90,386993
24023,0.001913,74.125.130.0-255,2902,111178,90,386993
24024,0.001915,172.31.47.0-255,66,111244,90,386993
24025,0.001928,74.125.130.0-255,8574,119818,90,386993
24026,0.00193,172.31.47.0-255,66,119884,90,386993
24027,0.001934,74.125.130.0-255,1484,121368,90,386993
24028,0.001969,74.125.130.0-255,8574,129942,90,386993
24029,0.001971,172.31.47.0-255,66,130008,90,386993
24030,0.001978,74.125.130.0-255,5020,135028,90,386993
24031,0.00198,172.31.47.0-255,66,135094,90,386993
24032,0.002063,74.125.130.0-255,1484,136578,90,386993
24033,0.00208,74.125.130.0-255,2902,139480,90,386993
24034,0.002083,172.31.47.0-255,66,139546,90,386993
24035,0.00209,74.125.130.0-255,4320,143866,90,386993
24036,0.002091,172.31.47.0-255,66,143932,90,386993
24037,0.002125,74.125.130.0-255,1484,145416,90,386993
24038,0.002133,74.125.130.0-255,7156,152572,90,386993
24039,0.002136,172.31.47.0-255,66,152638,90,386993
24040,0.002145,74.125.130.0-255,8574,161212,90,386993
24041,0.002147,172.31.47.0-255,66,161278,90,386993
24042,0.002182,74.125.130.0-255,7856,169134,90,386993
24043,0.002185,172.31.47.0-255,66,169200,90,386993
24044,0.00231,74.125.130.0-255,1484,170684,90,386993
24045,0.002316,74.125.130.0-255,2902,173586,90,386993
24046,0.00232,172.31.47.0-255,66,173652,90,386993
24047,0.002334,74.125.130.0-255,2902,176554,90,386993
24048,0.002341,172.31.47.0-255,66,176620,90,386993
24049,0.002372,74.125.130.0-255,2902,179522,90,386993
24050,0.002375,172.31.47.0-255,66,179588,90,386993
24051,0.002389,172.31.47.0-255,66,179654,90,386993
24052,0.002418,74.125.130.0-255,5738,185392,90,386993
24053,0.002421,172.31.47.0-255,66,185458,90,386993
24054,0.002442,74.125.130.0-255,5020,190478,90,386993
24055,0.002444,172.31.47.0-255,66,190544,90,386993
24056,0.002697,74.125.130.0-255,1484,192028,90,386993
24057,0.002706,74.125.130.0-255,2902,194930,90,386993
24058,0.00271,172.31.47.0-255,66,194996,90,386993
24059,0.002714,74.125.130.0-255,1484,196480,90,386993
24060,0.002717,74.125.130.0-255,1484,197964,90,386993
24061,0.002719,172.31.47.0-255,66,198030,90,386993
24062,0.002748,74.125.130.0-255,1484,199514,90,386993
24063,0.002754,74.125.130.0-255,4320,203834,90,386993
24064,0.002756,172.31.47.0-255,66,203900,90,386993
24065,0.002787,74.125.130.0-255,2902,206802,90,386993
24066,0.002789,172.31.47.0-255,66,206868,90,386993
24067,0.002792,74.125.130.0-255,1484,208352,90,386993
24068,0.002797,74.125.130.0-255,2902,211254,90,386993
24069,0.002799,172.31.47.0-255,66,211320,90,386993
24070,0.002828,74.125.130.0-255,5738,217058,90,386993
24071,0.00283,172.31.47.0-255,66,217124,90,386993
24072,0.002858,74.125.130.0-255,5738,222862,90,386993
24073,0.00286,172.31.47.0-255,66,222928,90,386993
24074,0.002865,74.125.130.0-255,2184,225112,90,386993
24075,0.002867,172.31.47.0-255,66,225178,90,386993
24076,0.002872,74.125.130.0-255,4320,229498,90,386993
24077,0.002875,172.31.47.0-255,66,229564,90,386993
24078,0.002879,74.125.130.0-255,2902,232466,90,386993
24079,0.002884,172.31.47.0-255,66,232532,90,386993
24080,0.002918,74.125.130.0-255,8574,241106,90,386993
24081,0.002921,172.31.47.0-255,66,241172,90,386993
24082,0.002928,74.125.130.0-255,5738,246910,90,386993
24083,0.00293,172.31.47.0-255,66,246976,90,386993
24084,0.002935,74.125.130.0-255,4320,251296,90,386993
24085,0.00294,172.31.47.0-255,66,251362,90,386993
24086,0.002963,74.125.130.0-255,1484,252846,90,386993
24087,0.003004,74.125.130.0-255,6438,259284,90,386993
24088,0.003008,172.31.47.0-255,66,259350,90,386993
24089,0.003066,74.125.130.0-255,1484,260834,90,386993
24090,0.003072,74.125.130.0-255,2902,263736,90,386993
24091,0.003075,172.31.47.0-255,66,263802,90,386993
24092,0.003124,74.125.130.0-255,4320,268122,90,386993
24093,0.003128,172.31.47.0-255,66,268188,90,386993
24094,0.003152,74.125.130.0-255,1484,269672,90,386993
24095,0.003178,74.125.130.0-255,2902,272574,90,386993
24096,0.00318,172.31.47.0-255,66,272640,90,386993
24097,0.003205,74.125.130.0-255,1484,274124,90,386993
24098,0.003208,74.125.130.0-255,1484,275608,90,386993
24099,0.00321,172.31.47.0-255,66,275674,90,386993
24100,0.003236,74.125.130.0-255,2902,278576,90,386993
24101,0.003239,172.31.47.0-255,66,278642,90,386993
24102,0.003242,74.125.130.0-255,1484,280126,90,386993
24103,0.003244,74.125.130.0-255,1484,281610,90,386993
24104,0.003247,172.31.47.0-255,66,281676,90,386993
24105,0.003273,74.125.130.0-255,1484,283160,90,386993
24106,0.00328,74.125.130.0-255,5738,288898,90,386993
24107,0.003282,172.31.47.0-255,66,288964,90,386993
24108,0.003326,74.125.130.0-255,5020,293984,90,386993
24109,0.003329,172.31.47.0-255,66,294050,90,386993
24110,0.003435,74.125.130.0-255,1484,295534,90,386993
24111,0.003451,74.125.130.0-255,2902,298436,90,386993
24112,0.003465,74.125.130.0-255,1484,299920,90,386993
24113,0.003476,74.125.130.0-255,1484,301404,90,386993
24114,0.003497,74.125.130.0-255,4320,305724,90,386993
24115,0.003521,74.125.130.0-255,1484,307208,90,386993
24116,0.003538,74.125.130.0-255,2902,310110,90,386993
24117,0.003549,74.125.130.0-255,1484,311594,90,386993
24118,0.003583,74.125.130.0-255,4320,315914,90,386993
24119,0.003586,74.125.130.0-255,1484,317398,90,386993
24120,0.003604,74.125.130.0-255,4320,321718,90,386993
24121,0.003629,74.125.130.0-255,4320,326038,90,386993
24122,0.003647,74.125.130.0-255,2184,328222,90,386993
24123,0.00365,74.125.130.0-255,1484,329706,90,386993
24124,0.003652,74.125.130.0-255,1484,331190,90,386993
24125,0.00369,74.125.130.0-255,4320,335510,90,386993
24126,0.00375,74.125.130.0-255,7156,342666,90,386993
24127,0.003769,74.125.130.0-255,6438,349104,90,386993
24128,0.00378,74.125.130.0-255,1484,350588,90,386993
24129,0.003801,74.125.130.0-255,2902,353490,90,386993
24130,0.00383,74.125.130.0-255,5738,359228,90,386993
24131,0.003833,74.125.130.0-255,1484,360712,90,386993
24132,0.00386,74.125.130.0-255,2902,363614,90,386993
24133,0.003888,74.125.130.0-255,2902,366516,90,386993
24134,0.003899,74.125.130.0-255,1484,368000,90,386993
24135,0.003912,74.125.130.0-255,2902,370902,90,386993
24136,0.003943,74.125.130.0-255,4320,375222,90,386993
24137,0.003958,74.125.130.0-255,1484,376706,90,386993
24138,0.003961,74.125.130.0-255,1484,378190,90,386993
24139,0.003981,74.125.130.0-255,5020,383210,90,386993
24140,0.004026,74.125.130.0-255,1484,384694,90,386993
24141,0.004046,74.125.130.0-255,1926,386620,90,386993
24142,0.004049,74.125.130.0-255,97,386717,90,386993
24143,0.004149,74.125.130.0-255,105,386822,90,386993
24144,0.005426,172.31.47.0-255,66,386888,90,386993
24145,0.007694,172.31.47.0-255,105,386993,90,386993
24146,0.0,172.31.47.0-255,66,66,90,66
24147,0.0,74.125.130.0-255,298,298,90,118758
24148,2.5e-05,172.31.47.0-255,66,364,90,118758
24149,0.000118,74.125.130.0-255,1484,1848,90,118758
24150,0.000122,172.31.47.0-255,66,1914,90,118758
24151,0.000127,74.125.130.0-255,2902,4816,90,118758
24152,0.00013,172.31.47.0-255,66,4882,90,118758
24153,0.000198,74.125.130.0-255,2902,7784,90,118758
24154,0.000201,172.31.47.0-255,66,7850,90,118758
24155,0.000226,74.125.130.0-255,4320,12170,90,118758
24156,0.000229,172.31.47.0-255,66,12236,90,118758
24157,0.000233,74.125.130.0-255,2011,14247,90,118758
24158,0.000236,172.31.47.0-255,66,14313,90,118758
24159,0.000239,74.125.130.0-255,1484,15797,90,118758
24160,0.000241,172.31.47.0-255,66,15863,90,118758
24161,0.000267,74.125.130.0-255,1484,17347,90,118758
24162,0.00027,172.31.47.0-255,66,17413,90,118758
24163,0.000276,74.125.130.0-255,7156,24569,90,118758
24164,0.000279,172.31.47.0-255,66,24635,90,118758
24165,0.000303,74.125.130.0-255,5738,30373,90,118758
24166,0.000306,172.31.47.0-255,66,30439,90,118758
24167,0.000333,74.125.130.0-255,1125,31564,90,118758
24168,0.000336,172.31.47.0-255,66,31630,90,118758
24169,0.000571,74.125.130.0-255,1484,33114,90,118758
24170,0.000575,172.31.47.0-255,66,33180,90,118758
24171,0.000595,74.125.130.0-255,1484,34664,90,118758
24172,0.000598,172.31.47.0-255,66,34730,90,118758
24173,0.000602,74.125.130.0-255,2902,37632,90,118758
24174,0.000604,172.31.47.0-255,66,37698,90,118758
24175,0.000637,74.125.130.0-255,5738,43436,90,118758
24176,0.000641,172.31.47.0-255,66,43502,90,118758
24177,0.000642,74.125.130.0-255,5379,48881,90,118758
24178,0.000645,172.31.47.0-255,66,48947,90,118758
24179,0.00067,74.125.130.0-255,5738,54685,90,118758
24180,0.000673,172.31.47.0-255,66,54751,90,118758
24181,0.000696,74.125.130.0-255,1484,56235,90,118758
24182,0.000717,74.125.130.0-255,9633,65868,90,118758
24183,0.000721,172.31.47.0-255,66,65934,90,118758
24184,0.001018,74.125.130.0-255,646,66580,90,118758
24185,0.001059,172.31.47.0-255,66,66646,90,118758
24186,0.001172,74.125.130.0-255,1484,68130,90,118758
24187,0.00119,74.125.130.0-255,2902,71032,90,118758
24188,0.001194,172.31.47.0-255,66,71098,90,118758
24189,0.001199,74.125.130.0-255,2902,74000,90,118758
24190,0.0012,172.31.47.0-255,66,74066,90,118758
24191,0.001227,74.125.130.0-255,4320,78386,90,118758
24192,0.001231,172.31.47.0-255,66,78452,90,118758
24193,0.001243,74.125.130.0-255,1484,79936,90,118758
24194,0.001264,74.125.130.0-255,8215,88151,90,118758
24195,0.001266,172.31.47.0-255,66,88217,90,118758
24196,0.001269,74.125.130.0-255,1484,89701,90,118758
24197,0.001295,74.125.130.0-255,8574,98275,90,118758
24198,0.001298,172.31.47.0-255,66,98341,90,118758
24199,0.001324,74.125.130.0-255,2543,100884,90,118758
24200,0.001327,172.31.47.0-255,66,100950,90,118758
24201,0.003544,74.125.130.0-255,2902,103852,90,118758
24202,0.00355,172.31.47.0-255,66,103918,90,118758
24203,0.003575,74.125.130.0-255,2902,106820,90,118758
24204,0.003578,172.31.47.0-255,66,106886,90,118758
24205,0.005793,74.125.130.0-255,2902,109788,90,118758
24206,0.005798,172.31.47.0-255,66,109854,90,118758
24207,0.005823,74.125.130.0-255,2902,112756,90,118758
24208,0.005825,172.31.47.0-255,66,112822,90,118758
24209,0.008044,74.125.130.0-255,2902,115724,90,118758
24210,0.00805,172.31.47.0-255,66,115790,90,118758
24211,0.008081,74.125.130.0-255,2902,118692,90,118758
24212,0.008085,172.31.47.0-255,66,118758,90,118758
24213,0.0,74.125.24.0-255,153,153,90,169226
24214,1.5e-05,172.31.47.0-255,66,219,90,169226
24215,4.7e-05,74.125.24.0-255,1484,1703,90,169226
24216,5.2e-05,172.31.47.0-255,66,1769,90,169226
24217,5.7e-05,74.125.24.0-255,2902,4671,90,169226
24218,6.1e-05,172.31.47.0-255,66,4737,90,169226
24219,6.7e-05,74.125.24.0-255,5738,10475,90,169226
24220,7e-05,172.31.47.0-255,66,10541,90,169226
24221,0.00011,74.125.24.0-255,7846,18387,90,169226
24222,0.000113,172.31.47.0-255,66,18453,90,169226
24223,0.00012,74.125.24.0-255,8574,27027,90,169226
24224,0.000122,172.31.47.0-255,66,27093,90,169226
24225,0.000154,74.125.24.0-255,3961,31054,90,169226
24226,0.000156,172.31.47.0-255,66,31120,90,169226
24227,0.000237,74.125.24.0-255,1484,32604,90,169226
24228,0.00024,172.31.47.0-255,66,32670,90,169226
24229,0.000245,74.125.24.0-255,2902,35572,90,169226
24230,0.000247,172.31.47.0-255,66,35638,90,169226
24231,0.00025,74.125.24.0-255,1484,37122,90,169226
24232,0.000252,172.31.47.0-255,66,37188,90,169226
24233,0.000278,74.125.24.0-255,4320,41508,90,169226
24234,0.000281,172.31.47.0-255,66,41574,90,169226
24235,0.000284,74.125.24.0-255,1484,43058,90,169226
24236,0.000286,172.31.47.0-255,66,43124,90,169226
24237,0.000325,172.31.47.0-255,66,43190,90,169226
24238,0.000357,74.125.24.0-255,9906,53096,90,169226
24239,0.000359,172.31.47.0-255,66,53162,90,169226
24240,0.000616,74.125.24.0-255,382,53544,90,169226
24241,0.00062,172.31.47.0-255,66,53610,90,169226
24242,0.000784,74.125.24.0-255,1484,55094,90,169226
24243,0.000789,74.125.24.0-255,2902,57996,90,169226
24244,0.000793,172.31.47.0-255,66,58062,90,169226
24245,0.000796,172.31.47.0-255,66,58128,90,169226
24246,0.000823,74.125.24.0-255,5738,63866,90,169226
24247,0.000825,172.31.47.0-255,66,63932,90,169226
24248,0.000831,74.125.24.0-255,4320,68252,90,169226
24249,0.000833,172.31.47.0-255,66,68318,90,169226
24250,0.000866,74.125.24.0-255,9633,77951,90,169226
24251,0.000868,172.31.47.0-255,66,78017,90,169226
24252,0.000912,74.125.24.0-255,5738,83755,90,169226
24253,0.000915,172.31.47.0-255,66,83821,90,169226
24254,0.000937,74.125.24.0-255,3961,87782,90,169226
24255,0.000939,172.31.47.0-255,66,87848,90,169226
24256,0.001521,74.125.24.0-255,1484,89332,90,169226
24257,0.001531,74.125.24.0-255,2902,92234,90,169226
24258,0.001535,172.31.47.0-255,66,92300,90,169226
24259,0.001561,74.125.24.0-255,4320,96620,90,169226
24260,0.001563,172.31.47.0-255,66,96686,90,169226
24261,0.001587,74.125.24.0-255,5738,102424,90,169226
24262,0.00159,172.31.47.0-255,66,102490,90,169226
24263,0.001621,172.31.47.0-255,66,102556,90,169226
24264,0.001628,74.125.24.0-255,5738,108294,90,169226
24265,0.001629,172.31.47.0-255,66,108360,90,169226
24266,0.001656,74.125.24.0-255,2184,110544,90,169226
24267,0.001658,172.31.47.0-255,66,110610,90,169226
24268,0.001735,74.125.24.0-255,1484,112094,90,169226
24269,0.001752,74.125.24.0-255,2902,114996,90,169226
24270,0.001755,172.31.47.0-255,66,115062,90,169226
24271,0.001759,74.125.24.0-255,2902,117964,90,169226
24272,0.001761,172.31.47.0-255,66,118030,90,169226
24273,0.001777,74.125.24.0-255,1484,119514,90,169226
24274,0.001799,74.125.24.0-255,5738,125252,90,169226
24275,0.001801,172.31.47.0-255,66,125318,90,169226
24276,0.001806,74.125.24.0-255,2902,128220,90,169226
24277,0.001807,172.31.47.0-255,66,128286,90,169226
24278,0.001846,172.31.47.0-255,66,128352,90,169226
24279,0.00185,74.125.24.0-255,3602,131954,90,169226
24280,0.001852,172.31.47.0-255,66,132020,90,169226
24281,0.001855,74.125.24.0-255,1484,133504,90,169226
24282,0.001886,172.31.47.0-255,66,133570,90,169226
24283,0.001895,74.125.24.0-255,9992,143562,90,169226
24284,0.001897,172.31.47.0-255,66,143628,90,169226
24285,0.001955,74.125.24.0-255,2184,145812,90,169226
24286,0.001958,172.31.47.0-255,66,145878,90,169226
24287,0.003928,74.125.24.0-255,2902,148780,90,169226
24288,0.003935,172.31.47.0-255,66,148846,90,169226
24289,0.003964,74.125.24.0-255,2902,151748,90,169226
24290,0.003967,172.31.47.0-255,66,151814,90,169226
24291,0.005957,74.125.24.0-255,5738,157552,90,169226
24292,0.005961,172.31.47.0-255,66,157618,90,169226
24293,0.007954,74.125.24.0-255,5738,163356,90,169226
24294,0.007962,172.31.47.0-255,66,163422,90,169226
24295,0.009988,74.125.24.0-255,5738,169160,90,169226
24296,0.009996,172.31.47.0-255,66,169226,90,169226
24297,0.0,172.31.47.0-255,105,105,90,276
24298,0.001783,157.240.13.0-255,105,210,90,276
24299,0.001795,172.31.47.0-255,66,276,90,276
24300,0.0,172.31.47.0-255,130,130,90,1625
24301,0.000455,172.31.47.0-255,236,366,90,1625
24302,0.000482,172.31.47.0-255,369,735,90,1625
24303,0.00249,74.125.68.0-255,630,1365,90,1625
24304,0.002661,172.31.47.0-255,97,1462,90,1625
24305,0.003211,74.125.68.0-255,97,1559,90,1625
24306,0.009668,74.125.68.0-255,66,1625,90,1625
24307,0.0,172.31.47.0-255,105,105,90,276
24308,0.001452,157.240.13.0-255,105,210,90,276
24309,0.001459,172.31.47.0-255,66,276,90,276
24310,0.0,74.125.200.0-255,297,297,90,152942
24311,2.3e-05,172.31.47.0-255,66,363,90,152942
24312,2.9e-05,74.125.200.0-255,1484,1847,90,152942
24313,3.4e-05,172.31.47.0-255,66,1913,90,152942
24314,3.9e-05,74.125.200.0-255,2902,4815,90,152942
24315,4.3e-05,172.31.47.0-255,66,4881,90,152942
24316,6.9e-05,74.125.200.0-255,5738,10619,90,152942
24317,7.2e-05,172.31.47.0-255,66,10685,90,152942
24318,9.1e-05,74.125.200.0-255,2902,13587,90,152942
24319,9.3e-05,172.31.47.0-255,66,13653,90,152942
24320,0.000115,74.125.200.0-255,1484,15137,90,152942
24321,0.000117,172.31.47.0-255,66,15203,90,152942
24322,0.000133,74.125.200.0-255,1928,17131,90,152942
24323,0.000136,172.31.47.0-255,66,17197,90,152942
24324,0.000141,74.125.200.0-255,4320,21517,90,152942
24325,0.000143,172.31.47.0-255,66,21583,90,152942
24326,0.000158,74.125.200.0-255,4320,25903,90,152942
24327,0.000161,172.31.47.0-255,66,25969,90,152942
24328,0.000176,74.125.200.0-255,5379,31348,90,152942
24329,0.000179,172.31.47.0-255,66,31414,90,152942
24330,0.00029,74.125.200.0-255,1484,32898,90,152942
24331,0.000295,172.31.47.0-255,66,32964,90,152942
24332,0.000301,74.125.200.0-255,2902,35866,90,152942
24333,0.000303,172.31.47.0-255,66,35932,90,152942
24334,0.000307,74.125.200.0-255,1484,37416,90,152942
24335,0.000308,172.31.47.0-255,66,37482,90,152942
24336,0.000334,74.125.200.0-255,4320,41802,90,152942
24337,0.000338,172.31.47.0-255,66,41868,90,152942
24338,0.000341,74.125.200.0-255,2902,44770,90,152942
24339,0.000344,172.31.47.0-255,66,44836,90,152942
24340,0.000348,74.125.200.0-255,2902,47738,90,152942
24341,0.00035,172.31.47.0-255,66,47804,90,152942
24342,0.000372,74.125.200.0-255,1125,48929,90,152942
24343,0.000378,74.125.200.0-255,2902,51831,90,152942
24344,0.000381,74.125.200.0-255,1484,53315,90,152942
24345,0.000392,172.31.47.0-255,66,53381,90,152942
24346,0.000402,74.125.200.0-255,2902,56283,90,152942
24347,0.000418,172.31.47.0-255,66,56349,90,152942
24348,0.00042,74.125.200.0-255,2902,59251,90,152942
24349,0.000423,172.31.47.0-255,66,59317,90,152942
24350,0.00044,74.125.200.0-255,5738,65055,90,152942
24351,0.000443,74.125.200.0-255,1125,66180,90,152942
24352,0.000451,172.31.47.0-255,66,66246,90,152942
24353,0.000467,74.125.200.0-255,399,66645,90,152942
24354,0.000589,74.125.200.0-255,343,66988,90,152942
24355,0.000683,74.125.200.0-255,1484,68472,90,152942
24356,0.000691,74.125.200.0-255,2902,71374,90,152942
24357,0.000703,172.31.47.0-255,66,71440,90,152942
24358,0.000728,74.125.200.0-255,5738,77178,90,152942
24359,0.000736,74.125.200.0-255,6797,83975,90,152942
24360,0.000743,172.31.47.0-255,66,84041,90,152942
24361,0.000822,74.125.200.0-255,1484,85525,90,152942
24362,0.00084,74.125.200.0-255,2902,88427,90,152942
24363,0.000844,172.31.47.0-255,66,88493,90,152942
24364,0.000866,74.125.200.0-255,5738,94231,90,152942
24365,0.00087,172.31.47.0-255,66,94297,90,152942
24366,0.000886,74.125.200.0-255,1484,95781,90,152942
24367,0.000912,74.125.200.0-255,5379,101160,90,152942
24368,0.000917,172.31.47.0-255,66,101226,90,152942
24369,0.001324,74.125.200.0-255,1484,102710,90,152942
24370,0.001332,74.125.200.0-255,2902,105612,90,152942
24371,0.001336,172.31.47.0-255,66,105678,90,152942
24372,0.00134,74.125.200.0-255,1484,107162,90,152942
24373,0.001359,74.125.200.0-255,4320,111482,90,152942
24374,0.001379,172.31.47.0-255,66,111548,90,152942
24375,0.001386,74.125.200.0-255,2902,114450,90,152942
24376,0.001393,172.31.47.0-255,66,114516,90,152942
24377,0.001405,74.125.200.0-255,8574,123090,90,152942
24378,0.001416,172.31.47.0-255,66,123156,90,152942
24379,0.001422,74.125.200.0-255,2902,126058,90,152942
24380,0.001431,172.31.47.0-255,66,126124,90,152942
24381,0.001441,74.125.200.0-255,9274,135398,90,152942
24382,0.001447,172.31.47.0-255,66,135464,90,152942
24383,0.00343,74.125.200.0-255,5738,141202,90,152942
24384,0.003442,172.31.47.0-255,66,141268,90,152942
24385,0.005437,74.125.200.0-255,4320,145588,90,152942
24386,0.005449,74.125.200.0-255,1484,147072,90,152942
24387,0.006733,172.31.47.0-255,66,147138,90,152942
24388,0.008728,74.125.200.0-255,5738,152876,90,152942
24389,0.008741,172.31.47.0-255,66,152942,90,152942
24390,0.0,74.125.68.0-255,153,153,90,177230
24391,2.8e-05,172.31.47.0-255,66,219,90,177230
24392,3.8e-05,74.125.68.0-255,1484,1703,90,177230
24393,4.3e-05,172.31.47.0-255,66,1769,90,177230
24394,5.8e-05,74.125.68.0-255,1484,3253,90,177230
24395,6.2e-05,172.31.47.0-255,66,3319,90,177230
24396,6.9e-05,74.125.68.0-255,2902,6221,90,177230
24397,7.3e-05,172.31.47.0-255,66,6287,90,177230
24398,8.1e-05,74.125.68.0-255,5738,12025,90,177230
24399,8.4e-05,172.31.47.0-255,66,12091,90,177230
24400,8.9e-05,74.125.68.0-255,2170,14261,90,177230
24401,9.4e-05,172.31.47.0-255,66,14327,90,177230
24402,0.000204,74.125.68.0-255,1484,15811,90,177230
24403,0.000209,172.31.47.0-255,66,15877,90,177230
24404,0.000216,74.125.68.0-255,2902,18779,90,177230
24405,0.000219,172.31.47.0-255,66,18845,90,177230
24406,0.000235,74.125.68.0-255,5738,24583,90,177230
24407,0.000238,172.31.47.0-255,66,24649,90,177230
24408,0.000244,74.125.68.0-255,2902,27551,90,177230
24409,0.000246,172.31.47.0-255,66,27617,90,177230
24410,0.000288,74.125.68.0-255,3961,31578,90,177230
24411,0.000291,172.31.47.0-255,66,31644,90,177230
24412,0.00037,74.125.68.0-255,1484,33128,90,177230
24413,0.000374,172.31.47.0-255,66,33194,90,177230
24414,0.000405,74.125.68.0-255,1484,34678,90,177230
24415,0.000409,172.31.47.0-255,66,34744,90,177230
24416,0.000415,74.125.68.0-255,2902,37646,90,177230
24417,0.000418,172.31.47.0-255,66,37712,90,177230
24418,0.000433,74.125.68.0-255,5738,43450,90,177230
24419,0.000437,172.31.47.0-255,66,43516,90,177230
24420,0.000444,74.125.68.0-255,5379,48895,90,177230
24421,0.000447,172.31.47.0-255,66,48961,90,177230
24422,0.00049,74.125.68.0-255,5738,54699,90,177230
24423,0.000494,172.31.47.0-255,66,54765,90,177230
24424,0.000514,74.125.68.0-255,8574,63339,90,177230
24425,0.000518,172.31.47.0-255,66,63405,90,177230
24426,0.000553,74.125.68.0-255,2855,66260,90,177230
24427,0.000555,172.31.47.0-255,66,66326,90,177230
24428,0.000558,74.125.68.0-255,110,66436,90,177230
24429,0.000576,74.125.68.0-255,330,66766,90,177230
24430,0.000791,74.125.68.0-255,1484,68250,90,177230
24431,0.000802,172.31.47.0-255,66,68316,90,177230
24432,0.000814,74.125.68.0-255,2902,71218,90,177230
24433,0.000835,172.31.47.0-255,66,71284,90,177230
24434,0.00085,74.125.68.0-255,5738,77022,90,177230
24435,0.000857,172.31.47.0-255,66,77088,90,177230
24436,0.000889,172.31.47.0-255,66,77154,90,177230
24437,0.000896,74.125.68.0-255,2902,80056,90,177230
24438,0.000901,172.31.47.0-255,66,80122,90,177230
24439,0.000949,74.125.68.0-255,7856,87978,90,177230
24440,0.000955,172.31.47.0-255,66,88044,90,177230
24441,0.001792,74.125.68.0-255,1484,89528,90,177230
24442,0.001799,74.125.68.0-255,2902,92430,90,177230
24443,0.00181,172.31.47.0-255,66,92496,90,177230
24444,0.001824,74.125.68.0-255,5738,98234,90,177230
24445,0.001827,172.31.47.0-255,66,98300,90,177230
24446,0.001835,74.125.68.0-255,1484,99784,90,177230
24447,0.001868,74.125.68.0-255,1484,101268,90,177230
24448,0.00187,172.31.47.0-255,66,101334,90,177230
24449,0.0019,74.125.68.0-255,1484,102818,90,177230
24450,0.001907,74.125.68.0-255,5738,108556,90,177230
24451,0.001909,172.31.47.0-255,66,108622,90,177230
24452,0.001918,74.125.68.0-255,8574,117196,90,177230
24453,0.001925,172.31.47.0-255,66,117262,90,177230
24454,0.001954,74.125.68.0-255,5020,122282,90,177230
24455,0.001956,172.31.47.0-255,66,122348,90,177230
24456,0.001961,74.125.68.0-255,2902,125250,90,177230
24457,0.001964,172.31.47.0-255,66,125316,90,177230
24458,0.001984,74.125.68.0-255,2902,128218,90,177230
24459,0.001987,172.31.47.0-255,66,128284,90,177230
24460,0.001994,74.125.68.0-255,1484,129768,90,177230
24461,0.002016,74.125.68.0-255,2902,132670,90,177230
24462,0.002019,172.31.47.0-255,66,132736,90,177230
24463,0.002022,74.125.68.0-255,1484,134220,90,177230
24464,0.002054,74.125.68.0-255,4320,138540,90,177230
24465,0.002057,172.31.47.0-255,66,138606,90,177230
24466,0.002064,74.125.68.0-255,7156,145762,90,177230
24467,0.002066,172.31.47.0-255,66,145828,90,177230
24468,0.002079,74.125.68.0-255,8574,154402,90,177230
24469,0.002082,172.31.47.0-255,66,154468,90,177230
24470,0.002086,74.125.68.0-255,2184,156652,90,177230
24471,0.002089,172.31.47.0-255,66,156718,90,177230
24472,0.002482,74.125.68.0-255,1484,158202,90,177230
24473,0.002507,74.125.68.0-255,2902,161104,90,177230
24474,0.002511,172.31.47.0-255,66,161170,90,177230
24475,0.002517,74.125.68.0-255,4320,165490,90,177230
24476,0.002519,172.31.47.0-255,66,165556,90,177230
24477,0.002522,74.125.68.0-255,1484,167040,90,177230
24478,0.005011,74.125.68.0-255,4320,171360,90,177230
24479,0.005018,172.31.47.0-255,66,171426,90,177230
24480,0.007508,74.125.68.0-255,5738,177164,90,177230
24481,0.007512,172.31.47.0-255,66,177230,90,177230
24482,0.0,172.31.47.0-255,105,105,90,105
24483,0.0,74.125.24.0-255,288,288,90,314828
24484,1.4e-05,172.31.47.0-255,66,354,90,314828
24485,2e-05,74.125.24.0-255,1484,1838,90,314828
24486,2.3e-05,172.31.47.0-255,66,1904,90,314828
24487,2.6e-05,74.125.24.0-255,1484,3388,90,314828
24488,2.9e-05,172.31.47.0-255,66,3454,90,314828
24489,5.9e-05,74.125.24.0-255,2902,6356,90,314828
24490,6.2e-05,172.31.47.0-255,66,6422,90,314828
24491,7e-05,74.125.24.0-255,7528,13950,90,314828
24492,7.2e-05,172.31.47.0-255,66,14016,90,314828
24493,0.000119,74.125.24.0-255,1484,15500,90,314828
24494,0.000122,172.31.47.0-255,66,15566,90,314828
24495,0.000127,74.125.24.0-255,2902,18468,90,314828
24496,0.000129,172.31.47.0-255,66,18534,90,314828
24497,0.00015,74.125.24.0-255,5738,24272,90,314828
24498,0.000153,172.31.47.0-255,66,24338,90,314828
24499,0.000156,74.125.24.0-255,2902,27240,90,314828
24500,0.000158,172.31.47.0-255,66,27306,90,314828
24501,0.000185,74.125.24.0-255,3961,31267,90,314828
24502,0.000188,172.31.47.0-255,66,31333,90,314828
24503,0.000312,74.125.24.0-255,1484,32817,90,314828
24504,0.000318,172.31.47.0-255,66,32883,90,314828
24505,0.000323,74.125.24.0-255,2902,35785,90,314828
24506,0.000326,172.31.47.0-255,66,35851,90,314828
24507,0.000337,74.125.24.0-255,5738,41589,90,314828
24508,0.00034,172.31.47.0-255,66,41655,90,314828
24509,0.000361,74.125.24.0-255,1484,43139,90,314828
24510,0.000364,172.31.47.0-255,66,43205,90,314828
24511,0.00039,74.125.24.0-255,5379,48584,90,314828
24512,0.000393,172.31.47.0-255,66,48650,90,314828
24513,0.000421,74.125.24.0-255,1484,50134,90,314828
24514,0.000423,172.31.47.0-255,66,50200,90,314828
24515,0.000457,74.125.24.0-255,2902,53102,90,314828
24516,0.000459,172.31.47.0-255,66,53168,90,314828
24517,0.000465,74.125.24.0-255,5738,58906,90,314828
24518,0.000467,172.31.47.0-255,66,58972,90,314828
24519,0.00047,74.125.24.0-255,2902,61874,90,314828
24520,0.000472,172.31.47.0-255,66,61940,90,314828
24521,0.000486,74.125.24.0-255,3961,65901,90,314828
24522,0.000489,172.31.47.0-255,66,65967,90,314828
24523,0.000495,74.125.24.0-255,676,66643,90,314828
24524,0.000579,74.125.24.0-255,1484,68127,90,314828
24525,0.000583,172.31.47.0-255,66,68193,90,314828
24526,0.000587,74.125.24.0-255,2902,71095,90,314828
24527,0.00059,172.31.47.0-255,66,71161,90,314828
24528,0.000592,74.125.24.0-255,1484,72645,90,314828
24529,0.00061,74.125.24.0-255,4320,76965,90,314828
24530,0.000617,172.31.47.0-255,66,77031,90,314828
24531,0.00062,74.125.24.0-255,1484,78515,90,314828
24532,0.000643,74.125.24.0-255,4831,83346,90,314828
24533,0.000646,172.31.47.0-255,66,83412,90,314828
24534,0.000667,74.125.24.0-255,4320,87732,90,314828
24535,0.000669,172.31.47.0-255,66,87798,90,314828
24536,0.000671,74.125.24.0-255,1484,89282,90,314828
24537,0.000694,74.125.24.0-255,4320,93602,90,314828
24538,0.000696,172.31.47.0-255,66,93668,90,314828
24539,0.000735,74.125.24.0-255,4320,97988,90,314828
24540,0.00074,172.31.47.0-255,66,98054,90,314828
24541,0.000763,74.125.24.0-255,2543,100597,90,314828
24542,0.000766,172.31.47.0-255,66,100663,90,314828
24543,0.001182,74.125.24.0-255,1484,102147,90,314828
24544,0.001188,74.125.24.0-255,2902,105049,90,314828
24545,0.001192,172.31.47.0-255,66,105115,90,314828
24546,0.001195,74.125.24.0-255,1484,106599,90,314828
24547,0.001223,74.125.24.0-255,4320,110919,90,314828
24548,0.001226,172.31.47.0-255,66,110985,90,314828
24549,0.001257,74.125.24.0-255,8574,119559,90,314828
24550,0.00126,172.31.47.0-255,66,119625,90,314828
24551,0.001284,74.125.24.0-255,4320,123945,90,314828
24552,0.001287,172.31.47.0-255,66,124011,90,314828
24553,0.001296,74.125.24.0-255,10692,134703,90,314828
24554,0.001297,172.31.47.0-255,66,134769,90,314828
24555,0.001773,74.125.24.0-255,1484,136253,90,314828
24556,0.001779,74.125.24.0-255,2902,139155,90,314828
24557,0.001782,172.31.47.0-255,66,139221,90,314828
24558,0.001788,74.125.24.0-255,4320,143541,90,314828
24559,0.001789,172.31.47.0-255,66,143607,90,314828
24560,0.001814,74.125.24.0-255,1484,145091,90,314828
24561,0.00182,74.125.24.0-255,5738,150829,90,314828
24562,0.001821,172.31.47.0-255,66,150895,90,314828
24563,0.001825,74.125.24.0-255,2902,153797,90,314828
24564,0.001826,172.31.47.0-255,66,153863,90,314828
24565,0.001859,74.125.24.0-255,9992,163855,90,314828
24566,0.001862,172.31.47.0-255,66,163921,90,314828
24567,0.001867,74.125.24.0-255,5020,168941,90,314828
24568,0.001868,172.31.47.0-255,66,169007,90,314828
24569,0.002541,74.125.24.0-255,1484,170491,90,314828
24570,0.002568,74.125.24.0-255,2902,173393,90,314828
24571,0.002572,172.31.47.0-255,66,173459,90,314828
24572,0.002578,74.125.24.0-255,5738,179197,90,314828
24573,0.00258,172.31.47.0-255,66,179263,90,314828
24574,0.00262,172.31.47.0-255,66,179329,90,314828
24575,0.002624,74.125.24.0-255,2902,182231,90,314828
24576,0.002626,172.31.47.0-255,66,182297,90,314828
24577,0.002628,74.125.24.0-255,1484,183781,90,314828
24578,0.002657,74.125.24.0-255,6438,190219,90,314828
24579,0.002661,172.31.47.0-255,66,190285,90,314828
24580,0.002748,74.125.24.0-255,1484,191769,90,314828
24581,0.00276,74.125.24.0-255,2902,194671,90,314828
24582,0.002763,172.31.47.0-255,66,194737,90,314828
24583,0.002767,74.125.24.0-255,1484,196221,90,314828
24584,0.002791,74.125.24.0-255,4320,200541,90,314828
24585,0.002794,172.31.47.0-255,66,200607,90,314828
24586,0.002797,74.125.24.0-255,2902,203509,90,314828
24587,0.002799,172.31.47.0-255,66,203575,90,314828
24588,0.002821,74.125.24.0-255,5738,209313,90,314828
24589,0.002823,172.31.47.0-255,66,209379,90,314828
24590,0.002855,172.31.47.0-255,66,209445,90,314828
24591,0.00286,74.125.24.0-255,3602,213047,90,314828
24592,0.002861,172.31.47.0-255,66,213113,90,314828
24593,0.00291,172.31.47.0-255,66,213179,90,314828
24594,0.002919,74.125.24.0-255,10692,223871,90,314828
24595,0.002921,172.31.47.0-255,66,223937,90,314828
24596,0.002927,74.125.24.0-255,7156,231093,90,314828
24597,0.002929,172.31.47.0-255,66,231159,90,314828
24598,0.002934,74.125.24.0-255,5738,236897,90,314828
24599,0.002936,172.31.47.0-255,66,236963,90,314828
24600,0.002957,74.125.24.0-255,1484,238447,90,314828
24601,0.002962,74.125.24.0-255,2902,241349,90,314828
24602,0.002963,172.31.47.0-255,66,241415,90,314828
24603,0.002989,74.125.24.0-255,7156,248571,90,314828
24604,0.002991,172.31.47.0-255,66,248637,90,314828
24605,0.002998,74.125.24.0-255,9274,257911,90,314828
24606,0.003,172.31.47.0-255,66,257977,90,314828
24607,0.003028,74.125.24.0-255,4320,262297,90,314828
24608,0.00303,172.31.47.0-255,66,262363,90,314828
24609,0.003067,74.125.24.0-255,1484,263847,90,314828
24610,0.003082,172.31.47.0-255,66,263913,90,314828
24611,0.00309,74.125.24.0-255,10692,274605,90,314828
24612,0.003092,172.31.47.0-255,66,274671,90,314828
24613,0.003103,172.31.47.0-255,66,274737,90,314828
24614,0.003105,74.125.24.0-255,1484,276221,90,314828
24615,0.003107,74.125.24.0-255,1484,277705,90,314828
24616,0.003108,172.31.47.0-255,66,277771,90,314828
24617,0.003143,74.125.24.0-255,2902,280673,90,314828
24618,0.003146,172.31.47.0-255,66,280739,90,314828
24619,0.00318,172.31.47.0-255,66,280805,90,314828
24620,0.003185,74.125.24.0-255,5738,286543,90,314828
24621,0.003187,172.31.47.0-255,66,286609,90,314828
24622,0.003218,74.125.24.0-255,1484,288093,90,314828
24623,0.003222,74.125.24.0-255,4320,292413,90,314828
24624,0.003224,172.31.47.0-255,66,292479,90,314828
24625,0.003227,74.125.24.0-255,1484,293963,90,314828
24626,0.003234,74.125.24.0-255,9992,303955,90,314828
24627,0.003235,172.31.47.0-255,66,304021,90,314828
24628,0.003243,74.125.24.0-255,2902,306923,90,314828
24629,0.003244,172.31.47.0-255,66,306989,90,314828
24630,0.003249,74.125.24.0-255,3602,310591,90,314828
24631,0.003252,74.125.24.0-255,1484,312075,90,314828
24632,0.003254,172.31.47.0-255,66,312141,90,314828
24633,0.003281,74.125.24.0-255,2182,314323,90,314828
24634,0.003284,172.31.47.0-255,66,314389,90,314828
24635,0.003287,74.125.24.0-255,97,314486,90,314828
24636,0.003308,74.125.24.0-255,105,314591,90,314828
24637,0.004652,172.31.47.0-255,66,314657,90,314828
24638,0.004686,172.31.47.0-255,105,314762,90,314828
24639,0.007227,74.125.24.0-255,66,314828,90,314828
24640,0.0,74.125.130.0-255,153,153,90,270334
24641,3.5e-05,172.31.47.0-255,66,219,90,270334
24642,4.2e-05,74.125.130.0-255,1484,1703,90,270334
24643,4.7e-05,172.31.47.0-255,66,1769,90,270334
24644,6e-05,74.125.130.0-255,2902,4671,90,270334
24645,6.3e-05,172.31.47.0-255,66,4737,90,270334
24646,6.8e-05,74.125.130.0-255,4320,9057,90,270334
24647,7e-05,172.31.47.0-255,66,9123,90,270334
24648,0.000105,74.125.130.0-255,8574,17697,90,270334
24649,0.000109,172.31.47.0-255,66,17763,90,270334
24650,0.000138,74.125.130.0-255,557,18320,90,270334
24651,0.000141,172.31.47.0-255,66,18386,90,270334
24652,0.00015,74.125.130.0-255,9992,28378,90,270334
24653,0.000159,172.31.47.0-255,66,28444,90,270334
24654,0.000163,74.125.130.0-255,2543,30987,90,270334
24655,0.000165,172.31.47.0-255,66,31053,90,270334
24656,0.000277,74.125.130.0-255,1484,32537,90,270334
24657,0.000281,172.31.47.0-255,66,32603,90,270334
24658,0.000286,74.125.130.0-255,1484,34087,90,270334
24659,0.000288,172.31.47.0-255,66,34153,90,270334
24660,0.000318,74.125.130.0-255,2902,37055,90,270334
24661,0.000322,172.31.47.0-255,66,37121,90,270334
24662,0.000328,74.125.130.0-255,5738,42859,90,270334
24663,0.000331,172.31.47.0-255,66,42925,90,270334
24664,0.000334,74.125.130.0-255,1484,44409,90,270334
24665,0.000336,172.31.47.0-255,66,44475,90,270334
24666,0.000372,74.125.130.0-255,3961,48436,90,270334
24667,0.000375,172.31.47.0-255,66,48502,90,270334
24668,0.000381,74.125.130.0-255,5738,54240,90,270334
24669,0.000384,172.31.47.0-255,66,54306,90,270334
24670,0.000428,172.31.47.0-255,66,54372,90,270334
24671,0.000431,74.125.130.0-255,366,54738,90,270334
24672,0.000526,74.125.130.0-255,1484,56222,90,270334
24673,0.000529,172.31.47.0-255,66,56288,90,270334
24674,0.000533,74.125.130.0-255,2902,59190,90,270334
24675,0.000536,172.31.47.0-255,66,59256,90,270334
24676,0.000575,74.125.130.0-255,4320,63576,90,270334
24677,0.00058,172.31.47.0-255,66,63642,90,270334
24678,0.000583,74.125.130.0-255,1484,65126,90,270334
24679,0.000612,74.125.130.0-255,8215,73341,90,270334
24680,0.000616,172.31.47.0-255,66,73407,90,270334
24681,0.00062,74.125.130.0-255,2902,76309,90,270334
24682,0.000622,172.31.47.0-255,66,76375,90,270334
24683,0.000649,74.125.130.0-255,1484,77859,90,270334
24684,0.00068,74.125.130.0-255,10501,88360,90,270334
24685,0.000684,172.31.47.0-255,66,88426,90,270334
24686,0.000742,74.125.130.0-255,1484,89910,90,270334
24687,0.000757,74.125.130.0-255,1484,91394,90,270334
24688,0.00076,172.31.47.0-255,66,91460,90,270334
24689,0.000785,74.125.130.0-255,1484,92944,90,270334
24690,0.000791,74.125.130.0-255,5738,98682,90,270334
24691,0.000793,172.31.47.0-255,66,98748,90,270334
24692,0.000798,74.125.130.0-255,2902,101650,90,270334
24693,0.0008,172.31.47.0-255,66,101716,90,270334
24694,0.000822,74.125.130.0-255,7156,108872,90,270334
24695,0.00083,172.31.47.0-255,66,108938,90,270334
24696,0.000869,172.31.47.0-255,66,109004,90,270334
24697,0.000873,74.125.130.0-255,2184,111188,90,270334
24698,0.000877,172.31.47.0-255,66,111254,90,270334
24699,0.001231,74.125.130.0-255,1484,112738,90,270334
24700,0.001246,74.125.130.0-255,2902,115640,90,270334
24701,0.001249,172.31.47.0-255,66,115706,90,270334
24702,0.001252,74.125.130.0-255,1484,117190,90,270334
24703,0.001276,74.125.130.0-255,2902,120092,90,270334
24704,0.001279,172.31.47.0-255,66,120158,90,270334
24705,0.001286,74.125.130.0-255,5738,125896,90,270334
24706,0.001287,172.31.47.0-255,66,125962,90,270334
24707,0.001311,74.125.130.0-255,2902,128864,90,270334
24708,0.001314,172.31.47.0-255,66,128930,90,270334
24709,0.001342,74.125.130.0-255,5738,134668,90,270334
24710,0.001345,172.31.47.0-255,66,134734,90,270334
24711,0.001353,74.125.130.0-255,9992,144726,90,270334
24712,0.001354,172.31.47.0-255,66,144792,90,270334
24713,0.001357,74.125.130.0-255,766,145558,90,270334
24714,0.001434,74.125.130.0-255,1484,147042,90,270334
24715,0.001437,172.31.47.0-255,66,147108,90,270334
24716,0.001475,74.125.130.0-255,2902,150010,90,270334
24717,0.001478,172.31.47.0-255,66,150076,90,270334
24718,0.001481,74.125.130.0-255,1484,151560,90,270334
24719,0.001485,74.125.130.0-255,2902,154462,90,270334
24720,0.001487,172.31.47.0-255,66,154528,90,270334
24721,0.001491,74.125.130.0-255,4320,158848,90,270334
24722,0.001493,172.31.47.0-255,66,158914,90,270334
24723,0.001518,74.125.130.0-255,1484,160398,90,270334
24724,0.001524,74.125.130.0-255,5738,166136,90,270334
24725,0.001526,172.31.47.0-255,66,166202,90,270334
24726,0.001549,74.125.130.0-255,2902,169104,90,270334
24727,0.001552,172.31.47.0-255,66,169170,90,270334
24728,0.001559,74.125.130.0-255,8574,177744,90,270334
24729,0.001561,172.31.47.0-255,66,177810,90,270334
24730,0.001587,74.125.130.0-255,1484,179294,90,270334
24731,0.00159,74.125.130.0-255,766,180060,90,270334
24732,0.001592,172.31.47.0-255,66,180126,90,270334
24733,0.001725,74.125.130.0-255,1484,181610,90,270334
24734,0.001743,74.125.130.0-255,2902,184512,90,270334
24735,0.001746,172.31.47.0-255,66,184578,90,270334
24736,0.001751,74.125.130.0-255,2902,187480,90,270334
24737,0.001753,172.31.47.0-255,66,187546,90,270334
24738,0.001778,74.125.130.0-255,2902,190448,90,270334
24739,0.00178,172.31.47.0-255,66,190514,90,270334
24740,0.001791,74.125.130.0-255,7156,197670,90,270334
24741,0.001793,172.31.47.0-255,66,197736,90,270334
24742,0.0018,74.125.130.0-255,7156,204892,90,270334
24743,0.001802,172.31.47.0-255,66,204958,90,270334
24744,0.00183,74.125.130.0-255,1484,206442,90,270334
24745,0.001837,74.125.130.0-255,7856,214298,90,270334
24746,0.00184,172.31.47.0-255,66,214364,90,270334
24747,0.001919,74.125.130.0-255,1484,215848,90,270334
24748,0.001924,74.125.130.0-255,2902,218750,90,270334
24749,0.001927,172.31.47.0-255,66,218816,90,270334
24750,0.001951,74.125.130.0-255,5738,224554,90,270334
24751,0.001953,172.31.47.0-255,66,224620,90,270334
24752,0.001989,74.125.130.0-255,8574,233194,90,270334
24753,0.001992,172.31.47.0-255,66,233260,90,270334
24754,0.001996,74.125.130.0-255,2902,236162,90,270334
24755,0.001998,172.31.47.0-255,66,236228,90,270334
24756,0.002034,74.125.130.0-255,7156,243384,90,270334
24757,0.002037,172.31.47.0-255,66,243450,90,270334
24758,0.002042,74.125.130.0-255,5020,248470,90,270334
24759,0.002044,172.31.47.0-255,66,248536,90,270334
24760,0.004021,74.125.130.0-255,5738,254274,90,270334
24761,0.004026,172.31.47.0-255,66,254340,90,270334
24762,0.006004,74.125.130.0-255,4320,258660,90,270334
24763,0.006007,172.31.47.0-255,66,258726,90,270334
24764,0.006026,74.125.130.0-255,1484,260210,90,270334
24765,0.007984,74.125.130.0-255,4320,264530,90,270334
24766,0.007989,172.31.47.0-255,66,264596,90,270334
24767,0.009995,74.125.130.0-255,5738,270334,90,270334
24768,0.0,172.31.47.0-255,105,105,90,105
24769,0.0,74.125.24.0-255,153,153,90,251167
24770,2.6e-05,172.31.47.0-255,66,219,90,251167
24771,3.2e-05,74.125.24.0-255,1484,1703,90,251167
24772,3.5e-05,172.31.47.0-255,66,1769,90,251167
24773,4e-05,74.125.24.0-255,2902,4671,90,251167
24774,4.4e-05,172.31.47.0-255,66,4737,90,251167
24775,5e-05,74.125.24.0-255,7156,11893,90,251167
24776,5.3e-05,172.31.47.0-255,66,11959,90,251167
24777,5.6e-05,74.125.24.0-255,1484,13443,90,251167
24778,5.8e-05,172.31.47.0-255,66,13509,90,251167
24779,0.000105,172.31.47.0-255,66,13575,90,251167
24780,0.000109,74.125.24.0-255,2543,16118,90,251167
24781,0.00011,172.31.47.0-255,66,16184,90,251167
24782,0.000152,74.125.24.0-255,1484,17668,90,251167
24783,0.000157,172.31.47.0-255,66,17734,90,251167
24784,0.000175,74.125.24.0-255,1484,19218,90,251167
24785,0.000178,172.31.47.0-255,66,19284,90,251167
24786,0.000183,74.125.24.0-255,4320,23604,90,251167
24787,0.000185,172.31.47.0-255,66,23670,90,251167
24788,0.000193,74.125.24.0-255,8574,32244,90,251167
24789,0.000195,172.31.47.0-255,66,32310,90,251167
24790,0.000215,74.125.24.0-255,2902,35212,90,251167
24791,0.000217,172.31.47.0-255,66,35278,90,251167
24792,0.000249,172.31.47.0-255,66,35344,90,251167
24793,0.000262,74.125.24.0-255,2823,38167,90,251167
24794,0.000265,172.31.47.0-255,66,38233,90,251167
24795,0.000281,74.125.24.0-255,130,38363,90,251167
24796,0.000284,172.31.47.0-255,66,38429,90,251167
24797,0.000382,74.125.24.0-255,344,38773,90,251167
24798,0.000385,172.31.47.0-255,66,38839,90,251167
24799,0.000755,74.125.24.0-255,1484,40323,90,251167
24800,0.00076,74.125.24.0-255,1484,41807,90,251167
24801,0.000763,172.31.47.0-255,66,41873,90,251167
24802,0.000782,74.125.24.0-255,1484,43357,90,251167
24803,0.000788,74.125.24.0-255,5738,49095,90,251167
24804,0.000791,172.31.47.0-255,66,49161,90,251167
24805,0.000798,74.125.24.0-255,7156,56317,90,251167
24806,0.0008,172.31.47.0-255,66,56383,90,251167
24807,0.000847,172.31.47.0-255,66,56449,90,251167
24808,0.000864,74.125.24.0-255,1484,57933,90,251167
24809,0.000869,74.125.24.0-255,2184,60117,90,251167
24810,0.000871,172.31.47.0-255,66,60183,90,251167
24811,0.001282,74.125.24.0-255,1484,61667,90,251167
24812,0.001293,74.125.24.0-255,2902,64569,90,251167
24813,0.001297,172.31.47.0-255,66,64635,90,251167
24814,0.001302,74.125.24.0-255,2902,67537,90,251167
24815,0.001304,172.31.47.0-255,66,67603,90,251167
24816,0.001321,74.125.24.0-255,2902,70505,90,251167
24817,0.001324,172.31.47.0-255,66,70571,90,251167
24818,0.001332,74.125.24.0-255,8574,79145,90,251167
24819,0.001334,172.31.47.0-255,66,79211,90,251167
24820,0.001353,74.125.24.0-255,4320,83531,90,251167
24821,0.001355,172.31.47.0-255,66,83597,90,251167
24822,0.00136,74.125.24.0-255,4320,87917,90,251167
24823,0.001362,172.31.47.0-255,66,87983,90,251167
24824,0.001384,74.125.24.0-255,6438,94421,90,251167
24825,0.001386,172.31.47.0-255,66,94487,90,251167
24826,0.001448,74.125.24.0-255,1484,95971,90,251167
24827,0.001469,74.125.24.0-255,2902,98873,90,251167
24828,0.001473,172.31.47.0-255,66,98939,90,251167
24829,0.001478,74.125.24.0-255,2902,101841,90,251167
24830,0.00148,172.31.47.0-255,66,101907,90,251167
24831,0.001496,74.125.24.0-255,2902,104809,90,251167
24832,0.001498,172.31.47.0-255,66,104875,90,251167
24833,0.001538,74.125.24.0-255,5738,110613,90,251167
24834,0.001541,172.31.47.0-255,66,110679,90,251167
24835,0.001566,74.125.24.0-255,7156,117835,90,251167
24836,0.001569,172.31.47.0-255,66,117901,90,251167
24837,0.001573,74.125.24.0-255,1484,119385,90,251167
24838,0.001598,74.125.24.0-255,9274,128659,90,251167
24839,0.0016,172.31.47.0-255,66,128725,90,251167
24840,0.001618,74.125.24.0-255,5738,134463,90,251167
24841,0.001621,172.31.47.0-255,66,134529,90,251167
24842,0.001628,74.125.24.0-255,7156,141685,90,251167
24843,0.001631,172.31.47.0-255,66,141751,90,251167
24844,0.00166,74.125.24.0-255,8574,150325,90,251167
24845,0.001663,172.31.47.0-255,66,150391,90,251167
24846,0.001683,74.125.24.0-255,5738,156129,90,251167
24847,0.001685,172.31.47.0-255,66,156195,90,251167
24848,0.001695,74.125.24.0-255,1484,157679,90,251167
24849,0.001715,74.125.24.0-255,5020,162699,90,251167
24850,0.001717,172.31.47.0-255,66,162765,90,251167
24851,0.001755,74.125.24.0-255,4320,167085,90,251167
24852,0.001757,172.31.47.0-255,66,167151,90,251167
24853,0.001776,74.125.24.0-255,1484,168635,90,251167
24854,0.001782,74.125.24.0-255,7156,175791,90,251167
24855,0.001785,172.31.47.0-255,66,175857,90,251167
24856,0.001787,74.125.24.0-255,1484,177341,90,251167
24857,0.001815,172.31.47.0-255,66,177407,90,251167
24858,0.001821,74.125.24.0-255,6438,183845,90,251167
24859,0.001823,172.31.47.0-255,66,183911,90,251167
24860,0.001892,74.125.24.0-255,1484,185395,90,251167
24861,0.001906,74.125.24.0-255,2902,188297,90,251167
24862,0.001908,172.31.47.0-255,66,188363,90,251167
24863,0.001928,74.125.24.0-255,5738,194101,90,251167
24864,0.00193,172.31.47.0-255,66,194167,90,251167
24865,0.001954,74.125.24.0-255,2902,197069,90,251167
24866,0.001956,172.31.47.0-255,66,197135,90,251167
24867,0.001983,74.125.24.0-255,9992,207127,90,251167
24868,0.001986,172.31.47.0-255,66,207193,90,251167
24869,0.00201,74.125.24.0-255,1484,208677,90,251167
24870,0.002028,74.125.24.0-255,9274,217951,90,251167
24871,0.002031,172.31.47.0-255,66,218017,90,251167
24872,0.00248,74.125.24.0-255,1484,219501,90,251167
24873,0.002496,74.125.24.0-255,2902,222403,90,251167
24874,0.002498,172.31.47.0-255,66,222469,90,251167
24875,0.002501,74.125.24.0-255,2902,225371,90,251167
24876,0.002503,172.31.47.0-255,66,225437,90,251167
24877,0.002516,74.125.24.0-255,2902,228339,90,251167
24878,0.002518,172.31.47.0-255,66,228405,90,251167
24879,0.002521,74.125.24.0-255,1484,229889,90,251167
24880,0.002542,74.125.24.0-255,4320,234209,90,251167
24881,0.002544,172.31.47.0-255,66,234275,90,251167
24882,0.002554,172.31.47.0-255,66,234341,90,251167
24883,0.002564,74.125.24.0-255,1484,235825,90,251167
24884,0.002569,74.125.24.0-255,5020,240845,90,251167
24885,0.002571,172.31.47.0-255,66,240911,90,251167
24886,0.005103,74.125.24.0-255,4320,245231,90,251167
24887,0.005106,172.31.47.0-255,66,245297,90,251167
24888,0.005122,74.125.24.0-255,1484,246781,90,251167
24889,0.007661,74.125.24.0-255,4320,251101,90,251167
24890,0.007684,172.31.47.0-255,66,251167,90,251167
24891,0.0,172.31.47.0-255,66,66,90,66
24892,0.0,172.217.194.0-255,298,298,90,169985
24893,2.5e-05,172.31.47.0-255,66,364,90,169985
24894,3.1e-05,172.217.194.0-255,1484,1848,90,169985
24895,3.4e-05,172.31.47.0-255,66,1914,90,169985
24896,4e-05,172.217.194.0-255,4320,6234,90,169985
24897,4.2e-05,172.31.47.0-255,66,6300,90,169985
24898,4.5e-05,172.217.194.0-255,1484,7784,90,169985
24899,4.7e-05,172.31.47.0-255,66,7850,90,169985
24900,7.9e-05,172.217.194.0-255,6140,13990,90,169985
24901,8.1e-05,172.31.47.0-255,66,14056,90,169985
24902,0.000132,172.217.194.0-255,1484,15540,90,169985
24903,0.000134,172.31.47.0-255,66,15606,90,169985
24904,0.000138,172.217.194.0-255,1484,17090,90,169985
24905,0.00014,172.31.47.0-255,66,17156,90,169985
24906,0.000155,172.217.194.0-255,1484,18640,90,169985
24907,0.000157,172.31.47.0-255,66,18706,90,169985
24908,0.000172,172.217.194.0-255,4320,23026,90,169985
24909,0.000174,172.31.47.0-255,66,23092,90,169985
24910,0.000197,172.217.194.0-255,1484,24576,90,169985
24911,0.000199,172.31.47.0-255,66,24642,90,169985
24912,0.000206,172.217.194.0-255,6797,31439,90,169985
24913,0.000208,172.31.47.0-255,66,31505,90,169985
24914,0.000249,172.31.47.0-255,66,31571,90,169985
24915,0.000252,172.217.194.0-255,2543,34114,90,169985
24916,0.000255,172.31.47.0-255,66,34180,90,169985
24917,0.00029,172.217.194.0-255,4320,38500,90,169985
24918,0.000293,172.31.47.0-255,66,38566,90,169985
24919,0.000321,172.31.47.0-255,66,38632,90,169985
24920,0.000398,172.217.194.0-255,121,38753,90,169985
24921,0.000401,172.31.47.0-255,66,38819,90,169985
24922,0.000477,172.217.194.0-255,1484,40303,90,169985
24923,0.000482,172.217.194.0-255,2902,43205,90,169985
24924,0.000485,172.31.47.0-255,66,43271,90,169985
24925,0.000507,172.217.194.0-255,5738,49009,90,169985
24926,0.00051,172.31.47.0-255,66,49075,90,169985
24927,0.000541,172.217.194.0-255,8215,57290,90,169985
24928,0.000543,172.31.47.0-255,66,57356,90,169985
24929,0.000547,172.217.194.0-255,2902,60258,90,169985
24930,0.000551,172.31.47.0-255,66,60324,90,169985
24931,0.000567,172.217.194.0-255,5738,66062,90,169985
24932,0.00057,172.31.47.0-255,66,66128,90,169985
24933,0.000589,172.217.194.0-255,5738,71866,90,169985
24934,0.000592,172.31.47.0-255,66,71932,90,169985
24935,0.000602,172.217.194.0-255,1125,73057,90,169985
24936,0.000772,172.217.194.0-255,380,73437,90,169985
24937,0.000858,172.217.194.0-255,1484,74921,90,169985
24938,0.000861,172.31.47.0-255,66,74987,90,169985
24939,0.000866,172.217.194.0-255,2902,77889,90,169985
24940,0.000867,172.31.47.0-255,66,77955,90,169985
24941,0.000887,172.217.194.0-255,5738,83693,90,169985
24942,0.00089,172.31.47.0-255,66,83759,90,169985
24943,0.000895,172.217.194.0-255,5738,89497,90,169985
24944,0.000897,172.31.47.0-255,66,89563,90,169985
24945,0.000931,172.31.47.0-255,66,89629,90,169985
24946,0.000954,172.217.194.0-255,5020,94649,90,169985
24947,0.000956,172.31.47.0-255,66,94715,90,169985
24948,0.00124,172.217.194.0-255,1484,96199,90,169985
24949,0.001249,172.217.194.0-255,2902,99101,90,169985
24950,0.001253,172.31.47.0-255,66,99167,90,169985
24951,0.00126,172.217.194.0-255,5738,104905,90,169985
24952,0.001262,172.31.47.0-255,66,104971,90,169985
24953,0.001298,172.31.47.0-255,66,105037,90,169985
24954,0.001305,172.217.194.0-255,5738,110775,90,169985
24955,0.001307,172.31.47.0-255,66,110841,90,169985
24956,0.001325,172.217.194.0-255,5020,115861,90,169985
24957,0.001328,172.31.47.0-255,66,115927,90,169985
24958,0.001783,172.217.194.0-255,1484,117411,90,169985
24959,0.001791,172.217.194.0-255,2902,120313,90,169985
24960,0.001795,172.31.47.0-255,66,120379,90,169985
24961,0.001803,172.217.194.0-255,5738,126117,90,169985
24962,0.001805,172.31.47.0-255,66,126183,90,169985
24963,0.00181,172.217.194.0-255,5738,131921,90,169985
24964,0.001813,172.31.47.0-255,66,131987,90,169985
24965,0.001826,172.217.194.0-255,1484,133471,90,169985
24966,0.001852,172.31.47.0-255,66,133537,90,169985
24967,0.001877,172.217.194.0-255,2902,136439,90,169985
24968,0.00188,172.31.47.0-255,66,136505,90,169985
24969,0.001899,172.217.194.0-255,2184,138689,90,169985
24970,0.001905,172.31.47.0-255,66,138755,90,169985
24971,0.00203,172.217.194.0-255,1484,140239,90,169985
24972,0.002036,172.217.194.0-255,2902,143141,90,169985
24973,0.00204,172.31.47.0-255,66,143207,90,169985
24974,0.002045,172.217.194.0-255,4320,147527,90,169985
24975,0.002047,172.31.47.0-255,66,147593,90,169985
24976,0.00206,172.217.194.0-255,1484,149077,90,169985
24977,0.002087,172.31.47.0-255,66,149143,90,169985
24978,0.002108,172.217.194.0-255,2902,152045,90,169985
24979,0.00211,172.31.47.0-255,66,152111,90,169985
24980,0.002147,172.31.47.0-255,66,152177,90,169985
24981,0.002166,172.31.47.0-255,66,152243,90,169985
24982,0.002234,172.31.47.0-255,66,152309,90,169985
24983,0.002247,172.31.47.0-255,66,152375,90,169985
24984,0.002258,172.31.47.0-255,66,152441,90,169985
24985,0.002269,172.31.47.0-255,66,152507,90,169985
24986,0.002303,172.31.47.0-255,66,152573,90,169985
24987,0.004556,172.217.194.0-255,5738,158311,90,169985
24988,0.004562,172.31.47.0-255,66,158377,90,169985
24989,0.006816,172.217.194.0-255,5738,164115,90,169985
24990,0.006823,172.31.47.0-255,66,164181,90,169985
24991,0.009069,172.217.194.0-255,5738,169919,90,169985
24992,0.009075,172.31.47.0-255,66,169985,90,169985
24993,0.0,172.31.47.0-255,66,66,90,66
24994,0.0,172.217.194.0-255,153,153,90,259952
24995,2.3e-05,172.31.47.0-255,66,219,90,259952
24996,2.9e-05,172.217.194.0-255,1484,1703,90,259952
24997,3.2e-05,172.31.47.0-255,66,1769,90,259952
24998,3.7e-05,172.217.194.0-255,2902,4671,90,259952
24999,3.9e-05,172.31.47.0-255,66,4737,90,259952
25000,5.3e-05,172.217.194.0-255,7156,11893,90,259952
25001,5.5e-05,172.31.47.0-255,66,11959,90,259952
25002,0.000114,172.31.47.0-255,66,12025,90,259952
25003,0.000118,172.217.194.0-255,2543,14568,90,259952
25004,0.00012,172.31.47.0-255,66,14634,90,259952
25005,0.000359,172.217.194.0-255,1484,16118,90,259952
25006,0.000364,172.31.47.0-255,66,16184,90,259952
25007,0.000367,172.217.194.0-255,1484,17668,90,259952
25008,0.000369,172.31.47.0-255,66,17734,90,259952
25009,0.000391,172.217.194.0-255,1484,19218,90,259952
25010,0.000394,172.31.47.0-255,66,19284,90,259952
25011,0.000404,172.217.194.0-255,5738,25022,90,259952
25012,0.000406,172.31.47.0-255,66,25088,90,259952
25013,0.000409,172.217.194.0-255,1484,26572,90,259952
25014,0.000411,172.31.47.0-255,66,26638,90,259952
25015,0.000437,172.217.194.0-255,9633,36271,90,259952
25016,0.00044,172.31.47.0-255,66,36337,90,259952
25017,0.000453,172.217.194.0-255,1125,37462,90,259952
25018,0.000456,172.31.47.0-255,66,37528,90,259952
25019,0.000458,172.31.47.0-255,66,37594,90,259952
25020,0.000567,172.217.194.0-255,646,38240,90,259952
25021,0.000571,172.31.47.0-255,66,38306,90,259952
25022,0.000634,172.217.194.0-255,1484,39790,90,259952
25023,0.000637,172.31.47.0-255,66,39856,90,259952
25024,0.00066,172.217.194.0-255,2902,42758,90,259952
25025,0.000663,172.31.47.0-255,66,42824,90,259952
25026,0.000669,172.217.194.0-255,5738,48562,90,259952
25027,0.000671,172.31.47.0-255,66,48628,90,259952
25028,0.000718,172.31.47.0-255,66,48694,90,259952
25029,0.000727,172.217.194.0-255,10692,59386,90,259952
25030,0.000729,172.31.47.0-255,66,59452,90,259952
25031,0.000759,172.217.194.0-255,1484,60936,90,259952
25032,0.00077,172.217.194.0-255,2902,63838,90,259952
25033,0.000772,172.31.47.0-255,66,63904,90,259952
25034,0.000799,172.217.194.0-255,5738,69642,90,259952
25035,0.000802,172.31.47.0-255,66,69708,90,259952
25036,0.000828,172.217.194.0-255,7156,76864,90,259952
25037,0.000831,172.31.47.0-255,66,76930,90,259952
25038,0.000859,172.217.194.0-255,2902,79832,90,259952
25039,0.000862,172.31.47.0-255,66,79898,90,259952
25040,0.000874,172.31.47.0-255,66,79964,90,259952
25041,0.000877,172.217.194.0-255,2184,82148,90,259952
25042,0.000879,172.31.47.0-255,66,82214,90,259952
25043,0.000906,172.217.194.0-255,2902,85116,90,259952
25044,0.000909,172.31.47.0-255,66,85182,90,259952
25045,0.000914,172.217.194.0-255,4320,89502,90,259952
25046,0.000916,172.31.47.0-255,66,89568,90,259952
25047,0.000952,172.217.194.0-255,8574,98142,90,259952
25048,0.000956,172.31.47.0-255,66,98208,90,259952
25049,0.000982,172.217.194.0-255,7156,105364,90,259952
25050,0.000985,172.31.47.0-255,66,105430,90,259952
25051,0.001013,172.217.194.0-255,10692,116122,90,259952
25052,0.001016,172.31.47.0-255,66,116188,90,259952
25053,0.001036,172.31.47.0-255,66,116254,90,259952
25054,0.001049,172.31.47.0-255,66,116320,90,259952
25055,0.001102,172.217.194.0-255,766,117086,90,259952
25056,0.001406,172.217.194.0-255,1484,118570,90,259952
25057,0.001412,172.31.47.0-255,66,118636,90,259952
25058,0.001417,172.217.194.0-255,2902,121538,90,259952
25059,0.001419,172.31.47.0-255,66,121604,90,259952
25060,0.001423,172.217.194.0-255,2902,124506,90,259952
25061,0.001425,172.31.47.0-255,66,124572,90,259952
25062,0.001452,172.217.194.0-255,2902,127474,90,259952
25063,0.001455,172.31.47.0-255,66,127540,90,259952
25064,0.001466,172.31.47.0-255,66,127606,90,259952
25065,0.001503,172.217.194.0-255,10692,138298,90,259952
25066,0.001504,172.31.47.0-255,66,138364,90,259952
25067,0.001526,172.217.194.0-255,1484,139848,90,259952
25068,0.001542,172.217.194.0-255,2902,142750,90,259952
25069,0.001544,172.31.47.0-255,66,142816,90,259952
25070,0.001567,172.217.194.0-255,5738,148554,90,259952
25071,0.001569,172.31.47.0-255,66,148620,90,259952
25072,0.00159,172.217.194.0-255,4320,152940,90,259952
25073,0.001592,172.31.47.0-255,66,153006,90,259952
25074,0.001615,172.217.194.0-255,7156,160162,90,259952
25075,0.001617,172.31.47.0-255,66,160228,90,259952
25076,0.001622,172.217.194.0-255,5738,165966,90,259952
25077,0.001624,172.31.47.0-255,66,166032,90,259952
25078,0.001647,172.217.194.0-255,6438,172470,90,259952
25079,0.001649,172.31.47.0-255,66,172536,90,259952
25080,0.001672,172.217.194.0-255,1484,174020,90,259952
25081,0.001676,172.217.194.0-255,2902,176922,90,259952
25082,0.001678,172.31.47.0-255,66,176988,90,259952
25083,0.001686,172.217.194.0-255,4320,181308,90,259952
25084,0.001688,172.31.47.0-255,66,181374,90,259952
25085,0.001709,172.217.194.0-255,1484,182858,90,259952
25086,0.001714,172.217.194.0-255,5738,188596,90,259952
25087,0.001716,172.31.47.0-255,66,188662,90,259952
25088,0.001727,172.31.47.0-255,66,188728,90,259952
25089,0.001731,172.217.194.0-255,5020,193748,90,259952
25090,0.001733,172.31.47.0-255,66,193814,90,259952
25091,0.001795,172.217.194.0-255,1484,195298,90,259952
25092,0.001798,172.217.194.0-255,1484,196782,90,259952
25093,0.001799,172.31.47.0-255,66,196848,90,259952
25094,0.001819,172.217.194.0-255,1484,198332,90,259952
25095,0.001825,172.217.194.0-255,5738,204070,90,259952
25096,0.001827,172.31.47.0-255,66,204136,90,259952
25097,0.001832,172.217.194.0-255,7156,211292,90,259952
25098,0.001834,172.31.47.0-255,66,211358,90,259952
25099,0.001851,172.217.194.0-255,1484,212842,90,259952
25100,0.001885,172.217.194.0-255,5738,218580,90,259952
25101,0.001888,172.31.47.0-255,66,218646,90,259952
25102,0.001913,172.217.194.0-255,9274,227920,90,259952
25103,0.001915,172.31.47.0-255,66,227986,90,259952
25104,0.001945,172.31.47.0-255,66,228052,90,259952
25105,0.001968,172.217.194.0-255,2902,230954,90,259952
25106,0.001969,172.31.47.0-255,66,231020,90,259952
25107,0.001979,172.31.47.0-255,66,231086,90,259952
25108,0.002002,172.217.194.0-255,1484,232570,90,259952
25109,0.002013,172.31.47.0-255,66,232636,90,259952
25110,0.002035,172.217.194.0-255,3602,236238,90,259952
25111,0.002036,172.31.47.0-255,66,236304,90,259952
25112,0.002076,172.217.194.0-255,8574,244878,90,259952
25113,0.002077,172.31.47.0-255,66,244944,90,259952
25114,0.002107,172.217.194.0-255,9992,254936,90,259952
25115,0.002109,172.31.47.0-255,66,255002,90,259952
25116,0.002113,172.217.194.0-255,4542,259544,90,259952
25117,0.002115,172.31.47.0-255,66,259610,90,259952
25118,0.002117,172.217.194.0-255,105,259715,90,259952
25119,0.006844,172.31.47.0-255,66,259781,90,259952
25120,0.006868,172.31.47.0-255,105,259886,90,259952
25121,0.009403,172.217.194.0-255,66,259952,90,259952
25122,0.0,216.58.221.0-255,153,153,90,260234
25123,2.2e-05,172.31.47.0-255,66,219,90,260234
25124,2.9e-05,216.58.221.0-255,1484,1703,90,260234
25125,3.3e-05,172.31.47.0-255,66,1769,90,260234
25126,3.9e-05,216.58.221.0-255,2902,4671,90,260234
25127,4.3e-05,172.31.47.0-255,66,4737,90,260234
25128,4.8e-05,216.58.221.0-255,4320,9057,90,260234
25129,5.1e-05,172.31.47.0-255,66,9123,90,260234
25130,8.1e-05,216.58.221.0-255,2902,12025,90,260234
25131,8.5e-05,172.31.47.0-255,66,12091,90,260234
25132,9e-05,216.58.221.0-255,2098,14189,90,260234
25133,9.3e-05,172.31.47.0-255,66,14255,90,260234
25134,9.7e-05,216.58.221.0-255,2902,17157,90,260234
25135,9.9e-05,172.31.47.0-255,66,17223,90,260234
25136,0.000107,216.58.221.0-255,7156,24379,90,260234
25137,0.000109,172.31.47.0-255,66,24445,90,260234
25138,0.000135,216.58.221.0-255,6797,31242,90,260234
25139,0.000139,172.31.47.0-255,66,31308,90,260234
25140,0.00019,216.58.221.0-255,1484,32792,90,260234
25141,0.000195,172.31.47.0-255,66,32858,90,260234
25142,0.0002,216.58.221.0-255,2902,35760,90,260234
25143,0.000203,172.31.47.0-255,66,35826,90,260234
25144,0.000233,216.58.221.0-255,5738,41564,90,260234
25145,0.000237,172.31.47.0-255,66,41630,90,260234
25146,0.000241,216.58.221.0-255,4320,45950,90,260234
25147,0.000244,172.31.47.0-255,66,46016,90,260234
25148,0.000267,216.58.221.0-255,1484,47500,90,260234
25149,0.000271,172.31.47.0-255,66,47566,90,260234
25150,0.000274,216.58.221.0-255,1125,48691,90,260234
25151,0.000276,172.31.47.0-255,66,48757,90,260234
25152,0.00032,216.58.221.0-255,1484,50241,90,260234
25153,0.000323,172.31.47.0-255,66,50307,90,260234
25154,0.000347,216.58.221.0-255,2902,53209,90,260234
25155,0.00035,172.31.47.0-255,66,53275,90,260234
25156,0.000356,216.58.221.0-255,4320,57595,90,260234
25157,0.000358,172.31.47.0-255,66,57661,90,260234
25158,0.000361,216.58.221.0-255,1484,59145,90,260234
25159,0.000392,216.58.221.0-255,7129,66274,90,260234
25160,0.000395,172.31.47.0-255,66,66340,90,260234
25161,0.001019,216.58.221.0-255,114,66454,90,260234
25162,0.001218,216.58.221.0-255,1484,67938,90,260234
25163,0.001224,172.31.47.0-255,66,68004,90,260234
25164,0.001243,216.58.221.0-255,2902,70906,90,260234
25165,0.001245,172.31.47.0-255,66,70972,90,260234
25166,0.001249,216.58.221.0-255,1484,72456,90,260234
25167,0.001274,216.58.221.0-255,4320,76776,90,260234
25168,0.001276,172.31.47.0-255,66,76842,90,260234
25169,0.00132,216.58.221.0-255,8574,85416,90,260234
25170,0.001323,172.31.47.0-255,66,85482,90,260234
25171,0.001345,216.58.221.0-255,5379,90861,90,260234
25172,0.001347,172.31.47.0-255,66,90927,90,260234
25173,0.001373,216.58.221.0-255,1484,92411,90,260234
25174,0.001391,216.58.221.0-255,2902,95313,90,260234
25175,0.001394,172.31.47.0-255,66,95379,90,260234
25176,0.001414,216.58.221.0-255,5379,100758,90,260234
25177,0.001416,172.31.47.0-255,66,100824,90,260234
25178,0.001461,216.58.221.0-255,1484,102308,90,260234
25179,0.001465,216.58.221.0-255,2902,105210,90,260234
25180,0.00147,172.31.47.0-255,66,105276,90,260234
25181,0.001493,216.58.221.0-255,1484,106760,90,260234
25182,0.001495,216.58.221.0-255,1484,108244,90,260234
25183,0.001499,172.31.47.0-255,66,108310,90,260234
25184,0.001517,216.58.221.0-255,1484,109794,90,260234
25185,0.001538,216.58.221.0-255,4320,114114,90,260234
25186,0.00154,172.31.47.0-255,66,114180,90,260234
25187,0.001564,216.58.221.0-255,5738,119918,90,260234
25188,0.001567,172.31.47.0-255,66,119984,90,260234
25189,0.001574,216.58.221.0-255,5738,125722,90,260234
25190,0.001576,172.31.47.0-255,66,125788,90,260234
25191,0.001604,216.58.221.0-255,5738,131526,90,260234
25192,0.001607,172.31.47.0-255,66,131592,90,260234
25193,0.001624,216.58.221.0-255,1484,133076,90,260234
25194,0.001628,216.58.221.0-255,2184,135260,90,260234
25195,0.001631,172.31.47.0-255,66,135326,90,260234
25196,0.001709,216.58.221.0-255,1484,136810,90,260234
25197,0.001724,216.58.221.0-255,1484,138294,90,260234
25198,0.001728,172.31.47.0-255,66,138360,90,260234
25199,0.00174,216.58.221.0-255,1484,139844,90,260234
25200,0.001744,216.58.221.0-255,1484,141328,90,260234
25201,0.001746,172.31.47.0-255,66,141394,90,260234
25202,0.001766,216.58.221.0-255,4320,145714,90,260234
25203,0.001771,172.31.47.0-255,66,145780,90,260234
25204,0.001815,216.58.221.0-255,7156,152936,90,260234
25205,0.001818,172.31.47.0-255,66,153002,90,260234
25206,0.001847,216.58.221.0-255,5738,158740,90,260234
25207,0.00185,172.31.47.0-255,66,158806,90,260234
25208,0.001858,216.58.221.0-255,8574,167380,90,260234
25209,0.00186,172.31.47.0-255,66,167446,90,260234
25210,0.001891,216.58.221.0-255,2184,169630,90,260234
25211,0.001894,172.31.47.0-255,66,169696,90,260234
25212,0.001929,216.58.221.0-255,1484,171180,90,260234
25213,0.001933,216.58.221.0-255,1484,172664,90,260234
25214,0.001935,172.31.47.0-255,66,172730,90,260234
25215,0.00196,216.58.221.0-255,1484,174214,90,260234
25216,0.001965,216.58.221.0-255,2902,177116,90,260234
25217,0.001967,172.31.47.0-255,66,177182,90,260234
25218,0.001981,216.58.221.0-255,1484,178666,90,260234
25219,0.001992,216.58.221.0-255,1484,180150,90,260234
25220,0.001994,172.31.47.0-255,66,180216,90,260234
25221,0.002013,216.58.221.0-255,5738,185954,90,260234
25222,0.002015,172.31.47.0-255,66,186020,90,260234
25223,0.002037,216.58.221.0-255,7156,193176,90,260234
25224,0.00204,172.31.47.0-255,66,193242,90,260234
25225,0.002047,216.58.221.0-255,7156,200398,90,260234
25226,0.002049,172.31.47.0-255,66,200464,90,260234
25227,0.002086,216.58.221.0-255,3602,204066,90,260234
25228,0.00209,172.31.47.0-255,66,204132,90,260234
25229,0.00213,216.58.221.0-255,2902,207034,90,260234
25230,0.002133,172.31.47.0-255,66,207100,90,260234
25231,0.002153,216.58.221.0-255,1484,208584,90,260234
25232,0.002159,216.58.221.0-255,4320,212904,90,260234
25233,0.002161,172.31.47.0-255,66,212970,90,260234
25234,0.002179,216.58.221.0-255,1484,214454,90,260234
25235,0.002188,216.58.221.0-255,8574,223028,90,260234
25236,0.00219,172.31.47.0-255,66,223094,90,260234
25237,0.002221,216.58.221.0-255,2902,225996,90,260234
25238,0.002225,172.31.47.0-255,66,226062,90,260234
25239,0.002232,216.58.221.0-255,7156,233218,90,260234
25240,0.002234,172.31.47.0-255,66,233284,90,260234
25241,0.002239,216.58.221.0-255,5020,238304,90,260234
25242,0.002242,172.31.47.0-255,66,238370,90,260234
25243,0.00413,216.58.221.0-255,4320,242690,90,260234
25244,0.004136,172.31.47.0-255,66,242756,90,260234
25245,0.004163,216.58.221.0-255,1484,244240,90,260234
25246,0.006019,216.58.221.0-255,4320,248560,90,260234
25247,0.006023,172.31.47.0-255,66,248626,90,260234
25248,0.007914,216.58.221.0-255,5738,254364,90,260234
25249,0.007917,172.31.47.0-255,66,254430,90,260234
25250,0.009811,216.58.221.0-255,5738,260168,90,260234
25251,0.009823,172.31.47.0-255,66,260234,90,260234
25252,0.0,74.125.24.0-255,153,153,90,293101
25253,1.4e-05,172.31.47.0-255,66,219,90,293101
25254,4.6e-05,74.125.24.0-255,1484,1703,90,293101
25255,5.1e-05,172.31.47.0-255,66,1769,90,293101
25256,5.4e-05,74.125.24.0-255,1484,3253,90,293101
25257,5.6e-05,172.31.47.0-255,66,3319,90,293101
25258,7.6e-05,74.125.24.0-255,1484,4803,90,293101
25259,7.8e-05,172.31.47.0-255,66,4869,90,293101
25260,8.9e-05,74.125.24.0-255,7156,12025,90,293101
25261,9.2e-05,172.31.47.0-255,66,12091,90,293101
25262,0.000118,74.125.24.0-255,2182,14273,90,293101
25263,0.000121,172.31.47.0-255,66,14339,90,293101
25264,0.000322,74.125.24.0-255,1484,15823,90,293101
25265,0.000328,172.31.47.0-255,66,15889,90,293101
25266,0.000334,74.125.24.0-255,2902,18791,90,293101
25267,0.000336,172.31.47.0-255,66,18857,90,293101
25268,0.000339,74.125.24.0-255,1484,20341,90,293101
25269,0.00034,172.31.47.0-255,66,20407,90,293101
25270,0.000366,74.125.24.0-255,4320,24727,90,293101
25271,0.000373,172.31.47.0-255,66,24793,90,293101
25272,0.000379,74.125.24.0-255,6797,31590,90,293101
25273,0.00038,172.31.47.0-255,66,31656,90,293101
25274,0.000422,74.125.24.0-255,7156,38812,90,293101
25275,0.000425,172.31.47.0-255,66,38878,90,293101
25276,0.000429,74.125.24.0-255,2902,41780,90,293101
25277,0.00043,172.31.47.0-255,66,41846,90,293101
25278,0.000459,74.125.24.0-255,6797,48643,90,293101
25279,0.000463,172.31.47.0-255,66,48709,90,293101
25280,0.001165,74.125.24.0-255,1484,50193,90,293101
25281,0.00117,172.31.47.0-255,66,50259,90,293101
25282,0.001178,74.125.24.0-255,2902,53161,90,293101
25283,0.00118,172.31.47.0-255,66,53227,90,293101
25284,0.001183,74.125.24.0-255,1484,54711,90,293101
25285,0.001218,74.125.24.0-255,4320,59031,90,293101
25286,0.00122,172.31.47.0-255,66,59097,90,293101
25287,0.001226,74.125.24.0-255,5738,64835,90,293101
25288,0.001227,172.31.47.0-255,66,64901,90,293101
25289,0.00123,74.125.24.0-255,1484,66385,90,293101
25290,0.001267,172.31.47.0-255,66,66451,90,293101
25291,0.001272,74.125.24.0-255,4541,70992,90,293101
25292,0.001273,172.31.47.0-255,66,71058,90,293101
25293,0.00132,172.31.47.0-255,66,71124,90,293101
25294,0.001346,74.125.24.0-255,5379,76503,90,293101
25295,0.001348,172.31.47.0-255,66,76569,90,293101
25296,0.002192,74.125.24.0-255,1484,78053,90,293101
25297,0.002216,74.125.24.0-255,2902,80955,90,293101
25298,0.00222,172.31.47.0-255,66,81021,90,293101
25299,0.002225,74.125.24.0-255,5738,86759,90,293101
25300,0.002227,172.31.47.0-255,66,86825,90,293101
25301,0.002268,74.125.24.0-255,4320,91145,90,293101
25302,0.00227,172.31.47.0-255,66,91211,90,293101
25303,0.002292,74.125.24.0-255,8574,99785,90,293101
25304,0.002294,172.31.47.0-255,66,99851,90,293101
25305,0.002342,74.125.24.0-255,10692,110543,90,293101
25306,0.002344,172.31.47.0-255,66,110609,90,293101
25307,0.002471,74.125.24.0-255,1484,112093,90,293101
25308,0.002485,74.125.24.0-255,2902,114995,90,293101
25309,0.002488,172.31.47.0-255,66,115061,90,293101
25310,0.002509,74.125.24.0-255,2902,117963,90,293101
25311,0.002511,172.31.47.0-255,66,118029,90,293101
25312,0.002532,74.125.24.0-255,2902,120931,90,293101
25313,0.002534,172.31.47.0-255,66,120997,90,293101
25314,0.002559,74.125.24.0-255,5738,126735,90,293101
25315,0.002561,172.31.47.0-255,66,126801,90,293101
25316,0.002584,74.125.24.0-255,4320,131121,90,293101
25317,0.002587,172.31.47.0-255,66,131187,90,293101
25318,0.002589,74.125.24.0-255,1484,132671,90,293101
25319,0.002592,74.125.24.0-255,2902,135573,90,293101
25320,0.002594,172.31.47.0-255,66,135639,90,293101
25321,0.002598,74.125.24.0-255,4320,139959,90,293101
25322,0.0026,172.31.47.0-255,66,140025,90,293101
25323,0.002625,74.125.24.0-255,1484,141509,90,293101
25324,0.002633,74.125.24.0-255,3602,145111,90,293101
25325,0.002635,172.31.47.0-255,66,145177,90,293101
25326,0.002801,74.125.24.0-255,1484,146661,90,293101
25327,0.00282,74.125.24.0-255,2902,149563,90,293101
25328,0.002824,172.31.47.0-255,66,149629,90,293101
25329,0.002851,74.125.24.0-255,4320,153949,90,293101
25330,0.002853,172.31.47.0-255,66,154015,90,293101
25331,0.002887,74.125.24.0-255,8574,162589,90,293101
25332,0.00289,172.31.47.0-255,66,162655,90,293101
25333,0.002928,74.125.24.0-255,9992,172647,90,293101
25334,0.002931,172.31.47.0-255,66,172713,90,293101
25335,0.002934,74.125.24.0-255,2902,175615,90,293101
25336,0.002937,172.31.47.0-255,66,175681,90,293101
25337,0.002976,74.125.24.0-255,3602,179283,90,293101
25338,0.00298,172.31.47.0-255,66,179349,90,293101
25339,0.003561,74.125.24.0-255,1484,180833,90,293101
25340,0.003582,74.125.24.0-255,2902,183735,90,293101
25341,0.003586,172.31.47.0-255,66,183801,90,293101
25342,0.00359,74.125.24.0-255,2902,186703,90,293101
25343,0.003592,172.31.47.0-255,66,186769,90,293101
25344,0.003626,74.125.24.0-255,7156,193925,90,293101
25345,0.003629,172.31.47.0-255,66,193991,90,293101
25346,0.003634,74.125.24.0-255,4320,198311,90,293101
25347,0.003635,172.31.47.0-255,66,198377,90,293101
25348,0.003667,74.125.24.0-255,9992,208369,90,293101
25349,0.003669,172.31.47.0-255,66,208435,90,293101
25350,0.003673,74.125.24.0-255,2902,211337,90,293101
25351,0.003674,172.31.47.0-255,66,211403,90,293101
25352,0.003692,74.125.24.0-255,2184,213587,90,293101
25353,0.003694,172.31.47.0-255,66,213653,90,293101
25354,0.003879,74.125.24.0-255,1484,215137,90,293101
25355,0.003899,74.125.24.0-255,2902,218039,90,293101
25356,0.003901,172.31.47.0-255,66,218105,90,293101
25357,0.003906,74.125.24.0-255,2902,221007,90,293101
25358,0.003907,172.31.47.0-255,66,221073,90,293101
25359,0.003927,74.125.24.0-255,2902,223975,90,293101
25360,0.00393,172.31.47.0-255,66,224041,90,293101
25361,0.003987,172.31.47.0-255,66,224107,90,293101
25362,0.003999,172.31.47.0-255,66,224173,90,293101
25363,0.004003,74.125.24.0-255,2902,227075,90,293101
25364,0.004004,172.31.47.0-255,66,227141,90,293101
25365,0.004034,74.125.24.0-255,2902,230043,90,293101
25366,0.004037,172.31.47.0-255,66,230109,90,293101
25367,0.004042,74.125.24.0-255,5738,235847,90,293101
25368,0.004049,172.31.47.0-255,66,235913,90,293101
25369,0.004096,172.31.47.0-255,66,235979,90,293101
25370,0.0041,74.125.24.0-255,3602,239581,90,293101
25371,0.004102,172.31.47.0-255,66,239647,90,293101
25372,0.004367,74.125.24.0-255,1484,241131,90,293101
25373,0.004372,74.125.24.0-255,2902,244033,90,293101
25374,0.004399,172.31.47.0-255,66,244099,90,293101
25375,0.004412,74.125.24.0-255,5738,249837,90,293101
25376,0.004414,172.31.47.0-255,66,249903,90,293101
25377,0.00442,74.125.24.0-255,5738,255641,90,293101
25378,0.004428,172.31.47.0-255,66,255707,90,293101
25379,0.004475,172.31.47.0-255,66,255773,90,293101
25380,0.00448,74.125.24.0-255,5020,260793,90,293101
25381,0.004482,172.31.47.0-255,66,260859,90,293101
25382,0.004507,74.125.24.0-255,4320,265179,90,293101
25383,0.00451,172.31.47.0-255,66,265245,90,293101
25384,0.004548,172.31.47.0-255,66,265311,90,293101
25385,0.00455,74.125.24.0-255,1484,266795,90,293101
25386,0.004553,74.125.24.0-255,1484,268279,90,293101
25387,0.004554,172.31.47.0-255,66,268345,90,293101
25388,0.004573,74.125.24.0-255,8574,276919,90,293101
25389,0.004579,172.31.47.0-255,66,276985,90,293101
25390,0.004608,172.31.47.0-255,66,277051,90,293101
25391,0.004611,74.125.24.0-255,4320,281371,90,293101
25392,0.004613,172.31.47.0-255,66,281437,90,293101
25393,0.004624,172.31.47.0-255,66,281503,90,293101
25394,0.004658,74.125.24.0-255,6438,287941,90,293101
25395,0.004661,172.31.47.0-255,66,288007,90,293101
25396,0.004666,74.125.24.0-255,4686,292693,90,293101
25397,0.004667,172.31.47.0-255,66,292759,90,293101
25398,0.004683,74.125.24.0-255,105,292864,90,293101
25399,0.00542,172.31.47.0-255,66,292930,90,293101
25400,0.00545,172.31.47.0-255,105,293035,90,293101
25401,0.00771,74.125.24.0-255,66,293101,90,293101
25402,0.0,172.31.47.0-255,105,105,90,210
25403,0.001482,157.240.13.0-255,105,210,90,210
25404,0.0,74.125.24.0-255,155,155,90,261709
25405,3e-05,172.31.47.0-255,66,221,90,261709
25406,3.7e-05,74.125.24.0-255,1484,1705,90,261709
25407,4e-05,172.31.47.0-255,66,1771,90,261709
25408,4.5e-05,74.125.24.0-255,2902,4673,90,261709
25409,4.7e-05,172.31.47.0-255,66,4739,90,261709
25410,7.3e-05,74.125.24.0-255,7156,11895,90,261709
25411,7.6e-05,172.31.47.0-255,66,11961,90,261709
25412,0.000111,74.125.24.0-255,3520,15481,90,261709
25413,0.000114,172.31.47.0-255,66,15547,90,261709
25414,0.000135,74.125.24.0-255,4320,19867,90,261709
25415,0.000138,172.31.47.0-255,66,19933,90,261709
25416,0.00014,74.125.24.0-255,1484,21417,90,261709
25417,0.000142,172.31.47.0-255,66,21483,90,261709
25418,0.00017,74.125.24.0-255,8574,30057,90,261709
25419,0.000172,172.31.47.0-255,66,30123,90,261709
25420,0.000177,74.125.24.0-255,4320,34443,90,261709
25421,0.00018,172.31.47.0-255,66,34509,90,261709
25422,0.000211,74.125.24.0-255,2902,37411,90,261709
25423,0.000214,172.31.47.0-255,66,37477,90,261709
25424,0.00025,74.125.24.0-255,10692,48169,90,261709
25425,0.000253,172.31.47.0-255,66,48235,90,261709
25426,0.000283,74.125.24.0-255,1484,49719,90,261709
25427,0.000285,172.31.47.0-255,66,49785,90,261709
25428,0.000314,74.125.24.0-255,2902,52687,90,261709
25429,0.000316,172.31.47.0-255,66,52753,90,261709
25430,0.000323,74.125.24.0-255,5738,58491,90,261709
25431,0.000324,172.31.47.0-255,66,58557,90,261709
25432,0.000373,74.125.24.0-255,4320,62877,90,261709
25433,0.000376,172.31.47.0-255,66,62943,90,261709
25434,0.000388,74.125.24.0-255,3132,66075,90,261709
25435,0.000394,172.31.47.0-255,66,66141,90,261709
25436,0.000467,74.125.24.0-255,1484,67625,90,261709
25437,0.000472,74.125.24.0-255,1484,69109,90,261709
25438,0.000474,172.31.47.0-255,66,69175,90,261709
25439,0.000499,74.125.24.0-255,1484,70659,90,261709
25440,0.000504,74.125.24.0-255,5738,76397,90,261709
25441,0.000506,172.31.47.0-255,66,76463,90,261709
25442,0.000513,74.125.24.0-255,6797,83260,90,261709
25443,0.000515,172.31.47.0-255,66,83326,90,261709
25444,0.000582,74.125.24.0-255,1484,84810,90,261709
25445,0.000586,74.125.24.0-255,2902,87712,90,261709
25446,0.000588,172.31.47.0-255,66,87778,90,261709
25447,0.000617,74.125.24.0-255,5738,93516,90,261709
25448,0.00062,74.125.24.0-255,4320,97836,90,261709
25449,0.000621,172.31.47.0-255,66,97902,90,261709
25450,0.000624,172.31.47.0-255,66,97968,90,261709
25451,0.000666,74.125.24.0-255,2543,100511,90,261709
25452,0.000669,172.31.47.0-255,66,100577,90,261709
25453,0.000965,74.125.24.0-255,1484,102061,90,261709
25454,0.000972,74.125.24.0-255,1484,103545,90,261709
25455,0.000975,172.31.47.0-255,66,103611,90,261709
25456,0.000997,74.125.24.0-255,1484,105095,90,261709
25457,0.001,74.125.24.0-255,1484,106579,90,261709
25458,0.001002,172.31.47.0-255,66,106645,90,261709
25459,0.001005,74.125.24.0-255,2902,109547,90,261709
25460,0.001007,172.31.47.0-255,66,109613,90,261709
25461,0.001026,74.125.24.0-255,5738,115351,90,261709
25462,0.001029,172.31.47.0-255,66,115417,90,261709
25463,0.001044,74.125.24.0-255,1484,116901,90,261709
25464,0.001065,74.125.24.0-255,7156,124057,90,261709
25465,0.001068,172.31.47.0-255,66,124123,90,261709
25466,0.001099,74.125.24.0-255,2902,127025,90,261709
25467,0.001102,172.31.47.0-255,66,127091,90,261709
25468,0.001128,74.125.24.0-255,7856,134947,90,261709
25469,0.001131,172.31.47.0-255,66,135013,90,261709
25470,0.001289,74.125.24.0-255,1484,136497,90,261709
25471,0.001294,74.125.24.0-255,2902,139399,90,261709
25472,0.001298,172.31.47.0-255,66,139465,90,261709
25473,0.00132,74.125.24.0-255,5738,145203,90,261709
25474,0.001323,172.31.47.0-255,66,145269,90,261709
25475,0.001353,74.125.24.0-255,1484,146753,90,261709
25476,0.001379,74.125.24.0-255,8574,155327,90,261709
25477,0.001381,172.31.47.0-255,66,155393,90,261709
25478,0.001428,74.125.24.0-255,9992,165385,90,261709
25479,0.001431,172.31.47.0-255,66,165451,90,261709
25480,0.001455,74.125.24.0-255,1484,166935,90,261709
25481,0.00146,74.125.24.0-255,2184,169119,90,261709
25482,0.001463,172.31.47.0-255,66,169185,90,261709
25483,0.001486,172.31.47.0-255,66,169251,90,261709
25484,0.001491,74.125.24.0-255,4320,173571,90,261709
25485,0.001493,172.31.47.0-255,66,173637,90,261709
25486,0.00153,172.31.47.0-255,66,173703,90,261709
25487,0.001553,74.125.24.0-255,2902,176605,90,261709
25488,0.001555,172.31.47.0-255,66,176671,90,261709
25489,0.00158,74.125.24.0-255,8574,185245,90,261709
25490,0.001582,172.31.47.0-255,66,185311,90,261709
25491,0.001594,172.31.47.0-255,66,185377,90,261709
25492,0.001612,74.125.24.0-255,4320,189697,90,261709
25493,0.001613,172.31.47.0-255,66,189763,90,261709
25494,0.00164,74.125.24.0-255,5020,194783,90,261709
25495,0.001642,172.31.47.0-255,66,194849,90,261709
25496,0.001661,74.125.24.0-255,1484,196333,90,261709
25497,0.001665,74.125.24.0-255,2902,199235,90,261709
25498,0.001667,172.31.47.0-255,66,199301,90,261709
25499,0.001672,74.125.24.0-255,5738,205039,90,261709
25500,0.001673,172.31.47.0-255,66,205105,90,261709
25501,0.001696,74.125.24.0-255,4320,209425,90,261709
25502,0.001698,172.31.47.0-255,66,209491,90,261709
25503,0.001732,74.125.24.0-255,8574,218065,90,261709
25504,0.001734,172.31.47.0-255,66,218131,90,261709
25505,0.00174,74.125.24.0-255,7156,225287,90,261709
25506,0.001742,172.31.47.0-255,66,225353,90,261709
25507,0.001772,172.31.47.0-255,66,225419,90,261709
25508,0.001804,74.125.24.0-255,3602,229021,90,261709
25509,0.001807,172.31.47.0-255,66,229087,90,261709
25510,0.001814,74.125.24.0-255,9992,239079,90,261709
25511,0.001815,172.31.47.0-255,66,239145,90,261709
25512,0.00182,74.125.24.0-255,5020,244165,90,261709
25513,0.001821,172.31.47.0-255,66,244231,90,261709
25514,0.004151,74.125.24.0-255,5738,249969,90,261709
25515,0.004156,172.31.47.0-255,66,250035,90,261709
25516,0.006469,74.125.24.0-255,5738,255773,90,261709
25517,0.006482,172.31.47.0-255,66,255839,90,261709
25518,0.008801,74.125.24.0-255,4320,260159,90,261709
25519,0.008807,172.31.47.0-255,66,260225,90,261709
25520,0.008819,74.125.24.0-255,1484,261709,90,261709
25521,0.0,172.217.194.0-255,143,143,90,183212
25522,1.6e-05,172.31.47.0-255,66,209,90,183212
25523,2.3e-05,172.217.194.0-255,1484,1693,90,183212
25524,2.8e-05,172.31.47.0-255,66,1759,90,183212
25525,3.3e-05,172.217.194.0-255,2902,4661,90,183212
25526,3.5e-05,172.31.47.0-255,66,4727,90,183212
25527,8.6e-05,172.217.194.0-255,4320,9047,90,183212
25528,8.9e-05,172.31.47.0-255,66,9113,90,183212
25529,0.000104,172.217.194.0-255,1484,10597,90,183212
25530,0.000106,172.31.47.0-255,66,10663,90,183212
25531,0.000111,172.217.194.0-255,3464,14127,90,183212
25532,0.000113,172.31.47.0-255,66,14193,90,183212
25533,0.000127,172.217.194.0-255,2902,17095,90,183212
25534,0.000129,172.31.47.0-255,66,17161,90,183212
25535,0.000161,172.217.194.0-255,8574,25735,90,183212
25536,0.000164,172.31.47.0-255,66,25801,90,183212
25537,0.000169,172.217.194.0-255,5379,31180,90,183212
25538,0.000171,172.31.47.0-255,66,31246,90,183212
25539,0.000583,172.217.194.0-255,1484,32730,90,183212
25540,0.000589,172.31.47.0-255,66,32796,90,183212
25541,0.000596,172.217.194.0-255,2902,35698,90,183212
25542,0.000598,172.31.47.0-255,66,35764,90,183212
25543,0.00062,172.217.194.0-255,1484,37248,90,183212
25544,0.000623,172.31.47.0-255,66,37314,90,183212
25545,0.000645,172.217.194.0-255,4320,41634,90,183212
25546,0.000648,172.31.47.0-255,66,41700,90,183212
25547,0.000668,172.217.194.0-255,2902,44602,90,183212
25548,0.000671,172.31.47.0-255,66,44668,90,183212
25549,0.000699,172.217.194.0-255,9992,54660,90,183212
25550,0.000702,172.31.47.0-255,66,54726,90,183212
25551,0.000709,172.217.194.0-255,7156,61882,90,183212
25552,0.000711,172.31.47.0-255,66,61948,90,183212
25553,0.000736,172.217.194.0-255,3602,65550,90,183212
25554,0.000738,172.31.47.0-255,66,65616,90,183212
25555,0.000894,172.217.194.0-255,377,65993,90,183212
25556,0.000958,172.217.194.0-255,365,66358,90,183212
25557,0.001005,172.217.194.0-255,1484,67842,90,183212
25558,0.001009,172.31.47.0-255,66,67908,90,183212
25559,0.001027,172.217.194.0-255,2902,70810,90,183212
25560,0.001029,172.31.47.0-255,66,70876,90,183212
25561,0.001045,172.217.194.0-255,1484,72360,90,183212
25562,0.001066,172.217.194.0-255,7156,79516,90,183212
25563,0.001068,172.31.47.0-255,66,79582,90,183212
25564,0.001073,172.217.194.0-255,4320,83902,90,183212
25565,0.001074,172.31.47.0-255,66,83968,90,183212
25566,0.001091,172.217.194.0-255,7156,91124,90,183212
25567,0.001093,172.31.47.0-255,66,91190,90,183212
25568,0.001132,172.217.194.0-255,2902,94092,90,183212
25569,0.001135,172.31.47.0-255,66,94158,90,183212
25570,0.001151,172.217.194.0-255,6438,100596,90,183212
25571,0.001154,172.31.47.0-255,66,100662,90,183212
25572,0.001966,172.217.194.0-255,1484,102146,90,183212
25573,0.001988,172.217.194.0-255,2902,105048,90,183212
25574,0.001991,172.31.47.0-255,66,105114,90,183212
25575,0.001994,172.217.194.0-255,1484,106598,90,183212
25576,0.002012,172.217.194.0-255,4320,110918,90,183212
25577,0.002014,172.31.47.0-255,66,110984,90,183212
25578,0.00204,172.217.194.0-255,5738,116722,90,183212
25579,0.002042,172.31.47.0-255,66,116788,90,183212
25580,0.002066,172.217.194.0-255,7156,123944,90,183212
25581,0.002068,172.31.47.0-255,66,124010,90,183212
25582,0.002074,172.217.194.0-255,7156,131166,90,183212
25583,0.002076,172.31.47.0-255,66,131232,90,183212
25584,0.002088,172.217.194.0-255,2902,134134,90,183212
25585,0.002089,172.31.47.0-255,66,134200,90,183212
25586,0.002091,172.217.194.0-255,766,134966,90,183212
25587,0.002157,172.217.194.0-255,1484,136450,90,183212
25588,0.00216,172.31.47.0-255,66,136516,90,183212
25589,0.002171,172.217.194.0-255,2902,139418,90,183212
25590,0.002173,172.31.47.0-255,66,139484,90,183212
25591,0.002207,172.217.194.0-255,4320,143804,90,183212
25592,0.002209,172.31.47.0-255,66,143870,90,183212
25593,0.002225,172.217.194.0-255,1484,145354,90,183212
25594,0.002232,172.217.194.0-255,7156,152510,90,183212
25595,0.002233,172.31.47.0-255,66,152576,90,183212
25596,0.002259,172.217.194.0-255,7156,159732,90,183212
25597,0.002262,172.31.47.0-255,66,159798,90,183212
25598,0.002274,172.217.194.0-255,1484,161282,90,183212
25599,0.002286,172.217.194.0-255,1484,162766,90,183212
25600,0.002287,172.31.47.0-255,66,162832,90,183212
25601,0.002306,172.217.194.0-255,2902,165734,90,183212
25602,0.002308,172.31.47.0-255,66,165800,90,183212
25603,0.004573,172.217.194.0-255,5738,171538,90,183212
25604,0.004578,172.31.47.0-255,66,171604,90,183212
25605,0.006872,172.217.194.0-255,5738,177342,90,183212
25606,0.00688,172.31.47.0-255,66,177408,90,183212
25607,0.009132,172.217.194.0-255,5738,183146,90,183212
25608,0.009141,172.31.47.0-255,66,183212,90,183212
25609,0.0,172.31.47.0-255,105,105,90,105
25610,0.0,74.125.200.0-255,153,153,90,350269
25611,2.5e-05,172.31.47.0-255,66,219,90,350269
25612,3.2e-05,74.125.200.0-255,1484,1703,90,350269
25613,3.6e-05,172.31.47.0-255,66,1769,90,350269
25614,4.1e-05,74.125.200.0-255,2902,4671,90,350269
25615,4.3e-05,172.31.47.0-255,66,4737,90,350269
25616,6.1e-05,74.125.200.0-255,4320,9057,90,350269
25617,6.3e-05,172.31.47.0-255,66,9123,90,350269
25618,8.5e-05,74.125.200.0-255,4933,14056,90,350269
25619,8.7e-05,172.31.47.0-255,66,14122,90,350269
25620,0.000105,74.125.200.0-255,5738,19860,90,350269
25621,0.000107,172.31.47.0-255,66,19926,90,350269
25622,0.000132,74.125.200.0-255,5738,25664,90,350269
25623,0.000134,172.31.47.0-255,66,25730,90,350269
25624,0.000162,74.125.200.0-255,5379,31109,90,350269
25625,0.000164,172.31.47.0-255,66,31175,90,350269
25626,0.000223,74.125.200.0-255,1484,32659,90,350269
25627,0.000225,172.31.47.0-255,66,32725,90,350269
25628,0.00023,74.125.200.0-255,2902,35627,90,350269
25629,0.000233,172.31.47.0-255,66,35693,90,350269
25630,0.000262,74.125.200.0-255,5738,41431,90,350269
25631,0.000265,172.31.47.0-255,66,41497,90,350269
25632,0.000268,74.125.200.0-255,1484,42981,90,350269
25633,0.000269,172.31.47.0-255,66,43047,90,350269
25634,0.000281,74.125.200.0-255,1484,44531,90,350269
25635,0.000283,172.31.47.0-255,66,44597,90,350269
25636,0.000296,74.125.200.0-255,1484,46081,90,350269
25637,0.000298,172.31.47.0-255,66,46147,90,350269
25638,0.000305,74.125.200.0-255,6797,52944,90,350269
25639,0.000307,172.31.47.0-255,66,53010,90,350269
25640,0.000311,74.125.200.0-255,4320,57330,90,350269
25641,0.000313,172.31.47.0-255,66,57396,90,350269
25642,0.000342,74.125.200.0-255,5738,63134,90,350269
25643,0.000351,172.31.47.0-255,66,63200,90,350269
25644,0.000355,74.125.200.0-255,2819,66019,90,350269
25645,0.000367,172.31.47.0-255,66,66085,90,350269
25646,0.000395,74.125.200.0-255,411,66496,90,350269
25647,0.000492,74.125.200.0-255,1484,67980,90,350269
25648,0.000496,172.31.47.0-255,66,68046,90,350269
25649,0.000506,74.125.200.0-255,1484,69530,90,350269
25650,0.00052,74.125.200.0-255,2902,72432,90,350269
25651,0.00053,172.31.47.0-255,66,72498,90,350269
25652,0.000538,74.125.200.0-255,5738,78236,90,350269
25653,0.000546,172.31.47.0-255,66,78302,90,350269
25654,0.000574,74.125.200.0-255,7156,85458,90,350269
25655,0.000582,172.31.47.0-255,66,85524,90,350269
25656,0.000586,74.125.200.0-255,4320,89844,90,350269
25657,0.000594,172.31.47.0-255,66,89910,90,350269
25658,0.000598,74.125.200.0-255,1484,91394,90,350269
25659,0.000618,74.125.200.0-255,1484,92878,90,350269
25660,0.000626,172.31.47.0-255,66,92944,90,350269
25661,0.000641,74.125.200.0-255,7856,100800,90,350269
25662,0.000643,172.31.47.0-255,66,100866,90,350269
25663,0.000725,74.125.200.0-255,1484,102350,90,350269
25664,0.00074,74.125.200.0-255,1484,103834,90,350269
25665,0.000743,74.125.200.0-255,1484,105318,90,350269
25666,0.000748,172.31.47.0-255,66,105384,90,350269
25667,0.000755,74.125.200.0-255,1484,106868,90,350269
25668,0.000769,74.125.200.0-255,5738,112606,90,350269
25669,0.000781,172.31.47.0-255,66,112672,90,350269
25670,0.000804,74.125.200.0-255,7156,119828,90,350269
25671,0.000809,172.31.47.0-255,66,119894,90,350269
25672,0.000811,74.125.200.0-255,5738,125632,90,350269
25673,0.000815,172.31.47.0-255,66,125698,90,350269
25674,0.000833,74.125.200.0-255,2902,128600,90,350269
25675,0.000841,74.125.200.0-255,6438,135038,90,350269
25676,0.000848,172.31.47.0-255,66,135104,90,350269
25677,0.000925,74.125.200.0-255,1484,136588,90,350269
25678,0.000942,74.125.200.0-255,2902,139490,90,350269
25679,0.000952,172.31.47.0-255,66,139556,90,350269
25680,0.000954,74.125.200.0-255,1484,141040,90,350269
25681,0.000971,74.125.200.0-255,4320,145360,90,350269
25682,0.000978,172.31.47.0-255,66,145426,90,350269
25683,0.000999,74.125.200.0-255,5738,151164,90,350269
25684,0.001003,172.31.47.0-255,66,151230,90,350269
25685,0.001018,74.125.200.0-255,7156,158386,90,350269
25686,0.001022,172.31.47.0-255,66,158452,90,350269
25687,0.001069,74.125.200.0-255,4320,162772,90,350269
25688,0.001074,172.31.47.0-255,66,162838,90,350269
25689,0.001121,74.125.200.0-255,5738,168576,90,350269
25690,0.001127,172.31.47.0-255,66,168642,90,350269
25691,0.001145,74.125.200.0-255,766,169408,90,350269
25692,0.001153,74.125.200.0-255,8574,177982,90,350269
25693,0.001162,74.125.200.0-255,9992,187974,90,350269
25694,0.001168,172.31.47.0-255,66,188040,90,350269
25695,0.001177,74.125.200.0-255,766,188806,90,350269
25696,0.001183,172.31.47.0-255,66,188872,90,350269
25697,0.001264,74.125.200.0-255,1484,190356,90,350269
25698,0.001268,74.125.200.0-255,1484,191840,90,350269
25699,0.001271,172.31.47.0-255,66,191906,90,350269
25700,0.001285,74.125.200.0-255,1484,193390,90,350269
25701,0.00129,74.125.200.0-255,2902,196292,90,350269
25702,0.001295,172.31.47.0-255,66,196358,90,350269
25703,0.001308,74.125.200.0-255,1484,197842,90,350269
25704,0.001314,74.125.200.0-255,5738,203580,90,350269
25705,0.001322,172.31.47.0-255,66,203646,90,350269
25706,0.001355,74.125.200.0-255,4320,207966,90,350269
25707,0.001357,172.31.47.0-255,66,208032,90,350269
25708,0.001362,172.31.47.0-255,66,208098,90,350269
25709,0.001405,74.125.200.0-255,3602,211700,90,350269
25710,0.001408,172.31.47.0-255,66,211766,90,350269
25711,0.001495,74.125.200.0-255,1484,213250,90,350269
25712,0.001498,74.125.200.0-255,1484,214734,90,350269
25713,0.001506,172.31.47.0-255,66,214800,90,350269
25714,0.001515,74.125.200.0-255,1484,216284,90,350269
25715,0.001519,74.125.200.0-255,2902,219186,90,350269
25716,0.001522,172.31.47.0-255,66,219252,90,350269
25717,0.001535,74.125.200.0-255,2902,222154,90,350269
25718,0.00154,172.31.47.0-255,66,222220,90,350269
25719,0.001554,74.125.200.0-255,4320,226540,90,350269
25720,0.001571,172.31.47.0-255,66,226606,90,350269
25721,0.001575,74.125.200.0-255,7156,233762,90,350269
25722,0.001586,172.31.47.0-255,66,233828,90,350269
25723,0.00159,74.125.200.0-255,2902,236730,90,350269
25724,0.001592,172.31.47.0-255,66,236796,90,350269
25725,0.001613,74.125.200.0-255,9274,246070,90,350269
25726,0.001617,172.31.47.0-255,66,246136,90,350269
25727,0.001674,74.125.200.0-255,1484,247620,90,350269
25728,0.001679,74.125.200.0-255,2902,250522,90,350269
25729,0.001682,74.125.200.0-255,1484,252006,90,350269
25730,0.00169,172.31.47.0-255,66,252072,90,350269
25731,0.0017,74.125.200.0-255,4320,256392,90,350269
25732,0.001704,74.125.200.0-255,2902,259294,90,350269
25733,0.001705,172.31.47.0-255,66,259360,90,350269
25734,0.001711,172.31.47.0-255,66,259426,90,350269
25735,0.001726,74.125.200.0-255,1484,260910,90,350269
25736,0.001741,74.125.200.0-255,5738,266648,90,350269
25737,0.001752,172.31.47.0-255,66,266714,90,350269
25738,0.001764,74.125.200.0-255,2902,269616,90,350269
25739,0.001769,172.31.47.0-255,66,269682,90,350269
25740,0.001774,74.125.200.0-255,10692,280374,90,350269
25741,0.001791,172.31.47.0-255,66,280440,90,350269
25742,0.001805,74.125.200.0-255,7156,287596,90,350269
25743,0.001816,172.31.47.0-255,66,287662,90,350269
25744,0.001822,74.125.200.0-255,4320,291982,90,350269
25745,0.001828,172.31.47.0-255,66,292048,90,350269
25746,0.001837,74.125.200.0-255,1484,293532,90,350269
25747,0.001869,74.125.200.0-255,4320,297852,90,350269
25748,0.001869,172.31.47.0-255,66,297918,90,350269
25749,0.001874,172.31.47.0-255,66,297984,90,350269
25750,0.00191,74.125.200.0-255,7156,305140,90,350269
25751,0.001916,172.31.47.0-255,66,305206,90,350269
25752,0.001935,74.125.200.0-255,6438,311644,90,350269
25753,0.00194,172.31.47.0-255,66,311710,90,350269
25754,0.001968,74.125.200.0-255,2902,314612,90,350269
25755,0.001972,172.31.47.0-255,66,314678,90,350269
25756,0.001995,74.125.200.0-255,8574,323252,90,350269
25757,0.001998,172.31.47.0-255,66,323318,90,350269
25758,0.002002,74.125.200.0-255,9274,332592,90,350269
25759,0.002006,74.125.200.0-255,2902,335494,90,350269
25760,0.002011,172.31.47.0-255,66,335560,90,350269
25761,0.002042,74.125.200.0-255,2902,338462,90,350269
25762,0.002054,172.31.47.0-255,66,338528,90,350269
25763,0.002066,74.125.200.0-255,5738,344266,90,350269
25764,0.002066,172.31.47.0-255,66,344332,90,350269
25765,0.00207,172.31.47.0-255,66,344398,90,350269
25766,0.002076,74.125.200.0-255,3602,348000,90,350269
25767,0.00208,172.31.47.0-255,66,348066,90,350269
25768,0.002118,74.125.200.0-255,2032,350098,90,350269
25769,0.00213,172.31.47.0-255,66,350164,90,350269
25770,0.002174,74.125.200.0-255,105,350269,90,350269
25771,0.0,172.217.194.0-255,153,153,90,157768
25772,2.2e-05,172.31.47.0-255,66,219,90,157768
25773,2.8e-05,172.217.194.0-255,1484,1703,90,157768
25774,3.3e-05,172.31.47.0-255,66,1769,90,157768
25775,3.8e-05,172.217.194.0-255,2902,4671,90,157768
25776,4.1e-05,172.31.47.0-255,66,4737,90,157768
25777,5e-05,172.217.194.0-255,7156,11893,90,157768
25778,5.3e-05,172.31.47.0-255,66,11959,90,157768
25779,7.7e-05,172.217.194.0-255,2147,14106,90,157768
25780,8e-05,172.31.47.0-255,66,14172,90,157768
25781,0.000114,172.217.194.0-255,2902,17074,90,157768
25782,0.000118,172.31.47.0-255,66,17140,90,157768
25783,0.00014,172.217.194.0-255,4320,21460,90,157768
25784,0.000142,172.31.47.0-255,66,21526,90,157768
25785,0.000162,172.217.194.0-255,1484,23010,90,157768
25786,0.000164,172.31.47.0-255,66,23076,90,157768
25787,0.000182,172.217.194.0-255,7156,30232,90,157768
25788,0.000185,172.31.47.0-255,66,30298,90,157768
25789,0.000206,172.217.194.0-255,1125,31423,90,157768
25790,0.000208,172.31.47.0-255,66,31489,90,157768
25791,0.000279,172.217.194.0-255,1484,32973,90,157768
25792,0.000283,172.31.47.0-255,66,33039,90,157768
25793,0.000288,172.217.194.0-255,2902,35941,90,157768
25794,0.00029,172.31.47.0-255,66,36007,90,157768
25795,0.000295,172.217.194.0-255,2902,38909,90,157768
25796,0.000298,172.31.47.0-255,66,38975,90,157768
25797,0.000313,172.217.194.0-255,2902,41877,90,157768
25798,0.000316,172.31.47.0-255,66,41943,90,157768
25799,0.000345,172.217.194.0-255,4320,46263,90,157768
25800,0.000348,172.31.47.0-255,66,46329,90,157768
25801,0.000367,172.217.194.0-255,2543,48872,90,157768
25802,0.00037,172.31.47.0-255,66,48938,90,157768
25803,0.000814,172.217.194.0-255,1484,50422,90,157768
25804,0.000823,172.217.194.0-255,2902,53324,90,157768
25805,0.000826,172.31.47.0-255,66,53390,90,157768
25806,0.000833,172.217.194.0-255,4320,57710,90,157768
25807,0.000835,172.31.47.0-255,66,57776,90,157768
25808,0.000849,172.217.194.0-255,1484,59260,90,157768
25809,0.000857,172.217.194.0-255,6797,66057,90,157768
25810,0.000859,172.31.47.0-255,66,66123,90,157768
25811,0.000893,172.217.194.0-255,646,66769,90,157768
25812,0.001069,172.31.47.0-255,66,66835,90,157768
25813,0.001091,172.217.194.0-255,1484,68319,90,157768
25814,0.001096,172.217.194.0-255,2902,71221,90,157768
25815,0.001104,172.31.47.0-255,66,71287,90,157768
25816,0.001112,172.217.194.0-255,5738,77025,90,157768
25817,0.001114,172.31.47.0-255,66,77091,90,157768
25818,0.001135,172.217.194.0-255,1484,78575,90,157768
25819,0.00116,172.31.47.0-255,66,78641,90,157768
25820,0.001164,172.217.194.0-255,1484,80125,90,157768
25821,0.001205,172.217.194.0-255,9992,90117,90,157768
25822,0.001207,172.31.47.0-255,66,90183,90,157768
25823,0.001224,172.217.194.0-255,766,90949,90,157768
25824,0.001229,172.217.194.0-255,2902,93851,90,157768
25825,0.001231,172.31.47.0-255,66,93917,90,157768
25826,0.00126,172.217.194.0-255,8574,102491,90,157768
25827,0.001263,172.31.47.0-255,66,102557,90,157768
25828,0.001268,172.217.194.0-255,3429,105986,90,157768
25829,0.001271,172.31.47.0-255,66,106052,90,157768
25830,0.001636,172.217.194.0-255,1484,107536,90,157768
25831,0.001642,172.217.194.0-255,2902,110438,90,157768
25832,0.001645,172.31.47.0-255,66,110504,90,157768
25833,0.001652,172.217.194.0-255,4320,114824,90,157768
25834,0.001654,172.31.47.0-255,66,114890,90,157768
25835,0.001669,172.217.194.0-255,1484,116374,90,157768
25836,0.001677,172.217.194.0-255,5738,122112,90,157768
25837,0.001679,172.31.47.0-255,66,122178,90,157768
25838,0.001699,172.217.194.0-255,7156,129334,90,157768
25839,0.001701,172.31.47.0-255,66,129400,90,157768
25840,0.001709,172.217.194.0-255,7156,136556,90,157768
25841,0.001711,172.31.47.0-255,66,136622,90,157768
25842,0.001727,172.217.194.0-255,3602,140224,90,157768
25843,0.00173,172.31.47.0-255,66,140290,90,157768
25844,0.003996,172.217.194.0-255,1484,141774,90,157768
25845,0.004018,172.217.194.0-255,4320,146094,90,157768
25846,0.004022,172.31.47.0-255,66,146160,90,157768
25847,0.00629,172.217.194.0-255,5738,151898,90,157768
25848,0.006297,172.31.47.0-255,66,151964,90,157768
25849,0.00862,172.217.194.0-255,5738,157702,90,157768
25850,0.008628,172.31.47.0-255,66,157768,90,157768
25851,0.0,172.217.194.0-255,143,143,90,181630
25852,2.8e-05,172.31.47.0-255,66,209,90,181630
25853,3.4e-05,172.217.194.0-255,1484,1693,90,181630
25854,3.8e-05,172.31.47.0-255,66,1759,90,181630
25855,4.2e-05,172.217.194.0-255,2902,4661,90,181630
25856,4.6e-05,172.31.47.0-255,66,4727,90,181630
25857,5.2e-05,172.217.194.0-255,4320,9047,90,181630
25858,5.4e-05,172.31.47.0-255,66,9113,90,181630
25859,0.000102,172.217.194.0-255,4881,13994,90,181630
25860,0.000105,172.31.47.0-255,66,14060,90,181630
25861,0.00015,172.217.194.0-255,1484,15544,90,181630
25862,0.000153,172.31.47.0-255,66,15610,90,181630
25863,0.000167,172.217.194.0-255,2902,18512,90,181630
25864,0.000169,172.31.47.0-255,66,18578,90,181630
25865,0.000174,172.217.194.0-255,2902,21480,90,181630
25866,0.000176,172.31.47.0-255,66,21546,90,181630
25867,0.000195,172.217.194.0-255,2902,24448,90,181630
25868,0.000198,172.31.47.0-255,66,24514,90,181630
25869,0.000203,172.217.194.0-255,4320,28834,90,181630
25870,0.000205,172.31.47.0-255,66,28900,90,181630
25871,0.000237,172.217.194.0-255,2902,31802,90,181630
25872,0.00024,172.31.47.0-255,66,31868,90,181630
25873,0.000264,172.217.194.0-255,9633,41501,90,181630
25874,0.000268,172.31.47.0-255,66,41567,90,181630
25875,0.000274,172.217.194.0-255,5738,47305,90,181630
25876,0.000277,172.31.47.0-255,66,47371,90,181630
25877,0.000331,172.31.47.0-255,66,47437,90,181630
25878,0.000334,172.217.194.0-255,645,48082,90,181630
25879,0.000337,172.31.47.0-255,66,48148,90,181630
25880,0.000515,172.217.194.0-255,1484,49632,90,181630
25881,0.000519,172.31.47.0-255,66,49698,90,181630
25882,0.000524,172.217.194.0-255,2902,52600,90,181630
25883,0.000527,172.31.47.0-255,66,52666,90,181630
25884,0.000556,172.217.194.0-255,5738,58404,90,181630
25885,0.00056,172.31.47.0-255,66,58470,90,181630
25886,0.000568,172.217.194.0-255,8574,67044,90,181630
25887,0.000571,172.31.47.0-255,66,67110,90,181630
25888,0.000594,172.217.194.0-255,4320,71430,90,181630
25889,0.000597,172.31.47.0-255,66,71496,90,181630
25890,0.0006,172.217.194.0-255,1484,72980,90,181630
25891,0.000619,172.217.194.0-255,9274,82254,90,181630
25892,0.000622,172.31.47.0-255,66,82320,90,181630
25893,0.000846,172.217.194.0-255,1484,83804,90,181630
25894,0.000863,172.217.194.0-255,2902,86706,90,181630
25895,0.000867,172.31.47.0-255,66,86772,90,181630
25896,0.000874,172.217.194.0-255,5738,92510,90,181630
25897,0.000876,172.31.47.0-255,66,92576,90,181630
25898,0.000918,172.31.47.0-255,66,92642,90,181630
25899,0.000928,172.217.194.0-255,10692,103334,90,181630
25900,0.000931,172.31.47.0-255,66,103400,90,181630
25901,0.000969,172.217.194.0-255,8574,111974,90,181630
25902,0.000972,172.31.47.0-255,66,112040,90,181630
25903,0.000977,172.217.194.0-255,2902,114942,90,181630
25904,0.000979,172.31.47.0-255,66,115008,90,181630
25905,0.000999,172.217.194.0-255,7156,122164,90,181630
25906,0.001002,172.31.47.0-255,66,122230,90,181630
25907,0.001014,172.217.194.0-255,2902,125132,90,181630
25908,0.001017,172.31.47.0-255,66,125198,90,181630
25909,0.001043,172.31.47.0-255,66,125264,90,181630
25910,0.00136,172.217.194.0-255,1484,126748,90,181630
25911,0.001363,172.217.194.0-255,1484,128232,90,181630
25912,0.001368,172.31.47.0-255,66,128298,90,181630
25913,0.001374,172.217.194.0-255,1484,129782,90,181630
25914,0.001382,172.217.194.0-255,5738,135520,90,181630
25915,0.001384,172.217.194.0-255,1484,137004,90,181630
25916,0.001385,172.31.47.0-255,66,137070,90,181630
25917,0.001403,172.217.194.0-255,1484,138554,90,181630
25918,0.001406,172.31.47.0-255,66,138620,90,181630
25919,0.001412,172.217.194.0-255,4320,142940,90,181630
25920,0.001414,172.31.47.0-255,66,143006,90,181630
25921,0.001436,172.217.194.0-255,5738,148744,90,181630
25922,0.001439,172.31.47.0-255,66,148810,90,181630
25923,0.001497,172.217.194.0-255,10692,159502,90,181630
25924,0.0015,172.31.47.0-255,66,159568,90,181630
25925,0.001982,172.217.194.0-255,1484,161052,90,181630
25926,0.003465,172.217.194.0-255,4320,165372,90,181630
25927,0.00347,172.31.47.0-255,66,165438,90,181630
25928,0.00543,172.217.194.0-255,2902,168340,90,181630
25929,0.005433,172.31.47.0-255,66,168406,90,181630
25930,0.005448,172.217.194.0-255,2902,171308,90,181630
25931,0.00545,172.31.47.0-255,66,171374,90,181630
25932,0.007386,172.217.194.0-255,4320,175694,90,181630
25933,0.007392,172.31.47.0-255,66,175760,90,181630
25934,0.007406,172.217.194.0-255,1484,177244,90,181630
25935,0.009513,172.217.194.0-255,4320,181564,90,181630
25936,0.009573,172.31.47.0-255,66,181630,90,181630
25937,0.0,74.125.24.0-255,153,153,90,112314
25938,2.5e-05,172.31.47.0-255,66,219,90,112314
25939,3.1e-05,74.125.24.0-255,1484,1703,90,112314
25940,3.6e-05,172.31.47.0-255,66,1769,90,112314
25941,4.1e-05,74.125.24.0-255,2902,4671,90,112314
25942,4.4e-05,172.31.47.0-255,66,4737,90,112314
25943,5.2e-05,74.125.24.0-255,7156,11893,90,112314
25944,5.5e-05,172.31.47.0-255,66,11959,90,112314
25945,5.9e-05,74.125.24.0-255,2109,14068,90,112314
25946,6.2e-05,172.31.47.0-255,66,14134,90,112314
25947,0.00059,74.125.24.0-255,1484,15618,90,112314
25948,0.000596,172.31.47.0-255,66,15684,90,112314
25949,0.000605,74.125.24.0-255,2902,18586,90,112314
25950,0.000607,172.31.47.0-255,66,18652,90,112314
25951,0.000613,74.125.24.0-255,4320,22972,90,112314
25952,0.000615,172.31.47.0-255,66,23038,90,112314
25953,0.000632,74.125.24.0-255,1484,24522,90,112314
25954,0.000635,172.31.47.0-255,66,24588,90,112314
25955,0.000669,74.125.24.0-255,5738,30326,90,112314
25956,0.000671,172.31.47.0-255,66,30392,90,112314
25957,0.000688,74.125.24.0-255,1125,31517,90,112314
25958,0.000692,172.31.47.0-255,66,31583,90,112314
25959,0.000719,74.125.24.0-255,4320,35903,90,112314
25960,0.000722,172.31.47.0-255,66,35969,90,112314
25961,0.000727,74.125.24.0-255,2902,38871,90,112314
25962,0.000729,172.31.47.0-255,66,38937,90,112314
25963,0.000743,74.125.24.0-255,2902,41839,90,112314
25964,0.000746,172.31.47.0-255,66,41905,90,112314
25965,0.000767,74.125.24.0-255,4320,46225,90,112314
25966,0.00077,172.31.47.0-255,66,46291,90,112314
25967,0.000788,74.125.24.0-255,2543,48834,90,112314
25968,0.00079,172.31.47.0-255,66,48900,90,112314
25969,0.001924,74.125.24.0-255,1484,50384,90,112314
25970,0.001934,74.125.24.0-255,2902,53286,90,112314
25971,0.001939,74.125.24.0-255,4320,57606,90,112314
25972,0.001955,74.125.24.0-255,1484,59090,90,112314
25973,0.001972,74.125.24.0-255,4320,63410,90,112314
25974,0.001984,74.125.24.0-255,3124,66534,90,112314
25975,0.002037,74.125.24.0-255,1484,68018,90,112314
25976,0.002051,74.125.24.0-255,2902,70920,90,112314
25977,0.002056,74.125.24.0-255,2902,73822,90,112314
25978,0.002069,74.125.24.0-255,2902,76724,90,112314
25979,0.002073,74.125.24.0-255,4320,81044,90,112314
25980,0.002122,74.125.24.0-255,2543,83587,90,112314
25981,0.002162,74.125.24.0-255,1484,85071,90,112314
25982,0.002173,74.125.24.0-255,1484,86555,90,112314
25983,0.002185,74.125.24.0-255,1484,88039,90,112314
25984,0.002188,74.125.24.0-255,1484,89523,90,112314
25985,0.002302,74.125.24.0-255,4320,93843,90,112314
25986,0.002309,74.125.24.0-255,6797,100640,90,112314
25987,0.003579,172.31.47.0-255,66,100706,90,112314
25988,0.005811,74.125.24.0-255,5738,106444,90,112314
25989,0.005818,172.31.47.0-255,66,106510,90,112314
25990,0.008054,74.125.24.0-255,5738,112248,90,112314
25991,0.008062,172.31.47.0-255,66,112314,90,112314
