,TIME,SRC,PACKET_SIZE,CUMULATIVE_PACKET_SIZE,PAGE_NUMBER,TOTAL_PACKET_SIZE
0,0.0,172.217.194.0-255,153,153,21,289467
1,1.4e-05,172.31.33.0-255,66,219,21,289467
2,2e-05,172.217.194.0-255,1484,1703,21,289467
3,2.3e-05,172.31.33.0-255,66,1769,21,289467
4,2.9e-05,172.217.194.0-255,2902,4671,21,289467
5,3.2e-05,172.31.33.0-255,66,4737,21,289467
6,3.5e-05,172.217.194.0-255,1484,6221,21,289467
7,4.3e-05,172.31.33.0-255,66,6287,21,289467
8,7.7e-05,172.217.194.0-255,5738,12025,21,289467
9,8e-05,172.31.33.0-255,66,12091,21,289467
10,8.4e-05,172.217.194.0-255,2021,14112,21,289467
11,8.5e-05,172.31.33.0-255,66,14178,21,289467
12,0.000213,172.217.194.0-255,1484,15662,21,289467
13,0.000217,172.31.33.0-255,66,15728,21,289467
14,0.000222,172.217.194.0-255,2902,18630,21,289467
15,0.000224,172.31.33.0-255,66,18696,21,289467
16,0.000228,172.217.194.0-255,2902,21598,21,289467
17,0.000234,172.31.33.0-255,66,21664,21,289467
18,0.000264,172.217.194.0-255,1484,23148,21,289467
19,0.000267,172.31.33.0-255,66,23214,21,289467
20,0.000273,172.217.194.0-255,5738,28952,21,289467
21,0.000275,172.31.33.0-255,66,29018,21,289467
22,0.000279,172.217.194.0-255,2543,31561,21,289467
23,0.000281,172.31.33.0-255,66,31627,21,289467
24,0.000424,172.217.194.0-255,1484,33111,21,289467
25,0.000429,172.31.33.0-255,66,33177,21,289467
26,0.000434,172.217.194.0-255,2902,36079,21,289467
27,0.000435,172.31.33.0-255,66,36145,21,289467
28,0.000438,172.217.194.0-255,1484,37629,21,289467
29,0.00044,172.31.33.0-255,66,37695,21,289467
30,0.000468,172.217.194.0-255,4320,42015,21,289467
31,0.000471,172.31.33.0-255,66,42081,21,289467
32,0.000474,172.217.194.0-255,1484,43565,21,289467
33,0.000507,172.31.33.0-255,66,43631,21,289467
34,0.00051,172.217.194.0-255,1484,45115,21,289467
35,0.000544,172.217.194.0-255,5738,50853,21,289467
36,0.000547,172.31.33.0-255,66,50919,21,289467
37,0.000568,172.217.194.0-255,2543,53462,21,289467
38,0.00057,172.31.33.0-255,66,53528,21,289467
39,0.00093,172.217.194.0-255,645,54173,21,289467
40,0.000944,172.217.194.0-255,1484,55657,21,289467
41,0.000947,172.31.33.0-255,66,55723,21,289467
42,0.000951,172.217.194.0-255,2902,58625,21,289467
43,0.000953,172.31.33.0-255,66,58691,21,289467
44,0.000982,172.217.194.0-255,5738,64429,21,289467
45,0.000985,172.31.33.0-255,66,64495,21,289467
46,0.001018,172.31.33.0-255,66,64561,21,289467
47,0.001046,172.217.194.0-255,4320,68881,21,289467
48,0.001048,172.31.33.0-255,66,68947,21,289467
49,0.00106,172.31.33.0-255,66,69013,21,289467
50,0.001062,172.217.194.0-255,766,69779,21,289467
51,0.001464,172.31.33.0-255,66,69845,21,289467
52,0.00182,172.217.194.0-255,1484,71329,21,289467
53,0.001831,172.217.194.0-255,2902,74231,21,289467
54,0.001836,172.31.33.0-255,66,74297,21,289467
55,0.00184,172.217.194.0-255,1484,75781,21,289467
56,0.001863,172.217.194.0-255,4320,80101,21,289467
57,0.001865,172.31.33.0-255,66,80167,21,289467
58,0.001895,172.217.194.0-255,7156,87323,21,289467
59,0.001897,172.31.33.0-255,66,87389,21,289467
60,0.00191,172.31.33.0-255,66,87455,21,289467
61,0.001937,172.217.194.0-255,6438,93893,21,289467
62,0.00194,172.31.33.0-255,66,93959,21,289467
63,0.002043,172.217.194.0-255,1484,95443,21,289467
64,0.002057,172.217.194.0-255,2902,98345,21,289467
65,0.00206,172.31.33.0-255,66,98411,21,289467
66,0.002064,172.217.194.0-255,2902,101313,21,289467
67,0.002066,172.31.33.0-255,66,101379,21,289467
68,0.002084,172.217.194.0-255,2902,104281,21,289467
69,0.002086,172.31.33.0-255,66,104347,21,289467
70,0.00209,172.217.194.0-255,2902,107249,21,289467
71,0.002095,172.31.33.0-255,66,107315,21,289467
72,0.002132,172.31.33.0-255,66,107381,21,289467
73,0.002137,172.217.194.0-255,2902,110283,21,289467
74,0.002138,172.31.33.0-255,66,110349,21,289467
75,0.002169,172.31.33.0-255,66,110415,21,289467
76,0.002438,172.217.194.0-255,1484,111899,21,289467
77,0.002444,172.217.194.0-255,1484,113383,21,289467
78,0.002447,172.31.33.0-255,66,113449,21,289467
79,0.002471,172.217.194.0-255,1484,114933,21,289467
80,0.002476,172.217.194.0-255,4320,119253,21,289467
81,0.002479,172.31.33.0-255,66,119319,21,289467
82,0.002506,172.217.194.0-255,1484,120803,21,289467
83,0.002518,172.31.33.0-255,66,120869,21,289467
84,0.002523,172.217.194.0-255,4320,125189,21,289467
85,0.002525,172.31.33.0-255,66,125255,21,289467
86,0.002551,172.217.194.0-255,4320,129575,21,289467
87,0.002553,172.31.33.0-255,66,129641,21,289467
88,0.002556,172.217.194.0-255,2184,131825,21,289467
89,0.002558,172.31.33.0-255,66,131891,21,289467
90,0.002662,172.217.194.0-255,1484,133375,21,289467
91,0.002671,172.217.194.0-255,1484,134859,21,289467
92,0.002674,172.31.33.0-255,66,134925,21,289467
93,0.002697,172.217.194.0-255,1484,136409,21,289467
94,0.002703,172.217.194.0-255,5738,142147,21,289467
95,0.002705,172.31.33.0-255,66,142213,21,289467
96,0.00274,172.217.194.0-255,4320,146533,21,289467
97,0.002743,172.31.33.0-255,66,146599,21,289467
98,0.002764,172.31.33.0-255,66,146665,21,289467
99,0.002774,172.31.33.0-255,66,146731,21,289467
100,0.005465,172.217.194.0-255,5738,152469,21,289467
101,0.005468,172.31.33.0-255,66,152535,21,289467
102,0.008166,172.217.194.0-255,5738,158273,21,289467
103,0.008172,172.31.33.0-255,66,158339,21,289467
104,0.010866,172.217.194.0-255,5738,164077,21,289467
105,0.010878,172.31.33.0-255,66,164143,21,289467
106,0.013578,172.217.194.0-255,5738,169881,21,289467
107,0.01359,172.31.33.0-255,66,169947,21,289467
108,0.01627,172.217.194.0-255,5738,175685,21,289467
109,0.016276,172.31.33.0-255,66,175751,21,289467
110,0.018992,172.217.194.0-255,5738,181489,21,289467
111,0.019005,172.31.33.0-255,66,181555,21,289467
112,0.0217,172.217.194.0-255,5738,187293,21,289467
113,0.021707,172.31.33.0-255,66,187359,21,289467
114,0.024406,172.217.194.0-255,5738,193097,21,289467
115,0.024413,172.31.33.0-255,66,193163,21,289467
116,0.027109,172.217.194.0-255,5738,198901,21,289467
117,0.027114,172.31.33.0-255,66,198967,21,289467
118,0.027463,172.31.33.0-255,192,199159,21,289467
119,0.027491,172.31.33.0-255,1113,200272,21,289467
120,0.027554,172.31.33.0-255,1514,201786,21,289467
121,0.027556,172.31.33.0-255,1514,203300,21,289467
122,0.027558,172.31.33.0-255,689,203989,21,289467
123,0.029131,104.244.42.0-255,66,204055,21,289467
124,0.029183,104.244.42.0-255,66,204121,21,289467
125,0.029233,104.244.42.0-255,66,204187,21,289467
126,0.029237,104.244.42.0-255,66,204253,21,289467
127,0.029796,172.217.194.0-255,4320,208573,21,289467
128,0.029803,172.31.33.0-255,66,208639,21,289467
129,0.029832,172.217.194.0-255,1484,210123,21,289467
130,0.032501,172.217.194.0-255,4320,214443,21,289467
131,0.032507,172.31.33.0-255,66,214509,21,289467
132,0.035206,172.217.194.0-255,5738,220247,21,289467
133,0.035213,172.31.33.0-255,66,220313,21,289467
134,0.037883,172.217.194.0-255,5738,226051,21,289467
135,0.037889,172.31.33.0-255,66,226117,21,289467
136,0.04058,172.217.194.0-255,5738,231855,21,289467
137,0.040587,172.31.33.0-255,66,231921,21,289467
138,0.043264,172.217.194.0-255,2902,234823,21,289467
139,0.04327,172.31.33.0-255,66,234889,21,289467
140,0.043298,172.217.194.0-255,2902,237791,21,289467
141,0.043301,172.31.33.0-255,66,237857,21,289467
142,0.045942,172.217.194.0-255,2902,240759,21,289467
143,0.045949,172.31.33.0-255,66,240825,21,289467
144,0.045987,172.217.194.0-255,2902,243727,21,289467
145,0.045991,172.31.33.0-255,66,243793,21,289467
146,0.048619,172.217.194.0-255,2902,246695,21,289467
147,0.048628,172.31.33.0-255,66,246761,21,289467
148,0.048667,172.217.194.0-255,2902,249663,21,289467
149,0.048669,172.31.33.0-255,66,249729,21,289467
150,0.05133,172.217.194.0-255,2902,252631,21,289467
151,0.051339,172.31.33.0-255,66,252697,21,289467
152,0.051372,172.217.194.0-255,2902,255599,21,289467
153,0.051377,172.31.33.0-255,66,255665,21,289467
154,0.054046,172.217.194.0-255,4320,259985,21,289467
155,0.054052,172.31.33.0-255,66,260051,21,289467
156,0.054076,172.217.194.0-255,1484,261535,21,289467
157,0.056823,172.217.194.0-255,4320,265855,21,289467
158,0.05683,172.31.33.0-255,66,265921,21,289467
159,0.059518,172.217.194.0-255,5738,271659,21,289467
160,0.059524,172.31.33.0-255,66,271725,21,289467
161,0.062223,172.217.194.0-255,5738,277463,21,289467
162,0.06223,172.31.33.0-255,66,277529,21,289467
163,0.064919,172.217.194.0-255,2902,280431,21,289467
164,0.064925,172.31.33.0-255,66,280497,21,289467
165,0.064954,172.217.194.0-255,2902,283399,21,289467
166,0.064956,172.31.33.0-255,66,283465,21,289467
167,0.067599,172.217.194.0-255,2902,286367,21,289467
168,0.067604,172.31.33.0-255,66,286433,21,289467
169,0.067626,172.217.194.0-255,1484,287917,21,289467
170,0.067639,172.217.194.0-255,1484,289401,21,289467
171,0.067641,172.31.33.0-255,66,289467,21,289467
172,0.0,172.31.33.0-255,299,299,21,365
173,0.001544,104.244.42.0-255,66,365,21,365
174,0.0,74.125.130.0-255,66,66,21,66
175,0.0,172.31.33.0-255,66,66,21,66
176,0.0,172.31.33.0-255,105,105,21,459
177,0.000175,172.31.33.0-255,90,195,21,459
178,0.000182,172.31.33.0-255,66,261,21,459
179,0.002758,74.125.200.0-255,66,327,21,459
180,0.00277,74.125.200.0-255,66,393,21,459
181,0.002779,172.31.33.0-255,66,459,21,459
182,0.0,74.125.24.0-255,146,146,21,310415
183,4.3e-05,172.31.33.0-255,66,212,21,310415
184,4.9e-05,74.125.24.0-255,1484,1696,21,310415
185,5.3e-05,172.31.33.0-255,66,1762,21,310415
186,5.7e-05,74.125.24.0-255,2902,4664,21,310415
187,6e-05,172.31.33.0-255,66,4730,21,310415
188,6.5e-05,74.125.24.0-255,5738,10468,21,310415
189,6.8e-05,172.31.33.0-255,66,10534,21,310415
190,7.2e-05,74.125.24.0-255,3376,13910,21,310415
191,7.5e-05,172.31.33.0-255,66,13976,21,310415
192,0.000158,74.125.24.0-255,1484,15460,21,310415
193,0.000162,172.31.33.0-255,66,15526,21,310415
194,0.000168,74.125.24.0-255,2902,18428,21,310415
195,0.00017,172.31.33.0-255,66,18494,21,310415
196,0.000194,74.125.24.0-255,5738,24232,21,310415
197,0.000196,172.31.33.0-255,66,24298,21,310415
198,0.000207,74.125.24.0-255,1484,25782,21,310415
199,0.000209,172.31.33.0-255,66,25848,21,310415
200,0.000228,74.125.24.0-255,4320,30168,21,310415
201,0.00023,172.31.33.0-255,66,30234,21,310415
202,0.000251,74.125.24.0-255,7156,37390,21,310415
203,0.000253,172.31.33.0-255,66,37456,21,310415
204,0.000278,74.125.24.0-255,6797,44253,21,310415
205,0.000281,172.31.33.0-255,66,44319,21,310415
206,0.000293,172.31.33.0-255,66,44385,21,310415
207,0.000346,74.125.24.0-255,4320,48705,21,310415
208,0.000349,172.31.33.0-255,66,48771,21,310415
209,0.000369,74.125.24.0-255,5353,54124,21,310415
210,0.000372,172.31.33.0-255,66,54190,21,310415
211,0.000375,74.125.24.0-255,111,54301,21,310415
212,0.000377,172.31.33.0-255,66,54367,21,310415
213,0.000658,74.125.24.0-255,330,54697,21,310415
214,0.000663,172.31.33.0-255,66,54763,21,310415
215,0.00086,74.125.24.0-255,1484,56247,21,310415
216,0.000865,172.31.33.0-255,66,56313,21,310415
217,0.000874,74.125.24.0-255,2902,59215,21,310415
218,0.000876,172.31.33.0-255,66,59281,21,310415
219,0.000882,74.125.24.0-255,5738,65019,21,310415
220,0.000884,172.31.33.0-255,66,65085,21,310415
221,0.000902,74.125.24.0-255,2902,67987,21,310415
222,0.000904,172.31.33.0-255,66,68053,21,310415
223,0.000928,172.31.33.0-255,66,68119,21,310415
224,0.000949,74.125.24.0-255,1484,69603,21,310415
225,0.000952,172.31.33.0-255,66,69669,21,310415
226,0.000969,74.125.24.0-255,7156,76825,21,310415
227,0.000972,172.31.33.0-255,66,76891,21,310415
228,0.000992,74.125.24.0-255,2184,79075,21,310415
229,0.000995,172.31.33.0-255,66,79141,21,310415
230,0.001184,74.125.24.0-255,1484,80625,21,310415
231,0.001192,74.125.24.0-255,2902,83527,21,310415
232,0.001214,74.125.24.0-255,5738,89265,21,310415
233,0.001242,74.125.24.0-255,5738,95003,21,310415
234,0.001248,74.125.24.0-255,4320,99323,21,310415
235,0.001267,74.125.24.0-255,7156,106479,21,310415
236,0.001282,74.125.24.0-255,1484,107963,21,310415
237,0.001294,74.125.24.0-255,5020,112983,21,310415
238,0.002006,74.125.24.0-255,1484,114467,21,310415
239,0.002011,74.125.24.0-255,1484,115951,21,310415
240,0.002021,74.125.24.0-255,1484,117435,21,310415
241,0.002028,74.125.24.0-255,5738,123173,21,310415
242,0.002051,74.125.24.0-255,4320,127493,21,310415
243,0.002067,74.125.24.0-255,7156,134649,21,310415
244,0.002102,74.125.24.0-255,1484,136133,21,310415
245,0.002167,74.125.24.0-255,1484,137617,21,310415
246,0.00222,74.125.24.0-255,5738,143355,21,310415
247,0.002241,74.125.24.0-255,5020,148375,21,310415
248,0.0059,172.31.33.0-255,66,148441,21,310415
249,0.00819,74.125.24.0-255,5738,154179,21,310415
250,0.008196,172.31.33.0-255,66,154245,21,310415
251,0.010488,74.125.24.0-255,5738,159983,21,310415
252,0.010507,172.31.33.0-255,66,160049,21,310415
253,0.012793,74.125.24.0-255,5738,165787,21,310415
254,0.012806,172.31.33.0-255,66,165853,21,310415
255,0.015073,74.125.24.0-255,5738,171591,21,310415
256,0.015082,172.31.33.0-255,66,171657,21,310415
257,0.017395,74.125.24.0-255,5738,177395,21,310415
258,0.017402,172.31.33.0-255,66,177461,21,310415
259,0.019763,74.125.24.0-255,5738,183199,21,310415
260,0.01977,172.31.33.0-255,66,183265,21,310415
261,0.022097,74.125.24.0-255,5738,189003,21,310415
262,0.022116,172.31.33.0-255,66,189069,21,310415
263,0.024428,74.125.24.0-255,5738,194807,21,310415
264,0.024436,172.31.33.0-255,66,194873,21,310415
265,0.026752,74.125.24.0-255,5738,200611,21,310415
266,0.026759,172.31.33.0-255,66,200677,21,310415
267,0.029115,74.125.24.0-255,5738,206415,21,310415
268,0.029133,172.31.33.0-255,66,206481,21,310415
269,0.031433,74.125.24.0-255,5738,212219,21,310415
270,0.031439,172.31.33.0-255,66,212285,21,310415
271,0.03359,172.31.33.0-255,172,212457,21,310415
272,0.033627,172.31.33.0-255,1109,213566,21,310415
273,0.033659,172.31.33.0-255,1514,215080,21,310415
274,0.033661,172.31.33.0-255,1514,216594,21,310415
275,0.033682,172.31.33.0-255,693,217287,21,310415
276,0.033719,74.125.24.0-255,5738,223025,21,310415
277,0.033723,172.31.33.0-255,66,223091,21,310415
278,0.035163,104.244.42.0-255,66,223157,21,310415
279,0.035174,104.244.42.0-255,66,223223,21,310415
280,0.035198,104.244.42.0-255,66,223289,21,310415
281,0.035203,104.244.42.0-255,66,223355,21,310415
282,0.036036,74.125.24.0-255,5738,229093,21,310415
283,0.036048,172.31.33.0-255,66,229159,21,310415
284,0.038364,74.125.24.0-255,5738,234897,21,310415
285,0.038382,172.31.33.0-255,66,234963,21,310415
286,0.040755,74.125.24.0-255,5738,240701,21,310415
287,0.040782,172.31.33.0-255,66,240767,21,310415
288,0.043107,74.125.24.0-255,5738,246505,21,310415
289,0.043116,172.31.33.0-255,66,246571,21,310415
290,0.045418,74.125.24.0-255,5738,252309,21,310415
291,0.045438,172.31.33.0-255,66,252375,21,310415
292,0.047724,74.125.24.0-255,5738,258113,21,310415
293,0.047739,172.31.33.0-255,66,258179,21,310415
294,0.050072,74.125.24.0-255,5738,263917,21,310415
295,0.050091,172.31.33.0-255,66,263983,21,310415
296,0.052396,74.125.24.0-255,5738,269721,21,310415
297,0.052415,172.31.33.0-255,66,269787,21,310415
298,0.054746,74.125.24.0-255,5738,275525,21,310415
299,0.054765,172.31.33.0-255,66,275591,21,310415
300,0.057081,74.125.24.0-255,5738,281329,21,310415
301,0.0571,172.31.33.0-255,66,281395,21,310415
302,0.059413,74.125.24.0-255,5738,287133,21,310415
303,0.05943,172.31.33.0-255,66,287199,21,310415
304,0.06174,74.125.24.0-255,5738,292937,21,310415
305,0.061761,172.31.33.0-255,66,293003,21,310415
306,0.064088,74.125.24.0-255,5738,298741,21,310415
307,0.064106,172.31.33.0-255,66,298807,21,310415
308,0.066393,74.125.24.0-255,5738,304545,21,310415
309,0.066398,172.31.33.0-255,66,304611,21,310415
310,0.068673,74.125.24.0-255,5738,310349,21,310415
311,0.068677,172.31.33.0-255,66,310415,21,310415
312,0.0,172.31.33.0-255,232,232,21,298
313,0.00749,74.125.24.0-255,66,298,21,298
314,0.0,172.31.33.0-255,105,105,21,2295
315,5.3e-05,172.31.33.0-255,105,210,21,2295
316,0.000111,172.31.33.0-255,105,315,21,2295
317,0.000146,172.31.33.0-255,105,420,21,2295
318,0.00021,172.31.33.0-255,105,525,21,2295
319,0.000542,172.31.33.0-255,90,615,21,2295
320,0.000552,172.31.33.0-255,66,681,21,2295
321,0.000726,172.31.33.0-255,90,771,21,2295
322,0.000732,172.31.33.0-255,66,837,21,2295
323,0.001045,172.31.33.0-255,90,927,21,2295
324,0.001051,172.31.33.0-255,66,993,21,2295
325,0.001253,172.31.33.0-255,90,1083,21,2295
326,0.001259,172.31.33.0-255,66,1149,21,2295
327,0.001401,172.31.33.0-255,90,1239,21,2295
328,0.001407,172.31.33.0-255,66,1305,21,2295
329,0.002592,74.125.68.0-255,66,1371,21,2295
330,0.00262,74.125.68.0-255,66,1437,21,2295
331,0.00264,172.31.33.0-255,66,1503,21,2295
332,0.002995,74.125.68.0-255,66,1569,21,2295
333,0.00301,74.125.68.0-255,66,1635,21,2295
334,0.00302,172.31.33.0-255,66,1701,21,2295
335,0.003566,172.217.194.0-255,66,1767,21,2295
336,0.003582,172.217.194.0-255,66,1833,21,2295
337,0.003594,172.31.33.0-255,66,1899,21,2295
338,0.003623,74.125.130.0-255,66,1965,21,2295
339,0.003636,74.125.130.0-255,66,2031,21,2295
340,0.003647,172.31.33.0-255,66,2097,21,2295
341,0.004043,74.125.24.0-255,66,2163,21,2295
342,0.004056,74.125.24.0-255,66,2229,21,2295
343,0.004066,172.31.33.0-255,66,2295,21,2295
344,0.0,172.31.33.0-255,105,105,21,459
345,0.000284,172.31.33.0-255,90,195,21,459
346,0.000292,172.31.33.0-255,66,261,21,459
347,0.002559,74.125.24.0-255,66,327,21,459
348,0.002578,74.125.24.0-255,66,393,21,459
349,0.002588,172.31.33.0-255,66,459,21,459
350,0.0,172.217.194.0-255,152,152,21,308821
351,2.2e-05,172.31.33.0-255,66,218,21,308821
352,3e-05,172.217.194.0-255,1484,1702,21,308821
353,3.5e-05,172.31.33.0-255,66,1768,21,308821
354,4.1e-05,172.217.194.0-255,2902,4670,21,308821
355,4.5e-05,172.31.33.0-255,66,4736,21,308821
356,5.3e-05,172.217.194.0-255,7156,11892,21,308821
357,5.6e-05,172.31.33.0-255,66,11958,21,308821
358,0.0001,172.31.33.0-255,66,12024,21,308821
359,0.000103,172.217.194.0-255,1484,13508,21,308821
360,0.000105,172.31.33.0-255,66,13574,21,308821
361,0.000109,172.217.194.0-255,1125,14699,21,308821
362,0.000111,172.31.33.0-255,66,14765,21,308821
363,0.000153,172.217.194.0-255,1484,16249,21,308821
364,0.000155,172.31.33.0-255,66,16315,21,308821
365,0.000159,172.217.194.0-255,1484,17799,21,308821
366,0.000161,172.31.33.0-255,66,17865,21,308821
367,0.000177,172.217.194.0-255,2902,20767,21,308821
368,0.000179,172.31.33.0-255,66,20833,21,308821
369,0.000185,172.217.194.0-255,4320,25153,21,308821
370,0.000188,172.31.33.0-255,66,25219,21,308821
371,0.000211,172.217.194.0-255,2902,28121,21,308821
372,0.000214,172.31.33.0-255,66,28187,21,308821
373,0.000218,172.217.194.0-255,1484,29671,21,308821
374,0.00022,172.31.33.0-255,66,29737,21,308821
375,0.000243,172.31.33.0-255,66,29803,21,308821
376,0.000269,172.217.194.0-255,3961,33764,21,308821
377,0.000272,172.31.33.0-255,66,33830,21,308821
378,0.000278,172.217.194.0-255,4264,38094,21,308821
379,0.000281,172.31.33.0-255,66,38160,21,308821
380,0.000314,172.217.194.0-255,385,38545,21,308821
381,0.000423,172.217.194.0-255,1484,40029,21,308821
382,0.000427,172.31.33.0-255,66,40095,21,308821
383,0.000433,172.217.194.0-255,2902,42997,21,308821
384,0.000436,172.31.33.0-255,66,43063,21,308821
385,0.000439,172.217.194.0-255,1484,44547,21,308821
386,0.000464,172.217.194.0-255,4320,48867,21,308821
387,0.000467,172.31.33.0-255,66,48933,21,308821
388,0.000505,172.217.194.0-255,2902,51835,21,308821
389,0.000508,172.31.33.0-255,66,51901,21,308821
390,0.000542,172.217.194.0-255,3410,55311,21,308821
391,0.000545,172.31.33.0-255,66,55377,21,308821
392,0.001148,172.217.194.0-255,1484,56861,21,308821
393,0.001159,172.217.194.0-255,1484,58345,21,308821
394,0.001162,172.31.33.0-255,66,58411,21,308821
395,0.001187,172.217.194.0-255,1484,59895,21,308821
396,0.00119,172.217.194.0-255,1484,61379,21,308821
397,0.001193,172.31.33.0-255,66,61445,21,308821
398,0.001212,172.217.194.0-255,4320,65765,21,308821
399,0.001214,172.31.33.0-255,66,65831,21,308821
400,0.001256,172.31.33.0-255,66,65897,21,308821
401,0.00128,172.217.194.0-255,4320,70217,21,308821
402,0.001283,172.31.33.0-255,66,70283,21,308821
403,0.00129,172.217.194.0-255,7156,77439,21,308821
404,0.001292,172.31.33.0-255,66,77505,21,308821
405,0.001297,172.217.194.0-255,3602,81107,21,308821
406,0.0013,172.31.33.0-255,66,81173,21,308821
407,0.001554,172.217.194.0-255,1484,82657,21,308821
408,0.00156,172.217.194.0-255,2902,85559,21,308821
409,0.001563,172.31.33.0-255,66,85625,21,308821
410,0.001568,172.217.194.0-255,1484,87109,21,308821
411,0.001586,172.217.194.0-255,4320,91429,21,308821
412,0.001589,172.31.33.0-255,66,91495,21,308821
413,0.001605,172.217.194.0-255,1484,92979,21,308821
414,0.001647,172.217.194.0-255,7156,100135,21,308821
415,0.00165,172.31.33.0-255,66,100201,21,308821
416,0.001671,172.217.194.0-255,4320,104521,21,308821
417,0.001674,172.31.33.0-255,66,104587,21,308821
418,0.001686,172.31.33.0-255,66,104653,21,308821
419,0.001786,172.217.194.0-255,1484,106137,21,308821
420,0.001803,172.217.194.0-255,2902,109039,21,308821
421,0.001806,172.31.33.0-255,66,109105,21,308821
422,0.001826,172.217.194.0-255,5738,114843,21,308821
423,0.001829,172.31.33.0-255,66,114909,21,308821
424,0.001834,172.217.194.0-255,4320,119229,21,308821
425,0.001836,172.31.33.0-255,66,119295,21,308821
426,0.001856,172.217.194.0-255,4320,123615,21,308821
427,0.00186,172.31.33.0-255,66,123681,21,308821
428,0.0019,172.217.194.0-255,7156,130837,21,308821
429,0.001904,172.31.33.0-255,66,130903,21,308821
430,0.00193,172.31.33.0-255,66,130969,21,308821
431,0.002432,172.217.194.0-255,1484,132453,21,308821
432,0.002437,172.217.194.0-255,1484,133937,21,308821
433,0.002441,172.31.33.0-255,66,134003,21,308821
434,0.002457,172.217.194.0-255,1484,135487,21,308821
435,0.002462,172.217.194.0-255,4320,139807,21,308821
436,0.002464,172.31.33.0-255,66,139873,21,308821
437,0.002486,172.217.194.0-255,1484,141357,21,308821
438,0.002498,172.31.33.0-255,66,141423,21,308821
439,0.002505,172.217.194.0-255,7156,148579,21,308821
440,0.002507,172.31.33.0-255,66,148645,21,308821
441,0.002524,172.217.194.0-255,1484,150129,21,308821
442,0.00254,172.217.194.0-255,2184,152313,21,308821
443,0.002542,172.31.33.0-255,66,152379,21,308821
444,0.005084,172.217.194.0-255,2902,155281,21,308821
445,0.005092,172.31.33.0-255,66,155347,21,308821
446,0.005113,172.217.194.0-255,2902,158249,21,308821
447,0.005116,172.31.33.0-255,66,158315,21,308821
448,0.007674,172.217.194.0-255,2902,161217,21,308821
449,0.007678,172.31.33.0-255,66,161283,21,308821
450,0.007698,172.217.194.0-255,2902,164185,21,308821
451,0.0077,172.31.33.0-255,66,164251,21,308821
452,0.010273,172.217.194.0-255,5738,169989,21,308821
453,0.010281,172.31.33.0-255,66,170055,21,308821
454,0.012833,172.217.194.0-255,5738,175793,21,308821
455,0.012844,172.31.33.0-255,66,175859,21,308821
456,0.015437,172.217.194.0-255,5738,181597,21,308821
457,0.015447,172.31.33.0-255,66,181663,21,308821
458,0.017999,172.217.194.0-255,5738,187401,21,308821
459,0.018009,172.31.33.0-255,66,187467,21,308821
460,0.020582,172.217.194.0-255,5738,193205,21,308821
461,0.020602,172.31.33.0-255,66,193271,21,308821
462,0.023246,172.217.194.0-255,5738,199009,21,308821
463,0.023266,172.31.33.0-255,66,199075,21,308821
464,0.025862,172.217.194.0-255,5738,204813,21,308821
465,0.025879,172.31.33.0-255,66,204879,21,308821
466,0.028455,172.217.194.0-255,5738,210617,21,308821
467,0.028469,172.31.33.0-255,66,210683,21,308821
468,0.031037,172.217.194.0-255,5738,216421,21,308821
469,0.031046,172.31.33.0-255,66,216487,21,308821
470,0.033623,172.217.194.0-255,5738,222225,21,308821
471,0.033633,172.31.33.0-255,66,222291,21,308821
472,0.036218,172.217.194.0-255,5738,228029,21,308821
473,0.036224,172.31.33.0-255,66,228095,21,308821
474,0.036715,172.31.33.0-255,172,228267,21,308821
475,0.036748,172.31.33.0-255,1113,229380,21,308821
476,0.036802,172.31.33.0-255,1514,230894,21,308821
477,0.036803,172.31.33.0-255,1514,232408,21,308821
478,0.036828,172.31.33.0-255,697,233105,21,308821
479,0.038318,104.244.42.0-255,66,233171,21,308821
480,0.038326,104.244.42.0-255,66,233237,21,308821
481,0.038395,104.244.42.0-255,66,233303,21,308821
482,0.0384,104.244.42.0-255,66,233369,21,308821
483,0.038792,172.217.194.0-255,5738,239107,21,308821
484,0.038798,172.31.33.0-255,66,239173,21,308821
485,0.041379,172.217.194.0-255,5738,244911,21,308821
486,0.041388,172.31.33.0-255,66,244977,21,308821
487,0.043996,172.217.194.0-255,5738,250715,21,308821
488,0.044004,172.31.33.0-255,66,250781,21,308821
489,0.046548,172.217.194.0-255,5738,256519,21,308821
490,0.046555,172.31.33.0-255,66,256585,21,308821
491,0.049137,172.217.194.0-255,5738,262323,21,308821
492,0.049143,172.31.33.0-255,66,262389,21,308821
493,0.051719,172.217.194.0-255,5738,268127,21,308821
494,0.051726,172.31.33.0-255,66,268193,21,308821
495,0.054278,172.217.194.0-255,5738,273931,21,308821
496,0.054284,172.31.33.0-255,66,273997,21,308821
497,0.056851,172.217.194.0-255,5738,279735,21,308821
498,0.056857,172.31.33.0-255,66,279801,21,308821
499,0.059449,172.217.194.0-255,5738,285539,21,308821
500,0.059456,172.31.33.0-255,66,285605,21,308821
501,0.062058,172.217.194.0-255,5738,291343,21,308821
502,0.062066,172.31.33.0-255,66,291409,21,308821
503,0.064666,172.217.194.0-255,5738,297147,21,308821
504,0.064672,172.31.33.0-255,66,297213,21,308821
505,0.067255,172.217.194.0-255,5738,302951,21,308821
506,0.067263,172.31.33.0-255,66,303017,21,308821
507,0.069828,172.217.194.0-255,5738,308755,21,308821
508,0.069834,172.31.33.0-255,66,308821,21,308821
509,0.0,74.125.24.0-255,298,298,21,332050
510,3.1e-05,172.31.33.0-255,66,364,21,332050
511,3.7e-05,74.125.24.0-255,1484,1848,21,332050
512,4.2e-05,172.31.33.0-255,66,1914,21,332050
513,4.8e-05,74.125.24.0-255,4320,6234,21,332050
514,5.2e-05,172.31.33.0-255,66,6300,21,332050
515,7e-05,172.31.33.0-255,66,6366,21,332050
516,7.6e-05,74.125.24.0-255,4320,10686,21,332050
517,7.8e-05,172.31.33.0-255,66,10752,21,332050
518,0.000125,172.31.33.0-255,66,10818,21,332050
519,0.00013,74.125.24.0-255,2543,13361,21,332050
520,0.000132,172.31.33.0-255,66,13427,21,332050
521,0.000157,74.125.24.0-255,2902,16329,21,332050
522,0.000159,172.31.33.0-255,66,16395,21,332050
523,0.000164,74.125.24.0-255,4320,20715,21,332050
524,0.000167,172.31.33.0-255,66,20781,21,332050
525,0.000173,74.125.24.0-255,5738,26519,21,332050
526,0.000175,172.31.33.0-255,66,26585,21,332050
527,0.000208,74.125.24.0-255,2902,29487,21,332050
528,0.00021,172.31.33.0-255,66,29553,21,332050
529,0.000214,74.125.24.0-255,1125,30678,21,332050
530,0.000216,172.31.33.0-255,66,30744,21,332050
531,0.000781,74.125.24.0-255,1484,32228,21,332050
532,0.000787,172.31.33.0-255,66,32294,21,332050
533,0.000796,74.125.24.0-255,2902,35196,21,332050
534,0.000799,172.31.33.0-255,66,35262,21,332050
535,0.000829,74.125.24.0-255,5738,41000,21,332050
536,0.000833,172.31.33.0-255,66,41066,21,332050
537,0.00084,74.125.24.0-255,6797,47863,21,332050
538,0.000843,172.31.33.0-255,66,47929,21,332050
539,0.000871,74.125.24.0-255,4320,52249,21,332050
540,0.000875,172.31.33.0-255,66,52315,21,332050
541,0.000902,74.125.24.0-255,4320,56635,21,332050
542,0.000906,172.31.33.0-255,66,56701,21,332050
543,0.000942,172.31.33.0-255,66,56767,21,332050
544,0.000968,74.125.24.0-255,5738,62505,21,332050
545,0.000971,172.31.33.0-255,66,62571,21,332050
546,0.001007,74.125.24.0-255,2902,65473,21,332050
547,0.001011,172.31.33.0-255,66,65539,21,332050
548,0.001017,74.125.24.0-255,5738,71277,21,332050
549,0.001019,172.31.33.0-255,66,71343,21,332050
550,0.001023,74.125.24.0-255,2543,73886,21,332050
551,0.001026,172.31.33.0-255,66,73952,21,332050
552,0.001075,74.125.24.0-255,1484,75436,21,332050
553,0.001082,74.125.24.0-255,2902,78338,21,332050
554,0.001086,172.31.33.0-255,66,78404,21,332050
555,0.00112,74.125.24.0-255,5738,84142,21,332050
556,0.001124,172.31.33.0-255,66,84208,21,332050
557,0.00113,74.125.24.0-255,4320,88528,21,332050
558,0.001132,172.31.33.0-255,66,88594,21,332050
559,0.001161,74.125.24.0-255,2543,91137,21,332050
560,0.001164,172.31.33.0-255,66,91203,21,332050
561,0.001336,74.125.24.0-255,1484,92687,21,332050
562,0.001343,74.125.24.0-255,2902,95589,21,332050
563,0.001348,172.31.33.0-255,66,95655,21,332050
564,0.001356,74.125.24.0-255,5738,101393,21,332050
565,0.001358,172.31.33.0-255,66,101459,21,332050
566,0.001361,74.125.24.0-255,1484,102943,21,332050
567,0.001407,172.31.33.0-255,66,103009,21,332050
568,0.001413,74.125.24.0-255,7156,110165,21,332050
569,0.001415,172.31.33.0-255,66,110231,21,332050
570,0.001438,74.125.24.0-255,3602,113833,21,332050
571,0.001441,172.31.33.0-255,66,113899,21,332050
572,0.001623,74.125.24.0-255,1484,115383,21,332050
573,0.00163,74.125.24.0-255,2902,118285,21,332050
574,0.001635,172.31.33.0-255,66,118351,21,332050
575,0.001639,74.125.24.0-255,2902,121253,21,332050
576,0.001641,172.31.33.0-255,66,121319,21,332050
577,0.001664,74.125.24.0-255,2902,124221,21,332050
578,0.001666,172.31.33.0-255,66,124287,21,332050
579,0.001676,74.125.24.0-255,7156,131443,21,332050
580,0.001678,172.31.33.0-255,66,131509,21,332050
581,0.001704,74.125.24.0-255,5738,137247,21,332050
582,0.001707,172.31.33.0-255,66,137313,21,332050
583,0.001717,172.31.33.0-255,66,137379,21,332050
584,0.00172,74.125.24.0-255,766,138145,21,332050
585,0.002172,74.125.24.0-255,1484,139629,21,332050
586,0.002177,172.31.33.0-255,66,139695,21,332050
587,0.002181,74.125.24.0-255,1484,141179,21,332050
588,0.002203,74.125.24.0-255,1484,142663,21,332050
589,0.002205,172.31.33.0-255,66,142729,21,332050
590,0.002211,74.125.24.0-255,5738,148467,21,332050
591,0.002213,172.31.33.0-255,66,148533,21,332050
592,0.002247,172.31.33.0-255,66,148599,21,332050
593,0.002253,74.125.24.0-255,5738,154337,21,332050
594,0.002254,172.31.33.0-255,66,154403,21,332050
595,0.002301,74.125.24.0-255,5738,160141,21,332050
596,0.002304,172.31.33.0-255,66,160207,21,332050
597,0.002345,172.31.33.0-255,66,160273,21,332050
598,0.002358,172.31.33.0-255,66,160339,21,332050
599,0.002362,74.125.24.0-255,4320,164659,21,332050
600,0.002364,172.31.33.0-255,66,164725,21,332050
601,0.004639,74.125.24.0-255,1484,166209,21,332050
602,0.004674,74.125.24.0-255,4320,170529,21,332050
603,0.00468,172.31.33.0-255,66,170595,21,332050
604,0.007014,74.125.24.0-255,5738,176333,21,332050
605,0.007034,172.31.33.0-255,66,176399,21,332050
606,0.009347,74.125.24.0-255,5738,182137,21,332050
607,0.009365,172.31.33.0-255,66,182203,21,332050
608,0.011678,74.125.24.0-255,5738,187941,21,332050
609,0.011683,172.31.33.0-255,66,188007,21,332050
610,0.014005,74.125.24.0-255,5738,193745,21,332050
611,0.014024,172.31.33.0-255,66,193811,21,332050
612,0.016361,74.125.24.0-255,5738,199549,21,332050
613,0.016371,172.31.33.0-255,66,199615,21,332050
614,0.018691,74.125.24.0-255,5738,205353,21,332050
615,0.018697,172.31.33.0-255,66,205419,21,332050
616,0.021021,74.125.24.0-255,5738,211157,21,332050
617,0.021036,172.31.33.0-255,66,211223,21,332050
618,0.023344,74.125.24.0-255,5738,216961,21,332050
619,0.023351,172.31.33.0-255,66,217027,21,332050
620,0.025677,74.125.24.0-255,5738,222765,21,332050
621,0.025689,172.31.33.0-255,66,222831,21,332050
622,0.028037,74.125.24.0-255,5738,228569,21,332050
623,0.028053,172.31.33.0-255,66,228635,21,332050
624,0.030364,74.125.24.0-255,4320,232955,21,332050
625,0.030369,172.31.33.0-255,66,233021,21,332050
626,0.030396,74.125.24.0-255,1484,234505,21,332050
627,0.0327,74.125.24.0-255,4320,238825,21,332050
628,0.032707,172.31.33.0-255,66,238891,21,332050
629,0.035027,74.125.24.0-255,5738,244629,21,332050
630,0.035034,172.31.33.0-255,66,244695,21,332050
631,0.037383,74.125.24.0-255,5738,250433,21,332050
632,0.037395,172.31.33.0-255,66,250499,21,332050
633,0.038679,172.31.33.0-255,172,250671,21,332050
634,0.03872,172.31.33.0-255,1113,251784,21,332050
635,0.038792,172.31.33.0-255,1514,253298,21,332050
636,0.038794,172.31.33.0-255,1288,254586,21,332050
637,0.039708,74.125.24.0-255,4320,258906,21,332050
638,0.039713,172.31.33.0-255,66,258972,21,332050
639,0.039744,74.125.24.0-255,1484,260456,21,332050
640,0.040235,104.244.42.0-255,66,260522,21,332050
641,0.040346,104.244.42.0-255,66,260588,21,332050
642,0.040398,104.244.42.0-255,66,260654,21,332050
643,0.042023,74.125.24.0-255,4320,264974,21,332050
644,0.042028,172.31.33.0-255,66,265040,21,332050
645,0.044343,74.125.24.0-255,5738,270778,21,332050
646,0.044348,172.31.33.0-255,66,270844,21,332050
647,0.046639,74.125.24.0-255,5738,276582,21,332050
648,0.046644,172.31.33.0-255,66,276648,21,332050
649,0.048929,74.125.24.0-255,5738,282386,21,332050
650,0.048936,172.31.33.0-255,66,282452,21,332050
651,0.051239,74.125.24.0-255,4320,286772,21,332050
652,0.051244,172.31.33.0-255,66,286838,21,332050
653,0.051277,74.125.24.0-255,1484,288322,21,332050
654,0.053574,74.125.24.0-255,4320,292642,21,332050
655,0.05358,172.31.33.0-255,66,292708,21,332050
656,0.055875,74.125.24.0-255,5738,298446,21,332050
657,0.05588,172.31.33.0-255,66,298512,21,332050
658,0.058194,74.125.24.0-255,5738,304250,21,332050
659,0.0582,172.31.33.0-255,66,304316,21,332050
660,0.060507,74.125.24.0-255,5738,310054,21,332050
661,0.060513,172.31.33.0-255,66,310120,21,332050
662,0.062814,74.125.24.0-255,4320,314440,21,332050
663,0.06282,172.31.33.0-255,66,314506,21,332050
664,0.062853,74.125.24.0-255,1484,315990,21,332050
665,0.065123,74.125.24.0-255,4320,320310,21,332050
666,0.06513,172.31.33.0-255,66,320376,21,332050
667,0.06745,74.125.24.0-255,5738,326114,21,332050
668,0.067455,172.31.33.0-255,66,326180,21,332050
669,0.069774,74.125.24.0-255,4320,330500,21,332050
670,0.069779,172.31.33.0-255,66,330566,21,332050
671,0.069813,74.125.24.0-255,1484,332050,21,332050
672,0.0,74.125.200.0-255,153,153,21,302384
673,3.3e-05,172.31.33.0-255,66,219,21,302384
674,4e-05,74.125.200.0-255,1484,1703,21,302384
675,4.4e-05,172.31.33.0-255,66,1769,21,302384
676,4.8e-05,74.125.200.0-255,2902,4671,21,302384
677,5.8e-05,172.31.33.0-255,66,4737,21,302384
678,6.1e-05,74.125.200.0-255,1484,6221,21,302384
679,6.4e-05,172.31.33.0-255,66,6287,21,302384
680,6.7e-05,74.125.200.0-255,2902,9189,21,302384
681,7.1e-05,172.31.33.0-255,66,9255,21,302384
682,0.000114,74.125.200.0-255,4908,14163,21,302384
683,0.000118,172.31.33.0-255,66,14229,21,302384
684,0.000219,74.125.200.0-255,1484,15713,21,302384
685,0.000223,172.31.33.0-255,66,15779,21,302384
686,0.000227,74.125.200.0-255,1484,17263,21,302384
687,0.000231,172.31.33.0-255,66,17329,21,302384
688,0.000253,74.125.200.0-255,1484,18813,21,302384
689,0.000256,172.31.33.0-255,66,18879,21,302384
690,0.000259,74.125.200.0-255,1484,20363,21,302384
691,0.000262,172.31.33.0-255,66,20429,21,302384
692,0.000285,74.125.200.0-255,2902,23331,21,302384
693,0.000291,74.125.200.0-255,5738,29069,21,302384
694,0.000292,172.31.33.0-255,66,29135,21,302384
695,0.000295,172.31.33.0-255,66,29201,21,302384
696,0.000324,74.125.200.0-255,2543,31744,21,302384
697,0.000328,172.31.33.0-255,66,31810,21,302384
698,0.000358,74.125.200.0-255,2902,34712,21,302384
699,0.000362,172.31.33.0-255,66,34778,21,302384
700,0.000369,74.125.200.0-255,7156,41934,21,302384
701,0.000372,172.31.33.0-255,66,42000,21,302384
702,0.000375,74.125.200.0-255,2902,44902,21,302384
703,0.000377,172.31.33.0-255,66,44968,21,302384
704,0.000382,74.125.200.0-255,4320,49288,21,302384
705,0.000385,172.31.33.0-255,66,49354,21,302384
706,0.000391,74.125.200.0-255,5738,55092,21,302384
707,0.000395,172.31.33.0-255,66,55158,21,302384
708,0.000417,74.125.200.0-255,2902,58060,21,302384
709,0.000421,172.31.33.0-255,66,58126,21,302384
710,0.000452,74.125.200.0-255,363,58489,21,302384
711,0.000455,172.31.33.0-255,66,58555,21,302384
712,0.000561,74.125.200.0-255,1484,60039,21,302384
713,0.000565,172.31.33.0-255,66,60105,21,302384
714,0.000604,74.125.200.0-255,1484,61589,21,302384
715,0.000622,74.125.200.0-255,1484,63073,21,302384
716,0.000625,172.31.33.0-255,66,63139,21,302384
717,0.000633,74.125.200.0-255,5738,68877,21,302384
718,0.000636,172.31.33.0-255,66,68943,21,302384
719,0.000641,74.125.200.0-255,4320,73263,21,302384
720,0.000644,172.31.33.0-255,66,73329,21,302384
721,0.000657,74.125.200.0-255,5738,79067,21,302384
722,0.000659,172.31.33.0-255,66,79133,21,302384
723,0.000672,172.31.33.0-255,66,79199,21,302384
724,0.000675,74.125.200.0-255,2184,81383,21,302384
725,0.000677,74.125.200.0-255,382,81765,21,302384
726,0.000678,172.31.33.0-255,66,81831,21,302384
727,0.001062,74.125.200.0-255,1484,83315,21,302384
728,0.001067,172.31.33.0-255,66,83381,21,302384
729,0.001072,74.125.200.0-255,2902,86283,21,302384
730,0.001074,172.31.33.0-255,66,86349,21,302384
731,0.001093,74.125.200.0-255,5738,92087,21,302384
732,0.0011,172.31.33.0-255,66,92153,21,302384
733,0.001152,74.125.200.0-255,4320,96473,21,302384
734,0.001157,172.31.33.0-255,66,96539,21,302384
735,0.001192,74.125.200.0-255,1484,98023,21,302384
736,0.001199,74.125.200.0-255,7156,105179,21,302384
737,0.001201,172.31.33.0-255,66,105245,21,302384
738,0.001213,172.31.33.0-255,66,105311,21,302384
739,0.001216,74.125.200.0-255,766,106077,21,302384
740,0.001318,74.125.200.0-255,1484,107561,21,302384
741,0.001322,172.31.33.0-255,66,107627,21,302384
742,0.001352,74.125.200.0-255,2902,110529,21,302384
743,0.001355,172.31.33.0-255,66,110595,21,302384
744,0.001361,74.125.200.0-255,5738,116333,21,302384
745,0.001363,172.31.33.0-255,66,116399,21,302384
746,0.001399,172.31.33.0-255,66,116465,21,302384
747,0.001432,172.31.33.0-255,66,116531,21,302384
748,0.00146,74.125.200.0-255,3602,120133,21,302384
749,0.001463,172.31.33.0-255,66,120199,21,302384
750,0.001466,74.125.200.0-255,1484,121683,21,302384
751,0.001469,74.125.200.0-255,1484,123167,21,302384
752,0.001471,172.31.33.0-255,66,123233,21,302384
753,0.00149,74.125.200.0-255,1484,124717,21,302384
754,0.001516,74.125.200.0-255,5738,130455,21,302384
755,0.001519,172.31.33.0-255,66,130521,21,302384
756,0.001525,74.125.200.0-255,4320,134841,21,302384
757,0.001527,172.31.33.0-255,66,134907,21,302384
758,0.001552,74.125.200.0-255,7156,142063,21,302384
759,0.001555,172.31.33.0-255,66,142129,21,302384
760,0.001568,172.31.33.0-255,66,142195,21,302384
761,0.001669,74.125.200.0-255,1484,143679,21,302384
762,0.001674,74.125.200.0-255,1484,145163,21,302384
763,0.001677,172.31.33.0-255,66,145229,21,302384
764,0.001706,74.125.200.0-255,1484,146713,21,302384
765,0.001713,74.125.200.0-255,5738,152451,21,302384
766,0.001715,172.31.33.0-255,66,152517,21,302384
767,0.00172,74.125.200.0-255,2902,155419,21,302384
768,0.001723,172.31.33.0-255,66,155485,21,302384
769,0.001748,74.125.200.0-255,4320,159805,21,302384
770,0.001751,172.31.33.0-255,66,159871,21,302384
771,0.00177,172.31.33.0-255,66,159937,21,302384
772,0.001774,74.125.200.0-255,2902,162839,21,302384
773,0.001777,172.31.33.0-255,66,162905,21,302384
774,0.00181,74.125.200.0-255,5020,167925,21,302384
775,0.001814,172.31.33.0-255,66,167991,21,302384
776,0.001818,74.125.200.0-255,2902,170893,21,302384
777,0.00182,172.31.33.0-255,66,170959,21,302384
778,0.001848,74.125.200.0-255,1484,172443,21,302384
779,0.001855,74.125.200.0-255,5738,178181,21,302384
780,0.001859,172.31.33.0-255,66,178247,21,302384
781,0.001899,172.31.33.0-255,66,178313,21,302384
782,0.001935,74.125.200.0-255,2902,181215,21,302384
783,0.00194,172.31.33.0-255,66,181281,21,302384
784,0.001975,172.31.33.0-255,66,181347,21,302384
785,0.001978,74.125.200.0-255,2184,183531,21,302384
786,0.00198,172.31.33.0-255,66,183597,21,302384
787,0.002111,74.125.200.0-255,1484,185081,21,302384
788,0.002118,74.125.200.0-255,2902,187983,21,302384
789,0.002121,172.31.33.0-255,66,188049,21,302384
790,0.002126,74.125.200.0-255,2902,190951,21,302384
791,0.002128,172.31.33.0-255,66,191017,21,302384
792,0.002131,74.125.200.0-255,1484,192501,21,302384
793,0.002155,74.125.200.0-255,2902,195403,21,302384
794,0.002159,172.31.33.0-255,66,195469,21,302384
795,0.002169,172.31.33.0-255,66,195535,21,302384
796,0.002194,74.125.200.0-255,7156,202691,21,302384
797,0.002199,172.31.33.0-255,66,202757,21,302384
798,0.002237,172.31.33.0-255,66,202823,21,302384
799,0.002242,74.125.200.0-255,2902,205725,21,302384
800,0.002244,172.31.33.0-255,66,205791,21,302384
801,0.002285,172.31.33.0-255,66,205857,21,302384
802,0.002293,74.125.200.0-255,5738,211595,21,302384
803,0.002296,172.31.33.0-255,66,211661,21,302384
804,0.002302,74.125.200.0-255,7156,218817,21,302384
805,0.002304,172.31.33.0-255,66,218883,21,302384
806,0.002336,74.125.200.0-255,3602,222485,21,302384
807,0.002341,172.31.33.0-255,66,222551,21,302384
808,0.002502,74.125.200.0-255,1484,224035,21,302384
809,0.002508,74.125.200.0-255,2902,226937,21,302384
810,0.002512,172.31.33.0-255,66,227003,21,302384
811,0.002529,74.125.200.0-255,5738,232741,21,302384
812,0.002537,172.31.33.0-255,66,232807,21,302384
813,0.002542,74.125.200.0-255,2902,235709,21,302384
814,0.002544,172.31.33.0-255,66,235775,21,302384
815,0.002589,172.31.33.0-255,66,235841,21,302384
816,0.002592,74.125.200.0-255,1484,237325,21,302384
817,0.005114,74.125.200.0-255,1484,238809,21,302384
818,0.00512,172.31.33.0-255,66,238875,21,302384
819,0.005145,74.125.200.0-255,2902,241777,21,302384
820,0.005147,172.31.33.0-255,66,241843,21,302384
821,0.007635,74.125.200.0-255,2902,244745,21,302384
822,0.007638,172.31.33.0-255,66,244811,21,302384
823,0.007664,74.125.200.0-255,2902,247713,21,302384
824,0.007666,172.31.33.0-255,66,247779,21,302384
825,0.010168,74.125.200.0-255,2902,250681,21,302384
826,0.010177,172.31.33.0-255,66,250747,21,302384
827,0.010217,74.125.200.0-255,2902,253649,21,302384
828,0.01022,172.31.33.0-255,66,253715,21,302384
829,0.012715,74.125.200.0-255,2902,256617,21,302384
830,0.012731,172.31.33.0-255,66,256683,21,302384
831,0.012765,74.125.200.0-255,2902,259585,21,302384
832,0.01277,172.31.33.0-255,66,259651,21,302384
833,0.015288,74.125.200.0-255,5738,265389,21,302384
834,0.015308,172.31.33.0-255,66,265455,21,302384
835,0.017846,74.125.200.0-255,5738,271193,21,302384
836,0.017853,172.31.33.0-255,66,271259,21,302384
837,0.020395,74.125.200.0-255,5738,276997,21,302384
838,0.020404,172.31.33.0-255,66,277063,21,302384
839,0.022946,74.125.200.0-255,5738,282801,21,302384
840,0.022958,172.31.33.0-255,66,282867,21,302384
841,0.025496,74.125.200.0-255,5738,288605,21,302384
842,0.025503,172.31.33.0-255,66,288671,21,302384
843,0.028044,74.125.200.0-255,5738,294409,21,302384
844,0.02805,172.31.33.0-255,66,294475,21,302384
845,0.03057,74.125.200.0-255,513,294988,21,302384
846,0.030782,172.31.33.0-255,66,295054,21,302384
847,0.030811,172.31.33.0-255,105,295159,21,302384
848,0.033318,74.125.200.0-255,66,295225,21,302384
849,0.046009,172.31.33.0-255,172,295397,21,302384
850,0.046038,172.31.33.0-255,1113,296510,21,302384
851,0.046085,172.31.33.0-255,1514,298024,21,302384
852,0.046104,172.31.33.0-255,1514,299538,21,302384
853,0.046108,172.31.33.0-255,1514,301052,21,302384
854,0.046122,172.31.33.0-255,1068,302120,21,302384
855,0.047566,104.244.42.0-255,66,302186,21,302384
856,0.047614,104.244.42.0-255,66,302252,21,302384
857,0.047719,104.244.42.0-255,66,302318,21,302384
858,0.047721,104.244.42.0-255,66,302384,21,302384
859,0.0,172.31.33.0-255,105,105,21,2295
860,3.4e-05,172.31.33.0-255,105,210,21,2295
861,7.4e-05,172.31.33.0-255,105,315,21,2295
862,0.000122,172.31.33.0-255,105,420,21,2295
863,0.000176,172.31.33.0-255,105,525,21,2295
864,0.00044,172.31.33.0-255,90,615,21,2295
865,0.00045,172.31.33.0-255,66,681,21,2295
866,0.000621,172.31.33.0-255,90,771,21,2295
867,0.000628,172.31.33.0-255,66,837,21,2295
868,0.00079,172.31.33.0-255,90,927,21,2295
869,0.000797,172.31.33.0-255,66,993,21,2295
870,0.000932,172.31.33.0-255,90,1083,21,2295
871,0.000938,172.31.33.0-255,66,1149,21,2295
872,0.001265,172.31.33.0-255,90,1239,21,2295
873,0.001271,172.31.33.0-255,66,1305,21,2295
874,0.002738,74.125.24.0-255,66,1371,21,2295
875,0.002766,74.125.24.0-255,66,1437,21,2295
876,0.002778,172.31.33.0-255,66,1503,21,2295
877,0.002908,74.125.200.0-255,66,1569,21,2295
878,0.002918,74.125.200.0-255,66,1635,21,2295
879,0.00292,172.31.33.0-255,66,1701,21,2295
880,0.003061,74.125.68.0-255,66,1767,21,2295
881,0.003079,74.125.68.0-255,66,1833,21,2295
882,0.003081,172.31.33.0-255,66,1899,21,2295
883,0.003174,74.125.24.0-255,66,1965,21,2295
884,0.003178,74.125.24.0-255,66,2031,21,2295
885,0.003179,172.31.33.0-255,66,2097,21,2295
886,0.003496,172.217.194.0-255,66,2163,21,2295
887,0.00351,172.217.194.0-255,66,2229,21,2295
888,0.003513,172.31.33.0-255,66,2295,21,2295
889,0.0,172.217.194.0-255,152,152,21,267274
890,2.9e-05,172.31.33.0-255,66,218,21,267274
891,3.6e-05,172.217.194.0-255,1484,1702,21,267274
892,4e-05,172.31.33.0-255,66,1768,21,267274
893,4.4e-05,172.217.194.0-255,2902,4670,21,267274
894,4.7e-05,172.31.33.0-255,66,4736,21,267274
895,4.9e-05,172.217.194.0-255,1484,6220,21,267274
896,5.1e-05,172.31.33.0-255,66,6286,21,267274
897,8.2e-05,172.217.194.0-255,5738,12024,21,267274
898,8.5e-05,172.31.33.0-255,66,12090,21,267274
899,8.8e-05,172.217.194.0-255,1955,14045,21,267274
900,8.9e-05,172.31.33.0-255,66,14111,21,267274
901,0.000238,172.217.194.0-255,1484,15595,21,267274
902,0.000242,172.31.33.0-255,66,15661,21,267274
903,0.000257,172.217.194.0-255,2902,18563,21,267274
904,0.00026,172.31.33.0-255,66,18629,21,267274
905,0.000264,172.217.194.0-255,5738,24367,21,267274
906,0.000266,172.31.33.0-255,66,24433,21,267274
907,0.000268,172.217.194.0-255,1484,25917,21,267274
908,0.000271,172.31.33.0-255,66,25983,21,267274
909,0.000291,172.217.194.0-255,5379,31362,21,267274
910,0.000295,172.31.33.0-255,66,31428,21,267274
911,0.000301,172.217.194.0-255,4320,35748,21,267274
912,0.000303,172.31.33.0-255,66,35814,21,267274
913,0.000317,172.217.194.0-255,2902,38716,21,267274
914,0.00032,172.31.33.0-255,66,38782,21,267274
915,0.000332,172.217.194.0-255,5738,44520,21,267274
916,0.000334,172.31.33.0-255,66,44586,21,267274
917,0.000358,172.217.194.0-255,2902,47488,21,267274
918,0.000363,172.217.194.0-255,5738,53226,21,267274
919,0.000363,172.31.33.0-255,66,53292,21,267274
920,0.000366,172.31.33.0-255,66,53358,21,267274
921,0.000384,172.217.194.0-255,4320,57678,21,267274
922,0.000387,172.31.33.0-255,66,57744,21,267274
923,0.000396,172.31.33.0-255,66,57810,21,267274
924,0.000433,172.217.194.0-255,645,58455,21,267274
925,0.000701,172.31.33.0-255,66,58521,21,267274
926,0.001059,172.217.194.0-255,1484,60005,21,267274
927,0.001068,172.217.194.0-255,2902,62907,21,267274
928,0.001072,172.31.33.0-255,66,62973,21,267274
929,0.001076,172.217.194.0-255,1484,64457,21,267274
930,0.001094,172.217.194.0-255,4320,68777,21,267274
931,0.001096,172.31.33.0-255,66,68843,21,267274
932,0.001138,172.217.194.0-255,4320,73163,21,267274
933,0.001141,172.31.33.0-255,66,73229,21,267274
934,0.001156,172.217.194.0-255,1995,75224,21,267274
935,0.001158,172.31.33.0-255,66,75290,21,267274
936,0.001276,172.217.194.0-255,1484,76774,21,267274
937,0.001281,172.217.194.0-255,2902,79676,21,267274
938,0.001284,172.31.33.0-255,66,79742,21,267274
939,0.00129,172.217.194.0-255,5738,85480,21,267274
940,0.001292,172.31.33.0-255,66,85546,21,267274
941,0.001314,172.217.194.0-255,1484,87030,21,267274
942,0.001334,172.31.33.0-255,66,87096,21,267274
943,0.001337,172.217.194.0-255,1484,88580,21,267274
944,0.001356,172.31.33.0-255,66,88646,21,267274
945,0.002342,172.217.194.0-255,1484,90130,21,267274
946,0.002355,172.217.194.0-255,2902,93032,21,267274
947,0.002357,172.31.33.0-255,66,93098,21,267274
948,0.00236,172.217.194.0-255,1484,94582,21,267274
949,0.002378,172.217.194.0-255,4320,98902,21,267274
950,0.00238,172.31.33.0-255,66,98968,21,267274
951,0.002383,172.217.194.0-255,1484,100452,21,267274
952,0.0024,172.217.194.0-255,5738,106190,21,267274
953,0.002402,172.31.33.0-255,66,106256,21,267274
954,0.004748,172.217.194.0-255,5738,111994,21,267274
955,0.004754,172.31.33.0-255,66,112060,21,267274
956,0.007111,172.217.194.0-255,5738,117798,21,267274
957,0.007116,172.31.33.0-255,66,117864,21,267274
958,0.009477,172.217.194.0-255,5738,123602,21,267274
959,0.009484,172.31.33.0-255,66,123668,21,267274
960,0.011881,172.217.194.0-255,5738,129406,21,267274
961,0.011891,172.31.33.0-255,66,129472,21,267274
962,0.014245,172.217.194.0-255,5738,135210,21,267274
963,0.014254,172.31.33.0-255,66,135276,21,267274
964,0.016637,172.217.194.0-255,5738,141014,21,267274
965,0.016645,172.31.33.0-255,66,141080,21,267274
966,0.019023,172.217.194.0-255,5738,146818,21,267274
967,0.019029,172.31.33.0-255,66,146884,21,267274
968,0.021405,172.217.194.0-255,5738,152622,21,267274
969,0.021412,172.31.33.0-255,66,152688,21,267274
970,0.023766,172.217.194.0-255,5738,158426,21,267274
971,0.023773,172.31.33.0-255,66,158492,21,267274
972,0.024666,172.31.33.0-255,172,158664,21,267274
973,0.024708,172.31.33.0-255,1109,159773,21,267274
974,0.024783,172.31.33.0-255,1514,161287,21,267274
975,0.024785,172.31.33.0-255,1514,162801,21,267274
976,0.024813,172.31.33.0-255,693,163494,21,267274
977,0.026154,172.217.194.0-255,5738,169232,21,267274
978,0.02616,172.31.33.0-255,66,169298,21,267274
979,0.026189,104.244.42.0-255,66,169364,21,267274
980,0.026234,104.244.42.0-255,66,169430,21,267274
981,0.026352,104.244.42.0-255,66,169496,21,267274
982,0.026357,104.244.42.0-255,66,169562,21,267274
983,0.028545,172.217.194.0-255,5738,175300,21,267274
984,0.02855,172.31.33.0-255,66,175366,21,267274
985,0.030952,172.217.194.0-255,5738,181104,21,267274
986,0.030958,172.31.33.0-255,66,181170,21,267274
987,0.033345,172.217.194.0-255,5738,186908,21,267274
988,0.033352,172.31.33.0-255,66,186974,21,267274
989,0.035744,172.217.194.0-255,4320,191294,21,267274
990,0.035749,172.31.33.0-255,66,191360,21,267274
991,0.035768,172.217.194.0-255,1484,192844,21,267274
992,0.038141,172.217.194.0-255,4320,197164,21,267274
993,0.038146,172.31.33.0-255,66,197230,21,267274
994,0.040519,172.217.194.0-255,4320,201550,21,267274
995,0.040524,172.31.33.0-255,66,201616,21,267274
996,0.040551,172.217.194.0-255,1484,203100,21,267274
997,0.042872,172.217.194.0-255,2902,206002,21,267274
998,0.042878,172.31.33.0-255,66,206068,21,267274
999,0.042907,172.217.194.0-255,1484,207552,21,267274
1000,0.045245,172.217.194.0-255,2902,210454,21,267274
1001,0.04525,172.31.33.0-255,66,210520,21,267274
1002,0.045275,172.217.194.0-255,1484,212004,21,267274
1003,0.047631,172.217.194.0-255,4320,216324,21,267274
1004,0.047637,172.31.33.0-255,66,216390,21,267274
1005,0.05007,172.217.194.0-255,5738,222128,21,267274
1006,0.050074,172.31.33.0-255,66,222194,21,267274
1007,0.052436,172.217.194.0-255,5738,227932,21,267274
1008,0.052441,172.31.33.0-255,66,227998,21,267274
1009,0.05481,172.217.194.0-255,5738,233736,21,267274
1010,0.054816,172.31.33.0-255,66,233802,21,267274
1011,0.057183,172.217.194.0-255,5738,239540,21,267274
1012,0.057188,172.31.33.0-255,66,239606,21,267274
1013,0.059559,172.217.194.0-255,5738,245344,21,267274
1014,0.059564,172.31.33.0-255,66,245410,21,267274
1015,0.06194,172.217.194.0-255,5738,251148,21,267274
1016,0.061946,172.31.33.0-255,66,251214,21,267274
1017,0.064339,172.217.194.0-255,5738,256952,21,267274
1018,0.064345,172.31.33.0-255,66,257018,21,267274
1019,0.066701,172.217.194.0-255,4320,261338,21,267274
1020,0.066706,172.31.33.0-255,66,261404,21,267274
1021,0.066729,172.217.194.0-255,1484,262888,21,267274
1022,0.069091,172.217.194.0-255,4320,267208,21,267274
1023,0.069096,172.31.33.0-255,66,267274,21,267274
1024,0.0,74.125.24.0-255,156,156,21,316759
1025,1.7e-05,172.31.33.0-255,66,222,21,316759
1026,2.3e-05,74.125.24.0-255,1484,1706,21,316759
1027,2.8e-05,172.31.33.0-255,66,1772,21,316759
1028,3.3e-05,74.125.24.0-255,2902,4674,21,316759
1029,3.5e-05,172.31.33.0-255,66,4740,21,316759
1030,3.8e-05,74.125.24.0-255,1484,6224,21,316759
1031,4e-05,172.31.33.0-255,66,6290,21,316759
1032,6.5e-05,74.125.24.0-255,2902,9192,21,316759
1033,6.7e-05,172.31.33.0-255,66,9258,21,316759
1034,7e-05,74.125.24.0-255,1484,10742,21,316759
1035,7.1e-05,172.31.33.0-255,66,10808,21,316759
1036,9.1e-05,74.125.24.0-255,5738,16546,21,316759
1037,9.3e-05,172.31.33.0-255,66,16612,21,316759
1038,0.000115,74.125.24.0-255,2059,18671,21,316759
1039,0.000117,172.31.33.0-255,66,18737,21,316759
1040,0.00013,172.31.33.0-255,66,18803,21,316759
1041,0.000173,172.31.33.0-255,66,18869,21,316759
1042,0.000199,172.31.33.0-255,66,18935,21,316759
1043,0.000203,74.125.24.0-255,2902,21837,21,316759
1044,0.000205,172.31.33.0-255,66,21903,21,316759
1045,0.000218,74.125.24.0-255,4320,26223,21,316759
1046,0.00022,172.31.33.0-255,66,26289,21,316759
1047,0.00024,74.125.24.0-255,7071,33360,21,316759
1048,0.000242,172.31.33.0-255,66,33426,21,316759
1049,0.000244,74.125.24.0-255,129,33555,21,316759
1050,0.000246,172.31.33.0-255,66,33621,21,316759
1051,0.000505,74.125.24.0-255,1484,35105,21,316759
1052,0.00051,172.31.33.0-255,66,35171,21,316759
1053,0.000514,74.125.24.0-255,1484,36655,21,316759
1054,0.000528,74.125.24.0-255,1484,38139,21,316759
1055,0.00053,172.31.33.0-255,66,38205,21,316759
1056,0.000535,74.125.24.0-255,2902,41107,21,316759
1057,0.000537,172.31.33.0-255,66,41173,21,316759
1058,0.000552,74.125.24.0-255,2902,44075,21,316759
1059,0.000554,172.31.33.0-255,66,44141,21,316759
1060,0.000559,74.125.24.0-255,5738,49879,21,316759
1061,0.000561,172.31.33.0-255,66,49945,21,316759
1062,0.000575,74.125.24.0-255,1484,51429,21,316759
1063,0.000582,74.125.24.0-255,7156,58585,21,316759
1064,0.000584,172.31.33.0-255,66,58651,21,316759
1065,0.000599,74.125.24.0-255,1484,60135,21,316759
1066,0.000616,74.125.24.0-255,2902,63037,21,316759
1067,0.000619,172.31.33.0-255,66,63103,21,316759
1068,0.000642,74.125.24.0-255,5020,68123,21,316759
1069,0.000644,172.31.33.0-255,66,68189,21,316759
1070,0.000647,74.125.24.0-255,1484,69673,21,316759
1071,0.000663,74.125.24.0-255,7156,76829,21,316759
1072,0.000665,172.31.33.0-255,66,76895,21,316759
1073,0.000669,74.125.24.0-255,2902,79797,21,316759
1074,0.00067,172.31.33.0-255,66,79863,21,316759
1075,0.000698,74.125.24.0-255,7156,87019,21,316759
1076,0.000701,172.31.33.0-255,66,87085,21,316759
1077,0.000713,74.125.24.0-255,2902,89987,21,316759
1078,0.000715,172.31.33.0-255,66,90053,21,316759
1079,0.000737,172.31.33.0-255,66,90119,21,316759
1080,0.000777,172.31.33.0-255,66,90185,21,316759
1081,0.000799,74.125.24.0-255,4320,94505,21,316759
1082,0.000801,172.31.33.0-255,66,94571,21,316759
1083,0.000814,172.31.33.0-255,66,94637,21,316759
1084,0.000818,74.125.24.0-255,3884,98521,21,316759
1085,0.000821,172.31.33.0-255,66,98587,21,316759
1086,0.000987,74.125.24.0-255,1484,100071,21,316759
1087,0.000992,74.125.24.0-255,2902,102973,21,316759
1088,0.000995,172.31.33.0-255,66,103039,21,316759
1089,0.001017,74.125.24.0-255,5738,108777,21,316759
1090,0.001019,172.31.33.0-255,66,108843,21,316759
1091,0.001041,74.125.24.0-255,5738,114581,21,316759
1092,0.001043,172.31.33.0-255,66,114647,21,316759
1093,0.001064,74.125.24.0-255,7156,121803,21,316759
1094,0.001066,172.31.33.0-255,66,121869,21,316759
1095,0.001109,74.125.24.0-255,5738,127607,21,316759
1096,0.001112,172.31.33.0-255,66,127673,21,316759
1097,0.001126,74.125.24.0-255,5020,132693,21,316759
1098,0.001129,172.31.33.0-255,66,132759,21,316759
1099,0.001147,74.125.24.0-255,1484,134243,21,316759
1100,0.001183,172.31.33.0-255,66,134309,21,316759
1101,0.001194,172.31.33.0-255,66,134375,21,316759
1102,0.001229,74.125.24.0-255,4320,138695,21,316759
1103,0.001232,172.31.33.0-255,66,138761,21,316759
1104,0.001253,74.125.24.0-255,6438,145199,21,316759
1105,0.001256,172.31.33.0-255,66,145265,21,316759
1106,0.002451,74.125.24.0-255,1484,146749,21,316759
1107,0.002469,74.125.24.0-255,1484,148233,21,316759
1108,0.002473,172.31.33.0-255,66,148299,21,316759
1109,0.003658,74.125.24.0-255,2902,151201,21,316759
1110,0.003663,172.31.33.0-255,66,151267,21,316759
1111,0.004885,74.125.24.0-255,2902,154169,21,316759
1112,0.004888,172.31.33.0-255,66,154235,21,316759
1113,0.006083,74.125.24.0-255,2902,157137,21,316759
1114,0.006089,172.31.33.0-255,66,157203,21,316759
1115,0.007352,74.125.24.0-255,2902,160105,21,316759
1116,0.007354,172.31.33.0-255,66,160171,21,316759
1117,0.008496,74.125.24.0-255,2902,163073,21,316759
1118,0.008502,172.31.33.0-255,66,163139,21,316759
1119,0.009769,74.125.24.0-255,2902,166041,21,316759
1120,0.009774,172.31.33.0-255,66,166107,21,316759
1121,0.010912,74.125.24.0-255,2902,169009,21,316759
1122,0.010918,172.31.33.0-255,66,169075,21,316759
1123,0.012185,74.125.24.0-255,2902,171977,21,316759
1124,0.012192,172.31.33.0-255,66,172043,21,316759
1125,0.013348,74.125.24.0-255,2902,174945,21,316759
1126,0.013354,172.31.33.0-255,66,175011,21,316759
1127,0.014627,74.125.24.0-255,2902,177913,21,316759
1128,0.014633,172.31.33.0-255,66,177979,21,316759
1129,0.01575,74.125.24.0-255,2902,180881,21,316759
1130,0.015756,172.31.33.0-255,66,180947,21,316759
1131,0.017054,74.125.24.0-255,2902,183849,21,316759
1132,0.017061,172.31.33.0-255,66,183915,21,316759
1133,0.018167,74.125.24.0-255,2902,186817,21,316759
1134,0.018173,172.31.33.0-255,66,186883,21,316759
1135,0.019492,74.125.24.0-255,2902,189785,21,316759
1136,0.019498,172.31.33.0-255,66,189851,21,316759
1137,0.020583,74.125.24.0-255,2902,192753,21,316759
1138,0.020589,172.31.33.0-255,66,192819,21,316759
1139,0.0219,74.125.24.0-255,2902,195721,21,316759
1140,0.021905,172.31.33.0-255,66,195787,21,316759
1141,0.023023,74.125.24.0-255,2902,198689,21,316759
1142,0.023029,172.31.33.0-255,66,198755,21,316759
1143,0.024331,74.125.24.0-255,2902,201657,21,316759
1144,0.024337,172.31.33.0-255,66,201723,21,316759
1145,0.025454,74.125.24.0-255,2902,204625,21,316759
1146,0.025459,172.31.33.0-255,66,204691,21,316759
1147,0.026776,74.125.24.0-255,2902,207593,21,316759
1148,0.026782,172.31.33.0-255,66,207659,21,316759
1149,0.027884,74.125.24.0-255,2902,210561,21,316759
1150,0.027891,172.31.33.0-255,66,210627,21,316759
1151,0.029202,74.125.24.0-255,2902,213529,21,316759
1152,0.029209,172.31.33.0-255,66,213595,21,316759
1153,0.030323,74.125.24.0-255,2902,216497,21,316759
1154,0.030328,172.31.33.0-255,66,216563,21,316759
1155,0.030924,172.31.33.0-255,192,216755,21,316759
1156,0.03095,172.31.33.0-255,1113,217868,21,316759
1157,0.030999,172.31.33.0-255,1514,219382,21,316759
1158,0.031001,172.31.33.0-255,1514,220896,21,316759
1159,0.031022,172.31.33.0-255,689,221585,21,316759
1160,0.03163,74.125.24.0-255,2902,224487,21,316759
1161,0.031635,172.31.33.0-255,66,224553,21,316759
1162,0.032585,104.244.42.0-255,66,224619,21,316759
1163,0.032627,104.244.42.0-255,66,224685,21,316759
1164,0.032676,104.244.42.0-255,66,224751,21,316759
1165,0.032748,74.125.24.0-255,2902,227653,21,316759
1166,0.032752,172.31.33.0-255,66,227719,21,316759
1167,0.034039,74.125.24.0-255,2902,230621,21,316759
1168,0.034043,172.31.33.0-255,66,230687,21,316759
1169,0.035219,74.125.24.0-255,2902,233589,21,316759
1170,0.035224,172.31.33.0-255,66,233655,21,316759
1171,0.036475,74.125.24.0-255,2902,236557,21,316759
1172,0.03648,172.31.33.0-255,66,236623,21,316759
1173,0.037661,74.125.24.0-255,2902,239525,21,316759
1174,0.037666,172.31.33.0-255,66,239591,21,316759
1175,0.038909,74.125.24.0-255,2902,242493,21,316759
1176,0.038917,172.31.33.0-255,66,242559,21,316759
1177,0.040154,74.125.24.0-255,2902,245461,21,316759
1178,0.040163,172.31.33.0-255,66,245527,21,316759
1179,0.041337,74.125.24.0-255,2902,248429,21,316759
1180,0.041342,172.31.33.0-255,66,248495,21,316759
1181,0.042573,74.125.24.0-255,2902,251397,21,316759
1182,0.042578,172.31.33.0-255,66,251463,21,316759
1183,0.043761,74.125.24.0-255,2902,254365,21,316759
1184,0.043766,172.31.33.0-255,66,254431,21,316759
1185,0.04498,74.125.24.0-255,2902,257333,21,316759
1186,0.044985,172.31.33.0-255,66,257399,21,316759
1187,0.046179,74.125.24.0-255,2902,260301,21,316759
1188,0.046185,172.31.33.0-255,66,260367,21,316759
1189,0.047429,74.125.24.0-255,2902,263269,21,316759
1190,0.047434,172.31.33.0-255,66,263335,21,316759
1191,0.048584,74.125.24.0-255,2902,266237,21,316759
1192,0.048592,172.31.33.0-255,66,266303,21,316759
1193,0.04986,74.125.24.0-255,2902,269205,21,316759
1194,0.049864,172.31.33.0-255,66,269271,21,316759
1195,0.051018,74.125.24.0-255,2902,272173,21,316759
1196,0.051023,172.31.33.0-255,66,272239,21,316759
1197,0.052305,74.125.24.0-255,2902,275141,21,316759
1198,0.05231,172.31.33.0-255,66,275207,21,316759
1199,0.05343,74.125.24.0-255,2902,278109,21,316759
1200,0.053435,172.31.33.0-255,66,278175,21,316759
1201,0.054743,74.125.24.0-255,2902,281077,21,316759
1202,0.054751,172.31.33.0-255,66,281143,21,316759
1203,0.055887,74.125.24.0-255,2902,284045,21,316759
1204,0.055893,172.31.33.0-255,66,284111,21,316759
1205,0.057209,74.125.24.0-255,2902,287013,21,316759
1206,0.057215,172.31.33.0-255,66,287079,21,316759
1207,0.058329,74.125.24.0-255,2902,289981,21,316759
1208,0.058335,172.31.33.0-255,66,290047,21,316759
1209,0.059614,74.125.24.0-255,2902,292949,21,316759
1210,0.059619,172.31.33.0-255,66,293015,21,316759
1211,0.060752,74.125.24.0-255,2902,295917,21,316759
1212,0.060757,172.31.33.0-255,66,295983,21,316759
1213,0.062038,74.125.24.0-255,2902,298885,21,316759
1214,0.062044,172.31.33.0-255,66,298951,21,316759
1215,0.063229,74.125.24.0-255,2902,301853,21,316759
1216,0.063233,172.31.33.0-255,66,301919,21,316759
1217,0.064456,74.125.24.0-255,2902,304821,21,316759
1218,0.064461,172.31.33.0-255,66,304887,21,316759
1219,0.065645,74.125.24.0-255,2902,307789,21,316759
1220,0.06565,172.31.33.0-255,66,307855,21,316759
1221,0.066855,74.125.24.0-255,2902,310757,21,316759
1222,0.06686,172.31.33.0-255,66,310823,21,316759
1223,0.068084,74.125.24.0-255,2902,313725,21,316759
1224,0.068091,172.31.33.0-255,66,313791,21,316759
1225,0.069303,74.125.24.0-255,2902,316693,21,316759
1226,0.069311,172.31.33.0-255,66,316759,21,316759
1227,0.0,172.217.194.0-255,153,153,21,312863
1228,1.7e-05,172.31.33.0-255,66,219,21,312863
1229,4.2e-05,172.217.194.0-255,1484,1703,21,312863
1230,4.7e-05,172.31.33.0-255,66,1769,21,312863
1231,5.2e-05,172.217.194.0-255,2902,4671,21,312863
1232,5.5e-05,172.31.33.0-255,66,4737,21,312863
1233,6.2e-05,172.217.194.0-255,7156,11893,21,312863
1234,6.4e-05,172.31.33.0-255,66,11959,21,312863
1235,9.9e-05,172.217.194.0-255,6275,18234,21,312863
1236,0.000105,172.31.33.0-255,66,18300,21,312863
1237,0.000112,172.217.194.0-255,7156,25456,21,312863
1238,0.000114,172.31.33.0-255,66,25522,21,312863
1239,0.000139,172.217.194.0-255,2902,28424,21,312863
1240,0.000141,172.31.33.0-255,66,28490,21,312863
1241,0.000162,172.217.194.0-255,2543,31033,21,312863
1242,0.000164,172.31.33.0-255,66,31099,21,312863
1243,0.000574,172.217.194.0-255,1484,32583,21,312863
1244,0.000579,172.31.33.0-255,66,32649,21,312863
1245,0.000607,172.217.194.0-255,2902,35551,21,312863
1246,0.00061,172.31.33.0-255,66,35617,21,312863
1247,0.000616,172.217.194.0-255,5738,41355,21,312863
1248,0.000618,172.31.33.0-255,66,41421,21,312863
1249,0.000622,172.217.194.0-255,2902,44323,21,312863
1250,0.000624,172.31.33.0-255,66,44389,21,312863
1251,0.000668,172.31.33.0-255,66,44455,21,312863
1252,0.000674,172.217.194.0-255,7156,51611,21,312863
1253,0.000676,172.31.33.0-255,66,51677,21,312863
1254,0.000697,172.217.194.0-255,3602,55279,21,312863
1255,0.000699,172.31.33.0-255,66,55345,21,312863
1256,0.000702,172.217.194.0-255,677,56022,21,312863
1257,0.000707,172.31.33.0-255,66,56088,21,312863
1258,0.000724,172.217.194.0-255,1484,57572,21,312863
1259,0.000747,172.217.194.0-255,4320,61892,21,312863
1260,0.000749,172.31.33.0-255,66,61958,21,312863
1261,0.000774,172.217.194.0-255,5738,67696,21,312863
1262,0.000777,172.31.33.0-255,66,67762,21,312863
1263,0.000814,172.217.194.0-255,4320,72082,21,312863
1264,0.000817,172.31.33.0-255,66,72148,21,312863
1265,0.000828,172.31.33.0-255,66,72214,21,312863
1266,0.000838,172.217.194.0-255,6438,78652,21,312863
1267,0.00084,172.31.33.0-255,66,78718,21,312863
1268,0.000846,172.217.194.0-255,7156,85874,21,312863
1269,0.000848,172.31.33.0-255,66,85940,21,312863
1270,0.000877,172.217.194.0-255,1484,87424,21,312863
1271,0.000906,172.31.33.0-255,66,87490,21,312863
1272,0.000916,172.31.33.0-255,66,87556,21,312863
1273,0.000925,172.217.194.0-255,5020,92576,21,312863
1274,0.000927,172.31.33.0-255,66,92642,21,312863
1275,0.000955,172.217.194.0-255,2902,95544,21,312863
1276,0.000957,172.31.33.0-255,66,95610,21,312863
1277,0.000962,172.217.194.0-255,4320,99930,21,312863
1278,0.000964,172.31.33.0-255,66,99996,21,312863
1279,0.000966,172.217.194.0-255,1484,101480,21,312863
1280,0.000993,172.217.194.0-255,7156,108636,21,312863
1281,0.000996,172.31.33.0-255,66,108702,21,312863
1282,0.001035,172.31.33.0-255,66,108768,21,312863
1283,0.002126,172.217.194.0-255,1484,110252,21,312863
1284,0.002134,172.217.194.0-255,2902,113154,21,312863
1285,0.002138,172.31.33.0-255,66,113220,21,312863
1286,0.002141,172.217.194.0-255,1484,114704,21,312863
1287,0.002167,172.217.194.0-255,4320,119024,21,312863
1288,0.002169,172.31.33.0-255,66,119090,21,312863
1289,0.002187,172.217.194.0-255,2902,121992,21,312863
1290,0.002189,172.31.33.0-255,66,122058,21,312863
1291,0.002218,172.217.194.0-255,5738,127796,21,312863
1292,0.002221,172.31.33.0-255,66,127862,21,312863
1293,0.002224,172.217.194.0-255,1484,129346,21,312863
1294,0.002254,172.31.33.0-255,66,129412,21,312863
1295,0.002387,172.217.194.0-255,1484,130896,21,312863
1296,0.002408,172.217.194.0-255,2902,133798,21,312863
1297,0.002411,172.31.33.0-255,66,133864,21,312863
1298,0.002415,172.217.194.0-255,2902,136766,21,312863
1299,0.002418,172.31.33.0-255,66,136832,21,312863
1300,0.002448,172.217.194.0-255,7156,143988,21,312863
1301,0.002451,172.31.33.0-255,66,144054,21,312863
1302,0.002478,172.217.194.0-255,5738,149792,21,312863
1303,0.002481,172.31.33.0-255,66,149858,21,312863
1304,0.002562,172.31.33.0-255,66,149924,21,312863
1305,0.002567,172.217.194.0-255,3602,153526,21,312863
1306,0.002569,172.31.33.0-255,66,153592,21,312863
1307,0.005003,172.217.194.0-255,4320,157912,21,312863
1308,0.005006,172.31.33.0-255,66,157978,21,312863
1309,0.005029,172.217.194.0-255,1484,159462,21,312863
1310,0.00746,172.217.194.0-255,4320,163782,21,312863
1311,0.007466,172.31.33.0-255,66,163848,21,312863
1312,0.009942,172.217.194.0-255,5738,169586,21,312863
1313,0.009949,172.31.33.0-255,66,169652,21,312863
1314,0.012437,172.217.194.0-255,5738,175390,21,312863
1315,0.012444,172.31.33.0-255,66,175456,21,312863
1316,0.014935,172.217.194.0-255,5738,181194,21,312863
1317,0.014946,172.31.33.0-255,66,181260,21,312863
1318,0.017413,172.217.194.0-255,5738,186998,21,312863
1319,0.01742,172.31.33.0-255,66,187064,21,312863
1320,0.019896,172.217.194.0-255,5738,192802,21,312863
1321,0.019903,172.31.33.0-255,66,192868,21,312863
1322,0.022379,172.217.194.0-255,5738,198606,21,312863
1323,0.022386,172.31.33.0-255,66,198672,21,312863
1324,0.024867,172.217.194.0-255,5738,204410,21,312863
1325,0.024874,172.31.33.0-255,66,204476,21,312863
1326,0.027399,172.217.194.0-255,5738,210214,21,312863
1327,0.027407,172.31.33.0-255,66,210280,21,312863
1328,0.02809,172.31.33.0-255,172,210452,21,312863
1329,0.028117,172.31.33.0-255,1113,211565,21,312863
1330,0.028165,172.31.33.0-255,1514,213079,21,312863
1331,0.028167,172.31.33.0-255,1514,214593,21,312863
1332,0.028189,172.31.33.0-255,690,215283,21,312863
1333,0.02971,104.244.42.0-255,66,215349,21,312863
1334,0.029757,104.244.42.0-255,66,215415,21,312863
1335,0.029796,104.244.42.0-255,66,215481,21,312863
1336,0.029799,104.244.42.0-255,66,215547,21,312863
1337,0.029832,172.217.194.0-255,4320,219867,21,312863
1338,0.029836,172.31.33.0-255,66,219933,21,312863
1339,0.029863,172.217.194.0-255,1484,221417,21,312863
1340,0.032303,172.217.194.0-255,4320,225737,21,312863
1341,0.032309,172.31.33.0-255,66,225803,21,312863
1342,0.03476,172.217.194.0-255,5738,231541,21,312863
1343,0.034763,172.31.33.0-255,66,231607,21,312863
1344,0.037208,172.217.194.0-255,5738,237345,21,312863
1345,0.037224,172.31.33.0-255,66,237411,21,312863
1346,0.039725,172.217.194.0-255,5738,243149,21,312863
1347,0.039732,172.31.33.0-255,66,243215,21,312863
1348,0.042222,172.217.194.0-255,5738,248953,21,312863
1349,0.042229,172.31.33.0-255,66,249019,21,312863
1350,0.044682,172.217.194.0-255,5738,254757,21,312863
1351,0.044688,172.31.33.0-255,66,254823,21,312863
1352,0.047138,172.217.194.0-255,5738,260561,21,312863
1353,0.047143,172.31.33.0-255,66,260627,21,312863
1354,0.049596,172.217.194.0-255,5738,266365,21,312863
1355,0.049602,172.31.33.0-255,66,266431,21,312863
1356,0.052089,172.217.194.0-255,5738,272169,21,312863
1357,0.052096,172.31.33.0-255,66,272235,21,312863
1358,0.054592,172.217.194.0-255,5738,277973,21,312863
1359,0.054599,172.31.33.0-255,66,278039,21,312863
1360,0.057072,172.217.194.0-255,5738,283777,21,312863
1361,0.057078,172.31.33.0-255,66,283843,21,312863
1362,0.059558,172.217.194.0-255,5738,289581,21,312863
1363,0.059563,172.31.33.0-255,66,289647,21,312863
1364,0.062027,172.217.194.0-255,5738,295385,21,312863
1365,0.062033,172.31.33.0-255,66,295451,21,312863
1366,0.064511,172.217.194.0-255,5738,301189,21,312863
1367,0.064517,172.31.33.0-255,66,301255,21,312863
1368,0.067002,172.217.194.0-255,5738,306993,21,312863
1369,0.067008,172.31.33.0-255,66,307059,21,312863
1370,0.069485,172.217.194.0-255,5738,312797,21,312863
1371,0.069494,172.31.33.0-255,66,312863,21,312863
1372,0.0,172.217.194.0-255,153,153,21,325246
1373,2e-05,172.31.33.0-255,66,219,21,325246
1374,3.9e-05,172.217.194.0-255,1484,1703,21,325246
1375,4.8e-05,172.31.33.0-255,66,1769,21,325246
1376,5.3e-05,172.217.194.0-255,2902,4671,21,325246
1377,5.5e-05,172.31.33.0-255,66,4737,21,325246
1378,5.9e-05,172.217.194.0-255,2902,7639,21,325246
1379,6.1e-05,172.31.33.0-255,66,7705,21,325246
1380,0.000101,172.217.194.0-255,4320,12025,21,325246
1381,0.000104,172.31.33.0-255,66,12091,21,325246
1382,0.000123,172.217.194.0-255,2011,14102,21,325246
1383,0.000125,172.31.33.0-255,66,14168,21,325246
1384,0.000147,172.217.194.0-255,7156,21324,21,325246
1385,0.00015,172.31.33.0-255,66,21390,21,325246
1386,0.000177,172.217.194.0-255,5738,27128,21,325246
1387,0.000179,172.31.33.0-255,66,27194,21,325246
1388,0.000204,172.217.194.0-255,3961,31155,21,325246
1389,0.000206,172.31.33.0-255,66,31221,21,325246
1390,0.000249,172.217.194.0-255,2902,34123,21,325246
1391,0.000253,172.31.33.0-255,66,34189,21,325246
1392,0.000256,172.217.194.0-255,1484,35673,21,325246
1393,0.000257,172.31.33.0-255,66,35739,21,325246
1394,0.000292,172.217.194.0-255,2902,38641,21,325246
1395,0.000295,172.31.33.0-255,66,38707,21,325246
1396,0.000304,172.31.33.0-255,66,38773,21,325246
1397,0.000309,172.217.194.0-255,4320,43093,21,325246
1398,0.000316,172.31.33.0-255,66,43159,21,325246
1399,0.000346,172.217.194.0-255,6797,49956,21,325246
1400,0.000349,172.31.33.0-255,66,50022,21,325246
1401,0.000353,172.217.194.0-255,2902,52924,21,325246
1402,0.000355,172.31.33.0-255,66,52990,21,325246
1403,0.000379,172.217.194.0-255,3961,56951,21,325246
1404,0.000385,172.31.33.0-255,66,57017,21,325246
1405,0.000496,172.217.194.0-255,647,57664,21,325246
1406,0.000607,172.217.194.0-255,1484,59148,21,325246
1407,0.000611,172.31.33.0-255,66,59214,21,325246
1408,0.000615,172.217.194.0-255,2902,62116,21,325246
1409,0.000616,172.31.33.0-255,66,62182,21,325246
1410,0.000646,172.217.194.0-255,5738,67920,21,325246
1411,0.000648,172.31.33.0-255,66,67986,21,325246
1412,0.000668,172.217.194.0-255,7156,75142,21,325246
1413,0.000671,172.31.33.0-255,66,75208,21,325246
1414,0.000688,172.217.194.0-255,5738,80946,21,325246
1415,0.00069,172.217.194.0-255,1484,82430,21,325246
1416,0.000692,172.31.33.0-255,66,82496,21,325246
1417,0.000701,172.217.194.0-255,1484,83980,21,325246
1418,0.000703,172.31.33.0-255,66,84046,21,325246
1419,0.000737,172.31.33.0-255,66,84112,21,325246
1420,0.00113,172.217.194.0-255,1484,85596,21,325246
1421,0.001138,172.217.194.0-255,2902,88498,21,325246
1422,0.001141,172.31.33.0-255,66,88564,21,325246
1423,0.001147,172.217.194.0-255,5738,94302,21,325246
1424,0.001149,172.31.33.0-255,66,94368,21,325246
1425,0.001184,172.31.33.0-255,66,94434,21,325246
1426,0.001212,172.217.194.0-255,4320,98754,21,325246
1427,0.001214,172.31.33.0-255,66,98820,21,325246
1428,0.001241,172.217.194.0-255,6438,105258,21,325246
1429,0.001244,172.31.33.0-255,66,105324,21,325246
1430,0.001277,172.31.33.0-255,66,105390,21,325246
1431,0.001281,172.217.194.0-255,2902,108292,21,325246
1432,0.001283,172.31.33.0-255,66,108358,21,325246
1433,0.001308,172.217.194.0-255,2902,111260,21,325246
1434,0.001311,172.31.33.0-255,66,111326,21,325246
1435,0.001338,172.217.194.0-255,4320,115646,21,325246
1436,0.00134,172.31.33.0-255,66,115712,21,325246
1437,0.001375,172.31.33.0-255,66,115778,21,325246
1438,0.001399,172.217.194.0-255,1484,117262,21,325246
1439,0.001406,172.217.194.0-255,2902,120164,21,325246
1440,0.001408,172.31.33.0-255,66,120230,21,325246
1441,0.001411,172.217.194.0-255,1484,121714,21,325246
1442,0.001437,172.217.194.0-255,4320,126034,21,325246
1443,0.001439,172.31.33.0-255,66,126100,21,325246
1444,0.001488,172.217.194.0-255,7156,133256,21,325246
1445,0.00149,172.31.33.0-255,66,133322,21,325246
1446,0.001517,172.217.194.0-255,4320,137642,21,325246
1447,0.001519,172.31.33.0-255,66,137708,21,325246
1448,0.001687,172.217.194.0-255,1484,139192,21,325246
1449,0.001691,172.217.194.0-255,2902,142094,21,325246
1450,0.001705,172.217.194.0-255,1484,143578,21,325246
1451,0.001722,172.217.194.0-255,4320,147898,21,325246
1452,0.001724,172.217.194.0-255,1484,149382,21,325246
1453,0.001739,172.217.194.0-255,4320,153702,21,325246
1454,0.001748,172.217.194.0-255,1484,155186,21,325246
1455,0.001776,172.217.194.0-255,1484,156670,21,325246
1456,0.001779,172.217.194.0-255,2184,158854,21,325246
1457,0.001833,172.217.194.0-255,4320,163174,21,325246
1458,0.001867,172.217.194.0-255,5738,168912,21,325246
1459,0.001869,172.217.194.0-255,1484,170396,21,325246
1460,0.001886,172.217.194.0-255,2902,173298,21,325246
1461,0.001921,172.217.194.0-255,2184,175482,21,325246
1462,0.001944,172.217.194.0-255,1484,176966,21,325246
1463,0.001956,172.217.194.0-255,2902,179868,21,325246
1464,0.001972,172.217.194.0-255,5738,185606,21,325246
1465,0.001992,172.217.194.0-255,5738,191344,21,325246
1466,0.002025,172.217.194.0-255,4320,195664,21,325246
1467,0.002041,172.217.194.0-255,2902,198566,21,325246
1468,0.002051,172.217.194.0-255,2184,200750,21,325246
1469,0.005798,172.31.33.0-255,66,200816,21,325246
1470,0.008129,172.217.194.0-255,5738,206554,21,325246
1471,0.008142,172.31.33.0-255,66,206620,21,325246
1472,0.010438,172.217.194.0-255,5738,212358,21,325246
1473,0.010454,172.31.33.0-255,66,212424,21,325246
1474,0.012776,172.217.194.0-255,5738,218162,21,325246
1475,0.012787,172.31.33.0-255,66,218228,21,325246
1476,0.015082,172.217.194.0-255,5738,223966,21,325246
1477,0.015089,172.31.33.0-255,66,224032,21,325246
1478,0.017402,172.217.194.0-255,5738,229770,21,325246
1479,0.017409,172.31.33.0-255,66,229836,21,325246
1480,0.019707,172.217.194.0-255,5738,235574,21,325246
1481,0.019714,172.31.33.0-255,66,235640,21,325246
1482,0.021996,172.217.194.0-255,5738,241378,21,325246
1483,0.022008,172.31.33.0-255,66,241444,21,325246
1484,0.024306,172.217.194.0-255,5738,247182,21,325246
1485,0.024321,172.31.33.0-255,66,247248,21,325246
1486,0.026607,172.217.194.0-255,5738,252986,21,325246
1487,0.026614,172.31.33.0-255,66,253052,21,325246
1488,0.028983,172.217.194.0-255,5738,258790,21,325246
1489,0.029004,172.31.33.0-255,66,258856,21,325246
1490,0.031322,172.217.194.0-255,5738,264594,21,325246
1491,0.031329,172.31.33.0-255,66,264660,21,325246
1492,0.033657,172.217.194.0-255,5738,270398,21,325246
1493,0.033664,172.31.33.0-255,66,270464,21,325246
1494,0.035959,172.217.194.0-255,5738,276202,21,325246
1495,0.035968,172.31.33.0-255,66,276268,21,325246
1496,0.038296,172.217.194.0-255,5738,282006,21,325246
1497,0.038306,172.31.33.0-255,66,282072,21,325246
1498,0.040598,172.217.194.0-255,5738,287810,21,325246
1499,0.040607,172.31.33.0-255,66,287876,21,325246
1500,0.04062,172.31.33.0-255,172,288048,21,325246
1501,0.04065,172.31.33.0-255,1113,289161,21,325246
1502,0.040692,172.31.33.0-255,1514,290675,21,325246
1503,0.040694,172.31.33.0-255,1514,292189,21,325246
1504,0.040695,172.31.33.0-255,1514,293703,21,325246
1505,0.040696,172.31.33.0-255,1068,294771,21,325246
1506,0.042192,104.244.42.0-255,66,294837,21,325246
1507,0.04224,104.244.42.0-255,66,294903,21,325246
1508,0.042298,104.244.42.0-255,66,294969,21,325246
1509,0.042301,104.244.42.0-255,66,295035,21,325246
1510,0.042878,172.217.194.0-255,2902,297937,21,325246
1511,0.042882,172.31.33.0-255,66,298003,21,325246
1512,0.042919,172.217.194.0-255,2902,300905,21,325246
1513,0.042922,172.31.33.0-255,66,300971,21,325246
1514,0.045158,172.217.194.0-255,2902,303873,21,325246
1515,0.045163,172.31.33.0-255,66,303939,21,325246
1516,0.045214,172.217.194.0-255,2902,306841,21,325246
1517,0.045218,172.31.33.0-255,66,306907,21,325246
1518,0.047456,172.217.194.0-255,2902,309809,21,325246
1519,0.047463,172.31.33.0-255,66,309875,21,325246
1520,0.047505,172.217.194.0-255,2902,312777,21,325246
1521,0.047508,172.31.33.0-255,66,312843,21,325246
1522,0.049737,172.217.194.0-255,2902,315745,21,325246
1523,0.049743,172.31.33.0-255,66,315811,21,325246
1524,0.049871,172.217.194.0-255,2902,318713,21,325246
1525,0.049876,172.31.33.0-255,66,318779,21,325246
1526,0.052009,172.217.194.0-255,1484,320263,21,325246
1527,0.052035,172.217.194.0-255,1484,321747,21,325246
1528,0.05204,172.31.33.0-255,66,321813,21,325246
1529,0.052176,172.217.194.0-255,2902,324715,21,325246
1530,0.052181,172.31.33.0-255,66,324781,21,325246
1531,0.054324,172.217.194.0-255,228,325009,21,325246
1532,0.054443,172.31.33.0-255,66,325075,21,325246
1533,0.054471,172.31.33.0-255,105,325180,21,325246
1534,0.056736,172.217.194.0-255,66,325246,21,325246
1535,0.0,172.217.194.0-255,153,153,21,247384
1536,2.6e-05,172.31.33.0-255,66,219,21,247384
1537,3.2e-05,172.217.194.0-255,1484,1703,21,247384
1538,3.6e-05,172.31.33.0-255,66,1769,21,247384
1539,4e-05,172.217.194.0-255,2902,4671,21,247384
1540,4.3e-05,172.31.33.0-255,66,4737,21,247384
1541,5.1e-05,172.217.194.0-255,7156,11893,21,247384
1542,5.3e-05,172.31.33.0-255,66,11959,21,247384
1543,6.6e-05,172.217.194.0-255,1484,13443,21,247384
1544,6.9e-05,172.31.33.0-255,66,13509,21,247384
1545,8.9e-05,172.217.194.0-255,642,14151,21,247384
1546,9.1e-05,172.31.33.0-255,66,14217,21,247384
1547,0.000184,172.217.194.0-255,1484,15701,21,247384
1548,0.000188,172.31.33.0-255,66,15767,21,247384
1549,0.000193,172.217.194.0-255,2902,18669,21,247384
1550,0.000196,172.31.33.0-255,66,18735,21,247384
1551,0.000198,172.217.194.0-255,1484,20219,21,247384
1552,0.0002,172.31.33.0-255,66,20285,21,247384
1553,0.000215,172.217.194.0-255,4320,24605,21,247384
1554,0.000217,172.31.33.0-255,66,24671,21,247384
1555,0.000243,172.217.194.0-255,4320,28991,21,247384
1556,0.000246,172.31.33.0-255,66,29057,21,247384
1557,0.000271,172.31.33.0-255,66,29123,21,247384
1558,0.000276,172.217.194.0-255,4320,33443,21,247384
1559,0.000279,172.31.33.0-255,66,33509,21,247384
1560,0.000307,172.217.194.0-255,5379,38888,21,247384
1561,0.00031,172.31.33.0-255,66,38954,21,247384
1562,0.000765,172.217.194.0-255,1484,40438,21,247384
1563,0.00077,172.31.33.0-255,66,40504,21,247384
1564,0.000778,172.217.194.0-255,2902,43406,21,247384
1565,0.000781,172.31.33.0-255,66,43472,21,247384
1566,0.000803,172.217.194.0-255,5738,49210,21,247384
1567,0.000806,172.31.33.0-255,66,49276,21,247384
1568,0.000826,172.217.194.0-255,4320,53596,21,247384
1569,0.000829,172.31.33.0-255,66,53662,21,247384
1570,0.000849,172.217.194.0-255,3122,56784,21,247384
1571,0.000852,172.31.33.0-255,66,56850,21,247384
1572,0.000887,172.217.194.0-255,4320,61170,21,247384
1573,0.00089,172.31.33.0-255,66,61236,21,247384
1574,0.00091,172.217.194.0-255,4320,65556,21,247384
1575,0.000913,172.31.33.0-255,66,65622,21,247384
1576,0.000922,172.31.33.0-255,66,65688,21,247384
1577,0.000926,172.217.194.0-255,2902,68590,21,247384
1578,0.000928,172.31.33.0-255,66,68656,21,247384
1579,0.000963,172.31.33.0-255,66,68722,21,247384
1580,0.002094,172.217.194.0-255,1484,70206,21,247384
1581,0.0021,172.217.194.0-255,1484,71690,21,247384
1582,0.002103,172.31.33.0-255,66,71756,21,247384
1583,0.002117,172.217.194.0-255,1484,73240,21,247384
1584,0.002122,172.217.194.0-255,4320,77560,21,247384
1585,0.002124,172.31.33.0-255,66,77626,21,247384
1586,0.002143,172.217.194.0-255,1484,79110,21,247384
1587,0.002145,172.217.194.0-255,1484,80594,21,247384
1588,0.002146,172.31.33.0-255,66,80660,21,247384
1589,0.002155,172.31.33.0-255,66,80726,21,247384
1590,0.002195,172.31.33.0-255,66,80792,21,247384
1591,0.004556,172.217.194.0-255,1484,82276,21,247384
1592,0.004567,172.217.194.0-255,2902,85178,21,247384
1593,0.00457,172.31.33.0-255,66,85244,21,247384
1594,0.004585,172.217.194.0-255,1484,86728,21,247384
1595,0.006892,172.217.194.0-255,4320,91048,21,247384
1596,0.006898,172.31.33.0-255,66,91114,21,247384
1597,0.009248,172.217.194.0-255,5738,96852,21,247384
1598,0.009255,172.31.33.0-255,66,96918,21,247384
1599,0.011604,172.217.194.0-255,5738,102656,21,247384
1600,0.011611,172.31.33.0-255,66,102722,21,247384
1601,0.01395,172.217.194.0-255,5738,108460,21,247384
1602,0.013958,172.31.33.0-255,66,108526,21,247384
1603,0.016333,172.217.194.0-255,5738,114264,21,247384
1604,0.01634,172.31.33.0-255,66,114330,21,247384
1605,0.018682,172.217.194.0-255,5738,120068,21,247384
1606,0.018688,172.31.33.0-255,66,120134,21,247384
1607,0.021056,172.217.194.0-255,5738,125872,21,247384
1608,0.021063,172.31.33.0-255,66,125938,21,247384
1609,0.023399,172.217.194.0-255,5738,131676,21,247384
1610,0.023406,172.31.33.0-255,66,131742,21,247384
1611,0.02575,172.217.194.0-255,5738,137480,21,247384
1612,0.025758,172.31.33.0-255,66,137546,21,247384
1613,0.027011,172.31.33.0-255,172,137718,21,247384
1614,0.027042,172.31.33.0-255,1113,138831,21,247384
1615,0.027072,172.31.33.0-255,1514,140345,21,247384
1616,0.027073,172.31.33.0-255,1514,141859,21,247384
1617,0.027094,172.31.33.0-255,689,142548,21,247384
1618,0.028085,172.217.194.0-255,5738,148286,21,247384
1619,0.028091,172.31.33.0-255,66,148352,21,247384
1620,0.028588,104.244.42.0-255,66,148418,21,247384
1621,0.028622,104.244.42.0-255,66,148484,21,247384
1622,0.028632,104.244.42.0-255,66,148550,21,247384
1623,0.028634,104.244.42.0-255,66,148616,21,247384
1624,0.030433,172.217.194.0-255,2902,151518,21,247384
1625,0.030437,172.31.33.0-255,66,151584,21,247384
1626,0.030467,172.217.194.0-255,2902,154486,21,247384
1627,0.03047,172.31.33.0-255,66,154552,21,247384
1628,0.032771,172.217.194.0-255,2902,157454,21,247384
1629,0.032775,172.31.33.0-255,66,157520,21,247384
1630,0.032825,172.217.194.0-255,2902,160422,21,247384
1631,0.032828,172.31.33.0-255,66,160488,21,247384
1632,0.035114,172.217.194.0-255,2902,163390,21,247384
1633,0.035118,172.31.33.0-255,66,163456,21,247384
1634,0.035163,172.217.194.0-255,2902,166358,21,247384
1635,0.035167,172.31.33.0-255,66,166424,21,247384
1636,0.037442,172.217.194.0-255,2902,169326,21,247384
1637,0.037446,172.31.33.0-255,66,169392,21,247384
1638,0.03748,172.217.194.0-255,1484,170876,21,247384
1639,0.037497,172.217.194.0-255,1484,172360,21,247384
1640,0.037499,172.31.33.0-255,66,172426,21,247384
1641,0.039806,172.217.194.0-255,2902,175328,21,247384
1642,0.039812,172.31.33.0-255,66,175394,21,247384
1643,0.039847,172.217.194.0-255,2902,178296,21,247384
1644,0.03985,172.31.33.0-255,66,178362,21,247384
1645,0.042141,172.217.194.0-255,2902,181264,21,247384
1646,0.042146,172.31.33.0-255,66,181330,21,247384
1647,0.042171,172.217.194.0-255,1484,182814,21,247384
1648,0.042188,172.217.194.0-255,1484,184298,21,247384
1649,0.042191,172.31.33.0-255,66,184364,21,247384
1650,0.044487,172.217.194.0-255,2902,187266,21,247384
1651,0.044491,172.31.33.0-255,66,187332,21,247384
1652,0.04453,172.217.194.0-255,2902,190234,21,247384
1653,0.044533,172.31.33.0-255,66,190300,21,247384
1654,0.046818,172.217.194.0-255,2902,193202,21,247384
1655,0.046822,172.31.33.0-255,66,193268,21,247384
1656,0.046858,172.217.194.0-255,2902,196170,21,247384
1657,0.046861,172.31.33.0-255,66,196236,21,247384
1658,0.049184,172.217.194.0-255,2902,199138,21,247384
1659,0.049191,172.31.33.0-255,66,199204,21,247384
1660,0.049212,172.217.194.0-255,2902,202106,21,247384
1661,0.049214,172.31.33.0-255,66,202172,21,247384
1662,0.051571,172.217.194.0-255,4320,206492,21,247384
1663,0.051575,172.31.33.0-255,66,206558,21,247384
1664,0.051604,172.217.194.0-255,1484,208042,21,247384
1665,0.053918,172.217.194.0-255,4320,212362,21,247384
1666,0.053922,172.31.33.0-255,66,212428,21,247384
1667,0.056273,172.217.194.0-255,5738,218166,21,247384
1668,0.056279,172.31.33.0-255,66,218232,21,247384
1669,0.058646,172.217.194.0-255,1484,219716,21,247384
1670,0.058677,172.217.194.0-255,4320,224036,21,247384
1671,0.058681,172.31.33.0-255,66,224102,21,247384
1672,0.061087,172.217.194.0-255,5738,229840,21,247384
1673,0.061093,172.31.33.0-255,66,229906,21,247384
1674,0.063464,172.217.194.0-255,5738,235644,21,247384
1675,0.063469,172.31.33.0-255,66,235710,21,247384
1676,0.065803,172.217.194.0-255,5738,241448,21,247384
1677,0.065808,172.31.33.0-255,66,241514,21,247384
1678,0.068172,172.217.194.0-255,4320,245834,21,247384
1679,0.068177,172.31.33.0-255,66,245900,21,247384
1680,0.068205,172.217.194.0-255,1484,247384,21,247384
1681,0.0,74.125.24.0-255,154,154,21,267005
1682,1.4e-05,172.31.33.0-255,66,220,21,267005
1683,2e-05,74.125.24.0-255,1484,1704,21,267005
1684,2.4e-05,172.31.33.0-255,66,1770,21,267005
1685,4.6e-05,74.125.24.0-255,2902,4672,21,267005
1686,4.9e-05,172.31.33.0-255,66,4738,21,267005
1687,5.8e-05,74.125.24.0-255,4320,9058,21,267005
1688,6e-05,172.31.33.0-255,66,9124,21,267005
1689,7.9e-05,74.125.24.0-255,2902,12026,21,267005
1690,8.1e-05,172.31.33.0-255,66,12092,21,267005
1691,0.000118,74.125.24.0-255,2054,14146,21,267005
1692,0.000121,172.31.33.0-255,66,14212,21,267005
1693,0.000135,172.31.33.0-255,66,14278,21,267005
1694,0.000141,74.125.24.0-255,5379,19657,21,267005
1695,0.000143,172.31.33.0-255,66,19723,21,267005
1696,0.0003,74.125.24.0-255,1484,21207,21,267005
1697,0.000304,172.31.33.0-255,66,21273,21,267005
1698,0.00031,74.125.24.0-255,2902,24175,21,267005
1699,0.000311,172.31.33.0-255,66,24241,21,267005
1700,0.000338,74.125.24.0-255,5738,29979,21,267005
1701,0.00034,172.31.33.0-255,66,30045,21,267005
1702,0.000373,172.31.33.0-255,66,30111,21,267005
1703,0.000411,74.125.24.0-255,4320,34431,21,267005
1704,0.000413,172.31.33.0-255,66,34497,21,267005
1705,0.000431,74.125.24.0-255,6733,41230,21,267005
1706,0.000433,172.31.33.0-255,66,41296,21,267005
1707,0.000665,74.125.24.0-255,134,41430,21,267005
1708,0.000671,172.31.33.0-255,66,41496,21,267005
1709,0.000865,74.125.24.0-255,1484,42980,21,267005
1710,0.000869,172.31.33.0-255,66,43046,21,267005
1711,0.000885,74.125.24.0-255,2902,45948,21,267005
1712,0.000887,172.31.33.0-255,66,46014,21,267005
1713,0.000912,74.125.24.0-255,5738,51752,21,267005
1714,0.000916,172.31.33.0-255,66,51818,21,267005
1715,0.000941,74.125.24.0-255,4320,56138,21,267005
1716,0.000943,172.31.33.0-255,66,56204,21,267005
1717,0.000965,74.125.24.0-255,1484,57688,21,267005
1718,0.00098,172.31.33.0-255,66,57754,21,267005
1719,0.000984,74.125.24.0-255,2902,60656,21,267005
1720,0.000986,172.31.33.0-255,66,60722,21,267005
1721,0.000989,74.125.24.0-255,1484,62206,21,267005
1722,0.001013,74.125.24.0-255,3602,65808,21,267005
1723,0.001016,172.31.33.0-255,66,65874,21,267005
1724,0.001088,74.125.24.0-255,1484,67358,21,267005
1725,0.0011,74.125.24.0-255,1484,68842,21,267005
1726,0.001103,172.31.33.0-255,66,68908,21,267005
1727,0.001126,74.125.24.0-255,1484,70392,21,267005
1728,0.001132,74.125.24.0-255,5738,76130,21,267005
1729,0.001135,172.31.33.0-255,66,76196,21,267005
1730,0.001141,74.125.24.0-255,7156,83352,21,267005
1731,0.001143,172.31.33.0-255,66,83418,21,267005
1732,0.001168,74.125.24.0-255,5738,89156,21,267005
1733,0.00117,172.31.33.0-255,66,89222,21,267005
1734,0.00118,172.31.33.0-255,66,89288,21,267005
1735,0.001206,74.125.24.0-255,2184,91472,21,267005
1736,0.001209,172.31.33.0-255,66,91538,21,267005
1737,0.001255,74.125.24.0-255,1484,93022,21,267005
1738,0.001261,74.125.24.0-255,2902,95924,21,267005
1739,0.001263,172.31.33.0-255,66,95990,21,267005
1740,0.001292,74.125.24.0-255,5738,101728,21,267005
1741,0.001295,172.31.33.0-255,66,101794,21,267005
1742,0.001298,74.125.24.0-255,1484,103278,21,267005
1743,0.00132,74.125.24.0-255,7156,110434,21,267005
1744,0.001323,172.31.33.0-255,66,110500,21,267005
1745,0.001351,74.125.24.0-255,4320,114820,21,267005
1746,0.001362,172.31.33.0-255,66,114886,21,267005
1747,0.001368,172.31.33.0-255,66,114952,21,267005
1748,0.001372,74.125.24.0-255,2184,117136,21,267005
1749,0.001374,172.31.33.0-255,66,117202,21,267005
1750,0.001421,74.125.24.0-255,1484,118686,21,267005
1751,0.001424,74.125.24.0-255,1484,120170,21,267005
1752,0.001426,172.31.33.0-255,66,120236,21,267005
1753,0.00145,74.125.24.0-255,1484,121720,21,267005
1754,0.001455,74.125.24.0-255,5738,127458,21,267005
1755,0.001459,172.31.33.0-255,66,127524,21,267005
1756,0.001484,74.125.24.0-255,4320,131844,21,267005
1757,0.001486,172.31.33.0-255,66,131910,21,267005
1758,0.001507,74.125.24.0-255,1484,133394,21,267005
1759,0.001511,172.31.33.0-255,66,133460,21,267005
1760,0.001579,74.125.24.0-255,4320,137780,21,267005
1761,0.001582,172.31.33.0-255,66,137846,21,267005
1762,0.001613,172.31.33.0-255,66,137912,21,267005
1763,0.001629,172.31.33.0-255,66,137978,21,267005
1764,0.001634,74.125.24.0-255,4320,142298,21,267005
1765,0.001636,172.31.33.0-255,66,142364,21,267005
1766,0.001647,172.31.33.0-255,66,142430,21,267005
1767,0.001671,74.125.24.0-255,3602,146032,21,267005
1768,0.001677,172.31.33.0-255,66,146098,21,267005
1769,0.001697,74.125.24.0-255,1484,147582,21,267005
1770,0.001701,74.125.24.0-255,2902,150484,21,267005
1771,0.001704,172.31.33.0-255,66,150550,21,267005
1772,0.001732,74.125.24.0-255,5738,156288,21,267005
1773,0.001735,172.31.33.0-255,66,156354,21,267005
1774,0.001739,74.125.24.0-255,2902,159256,21,267005
1775,0.001741,172.31.33.0-255,66,159322,21,267005
1776,0.001797,172.31.33.0-255,66,159388,21,267005
1777,0.001802,74.125.24.0-255,4320,163708,21,267005
1778,0.001804,172.31.33.0-255,66,163774,21,267005
1779,0.001846,74.125.24.0-255,6438,170212,21,267005
1780,0.001849,172.31.33.0-255,66,170278,21,267005
1781,0.001963,74.125.24.0-255,1484,171762,21,267005
1782,0.001975,74.125.24.0-255,2902,174664,21,267005
1783,0.001978,172.31.33.0-255,66,174730,21,267005
1784,0.002005,74.125.24.0-255,5738,180468,21,267005
1785,0.002008,172.31.33.0-255,66,180534,21,267005
1786,0.002031,74.125.24.0-255,7156,187690,21,267005
1787,0.002033,172.31.33.0-255,66,187756,21,267005
1788,0.00206,74.125.24.0-255,5738,193494,21,267005
1789,0.002062,172.31.33.0-255,66,193560,21,267005
1790,0.00209,74.125.24.0-255,4320,197880,21,267005
1791,0.002093,172.31.33.0-255,66,197946,21,267005
1792,0.002127,172.31.33.0-255,66,198012,21,267005
1793,0.002145,172.31.33.0-255,66,198078,21,267005
1794,0.002154,172.31.33.0-255,66,198144,21,267005
1795,0.002179,74.125.24.0-255,4320,202464,21,267005
1796,0.002185,172.31.33.0-255,66,202530,21,267005
1797,0.002187,74.125.24.0-255,1484,204014,21,267005
1798,0.002218,172.31.33.0-255,66,204080,21,267005
1799,0.002221,74.125.24.0-255,1484,205564,21,267005
1800,0.002251,172.31.33.0-255,66,205630,21,267005
1801,0.002258,74.125.24.0-255,7156,212786,21,267005
1802,0.00226,172.31.33.0-255,66,212852,21,267005
1803,0.002275,74.125.24.0-255,2184,215036,21,267005
1804,0.002277,172.31.33.0-255,66,215102,21,267005
1805,0.002305,74.125.24.0-255,1484,216586,21,267005
1806,0.0045,74.125.24.0-255,4320,220906,21,267005
1807,0.004506,172.31.33.0-255,66,220972,21,267005
1808,0.006774,74.125.24.0-255,5738,226710,21,267005
1809,0.006779,172.31.33.0-255,66,226776,21,267005
1810,0.009002,74.125.24.0-255,5738,232514,21,267005
1811,0.009008,172.31.33.0-255,66,232580,21,267005
1812,0.011248,74.125.24.0-255,4320,236900,21,267005
1813,0.011255,172.31.33.0-255,66,236966,21,267005
1814,0.011282,74.125.24.0-255,1484,238450,21,267005
1815,0.01352,74.125.24.0-255,4320,242770,21,267005
1816,0.013527,172.31.33.0-255,66,242836,21,267005
1817,0.015775,74.125.24.0-255,5738,248574,21,267005
1818,0.015784,172.31.33.0-255,66,248640,21,267005
1819,0.018066,74.125.24.0-255,5738,254378,21,267005
1820,0.018077,172.31.33.0-255,66,254444,21,267005
1821,0.020324,74.125.24.0-255,5738,260182,21,267005
1822,0.02033,172.31.33.0-255,66,260248,21,267005
1823,0.022586,74.125.24.0-255,1254,261502,21,267005
1824,0.023957,172.31.33.0-255,66,261568,21,267005
1825,0.02399,172.31.33.0-255,105,261673,21,267005
1826,0.026205,74.125.24.0-255,66,261739,21,267005
1827,0.030667,172.31.33.0-255,172,261911,21,267005
1828,0.030694,172.31.33.0-255,1113,263024,21,267005
1829,0.030746,172.31.33.0-255,1514,264538,21,267005
1830,0.030748,172.31.33.0-255,1514,266052,21,267005
1831,0.030749,172.31.33.0-255,689,266741,21,267005
1832,0.03245,104.244.42.0-255,66,266807,21,267005
1833,0.032475,104.244.42.0-255,66,266873,21,267005
1834,0.032525,104.244.42.0-255,66,266939,21,267005
1835,0.032537,104.244.42.0-255,66,267005,21,267005
1836,0.0,172.217.194.0-255,153,153,21,294310
1837,2.5e-05,172.31.33.0-255,66,219,21,294310
1838,3.1e-05,172.217.194.0-255,1484,1703,21,294310
1839,3.5e-05,172.31.33.0-255,66,1769,21,294310
1840,3.9e-05,172.217.194.0-255,2902,4671,21,294310
1841,4.9e-05,172.31.33.0-255,66,4737,21,294310
1842,5.6e-05,172.217.194.0-255,7156,11893,21,294310
1843,5.8e-05,172.31.33.0-255,66,11959,21,294310
1844,9.2e-05,172.217.194.0-255,1484,13443,21,294310
1845,9.4e-05,172.31.33.0-255,66,13509,21,294310
1846,9.7e-05,172.217.194.0-255,640,14149,21,294310
1847,9.9e-05,172.31.33.0-255,66,14215,21,294310
1848,0.000168,172.217.194.0-255,1484,15699,21,294310
1849,0.000171,172.31.33.0-255,66,15765,21,294310
1850,0.000175,172.217.194.0-255,2902,18667,21,294310
1851,0.000178,172.31.33.0-255,66,18733,21,294310
1852,0.000206,172.217.194.0-255,5738,24471,21,294310
1853,0.000208,172.31.33.0-255,66,24537,21,294310
1854,0.000241,172.217.194.0-255,5738,30275,21,294310
1855,0.000244,172.31.33.0-255,66,30341,21,294310
1856,0.00027,172.217.194.0-255,1125,31466,21,294310
1857,0.000273,172.31.33.0-255,66,31532,21,294310
1858,0.000635,172.217.194.0-255,1484,33016,21,294310
1859,0.00064,172.31.33.0-255,66,33082,21,294310
1860,0.000648,172.217.194.0-255,2902,35984,21,294310
1861,0.00065,172.31.33.0-255,66,36050,21,294310
1862,0.000661,172.217.194.0-255,5738,41788,21,294310
1863,0.000663,172.31.33.0-255,66,41854,21,294310
1864,0.000708,172.31.33.0-255,66,41920,21,294310
1865,0.000727,172.31.33.0-255,66,41986,21,294310
1866,0.00073,172.217.194.0-255,341,42327,21,294310
1867,0.000747,172.217.194.0-255,118,42445,21,294310
1868,0.000821,172.217.194.0-255,381,42826,21,294310
1869,0.001201,172.217.194.0-255,1484,44310,21,294310
1870,0.001207,172.31.33.0-255,66,44376,21,294310
1871,0.00123,172.217.194.0-255,2902,47278,21,294310
1872,0.001232,172.31.33.0-255,66,47344,21,294310
1873,0.001237,172.217.194.0-255,4320,51664,21,294310
1874,0.001238,172.31.33.0-255,66,51730,21,294310
1875,0.001252,172.217.194.0-255,1484,53214,21,294310
1876,0.001268,172.217.194.0-255,4320,57534,21,294310
1877,0.00127,172.31.33.0-255,66,57600,21,294310
1878,0.001298,172.217.194.0-255,7156,64756,21,294310
1879,0.001301,172.31.33.0-255,66,64822,21,294310
1880,0.00133,172.31.33.0-255,66,64888,21,294310
1881,0.001425,172.217.194.0-255,1484,66372,21,294310
1882,0.001438,172.217.194.0-255,1484,67856,21,294310
1883,0.00144,172.31.33.0-255,66,67922,21,294310
1884,0.001463,172.217.194.0-255,1484,69406,21,294310
1885,0.001468,172.217.194.0-255,5738,75144,21,294310
1886,0.00147,172.31.33.0-255,66,75210,21,294310
1887,0.001479,172.31.33.0-255,66,75276,21,294310
1888,0.001519,172.217.194.0-255,2902,78178,21,294310
1889,0.001521,172.31.33.0-255,66,78244,21,294310
1890,0.001552,172.31.33.0-255,66,78310,21,294310
1891,0.00178,172.217.194.0-255,1484,79794,21,294310
1892,0.001796,172.217.194.0-255,2902,82696,21,294310
1893,0.001798,172.31.33.0-255,66,82762,21,294310
1894,0.001801,172.217.194.0-255,2902,85664,21,294310
1895,0.001803,172.31.33.0-255,66,85730,21,294310
1896,0.001821,172.217.194.0-255,2902,88632,21,294310
1897,0.001823,172.31.33.0-255,66,88698,21,294310
1898,0.001825,172.217.194.0-255,1484,90182,21,294310
1899,0.001855,172.31.33.0-255,66,90248,21,294310
1900,0.001878,172.217.194.0-255,5738,95986,21,294310
1901,0.00188,172.31.33.0-255,66,96052,21,294310
1902,0.001907,172.31.33.0-255,66,96118,21,294310
1903,0.00194,172.217.194.0-255,1484,97602,21,294310
1904,0.001949,172.217.194.0-255,1484,99086,21,294310
1905,0.001951,172.31.33.0-255,66,99152,21,294310
1906,0.001975,172.217.194.0-255,1484,100636,21,294310
1907,0.00198,172.217.194.0-255,5738,106374,21,294310
1908,0.001982,172.31.33.0-255,66,106440,21,294310
1909,0.001984,172.217.194.0-255,1484,107924,21,294310
1910,0.001986,172.217.194.0-255,1484,109408,21,294310
1911,0.001988,172.31.33.0-255,66,109474,21,294310
1912,0.002009,172.217.194.0-255,7156,116630,21,294310
1913,0.002015,172.31.33.0-255,66,116696,21,294310
1914,0.002042,172.31.33.0-255,66,116762,21,294310
1915,0.002053,172.217.194.0-255,1484,118246,21,294310
1916,0.002078,172.217.194.0-255,2184,120430,21,294310
1917,0.00208,172.31.33.0-255,66,120496,21,294310
1918,0.004316,172.217.194.0-255,1484,121980,21,294310
1919,0.004365,172.217.194.0-255,2902,124882,21,294310
1920,0.004369,172.31.33.0-255,66,124948,21,294310
1921,0.004388,172.217.194.0-255,1484,126432,21,294310
1922,0.006744,172.217.194.0-255,4320,130752,21,294310
1923,0.006751,172.31.33.0-255,66,130818,21,294310
1924,0.009063,172.217.194.0-255,5738,136556,21,294310
1925,0.00907,172.31.33.0-255,66,136622,21,294310
1926,0.011397,172.217.194.0-255,5738,142360,21,294310
1927,0.011405,172.31.33.0-255,66,142426,21,294310
1928,0.013699,172.217.194.0-255,5738,148164,21,294310
1929,0.013706,172.31.33.0-255,66,148230,21,294310
1930,0.015999,172.217.194.0-255,5738,153968,21,294310
1931,0.016007,172.31.33.0-255,66,154034,21,294310
1932,0.018316,172.217.194.0-255,5738,159772,21,294310
1933,0.018321,172.31.33.0-255,66,159838,21,294310
1934,0.020662,172.217.194.0-255,5738,165576,21,294310
1935,0.020669,172.31.33.0-255,66,165642,21,294310
1936,0.022989,172.217.194.0-255,5738,171380,21,294310
1937,0.022994,172.31.33.0-255,66,171446,21,294310
1938,0.023166,172.31.33.0-255,172,171618,21,294310
1939,0.023191,172.31.33.0-255,1113,172731,21,294310
1940,0.023235,172.31.33.0-255,1514,174245,21,294310
1941,0.023236,172.31.33.0-255,1514,175759,21,294310
1942,0.023261,172.31.33.0-255,689,176448,21,294310
1943,0.024714,104.244.42.0-255,66,176514,21,294310
1944,0.02472,104.244.42.0-255,66,176580,21,294310
1945,0.024803,104.244.42.0-255,66,176646,21,294310
1946,0.024805,104.244.42.0-255,66,176712,21,294310
1947,0.02528,172.217.194.0-255,5738,182450,21,294310
1948,0.025286,172.31.33.0-255,66,182516,21,294310
1949,0.027595,172.217.194.0-255,5738,188254,21,294310
1950,0.027601,172.31.33.0-255,66,188320,21,294310
1951,0.029898,172.217.194.0-255,5738,194058,21,294310
1952,0.029903,172.31.33.0-255,66,194124,21,294310
1953,0.032184,172.217.194.0-255,2902,197026,21,294310
1954,0.032188,172.31.33.0-255,66,197092,21,294310
1955,0.032213,172.217.194.0-255,2902,199994,21,294310
1956,0.032216,172.31.33.0-255,66,200060,21,294310
1957,0.034483,172.217.194.0-255,2902,202962,21,294310
1958,0.034488,172.31.33.0-255,66,203028,21,294310
1959,0.034533,172.217.194.0-255,2902,205930,21,294310
1960,0.034536,172.31.33.0-255,66,205996,21,294310
1961,0.036772,172.217.194.0-255,2902,208898,21,294310
1962,0.036777,172.31.33.0-255,66,208964,21,294310
1963,0.036882,172.217.194.0-255,2902,211866,21,294310
1964,0.036887,172.31.33.0-255,66,211932,21,294310
1965,0.039054,172.217.194.0-255,2902,214834,21,294310
1966,0.039059,172.31.33.0-255,66,214900,21,294310
1967,0.039157,172.217.194.0-255,2902,217802,21,294310
1968,0.039161,172.31.33.0-255,66,217868,21,294310
1969,0.041322,172.217.194.0-255,2902,220770,21,294310
1970,0.041326,172.31.33.0-255,66,220836,21,294310
1971,0.041474,172.217.194.0-255,2902,223738,21,294310
1972,0.041478,172.31.33.0-255,66,223804,21,294310
1973,0.043615,172.217.194.0-255,2902,226706,21,294310
1974,0.043634,172.31.33.0-255,66,226772,21,294310
1975,0.043768,172.217.194.0-255,2902,229674,21,294310
1976,0.043772,172.31.33.0-255,66,229740,21,294310
1977,0.045926,172.217.194.0-255,2902,232642,21,294310
1978,0.045931,172.31.33.0-255,66,232708,21,294310
1979,0.046104,172.217.194.0-255,2902,235610,21,294310
1980,0.046109,172.31.33.0-255,66,235676,21,294310
1981,0.048207,172.217.194.0-255,2902,238578,21,294310
1982,0.048212,172.31.33.0-255,66,238644,21,294310
1983,0.048421,172.217.194.0-255,2902,241546,21,294310
1984,0.048426,172.31.33.0-255,66,241612,21,294310
1985,0.050532,172.217.194.0-255,2902,244514,21,294310
1986,0.050536,172.31.33.0-255,66,244580,21,294310
1987,0.050747,172.217.194.0-255,2902,247482,21,294310
1988,0.050751,172.31.33.0-255,66,247548,21,294310
1989,0.052838,172.217.194.0-255,2902,250450,21,294310
1990,0.052843,172.31.33.0-255,66,250516,21,294310
1991,0.053069,172.217.194.0-255,2902,253418,21,294310
1992,0.053074,172.31.33.0-255,66,253484,21,294310
1993,0.055126,172.217.194.0-255,2902,256386,21,294310
1994,0.055131,172.31.33.0-255,66,256452,21,294310
1995,0.055376,172.217.194.0-255,2902,259354,21,294310
1996,0.055382,172.31.33.0-255,66,259420,21,294310
1997,0.057435,172.217.194.0-255,1484,260904,21,294310
1998,0.057739,172.217.194.0-255,4320,265224,21,294310
1999,0.057745,172.31.33.0-255,66,265290,21,294310
2000,0.060041,172.217.194.0-255,5738,271028,21,294310
2001,0.06006,172.31.33.0-255,66,271094,21,294310
2002,0.062339,172.217.194.0-255,5738,276832,21,294310
2003,0.062343,172.31.33.0-255,66,276898,21,294310
2004,0.064644,172.217.194.0-255,5738,282636,21,294310
2005,0.06465,172.31.33.0-255,66,282702,21,294310
2006,0.06698,172.217.194.0-255,5738,288440,21,294310
2007,0.066985,172.31.33.0-255,66,288506,21,294310
2008,0.06932,172.217.194.0-255,5738,294244,21,294310
2009,0.069324,172.31.33.0-255,66,294310,21,294310
2010,0.0,172.31.33.0-255,105,105,21,984
2011,4.9e-05,172.31.33.0-255,105,210,21,984
2012,0.000219,172.31.33.0-255,90,300,21,984
2013,0.000228,172.31.33.0-255,66,366,21,984
2014,0.000568,172.31.33.0-255,90,456,21,984
2015,0.000575,172.31.33.0-255,66,522,21,984
2016,0.002436,172.217.194.0-255,66,588,21,984
2017,0.002453,172.217.194.0-255,66,654,21,984
2018,0.002457,172.31.33.0-255,66,720,21,984
2019,0.00248,172.217.194.0-255,66,786,21,984
2020,0.002844,74.125.200.0-255,66,852,21,984
2021,0.002854,74.125.200.0-255,66,918,21,984
2022,0.002862,172.31.33.0-255,66,984,21,984
2023,0.0,172.217.194.0-255,66,66,21,132
2024,0.033789,172.31.33.0-255,66,132,21,132
2025,0.0,172.31.33.0-255,105,105,21,984
2026,5.3e-05,172.31.33.0-255,105,210,21,984
2027,0.00024,172.31.33.0-255,90,300,21,984
2028,0.000249,172.31.33.0-255,66,366,21,984
2029,0.000422,172.31.33.0-255,90,456,21,984
2030,0.00043,172.31.33.0-255,66,522,21,984
2031,0.002591,172.217.194.0-255,66,588,21,984
2032,0.002617,172.217.194.0-255,66,654,21,984
2033,0.002628,172.31.33.0-255,66,720,21,984
2034,0.002631,172.217.194.0-255,66,786,21,984
2035,0.002747,74.125.24.0-255,66,852,21,984
2036,0.002764,74.125.24.0-255,66,918,21,984
2037,0.002784,172.31.33.0-255,66,984,21,984
2038,0.0,74.125.24.0-255,154,154,21,306094
2039,2.6e-05,172.31.33.0-255,66,220,21,306094
2040,3.3e-05,74.125.24.0-255,1484,1704,21,306094
2041,3.6e-05,172.31.33.0-255,66,1770,21,306094
2042,4.1e-05,74.125.24.0-255,2902,4672,21,306094
2043,5e-05,172.31.33.0-255,66,4738,21,306094
2044,5.7e-05,74.125.24.0-255,7156,11894,21,306094
2045,6e-05,172.31.33.0-255,66,11960,21,306094
2046,6.2e-05,74.125.24.0-255,1484,13444,21,306094
2047,6.5e-05,172.31.33.0-255,66,13510,21,306094
2048,0.000108,172.31.33.0-255,66,13576,21,306094
2049,0.000113,74.125.24.0-255,3961,17537,21,306094
2050,0.000115,172.31.33.0-255,66,17603,21,306094
2051,0.000322,74.125.24.0-255,1484,19087,21,306094
2052,0.000329,172.31.33.0-255,66,19153,21,306094
2053,0.000334,74.125.24.0-255,2902,22055,21,306094
2054,0.000336,172.31.33.0-255,66,22121,21,306094
2055,0.000341,74.125.24.0-255,4320,26441,21,306094
2056,0.000344,172.31.33.0-255,66,26507,21,306094
2057,0.000374,74.125.24.0-255,1484,27991,21,306094
2058,0.000377,172.31.33.0-255,66,28057,21,306094
2059,0.000383,74.125.24.0-255,6797,34854,21,306094
2060,0.000386,172.31.33.0-255,66,34920,21,306094
2061,0.000441,74.125.24.0-255,1484,36404,21,306094
2062,0.000446,172.31.33.0-255,66,36470,21,306094
2063,0.000451,74.125.24.0-255,2902,39372,21,306094
2064,0.000453,172.31.33.0-255,66,39438,21,306094
2065,0.000486,74.125.24.0-255,5738,45176,21,306094
2066,0.000491,172.31.33.0-255,66,45242,21,306094
2067,0.000526,74.125.24.0-255,5738,50980,21,306094
2068,0.000532,172.31.33.0-255,66,51046,21,306094
2069,0.000537,74.125.24.0-255,1420,52466,21,306094
2070,0.000639,74.125.24.0-255,129,52595,21,306094
2071,0.000668,74.125.24.0-255,349,52944,21,306094
2072,0.000673,172.31.33.0-255,66,53010,21,306094
2073,0.000915,74.125.24.0-255,1484,54494,21,306094
2074,0.000924,74.125.24.0-255,2902,57396,21,306094
2075,0.000928,172.31.33.0-255,66,57462,21,306094
2076,0.000933,74.125.24.0-255,4320,61782,21,306094
2077,0.000935,172.31.33.0-255,66,61848,21,306094
2078,0.000963,74.125.24.0-255,1484,63332,21,306094
2079,0.000976,172.31.33.0-255,66,63398,21,306094
2080,0.001003,74.125.24.0-255,4320,67718,21,306094
2081,0.001006,172.31.33.0-255,66,67784,21,306094
2082,0.001011,74.125.24.0-255,2902,70686,21,306094
2083,0.001013,172.31.33.0-255,66,70752,21,306094
2084,0.001049,172.31.33.0-255,66,70818,21,306094
2085,0.0014,74.125.24.0-255,1484,72302,21,306094
2086,0.001406,74.125.24.0-255,2902,75204,21,306094
2087,0.00141,172.31.33.0-255,66,75270,21,306094
2088,0.00144,74.125.24.0-255,5738,81008,21,306094
2089,0.001443,172.31.33.0-255,66,81074,21,306094
2090,0.001448,74.125.24.0-255,4320,85394,21,306094
2091,0.00145,172.31.33.0-255,66,85460,21,306094
2092,0.00148,74.125.24.0-255,2902,88362,21,306094
2093,0.001483,172.31.33.0-255,66,88428,21,306094
2094,0.001496,172.31.33.0-255,66,88494,21,306094
2095,0.001499,74.125.24.0-255,2184,90678,21,306094
2096,0.001501,172.31.33.0-255,66,90744,21,306094
2097,0.001565,74.125.24.0-255,1484,92228,21,306094
2098,0.00157,74.125.24.0-255,2902,95130,21,306094
2099,0.001572,172.31.33.0-255,66,95196,21,306094
2100,0.001577,74.125.24.0-255,4320,99516,21,306094
2101,0.001579,172.31.33.0-255,66,99582,21,306094
2102,0.001602,74.125.24.0-255,1484,101066,21,306094
2103,0.001611,172.31.33.0-255,66,101132,21,306094
2104,0.001688,74.125.24.0-255,5738,106870,21,306094
2105,0.001692,172.31.33.0-255,66,106936,21,306094
2106,0.001723,172.31.33.0-255,66,107002,21,306094
2107,0.001726,74.125.24.0-255,1484,108486,21,306094
2108,0.001759,74.125.24.0-255,4320,112806,21,306094
2109,0.001759,172.31.33.0-255,66,112872,21,306094
2110,0.001761,172.31.33.0-255,66,112938,21,306094
2111,0.001789,74.125.24.0-255,4320,117258,21,306094
2112,0.001792,172.31.33.0-255,66,117324,21,306094
2113,0.001816,74.125.24.0-255,5738,123062,21,306094
2114,0.001819,172.31.33.0-255,66,123128,21,306094
2115,0.001842,74.125.24.0-255,3602,126730,21,306094
2116,0.001846,172.31.33.0-255,66,126796,21,306094
2117,0.004032,74.125.24.0-255,1484,128280,21,306094
2118,0.00409,74.125.24.0-255,1484,129764,21,306094
2119,0.004094,172.31.33.0-255,66,129830,21,306094
2120,0.004106,74.125.24.0-255,2902,132732,21,306094
2121,0.004113,172.31.33.0-255,66,132798,21,306094
2122,0.006289,74.125.24.0-255,2902,135700,21,306094
2123,0.006293,172.31.33.0-255,66,135766,21,306094
2124,0.006357,74.125.24.0-255,2902,138668,21,306094
2125,0.006359,172.31.33.0-255,66,138734,21,306094
2126,0.008512,74.125.24.0-255,2902,141636,21,306094
2127,0.008518,172.31.33.0-255,66,141702,21,306094
2128,0.008622,74.125.24.0-255,2902,144604,21,306094
2129,0.008627,172.31.33.0-255,66,144670,21,306094
2130,0.010738,74.125.24.0-255,2902,147572,21,306094
2131,0.010745,172.31.33.0-255,66,147638,21,306094
2132,0.010863,74.125.24.0-255,2902,150540,21,306094
2133,0.010868,172.31.33.0-255,66,150606,21,306094
2134,0.013024,74.125.24.0-255,2902,153508,21,306094
2135,0.013031,172.31.33.0-255,66,153574,21,306094
2136,0.013127,74.125.24.0-255,2902,156476,21,306094
2137,0.013131,172.31.33.0-255,66,156542,21,306094
2138,0.015286,74.125.24.0-255,2902,159444,21,306094
2139,0.015292,172.31.33.0-255,66,159510,21,306094
2140,0.015348,74.125.24.0-255,2902,162412,21,306094
2141,0.015352,172.31.33.0-255,66,162478,21,306094
2142,0.017522,74.125.24.0-255,2902,165380,21,306094
2143,0.01753,172.31.33.0-255,66,165446,21,306094
2144,0.017598,74.125.24.0-255,1484,166930,21,306094
2145,0.01761,74.125.24.0-255,1484,168414,21,306094
2146,0.017613,172.31.33.0-255,66,168480,21,306094
2147,0.019742,74.125.24.0-255,2902,171382,21,306094
2148,0.019749,172.31.33.0-255,66,171448,21,306094
2149,0.019872,74.125.24.0-255,2902,174350,21,306094
2150,0.019877,172.31.33.0-255,66,174416,21,306094
2151,0.021996,74.125.24.0-255,2902,177318,21,306094
2152,0.022003,172.31.33.0-255,66,177384,21,306094
2153,0.022099,74.125.24.0-255,2902,180286,21,306094
2154,0.022102,172.31.33.0-255,66,180352,21,306094
2155,0.024232,74.125.24.0-255,2902,183254,21,306094
2156,0.024238,172.31.33.0-255,66,183320,21,306094
2157,0.024311,74.125.24.0-255,2902,186222,21,306094
2158,0.024316,172.31.33.0-255,66,186288,21,306094
2159,0.024738,172.31.33.0-255,172,186460,21,306094
2160,0.024773,172.31.33.0-255,1109,187569,21,306094
2161,0.024839,172.31.33.0-255,1514,189083,21,306094
2162,0.024841,172.31.33.0-255,1514,190597,21,306094
2163,0.024842,172.31.33.0-255,693,191290,21,306094
2164,0.026269,104.244.42.0-255,66,191356,21,306094
2165,0.026322,104.244.42.0-255,66,191422,21,306094
2166,0.026422,104.244.42.0-255,66,191488,21,306094
2167,0.026424,104.244.42.0-255,66,191554,21,306094
2168,0.026482,74.125.24.0-255,2902,194456,21,306094
2169,0.026486,172.31.33.0-255,66,194522,21,306094
2170,0.026545,74.125.24.0-255,2902,197424,21,306094
2171,0.026549,172.31.33.0-255,66,197490,21,306094
2172,0.027517,104.244.42.0-255,108,197598,21,306094
2173,0.027533,172.31.33.0-255,66,197664,21,306094
2174,0.028708,74.125.24.0-255,2902,200566,21,306094
2175,0.028711,172.31.33.0-255,66,200632,21,306094
2176,0.028772,74.125.24.0-255,2902,203534,21,306094
2177,0.028776,172.31.33.0-255,66,203600,21,306094
2178,0.030977,74.125.24.0-255,2902,206502,21,306094
2179,0.030981,172.31.33.0-255,66,206568,21,306094
2180,0.031046,74.125.24.0-255,2902,209470,21,306094
2181,0.03105,172.31.33.0-255,66,209536,21,306094
2182,0.033233,74.125.24.0-255,2902,212438,21,306094
2183,0.033238,172.31.33.0-255,66,212504,21,306094
2184,0.033286,74.125.24.0-255,2902,215406,21,306094
2185,0.033291,172.31.33.0-255,66,215472,21,306094
2186,0.035479,74.125.24.0-255,2902,218374,21,306094
2187,0.035485,172.31.33.0-255,66,218440,21,306094
2188,0.035552,74.125.24.0-255,1484,219924,21,306094
2189,0.035565,74.125.24.0-255,1484,221408,21,306094
2190,0.035568,172.31.33.0-255,66,221474,21,306094
2191,0.037731,74.125.24.0-255,2902,224376,21,306094
2192,0.037737,172.31.33.0-255,66,224442,21,306094
2193,0.037784,74.125.24.0-255,2902,227344,21,306094
2194,0.037788,172.31.33.0-255,66,227410,21,306094
2195,0.03999,74.125.24.0-255,4320,231730,21,306094
2196,0.039994,172.31.33.0-255,66,231796,21,306094
2197,0.040018,74.125.24.0-255,1484,233280,21,306094
2198,0.042236,74.125.24.0-255,4320,237600,21,306094
2199,0.042241,172.31.33.0-255,66,237666,21,306094
2200,0.044484,74.125.24.0-255,5738,243404,21,306094
2201,0.044488,172.31.33.0-255,66,243470,21,306094
2202,0.046727,74.125.24.0-255,4320,247790,21,306094
2203,0.046732,172.31.33.0-255,66,247856,21,306094
2204,0.046762,74.125.24.0-255,1484,249340,21,306094
2205,0.048979,74.125.24.0-255,4320,253660,21,306094
2206,0.048984,172.31.33.0-255,66,253726,21,306094
2207,0.051216,74.125.24.0-255,5738,259464,21,306094
2208,0.051221,172.31.33.0-255,66,259530,21,306094
2209,0.053503,74.125.24.0-255,5738,265268,21,306094
2210,0.053508,172.31.33.0-255,66,265334,21,306094
2211,0.055787,74.125.24.0-255,5738,271072,21,306094
2212,0.055791,172.31.33.0-255,66,271138,21,306094
2213,0.05807,74.125.24.0-255,5738,276876,21,306094
2214,0.058074,172.31.33.0-255,66,276942,21,306094
2215,0.060281,74.125.24.0-255,2902,279844,21,306094
2216,0.060285,172.31.33.0-255,66,279910,21,306094
2217,0.060314,74.125.24.0-255,2902,282812,21,306094
2218,0.060317,172.31.33.0-255,66,282878,21,306094
2219,0.062537,74.125.24.0-255,5738,288616,21,306094
2220,0.062542,172.31.33.0-255,66,288682,21,306094
2221,0.06479,74.125.24.0-255,5738,294420,21,306094
2222,0.064795,172.31.33.0-255,66,294486,21,306094
2223,0.067012,74.125.24.0-255,5738,300224,21,306094
2224,0.067016,172.31.33.0-255,66,300290,21,306094
2225,0.069233,74.125.24.0-255,5738,306028,21,306094
2226,0.069237,172.31.33.0-255,66,306094,21,306094
2227,0.0,172.31.33.0-255,105,105,21,276
2228,0.001773,157.240.7.0-255,105,210,21,276
2229,0.001784,172.31.33.0-255,66,276,21,276
2230,0.0,74.125.68.0-255,297,297,21,325015
2231,1.7e-05,172.31.33.0-255,66,363,21,325015
2232,2.3e-05,74.125.68.0-255,1484,1847,21,325015
2233,2.7e-05,172.31.33.0-255,66,1913,21,325015
2234,3.2e-05,74.125.68.0-255,2902,4815,21,325015
2235,3.5e-05,172.31.33.0-255,66,4881,21,325015
2236,5.1e-05,74.125.68.0-255,1484,6365,21,325015
2237,5.4e-05,172.31.33.0-255,66,6431,21,325015
2238,5.9e-05,74.125.68.0-255,4320,10751,21,325015
2239,6.1e-05,172.31.33.0-255,66,10817,21,325015
2240,7.6e-05,74.125.68.0-255,1484,12301,21,325015
2241,7.8e-05,172.31.33.0-255,66,12367,21,325015
2242,0.000105,172.31.33.0-255,66,12433,21,325015
2243,0.000122,74.125.68.0-255,1823,14256,21,325015
2244,0.000124,172.31.33.0-255,66,14322,21,325015
2245,0.000133,74.125.68.0-255,1484,15806,21,325015
2246,0.000136,172.31.33.0-255,66,15872,21,325015
2247,0.000163,74.125.68.0-255,6797,22669,21,325015
2248,0.000165,172.31.33.0-255,66,22735,21,325015
2249,0.000361,74.125.68.0-255,1484,24219,21,325015
2250,0.000366,172.31.33.0-255,66,24285,21,325015
2251,0.000371,74.125.68.0-255,2902,27187,21,325015
2252,0.000373,172.31.33.0-255,66,27253,21,325015
2253,0.000395,74.125.68.0-255,2902,30155,21,325015
2254,0.000397,172.31.33.0-255,66,30221,21,325015
2255,0.0004,74.125.68.0-255,1484,31705,21,325015
2256,0.000402,172.31.33.0-255,66,31771,21,325015
2257,0.000416,74.125.68.0-255,2902,34673,21,325015
2258,0.000418,172.31.33.0-255,66,34739,21,325015
2259,0.000441,74.125.68.0-255,2902,37641,21,325015
2260,0.000443,172.31.33.0-255,66,37707,21,325015
2261,0.000458,74.125.68.0-255,3961,41668,21,325015
2262,0.000482,172.31.33.0-255,66,41734,21,325015
2263,0.000498,74.125.68.0-255,1484,43218,21,325015
2264,0.000504,74.125.68.0-255,2902,46120,21,325015
2265,0.000522,172.31.33.0-255,66,46186,21,325015
2266,0.000541,74.125.68.0-255,2902,49088,21,325015
2267,0.000548,172.31.33.0-255,66,49154,21,325015
2268,0.000555,74.125.68.0-255,2902,52056,21,325015
2269,0.000559,172.31.33.0-255,66,52122,21,325015
2270,0.000605,74.125.68.0-255,2902,55024,21,325015
2271,0.000612,172.31.33.0-255,66,55090,21,325015
2272,0.00062,74.125.68.0-255,2817,57907,21,325015
2273,0.000624,172.31.33.0-255,66,57973,21,325015
2274,0.001046,74.125.68.0-255,130,58103,21,325015
2275,0.001068,172.31.33.0-255,66,58169,21,325015
2276,0.001739,74.125.68.0-255,1484,59653,21,325015
2277,0.00175,74.125.68.0-255,2902,62555,21,325015
2278,0.00177,74.125.68.0-255,5738,68293,21,325015
2279,0.001791,74.125.68.0-255,7156,75449,21,325015
2280,0.001822,74.125.68.0-255,4320,79769,21,325015
2281,0.001846,74.125.68.0-255,7156,86925,21,325015
2282,0.001871,74.125.68.0-255,5020,91945,21,325015
2283,0.001925,74.125.68.0-255,1484,93429,21,325015
2284,0.00194,74.125.68.0-255,2902,96331,21,325015
2285,0.001965,74.125.68.0-255,5738,102069,21,325015
2286,0.001969,74.125.68.0-255,2902,104971,21,325015
2287,0.002026,74.125.68.0-255,4320,109291,21,325015
2288,0.002046,74.125.68.0-255,5738,115029,21,325015
2289,0.002056,74.125.68.0-255,1484,116513,21,325015
2290,0.002087,74.125.68.0-255,2902,119415,21,325015
2291,0.002129,74.125.68.0-255,4320,123735,21,325015
2292,0.002185,74.125.68.0-255,5020,128755,21,325015
2293,0.002228,74.125.68.0-255,2902,131657,21,325015
2294,0.00224,74.125.68.0-255,2902,134559,21,325015
2295,0.002249,74.125.68.0-255,1484,136043,21,325015
2296,0.00226,74.125.68.0-255,1484,137527,21,325015
2297,0.00228,74.125.68.0-255,7156,144683,21,325015
2298,0.002285,74.125.68.0-255,4320,149003,21,325015
2299,0.002288,74.125.68.0-255,1484,150487,21,325015
2300,0.002302,74.125.68.0-255,4320,154807,21,325015
2301,0.002313,74.125.68.0-255,1484,156291,21,325015
2302,0.002331,74.125.68.0-255,5738,162029,21,325015
2303,0.004696,172.31.33.0-255,66,162095,21,325015
2304,0.007006,74.125.68.0-255,5738,167833,21,325015
2305,0.007012,172.31.33.0-255,66,167899,21,325015
2306,0.00932,74.125.68.0-255,5738,173637,21,325015
2307,0.009326,172.31.33.0-255,66,173703,21,325015
2308,0.011637,74.125.68.0-255,5738,179441,21,325015
2309,0.011645,172.31.33.0-255,66,179507,21,325015
2310,0.013941,74.125.68.0-255,5738,185245,21,325015
2311,0.015406,172.31.33.0-255,66,185311,21,325015
2312,0.017714,74.125.68.0-255,5738,191049,21,325015
2313,0.017723,172.31.33.0-255,66,191115,21,325015
2314,0.020027,74.125.68.0-255,5738,196853,21,325015
2315,0.020038,172.31.33.0-255,66,196919,21,325015
2316,0.022336,74.125.68.0-255,5738,202657,21,325015
2317,0.022343,172.31.33.0-255,66,202723,21,325015
2318,0.024654,74.125.68.0-255,5738,208461,21,325015
2319,0.024661,172.31.33.0-255,66,208527,21,325015
2320,0.025354,172.31.33.0-255,231,208758,21,325015
2321,0.025387,172.31.33.0-255,1109,209867,21,325015
2322,0.025447,172.31.33.0-255,1514,211381,21,325015
2323,0.025449,172.31.33.0-255,1180,212561,21,325015
2324,0.026899,104.244.42.0-255,66,212627,21,325015
2325,0.026956,104.244.42.0-255,66,212693,21,325015
2326,0.026976,74.125.68.0-255,5738,218431,21,325015
2327,0.02698,172.31.33.0-255,66,218497,21,325015
2328,0.026998,104.244.42.0-255,66,218563,21,325015
2329,0.029285,74.125.68.0-255,5738,224301,21,325015
2330,0.029291,172.31.33.0-255,66,224367,21,325015
2331,0.03159,74.125.68.0-255,5738,230105,21,325015
2332,0.031596,172.31.33.0-255,66,230171,21,325015
2333,0.033904,74.125.68.0-255,5738,235909,21,325015
2334,0.03391,172.31.33.0-255,66,235975,21,325015
2335,0.036205,74.125.68.0-255,5738,241713,21,325015
2336,0.036211,172.31.33.0-255,66,241779,21,325015
2337,0.038519,74.125.68.0-255,2902,244681,21,325015
2338,0.038525,172.31.33.0-255,66,244747,21,325015
2339,0.038545,74.125.68.0-255,2902,247649,21,325015
2340,0.038568,172.31.33.0-255,66,247715,21,325015
2341,0.040813,74.125.68.0-255,2902,250617,21,325015
2342,0.040818,172.31.33.0-255,66,250683,21,325015
2343,0.040844,74.125.68.0-255,1484,252167,21,325015
2344,0.040855,74.125.68.0-255,1484,253651,21,325015
2345,0.040866,172.31.33.0-255,66,253717,21,325015
2346,0.043141,74.125.68.0-255,2902,256619,21,325015
2347,0.043148,172.31.33.0-255,66,256685,21,325015
2348,0.043218,74.125.68.0-255,2902,259587,21,325015
2349,0.043268,172.31.33.0-255,66,259653,21,325015
2350,0.04547,74.125.68.0-255,2902,262555,21,325015
2351,0.045476,172.31.33.0-255,66,262621,21,325015
2352,0.045574,74.125.68.0-255,2902,265523,21,325015
2353,0.045578,172.31.33.0-255,66,265589,21,325015
2354,0.047781,74.125.68.0-255,2902,268491,21,325015
2355,0.047787,172.31.33.0-255,66,268557,21,325015
2356,0.047869,74.125.68.0-255,2902,271459,21,325015
2357,0.047873,172.31.33.0-255,66,271525,21,325015
2358,0.05009,74.125.68.0-255,2902,274427,21,325015
2359,0.050095,172.31.33.0-255,66,274493,21,325015
2360,0.050165,74.125.68.0-255,2902,277395,21,325015
2361,0.050178,172.31.33.0-255,66,277461,21,325015
2362,0.052411,74.125.68.0-255,2902,280363,21,325015
2363,0.052417,172.31.33.0-255,66,280429,21,325015
2364,0.052463,74.125.68.0-255,2902,283331,21,325015
2365,0.052498,172.31.33.0-255,66,283397,21,325015
2366,0.054728,74.125.68.0-255,2902,286299,21,325015
2367,0.054735,172.31.33.0-255,66,286365,21,325015
2368,0.05479,74.125.68.0-255,2902,289267,21,325015
2369,0.054817,172.31.33.0-255,66,289333,21,325015
2370,0.057039,74.125.68.0-255,2902,292235,21,325015
2371,0.057045,172.31.33.0-255,66,292301,21,325015
2372,0.057106,74.125.68.0-255,2902,295203,21,325015
2373,0.057115,172.31.33.0-255,66,295269,21,325015
2374,0.059343,74.125.68.0-255,2902,298171,21,325015
2375,0.059348,172.31.33.0-255,66,298237,21,325015
2376,0.059406,74.125.68.0-255,2902,301139,21,325015
2377,0.059467,172.31.33.0-255,66,301205,21,325015
2378,0.061647,74.125.68.0-255,2902,304107,21,325015
2379,0.061653,172.31.33.0-255,66,304173,21,325015
2380,0.061752,74.125.68.0-255,2902,307075,21,325015
2381,0.061756,172.31.33.0-255,66,307141,21,325015
2382,0.063972,74.125.68.0-255,2902,310043,21,325015
2383,0.063979,172.31.33.0-255,66,310109,21,325015
2384,0.064046,74.125.68.0-255,1484,311593,21,325015
2385,0.064062,74.125.68.0-255,1484,313077,21,325015
2386,0.06407,172.31.33.0-255,66,313143,21,325015
2387,0.066281,74.125.68.0-255,2902,316045,21,325015
2388,0.066287,172.31.33.0-255,66,316111,21,325015
2389,0.066351,74.125.68.0-255,2902,319013,21,325015
2390,0.066365,172.31.33.0-255,66,319079,21,325015
2391,0.068594,74.125.68.0-255,2902,321981,21,325015
2392,0.0686,172.31.33.0-255,66,322047,21,325015
2393,0.068649,74.125.68.0-255,2902,324949,21,325015
2394,0.068672,172.31.33.0-255,66,325015,21,325015
2395,0.0,172.31.33.0-255,105,105,21,459
2396,0.0002,172.31.33.0-255,90,195,21,459
2397,0.000211,172.31.33.0-255,66,261,21,459
2398,0.002834,74.125.24.0-255,66,327,21,459
2399,0.002878,74.125.24.0-255,66,393,21,459
2400,0.002901,172.31.33.0-255,66,459,21,459
2401,0.0,172.31.33.0-255,299,299,21,365
2402,0.00149,104.244.42.0-255,66,365,21,365
2403,0.0,74.125.24.0-255,301,301,21,252376
2404,1.4e-05,172.31.33.0-255,66,367,21,252376
2405,2.1e-05,74.125.24.0-255,1484,1851,21,252376
2406,2.4e-05,172.31.33.0-255,66,1917,21,252376
2407,3.1e-05,74.125.24.0-255,4320,6237,21,252376
2408,4.2e-05,172.31.33.0-255,66,6303,21,252376
2409,5.4e-05,172.31.33.0-255,66,6369,21,252376
2410,7.5e-05,74.125.24.0-255,5738,12107,21,252376
2411,7.8e-05,172.31.33.0-255,66,12173,21,252376
2412,0.000107,74.125.24.0-255,7156,19329,21,252376
2413,0.000109,172.31.33.0-255,66,19395,21,252376
2414,0.000114,74.125.24.0-255,2543,21938,21,252376
2415,0.000116,172.31.33.0-255,66,22004,21,252376
2416,0.000167,74.125.24.0-255,1484,23488,21,252376
2417,0.00017,172.31.33.0-255,66,23554,21,252376
2418,0.000173,74.125.24.0-255,1484,25038,21,252376
2419,0.000175,172.31.33.0-255,66,25104,21,252376
2420,0.0002,74.125.24.0-255,1484,26588,21,252376
2421,0.000206,172.31.33.0-255,66,26654,21,252376
2422,0.000212,74.125.24.0-255,5738,32392,21,252376
2423,0.000214,172.31.33.0-255,66,32458,21,252376
2424,0.000219,74.125.24.0-255,5738,38196,21,252376
2425,0.000221,172.31.33.0-255,66,38262,21,252376
2426,0.00026,172.31.33.0-255,66,38328,21,252376
2427,0.000295,172.31.33.0-255,66,38394,21,252376
2428,0.000298,74.125.24.0-255,415,38809,21,252376
2429,0.000299,172.31.33.0-255,66,38875,21,252376
2430,0.000353,74.125.24.0-255,330,39205,21,252376
2431,0.000355,172.31.33.0-255,66,39271,21,252376
2432,0.000531,74.125.24.0-255,1484,40755,21,252376
2433,0.000536,74.125.24.0-255,2902,43657,21,252376
2434,0.00054,172.31.33.0-255,66,43723,21,252376
2435,0.000546,74.125.24.0-255,5738,49461,21,252376
2436,0.000548,172.31.33.0-255,66,49527,21,252376
2437,0.00058,172.31.33.0-255,66,49593,21,252376
2438,0.000617,74.125.24.0-255,1484,51077,21,252376
2439,0.000652,172.31.33.0-255,66,51143,21,252376
2440,0.00119,74.125.24.0-255,1484,52627,21,252376
2441,0.001204,74.125.24.0-255,2902,55529,21,252376
2442,0.001208,172.31.33.0-255,66,55595,21,252376
2443,0.001214,74.125.24.0-255,5738,61333,21,252376
2444,0.001216,172.31.33.0-255,66,61399,21,252376
2445,0.001229,74.125.24.0-255,1484,62883,21,252376
2446,0.001258,172.31.33.0-255,66,62949,21,252376
2447,0.001294,74.125.24.0-255,7156,70105,21,252376
2448,0.001296,172.31.33.0-255,66,70171,21,252376
2449,0.001325,74.125.24.0-255,3602,73773,21,252376
2450,0.001328,172.31.33.0-255,66,73839,21,252376
2451,0.001331,74.125.24.0-255,1484,75323,21,252376
2452,0.001352,74.125.24.0-255,2902,78225,21,252376
2453,0.001355,172.31.33.0-255,66,78291,21,252376
2454,0.00136,74.125.24.0-255,5738,84029,21,252376
2455,0.001362,172.31.33.0-255,66,84095,21,252376
2456,0.001401,172.31.33.0-255,66,84161,21,252376
2457,0.001409,172.31.33.0-255,66,84227,21,252376
2458,0.00144,74.125.24.0-255,2184,86411,21,252376
2459,0.001442,172.31.33.0-255,66,86477,21,252376
2460,0.001812,74.125.24.0-255,1484,87961,21,252376
2461,0.001817,74.125.24.0-255,1484,89445,21,252376
2462,0.001819,172.31.33.0-255,66,89511,21,252376
2463,0.00183,74.125.24.0-255,1484,90995,21,252376
2464,0.001832,74.125.24.0-255,1484,92479,21,252376
2465,0.001838,172.31.33.0-255,66,92545,21,252376
2466,0.001865,74.125.24.0-255,4320,96865,21,252376
2467,0.001867,172.31.33.0-255,66,96931,21,252376
2468,0.00187,74.125.24.0-255,1484,98415,21,252376
2469,0.001911,172.31.33.0-255,66,98481,21,252376
2470,0.001927,172.31.33.0-255,66,98547,21,252376
2471,0.002068,74.125.24.0-255,1484,100031,21,252376
2472,0.002089,74.125.24.0-255,2902,102933,21,252376
2473,0.002092,172.31.33.0-255,66,102999,21,252376
2474,0.002098,74.125.24.0-255,5738,108737,21,252376
2475,0.0021,172.31.33.0-255,66,108803,21,252376
2476,0.002105,74.125.24.0-255,5738,114541,21,252376
2477,0.002106,172.31.33.0-255,66,114607,21,252376
2478,0.002157,172.31.33.0-255,66,114673,21,252376
2479,0.002159,74.125.24.0-255,766,115439,21,252376
2480,0.002195,74.125.24.0-255,1484,116923,21,252376
2481,0.002198,74.125.24.0-255,1484,118407,21,252376
2482,0.002201,172.31.33.0-255,66,118473,21,252376
2483,0.002221,74.125.24.0-255,1484,119957,21,252376
2484,0.002223,172.31.33.0-255,66,120023,21,252376
2485,0.002229,74.125.24.0-255,5738,125761,21,252376
2486,0.002231,172.31.33.0-255,66,125827,21,252376
2487,0.002277,172.31.33.0-255,66,125893,21,252376
2488,0.002334,172.31.33.0-255,66,125959,21,252376
2489,0.00235,172.31.33.0-255,66,126025,21,252376
2490,0.002369,74.125.24.0-255,5738,131763,21,252376
2491,0.002372,172.31.33.0-255,66,131829,21,252376
2492,0.002418,172.31.33.0-255,66,131895,21,252376
2493,0.004766,74.125.24.0-255,5738,137633,21,252376
2494,0.004773,172.31.33.0-255,66,137699,21,252376
2495,0.007076,74.125.24.0-255,5738,143437,21,252376
2496,0.00708,172.31.33.0-255,66,143503,21,252376
2497,0.009403,74.125.24.0-255,5738,149241,21,252376
2498,0.009411,172.31.33.0-255,66,149307,21,252376
2499,0.011737,74.125.24.0-255,5738,155045,21,252376
2500,0.011746,172.31.33.0-255,66,155111,21,252376
2501,0.014092,74.125.24.0-255,5738,160849,21,252376
2502,0.014098,172.31.33.0-255,66,160915,21,252376
2503,0.016415,74.125.24.0-255,5738,166653,21,252376
2504,0.016426,172.31.33.0-255,66,166719,21,252376
2505,0.018741,74.125.24.0-255,5738,172457,21,252376
2506,0.018749,172.31.33.0-255,66,172523,21,252376
2507,0.021063,74.125.24.0-255,5738,178261,21,252376
2508,0.021071,172.31.33.0-255,66,178327,21,252376
2509,0.023372,74.125.24.0-255,5738,184065,21,252376
2510,0.023378,172.31.33.0-255,66,184131,21,252376
2511,0.025723,74.125.24.0-255,5738,189869,21,252376
2512,0.02573,172.31.33.0-255,66,189935,21,252376
2513,0.028058,74.125.24.0-255,5738,195673,21,252376
2514,0.028066,172.31.33.0-255,66,195739,21,252376
2515,0.030378,74.125.24.0-255,5738,201477,21,252376
2516,0.030385,172.31.33.0-255,66,201543,21,252376
2517,0.031747,172.31.33.0-255,172,201715,21,252376
2518,0.031775,172.31.33.0-255,1109,202824,21,252376
2519,0.031826,172.31.33.0-255,1514,204338,21,252376
2520,0.031828,172.31.33.0-255,1514,205852,21,252376
2521,0.031832,172.31.33.0-255,1514,207366,21,252376
2522,0.031833,172.31.33.0-255,1514,208880,21,252376
2523,0.031863,172.31.33.0-255,473,209353,21,252376
2524,0.032698,74.125.24.0-255,5738,215091,21,252376
2525,0.032704,172.31.33.0-255,66,215157,21,252376
2526,0.033298,104.244.42.0-255,66,215223,21,252376
2527,0.033328,104.244.42.0-255,66,215289,21,252376
2528,0.033344,104.244.42.0-255,66,215355,21,252376
2529,0.033399,104.244.42.0-255,66,215421,21,252376
2530,0.035027,74.125.24.0-255,5738,221159,21,252376
2531,0.035032,172.31.33.0-255,66,221225,21,252376
2532,0.037355,74.125.24.0-255,5738,226963,21,252376
2533,0.037361,172.31.33.0-255,66,227029,21,252376
2534,0.039673,74.125.24.0-255,5738,232767,21,252376
2535,0.039679,172.31.33.0-255,66,232833,21,252376
2536,0.041996,74.125.24.0-255,5738,238571,21,252376
2537,0.042004,172.31.33.0-255,66,238637,21,252376
2538,0.044321,74.125.24.0-255,5738,244375,21,252376
2539,0.044327,172.31.33.0-255,66,244441,21,252376
2540,0.046635,74.125.24.0-255,5738,250179,21,252376
2541,0.046641,172.31.33.0-255,66,250245,21,252376
2542,0.048933,74.125.24.0-255,1894,252139,21,252376
2543,0.048938,172.31.33.0-255,66,252205,21,252376
2544,0.049104,172.31.33.0-255,105,252310,21,252376
2545,0.051407,74.125.24.0-255,66,252376,21,252376
2546,0.0,74.125.24.0-255,156,156,21,201058
2547,2.9e-05,172.31.33.0-255,66,222,21,201058
2548,3.5e-05,74.125.24.0-255,1484,1706,21,201058
2549,3.9e-05,172.31.33.0-255,66,1772,21,201058
2550,4.4e-05,74.125.24.0-255,2902,4674,21,201058
2551,4.6e-05,172.31.33.0-255,66,4740,21,201058
2552,4.9e-05,74.125.24.0-255,1484,6224,21,201058
2553,5.1e-05,172.31.33.0-255,66,6290,21,201058
2554,7.2e-05,74.125.24.0-255,5738,12028,21,201058
2555,7.4e-05,172.31.33.0-255,66,12094,21,201058
2556,7.7e-05,74.125.24.0-255,2057,14151,21,201058
2557,7.9e-05,172.31.33.0-255,66,14217,21,201058
2558,0.000101,74.125.24.0-255,4320,18537,21,201058
2559,0.000103,172.31.33.0-255,66,18603,21,201058
2560,0.00013,172.31.33.0-255,66,18669,21,201058
2561,0.000144,74.125.24.0-255,5738,24407,21,201058
2562,0.000147,172.31.33.0-255,66,24473,21,201058
2563,0.000182,172.31.33.0-255,66,24539,21,201058
2564,0.000185,74.125.24.0-255,766,25305,21,201058
2565,0.000187,172.31.33.0-255,66,25371,21,201058
2566,0.000201,74.125.24.0-255,2902,28273,21,201058
2567,0.000203,172.31.33.0-255,66,28339,21,201058
2568,0.000241,172.31.33.0-255,66,28405,21,201058
2569,0.000244,74.125.24.0-255,132,28537,21,201058
2570,0.000246,172.31.33.0-255,66,28603,21,201058
2571,0.000334,74.125.24.0-255,1484,30087,21,201058
2572,0.000337,172.31.33.0-255,66,30153,21,201058
2573,0.000341,74.125.24.0-255,2902,33055,21,201058
2574,0.000346,172.31.33.0-255,66,33121,21,201058
2575,0.000357,74.125.24.0-255,5738,38859,21,201058
2576,0.000359,172.31.33.0-255,66,38925,21,201058
2577,0.000379,74.125.24.0-255,7156,46081,21,201058
2578,0.000381,172.31.33.0-255,66,46147,21,201058
2579,0.000395,74.125.24.0-255,5738,51885,21,201058
2580,0.000397,172.31.33.0-255,66,51951,21,201058
2581,0.000409,74.125.24.0-255,4320,56271,21,201058
2582,0.000411,172.31.33.0-255,66,56337,21,201058
2583,0.00044,74.125.24.0-255,6438,62775,21,201058
2584,0.000443,172.31.33.0-255,66,62841,21,201058
2585,0.000455,172.31.33.0-255,66,62907,21,201058
2586,0.000457,74.125.24.0-255,1484,64391,21,201058
2587,0.000479,172.31.33.0-255,66,64457,21,201058
2588,0.000499,74.125.24.0-255,2902,67359,21,201058
2589,0.000502,172.31.33.0-255,66,67425,21,201058
2590,0.000513,172.31.33.0-255,66,67491,21,201058
2591,0.00054,74.125.24.0-255,3602,71093,21,201058
2592,0.000542,172.31.33.0-255,66,71159,21,201058
2593,0.000556,172.31.33.0-255,66,71225,21,201058
2594,0.000579,74.125.24.0-255,1484,72709,21,201058
2595,0.000594,74.125.24.0-255,2902,75611,21,201058
2596,0.000598,172.31.33.0-255,66,75677,21,201058
2597,0.0006,74.125.24.0-255,5738,81415,21,201058
2598,0.000602,172.31.33.0-255,66,81481,21,201058
2599,0.00063,172.31.33.0-255,66,81547,21,201058
2600,0.000645,74.125.24.0-255,1484,83031,21,201058
2601,0.000697,74.125.24.0-255,7156,90187,21,201058
2602,0.000707,172.31.33.0-255,66,90253,21,201058
2603,0.000712,74.125.24.0-255,6438,96691,21,201058
2604,0.000721,172.31.33.0-255,66,96757,21,201058
2605,0.00073,74.125.24.0-255,1484,98241,21,201058
2606,0.000734,74.125.24.0-255,2902,101143,21,201058
2607,0.000741,172.31.33.0-255,66,101209,21,201058
2608,0.000744,74.125.24.0-255,1484,102693,21,201058
2609,0.000762,74.125.24.0-255,4320,107013,21,201058
2610,0.000765,172.31.33.0-255,66,107079,21,201058
2611,0.000771,74.125.24.0-255,7156,114235,21,201058
2612,0.000776,172.31.33.0-255,66,114301,21,201058
2613,0.000788,74.125.24.0-255,2902,117203,21,201058
2614,0.000794,172.31.33.0-255,66,117269,21,201058
2615,0.00082,172.31.33.0-255,66,117335,21,201058
2616,0.000843,172.31.33.0-255,66,117401,21,201058
2617,0.000854,74.125.24.0-255,3602,121003,21,201058
2618,0.000863,172.31.33.0-255,66,121069,21,201058
2619,0.000867,172.31.33.0-255,66,121135,21,201058
2620,0.000889,74.125.24.0-255,1484,122619,21,201058
2621,0.000902,172.31.33.0-255,66,122685,21,201058
2622,0.000919,74.125.24.0-255,2902,125587,21,201058
2623,0.000923,172.31.33.0-255,66,125653,21,201058
2624,0.000955,172.31.33.0-255,66,125719,21,201058
2625,0.000958,74.125.24.0-255,1484,127203,21,201058
2626,0.000974,74.125.24.0-255,4320,131523,21,201058
2627,0.000994,74.125.24.0-255,7156,138679,21,201058
2628,0.000994,172.31.33.0-255,66,138745,21,201058
2629,0.000996,74.125.24.0-255,1484,140229,21,201058
2630,0.000998,172.31.33.0-255,66,140295,21,201058
2631,0.001026,172.31.33.0-255,66,140361,21,201058
2632,0.001096,74.125.24.0-255,1484,141845,21,201058
2633,0.001115,74.125.24.0-255,2902,144747,21,201058
2634,0.001118,172.31.33.0-255,66,144813,21,201058
2635,0.001124,74.125.24.0-255,5738,150551,21,201058
2636,0.00113,172.31.33.0-255,66,150617,21,201058
2637,0.00114,74.125.24.0-255,5738,156355,21,201058
2638,0.001154,74.125.24.0-255,1484,157839,21,201058
2639,0.001154,172.31.33.0-255,66,157905,21,201058
2640,0.001183,172.31.33.0-255,66,157971,21,201058
2641,0.001207,74.125.24.0-255,1484,159455,21,201058
2642,0.001233,172.31.33.0-255,66,159521,21,201058
2643,0.001235,74.125.24.0-255,5738,165259,21,201058
2644,0.001237,172.31.33.0-255,66,165325,21,201058
2645,0.001255,74.125.24.0-255,766,166091,21,201058
2646,0.001262,74.125.24.0-255,7156,173247,21,201058
2647,0.001265,172.31.33.0-255,66,173313,21,201058
2648,0.001297,74.125.24.0-255,7156,180469,21,201058
2649,0.001303,172.31.33.0-255,66,180535,21,201058
2650,0.001334,172.31.33.0-255,66,180601,21,201058
2651,0.001342,74.125.24.0-255,5738,186339,21,201058
2652,0.001347,172.31.33.0-255,66,186405,21,201058
2653,0.001369,172.31.33.0-255,66,186471,21,201058
2654,0.001389,74.125.24.0-255,2902,189373,21,201058
2655,0.001392,172.31.33.0-255,66,189439,21,201058
2656,0.001409,74.125.24.0-255,3027,192466,21,201058
2657,0.001411,74.125.24.0-255,105,192571,21,201058
2658,0.001421,172.31.33.0-255,66,192637,21,201058
2659,0.003022,172.31.33.0-255,105,192742,21,201058
2660,0.004998,74.125.24.0-255,66,192808,21,201058
2661,0.026083,172.31.33.0-255,172,192980,21,201058
2662,0.026111,172.31.33.0-255,1113,194093,21,201058
2663,0.026144,172.31.33.0-255,1514,195607,21,201058
2664,0.026145,172.31.33.0-255,1514,197121,21,201058
2665,0.026146,172.31.33.0-255,1514,198635,21,201058
2666,0.026148,172.31.33.0-255,1514,200149,21,201058
2667,0.026149,172.31.33.0-255,471,200620,21,201058
2668,0.027645,104.244.42.0-255,66,200686,21,201058
2669,0.027854,104.244.42.0-255,66,200752,21,201058
2670,0.027857,104.244.42.0-255,66,200818,21,201058
2671,0.02786,104.244.42.0-255,66,200884,21,201058
2672,0.028482,104.244.42.0-255,108,200992,21,201058
2673,0.02849,172.31.33.0-255,66,201058,21,201058
2674,0.0,172.31.33.0-255,74,74,21,6416
2675,0.002284,172.217.194.0-255,74,148,21,6416
2676,0.002305,172.31.33.0-255,66,214,21,6416
2677,0.005663,172.31.33.0-255,583,797,21,6416
2678,0.00795,172.217.194.0-255,66,863,21,6416
2679,0.008262,172.217.194.0-255,3849,4712,21,6416
2680,0.008269,172.31.33.0-255,66,4778,21,6416
2681,0.025078,172.31.33.0-255,130,4908,21,6416
2682,0.025502,172.31.33.0-255,236,5144,21,6416
2683,0.025529,172.31.33.0-255,316,5460,21,6416
2684,0.027894,172.217.194.0-255,630,6090,21,6416
2685,0.028077,172.31.33.0-255,97,6187,21,6416
2686,0.029193,172.217.194.0-255,97,6284,21,6416
2687,0.034894,172.217.194.0-255,66,6350,21,6416
2688,0.067517,172.31.33.0-255,66,6416,21,6416
2689,0.0,172.217.194.0-255,148,148,21,205365
2690,1.4e-05,172.31.33.0-255,66,214,21,205365
2691,2.1e-05,172.217.194.0-255,1484,1698,21,205365
2692,2.5e-05,172.31.33.0-255,66,1764,21,205365
2693,3e-05,172.217.194.0-255,2902,4666,21,205365
2694,3.3e-05,172.31.33.0-255,66,4732,21,205365
2695,4.6e-05,172.217.194.0-255,4320,9052,21,205365
2696,4.9e-05,172.31.33.0-255,66,9118,21,205365
2697,8.1e-05,172.217.194.0-255,2902,12020,21,205365
2698,8.4e-05,172.31.33.0-255,66,12086,21,205365
2699,8.8e-05,172.217.194.0-255,2021,14107,21,205365
2700,9.1e-05,172.31.33.0-255,66,14173,21,205365
2701,9.5e-05,172.217.194.0-255,2902,17075,21,205365
2702,9.7e-05,172.31.33.0-255,66,17141,21,205365
2703,0.000105,172.217.194.0-255,7156,24297,21,205365
2704,0.000108,172.31.33.0-255,66,24363,21,205365
2705,0.000132,172.217.194.0-255,4320,28683,21,205365
2706,0.000135,172.31.33.0-255,66,28749,21,205365
2707,0.000155,172.217.194.0-255,1484,30233,21,205365
2708,0.000157,172.31.33.0-255,66,30299,21,205365
2709,0.000161,172.217.194.0-255,1125,31424,21,205365
2710,0.000162,172.31.33.0-255,66,31490,21,205365
2711,0.000221,172.217.194.0-255,1484,32974,21,205365
2712,0.000224,172.31.33.0-255,66,33040,21,205365
2713,0.000229,172.217.194.0-255,2902,35942,21,205365
2714,0.000231,172.31.33.0-255,66,36008,21,205365
2715,0.000235,172.217.194.0-255,2902,38910,21,205365
2716,0.000241,172.31.33.0-255,66,38976,21,205365
2717,0.000265,172.217.194.0-255,2902,41878,21,205365
2718,0.000268,172.31.33.0-255,66,41944,21,205365
2719,0.00028,172.31.33.0-255,66,42010,21,205365
2720,0.000321,172.31.33.0-255,66,42076,21,205365
2721,0.000324,172.217.194.0-255,1414,43490,21,205365
2722,0.000326,172.31.33.0-255,66,43556,21,205365
2723,0.000364,172.217.194.0-255,366,43922,21,205365
2724,0.000366,172.31.33.0-255,66,43988,21,205365
2725,0.00044,172.217.194.0-255,1484,45472,21,205365
2726,0.000444,172.31.33.0-255,66,45538,21,205365
2727,0.000449,172.217.194.0-255,2902,48440,21,205365
2728,0.000451,172.31.33.0-255,66,48506,21,205365
2729,0.000483,172.217.194.0-255,5738,54244,21,205365
2730,0.000486,172.31.33.0-255,66,54310,21,205365
2731,0.000491,172.217.194.0-255,4320,58630,21,205365
2732,0.000539,172.217.194.0-255,5738,64368,21,205365
2733,0.000571,172.217.194.0-255,1125,65493,21,205365
2734,0.000617,172.217.194.0-255,1484,66977,21,205365
2735,0.000634,172.217.194.0-255,1484,68461,21,205365
2736,0.000656,172.217.194.0-255,1484,69945,21,205365
2737,0.000661,172.217.194.0-255,5738,75683,21,205365
2738,0.000687,172.217.194.0-255,4320,80003,21,205365
2739,0.000692,172.31.33.0-255,66,80069,21,205365
2740,0.000698,172.31.33.0-255,66,80135,21,205365
2741,0.000754,172.217.194.0-255,4320,84455,21,205365
2742,0.000769,172.217.194.0-255,6438,90893,21,205365
2743,0.000797,172.31.33.0-255,66,90959,21,205365
2744,0.000865,172.217.194.0-255,1484,92443,21,205365
2745,0.00087,172.217.194.0-255,1484,93927,21,205365
2746,0.000882,172.217.194.0-255,1484,95411,21,205365
2747,0.000888,172.217.194.0-255,5738,101149,21,205365
2748,0.000911,172.217.194.0-255,5738,106887,21,205365
2749,0.000924,172.217.194.0-255,7156,114043,21,205365
2750,0.000992,172.31.33.0-255,66,114109,21,205365
2751,0.001371,172.217.194.0-255,1484,115593,21,205365
2752,0.001377,172.217.194.0-255,1484,117077,21,205365
2753,0.001394,172.31.33.0-255,66,117143,21,205365
2754,0.001398,172.217.194.0-255,1484,118627,21,205365
2755,0.001404,172.217.194.0-255,5738,124365,21,205365
2756,0.00144,172.31.33.0-255,66,124431,21,205365
2757,0.001467,172.217.194.0-255,4320,128751,21,205365
2758,0.001523,172.31.33.0-255,66,128817,21,205365
2759,0.001685,172.217.194.0-255,1484,130301,21,205365
2760,0.001702,172.217.194.0-255,2902,133203,21,205365
2761,0.001715,172.31.33.0-255,66,133269,21,205365
2762,0.001731,172.217.194.0-255,5738,139007,21,205365
2763,0.001748,172.31.33.0-255,66,139073,21,205365
2764,0.00176,172.217.194.0-255,5738,144811,21,205365
2765,0.001784,172.217.194.0-255,7156,151967,21,205365
2766,0.001795,172.31.33.0-255,66,152033,21,205365
2767,0.002114,172.217.194.0-255,2902,154935,21,205365
2768,0.002141,172.217.194.0-255,7156,162091,21,205365
2769,0.002148,172.217.194.0-255,5738,167829,21,205365
2770,0.002154,172.31.33.0-255,66,167895,21,205365
2771,0.002201,172.217.194.0-255,4320,172215,21,205365
2772,0.002267,172.217.194.0-255,2902,175117,21,205365
2773,0.002276,172.31.33.0-255,66,175183,21,205365
2774,0.002355,172.217.194.0-255,5738,180921,21,205365
2775,0.002387,172.217.194.0-255,6438,187359,21,205365
2776,0.00241,172.31.33.0-255,66,187425,21,205365
2777,0.004706,172.217.194.0-255,4320,191745,21,205365
2778,0.00471,172.31.33.0-255,66,191811,21,205365
2779,0.004732,172.217.194.0-255,1484,193295,21,205365
2780,0.004734,172.31.33.0-255,66,193361,21,205365
2781,0.00704,172.217.194.0-255,3481,196842,21,205365
2782,0.007045,172.31.33.0-255,66,196908,21,205365
2783,0.009708,172.31.33.0-255,105,197013,21,205365
2784,0.012,172.217.194.0-255,66,197079,21,205365
2785,0.021666,172.31.33.0-255,210,197289,21,205365
2786,0.021737,172.31.33.0-255,1113,198402,21,205365
2787,0.02177,172.31.33.0-255,1514,199916,21,205365
2788,0.021772,172.31.33.0-255,1514,201430,21,205365
2789,0.021773,172.31.33.0-255,1514,202944,21,205365
2790,0.021774,172.31.33.0-255,1514,204458,21,205365
2791,0.021803,172.31.33.0-255,469,204927,21,205365
2792,0.023344,104.244.42.0-255,66,204993,21,205365
2793,0.023391,104.244.42.0-255,66,205059,21,205365
2794,0.023426,104.244.42.0-255,66,205125,21,205365
2795,0.02344,104.244.42.0-255,66,205191,21,205365
2796,0.025741,104.244.42.0-255,108,205299,21,205365
2797,0.025751,172.31.33.0-255,66,205365,21,205365
2798,0.0,74.125.68.0-255,153,153,21,249403
2799,2.3e-05,172.31.33.0-255,66,219,21,249403
2800,5.3e-05,74.125.68.0-255,1484,1703,21,249403
2801,5.7e-05,172.31.33.0-255,66,1769,21,249403
2802,6.2e-05,74.125.68.0-255,2902,4671,21,249403
2803,6.5e-05,172.31.33.0-255,66,4737,21,249403
2804,7.3e-05,74.125.68.0-255,4320,9057,21,249403
2805,7.6e-05,172.31.33.0-255,66,9123,21,249403
2806,0.000109,74.125.68.0-255,2902,12025,21,249403
2807,0.000111,172.31.33.0-255,66,12091,21,249403
2808,0.000138,74.125.68.0-255,6210,18301,21,249403
2809,0.000141,172.31.33.0-255,66,18367,21,249403
2810,0.000146,74.125.68.0-255,2902,21269,21,249403
2811,0.000147,172.31.33.0-255,66,21335,21,249403
2812,0.000172,74.125.68.0-255,2902,24237,21,249403
2813,0.000175,172.31.33.0-255,66,24303,21,249403
2814,0.000204,74.125.68.0-255,6797,31100,21,249403
2815,0.000206,172.31.33.0-255,66,31166,21,249403
2816,0.000283,74.125.68.0-255,1484,32650,21,249403
2817,0.000287,172.31.33.0-255,66,32716,21,249403
2818,0.000312,74.125.68.0-255,2902,35618,21,249403
2819,0.000315,172.31.33.0-255,66,35684,21,249403
2820,0.000317,74.125.68.0-255,1484,37168,21,249403
2821,0.000319,172.31.33.0-255,66,37234,21,249403
2822,0.000323,74.125.68.0-255,2902,40136,21,249403
2823,0.000326,172.31.33.0-255,66,40202,21,249403
2824,0.000349,74.125.68.0-255,5738,45940,21,249403
2825,0.000352,172.31.33.0-255,66,46006,21,249403
2826,0.000393,172.31.33.0-255,66,46072,21,249403
2827,0.000423,74.125.68.0-255,2902,48974,21,249403
2828,0.000426,172.31.33.0-255,66,49040,21,249403
2829,0.000457,74.125.68.0-255,6438,55478,21,249403
2830,0.00046,172.31.33.0-255,66,55544,21,249403
2831,0.000463,74.125.68.0-255,443,55987,21,249403
2832,0.000566,74.125.68.0-255,331,56318,21,249403
2833,0.000695,172.31.33.0-255,66,56384,21,249403
2834,0.00079,74.125.68.0-255,1484,57868,21,249403
2835,0.000808,74.125.68.0-255,2902,60770,21,249403
2836,0.000812,172.31.33.0-255,66,60836,21,249403
2837,0.000817,74.125.68.0-255,1484,62320,21,249403
2838,0.000838,74.125.68.0-255,2902,65222,21,249403
2839,0.00084,172.31.33.0-255,66,65288,21,249403
2840,0.000844,74.125.68.0-255,1484,66772,21,249403
2841,0.00087,74.125.68.0-255,4320,71092,21,249403
2842,0.000873,172.31.33.0-255,66,71158,21,249403
2843,0.000887,74.125.68.0-255,4320,75478,21,249403
2844,0.000894,172.31.33.0-255,66,75544,21,249403
2845,0.000911,74.125.68.0-255,6797,82341,21,249403
2846,0.000914,172.31.33.0-255,66,82407,21,249403
2847,0.000944,172.31.33.0-255,66,82473,21,249403
2848,0.003282,74.125.68.0-255,4320,86793,21,249403
2849,0.003288,172.31.33.0-255,66,86859,21,249403
2850,0.003308,74.125.68.0-255,1484,88343,21,249403
2851,0.005615,74.125.68.0-255,4320,92663,21,249403
2852,0.00562,172.31.33.0-255,66,92729,21,249403
2853,0.007958,74.125.68.0-255,5738,98467,21,249403
2854,0.007965,172.31.33.0-255,66,98533,21,249403
2855,0.010302,74.125.68.0-255,5738,104271,21,249403
2856,0.010311,172.31.33.0-255,66,104337,21,249403
2857,0.012666,74.125.68.0-255,4320,108657,21,249403
2858,0.012673,172.31.33.0-255,66,108723,21,249403
2859,0.012706,74.125.68.0-255,1484,110207,21,249403
2860,0.015036,74.125.68.0-255,4320,114527,21,249403
2861,0.015042,172.31.33.0-255,66,114593,21,249403
2862,0.017382,74.125.68.0-255,2902,117495,21,249403
2863,0.017387,172.31.33.0-255,66,117561,21,249403
2864,0.01741,74.125.68.0-255,2902,120463,21,249403
2865,0.017412,172.31.33.0-255,66,120529,21,249403
2866,0.019709,74.125.68.0-255,2902,123431,21,249403
2867,0.019714,172.31.33.0-255,66,123497,21,249403
2868,0.01975,74.125.68.0-255,2902,126399,21,249403
2869,0.019755,172.31.33.0-255,66,126465,21,249403
2870,0.020851,172.31.33.0-255,246,126711,21,249403
2871,0.020876,172.31.33.0-255,1133,127844,21,249403
2872,0.020911,172.31.33.0-255,1514,129358,21,249403
2873,0.020913,172.31.33.0-255,1514,130872,21,249403
2874,0.020933,172.31.33.0-255,669,131541,21,249403
2875,0.022057,74.125.68.0-255,2902,134443,21,249403
2876,0.022062,172.31.33.0-255,66,134509,21,249403
2877,0.022097,74.125.68.0-255,2902,137411,21,249403
2878,0.0221,172.31.33.0-255,66,137477,21,249403
2879,0.022422,104.244.42.0-255,66,137543,21,249403
2880,0.022428,104.244.42.0-255,66,137609,21,249403
2881,0.022442,104.244.42.0-255,66,137675,21,249403
2882,0.022445,104.244.42.0-255,66,137741,21,249403
2883,0.024389,74.125.68.0-255,2902,140643,21,249403
2884,0.024393,172.31.33.0-255,66,140709,21,249403
2885,0.024421,74.125.68.0-255,2902,143611,21,249403
2886,0.024424,172.31.33.0-255,66,143677,21,249403
2887,0.026735,74.125.68.0-255,2902,146579,21,249403
2888,0.026739,172.31.33.0-255,66,146645,21,249403
2889,0.026769,74.125.68.0-255,2902,149547,21,249403
2890,0.026771,172.31.33.0-255,66,149613,21,249403
2891,0.02907,74.125.68.0-255,2902,152515,21,249403
2892,0.029076,172.31.33.0-255,66,152581,21,249403
2893,0.029094,74.125.68.0-255,2902,155483,21,249403
2894,0.029097,172.31.33.0-255,66,155549,21,249403
2895,0.031418,74.125.68.0-255,5738,161287,21,249403
2896,0.031422,172.31.33.0-255,66,161353,21,249403
2897,0.033769,74.125.68.0-255,5738,167091,21,249403
2898,0.033774,172.31.33.0-255,66,167157,21,249403
2899,0.036137,74.125.68.0-255,4320,171477,21,249403
2900,0.036142,172.31.33.0-255,66,171543,21,249403
2901,0.036171,74.125.68.0-255,1484,173027,21,249403
2902,0.038479,74.125.68.0-255,2902,175929,21,249403
2903,0.038485,172.31.33.0-255,66,175995,21,249403
2904,0.038513,74.125.68.0-255,1484,177479,21,249403
2905,0.04082,74.125.68.0-255,4320,181799,21,249403
2906,0.040824,172.31.33.0-255,66,181865,21,249403
2907,0.043164,74.125.68.0-255,5738,187603,21,249403
2908,0.043169,172.31.33.0-255,66,187669,21,249403
2909,0.045506,74.125.68.0-255,4320,191989,21,249403
2910,0.045511,172.31.33.0-255,66,192055,21,249403
2911,0.045544,74.125.68.0-255,1484,193539,21,249403
2912,0.047855,74.125.68.0-255,4320,197859,21,249403
2913,0.047861,172.31.33.0-255,66,197925,21,249403
2914,0.050186,74.125.68.0-255,5738,203663,21,249403
2915,0.05019,172.31.33.0-255,66,203729,21,249403
2916,0.052513,74.125.68.0-255,4320,208049,21,249403
2917,0.052517,172.31.33.0-255,66,208115,21,249403
2918,0.052544,74.125.68.0-255,1484,209599,21,249403
2919,0.054845,74.125.68.0-255,4320,213919,21,249403
2920,0.054851,172.31.33.0-255,66,213985,21,249403
2921,0.057185,74.125.68.0-255,5738,219723,21,249403
2922,0.05719,172.31.33.0-255,66,219789,21,249403
2923,0.059521,74.125.68.0-255,1484,221273,21,249403
2924,0.05955,74.125.68.0-255,4320,225593,21,249403
2925,0.059554,172.31.33.0-255,66,225659,21,249403
2926,0.061882,74.125.68.0-255,2902,228561,21,249403
2927,0.061886,172.31.33.0-255,66,228627,21,249403
2928,0.061914,74.125.68.0-255,2902,231529,21,249403
2929,0.061917,172.31.33.0-255,66,231595,21,249403
2930,0.06424,74.125.68.0-255,2902,234497,21,249403
2931,0.064246,172.31.33.0-255,66,234563,21,249403
2932,0.064272,74.125.68.0-255,2902,237465,21,249403
2933,0.064274,172.31.33.0-255,66,237531,21,249403
2934,0.066581,74.125.68.0-255,2902,240433,21,249403
2935,0.066588,172.31.33.0-255,66,240499,21,249403
2936,0.06662,74.125.68.0-255,2902,243401,21,249403
2937,0.066623,172.31.33.0-255,66,243467,21,249403
2938,0.068932,74.125.68.0-255,2902,246369,21,249403
2939,0.068937,172.31.33.0-255,66,246435,21,249403
2940,0.068967,74.125.68.0-255,2902,249337,21,249403
2941,0.06897,172.31.33.0-255,66,249403,21,249403
2942,0.0,172.217.194.0-255,146,146,21,194320
2943,3.2e-05,172.31.33.0-255,66,212,21,194320
2944,4e-05,172.217.194.0-255,1484,1696,21,194320
2945,4.4e-05,172.31.33.0-255,66,1762,21,194320
2946,4.8e-05,172.217.194.0-255,2902,4664,21,194320
2947,5.1e-05,172.31.33.0-255,66,4730,21,194320
2948,6.4e-05,172.217.194.0-255,7156,11886,21,194320
2949,6.7e-05,172.31.33.0-255,66,11952,21,194320
2950,0.000115,172.31.33.0-255,66,12018,21,194320
2951,0.000119,172.217.194.0-255,2543,14561,21,194320
2952,0.000121,172.31.33.0-255,66,14627,21,194320
2953,0.000156,172.217.194.0-255,1484,16111,21,194320
2954,0.000159,172.31.33.0-255,66,16177,21,194320
2955,0.000163,172.217.194.0-255,2902,19079,21,194320
2956,0.000166,172.31.33.0-255,66,19145,21,194320
2957,0.000202,172.217.194.0-255,5738,24883,21,194320
2958,0.000206,172.31.33.0-255,66,24949,21,194320
2959,0.000213,172.217.194.0-255,6797,31746,21,194320
2960,0.000215,172.31.33.0-255,66,31812,21,194320
2961,0.000221,172.217.194.0-255,4320,36132,21,194320
2962,0.000224,172.31.33.0-255,66,36198,21,194320
2963,0.000264,172.31.33.0-255,66,36264,21,194320
2964,0.000268,172.217.194.0-255,2829,39093,21,194320
2965,0.00027,172.31.33.0-255,66,39159,21,194320
2966,0.000272,172.217.194.0-255,101,39260,21,194320
2967,0.000281,172.31.33.0-255,66,39326,21,194320
2968,0.000304,172.217.194.0-255,1484,40810,21,194320
2969,0.000308,172.31.33.0-255,66,40876,21,194320
2970,0.000317,172.217.194.0-255,2902,43778,21,194320
2971,0.00032,172.31.33.0-255,66,43844,21,194320
2972,0.000323,172.217.194.0-255,1484,45328,21,194320
2973,0.00036,172.217.194.0-255,5738,51066,21,194320
2974,0.000364,172.31.33.0-255,66,51132,21,194320
2975,0.00037,172.217.194.0-255,5379,56511,21,194320
2976,0.000372,172.31.33.0-255,66,56577,21,194320
2977,0.000396,172.217.194.0-255,4320,60897,21,194320
2978,0.000401,172.31.33.0-255,66,60963,21,194320
2979,0.000413,172.217.194.0-255,5738,66701,21,194320
2980,0.000415,172.31.33.0-255,66,66767,21,194320
2981,0.000458,172.31.33.0-255,66,66833,21,194320
2982,0.000465,172.217.194.0-255,7156,73989,21,194320
2983,0.000467,172.31.33.0-255,66,74055,21,194320
2984,0.000496,172.217.194.0-255,3961,78016,21,194320
2985,0.0005,172.31.33.0-255,66,78082,21,194320
2986,0.000544,172.217.194.0-255,4320,82402,21,194320
2987,0.000548,172.31.33.0-255,66,82468,21,194320
2988,0.000553,172.217.194.0-255,4320,86788,21,194320
2989,0.000555,172.31.33.0-255,66,86854,21,194320
2990,0.000582,172.217.194.0-255,1484,88338,21,194320
2991,0.000589,172.217.194.0-255,5738,94076,21,194320
2992,0.000592,172.31.33.0-255,66,94142,21,194320
2993,0.000627,172.217.194.0-255,6797,100939,21,194320
2994,0.000631,172.31.33.0-255,66,101005,21,194320
2995,0.000649,172.31.33.0-255,66,101071,21,194320
2996,0.000654,172.217.194.0-255,4320,105391,21,194320
2997,0.000656,172.31.33.0-255,66,105457,21,194320
2998,0.0007,172.31.33.0-255,66,105523,21,194320
2999,0.000721,172.31.33.0-255,66,105589,21,194320
3000,0.000725,172.217.194.0-255,2902,108491,21,194320
3001,0.000727,172.31.33.0-255,66,108557,21,194320
3002,0.000812,172.31.33.0-255,66,108623,21,194320
3003,0.000832,172.31.33.0-255,66,108689,21,194320
3004,0.000859,172.217.194.0-255,2902,111591,21,194320
3005,0.000862,172.31.33.0-255,66,111657,21,194320
3006,0.000893,172.31.33.0-255,66,111723,21,194320
3007,0.000917,172.217.194.0-255,1484,113207,21,194320
3008,0.00094,172.217.194.0-255,2902,116109,21,194320
3009,0.000943,172.31.33.0-255,66,116175,21,194320
3010,0.000949,172.217.194.0-255,5738,121913,21,194320
3011,0.000952,172.31.33.0-255,66,121979,21,194320
3012,0.001007,172.217.194.0-255,5738,127717,21,194320
3013,0.00101,172.31.33.0-255,66,127783,21,194320
3014,0.001039,172.217.194.0-255,3961,131744,21,194320
3015,0.001048,172.31.33.0-255,66,131810,21,194320
3016,0.00106,172.31.33.0-255,66,131876,21,194320
3017,0.001064,172.217.194.0-255,3961,135837,21,194320
3018,0.001066,172.31.33.0-255,66,135903,21,194320
3019,0.001106,172.217.194.0-255,2902,138805,21,194320
3020,0.00111,172.31.33.0-255,66,138871,21,194320
3021,0.001335,172.217.194.0-255,1484,140355,21,194320
3022,0.001341,172.217.194.0-255,5738,146093,21,194320
3023,0.001344,172.31.33.0-255,66,146159,21,194320
3024,0.001362,172.31.33.0-255,66,146225,21,194320
3025,0.001369,172.217.194.0-255,7156,153381,21,194320
3026,0.001372,172.31.33.0-255,66,153447,21,194320
3027,0.001376,172.217.194.0-255,3961,157408,21,194320
3028,0.001379,172.31.33.0-255,66,157474,21,194320
3029,0.001384,172.217.194.0-255,4320,161794,21,194320
3030,0.001387,172.31.33.0-255,66,161860,21,194320
3031,0.001399,172.31.33.0-255,66,161926,21,194320
3032,0.001413,172.217.194.0-255,3602,165528,21,194320
3033,0.001433,172.31.33.0-255,66,165594,21,194320
3034,0.001446,172.31.33.0-255,66,165660,21,194320
3035,0.001447,172.31.33.0-255,66,165726,21,194320
3036,0.001498,172.217.194.0-255,1484,167210,21,194320
3037,0.001514,172.217.194.0-255,2902,170112,21,194320
3038,0.001517,172.31.33.0-255,66,170178,21,194320
3039,0.001545,172.217.194.0-255,5738,175916,21,194320
3040,0.001549,172.31.33.0-255,66,175982,21,194320
3041,0.001582,172.217.194.0-255,4320,180302,21,194320
3042,0.001585,172.31.33.0-255,66,180368,21,194320
3043,0.001625,172.31.33.0-255,66,180434,21,194320
3044,0.001669,172.217.194.0-255,5738,186172,21,194320
3045,0.001673,172.31.33.0-255,66,186238,21,194320
3046,0.001694,172.217.194.0-255,1484,187722,21,194320
3047,0.00171,172.31.33.0-255,66,187788,21,194320
3048,0.001723,172.31.33.0-255,66,187854,21,194320
3049,0.001727,172.217.194.0-255,1773,189627,21,194320
3050,0.001729,172.31.33.0-255,66,189693,21,194320
3051,0.001732,172.217.194.0-255,105,189798,21,194320
3052,0.003854,172.31.33.0-255,66,189864,21,194320
3053,0.003881,172.31.33.0-255,105,189969,21,194320
3054,0.006122,172.217.194.0-255,66,190035,21,194320
3055,0.041589,172.31.33.0-255,172,190207,21,194320
3056,0.041615,172.31.33.0-255,1113,191320,21,194320
3057,0.041667,172.31.33.0-255,1514,192834,21,194320
3058,0.041669,172.31.33.0-255,1288,194122,21,194320
3059,0.043156,104.244.42.0-255,66,194188,21,194320
3060,0.043166,104.244.42.0-255,66,194254,21,194320
3061,0.043193,104.244.42.0-255,66,194320,21,194320
3062,0.0,172.217.194.0-255,153,153,21,216933
3063,2.4e-05,172.31.33.0-255,66,219,21,216933
3064,3e-05,172.217.194.0-255,1484,1703,21,216933
3065,3.4e-05,172.31.33.0-255,66,1769,21,216933
3066,3.9e-05,172.217.194.0-255,2902,4671,21,216933
3067,4e-05,172.31.33.0-255,66,4737,21,216933
3068,6.4e-05,172.217.194.0-255,7156,11893,21,216933
3069,6.6e-05,172.31.33.0-255,66,11959,21,216933
3070,7.1e-05,172.217.194.0-255,3441,15400,21,216933
3071,7.4e-05,172.31.33.0-255,66,15466,21,216933
3072,0.000104,172.217.194.0-255,4320,19786,21,216933
3073,0.000106,172.31.33.0-255,66,19852,21,216933
3074,0.000143,172.31.33.0-255,66,19918,21,216933
3075,0.000148,172.217.194.0-255,2543,22461,21,216933
3076,0.00015,172.31.33.0-255,66,22527,21,216933
3077,0.000154,172.217.194.0-255,2902,25429,21,216933
3078,0.000156,172.31.33.0-255,66,25495,21,216933
3079,0.000158,172.217.194.0-255,1484,26979,21,216933
3080,0.00016,172.31.33.0-255,66,27045,21,216933
3081,0.000184,172.217.194.0-255,5738,32783,21,216933
3082,0.000187,172.31.33.0-255,66,32849,21,216933
3083,0.000193,172.217.194.0-255,4320,37169,21,216933
3084,0.000195,172.31.33.0-255,66,37235,21,216933
3085,0.000222,172.217.194.0-255,7156,44391,21,216933
3086,0.000225,172.31.33.0-255,66,44457,21,216933
3087,0.000242,172.217.194.0-255,1484,45941,21,216933
3088,0.000244,172.31.33.0-255,66,46007,21,216933
3089,0.000268,172.31.33.0-255,66,46073,21,216933
3090,0.000287,172.217.194.0-255,2491,48564,21,216933
3091,0.00029,172.31.33.0-255,66,48630,21,216933
3092,0.000499,172.217.194.0-255,369,48999,21,216933
3093,0.000593,172.217.194.0-255,1484,50483,21,216933
3094,0.000597,172.31.33.0-255,66,50549,21,216933
3095,0.000602,172.217.194.0-255,2902,53451,21,216933
3096,0.000605,172.31.33.0-255,66,53517,21,216933
3097,0.00061,172.217.194.0-255,4320,57837,21,216933
3098,0.000611,172.31.33.0-255,66,57903,21,216933
3099,0.000628,172.217.194.0-255,1484,59387,21,216933
3100,0.000641,172.217.194.0-255,1484,60871,21,216933
3101,0.000644,172.31.33.0-255,66,60937,21,216933
3102,0.000679,172.31.33.0-255,66,61003,21,216933
3103,0.000683,172.217.194.0-255,1484,62487,21,216933
3104,0.000718,172.217.194.0-255,5738,68225,21,216933
3105,0.000722,172.31.33.0-255,66,68291,21,216933
3106,0.000739,172.217.194.0-255,3602,71893,21,216933
3107,0.000742,172.31.33.0-255,66,71959,21,216933
3108,0.000853,172.217.194.0-255,1484,73443,21,216933
3109,0.000861,172.217.194.0-255,2902,76345,21,216933
3110,0.000867,172.31.33.0-255,66,76411,21,216933
3111,0.000882,172.217.194.0-255,4320,80731,21,216933
3112,0.000885,172.31.33.0-255,66,80797,21,216933
3113,0.000908,172.217.194.0-255,1484,82281,21,216933
3114,0.000914,172.217.194.0-255,2902,85183,21,216933
3115,0.000916,172.31.33.0-255,66,85249,21,216933
3116,0.000929,172.31.33.0-255,66,85315,21,216933
3117,0.000947,172.217.194.0-255,2902,88217,21,216933
3118,0.00095,172.31.33.0-255,66,88283,21,216933
3119,0.000981,172.31.33.0-255,66,88349,21,216933
3120,0.001568,172.217.194.0-255,1484,89833,21,216933
3121,0.001579,172.217.194.0-255,2902,92735,21,216933
3122,0.001583,172.31.33.0-255,66,92801,21,216933
3123,0.001589,172.217.194.0-255,2902,95703,21,216933
3124,0.001591,172.31.33.0-255,66,95769,21,216933
3125,0.001608,172.217.194.0-255,2902,98671,21,216933
3126,0.00161,172.31.33.0-255,66,98737,21,216933
3127,0.001614,172.217.194.0-255,2902,101639,21,216933
3128,0.001616,172.31.33.0-255,66,101705,21,216933
3129,0.001653,172.217.194.0-255,7156,108861,21,216933
3130,0.001658,172.31.33.0-255,66,108927,21,216933
3131,0.001661,172.31.33.0-255,66,108993,21,216933
3132,0.001685,172.217.194.0-255,3602,112595,21,216933
3133,0.001687,172.31.33.0-255,66,112661,21,216933
3134,0.00169,172.217.194.0-255,1484,114145,21,216933
3135,0.001694,172.217.194.0-255,2902,117047,21,216933
3136,0.001696,172.31.33.0-255,66,117113,21,216933
3137,0.001702,172.217.194.0-255,5738,122851,21,216933
3138,0.001703,172.31.33.0-255,66,122917,21,216933
3139,0.001708,172.217.194.0-255,2902,125819,21,216933
3140,0.001711,172.31.33.0-255,66,125885,21,216933
3141,0.001745,172.31.33.0-255,66,125951,21,216933
3142,0.00175,172.217.194.0-255,4320,130271,21,216933
3143,0.001752,172.31.33.0-255,66,130337,21,216933
3144,0.001783,172.217.194.0-255,6438,136775,21,216933
3145,0.001788,172.31.33.0-255,66,136841,21,216933
3146,0.001826,172.217.194.0-255,4320,141161,21,216933
3147,0.001829,172.31.33.0-255,66,141227,21,216933
3148,0.001868,172.31.33.0-255,66,141293,21,216933
3149,0.001891,172.217.194.0-255,5738,147031,21,216933
3150,0.001894,172.31.33.0-255,66,147097,21,216933
3151,0.001905,172.31.33.0-255,66,147163,21,216933
3152,0.001946,172.217.194.0-255,1484,148647,21,216933
3153,0.001952,172.217.194.0-255,2902,151549,21,216933
3154,0.001955,172.31.33.0-255,66,151615,21,216933
3155,0.001961,172.217.194.0-255,5738,157353,21,216933
3156,0.001963,172.31.33.0-255,66,157419,21,216933
3157,0.001974,172.217.194.0-255,7156,164575,21,216933
3158,0.001977,172.31.33.0-255,66,164641,21,216933
3159,0.001998,172.217.194.0-255,5738,170379,21,216933
3160,0.002001,172.31.33.0-255,66,170445,21,216933
3161,0.002014,172.31.33.0-255,66,170511,21,216933
3162,0.002017,172.217.194.0-255,1484,171995,21,216933
3163,0.00203,172.217.194.0-255,2902,174897,21,216933
3164,0.002033,172.31.33.0-255,66,174963,21,216933
3165,0.002056,172.217.194.0-255,5738,180701,21,216933
3166,0.00206,172.31.33.0-255,66,180767,21,216933
3167,0.002075,172.217.194.0-255,4320,185087,21,216933
3168,0.002078,172.31.33.0-255,66,185153,21,216933
3169,0.002107,172.217.194.0-255,7156,192309,21,216933
3170,0.00211,172.31.33.0-255,66,192375,21,216933
3171,0.002128,172.217.194.0-255,1484,193859,21,216933
3172,0.002135,172.217.194.0-255,5738,199597,21,216933
3173,0.002137,172.31.33.0-255,66,199663,21,216933
3174,0.002157,172.217.194.0-255,4320,203983,21,216933
3175,0.002159,172.31.33.0-255,66,204049,21,216933
3176,0.002171,172.31.33.0-255,66,204115,21,216933
3177,0.002222,172.217.194.0-255,5738,209853,21,216933
3178,0.002227,172.31.33.0-255,66,209919,21,216933
3179,0.002236,172.31.33.0-255,66,209985,21,216933
3180,0.002239,172.31.33.0-255,66,210051,21,216933
3181,0.002255,172.31.33.0-255,66,210117,21,216933
3182,0.002293,172.31.33.0-255,66,210183,21,216933
3183,0.002307,172.31.33.0-255,66,210249,21,216933
3184,0.002354,172.31.33.0-255,66,210315,21,216933
3185,0.002357,172.217.194.0-255,766,211081,21,216933
3186,0.002373,172.31.33.0-255,66,211147,21,216933
3187,0.002376,172.217.194.0-255,105,211252,21,216933
3188,0.004101,172.31.33.0-255,66,211318,21,216933
3189,0.004132,172.31.33.0-255,105,211423,21,216933
3190,0.006597,172.217.194.0-255,66,211489,21,216933
3191,0.023765,172.31.33.0-255,176,211665,21,216933
3192,0.023808,172.31.33.0-255,1113,212778,21,216933
3193,0.023883,172.31.33.0-255,1514,214292,21,216933
3194,0.023885,172.31.33.0-255,1514,215806,21,216933
3195,0.023886,172.31.33.0-255,689,216495,21,216933
3196,0.025435,104.244.42.0-255,66,216561,21,216933
3197,0.025442,104.244.42.0-255,66,216627,21,216933
3198,0.025551,104.244.42.0-255,66,216693,21,216933
3199,0.025554,104.244.42.0-255,66,216759,21,216933
3200,0.026265,104.244.42.0-255,108,216867,21,216933
3201,0.026281,172.31.33.0-255,66,216933,21,216933
3202,0.0,172.31.33.0-255,105,105,21,1377
3203,2.8e-05,172.31.33.0-255,105,210,21,1377
3204,5.1e-05,172.31.33.0-255,105,315,21,1377
3205,0.000299,172.31.33.0-255,90,405,21,1377
3206,0.000307,172.31.33.0-255,66,471,21,1377
3207,0.000466,172.31.33.0-255,90,561,21,1377
3208,0.000473,172.31.33.0-255,66,627,21,1377
3209,0.000602,172.31.33.0-255,90,717,21,1377
3210,0.000608,172.31.33.0-255,66,783,21,1377
3211,0.001973,172.217.160.0-255,66,849,21,1377
3212,0.001989,172.217.160.0-255,66,915,21,1377
3213,0.002002,172.31.33.0-255,66,981,21,1377
3214,0.002481,172.217.194.0-255,66,1047,21,1377
3215,0.002496,172.217.194.0-255,66,1113,21,1377
3216,0.002499,172.31.33.0-255,66,1179,21,1377
3217,0.002594,172.217.194.0-255,66,1245,21,1377
3218,0.002599,172.217.194.0-255,66,1311,21,1377
3219,0.002601,172.31.33.0-255,66,1377,21,1377
3220,0.0,172.253.118.0-255,153,153,21,346333
3221,2.9e-05,172.31.33.0-255,66,219,21,346333
3222,3.6e-05,172.253.118.0-255,1484,1703,21,346333
3223,4.1e-05,172.31.33.0-255,66,1769,21,346333
3224,4.6e-05,172.253.118.0-255,2902,4671,21,346333
3225,4.8e-05,172.31.33.0-255,66,4737,21,346333
3226,5.5e-05,172.253.118.0-255,7156,11893,21,346333
3227,5.7e-05,172.31.33.0-255,66,11959,21,346333
3228,8.2e-05,172.253.118.0-255,2096,14055,21,346333
3229,8.4e-05,172.31.33.0-255,66,14121,21,346333
3230,0.000144,172.253.118.0-255,1484,15605,21,346333
3231,0.000147,172.31.33.0-255,66,15671,21,346333
3232,0.000153,172.253.118.0-255,2902,18573,21,346333
3233,0.000156,172.31.33.0-255,66,18639,21,346333
3234,0.00016,172.253.118.0-255,2902,21541,21,346333
3235,0.000162,172.31.33.0-255,66,21607,21,346333
3236,0.00019,172.253.118.0-255,2902,24509,21,346333
3237,0.000193,172.31.33.0-255,66,24575,21,346333
3238,0.000199,172.253.118.0-255,5738,30313,21,346333
3239,0.000201,172.31.33.0-255,66,30379,21,346333
3240,0.000237,172.31.33.0-255,66,30445,21,346333
3241,0.000257,172.253.118.0-255,5379,35824,21,346333
3242,0.00026,172.31.33.0-255,66,35890,21,346333
3243,0.000266,172.253.118.0-255,3961,39851,21,346333
3244,0.00027,172.31.33.0-255,66,39917,21,346333
3245,0.000298,172.253.118.0-255,1484,41401,21,346333
3246,0.000301,172.31.33.0-255,66,41467,21,346333
3247,0.000306,172.253.118.0-255,2902,44369,21,346333
3248,0.000308,172.31.33.0-255,66,44435,21,346333
3249,0.000323,172.253.118.0-255,4320,48755,21,346333
3250,0.000326,172.31.33.0-255,66,48821,21,346333
3251,0.000337,172.253.118.0-255,1484,50305,21,346333
3252,0.000344,172.253.118.0-255,2902,53207,21,346333
3253,0.000347,172.31.33.0-255,66,53273,21,346333
3254,0.000383,172.253.118.0-255,4286,57559,21,346333
3255,0.000386,172.31.33.0-255,66,57625,21,346333
3256,0.00043,172.253.118.0-255,354,57979,21,346333
3257,0.000765,172.31.33.0-255,66,58045,21,346333
3258,0.00089,172.253.118.0-255,1484,59529,21,346333
3259,0.000899,172.253.118.0-255,2902,62431,21,346333
3260,0.000903,172.31.33.0-255,66,62497,21,346333
3261,0.000908,172.253.118.0-255,2902,65399,21,346333
3262,0.00091,172.31.33.0-255,66,65465,21,346333
3263,0.000925,172.253.118.0-255,2902,68367,21,346333
3264,0.000928,172.31.33.0-255,66,68433,21,346333
3265,0.000933,172.253.118.0-255,2902,71335,21,346333
3266,0.000935,172.31.33.0-255,66,71401,21,346333
3267,0.000971,172.31.33.0-255,66,71467,21,346333
3268,0.000977,172.253.118.0-255,5738,77205,21,346333
3269,0.000979,172.31.33.0-255,66,77271,21,346333
3270,0.001,172.253.118.0-255,5020,82291,21,346333
3271,0.001003,172.31.33.0-255,66,82357,21,346333
3272,0.001143,172.253.118.0-255,1484,83841,21,346333
3273,0.001151,172.253.118.0-255,2902,86743,21,346333
3274,0.001154,172.31.33.0-255,66,86809,21,346333
3275,0.001177,172.253.118.0-255,5738,92547,21,346333
3276,0.00118,172.31.33.0-255,66,92613,21,346333
3277,0.001194,172.253.118.0-255,5738,98351,21,346333
3278,0.001197,172.31.33.0-255,66,98417,21,346333
3279,0.001215,172.253.118.0-255,7156,105573,21,346333
3280,0.001217,172.31.33.0-255,66,105639,21,346333
3281,0.001223,172.253.118.0-255,5738,111377,21,346333
3282,0.001226,172.31.33.0-255,66,111443,21,346333
3283,0.001276,172.253.118.0-255,5020,116463,21,346333
3284,0.00128,172.31.33.0-255,66,116529,21,346333
3285,0.001294,172.253.118.0-255,1484,118013,21,346333
3286,0.001297,172.253.118.0-255,1484,119497,21,346333
3287,0.001299,172.31.33.0-255,66,119563,21,346333
3288,0.001322,172.253.118.0-255,1484,121047,21,346333
3289,0.001329,172.253.118.0-255,5738,126785,21,346333
3290,0.001332,172.31.33.0-255,66,126851,21,346333
3291,0.00137,172.253.118.0-255,1484,128335,21,346333
3292,0.001397,172.31.33.0-255,66,128401,21,346333
3293,0.001402,172.253.118.0-255,5738,134139,21,346333
3294,0.001404,172.31.33.0-255,66,134205,21,346333
3295,0.001409,172.253.118.0-255,5020,139225,21,346333
3296,0.001411,172.31.33.0-255,66,139291,21,346333
3297,0.001767,172.253.118.0-255,1484,140775,21,346333
3298,0.001769,172.253.118.0-255,1484,142259,21,346333
3299,0.001771,172.31.33.0-255,66,142325,21,346333
3300,0.001783,172.253.118.0-255,1484,143809,21,346333
3301,0.001788,172.253.118.0-255,5738,149547,21,346333
3302,0.00179,172.31.33.0-255,66,149613,21,346333
3303,0.001793,172.253.118.0-255,1484,151097,21,346333
3304,0.001812,172.253.118.0-255,1484,152581,21,346333
3305,0.001814,172.31.33.0-255,66,152647,21,346333
3306,0.001822,172.31.33.0-255,66,152713,21,346333
3307,0.001841,172.253.118.0-255,1484,154197,21,346333
3308,0.00187,172.31.33.0-255,66,154263,21,346333
3309,0.001937,172.253.118.0-255,1484,155747,21,346333
3310,0.001946,172.253.118.0-255,2902,158649,21,346333
3311,0.001948,172.31.33.0-255,66,158715,21,346333
3312,0.001967,172.253.118.0-255,5738,164453,21,346333
3313,0.001969,172.31.33.0-255,66,164519,21,346333
3314,0.002001,172.31.33.0-255,66,164585,21,346333
3315,0.002019,172.253.118.0-255,7156,171741,21,346333
3316,0.002022,172.31.33.0-255,66,171807,21,346333
3317,0.002034,172.253.118.0-255,3602,175409,21,346333
3318,0.002037,172.31.33.0-255,66,175475,21,346333
3319,0.002064,172.253.118.0-255,1484,176959,21,346333
3320,0.002068,172.253.118.0-255,2902,179861,21,346333
3321,0.00207,172.31.33.0-255,66,179927,21,346333
3322,0.002089,172.253.118.0-255,5738,185665,21,346333
3323,0.002091,172.31.33.0-255,66,185731,21,346333
3324,0.002122,172.31.33.0-255,66,185797,21,346333
3325,0.002126,172.253.118.0-255,4320,190117,21,346333
3326,0.002127,172.31.33.0-255,66,190183,21,346333
3327,0.002143,172.253.118.0-255,5738,195921,21,346333
3328,0.002145,172.31.33.0-255,66,195987,21,346333
3329,0.002155,172.253.118.0-255,2902,198889,21,346333
3330,0.002157,172.31.33.0-255,66,198955,21,346333
3331,0.00217,172.253.118.0-255,2184,201139,21,346333
3332,0.002172,172.31.33.0-255,66,201205,21,346333
3333,0.002202,172.253.118.0-255,4320,205525,21,346333
3334,0.002204,172.31.33.0-255,66,205591,21,346333
3335,0.002218,172.253.118.0-255,1484,207075,21,346333
3336,0.002237,172.253.118.0-255,4320,211395,21,346333
3337,0.002239,172.31.33.0-255,66,211461,21,346333
3338,0.002249,172.253.118.0-255,2902,214363,21,346333
3339,0.002251,172.31.33.0-255,66,214429,21,346333
3340,0.002267,172.31.33.0-255,66,214495,21,346333
3341,0.002271,172.253.118.0-255,2902,217397,21,346333
3342,0.002272,172.31.33.0-255,66,217463,21,346333
3343,0.002305,172.253.118.0-255,4320,221783,21,346333
3344,0.002307,172.31.33.0-255,66,221849,21,346333
3345,0.002322,172.253.118.0-255,5020,226869,21,346333
3346,0.002324,172.31.33.0-255,66,226935,21,346333
3347,0.004595,172.253.118.0-255,2902,229837,21,346333
3348,0.004599,172.31.33.0-255,66,229903,21,346333
3349,0.004615,172.253.118.0-255,2902,232805,21,346333
3350,0.006898,172.253.118.0-255,2902,235707,21,346333
3351,0.011396,172.31.33.0-255,66,235773,21,346333
3352,0.013708,172.253.118.0-255,5738,241511,21,346333
3353,0.013724,172.31.33.0-255,66,241577,21,346333
3354,0.016028,172.253.118.0-255,5738,247315,21,346333
3355,0.016034,172.31.33.0-255,66,247381,21,346333
3356,0.018356,172.253.118.0-255,5738,253119,21,346333
3357,0.018364,172.31.33.0-255,66,253185,21,346333
3358,0.020691,172.253.118.0-255,5738,258923,21,346333
3359,0.020706,172.31.33.0-255,66,258989,21,346333
3360,0.023004,172.253.118.0-255,5738,264727,21,346333
3361,0.023013,172.31.33.0-255,66,264793,21,346333
3362,0.025362,172.253.118.0-255,5738,270531,21,346333
3363,0.02538,172.31.33.0-255,66,270597,21,346333
3364,0.027676,172.253.118.0-255,5738,276335,21,346333
3365,0.027681,172.31.33.0-255,66,276401,21,346333
3366,0.029978,172.253.118.0-255,4320,280721,21,346333
3367,0.029984,172.31.33.0-255,66,280787,21,346333
3368,0.030013,172.253.118.0-255,1484,282271,21,346333
3369,0.032284,172.253.118.0-255,4320,286591,21,346333
3370,0.032293,172.31.33.0-255,66,286657,21,346333
3371,0.034609,172.253.118.0-255,5738,292395,21,346333
3372,0.034616,172.31.33.0-255,66,292461,21,346333
3373,0.036904,172.253.118.0-255,5738,298199,21,346333
3374,0.03691,172.31.33.0-255,66,298265,21,346333
3375,0.036998,172.31.33.0-255,101,298366,21,346333
3376,0.038195,172.31.33.0-255,172,298538,21,346333
3377,0.038221,172.31.33.0-255,1113,299651,21,346333
3378,0.038255,172.31.33.0-255,1514,301165,21,346333
3379,0.038257,172.31.33.0-255,1290,302455,21,346333
3380,0.039194,172.253.118.0-255,5738,308193,21,346333
3381,0.0392,172.31.33.0-255,66,308259,21,346333
3382,0.03924,172.253.118.0-255,66,308325,21,346333
3383,0.039675,104.244.42.0-255,66,308391,21,346333
3384,0.039707,104.244.42.0-255,66,308457,21,346333
3385,0.03975,104.244.42.0-255,66,308523,21,346333
3386,0.041501,172.253.118.0-255,2902,311425,21,346333
3387,0.041505,172.31.33.0-255,66,311491,21,346333
3388,0.041527,172.253.118.0-255,2902,314393,21,346333
3389,0.041529,172.31.33.0-255,66,314459,21,346333
3390,0.043805,172.253.118.0-255,1484,315943,21,346333
3391,0.043828,172.253.118.0-255,4320,320263,21,346333
3392,0.043831,172.31.33.0-255,66,320329,21,346333
3393,0.046139,172.253.118.0-255,1484,321813,21,346333
3394,0.046166,172.253.118.0-255,4320,326133,21,346333
3395,0.046169,172.31.33.0-255,66,326199,21,346333
3396,0.048451,172.253.118.0-255,5738,331937,21,346333
3397,0.048457,172.31.33.0-255,66,332003,21,346333
3398,0.05076,172.253.118.0-255,5738,337741,21,346333
3399,0.050765,172.31.33.0-255,66,337807,21,346333
3400,0.053057,172.253.118.0-255,5738,343545,21,346333
3401,0.053062,172.31.33.0-255,66,343611,21,346333
3402,0.055356,172.253.118.0-255,2485,346096,21,346333
3403,0.055361,172.31.33.0-255,66,346162,21,346333
3404,0.055499,172.31.33.0-255,105,346267,21,346333
3405,0.061506,172.253.118.0-255,66,346333,21,346333
3406,0.0,172.217.194.0-255,148,148,21,311110
3407,1.9e-05,172.31.33.0-255,66,214,21,311110
3408,3.7e-05,172.217.194.0-255,1484,1698,21,311110
3409,4.1e-05,172.31.33.0-255,66,1764,21,311110
3410,4.5e-05,172.217.194.0-255,2902,4666,21,311110
3411,4.8e-05,172.31.33.0-255,66,4732,21,311110
3412,7.7e-05,172.217.194.0-255,7156,11888,21,311110
3413,8e-05,172.31.33.0-255,66,11954,21,311110
3414,8.3e-05,172.217.194.0-255,2010,13964,21,311110
3415,8.4e-05,172.31.33.0-255,66,14030,21,311110
3416,8.7e-05,172.217.194.0-255,1484,15514,21,311110
3417,8.8e-05,172.31.33.0-255,66,15580,21,311110
3418,0.000109,172.31.33.0-255,66,15646,21,311110
3419,0.000129,172.217.194.0-255,5379,21025,21,311110
3420,0.000132,172.31.33.0-255,66,21091,21,311110
3421,0.000199,172.217.194.0-255,1484,22575,21,311110
3422,0.000202,172.31.33.0-255,66,22641,21,311110
3423,0.000206,172.217.194.0-255,2902,25543,21,311110
3424,0.000208,172.31.33.0-255,66,25609,21,311110
3425,0.000228,172.217.194.0-255,1484,27093,21,311110
3426,0.00023,172.31.33.0-255,66,27159,21,311110
3427,0.000234,172.217.194.0-255,1484,28643,21,311110
3428,0.000235,172.31.33.0-255,66,28709,21,311110
3429,0.000247,172.217.194.0-255,1484,30193,21,311110
3430,0.00025,172.31.33.0-255,66,30259,21,311110
3431,0.000254,172.217.194.0-255,2902,33161,21,311110
3432,0.000256,172.31.33.0-255,66,33227,21,311110
3433,0.000275,172.217.194.0-255,2902,36129,21,311110
3434,0.000279,172.31.33.0-255,66,36195,21,311110
3435,0.000297,172.217.194.0-255,7156,43351,21,311110
3436,0.0003,172.31.33.0-255,66,43417,21,311110
3437,0.000317,172.217.194.0-255,5738,49155,21,311110
3438,0.00032,172.31.33.0-255,66,49221,21,311110
3439,0.000323,172.217.194.0-255,1484,50705,21,311110
3440,0.000339,172.217.194.0-255,5630,56335,21,311110
3441,0.000341,172.31.33.0-255,66,56401,21,311110
3442,0.000584,172.217.194.0-255,1484,57885,21,311110
3443,0.000595,172.217.194.0-255,2902,60787,21,311110
3444,0.000599,172.31.33.0-255,66,60853,21,311110
3445,0.00062,172.217.194.0-255,5738,66591,21,311110
3446,0.000622,172.31.33.0-255,66,66657,21,311110
3447,0.000625,172.217.194.0-255,1484,68141,21,311110
3448,0.000647,172.31.33.0-255,66,68207,21,311110
3449,0.000683,172.217.194.0-255,2902,71109,21,311110
3450,0.000686,172.31.33.0-255,66,71175,21,311110
3451,0.000702,172.217.194.0-255,4320,75495,21,311110
3452,0.000705,172.31.33.0-255,66,75561,21,311110
3453,0.000732,172.217.194.0-255,6438,81999,21,311110
3454,0.000735,172.31.33.0-255,66,82065,21,311110
3455,0.000747,172.31.33.0-255,66,82131,21,311110
3456,0.000751,172.217.194.0-255,4320,86451,21,311110
3457,0.000753,172.31.33.0-255,66,86517,21,311110
3458,0.000768,172.217.194.0-255,4320,90837,21,311110
3459,0.000771,172.31.33.0-255,66,90903,21,311110
3460,0.000788,172.217.194.0-255,2902,93805,21,311110
3461,0.000792,172.31.33.0-255,66,93871,21,311110
3462,0.00081,172.31.33.0-255,66,93937,21,311110
3463,0.000849,172.31.33.0-255,66,94003,21,311110
3464,0.00086,172.31.33.0-255,66,94069,21,311110
3465,0.000877,172.217.194.0-255,6438,100507,21,311110
3466,0.00088,172.31.33.0-255,66,100573,21,311110
3467,0.000927,172.217.194.0-255,1484,102057,21,311110
3468,0.000942,172.217.194.0-255,2902,104959,21,311110
3469,0.000945,172.31.33.0-255,66,105025,21,311110
3470,0.000964,172.217.194.0-255,5738,110763,21,311110
3471,0.000966,172.31.33.0-255,66,110829,21,311110
3472,0.000986,172.217.194.0-255,5738,116567,21,311110
3473,0.000988,172.31.33.0-255,66,116633,21,311110
3474,0.001008,172.217.194.0-255,7156,123789,21,311110
3475,0.001011,172.31.33.0-255,66,123855,21,311110
3476,0.001019,172.31.33.0-255,66,123921,21,311110
3477,0.001041,172.217.194.0-255,2184,126105,21,311110
3478,0.001043,172.31.33.0-255,66,126171,21,311110
3479,0.001288,172.217.194.0-255,1484,127655,21,311110
3480,0.001292,172.217.194.0-255,1484,129139,21,311110
3481,0.001294,172.31.33.0-255,66,129205,21,311110
3482,0.001311,172.217.194.0-255,1484,130689,21,311110
3483,0.001316,172.217.194.0-255,4320,135009,21,311110
3484,0.001319,172.31.33.0-255,66,135075,21,311110
3485,0.001335,172.217.194.0-255,1484,136559,21,311110
3486,0.001345,172.31.33.0-255,66,136625,21,311110
3487,0.001369,172.217.194.0-255,4320,140945,21,311110
3488,0.001371,172.31.33.0-255,66,141011,21,311110
3489,0.001381,172.31.33.0-255,66,141077,21,311110
3490,0.001547,172.217.194.0-255,1484,142561,21,311110
3491,0.00155,172.217.194.0-255,1484,144045,21,311110
3492,0.001553,172.31.33.0-255,66,144111,21,311110
3493,0.001563,172.217.194.0-255,1484,145595,21,311110
3494,0.001568,172.217.194.0-255,4320,149915,21,311110
3495,0.00157,172.31.33.0-255,66,149981,21,311110
3496,0.00159,172.217.194.0-255,1484,151465,21,311110
3497,0.001594,172.217.194.0-255,4320,155785,21,311110
3498,0.001596,172.31.33.0-255,66,155851,21,311110
3499,0.001626,172.31.33.0-255,66,155917,21,311110
3500,0.001636,172.31.33.0-255,66,155983,21,311110
3501,0.001655,172.217.194.0-255,766,156749,21,311110
3502,0.001957,172.31.33.0-255,66,156815,21,311110
3503,0.002268,172.217.194.0-255,1484,158299,21,311110
3504,0.002277,172.217.194.0-255,2902,161201,21,311110
3505,0.002281,172.31.33.0-255,66,161267,21,311110
3506,0.004191,172.217.194.0-255,1484,162751,21,311110
3507,0.004509,172.217.194.0-255,2902,165653,21,311110
3508,0.004513,172.31.33.0-255,66,165719,21,311110
3509,0.00453,172.217.194.0-255,1484,167203,21,311110
3510,0.006769,172.217.194.0-255,4320,171523,21,311110
3511,0.006771,172.31.33.0-255,66,171589,21,311110
3512,0.009027,172.217.194.0-255,5738,177327,21,311110
3513,0.009033,172.31.33.0-255,66,177393,21,311110
3514,0.011265,172.217.194.0-255,5738,183131,21,311110
3515,0.01127,172.31.33.0-255,66,183197,21,311110
3516,0.013522,172.217.194.0-255,5738,188935,21,311110
3517,0.013531,172.31.33.0-255,66,189001,21,311110
3518,0.015811,172.217.194.0-255,5738,194739,21,311110
3519,0.015818,172.31.33.0-255,66,194805,21,311110
3520,0.018075,172.217.194.0-255,5738,200543,21,311110
3521,0.018082,172.31.33.0-255,66,200609,21,311110
3522,0.020343,172.217.194.0-255,5738,206347,21,311110
3523,0.020348,172.31.33.0-255,66,206413,21,311110
3524,0.022603,172.217.194.0-255,5738,212151,21,311110
3525,0.022608,172.31.33.0-255,66,212217,21,311110
3526,0.024852,172.217.194.0-255,5738,217955,21,311110
3527,0.024858,172.31.33.0-255,66,218021,21,311110
3528,0.025472,172.31.33.0-255,172,218193,21,311110
3529,0.025508,172.31.33.0-255,1114,219307,21,311110
3530,0.025568,172.31.33.0-255,1514,220821,21,311110
3531,0.02557,172.31.33.0-255,1514,222335,21,311110
3532,0.025595,172.31.33.0-255,688,223023,21,311110
3533,0.027005,104.244.42.0-255,66,223089,21,311110
3534,0.027056,104.244.42.0-255,66,223155,21,311110
3535,0.027097,104.244.42.0-255,66,223221,21,311110
3536,0.027101,172.217.194.0-255,1484,224705,21,311110
3537,0.027123,172.217.194.0-255,4320,229025,21,311110
3538,0.027127,172.31.33.0-255,66,229091,21,311110
3539,0.02716,104.244.42.0-255,66,229157,21,311110
3540,0.029354,172.217.194.0-255,5738,234895,21,311110
3541,0.029359,172.31.33.0-255,66,234961,21,311110
3542,0.0316,172.217.194.0-255,5738,240699,21,311110
3543,0.031605,172.31.33.0-255,66,240765,21,311110
3544,0.033833,172.217.194.0-255,5738,246503,21,311110
3545,0.033839,172.31.33.0-255,66,246569,21,311110
3546,0.036127,172.217.194.0-255,5738,252307,21,311110
3547,0.036131,172.31.33.0-255,66,252373,21,311110
3548,0.038387,172.217.194.0-255,5738,258111,21,311110
3549,0.038392,172.31.33.0-255,66,258177,21,311110
3550,0.040621,172.217.194.0-255,5738,263915,21,311110
3551,0.040625,172.31.33.0-255,66,263981,21,311110
3552,0.042854,172.217.194.0-255,5738,269719,21,311110
3553,0.042858,172.31.33.0-255,66,269785,21,311110
3554,0.045128,172.217.194.0-255,5738,275523,21,311110
3555,0.045134,172.31.33.0-255,66,275589,21,311110
3556,0.047406,172.217.194.0-255,5738,281327,21,311110
3557,0.047411,172.31.33.0-255,66,281393,21,311110
3558,0.049665,172.217.194.0-255,2902,284295,21,311110
3559,0.049669,172.31.33.0-255,66,284361,21,311110
3560,0.049692,172.217.194.0-255,2902,287263,21,311110
3561,0.049695,172.31.33.0-255,66,287329,21,311110
3562,0.051893,172.217.194.0-255,2902,290231,21,311110
3563,0.051897,172.31.33.0-255,66,290297,21,311110
3564,0.051947,172.217.194.0-255,1484,291781,21,311110
3565,0.051961,172.217.194.0-255,1484,293265,21,311110
3566,0.051964,172.31.33.0-255,66,293331,21,311110
3567,0.054131,172.217.194.0-255,2902,296233,21,311110
3568,0.054136,172.31.33.0-255,66,296299,21,311110
3569,0.054229,172.217.194.0-255,2902,299201,21,311110
3570,0.054235,172.31.33.0-255,66,299267,21,311110
3571,0.05636,172.217.194.0-255,1484,300751,21,311110
3572,0.056489,172.217.194.0-255,4320,305071,21,311110
3573,0.056494,172.31.33.0-255,66,305137,21,311110
3574,0.058726,172.217.194.0-255,5736,310873,21,311110
3575,0.058731,172.31.33.0-255,66,310939,21,311110
3576,0.058881,172.31.33.0-255,105,311044,21,311110
3577,0.061107,172.217.194.0-255,66,311110,21,311110
3578,0.0,172.31.33.0-255,299,299,21,365
3579,0.00153,104.244.42.0-255,66,365,21,365
3580,0.0,172.31.33.0-255,66,66,21,66
3581,0.0,172.31.33.0-255,105,105,21,459
3582,0.000202,172.31.33.0-255,90,195,21,459
3583,0.000212,172.31.33.0-255,66,261,21,459
3584,0.003233,74.125.24.0-255,66,327,21,459
3585,0.003244,74.125.24.0-255,66,393,21,459
3586,0.003253,172.31.33.0-255,66,459,21,459
3587,0.0,74.125.24.0-255,153,153,21,237394
3588,2.7e-05,172.31.33.0-255,66,219,21,237394
3589,3.3e-05,74.125.24.0-255,1484,1703,21,237394
3590,3.8e-05,172.31.33.0-255,66,1769,21,237394
3591,4.3e-05,74.125.24.0-255,2902,4671,21,237394
3592,4.6e-05,172.31.33.0-255,66,4737,21,237394
3593,8.2e-05,74.125.24.0-255,4320,9057,21,237394
3594,8.5e-05,172.31.33.0-255,66,9123,21,237394
3595,0.00011,74.125.24.0-255,2902,12025,21,237394
3596,0.000112,172.31.33.0-255,66,12091,21,237394
3597,0.000125,172.31.33.0-255,66,12157,21,237394
3598,0.000136,172.31.33.0-255,66,12223,21,237394
3599,0.000151,74.125.24.0-255,1484,13707,21,237394
3600,0.000154,172.31.33.0-255,66,13773,21,237394
3601,0.000181,74.125.24.0-255,2902,16675,21,237394
3602,0.000183,172.31.33.0-255,66,16741,21,237394
3603,0.000186,74.125.24.0-255,1484,18225,21,237394
3604,0.000189,172.31.33.0-255,66,18291,21,237394
3605,0.000193,74.125.24.0-255,2902,21193,21,237394
3606,0.000195,172.31.33.0-255,66,21259,21,237394
3607,0.000201,74.125.24.0-255,4320,25579,21,237394
3608,0.000203,172.31.33.0-255,66,25645,21,237394
3609,0.000224,74.125.24.0-255,1484,27129,21,237394
3610,0.000227,172.31.33.0-255,66,27195,21,237394
3611,0.000231,74.125.24.0-255,2543,29738,21,237394
3612,0.000233,172.31.33.0-255,66,29804,21,237394
3613,0.000287,74.125.24.0-255,1484,31288,21,237394
3614,0.000291,172.31.33.0-255,66,31354,21,237394
3615,0.000299,74.125.24.0-255,2902,34256,21,237394
3616,0.000302,172.31.33.0-255,66,34322,21,237394
3617,0.000304,74.125.24.0-255,1484,35806,21,237394
3618,0.00032,74.125.24.0-255,4320,40126,21,237394
3619,0.000324,172.31.33.0-255,66,40192,21,237394
3620,0.000329,74.125.24.0-255,4320,44512,21,237394
3621,0.000331,172.31.33.0-255,66,44578,21,237394
3622,0.000372,74.125.24.0-255,2876,47454,21,237394
3623,0.000376,172.31.33.0-255,66,47520,21,237394
3624,0.000534,74.125.24.0-255,109,47629,21,237394
3625,0.000584,74.125.24.0-255,332,47961,21,237394
3626,0.000753,74.125.24.0-255,1484,49445,21,237394
3627,0.000757,172.31.33.0-255,66,49511,21,237394
3628,0.000761,74.125.24.0-255,1484,50995,21,237394
3629,0.000777,74.125.24.0-255,1484,52479,21,237394
3630,0.00078,172.31.33.0-255,66,52545,21,237394
3631,0.000783,74.125.24.0-255,1484,54029,21,237394
3632,0.000789,74.125.24.0-255,5738,59767,21,237394
3633,0.000791,172.31.33.0-255,66,59833,21,237394
3634,0.000821,74.125.24.0-255,2902,62735,21,237394
3635,0.000824,172.31.33.0-255,66,62801,21,237394
3636,0.000846,172.31.33.0-255,66,62867,21,237394
3637,0.000851,74.125.24.0-255,4320,67187,21,237394
3638,0.000854,172.31.33.0-255,66,67253,21,237394
3639,0.000876,74.125.24.0-255,5020,72273,21,237394
3640,0.000879,172.31.33.0-255,66,72339,21,237394
3641,0.000926,74.125.24.0-255,1484,73823,21,237394
3642,0.000943,74.125.24.0-255,2902,76725,21,237394
3643,0.000946,172.31.33.0-255,66,76791,21,237394
3644,0.000965,74.125.24.0-255,4320,81111,21,237394
3645,0.000968,172.31.33.0-255,66,81177,21,237394
3646,0.000988,74.125.24.0-255,1484,82661,21,237394
3647,0.001007,74.125.24.0-255,4320,86981,21,237394
3648,0.00101,172.31.33.0-255,66,87047,21,237394
3649,0.001036,172.31.33.0-255,66,87113,21,237394
3650,0.001043,74.125.24.0-255,7156,94269,21,237394
3651,0.001045,172.31.33.0-255,66,94335,21,237394
3652,0.001064,74.125.24.0-255,3602,97937,21,237394
3653,0.001066,172.31.33.0-255,66,98003,21,237394
3654,0.001101,172.31.33.0-255,66,98069,21,237394
3655,0.001104,74.125.24.0-255,1484,99553,21,237394
3656,0.001121,74.125.24.0-255,7156,106709,21,237394
3657,0.001124,172.31.33.0-255,66,106775,21,237394
3658,0.001145,74.125.24.0-255,1484,108259,21,237394
3659,0.001158,172.31.33.0-255,66,108325,21,237394
3660,0.001173,74.125.24.0-255,3602,111927,21,237394
3661,0.001176,172.31.33.0-255,66,111993,21,237394
3662,0.001179,74.125.24.0-255,1484,113477,21,237394
3663,0.0012,74.125.24.0-255,1484,114961,21,237394
3664,0.001205,172.31.33.0-255,66,115027,21,237394
3665,0.001211,74.125.24.0-255,1484,116511,21,237394
3666,0.001222,74.125.24.0-255,1484,117995,21,237394
3667,0.001224,172.31.33.0-255,66,118061,21,237394
3668,0.001246,74.125.24.0-255,4320,122381,21,237394
3669,0.001249,172.31.33.0-255,66,122447,21,237394
3670,0.001294,172.31.33.0-255,66,122513,21,237394
3671,0.001311,74.125.24.0-255,1484,123997,21,237394
3672,0.001318,74.125.24.0-255,7156,131153,21,237394
3673,0.001322,172.31.33.0-255,66,131219,21,237394
3674,0.001335,172.31.33.0-255,66,131285,21,237394
3675,0.001348,172.31.33.0-255,66,131351,21,237394
3676,0.001361,172.31.33.0-255,66,131417,21,237394
3677,0.001424,74.125.24.0-255,1484,132901,21,237394
3678,0.001429,74.125.24.0-255,2902,135803,21,237394
3679,0.001432,172.31.33.0-255,66,135869,21,237394
3680,0.001455,74.125.24.0-255,5738,141607,21,237394
3681,0.001458,172.31.33.0-255,66,141673,21,237394
3682,0.001473,74.125.24.0-255,2902,144575,21,237394
3683,0.001475,172.31.33.0-255,66,144641,21,237394
3684,0.0015,172.31.33.0-255,66,144707,21,237394
3685,0.001512,172.31.33.0-255,66,144773,21,237394
3686,0.001534,74.125.24.0-255,2184,146957,21,237394
3687,0.001537,172.31.33.0-255,66,147023,21,237394
3688,0.001676,74.125.24.0-255,1484,148507,21,237394
3689,0.001689,74.125.24.0-255,2902,151409,21,237394
3690,0.001692,172.31.33.0-255,66,151475,21,237394
3691,0.001697,74.125.24.0-255,2902,154377,21,237394
3692,0.001699,172.31.33.0-255,66,154443,21,237394
3693,0.001712,74.125.24.0-255,2902,157345,21,237394
3694,0.001714,172.31.33.0-255,66,157411,21,237394
3695,0.001718,74.125.24.0-255,2902,160313,21,237394
3696,0.001719,172.31.33.0-255,66,160379,21,237394
3697,0.00174,74.125.24.0-255,7156,167535,21,237394
3698,0.001742,172.31.33.0-255,66,167601,21,237394
3699,0.001762,74.125.24.0-255,2902,170503,21,237394
3700,0.001765,172.31.33.0-255,66,170569,21,237394
3701,0.001775,172.31.33.0-255,66,170635,21,237394
3702,0.001864,74.125.24.0-255,1484,172119,21,237394
3703,0.001879,74.125.24.0-255,1484,173603,21,237394
3704,0.001882,172.31.33.0-255,66,173669,21,237394
3705,0.001896,74.125.24.0-255,1484,175153,21,237394
3706,0.001902,74.125.24.0-255,5738,180891,21,237394
3707,0.001904,172.31.33.0-255,66,180957,21,237394
3708,0.001924,74.125.24.0-255,2902,183859,21,237394
3709,0.001926,172.31.33.0-255,66,183925,21,237394
3710,0.001941,74.125.24.0-255,1484,185409,21,237394
3711,0.001957,74.125.24.0-255,7156,192565,21,237394
3712,0.001959,172.31.33.0-255,66,192631,21,237394
3713,0.001976,74.125.24.0-255,1484,194115,21,237394
3714,0.00198,74.125.24.0-255,2902,197017,21,237394
3715,0.001982,172.31.33.0-255,66,197083,21,237394
3716,0.002001,74.125.24.0-255,4320,201403,21,237394
3717,0.002003,172.31.33.0-255,66,201469,21,237394
3718,0.002022,74.125.24.0-255,5738,207207,21,237394
3719,0.002024,172.31.33.0-255,66,207273,21,237394
3720,0.002039,74.125.24.0-255,3602,210875,21,237394
3721,0.002041,172.31.33.0-255,66,210941,21,237394
3722,0.002047,74.125.24.0-255,7156,218097,21,237394
3723,0.002049,172.31.33.0-255,66,218163,21,237394
3724,0.002078,172.31.33.0-255,66,218229,21,237394
3725,0.002103,74.125.24.0-255,2184,220413,21,237394
3726,0.002104,172.31.33.0-255,66,220479,21,237394
3727,0.002107,172.31.33.0-255,66,220545,21,237394
3728,0.00215,74.125.24.0-255,7156,227701,21,237394
3729,0.002154,172.31.33.0-255,66,227767,21,237394
3730,0.002163,172.31.33.0-255,66,227833,21,237394
3731,0.002195,172.31.33.0-255,66,227899,21,237394
3732,0.002221,172.31.33.0-255,66,227965,21,237394
3733,0.002223,74.125.24.0-255,766,228731,21,237394
3734,0.002267,172.31.33.0-255,66,228797,21,237394
3735,0.002289,74.125.24.0-255,105,228902,21,237394
3736,0.011675,172.31.33.0-255,66,228968,21,237394
3737,0.011704,172.31.33.0-255,105,229073,21,237394
3738,0.014236,74.125.24.0-255,66,229139,21,237394
3739,0.037291,172.31.33.0-255,171,229310,21,237394
3740,0.037318,172.31.33.0-255,1137,230447,21,237394
3741,0.037359,172.31.33.0-255,1514,231961,21,237394
3742,0.037361,172.31.33.0-255,1514,233475,21,237394
3743,0.037362,172.31.33.0-255,1514,234989,21,237394
3744,0.037363,172.31.33.0-255,1514,236503,21,237394
3745,0.037364,172.31.33.0-255,453,236956,21,237394
3746,0.038866,104.244.42.0-255,66,237022,21,237394
3747,0.038897,104.244.42.0-255,66,237088,21,237394
3748,0.03895,104.244.42.0-255,66,237154,21,237394
3749,0.038953,104.244.42.0-255,66,237220,21,237394
3750,0.039682,104.244.42.0-255,108,237328,21,237394
3751,0.0397,172.31.33.0-255,66,237394,21,237394
3752,0.0,172.217.194.0-255,299,299,21,204718
3753,1.7e-05,172.31.33.0-255,66,365,21,204718
3754,2.3e-05,172.217.194.0-255,1484,1849,21,204718
3755,2.7e-05,172.31.33.0-255,66,1915,21,204718
3756,3.2e-05,172.217.194.0-255,2902,4817,21,204718
3757,4.1e-05,172.31.33.0-255,66,4883,21,204718
3758,4.7e-05,172.217.194.0-255,4320,9203,21,204718
3759,4.9e-05,172.31.33.0-255,66,9269,21,204718
3760,8.5e-05,172.31.33.0-255,66,9335,21,204718
3761,9.1e-05,172.217.194.0-255,4320,13655,21,204718
3762,9.3e-05,172.31.33.0-255,66,13721,21,204718
3763,0.000114,172.217.194.0-255,5738,19459,21,204718
3764,0.000116,172.31.33.0-255,66,19525,21,204718
3765,0.000123,172.217.194.0-255,2543,22068,21,204718
3766,0.000125,172.31.33.0-255,66,22134,21,204718
3767,0.000187,172.217.194.0-255,1484,23618,21,204718
3768,0.00019,172.31.33.0-255,66,23684,21,204718
3769,0.000194,172.217.194.0-255,2902,26586,21,204718
3770,0.000196,172.31.33.0-255,66,26652,21,204718
3771,0.000229,172.217.194.0-255,5738,32390,21,204718
3772,0.000232,172.31.33.0-255,66,32456,21,204718
3773,0.000235,172.217.194.0-255,1484,33940,21,204718
3774,0.000237,172.31.33.0-255,66,34006,21,204718
3775,0.000264,172.217.194.0-255,5738,39744,21,204718
3776,0.000269,172.31.33.0-255,66,39810,21,204718
3777,0.000304,172.31.33.0-255,66,39876,21,204718
3778,0.000312,172.31.33.0-255,66,39942,21,204718
3779,0.000315,172.217.194.0-255,115,40057,21,204718
3780,0.000321,172.31.33.0-255,66,40123,21,204718
3781,0.000324,172.217.194.0-255,388,40511,21,204718
3782,0.000644,172.217.194.0-255,1484,41995,21,204718
3783,0.00065,172.31.33.0-255,66,42061,21,204718
3784,0.000674,172.217.194.0-255,2902,44963,21,204718
3785,0.000676,172.31.33.0-255,66,45029,21,204718
3786,0.000682,172.217.194.0-255,5738,50767,21,204718
3787,0.000684,172.31.33.0-255,66,50833,21,204718
3788,0.000698,172.31.33.0-255,66,50899,21,204718
3789,0.00073,172.217.194.0-255,7156,58055,21,204718
3790,0.000732,172.31.33.0-255,66,58121,21,204718
3791,0.000751,172.217.194.0-255,6438,64559,21,204718
3792,0.000754,172.31.33.0-255,66,64625,21,204718
3793,0.000942,172.217.194.0-255,1484,66109,21,204718
3794,0.000947,172.217.194.0-255,2902,69011,21,204718
3795,0.00095,172.31.33.0-255,66,69077,21,204718
3796,0.000971,172.217.194.0-255,5738,74815,21,204718
3797,0.000973,172.31.33.0-255,66,74881,21,204718
3798,0.001002,172.217.194.0-255,5738,80619,21,204718
3799,0.001004,172.31.33.0-255,66,80685,21,204718
3800,0.001009,172.217.194.0-255,5738,86423,21,204718
3801,0.001011,172.31.33.0-255,66,86489,21,204718
3802,0.001041,172.217.194.0-255,7156,93645,21,204718
3803,0.001043,172.31.33.0-255,66,93711,21,204718
3804,0.001049,172.217.194.0-255,5020,98731,21,204718
3805,0.001051,172.31.33.0-255,66,98797,21,204718
3806,0.001053,172.217.194.0-255,1484,100281,21,204718
3807,0.001078,172.217.194.0-255,4320,104601,21,204718
3808,0.001082,172.31.33.0-255,66,104667,21,204718
3809,0.001124,172.31.33.0-255,66,104733,21,204718
3810,0.00113,172.31.33.0-255,66,104799,21,204718
3811,0.001161,172.31.33.0-255,66,104865,21,204718
3812,0.001202,172.217.194.0-255,1484,106349,21,204718
3813,0.00122,172.31.33.0-255,66,106415,21,204718
3814,0.001236,172.31.33.0-255,66,106481,21,204718
3815,0.00124,172.217.194.0-255,2902,109383,21,204718
3816,0.001242,172.31.33.0-255,66,109449,21,204718
3817,0.001272,172.31.33.0-255,66,109515,21,204718
3818,0.001302,172.217.194.0-255,4320,113835,21,204718
3819,0.001305,172.31.33.0-255,66,113901,21,204718
3820,0.001311,172.217.194.0-255,5738,119639,21,204718
3821,0.001313,172.31.33.0-255,66,119705,21,204718
3822,0.001332,172.217.194.0-255,5738,125443,21,204718
3823,0.001334,172.31.33.0-255,66,125509,21,204718
3824,0.001363,172.217.194.0-255,5738,131247,21,204718
3825,0.001365,172.31.33.0-255,66,131313,21,204718
3826,0.001375,172.31.33.0-255,66,131379,21,204718
3827,0.001416,172.31.33.0-255,66,131445,21,204718
3828,0.001439,172.31.33.0-255,66,131511,21,204718
3829,0.001443,172.217.194.0-255,2902,134413,21,204718
3830,0.001444,172.31.33.0-255,66,134479,21,204718
3831,0.001466,172.217.194.0-255,6438,140917,21,204718
3832,0.001471,172.31.33.0-255,66,140983,21,204718
3833,0.001502,172.217.194.0-255,1484,142467,21,204718
3834,0.001506,172.217.194.0-255,2902,145369,21,204718
3835,0.001508,172.31.33.0-255,66,145435,21,204718
3836,0.001514,172.217.194.0-255,5738,151173,21,204718
3837,0.001516,172.31.33.0-255,66,151239,21,204718
3838,0.001551,172.31.33.0-255,66,151305,21,204718
3839,0.001557,172.217.194.0-255,5738,157043,21,204718
3840,0.001559,172.31.33.0-255,66,157109,21,204718
3841,0.001578,172.217.194.0-255,2902,160011,21,204718
3842,0.00158,172.31.33.0-255,66,160077,21,204718
3843,0.001601,172.217.194.0-255,2184,162261,21,204718
3844,0.001602,172.31.33.0-255,66,162327,21,204718
3845,0.001665,172.217.194.0-255,1484,163811,21,204718
3846,0.001668,172.217.194.0-255,1484,165295,21,204718
3847,0.00167,172.31.33.0-255,66,165361,21,204718
3848,0.001694,172.217.194.0-255,1484,166845,21,204718
3849,0.001701,172.217.194.0-255,5738,172583,21,204718
3850,0.001703,172.31.33.0-255,66,172649,21,204718
3851,0.001709,172.217.194.0-255,5738,178387,21,204718
3852,0.00171,172.31.33.0-255,66,178453,21,204718
3853,0.001744,172.31.33.0-255,66,178519,21,204718
3854,0.001768,172.217.194.0-255,4320,182839,21,204718
3855,0.001771,172.31.33.0-255,66,182905,21,204718
3856,0.001776,172.217.194.0-255,5020,187925,21,204718
3857,0.001778,172.31.33.0-255,66,187991,21,204718
3858,0.001859,172.217.194.0-255,1484,189475,21,204718
3859,0.001864,172.217.194.0-255,2902,192377,21,204718
3860,0.001866,172.31.33.0-255,66,192443,21,204718
3861,0.001886,172.217.194.0-255,5738,198181,21,204718
3862,0.001891,172.31.33.0-255,66,198247,21,204718
3863,0.001927,172.31.33.0-255,66,198313,21,204718
3864,0.001929,172.217.194.0-255,1484,199797,21,204718
3865,0.002001,172.31.33.0-255,66,199863,21,204718
3866,0.002015,172.31.33.0-255,66,199929,21,204718
3867,0.002052,172.31.33.0-255,66,199995,21,204718
3868,0.002062,172.31.33.0-255,66,200061,21,204718
3869,0.002069,172.217.194.0-255,105,200166,21,204718
3870,0.016389,172.31.33.0-255,66,200232,21,204718
3871,0.01644,172.31.33.0-255,105,200337,21,204718
3872,0.018639,172.217.194.0-255,66,200403,21,204718
3873,0.040133,172.31.33.0-255,200,200603,21,204718
3874,0.040162,172.31.33.0-255,1113,201716,21,204718
3875,0.040217,172.31.33.0-255,1514,203230,21,204718
3876,0.040239,172.31.33.0-255,1290,204520,21,204718
3877,0.041618,104.244.42.0-255,66,204586,21,204718
3878,0.041643,104.244.42.0-255,66,204652,21,204718
3879,0.041735,104.244.42.0-255,66,204718,21,204718
3880,0.0,74.125.24.0-255,153,153,21,285307
3881,1.3e-05,172.31.33.0-255,66,219,21,285307
3882,1.9e-05,74.125.24.0-255,1484,1703,21,285307
3883,2.2e-05,172.31.33.0-255,66,1769,21,285307
3884,2.7e-05,74.125.24.0-255,2902,4671,21,285307
3885,3e-05,172.31.33.0-255,66,4737,21,285307
3886,3.4e-05,74.125.24.0-255,2902,7639,21,285307
3887,3.7e-05,172.31.33.0-255,66,7705,21,285307
3888,5.9e-05,74.125.24.0-255,4320,12025,21,285307
3889,6.1e-05,172.31.33.0-255,66,12091,21,285307
3890,6.5e-05,74.125.24.0-255,1992,14083,21,285307
3891,6.7e-05,172.31.33.0-255,66,14149,21,285307
3892,0.000252,74.125.24.0-255,1484,15633,21,285307
3893,0.000256,172.31.33.0-255,66,15699,21,285307
3894,0.000261,74.125.24.0-255,2902,18601,21,285307
3895,0.000263,172.31.33.0-255,66,18667,21,285307
3896,0.000268,74.125.24.0-255,4320,22987,21,285307
3897,0.00027,172.31.33.0-255,66,23053,21,285307
3898,0.000286,74.125.24.0-255,1484,24537,21,285307
3899,0.000288,172.31.33.0-255,66,24603,21,285307
3900,0.000303,74.125.24.0-255,1484,26087,21,285307
3901,0.000305,172.31.33.0-255,66,26153,21,285307
3902,0.000325,74.125.24.0-255,6797,32950,21,285307
3903,0.000334,172.31.33.0-255,66,33016,21,285307
3904,0.000337,172.31.33.0-255,66,33082,21,285307
3905,0.000381,74.125.24.0-255,4320,37402,21,285307
3906,0.000384,172.31.33.0-255,66,37468,21,285307
3907,0.000396,74.125.24.0-255,2543,40011,21,285307
3908,0.000399,172.31.33.0-255,66,40077,21,285307
3909,0.000978,74.125.24.0-255,1484,41561,21,285307
3910,0.000983,172.31.33.0-255,66,41627,21,285307
3911,0.000991,74.125.24.0-255,2902,44529,21,285307
3912,0.000994,172.31.33.0-255,66,44595,21,285307
3913,0.001,74.125.24.0-255,5738,50333,21,285307
3914,0.001001,172.31.33.0-255,66,50399,21,285307
3915,0.001007,74.125.24.0-255,5738,56137,21,285307
3916,0.001008,172.31.33.0-255,66,56203,21,285307
3917,0.001025,74.125.24.0-255,1484,57687,21,285307
3918,0.001041,74.125.24.0-255,7156,64843,21,285307
3919,0.001044,172.31.33.0-255,66,64909,21,285307
3920,0.001065,74.125.24.0-255,5379,70288,21,285307
3921,0.001067,172.31.33.0-255,66,70354,21,285307
3922,0.001072,74.125.24.0-255,4542,74896,21,285307
3923,0.001073,172.31.33.0-255,66,74962,21,285307
3924,0.00114,74.125.24.0-255,1484,76446,21,285307
3925,0.001145,74.125.24.0-255,2902,79348,21,285307
3926,0.001148,172.31.33.0-255,66,79414,21,285307
3927,0.001165,74.125.24.0-255,4320,83734,21,285307
3928,0.001167,172.31.33.0-255,66,83800,21,285307
3929,0.001194,74.125.24.0-255,1484,85284,21,285307
3930,0.0012,74.125.24.0-255,6797,92081,21,285307
3931,0.001204,172.31.33.0-255,66,92147,21,285307
3932,0.001935,74.125.24.0-255,1484,93631,21,285307
3933,0.001943,74.125.24.0-255,2902,96533,21,285307
3934,0.001947,172.31.33.0-255,66,96599,21,285307
3935,0.001953,74.125.24.0-255,5738,102337,21,285307
3936,0.001955,172.31.33.0-255,66,102403,21,285307
3937,0.001967,74.125.24.0-255,1484,103887,21,285307
3938,0.001993,74.125.24.0-255,7156,111043,21,285307
3939,0.001997,172.31.33.0-255,66,111109,21,285307
3940,0.002053,74.125.24.0-255,2902,114011,21,285307
3941,0.002056,172.31.33.0-255,66,114077,21,285307
3942,0.002086,172.31.33.0-255,66,114143,21,285307
3943,0.004376,74.125.24.0-255,5738,119881,21,285307
3944,0.004381,172.31.33.0-255,66,119947,21,285307
3945,0.006677,74.125.24.0-255,5738,125685,21,285307
3946,0.006683,172.31.33.0-255,66,125751,21,285307
3947,0.008963,74.125.24.0-255,5738,131489,21,285307
3948,0.008971,172.31.33.0-255,66,131555,21,285307
3949,0.011261,74.125.24.0-255,5738,137293,21,285307
3950,0.011267,172.31.33.0-255,66,137359,21,285307
3951,0.013568,74.125.24.0-255,5738,143097,21,285307
3952,0.013577,172.31.33.0-255,66,143163,21,285307
3953,0.015873,74.125.24.0-255,5738,148901,21,285307
3954,0.01588,172.31.33.0-255,66,148967,21,285307
3955,0.01816,74.125.24.0-255,5738,154705,21,285307
3956,0.018166,172.31.33.0-255,66,154771,21,285307
3957,0.01979,172.31.33.0-255,200,154971,21,285307
3958,0.019818,172.31.33.0-255,1109,156080,21,285307
3959,0.019864,172.31.33.0-255,1514,157594,21,285307
3960,0.019866,172.31.33.0-255,1179,158773,21,285307
3961,0.020445,74.125.24.0-255,5738,164511,21,285307
3962,0.020451,172.31.33.0-255,66,164577,21,285307
3963,0.021322,104.244.42.0-255,66,164643,21,285307
3964,0.021349,104.244.42.0-255,66,164709,21,285307
3965,0.021398,104.244.42.0-255,66,164775,21,285307
3966,0.022748,74.125.24.0-255,5738,170513,21,285307
3967,0.022754,172.31.33.0-255,66,170579,21,285307
3968,0.025068,74.125.24.0-255,5738,176317,21,285307
3969,0.025074,172.31.33.0-255,66,176383,21,285307
3970,0.027359,74.125.24.0-255,5738,182121,21,285307
3971,0.027364,172.31.33.0-255,66,182187,21,285307
3972,0.029664,74.125.24.0-255,5738,187925,21,285307
3973,0.029669,172.31.33.0-255,66,187991,21,285307
3974,0.031959,74.125.24.0-255,5738,193729,21,285307
3975,0.031964,172.31.33.0-255,66,193795,21,285307
3976,0.034271,74.125.24.0-255,5738,199533,21,285307
3977,0.034277,172.31.33.0-255,66,199599,21,285307
3978,0.036608,74.125.24.0-255,5738,205337,21,285307
3979,0.036613,172.31.33.0-255,66,205403,21,285307
3980,0.038905,74.125.24.0-255,5738,211141,21,285307
3981,0.038909,172.31.33.0-255,66,211207,21,285307
3982,0.041219,74.125.24.0-255,5738,216945,21,285307
3983,0.041225,172.31.33.0-255,66,217011,21,285307
3984,0.043522,74.125.24.0-255,5738,222749,21,285307
3985,0.043528,172.31.33.0-255,66,222815,21,285307
3986,0.04583,74.125.24.0-255,5738,228553,21,285307
3987,0.045835,172.31.33.0-255,66,228619,21,285307
3988,0.048137,74.125.24.0-255,5738,234357,21,285307
3989,0.048143,172.31.33.0-255,66,234423,21,285307
3990,0.050442,74.125.24.0-255,5738,240161,21,285307
3991,0.050448,172.31.33.0-255,66,240227,21,285307
3992,0.052752,74.125.24.0-255,4320,244547,21,285307
3993,0.052757,172.31.33.0-255,66,244613,21,285307
3994,0.052775,74.125.24.0-255,1484,246097,21,285307
3995,0.055077,74.125.24.0-255,4320,250417,21,285307
3996,0.055082,172.31.33.0-255,66,250483,21,285307
3997,0.057386,74.125.24.0-255,5738,256221,21,285307
3998,0.057391,172.31.33.0-255,66,256287,21,285307
3999,0.059675,74.125.24.0-255,5738,262025,21,285307
4000,0.059681,172.31.33.0-255,66,262091,21,285307
4001,0.061975,74.125.24.0-255,5738,267829,21,285307
4002,0.061981,172.31.33.0-255,66,267895,21,285307
4003,0.064285,74.125.24.0-255,5738,273633,21,285307
4004,0.064292,172.31.33.0-255,66,273699,21,285307
4005,0.066575,74.125.24.0-255,5738,279437,21,285307
4006,0.06658,172.31.33.0-255,66,279503,21,285307
4007,0.068869,74.125.24.0-255,5738,285241,21,285307
4008,0.068875,172.31.33.0-255,66,285307,21,285307
4009,0.0,172.31.33.0-255,66,66,21,66
4010,0.0,172.31.33.0-255,105,105,21,1902
4011,4e-05,172.31.33.0-255,105,210,21,1902
4012,7.3e-05,172.31.33.0-255,105,315,21,1902
4013,0.000126,172.31.33.0-255,105,420,21,1902
4014,0.000424,172.31.33.0-255,90,510,21,1902
4015,0.000433,172.31.33.0-255,66,576,21,1902
4016,0.00081,172.31.33.0-255,90,666,21,1902
4017,0.000817,172.31.33.0-255,66,732,21,1902
4018,0.000955,172.31.33.0-255,90,822,21,1902
4019,0.000962,172.31.33.0-255,66,888,21,1902
4020,0.001091,172.31.33.0-255,90,978,21,1902
4021,0.001098,172.31.33.0-255,66,1044,21,1902
4022,0.002737,74.125.200.0-255,66,1110,21,1902
4023,0.002767,74.125.200.0-255,66,1176,21,1902
4024,0.002788,172.31.33.0-255,66,1242,21,1902
4025,0.003007,74.125.24.0-255,66,1308,21,1902
4026,0.003014,74.125.24.0-255,66,1374,21,1902
4027,0.003019,172.31.33.0-255,66,1440,21,1902
4028,0.003097,74.125.24.0-255,66,1506,21,1902
4029,0.003104,74.125.24.0-255,66,1572,21,1902
4030,0.003109,172.31.33.0-255,66,1638,21,1902
4031,0.003641,74.125.24.0-255,66,1704,21,1902
4032,0.003664,74.125.24.0-255,66,1770,21,1902
4033,0.003676,172.31.33.0-255,66,1836,21,1902
4034,0.003679,74.125.24.0-255,66,1902,21,1902
4035,0.0,172.31.33.0-255,105,105,21,2361
4036,4.9e-05,172.31.33.0-255,105,210,21,2361
4037,9.1e-05,172.31.33.0-255,105,315,21,2361
4038,0.000145,172.31.33.0-255,105,420,21,2361
4039,0.000209,172.31.33.0-255,105,525,21,2361
4040,0.000476,172.31.33.0-255,90,615,21,2361
4041,0.000487,172.31.33.0-255,66,681,21,2361
4042,0.000677,172.31.33.0-255,90,771,21,2361
4043,0.000685,172.31.33.0-255,66,837,21,2361
4044,0.000828,172.31.33.0-255,90,927,21,2361
4045,0.000835,172.31.33.0-255,66,993,21,2361
4046,0.000981,172.31.33.0-255,90,1083,21,2361
4047,0.000989,172.31.33.0-255,66,1149,21,2361
4048,0.001131,172.31.33.0-255,90,1239,21,2361
4049,0.001138,172.31.33.0-255,66,1305,21,2361
4050,0.002504,172.217.194.0-255,66,1371,21,2361
4051,0.002525,172.217.194.0-255,66,1437,21,2361
4052,0.00253,172.31.33.0-255,66,1503,21,2361
4053,0.002533,172.217.194.0-255,66,1569,21,2361
4054,0.002596,172.217.160.0-255,66,1635,21,2361
4055,0.00263,172.217.160.0-255,66,1701,21,2361
4056,0.00265,172.31.33.0-255,66,1767,21,2361
4057,0.00279,74.125.24.0-255,66,1833,21,2361
4058,0.002804,74.125.24.0-255,66,1899,21,2361
4059,0.002815,172.31.33.0-255,66,1965,21,2361
4060,0.00326,74.125.68.0-255,66,2031,21,2361
4061,0.003274,74.125.68.0-255,66,2097,21,2361
4062,0.003286,172.31.33.0-255,66,2163,21,2361
4063,0.003438,74.125.130.0-255,66,2229,21,2361
4064,0.003452,74.125.130.0-255,66,2295,21,2361
4065,0.003463,172.31.33.0-255,66,2361,21,2361
4066,0.0,172.31.33.0-255,105,105,21,459
4067,0.000356,172.31.33.0-255,90,195,21,459
4068,0.000366,172.31.33.0-255,66,261,21,459
4069,0.002319,74.125.24.0-255,66,327,21,459
4070,0.002334,74.125.24.0-255,66,393,21,459
4071,0.002345,172.31.33.0-255,66,459,21,459
4072,0.0,172.31.33.0-255,105,105,21,459
4073,0.000294,172.31.33.0-255,90,195,21,459
4074,0.000302,172.31.33.0-255,66,261,21,459
4075,0.002814,216.58.221.0-255,66,327,21,459
4076,0.002824,216.58.221.0-255,66,393,21,459
4077,0.002831,172.31.33.0-255,66,459,21,459
4078,0.0,74.125.200.0-255,152,152,21,364105
4079,2.9e-05,172.31.33.0-255,66,218,21,364105
4080,3.6e-05,74.125.200.0-255,1484,1702,21,364105
4081,4e-05,172.31.33.0-255,66,1768,21,364105
4082,4.2e-05,74.125.200.0-255,1484,3252,21,364105
4083,4.5e-05,172.31.33.0-255,66,3318,21,364105
4084,4.8e-05,74.125.200.0-255,1484,4802,21,364105
4085,5e-05,172.31.33.0-255,66,4868,21,364105
4086,6.4e-05,74.125.200.0-255,1484,6352,21,364105
4087,6.6e-05,172.31.33.0-255,66,6418,21,364105
4088,7.3e-05,74.125.200.0-255,5738,12156,21,364105
4089,7.5e-05,172.31.33.0-255,66,12222,21,364105
4090,9.4e-05,74.125.200.0-255,2019,14241,21,364105
4091,9.6e-05,172.31.33.0-255,66,14307,21,364105
4092,0.00013,74.125.200.0-255,2902,17209,21,364105
4093,0.000134,172.31.33.0-255,66,17275,21,364105
4094,0.000138,74.125.200.0-255,1484,18759,21,364105
4095,0.00014,172.31.33.0-255,66,18825,21,364105
4096,0.000143,74.125.200.0-255,1484,20309,21,364105
4097,0.000145,172.31.33.0-255,66,20375,21,364105
4098,0.000175,74.125.200.0-255,1484,21859,21,364105
4099,0.000178,172.31.33.0-255,66,21925,21,364105
4100,0.000184,74.125.200.0-255,5738,27663,21,364105
4101,0.000186,172.31.33.0-255,66,27729,21,364105
4102,0.000189,74.125.200.0-255,1484,29213,21,364105
4103,0.00019,172.31.33.0-255,66,29279,21,364105
4104,0.000205,74.125.200.0-255,2543,31822,21,364105
4105,0.000207,172.31.33.0-255,66,31888,21,364105
4106,0.000233,74.125.200.0-255,1484,33372,21,364105
4107,0.000235,172.31.33.0-255,66,33438,21,364105
4108,0.000258,74.125.200.0-255,2902,36340,21,364105
4109,0.00026,172.31.33.0-255,66,36406,21,364105
4110,0.000266,74.125.200.0-255,5738,42144,21,364105
4111,0.000268,172.31.33.0-255,66,42210,21,364105
4112,0.00029,74.125.200.0-255,1484,43694,21,364105
4113,0.000307,74.125.200.0-255,5379,49073,21,364105
4114,0.00031,172.31.33.0-255,66,49139,21,364105
4115,0.000664,74.125.200.0-255,1484,50623,21,364105
4116,0.000667,74.125.200.0-255,1484,52107,21,364105
4117,0.000672,172.31.33.0-255,66,52173,21,364105
4118,0.000678,74.125.200.0-255,1484,53657,21,364105
4119,0.000691,74.125.200.0-255,2902,56559,21,364105
4120,0.000694,172.31.33.0-255,66,56625,21,364105
4121,0.000719,74.125.200.0-255,2902,59527,21,364105
4122,0.000722,172.31.33.0-255,66,59593,21,364105
4123,0.000726,74.125.200.0-255,2902,62495,21,364105
4124,0.000728,172.31.33.0-255,66,62561,21,364105
4125,0.000733,74.125.200.0-255,3961,66522,21,364105
4126,0.000735,172.31.33.0-255,66,66588,21,364105
4127,0.000824,74.125.200.0-255,1484,68072,21,364105
4128,0.00084,74.125.200.0-255,2902,70974,21,364105
4129,0.000843,172.31.33.0-255,66,71040,21,364105
4130,0.000846,74.125.200.0-255,1484,72524,21,364105
4131,0.000861,74.125.200.0-255,2902,75426,21,364105
4132,0.000864,172.31.33.0-255,66,75492,21,364105
4133,0.000879,74.125.200.0-255,1484,76976,21,364105
4134,0.000901,172.31.33.0-255,66,77042,21,364105
4135,0.000946,74.125.200.0-255,4320,81362,21,364105
4136,0.000949,172.31.33.0-255,66,81428,21,364105
4137,0.00097,74.125.200.0-255,4320,85748,21,364105
4138,0.000973,172.31.33.0-255,66,85814,21,364105
4139,0.000992,74.125.200.0-255,1484,87298,21,364105
4140,0.001004,74.125.200.0-255,1484,88782,21,364105
4141,0.001007,172.31.33.0-255,66,88848,21,364105
4142,0.001027,74.125.200.0-255,3961,92809,21,364105
4143,0.001031,172.31.33.0-255,66,92875,21,364105
4144,0.001059,74.125.200.0-255,1484,94359,21,364105
4145,0.001077,74.125.200.0-255,2902,97261,21,364105
4146,0.00108,172.31.33.0-255,66,97327,21,364105
4147,0.001085,74.125.200.0-255,2902,100229,21,364105
4148,0.001087,172.31.33.0-255,66,100295,21,364105
4149,0.0011,74.125.200.0-255,2902,103197,21,364105
4150,0.001102,172.31.33.0-255,66,103263,21,364105
4151,0.001124,74.125.200.0-255,6783,110046,21,364105
4152,0.001127,172.31.33.0-255,66,110112,21,364105
4153,0.00117,74.125.200.0-255,1484,111596,21,364105
4154,0.001183,74.125.200.0-255,2902,114498,21,364105
4155,0.001186,172.31.33.0-255,66,114564,21,364105
4156,0.001208,74.125.200.0-255,5738,120302,21,364105
4157,0.001211,172.31.33.0-255,66,120368,21,364105
4158,0.001231,74.125.200.0-255,7156,127524,21,364105
4159,0.001234,172.31.33.0-255,66,127590,21,364105
4160,0.00125,74.125.200.0-255,1484,129074,21,364105
4161,0.001255,74.125.200.0-255,2902,131976,21,364105
4162,0.001257,172.31.33.0-255,66,132042,21,364105
4163,0.001282,74.125.200.0-255,7156,139198,21,364105
4164,0.001285,172.31.33.0-255,66,139264,21,364105
4165,0.001291,74.125.200.0-255,5020,144284,21,364105
4166,0.001293,172.31.33.0-255,66,144350,21,364105
4167,0.001687,74.125.200.0-255,1484,145834,21,364105
4168,0.001713,74.125.200.0-255,2902,148736,21,364105
4169,0.001717,172.31.33.0-255,66,148802,21,364105
4170,0.001722,74.125.200.0-255,4320,153122,21,364105
4171,0.001724,172.31.33.0-255,66,153188,21,364105
4172,0.001726,74.125.200.0-255,1484,154672,21,364105
4173,0.001754,74.125.200.0-255,7156,161828,21,364105
4174,0.001756,172.31.33.0-255,66,161894,21,364105
4175,0.001765,172.31.33.0-255,66,161960,21,364105
4176,0.001808,74.125.200.0-255,2902,164862,21,364105
4177,0.001811,172.31.33.0-255,66,164928,21,364105
4178,0.001831,74.125.200.0-255,5020,169948,21,364105
4179,0.001834,172.31.33.0-255,66,170014,21,364105
4180,0.002066,74.125.200.0-255,1484,171498,21,364105
4181,0.002087,74.125.200.0-255,2902,174400,21,364105
4182,0.002091,172.31.33.0-255,66,174466,21,364105
4183,0.002116,74.125.200.0-255,2902,177368,21,364105
4184,0.002119,172.31.33.0-255,66,177434,21,364105
4185,0.002138,74.125.200.0-255,2902,180336,21,364105
4186,0.002141,172.31.33.0-255,66,180402,21,364105
4187,0.002168,74.125.200.0-255,2902,183304,21,364105
4188,0.00217,172.31.33.0-255,66,183370,21,364105
4189,0.002187,74.125.200.0-255,2902,186272,21,364105
4190,0.00219,172.31.33.0-255,66,186338,21,364105
4191,0.0022,74.125.200.0-255,2902,189240,21,364105
4192,0.002202,172.31.33.0-255,66,189306,21,364105
4193,0.002219,74.125.200.0-255,1484,190790,21,364105
4194,0.002236,74.125.200.0-255,2902,193692,21,364105
4195,0.002238,172.31.33.0-255,66,193758,21,364105
4196,0.002256,74.125.200.0-255,2902,196660,21,364105
4197,0.002258,172.31.33.0-255,66,196726,21,364105
4198,0.00226,74.125.200.0-255,1484,198210,21,364105
4199,0.004484,74.125.200.0-255,1484,199694,21,364105
4200,0.004489,172.31.33.0-255,66,199760,21,364105
4201,0.004504,74.125.200.0-255,2902,202662,21,364105
4202,0.004506,172.31.33.0-255,66,202728,21,364105
4203,0.006741,74.125.200.0-255,5738,208466,21,364105
4204,0.006747,172.31.33.0-255,66,208532,21,364105
4205,0.009004,74.125.200.0-255,5738,214270,21,364105
4206,0.009011,172.31.33.0-255,66,214336,21,364105
4207,0.011322,74.125.200.0-255,5738,220074,21,364105
4208,0.01133,172.31.33.0-255,66,220140,21,364105
4209,0.0136,74.125.200.0-255,5738,225878,21,364105
4210,0.013606,172.31.33.0-255,66,225944,21,364105
4211,0.015861,74.125.200.0-255,4320,230264,21,364105
4212,0.015866,172.31.33.0-255,66,230330,21,364105
4213,0.015897,74.125.200.0-255,1484,231814,21,364105
4214,0.01814,74.125.200.0-255,4320,236134,21,364105
4215,0.018145,172.31.33.0-255,66,236200,21,364105
4216,0.020399,74.125.200.0-255,5738,241938,21,364105
4217,0.020405,172.31.33.0-255,66,242004,21,364105
4218,0.022654,74.125.200.0-255,5738,247742,21,364105
4219,0.02266,172.31.33.0-255,66,247808,21,364105
4220,0.024949,74.125.200.0-255,4320,252128,21,364105
4221,0.024955,172.31.33.0-255,66,252194,21,364105
4222,0.024972,74.125.200.0-255,1484,253678,21,364105
4223,0.025021,172.31.33.0-255,172,253850,21,364105
4224,0.025043,172.31.33.0-255,1109,254959,21,364105
4225,0.025122,172.31.33.0-255,1514,256473,21,364105
4226,0.025124,172.31.33.0-255,1180,257653,21,364105
4227,0.026572,104.244.42.0-255,66,257719,21,364105
4228,0.026577,104.244.42.0-255,66,257785,21,364105
4229,0.026687,104.244.42.0-255,66,257851,21,364105
4230,0.027195,74.125.200.0-255,2902,260753,21,364105
4231,0.027198,172.31.33.0-255,66,260819,21,364105
4232,0.027221,74.125.200.0-255,1484,262303,21,364105
4233,0.029452,74.125.200.0-255,4320,266623,21,364105
4234,0.029456,172.31.33.0-255,66,266689,21,364105
4235,0.03171,74.125.200.0-255,5738,272427,21,364105
4236,0.031715,172.31.33.0-255,66,272493,21,364105
4237,0.033969,74.125.200.0-255,4320,276813,21,364105
4238,0.033974,172.31.33.0-255,66,276879,21,364105
4239,0.034,74.125.200.0-255,1484,278363,21,364105
4240,0.03622,74.125.200.0-255,4320,282683,21,364105
4241,0.036225,172.31.33.0-255,66,282749,21,364105
4242,0.038475,74.125.200.0-255,2902,285651,21,364105
4243,0.038479,172.31.33.0-255,66,285717,21,364105
4244,0.038509,74.125.200.0-255,2902,288619,21,364105
4245,0.038511,172.31.33.0-255,66,288685,21,364105
4246,0.040737,74.125.200.0-255,2902,291587,21,364105
4247,0.040741,172.31.33.0-255,66,291653,21,364105
4248,0.040769,74.125.200.0-255,2902,294555,21,364105
4249,0.040772,172.31.33.0-255,66,294621,21,364105
4250,0.042991,74.125.200.0-255,2902,297523,21,364105
4251,0.042996,172.31.33.0-255,66,297589,21,364105
4252,0.043022,74.125.200.0-255,2902,300491,21,364105
4253,0.043024,172.31.33.0-255,66,300557,21,364105
4254,0.045248,74.125.200.0-255,2902,303459,21,364105
4255,0.045252,172.31.33.0-255,66,303525,21,364105
4256,0.045279,74.125.200.0-255,2902,306427,21,364105
4257,0.045281,172.31.33.0-255,66,306493,21,364105
4258,0.047514,74.125.200.0-255,2902,309395,21,364105
4259,0.047519,172.31.33.0-255,66,309461,21,364105
4260,0.047541,74.125.200.0-255,2902,312363,21,364105
4261,0.047543,172.31.33.0-255,66,312429,21,364105
4262,0.049795,74.125.200.0-255,5738,318167,21,364105
4263,0.049802,172.31.33.0-255,66,318233,21,364105
4264,0.052053,74.125.200.0-255,4320,322553,21,364105
4265,0.052058,172.31.33.0-255,66,322619,21,364105
4266,0.052085,74.125.200.0-255,1484,324103,21,364105
4267,0.054312,74.125.200.0-255,4320,328423,21,364105
4268,0.054316,172.31.33.0-255,66,328489,21,364105
4269,0.056565,74.125.200.0-255,2902,331391,21,364105
4270,0.056569,172.31.33.0-255,66,331457,21,364105
4271,0.056597,74.125.200.0-255,2902,334359,21,364105
4272,0.0566,172.31.33.0-255,66,334425,21,364105
4273,0.058814,74.125.200.0-255,2902,337327,21,364105
4274,0.058819,172.31.33.0-255,66,337393,21,364105
4275,0.05885,74.125.200.0-255,2902,340295,21,364105
4276,0.058853,172.31.33.0-255,66,340361,21,364105
4277,0.061069,74.125.200.0-255,2902,343263,21,364105
4278,0.061074,172.31.33.0-255,66,343329,21,364105
4279,0.061102,74.125.200.0-255,2902,346231,21,364105
4280,0.061105,172.31.33.0-255,66,346297,21,364105
4281,0.06332,74.125.200.0-255,2902,349199,21,364105
4282,0.063324,172.31.33.0-255,66,349265,21,364105
4283,0.063347,74.125.200.0-255,2902,352167,21,364105
4284,0.06335,172.31.33.0-255,66,352233,21,364105
4285,0.065573,74.125.200.0-255,2902,355135,21,364105
4286,0.065578,172.31.33.0-255,66,355201,21,364105
4287,0.065601,74.125.200.0-255,2902,358103,21,364105
4288,0.065604,172.31.33.0-255,66,358169,21,364105
4289,0.067836,74.125.200.0-255,2902,361071,21,364105
4290,0.067841,172.31.33.0-255,66,361137,21,364105
4291,0.067864,74.125.200.0-255,2902,364039,21,364105
4292,0.067866,172.31.33.0-255,66,364105,21,364105
4293,0.0,74.125.24.0-255,153,153,21,282367
4294,2.6e-05,172.31.33.0-255,66,219,21,282367
4295,3.3e-05,74.125.24.0-255,1484,1703,21,282367
4296,3.8e-05,172.31.33.0-255,66,1769,21,282367
4297,5.2e-05,74.125.24.0-255,2902,4671,21,282367
4298,5.6e-05,172.31.33.0-255,66,4737,21,282367
4299,6.4e-05,74.125.24.0-255,7156,11893,21,282367
4300,6.7e-05,172.31.33.0-255,66,11959,21,282367
4301,7.1e-05,74.125.24.0-255,2070,14029,21,282367
4302,7.4e-05,172.31.33.0-255,66,14095,21,282367
4303,0.000465,74.125.24.0-255,1484,15579,21,282367
4304,0.000471,172.31.33.0-255,66,15645,21,282367
4305,0.000479,74.125.24.0-255,2902,18547,21,282367
4306,0.000481,172.31.33.0-255,66,18613,21,282367
4307,0.000494,74.125.24.0-255,5738,24351,21,282367
4308,0.000496,172.31.33.0-255,66,24417,21,282367
4309,0.000522,74.125.24.0-255,5738,30155,21,282367
4310,0.000525,172.31.33.0-255,66,30221,21,282367
4311,0.000554,74.125.24.0-255,2543,32764,21,282367
4312,0.000557,172.31.33.0-255,66,32830,21,282367
4313,0.000569,172.31.33.0-255,66,32896,21,282367
4314,0.000576,74.125.24.0-255,6797,39693,21,282367
4315,0.000579,172.31.33.0-255,66,39759,21,282367
4316,0.000621,74.125.24.0-255,1484,41243,21,282367
4317,0.000624,172.31.33.0-255,66,41309,21,282367
4318,0.00063,74.125.24.0-255,2902,44211,21,282367
4319,0.000632,172.31.33.0-255,66,44277,21,282367
4320,0.000635,74.125.24.0-255,1484,45761,21,282367
4321,0.000642,172.31.33.0-255,66,45827,21,282367
4322,0.000673,74.125.24.0-255,4320,50147,21,282367
4323,0.000676,172.31.33.0-255,66,50213,21,282367
4324,0.000684,74.125.24.0-255,6797,57010,21,282367
4325,0.000686,172.31.33.0-255,66,57076,21,282367
4326,0.000853,74.125.24.0-255,647,57723,21,282367
4327,0.000885,74.125.24.0-255,1484,59207,21,282367
4328,0.000888,172.31.33.0-255,66,59273,21,282367
4329,0.000916,74.125.24.0-255,4320,63593,21,282367
4330,0.000919,172.31.33.0-255,66,63659,21,282367
4331,0.000922,74.125.24.0-255,1484,65143,21,282367
4332,0.00095,74.125.24.0-255,7156,72299,21,282367
4333,0.000953,172.31.33.0-255,66,72365,21,282367
4334,0.001016,172.31.33.0-255,66,72431,21,282367
4335,0.001047,74.125.24.0-255,1484,73915,21,282367
4336,0.00107,172.31.33.0-255,66,73981,21,282367
4337,0.001149,74.125.24.0-255,1484,75465,21,282367
4338,0.001155,74.125.24.0-255,2902,78367,21,282367
4339,0.001158,172.31.33.0-255,66,78433,21,282367
4340,0.001163,74.125.24.0-255,2902,81335,21,282367
4341,0.001166,172.31.33.0-255,66,81401,21,282367
4342,0.001197,74.125.24.0-255,2902,84303,21,282367
4343,0.0012,172.31.33.0-255,66,84369,21,282367
4344,0.001208,74.125.24.0-255,5738,90107,21,282367
4345,0.00121,172.31.33.0-255,66,90173,21,282367
4346,0.001223,172.31.33.0-255,66,90239,21,282367
4347,0.001252,74.125.24.0-255,1484,91723,21,282367
4348,0.001258,74.125.24.0-255,5020,96743,21,282367
4349,0.001261,172.31.33.0-255,66,96809,21,282367
4350,0.001287,74.125.24.0-255,1484,98293,21,282367
4351,0.001292,74.125.24.0-255,2902,101195,21,282367
4352,0.001295,172.31.33.0-255,66,101261,21,282367
4353,0.001334,74.125.24.0-255,5738,106999,21,282367
4354,0.001337,172.31.33.0-255,66,107065,21,282367
4355,0.001344,74.125.24.0-255,7156,114221,21,282367
4356,0.001347,172.31.33.0-255,66,114287,21,282367
4357,0.00139,172.31.33.0-255,66,114353,21,282367
4358,0.001395,74.125.24.0-255,2184,116537,21,282367
4359,0.001396,172.31.33.0-255,66,116603,21,282367
4360,0.001437,74.125.24.0-255,2902,119505,21,282367
4361,0.00144,172.31.33.0-255,66,119571,21,282367
4362,0.001446,74.125.24.0-255,4320,123891,21,282367
4363,0.001448,172.31.33.0-255,66,123957,21,282367
4364,0.001485,172.31.33.0-255,66,124023,21,282367
4365,0.001491,74.125.24.0-255,4320,128343,21,282367
4366,0.001493,172.31.33.0-255,66,128409,21,282367
4367,0.001519,74.125.24.0-255,1484,129893,21,282367
4368,0.00155,172.31.33.0-255,66,129959,21,282367
4369,0.001576,74.125.24.0-255,6438,136397,21,282367
4370,0.001579,172.31.33.0-255,66,136463,21,282367
4371,0.001591,172.31.33.0-255,66,136529,21,282367
4372,0.001636,74.125.24.0-255,5738,142267,21,282367
4373,0.001639,172.31.33.0-255,66,142333,21,282367
4374,0.001652,172.31.33.0-255,66,142399,21,282367
4375,0.001655,74.125.24.0-255,1484,143883,21,282367
4376,0.001681,74.125.24.0-255,2902,146785,21,282367
4377,0.001684,172.31.33.0-255,66,146851,21,282367
4378,0.00169,74.125.24.0-255,5738,152589,21,282367
4379,0.001693,172.31.33.0-255,66,152655,21,282367
4380,0.0017,74.125.24.0-255,6247,158902,21,282367
4381,0.001702,172.31.33.0-255,66,158968,21,282367
4382,0.001733,74.125.24.0-255,7156,166124,21,282367
4383,0.001737,172.31.33.0-255,66,166190,21,282367
4384,0.001763,74.125.24.0-255,7156,173346,21,282367
4385,0.001766,172.31.33.0-255,66,173412,21,282367
4386,0.00178,172.31.33.0-255,66,173478,21,282367
4387,0.001843,74.125.24.0-255,5020,178498,21,282367
4388,0.001845,172.31.33.0-255,66,178564,21,282367
4389,0.001851,74.125.24.0-255,5738,184302,21,282367
4390,0.001854,172.31.33.0-255,66,184368,21,282367
4391,0.001867,172.31.33.0-255,66,184434,21,282367
4392,0.00187,74.125.24.0-255,1484,185918,21,282367
4393,0.001923,172.31.33.0-255,66,185984,21,282367
4394,0.001951,74.125.24.0-255,5020,191004,21,282367
4395,0.001954,172.31.33.0-255,66,191070,21,282367
4396,0.002234,74.125.24.0-255,1484,192554,21,282367
4397,0.00224,74.125.24.0-255,2902,195456,21,282367
4398,0.002244,172.31.33.0-255,66,195522,21,282367
4399,0.00225,74.125.24.0-255,4320,199842,21,282367
4400,0.002252,172.31.33.0-255,66,199908,21,282367
4401,0.002269,74.125.24.0-255,1484,201392,21,282367
4402,0.002287,172.31.33.0-255,66,201458,21,282367
4403,0.002298,74.125.24.0-255,1484,202942,21,282367
4404,0.002308,74.125.24.0-255,5738,208680,21,282367
4405,0.00231,172.31.33.0-255,66,208746,21,282367
4406,0.002339,74.125.24.0-255,5020,213766,21,282367
4407,0.002343,172.31.33.0-255,66,213832,21,282367
4408,0.004603,74.125.24.0-255,5738,219570,21,282367
4409,0.00461,172.31.33.0-255,66,219636,21,282367
4410,0.006883,74.125.24.0-255,5738,225374,21,282367
4411,0.006886,172.31.33.0-255,66,225440,21,282367
4412,0.009184,74.125.24.0-255,5738,231178,21,282367
4413,0.009191,172.31.33.0-255,66,231244,21,282367
4414,0.011474,74.125.24.0-255,5738,236982,21,282367
4415,0.011481,172.31.33.0-255,66,237048,21,282367
4416,0.013808,74.125.24.0-255,5738,242786,21,282367
4417,0.013815,172.31.33.0-255,66,242852,21,282367
4418,0.0161,74.125.24.0-255,5738,248590,21,282367
4419,0.016107,172.31.33.0-255,66,248656,21,282367
4420,0.018425,74.125.24.0-255,5738,254394,21,282367
4421,0.01844,172.31.33.0-255,66,254460,21,282367
4422,0.020724,74.125.24.0-255,5738,260198,21,282367
4423,0.020735,172.31.33.0-255,66,260264,21,282367
4424,0.023039,74.125.24.0-255,5738,266002,21,282367
4425,0.023057,172.31.33.0-255,66,266068,21,282367
4426,0.025383,74.125.24.0-255,5738,271806,21,282367
4427,0.02539,172.31.33.0-255,66,271872,21,282367
4428,0.027676,74.125.24.0-255,5052,276924,21,282367
4429,0.027694,172.31.33.0-255,66,276990,21,282367
4430,0.027957,172.31.33.0-255,105,277095,21,282367
4431,0.030209,74.125.24.0-255,66,277161,21,282367
4432,0.042356,172.31.33.0-255,176,277337,21,282367
4433,0.042404,172.31.33.0-255,1113,278450,21,282367
4434,0.042476,172.31.33.0-255,1514,279964,21,282367
4435,0.042478,172.31.33.0-255,1514,281478,21,282367
4436,0.042501,172.31.33.0-255,691,282169,21,282367
4437,0.043863,104.244.42.0-255,66,282235,21,282367
4438,0.043951,104.244.42.0-255,66,282301,21,282367
4439,0.044001,104.244.42.0-255,66,282367,21,282367
4440,0.0,172.31.33.0-255,130,130,21,1688
4441,0.001982,172.31.33.0-255,236,366,21,1688
4442,0.002008,172.31.33.0-255,366,732,21,1688
4443,0.002675,74.125.24.0-255,630,1362,21,1688
4444,0.002959,172.31.33.0-255,97,1459,21,1688
4445,0.004347,74.125.24.0-255,97,1556,21,1688
4446,0.010797,74.125.24.0-255,66,1622,21,1688
4447,0.041495,172.31.33.0-255,66,1688,21,1688
4448,0.0,172.253.118.0-255,153,153,21,320241
4449,3.5e-05,172.31.33.0-255,66,219,21,320241
4450,4.2e-05,172.253.118.0-255,1484,1703,21,320241
4451,4.5e-05,172.31.33.0-255,66,1769,21,320241
4452,5e-05,172.253.118.0-255,2902,4671,21,320241
4453,5.4e-05,172.31.33.0-255,66,4737,21,320241
4454,6.2e-05,172.253.118.0-255,7156,11893,21,320241
4455,6.5e-05,172.31.33.0-255,66,11959,21,320241
4456,6.8e-05,172.253.118.0-255,1985,13944,21,320241
4457,7.2e-05,172.31.33.0-255,66,14010,21,320241
4458,0.00019,172.253.118.0-255,1484,15494,21,320241
4459,0.000196,172.31.33.0-255,66,15560,21,320241
4460,0.000216,172.253.118.0-255,2902,18462,21,320241
4461,0.000219,172.31.33.0-255,66,18528,21,320241
4462,0.000226,172.253.118.0-255,5738,24266,21,320241
4463,0.000228,172.31.33.0-255,66,24332,21,320241
4464,0.000273,172.253.118.0-255,6797,31129,21,320241
4465,0.000278,172.31.33.0-255,66,31195,21,320241
4466,0.000281,172.253.118.0-255,1484,32679,21,320241
4467,0.000282,172.31.33.0-255,66,32745,21,320241
4468,0.000303,172.253.118.0-255,5738,38483,21,320241
4469,0.000306,172.31.33.0-255,66,38549,21,320241
4470,0.000327,172.253.118.0-255,5738,44287,21,320241
4471,0.00033,172.31.33.0-255,66,44353,21,320241
4472,0.000352,172.253.118.0-255,3961,48314,21,320241
4473,0.000355,172.31.33.0-255,66,48380,21,320241
4474,0.000372,172.253.118.0-255,1484,49864,21,320241
4475,0.000375,172.31.33.0-255,66,49930,21,320241
4476,0.000396,172.253.118.0-255,2902,52832,21,320241
4477,0.000402,172.253.118.0-255,5738,58570,21,320241
4478,0.000402,172.31.33.0-255,66,58636,21,320241
4479,0.000406,172.31.33.0-255,66,58702,21,320241
4480,0.000424,172.253.118.0-255,2902,61604,21,320241
4481,0.000427,172.31.33.0-255,66,61670,21,320241
4482,0.000462,172.253.118.0-255,3961,65631,21,320241
4483,0.000467,172.31.33.0-255,66,65697,21,320241
4484,0.000492,172.253.118.0-255,677,66374,21,320241
4485,0.000735,172.253.118.0-255,1484,67858,21,320241
4486,0.00074,172.31.33.0-255,66,67924,21,320241
4487,0.000745,172.253.118.0-255,2902,70826,21,320241
4488,0.000747,172.31.33.0-255,66,70892,21,320241
4489,0.000777,172.253.118.0-255,5738,76630,21,320241
4490,0.00078,172.31.33.0-255,66,76696,21,320241
4491,0.000821,172.253.118.0-255,6797,83493,21,320241
4492,0.000824,172.31.33.0-255,66,83559,21,320241
4493,0.001418,172.253.118.0-255,1484,85043,21,320241
4494,0.00144,172.253.118.0-255,2902,87945,21,320241
4495,0.001444,172.31.33.0-255,66,88011,21,320241
4496,0.001452,172.253.118.0-255,5738,93749,21,320241
4497,0.001454,172.31.33.0-255,66,93815,21,320241
4498,0.001485,172.253.118.0-255,6797,100612,21,320241
4499,0.001488,172.31.33.0-255,66,100678,21,320241
4500,0.001698,172.253.118.0-255,1484,102162,21,320241
4501,0.001717,172.253.118.0-255,2902,105064,21,320241
4502,0.001721,172.31.33.0-255,66,105130,21,320241
4503,0.001725,172.253.118.0-255,2902,108032,21,320241
4504,0.001727,172.31.33.0-255,66,108098,21,320241
4505,0.001758,172.253.118.0-255,2902,111000,21,320241
4506,0.001761,172.31.33.0-255,66,111066,21,320241
4507,0.001769,172.253.118.0-255,7156,118222,21,320241
4508,0.001771,172.31.33.0-255,66,118288,21,320241
4509,0.001786,172.31.33.0-255,66,118354,21,320241
4510,0.001803,172.253.118.0-255,1484,119838,21,320241
4511,0.001808,172.253.118.0-255,2184,122022,21,320241
4512,0.00181,172.31.33.0-255,66,122088,21,320241
4513,0.002091,172.253.118.0-255,1484,123572,21,320241
4514,0.002111,172.253.118.0-255,2902,126474,21,320241
4515,0.002115,172.31.33.0-255,66,126540,21,320241
4516,0.002121,172.253.118.0-255,5738,132278,21,320241
4517,0.002123,172.31.33.0-255,66,132344,21,320241
4518,0.002185,172.31.33.0-255,66,132410,21,320241
4519,0.002192,172.253.118.0-255,5738,138148,21,320241
4520,0.002194,172.31.33.0-255,66,138214,21,320241
4521,0.002212,172.253.118.0-255,5020,143234,21,320241
4522,0.002215,172.31.33.0-255,66,143300,21,320241
4523,0.004441,172.253.118.0-255,4320,147620,21,320241
4524,0.004445,172.31.33.0-255,66,147686,21,320241
4525,0.004471,172.253.118.0-255,1484,149170,21,320241
4526,0.006688,172.253.118.0-255,4320,153490,21,320241
4527,0.006694,172.31.33.0-255,66,153556,21,320241
4528,0.008938,172.253.118.0-255,5738,159294,21,320241
4529,0.008947,172.31.33.0-255,66,159360,21,320241
4530,0.011192,172.253.118.0-255,5738,165098,21,320241
4531,0.011198,172.31.33.0-255,66,165164,21,320241
4532,0.013447,172.253.118.0-255,5738,170902,21,320241
4533,0.013456,172.31.33.0-255,66,170968,21,320241
4534,0.015697,172.253.118.0-255,5738,176706,21,320241
4535,0.015703,172.31.33.0-255,66,176772,21,320241
4536,0.017967,172.253.118.0-255,5738,182510,21,320241
4537,0.017976,172.31.33.0-255,66,182576,21,320241
4538,0.020243,172.253.118.0-255,5738,188314,21,320241
4539,0.020256,172.31.33.0-255,66,188380,21,320241
4540,0.022488,172.253.118.0-255,5738,194118,21,320241
4541,0.022497,172.31.33.0-255,66,194184,21,320241
4542,0.024764,172.253.118.0-255,5738,199922,21,320241
4543,0.024769,172.31.33.0-255,66,199988,21,320241
4544,0.024877,172.31.33.0-255,172,200160,21,320241
4545,0.024901,172.31.33.0-255,1109,201269,21,320241
4546,0.025008,172.31.33.0-255,1514,202783,21,320241
4547,0.02501,172.31.33.0-255,1180,203963,21,320241
4548,0.026453,104.244.42.0-255,66,204029,21,320241
4549,0.026522,104.244.42.0-255,66,204095,21,320241
4550,0.026648,104.244.42.0-255,66,204161,21,320241
4551,0.027026,172.253.118.0-255,5738,209899,21,320241
4552,0.027033,172.31.33.0-255,66,209965,21,320241
4553,0.02931,172.253.118.0-255,5738,215703,21,320241
4554,0.029317,172.31.33.0-255,66,215769,21,320241
4555,0.031566,172.253.118.0-255,5738,221507,21,320241
4556,0.031572,172.31.33.0-255,66,221573,21,320241
4557,0.033813,172.253.118.0-255,5738,227311,21,320241
4558,0.033819,172.31.33.0-255,66,227377,21,320241
4559,0.036087,172.253.118.0-255,5738,233115,21,320241
4560,0.036095,172.31.33.0-255,66,233181,21,320241
4561,0.038331,172.253.118.0-255,5738,238919,21,320241
4562,0.038338,172.31.33.0-255,66,238985,21,320241
4563,0.040577,172.253.118.0-255,5738,244723,21,320241
4564,0.040582,172.31.33.0-255,66,244789,21,320241
4565,0.042828,172.253.118.0-255,5738,250527,21,320241
4566,0.042837,172.31.33.0-255,66,250593,21,320241
4567,0.04507,172.253.118.0-255,5738,256331,21,320241
4568,0.045076,172.31.33.0-255,66,256397,21,320241
4569,0.047319,172.253.118.0-255,5738,262135,21,320241
4570,0.047324,172.31.33.0-255,66,262201,21,320241
4571,0.049579,172.253.118.0-255,5738,267939,21,320241
4572,0.049591,172.31.33.0-255,66,268005,21,320241
4573,0.051864,172.253.118.0-255,5738,273743,21,320241
4574,0.051871,172.31.33.0-255,66,273809,21,320241
4575,0.054111,172.253.118.0-255,5738,279547,21,320241
4576,0.054116,172.31.33.0-255,66,279613,21,320241
4577,0.05636,172.253.118.0-255,5738,285351,21,320241
4578,0.056366,172.31.33.0-255,66,285417,21,320241
4579,0.058615,172.253.118.0-255,5738,291155,21,320241
4580,0.058621,172.31.33.0-255,66,291221,21,320241
4581,0.060877,172.253.118.0-255,5738,296959,21,320241
4582,0.060884,172.31.33.0-255,66,297025,21,320241
4583,0.063122,172.253.118.0-255,5738,302763,21,320241
4584,0.063128,172.31.33.0-255,66,302829,21,320241
4585,0.065404,172.253.118.0-255,5738,308567,21,320241
4586,0.065412,172.31.33.0-255,66,308633,21,320241
4587,0.067639,172.253.118.0-255,5738,314371,21,320241
4588,0.067646,172.31.33.0-255,66,314437,21,320241
4589,0.0699,172.253.118.0-255,5738,320175,21,320241
4590,0.069907,172.31.33.0-255,66,320241,21,320241
4591,0.0,172.253.118.0-255,309,309,21,319472
4592,1.9e-05,172.31.33.0-255,66,375,21,319472
4593,2.4e-05,172.253.118.0-255,1484,1859,21,319472
4594,2.8e-05,172.31.33.0-255,66,1925,21,319472
4595,3.1e-05,172.253.118.0-255,1484,3409,21,319472
4596,3.4e-05,172.31.33.0-255,66,3475,21,319472
4597,6.4e-05,172.253.118.0-255,4320,7795,21,319472
4598,6.8e-05,172.31.33.0-255,66,7861,21,319472
4599,9.4e-05,172.253.118.0-255,6076,13937,21,319472
4600,9.7e-05,172.31.33.0-255,66,14003,21,319472
4601,0.000228,172.253.118.0-255,1484,15487,21,319472
4602,0.000232,172.31.33.0-255,66,15553,21,319472
4603,0.000238,172.253.118.0-255,2902,18455,21,319472
4604,0.000241,172.31.33.0-255,66,18521,21,319472
4605,0.000244,172.253.118.0-255,1484,20005,21,319472
4606,0.000246,172.31.33.0-255,66,20071,21,319472
4607,0.000276,172.253.118.0-255,4320,24391,21,319472
4608,0.000281,172.31.33.0-255,66,24457,21,319472
4609,0.000311,172.253.118.0-255,4320,28777,21,319472
4610,0.000313,172.31.33.0-255,66,28843,21,319472
4611,0.000338,172.31.33.0-255,66,28909,21,319472
4612,0.000376,172.31.33.0-255,66,28975,21,319472
4613,0.000715,172.253.118.0-255,1484,30459,21,319472
4614,0.00072,172.31.33.0-255,66,30525,21,319472
4615,0.000725,172.253.118.0-255,2902,33427,21,319472
4616,0.000727,172.31.33.0-255,66,33493,21,319472
4617,0.00075,172.253.118.0-255,5738,39231,21,319472
4618,0.000753,172.31.33.0-255,66,39297,21,319472
4619,0.000784,172.253.118.0-255,2902,42199,21,319472
4620,0.000787,172.31.33.0-255,66,42265,21,319472
4621,0.000804,172.253.118.0-255,4308,46573,21,319472
4622,0.000807,172.31.33.0-255,66,46639,21,319472
4623,0.000809,172.253.118.0-255,330,46969,21,319472
4624,0.000967,172.253.118.0-255,1484,48453,21,319472
4625,0.000972,172.31.33.0-255,66,48519,21,319472
4626,0.000977,172.253.118.0-255,2902,51421,21,319472
4627,0.000979,172.31.33.0-255,66,51487,21,319472
4628,0.000997,172.253.118.0-255,5738,57225,21,319472
4629,0.000999,172.31.33.0-255,66,57291,21,319472
4630,0.001021,172.253.118.0-255,1484,58775,21,319472
4631,0.001047,172.31.33.0-255,66,58841,21,319472
4632,0.001053,172.253.118.0-255,7156,65997,21,319472
4633,0.001055,172.31.33.0-255,66,66063,21,319472
4634,0.00108,172.253.118.0-255,2543,68606,21,319472
4635,0.001082,172.31.33.0-255,66,68672,21,319472
4636,0.001391,172.253.118.0-255,1484,70156,21,319472
4637,0.001396,172.253.118.0-255,2902,73058,21,319472
4638,0.001399,172.31.33.0-255,66,73124,21,319472
4639,0.001419,172.253.118.0-255,5738,78862,21,319472
4640,0.001421,172.31.33.0-255,66,78928,21,319472
4641,0.001447,172.31.33.0-255,66,78994,21,319472
4642,0.001487,172.253.118.0-255,4320,83314,21,319472
4643,0.001491,172.31.33.0-255,66,83380,21,319472
4644,0.001494,172.253.118.0-255,1484,84864,21,319472
4645,0.001504,172.31.33.0-255,66,84930,21,319472
4646,0.001533,172.253.118.0-255,1484,86414,21,319472
4647,0.001559,172.253.118.0-255,7156,93570,21,319472
4648,0.001562,172.31.33.0-255,66,93636,21,319472
4649,0.001572,172.31.33.0-255,66,93702,21,319472
4650,0.001597,172.253.118.0-255,5738,99440,21,319472
4651,0.001601,172.31.33.0-255,66,99506,21,319472
4652,0.001631,172.31.33.0-255,66,99572,21,319472
4653,0.002063,172.253.118.0-255,1484,101056,21,319472
4654,0.002071,172.253.118.0-255,2902,103958,21,319472
4655,0.002074,172.31.33.0-255,66,104024,21,319472
4656,0.002077,172.253.118.0-255,1484,105508,21,319472
4657,0.002096,172.253.118.0-255,4320,109828,21,319472
4658,0.002098,172.31.33.0-255,66,109894,21,319472
4659,0.0021,172.253.118.0-255,1484,111378,21,319472
4660,0.002116,172.253.118.0-255,1484,112862,21,319472
4661,0.002118,172.31.33.0-255,66,112928,21,319472
4662,0.002124,172.253.118.0-255,5738,118666,21,319472
4663,0.002126,172.31.33.0-255,66,118732,21,319472
4664,0.00214,172.253.118.0-255,4320,123052,21,319472
4665,0.002142,172.31.33.0-255,66,123118,21,319472
4666,0.002147,172.253.118.0-255,4320,127438,21,319472
4667,0.002149,172.31.33.0-255,66,127504,21,319472
4668,0.002168,172.253.118.0-255,4320,131824,21,319472
4669,0.00217,172.31.33.0-255,66,131890,21,319472
4670,0.002189,172.253.118.0-255,2184,134074,21,319472
4671,0.002191,172.31.33.0-255,66,134140,21,319472
4672,0.002232,172.253.118.0-255,1484,135624,21,319472
4673,0.002246,172.253.118.0-255,2902,138526,21,319472
4674,0.002249,172.31.33.0-255,66,138592,21,319472
4675,0.002255,172.253.118.0-255,5738,144330,21,319472
4676,0.002256,172.31.33.0-255,66,144396,21,319472
4677,0.002281,172.253.118.0-255,5738,150134,21,319472
4678,0.002283,172.31.33.0-255,66,150200,21,319472
4679,0.002303,172.253.118.0-255,7156,157356,21,319472
4680,0.002306,172.31.33.0-255,66,157422,21,319472
4681,0.002316,172.31.33.0-255,66,157488,21,319472
4682,0.002328,172.253.118.0-255,766,158254,21,319472
4683,0.004652,172.253.118.0-255,4320,162574,21,319472
4684,0.004661,172.31.33.0-255,66,162640,21,319472
4685,0.006986,172.253.118.0-255,5738,168378,21,319472
4686,0.006997,172.31.33.0-255,66,168444,21,319472
4687,0.009376,172.253.118.0-255,5738,174182,21,319472
4688,0.009383,172.31.33.0-255,66,174248,21,319472
4689,0.011708,172.253.118.0-255,5738,179986,21,319472
4690,0.011717,172.31.33.0-255,66,180052,21,319472
4691,0.014048,172.253.118.0-255,5738,185790,21,319472
4692,0.014056,172.31.33.0-255,66,185856,21,319472
4693,0.016385,172.253.118.0-255,5738,191594,21,319472
4694,0.016393,172.31.33.0-255,66,191660,21,319472
4695,0.018702,172.253.118.0-255,5738,197398,21,319472
4696,0.018709,172.31.33.0-255,66,197464,21,319472
4697,0.021072,172.253.118.0-255,5738,203202,21,319472
4698,0.021078,172.31.33.0-255,66,203268,21,319472
4699,0.023405,172.253.118.0-255,4320,207588,21,319472
4700,0.023411,172.31.33.0-255,66,207654,21,319472
4701,0.023431,172.253.118.0-255,1484,209138,21,319472
4702,0.025712,172.253.118.0-255,4320,213458,21,319472
4703,0.025718,172.31.33.0-255,66,213524,21,319472
4704,0.028038,172.253.118.0-255,5738,219262,21,319472
4705,0.028044,172.31.33.0-255,66,219328,21,319472
4706,0.028496,172.31.33.0-255,172,219500,21,319472
4707,0.028527,172.31.33.0-255,1113,220613,21,319472
4708,0.028551,172.31.33.0-255,1514,222127,21,319472
4709,0.028553,172.31.33.0-255,1514,223641,21,319472
4710,0.028574,172.31.33.0-255,691,224332,21,319472
4711,0.030161,104.244.42.0-255,66,224398,21,319472
4712,0.030168,104.244.42.0-255,66,224464,21,319472
4713,0.030212,104.244.42.0-255,66,224530,21,319472
4714,0.030215,104.244.42.0-255,66,224596,21,319472
4715,0.030362,172.253.118.0-255,1484,226080,21,319472
4716,0.030377,172.253.118.0-255,4320,230400,21,319472
4717,0.030382,172.31.33.0-255,66,230466,21,319472
4718,0.032718,172.253.118.0-255,5738,236204,21,319472
4719,0.032724,172.31.33.0-255,66,236270,21,319472
4720,0.035052,172.253.118.0-255,4320,240590,21,319472
4721,0.035056,172.31.33.0-255,66,240656,21,319472
4722,0.035076,172.253.118.0-255,1484,242140,21,319472
4723,0.037389,172.253.118.0-255,4320,246460,21,319472
4724,0.037397,172.31.33.0-255,66,246526,21,319472
4725,0.039728,172.253.118.0-255,5738,252264,21,319472
4726,0.039734,172.31.33.0-255,66,252330,21,319472
4727,0.042064,172.253.118.0-255,2902,255232,21,319472
4728,0.042069,172.31.33.0-255,66,255298,21,319472
4729,0.042095,172.253.118.0-255,2902,258200,21,319472
4730,0.042097,172.31.33.0-255,66,258266,21,319472
4731,0.0444,172.253.118.0-255,5738,264004,21,319472
4732,0.044406,172.31.33.0-255,66,264070,21,319472
4733,0.04674,172.253.118.0-255,5738,269808,21,319472
4734,0.046745,172.31.33.0-255,66,269874,21,319472
4735,0.049072,172.253.118.0-255,5738,275612,21,319472
4736,0.049077,172.31.33.0-255,66,275678,21,319472
4737,0.051393,172.253.118.0-255,5738,281416,21,319472
4738,0.051399,172.31.33.0-255,66,281482,21,319472
4739,0.053716,172.253.118.0-255,5738,287220,21,319472
4740,0.053722,172.31.33.0-255,66,287286,21,319472
4741,0.056033,172.253.118.0-255,4320,291606,21,319472
4742,0.056038,172.31.33.0-255,66,291672,21,319472
4743,0.056063,172.253.118.0-255,1484,293156,21,319472
4744,0.058359,172.253.118.0-255,4320,297476,21,319472
4745,0.058364,172.31.33.0-255,66,297542,21,319472
4746,0.060681,172.253.118.0-255,4320,301862,21,319472
4747,0.060686,172.31.33.0-255,66,301928,21,319472
4748,0.060715,172.253.118.0-255,1484,303412,21,319472
4749,0.063001,172.253.118.0-255,4320,307732,21,319472
4750,0.063006,172.31.33.0-255,66,307798,21,319472
4751,0.065338,172.253.118.0-255,5738,313536,21,319472
4752,0.065344,172.31.33.0-255,66,313602,21,319472
4753,0.067676,172.253.118.0-255,4320,317922,21,319472
4754,0.067681,172.31.33.0-255,66,317988,21,319472
4755,0.067709,172.253.118.0-255,1484,319472,21,319472
4756,0.0,172.31.33.0-255,105,105,21,459
4757,0.000203,172.31.33.0-255,90,195,21,459
4758,0.000211,172.31.33.0-255,66,261,21,459
4759,0.002942,74.125.24.0-255,66,327,21,459
4760,0.002958,74.125.24.0-255,66,393,21,459
4761,0.002971,172.31.33.0-255,66,459,21,459
4762,0.0,172.217.194.0-255,297,297,21,256628
4763,3.1e-05,172.31.33.0-255,66,363,21,256628
4764,3.7e-05,172.217.194.0-255,1484,1847,21,256628
4765,4.1e-05,172.31.33.0-255,66,1913,21,256628
4766,5.2e-05,172.217.194.0-255,4320,6233,21,256628
4767,5.5e-05,172.31.33.0-255,66,6299,21,256628
4768,5.9e-05,172.217.194.0-255,2902,9201,21,256628
4769,6.1e-05,172.31.33.0-255,66,9267,21,256628
4770,0.000109,172.217.194.0-255,4695,13962,21,256628
4771,0.000112,172.31.33.0-255,66,14028,21,256628
4772,0.000201,172.217.194.0-255,1484,15512,21,256628
4773,0.000204,172.31.33.0-255,66,15578,21,256628
4774,0.000209,172.217.194.0-255,2902,18480,21,256628
4775,0.000211,172.31.33.0-255,66,18546,21,256628
4776,0.000237,172.217.194.0-255,5738,24284,21,256628
4777,0.000239,172.31.33.0-255,66,24350,21,256628
4778,0.000268,172.31.33.0-255,66,24416,21,256628
4779,0.000274,172.217.194.0-255,7156,31572,21,256628
4780,0.000276,172.31.33.0-255,66,31638,21,256628
4781,0.000303,172.217.194.0-255,1484,33122,21,256628
4782,0.000306,172.31.33.0-255,66,33188,21,256628
4783,0.000313,172.217.194.0-255,6797,39985,21,256628
4784,0.000315,172.31.33.0-255,66,40051,21,256628
4785,0.000405,172.217.194.0-255,1484,41535,21,256628
4786,0.000408,172.31.33.0-255,66,41601,21,256628
4787,0.000414,172.217.194.0-255,2902,44503,21,256628
4788,0.000415,172.31.33.0-255,66,44569,21,256628
4789,0.00042,172.217.194.0-255,2902,47471,21,256628
4790,0.000428,172.31.33.0-255,66,47537,21,256628
4791,0.000454,172.217.194.0-255,2902,50439,21,256628
4792,0.000457,172.31.33.0-255,66,50505,21,256628
4793,0.000469,172.217.194.0-255,7049,57554,21,256628
4794,0.000478,172.31.33.0-255,66,57620,21,256628
4795,0.000648,172.217.194.0-255,1484,59104,21,256628
4796,0.000661,172.217.194.0-255,2902,62006,21,256628
4797,0.000664,172.31.33.0-255,66,62072,21,256628
4798,0.000692,172.217.194.0-255,5738,67810,21,256628
4799,0.000695,172.217.194.0-255,1484,69294,21,256628
4800,0.0007,172.31.33.0-255,66,69360,21,256628
4801,0.000708,172.217.194.0-255,4320,73680,21,256628
4802,0.000714,172.31.33.0-255,66,73746,21,256628
4803,0.000725,172.217.194.0-255,1439,75185,21,256628
4804,0.000743,172.31.33.0-255,66,75251,21,256628
4805,0.000747,172.217.194.0-255,2543,77794,21,256628
4806,0.000752,172.31.33.0-255,66,77860,21,256628
4807,0.001679,172.217.194.0-255,1484,79344,21,256628
4808,0.001689,172.217.194.0-255,2902,82246,21,256628
4809,0.001693,172.31.33.0-255,66,82312,21,256628
4810,0.001698,172.217.194.0-255,2902,85214,21,256628
4811,0.001723,172.217.194.0-255,2902,88116,21,256628
4812,0.001765,172.217.194.0-255,2902,91018,21,256628
4813,0.002103,172.217.194.0-255,1484,92502,21,256628
4814,0.002117,172.217.194.0-255,2902,95404,21,256628
4815,0.002138,172.217.194.0-255,5738,101142,21,256628
4816,0.002148,172.217.194.0-255,2902,104044,21,256628
4817,0.002176,172.217.194.0-255,1484,105528,21,256628
4818,0.002183,172.217.194.0-255,7156,112684,21,256628
4819,0.002192,172.217.194.0-255,2902,115586,21,256628
4820,0.002201,172.217.194.0-255,766,116352,21,256628
4821,0.010851,172.31.33.0-255,66,116418,21,256628
4822,0.011699,172.217.194.0-255,1484,117902,21,256628
4823,0.013151,172.217.194.0-255,4320,122222,21,256628
4824,0.013159,172.31.33.0-255,66,122288,21,256628
4825,0.015472,172.217.194.0-255,5738,128026,21,256628
4826,0.015531,172.31.33.0-255,66,128092,21,256628
4827,0.017847,172.217.194.0-255,5738,133830,21,256628
4828,0.017855,172.31.33.0-255,66,133896,21,256628
4829,0.02019,172.217.194.0-255,5738,139634,21,256628
4830,0.020196,172.31.33.0-255,66,139700,21,256628
4831,0.022237,172.31.33.0-255,171,139871,21,256628
4832,0.022261,172.31.33.0-255,1137,141008,21,256628
4833,0.022295,172.31.33.0-255,1514,142522,21,256628
4834,0.022297,172.31.33.0-255,1514,144036,21,256628
4835,0.022316,172.31.33.0-255,666,144702,21,256628
4836,0.022504,172.217.194.0-255,5738,150440,21,256628
4837,0.022509,172.31.33.0-255,66,150506,21,256628
4838,0.023764,104.244.42.0-255,66,150572,21,256628
4839,0.023844,104.244.42.0-255,66,150638,21,256628
4840,0.023847,104.244.42.0-255,66,150704,21,256628
4841,0.02385,104.244.42.0-255,66,150770,21,256628
4842,0.024813,172.217.194.0-255,2902,153672,21,256628
4843,0.024818,172.31.33.0-255,66,153738,21,256628
4844,0.024848,172.217.194.0-255,2902,156640,21,256628
4845,0.024863,172.31.33.0-255,66,156706,21,256628
4846,0.027111,172.217.194.0-255,2902,159608,21,256628
4847,0.027118,172.31.33.0-255,66,159674,21,256628
4848,0.027144,172.217.194.0-255,2902,162576,21,256628
4849,0.027154,172.31.33.0-255,66,162642,21,256628
4850,0.029437,172.217.194.0-255,5738,168380,21,256628
4851,0.029508,172.31.33.0-255,66,168446,21,256628
4852,0.0318,172.217.194.0-255,5738,174184,21,256628
4853,0.031805,172.31.33.0-255,66,174250,21,256628
4854,0.034103,172.217.194.0-255,4320,178570,21,256628
4855,0.034108,172.31.33.0-255,66,178636,21,256628
4856,0.034137,172.217.194.0-255,1484,180120,21,256628
4857,0.036403,172.217.194.0-255,4320,184440,21,256628
4858,0.036409,172.31.33.0-255,66,184506,21,256628
4859,0.038706,172.217.194.0-255,4320,188826,21,256628
4860,0.038711,172.31.33.0-255,66,188892,21,256628
4861,0.038738,172.217.194.0-255,1484,190376,21,256628
4862,0.041022,172.217.194.0-255,4320,194696,21,256628
4863,0.041027,172.31.33.0-255,66,194762,21,256628
4864,0.043324,172.217.194.0-255,2902,197664,21,256628
4865,0.04333,172.31.33.0-255,66,197730,21,256628
4866,0.043347,172.217.194.0-255,2902,200632,21,256628
4867,0.043426,172.31.33.0-255,66,200698,21,256628
4868,0.045655,172.217.194.0-255,2902,203600,21,256628
4869,0.045665,172.31.33.0-255,66,203666,21,256628
4870,0.04573,172.217.194.0-255,1484,205150,21,256628
4871,0.045746,172.217.194.0-255,1484,206634,21,256628
4872,0.045759,172.31.33.0-255,66,206700,21,256628
4873,0.047952,172.217.194.0-255,2902,209602,21,256628
4874,0.047956,172.31.33.0-255,66,209668,21,256628
4875,0.048055,172.217.194.0-255,2902,212570,21,256628
4876,0.048059,172.31.33.0-255,66,212636,21,256628
4877,0.050236,172.217.194.0-255,2902,215538,21,256628
4878,0.050241,172.31.33.0-255,66,215604,21,256628
4879,0.050334,172.217.194.0-255,1484,217088,21,256628
4880,0.050352,172.217.194.0-255,1484,218572,21,256628
4881,0.050356,172.31.33.0-255,66,218638,21,256628
4882,0.05254,172.217.194.0-255,2902,221540,21,256628
4883,0.052545,172.31.33.0-255,66,221606,21,256628
4884,0.052662,172.217.194.0-255,2902,224508,21,256628
4885,0.052667,172.31.33.0-255,66,224574,21,256628
4886,0.054838,172.217.194.0-255,2902,227476,21,256628
4887,0.054845,172.31.33.0-255,66,227542,21,256628
4888,0.054955,172.217.194.0-255,2902,230444,21,256628
4889,0.057157,172.217.194.0-255,2902,233346,21,256628
4890,0.058599,172.31.33.0-255,66,233412,21,256628
4891,0.060928,172.217.194.0-255,5738,239150,21,256628
4892,0.060944,172.31.33.0-255,66,239216,21,256628
4893,0.063263,172.217.194.0-255,5738,244954,21,256628
4894,0.063276,172.31.33.0-255,66,245020,21,256628
4895,0.065565,172.217.194.0-255,5738,250758,21,256628
4896,0.06557,172.31.33.0-255,66,250824,21,256628
4897,0.067877,172.217.194.0-255,5738,256562,21,256628
4898,0.067895,172.31.33.0-255,66,256628,21,256628
4899,0.0,74.125.68.0-255,153,153,21,370121
4900,2.1e-05,172.31.33.0-255,66,219,21,370121
4901,2.7e-05,74.125.68.0-255,1484,1703,21,370121
4902,3.1e-05,172.31.33.0-255,66,1769,21,370121
4903,4.6e-05,74.125.68.0-255,2902,4671,21,370121
4904,4.9e-05,172.31.33.0-255,66,4737,21,370121
4905,5.2e-05,74.125.68.0-255,2902,7639,21,370121
4906,5.4e-05,172.31.33.0-255,66,7705,21,370121
4907,6.9e-05,74.125.68.0-255,1484,9189,21,370121
4908,7.1e-05,172.31.33.0-255,66,9255,21,370121
4909,9.2e-05,74.125.68.0-255,5738,14993,21,370121
4910,9.4e-05,172.31.33.0-255,66,15059,21,370121
4911,0.000111,74.125.68.0-255,3486,18545,21,370121
4912,0.000113,172.31.33.0-255,66,18611,21,370121
4913,0.000118,74.125.68.0-255,5738,24349,21,370121
4914,0.000137,172.31.33.0-255,66,24415,21,370121
4915,0.000144,74.125.68.0-255,6797,31212,21,370121
4916,0.000146,172.31.33.0-255,66,31278,21,370121
4917,0.000245,74.125.68.0-255,1484,32762,21,370121
4918,0.00025,172.31.33.0-255,66,32828,21,370121
4919,0.000254,74.125.68.0-255,1484,34312,21,370121
4920,0.000256,172.31.33.0-255,66,34378,21,370121
4921,0.000258,74.125.68.0-255,1484,35862,21,370121
4922,0.00026,172.31.33.0-255,66,35928,21,370121
4923,0.000273,74.125.68.0-255,1484,37412,21,370121
4924,0.000275,172.31.33.0-255,66,37478,21,370121
4925,0.000278,74.125.68.0-255,1484,38962,21,370121
4926,0.00028,172.31.33.0-255,66,39028,21,370121
4927,0.000304,74.125.68.0-255,4320,43348,21,370121
4928,0.000308,172.31.33.0-255,66,43414,21,370121
4929,0.000319,172.31.33.0-255,66,43480,21,370121
4930,0.000358,172.31.33.0-255,66,43546,21,370121
4931,0.000361,74.125.68.0-255,766,44312,21,370121
4932,0.000362,172.31.33.0-255,66,44378,21,370121
4933,0.000377,74.125.68.0-255,428,44806,21,370121
4934,0.000379,172.31.33.0-255,66,44872,21,370121
4935,0.000481,74.125.68.0-255,1484,46356,21,370121
4936,0.000485,172.31.33.0-255,66,46422,21,370121
4937,0.000505,74.125.68.0-255,2902,49324,21,370121
4938,0.000509,172.31.33.0-255,66,49390,21,370121
4939,0.000513,74.125.68.0-255,2902,52292,21,370121
4940,0.000515,172.31.33.0-255,66,52358,21,370121
4941,0.00052,74.125.68.0-255,4320,56678,21,370121
4942,0.000522,172.31.33.0-255,66,56744,21,370121
4943,0.000542,74.125.68.0-255,7156,63900,21,370121
4944,0.000545,172.31.33.0-255,66,63966,21,370121
4945,0.000566,74.125.68.0-255,1484,65450,21,370121
4946,0.000568,172.31.33.0-255,66,65516,21,370121
4947,0.000579,172.31.33.0-255,66,65582,21,370121
4948,0.000614,74.125.68.0-255,5020,70602,21,370121
4949,0.000617,172.31.33.0-255,66,70668,21,370121
4950,0.000659,74.125.68.0-255,346,71014,21,370121
4951,0.000661,172.31.33.0-255,66,71080,21,370121
4952,0.000768,74.125.68.0-255,1484,72564,21,370121
4953,0.000772,172.31.33.0-255,66,72630,21,370121
4954,0.000777,74.125.68.0-255,2902,75532,21,370121
4955,0.000779,172.31.33.0-255,66,75598,21,370121
4956,0.000797,74.125.68.0-255,5738,81336,21,370121
4957,0.0008,172.31.33.0-255,66,81402,21,370121
4958,0.000803,74.125.68.0-255,1484,82886,21,370121
4959,0.000825,74.125.68.0-255,4320,87206,21,370121
4960,0.000832,74.125.68.0-255,7156,94362,21,370121
4961,0.000844,172.31.33.0-255,66,94428,21,370121
4962,0.000862,74.125.68.0-255,4320,98748,21,370121
4963,0.00088,74.125.68.0-255,4843,103591,21,370121
4964,0.000885,172.31.33.0-255,66,103657,21,370121
4965,0.000934,74.125.68.0-255,1484,105141,21,370121
4966,0.000954,74.125.68.0-255,1484,106625,21,370121
4967,0.000958,172.31.33.0-255,66,106691,21,370121
4968,0.000968,74.125.68.0-255,2902,109593,21,370121
4969,0.000972,172.31.33.0-255,66,109659,21,370121
4970,0.000985,74.125.68.0-255,4320,113979,21,370121
4971,0.000997,74.125.68.0-255,1484,115463,21,370121
4972,0.001012,74.125.68.0-255,4320,119783,21,370121
4973,0.001015,172.31.33.0-255,66,119849,21,370121
4974,0.00102,172.31.33.0-255,66,119915,21,370121
4975,0.001034,74.125.68.0-255,5738,125653,21,370121
4976,0.001039,74.125.68.0-255,2902,128555,21,370121
4977,0.001063,74.125.68.0-255,766,129321,21,370121
4978,0.001076,172.31.33.0-255,66,129387,21,370121
4979,0.001168,74.125.68.0-255,1484,130871,21,370121
4980,0.001174,74.125.68.0-255,2902,133773,21,370121
4981,0.001191,172.31.33.0-255,66,133839,21,370121
4982,0.001207,74.125.68.0-255,1484,135323,21,370121
4983,0.00122,74.125.68.0-255,2902,138225,21,370121
4984,0.001227,172.31.33.0-255,66,138291,21,370121
4985,0.001237,74.125.68.0-255,2902,141193,21,370121
4986,0.001241,172.31.33.0-255,66,141259,21,370121
4987,0.001254,74.125.68.0-255,2902,144161,21,370121
4988,0.001267,172.31.33.0-255,66,144227,21,370121
4989,0.001274,74.125.68.0-255,5738,149965,21,370121
4990,0.001278,172.31.33.0-255,66,150031,21,370121
4991,0.001284,74.125.68.0-255,1484,151515,21,370121
4992,0.001286,74.125.68.0-255,1484,152999,21,370121
4993,0.001303,74.125.68.0-255,7156,160155,21,370121
4994,0.001313,172.31.33.0-255,66,160221,21,370121
4995,0.001324,74.125.68.0-255,3602,163823,21,370121
4996,0.00134,172.31.33.0-255,66,163889,21,370121
4997,0.001786,74.125.68.0-255,1484,165373,21,370121
4998,0.001803,74.125.68.0-255,1484,166857,21,370121
4999,0.001806,172.31.33.0-255,66,166923,21,370121
5000,0.001826,74.125.68.0-255,1484,168407,21,370121
5001,0.00183,74.125.68.0-255,2902,171309,21,370121
5002,0.001835,74.125.68.0-255,4320,175629,21,370121
5003,0.00185,172.31.33.0-255,66,175695,21,370121
5004,0.001871,74.125.68.0-255,7156,182851,21,370121
5005,0.001875,172.31.33.0-255,66,182917,21,370121
5006,0.001893,74.125.68.0-255,1484,184401,21,370121
5007,0.001898,74.125.68.0-255,4320,188721,21,370121
5008,0.001909,172.31.33.0-255,66,188787,21,370121
5009,0.001954,172.31.33.0-255,66,188853,21,370121
5010,0.001956,74.125.68.0-255,766,189619,21,370121
5011,0.002063,74.125.68.0-255,1484,191103,21,370121
5012,0.002066,172.31.33.0-255,66,191169,21,370121
5013,0.002071,74.125.68.0-255,2902,194071,21,370121
5014,0.002081,172.31.33.0-255,66,194137,21,370121
5015,0.002084,74.125.68.0-255,1484,195621,21,370121
5016,0.002098,74.125.68.0-255,2902,198523,21,370121
5017,0.00211,74.125.68.0-255,4320,202843,21,370121
5018,0.002113,172.31.33.0-255,66,202909,21,370121
5019,0.002138,74.125.68.0-255,4320,207229,21,370121
5020,0.002144,74.125.68.0-255,7156,214385,21,370121
5021,0.002149,74.125.68.0-255,4320,218705,21,370121
5022,0.002168,74.125.68.0-255,4320,223025,21,370121
5023,0.002183,74.125.68.0-255,3602,226627,21,370121
5024,0.002202,74.125.68.0-255,4320,230947,21,370121
5025,0.002218,74.125.68.0-255,2902,233849,21,370121
5026,0.002232,74.125.68.0-255,7156,241005,21,370121
5027,0.002274,74.125.68.0-255,4320,245325,21,370121
5028,0.00229,74.125.68.0-255,4320,249645,21,370121
5029,0.007191,172.31.33.0-255,66,249711,21,370121
5030,0.00948,74.125.68.0-255,5738,255449,21,370121
5031,0.009486,172.31.33.0-255,66,255515,21,370121
5032,0.011762,74.125.68.0-255,5738,261253,21,370121
5033,0.011768,172.31.33.0-255,66,261319,21,370121
5034,0.014042,74.125.68.0-255,5738,267057,21,370121
5035,0.014049,172.31.33.0-255,66,267123,21,370121
5036,0.016319,74.125.68.0-255,5738,272861,21,370121
5037,0.016328,172.31.33.0-255,66,272927,21,370121
5038,0.018612,74.125.68.0-255,5738,278665,21,370121
5039,0.01862,172.31.33.0-255,66,278731,21,370121
5040,0.020898,74.125.68.0-255,5738,284469,21,370121
5041,0.020906,172.31.33.0-255,66,284535,21,370121
5042,0.023179,74.125.68.0-255,5738,290273,21,370121
5043,0.023184,172.31.33.0-255,66,290339,21,370121
5044,0.025449,74.125.68.0-255,5738,296077,21,370121
5045,0.025456,172.31.33.0-255,66,296143,21,370121
5046,0.027739,74.125.68.0-255,5738,301881,21,370121
5047,0.027746,172.31.33.0-255,66,301947,21,370121
5048,0.029246,172.31.33.0-255,172,302119,21,370121
5049,0.029279,172.31.33.0-255,1113,303232,21,370121
5050,0.029338,172.31.33.0-255,1514,304746,21,370121
5051,0.02934,172.31.33.0-255,1514,306260,21,370121
5052,0.029364,172.31.33.0-255,182,306442,21,370121
5053,0.030019,74.125.68.0-255,5738,312180,21,370121
5054,0.030026,172.31.33.0-255,66,312246,21,370121
5055,0.030784,104.244.42.0-255,66,312312,21,370121
5056,0.030795,104.244.42.0-255,66,312378,21,370121
5057,0.030845,104.244.42.0-255,66,312444,21,370121
5058,0.03089,104.244.42.0-255,66,312510,21,370121
5059,0.032302,74.125.68.0-255,5738,318248,21,370121
5060,0.032308,172.31.33.0-255,66,318314,21,370121
5061,0.034586,74.125.68.0-255,5738,324052,21,370121
5062,0.034593,172.31.33.0-255,66,324118,21,370121
5063,0.036876,74.125.68.0-255,5738,329856,21,370121
5064,0.036883,172.31.33.0-255,66,329922,21,370121
5065,0.039161,74.125.68.0-255,5738,335660,21,370121
5066,0.039167,172.31.33.0-255,66,335726,21,370121
5067,0.041454,74.125.68.0-255,5738,341464,21,370121
5068,0.041465,172.31.33.0-255,66,341530,21,370121
5069,0.04374,74.125.68.0-255,5738,347268,21,370121
5070,0.043746,172.31.33.0-255,66,347334,21,370121
5071,0.046019,74.125.68.0-255,5738,353072,21,370121
5072,0.046026,172.31.33.0-255,66,353138,21,370121
5073,0.048296,74.125.68.0-255,5738,358876,21,370121
5074,0.048302,172.31.33.0-255,66,358942,21,370121
5075,0.050571,74.125.68.0-255,5738,364680,21,370121
5076,0.050577,172.31.33.0-255,66,364746,21,370121
5077,0.052837,74.125.68.0-255,1484,366230,21,370121
5078,0.052842,172.31.33.0-255,66,366296,21,370121
5079,0.052864,74.125.68.0-255,3588,369884,21,370121
5080,0.052883,172.31.33.0-255,66,369950,21,370121
5081,0.053022,172.31.33.0-255,105,370055,21,370121
5082,0.055251,74.125.68.0-255,66,370121,21,370121
5083,0.0,172.31.33.0-255,105,105,21,459
5084,0.000225,172.31.33.0-255,90,195,21,459
5085,0.000233,172.31.33.0-255,66,261,21,459
5086,0.002566,74.125.24.0-255,66,327,21,459
5087,0.002587,74.125.24.0-255,66,393,21,459
5088,0.002603,172.31.33.0-255,66,459,21,459
5089,0.0,172.217.194.0-255,153,153,21,301796
5090,2.1e-05,172.31.33.0-255,66,219,21,301796
5091,2.8e-05,172.217.194.0-255,1484,1703,21,301796
5092,3.3e-05,172.31.33.0-255,66,1769,21,301796
5093,4.7e-05,172.217.194.0-255,2902,4671,21,301796
5094,5.1e-05,172.31.33.0-255,66,4737,21,301796
5095,5.6e-05,172.217.194.0-255,2902,7639,21,301796
5096,6e-05,172.31.33.0-255,66,7705,21,301796
5097,8.2e-05,172.217.194.0-255,4320,12025,21,301796
5098,8.5e-05,172.31.33.0-255,66,12091,21,301796
5099,8.8e-05,172.217.194.0-255,1484,13575,21,301796
5100,9e-05,172.31.33.0-255,66,13641,21,301796
5101,0.000114,172.217.194.0-255,604,14245,21,301796
5102,0.000116,172.31.33.0-255,66,14311,21,301796
5103,0.00012,172.217.194.0-255,1484,15795,21,301796
5104,0.000122,172.31.33.0-255,66,15861,21,301796
5105,0.000127,172.217.194.0-255,2902,18763,21,301796
5106,0.00013,172.31.33.0-255,66,18829,21,301796
5107,0.000151,172.217.194.0-255,1484,20313,21,301796
5108,0.000153,172.31.33.0-255,66,20379,21,301796
5109,0.000158,172.217.194.0-255,2902,23281,21,301796
5110,0.00016,172.31.33.0-255,66,23347,21,301796
5111,0.000198,172.217.194.0-255,7156,30503,21,301796
5112,0.000201,172.31.33.0-255,66,30569,21,301796
5113,0.000207,172.217.194.0-255,5738,36307,21,301796
5114,0.000209,172.31.33.0-255,66,36373,21,301796
5115,0.000232,172.217.194.0-255,5738,42111,21,301796
5116,0.000234,172.31.33.0-255,66,42177,21,301796
5117,0.000263,172.217.194.0-255,5738,47915,21,301796
5118,0.000265,172.31.33.0-255,66,47981,21,301796
5119,0.000269,172.217.194.0-255,766,48747,21,301796
5120,0.000271,172.31.33.0-255,66,48813,21,301796
5121,0.000502,172.217.194.0-255,1484,50297,21,301796
5122,0.00051,172.217.194.0-255,2902,53199,21,301796
5123,0.000516,172.31.33.0-255,66,53265,21,301796
5124,0.000522,172.217.194.0-255,4320,57585,21,301796
5125,0.000525,172.31.33.0-255,66,57651,21,301796
5126,0.000556,172.217.194.0-255,1484,59135,21,301796
5127,0.000564,172.217.194.0-255,7085,66220,21,301796
5128,0.000567,172.217.194.0-255,366,66586,21,301796
5129,0.000582,172.31.33.0-255,66,66652,21,301796
5130,0.000997,172.217.194.0-255,1484,68136,21,301796
5131,0.001041,172.217.194.0-255,1484,69620,21,301796
5132,0.001045,172.31.33.0-255,66,69686,21,301796
5133,0.001064,172.217.194.0-255,2902,72588,21,301796
5134,0.001067,172.31.33.0-255,66,72654,21,301796
5135,0.001097,172.217.194.0-255,5738,78392,21,301796
5136,0.0011,172.31.33.0-255,66,78458,21,301796
5137,0.001106,172.217.194.0-255,5738,84196,21,301796
5138,0.001108,172.31.33.0-255,66,84262,21,301796
5139,0.001137,172.217.194.0-255,5738,90000,21,301796
5140,0.00114,172.31.33.0-255,66,90066,21,301796
5141,0.001161,172.217.194.0-255,7156,97222,21,301796
5142,0.001164,172.31.33.0-255,66,97288,21,301796
5143,0.001167,172.217.194.0-255,1484,98772,21,301796
5144,0.001188,172.217.194.0-255,1484,100256,21,301796
5145,0.00119,172.31.33.0-255,66,100322,21,301796
5146,0.001193,172.217.194.0-255,766,101088,21,301796
5147,0.001559,172.31.33.0-255,66,101154,21,301796
5148,0.001923,172.217.194.0-255,1484,102638,21,301796
5149,0.001935,172.217.194.0-255,2902,105540,21,301796
5150,0.001939,172.31.33.0-255,66,105606,21,301796
5151,0.001946,172.217.194.0-255,5738,111344,21,301796
5152,0.001947,172.31.33.0-255,66,111410,21,301796
5153,0.00195,172.217.194.0-255,1484,112894,21,301796
5154,0.001986,172.31.33.0-255,66,112960,21,301796
5155,0.002042,172.217.194.0-255,7156,120116,21,301796
5156,0.002045,172.31.33.0-255,66,120182,21,301796
5157,0.002074,172.217.194.0-255,6438,126620,21,301796
5158,0.002076,172.31.33.0-255,66,126686,21,301796
5159,0.002103,172.31.33.0-255,66,126752,21,301796
5160,0.002128,172.217.194.0-255,5738,132490,21,301796
5161,0.002131,172.31.33.0-255,66,132556,21,301796
5162,0.002223,172.217.194.0-255,1484,134040,21,301796
5163,0.002268,172.217.194.0-255,2184,136224,21,301796
5164,0.002326,172.217.194.0-255,1484,137708,21,301796
5165,0.002341,172.217.194.0-255,2902,140610,21,301796
5166,0.002441,172.217.194.0-255,3602,144212,21,301796
5167,0.002487,172.217.194.0-255,1484,145696,21,301796
5168,0.002507,172.217.194.0-255,5738,151434,21,301796
5169,0.002529,172.217.194.0-255,5738,157172,21,301796
5170,0.002546,172.217.194.0-255,2902,160074,21,301796
5171,0.002595,172.217.194.0-255,4320,164394,21,301796
5172,0.002647,172.217.194.0-255,2902,167296,21,301796
5173,0.002664,172.217.194.0-255,5020,172316,21,301796
5174,0.002702,172.217.194.0-255,1484,173800,21,301796
5175,0.002743,172.217.194.0-255,6438,180238,21,301796
5176,0.002813,172.217.194.0-255,1484,181722,21,301796
5177,0.002827,172.217.194.0-255,2902,184624,21,301796
5178,0.002829,172.217.194.0-255,1484,186108,21,301796
5179,0.002852,172.217.194.0-255,2902,189010,21,301796
5180,0.002867,172.217.194.0-255,2902,191912,21,301796
5181,0.002879,172.217.194.0-255,1484,193396,21,301796
5182,0.002928,172.217.194.0-255,5738,199134,21,301796
5183,0.002944,172.217.194.0-255,3602,202736,21,301796
5184,0.003239,172.217.194.0-255,1484,204220,21,301796
5185,0.003258,172.217.194.0-255,2902,207122,21,301796
5186,0.003263,172.217.194.0-255,5738,212860,21,301796
5187,0.003313,172.217.194.0-255,7156,220016,21,301796
5188,0.003319,172.217.194.0-255,5738,225754,21,301796
5189,0.003355,172.217.194.0-255,2184,227938,21,301796
5190,0.003391,172.217.194.0-255,2902,230840,21,301796
5191,0.003406,172.217.194.0-255,7156,237996,21,301796
5192,0.00349,172.217.194.0-255,2902,240898,21,301796
5193,0.003507,172.217.194.0-255,4320,245218,21,301796
5194,0.003539,172.217.194.0-255,5020,250238,21,301796
5195,0.003563,172.217.194.0-255,4320,254558,21,301796
5196,0.003572,172.217.194.0-255,1484,256042,21,301796
5197,0.003576,172.217.194.0-255,2902,258944,21,301796
5198,0.003589,172.217.194.0-255,1484,260428,21,301796
5199,0.003599,172.217.194.0-255,1484,261912,21,301796
5200,0.003617,172.217.194.0-255,7156,269068,21,301796
5201,0.00364,172.217.194.0-255,2902,271970,21,301796
5202,0.00366,172.217.194.0-255,5738,277708,21,301796
5203,0.003678,172.217.194.0-255,2902,280610,21,301796
5204,0.003689,172.217.194.0-255,1484,282094,21,301796
5205,0.003705,172.217.194.0-255,2184,284278,21,301796
5206,0.003999,172.217.194.0-255,1484,285762,21,301796
5207,0.004005,172.217.194.0-255,2902,288664,21,301796
5208,0.004026,172.217.194.0-255,2902,291566,21,301796
5209,0.004049,172.217.194.0-255,4320,295886,21,301796
5210,0.004052,172.217.194.0-255,128,296014,21,301796
5211,0.004112,172.217.194.0-255,105,296119,21,301796
5212,0.006557,172.31.33.0-255,66,296185,21,301796
5213,0.008725,172.31.33.0-255,105,296290,21,301796
5214,0.011323,172.217.194.0-255,66,296356,21,301796
5215,0.031295,172.31.33.0-255,172,296528,21,301796
5216,0.031332,172.31.33.0-255,1113,297641,21,301796
5217,0.031392,172.31.33.0-255,1514,299155,21,301796
5218,0.031394,172.31.33.0-255,1514,300669,21,301796
5219,0.031421,172.31.33.0-255,689,301358,21,301796
5220,0.032969,104.244.42.0-255,66,301424,21,301796
5221,0.032978,104.244.42.0-255,66,301490,21,301796
5222,0.033058,104.244.42.0-255,66,301556,21,301796
5223,0.033061,104.244.42.0-255,66,301622,21,301796
5224,0.036544,104.244.42.0-255,108,301730,21,301796
5225,0.036557,172.31.33.0-255,66,301796,21,301796
5226,0.0,172.31.33.0-255,105,105,21,459
5227,0.000169,172.31.33.0-255,90,195,21,459
5228,0.000178,172.31.33.0-255,66,261,21,459
5229,0.002191,172.217.194.0-255,66,327,21,459
5230,0.002203,172.217.194.0-255,66,393,21,459
5231,0.002213,172.31.33.0-255,66,459,21,459
5232,0.0,172.31.33.0-255,105,105,21,459
5233,0.00029,172.31.33.0-255,90,195,21,459
5234,0.000299,172.31.33.0-255,66,261,21,459
5235,0.002603,74.125.24.0-255,66,327,21,459
5236,0.002613,74.125.24.0-255,66,393,21,459
5237,0.00262,172.31.33.0-255,66,459,21,459
5238,0.0,74.125.24.0-255,153,153,21,300787
5239,2.8e-05,172.31.33.0-255,66,219,21,300787
5240,3.6e-05,74.125.24.0-255,1484,1703,21,300787
5241,4e-05,172.31.33.0-255,66,1769,21,300787
5242,4.5e-05,74.125.24.0-255,2902,4671,21,300787
5243,5.5e-05,172.31.33.0-255,66,4737,21,300787
5244,6.2e-05,74.125.24.0-255,7156,11893,21,300787
5245,6.5e-05,172.31.33.0-255,66,11959,21,300787
5246,9.7e-05,74.125.24.0-255,2060,14019,21,300787
5247,0.0001,172.31.33.0-255,66,14085,21,300787
5248,0.00026,74.125.24.0-255,1484,15569,21,300787
5249,0.000265,172.31.33.0-255,66,15635,21,300787
5250,0.00027,74.125.24.0-255,2902,18537,21,300787
5251,0.000273,172.31.33.0-255,66,18603,21,300787
5252,0.000283,74.125.24.0-255,1484,20087,21,300787
5253,0.000285,172.31.33.0-255,66,20153,21,300787
5254,0.000317,74.125.24.0-255,2902,23055,21,300787
5255,0.000321,172.31.33.0-255,66,23121,21,300787
5256,0.000359,172.31.33.0-255,66,23187,21,300787
5257,0.00039,74.125.24.0-255,5738,28925,21,300787
5258,0.000394,172.31.33.0-255,66,28991,21,300787
5259,0.000416,74.125.24.0-255,4320,33311,21,300787
5260,0.000419,172.31.33.0-255,66,33377,21,300787
5261,0.000448,74.125.24.0-255,2902,36279,21,300787
5262,0.000453,74.125.24.0-255,3961,40240,21,300787
5263,0.000454,172.31.33.0-255,66,40306,21,300787
5264,0.000458,172.31.33.0-255,66,40372,21,300787
5265,0.001016,74.125.24.0-255,1484,41856,21,300787
5266,0.001021,172.31.33.0-255,66,41922,21,300787
5267,0.00103,74.125.24.0-255,2902,44824,21,300787
5268,0.001032,172.31.33.0-255,66,44890,21,300787
5269,0.001043,74.125.24.0-255,5738,50628,21,300787
5270,0.001045,172.31.33.0-255,66,50694,21,300787
5271,0.001052,74.125.24.0-255,6797,57491,21,300787
5272,0.001053,172.31.33.0-255,66,57557,21,300787
5273,0.001084,74.125.24.0-255,646,58203,21,300787
5274,0.001097,74.125.24.0-255,1484,59687,21,300787
5275,0.0011,172.31.33.0-255,66,59753,21,300787
5276,0.001104,74.125.24.0-255,1484,61237,21,300787
5277,0.001132,74.125.24.0-255,2902,64139,21,300787
5278,0.001135,172.31.33.0-255,66,64205,21,300787
5279,0.001145,172.31.33.0-255,66,64271,21,300787
5280,0.001153,74.125.24.0-255,1125,65396,21,300787
5281,0.001221,74.125.24.0-255,3961,69357,21,300787
5282,0.00124,172.31.33.0-255,66,69423,21,300787
5283,0.00152,74.125.24.0-255,1484,70907,21,300787
5284,0.001525,74.125.24.0-255,2902,73809,21,300787
5285,0.001527,172.31.33.0-255,66,73875,21,300787
5286,0.00153,74.125.24.0-255,1484,75359,21,300787
5287,0.001554,74.125.24.0-255,4320,79679,21,300787
5288,0.001556,172.31.33.0-255,66,79745,21,300787
5289,0.001559,74.125.24.0-255,1484,81229,21,300787
5290,0.001582,74.125.24.0-255,6130,87359,21,300787
5291,0.001584,172.31.33.0-255,66,87425,21,300787
5292,0.001588,74.125.24.0-255,4320,91745,21,300787
5293,0.001589,172.31.33.0-255,66,91811,21,300787
5294,0.00163,74.125.24.0-255,405,92216,21,300787
5295,0.001644,172.31.33.0-255,66,92282,21,300787
5296,0.002038,74.125.24.0-255,1484,93766,21,300787
5297,0.002057,74.125.24.0-255,2902,96668,21,300787
5298,0.00206,172.31.33.0-255,66,96734,21,300787
5299,0.002065,74.125.24.0-255,5738,102472,21,300787
5300,0.002067,172.31.33.0-255,66,102538,21,300787
5301,0.002106,172.31.33.0-255,66,102604,21,300787
5302,0.002133,74.125.24.0-255,4320,106924,21,300787
5303,0.002135,172.31.33.0-255,66,106990,21,300787
5304,0.002141,74.125.24.0-255,7156,114146,21,300787
5305,0.002142,172.31.33.0-255,66,114212,21,300787
5306,0.002174,74.125.24.0-255,3602,117814,21,300787
5307,0.002177,172.31.33.0-255,66,117880,21,300787
5308,0.002292,74.125.24.0-255,1484,119364,21,300787
5309,0.002297,74.125.24.0-255,2902,122266,21,300787
5310,0.002304,172.31.33.0-255,66,122332,21,300787
5311,0.00232,74.125.24.0-255,5738,128070,21,300787
5312,0.002323,74.125.24.0-255,1484,129554,21,300787
5313,0.002334,172.31.33.0-255,66,129620,21,300787
5314,0.002364,172.31.33.0-255,66,129686,21,300787
5315,0.002402,172.31.33.0-255,66,129752,21,300787
5316,0.002426,74.125.24.0-255,1484,131236,21,300787
5317,0.002443,74.125.24.0-255,2902,134138,21,300787
5318,0.002445,172.31.33.0-255,66,134204,21,300787
5319,0.002449,74.125.24.0-255,2902,137106,21,300787
5320,0.002452,172.31.33.0-255,66,137172,21,300787
5321,0.002469,74.125.24.0-255,2902,140074,21,300787
5322,0.002474,74.125.24.0-255,7156,147230,21,300787
5323,0.002491,172.31.33.0-255,66,147296,21,300787
5324,0.002504,74.125.24.0-255,4320,151616,21,300787
5325,0.002525,172.31.33.0-255,66,151682,21,300787
5326,0.002529,172.31.33.0-255,66,151748,21,300787
5327,0.002534,74.125.24.0-255,1484,153232,21,300787
5328,0.00254,74.125.24.0-255,2184,155416,21,300787
5329,0.002544,74.125.24.0-255,2902,158318,21,300787
5330,0.00257,74.125.24.0-255,7156,165474,21,300787
5331,0.002575,74.125.24.0-255,5738,171212,21,300787
5332,0.002581,172.31.33.0-255,66,171278,21,300787
5333,0.002618,74.125.24.0-255,5738,177016,21,300787
5334,0.002622,172.31.33.0-255,66,177082,21,300787
5335,0.002656,74.125.24.0-255,3602,180684,21,300787
5336,0.002693,74.125.24.0-255,1484,182168,21,300787
5337,0.002696,74.125.24.0-255,2902,185070,21,300787
5338,0.0027,172.31.33.0-255,66,185136,21,300787
5339,0.002725,74.125.24.0-255,5738,190874,21,300787
5340,0.00273,74.125.24.0-255,4320,195194,21,300787
5341,0.002734,172.31.33.0-255,66,195260,21,300787
5342,0.002772,74.125.24.0-255,5738,200998,21,300787
5343,0.002775,74.125.24.0-255,1484,202482,21,300787
5344,0.002786,172.31.33.0-255,66,202548,21,300787
5345,0.002812,74.125.24.0-255,5738,208286,21,300787
5346,0.002827,74.125.24.0-255,2902,211188,21,300787
5347,0.00283,74.125.24.0-255,3602,214790,21,300787
5348,0.002835,172.31.33.0-255,66,214856,21,300787
5349,0.002881,74.125.24.0-255,1484,216340,21,300787
5350,0.002894,74.125.24.0-255,2902,219242,21,300787
5351,0.002907,74.125.24.0-255,5738,224980,21,300787
5352,0.002909,172.31.33.0-255,66,225046,21,300787
5353,0.002913,172.31.33.0-255,66,225112,21,300787
5354,0.002935,74.125.24.0-255,7156,232268,21,300787
5355,0.002946,172.31.33.0-255,66,232334,21,300787
5356,0.002952,74.125.24.0-255,1484,233818,21,300787
5357,0.002957,74.125.24.0-255,5738,239556,21,300787
5358,0.002967,172.31.33.0-255,66,239622,21,300787
5359,0.00297,74.125.24.0-255,2902,242524,21,300787
5360,0.002972,74.125.24.0-255,1484,244008,21,300787
5361,0.003007,74.125.24.0-255,5020,249028,21,300787
5362,0.003009,172.31.33.0-255,66,249094,21,300787
5363,0.003017,172.31.33.0-255,66,249160,21,300787
5364,0.003086,74.125.24.0-255,1484,250644,21,300787
5365,0.003098,74.125.24.0-255,2902,253546,21,300787
5366,0.003109,172.31.33.0-255,66,253612,21,300787
5367,0.003114,74.125.24.0-255,4320,257932,21,300787
5368,0.003117,172.31.33.0-255,66,257998,21,300787
5369,0.003129,74.125.24.0-255,1484,259482,21,300787
5370,0.003132,74.125.24.0-255,1484,260966,21,300787
5371,0.00314,172.31.33.0-255,66,261032,21,300787
5372,0.003156,74.125.24.0-255,5738,266770,21,300787
5373,0.00316,172.31.33.0-255,66,266836,21,300787
5374,0.003174,74.125.24.0-255,2902,269738,21,300787
5375,0.003199,74.125.24.0-255,2184,271922,21,300787
5376,0.003201,172.31.33.0-255,66,271988,21,300787
5377,0.003206,172.31.33.0-255,66,272054,21,300787
5378,0.003259,74.125.24.0-255,1484,273538,21,300787
5379,0.003262,74.125.24.0-255,1484,275022,21,300787
5380,0.003274,74.125.24.0-255,1484,276506,21,300787
5381,0.003287,74.125.24.0-255,5738,282244,21,300787
5382,0.003293,172.31.33.0-255,66,282310,21,300787
5383,0.003323,172.31.33.0-255,66,282376,21,300787
5384,0.003346,74.125.24.0-255,7156,289532,21,300787
5385,0.003355,172.31.33.0-255,66,289598,21,300787
5386,0.003381,74.125.24.0-255,3602,293200,21,300787
5387,0.00339,74.125.24.0-255,1961,295161,21,300787
5388,0.003404,74.125.24.0-255,105,295266,21,300787
5389,0.003415,172.31.33.0-255,66,295332,21,300787
5390,0.00468,172.31.33.0-255,105,295437,21,300787
5391,0.007323,74.125.24.0-255,66,295503,21,300787
5392,0.026478,172.31.33.0-255,190,295693,21,300787
5393,0.026521,172.31.33.0-255,1113,296806,21,300787
5394,0.026596,172.31.33.0-255,1514,298320,21,300787
5395,0.026598,172.31.33.0-255,1514,299834,21,300787
5396,0.026623,172.31.33.0-255,689,300523,21,300787
5397,0.028127,104.244.42.0-255,66,300589,21,300787
5398,0.028135,104.244.42.0-255,66,300655,21,300787
5399,0.028229,104.244.42.0-255,66,300721,21,300787
5400,0.028232,104.244.42.0-255,66,300787,21,300787
5401,0.0,172.217.194.0-255,153,153,21,185097
5402,1.4e-05,172.31.33.0-255,66,219,21,185097
5403,2e-05,172.217.194.0-255,1484,1703,21,185097
5404,2.4e-05,172.31.33.0-255,66,1769,21,185097
5405,4.5e-05,172.217.194.0-255,2902,4671,21,185097
5406,4.8e-05,172.31.33.0-255,66,4737,21,185097
5407,5.2e-05,172.217.194.0-255,2902,7639,21,185097
5408,5.5e-05,172.31.33.0-255,66,7705,21,185097
5409,9.2e-05,172.217.194.0-255,5738,13443,21,185097
5410,9.4e-05,172.31.33.0-255,66,13509,21,185097
5411,0.000113,172.217.194.0-255,1975,15484,21,185097
5412,0.000115,172.31.33.0-255,66,15550,21,185097
5413,0.000124,172.217.194.0-255,7156,22706,21,185097
5414,0.000127,172.31.33.0-255,66,22772,21,185097
5415,0.000142,172.217.194.0-255,1484,24256,21,185097
5416,0.000144,172.31.33.0-255,66,24322,21,185097
5417,0.000154,172.31.33.0-255,66,24388,21,185097
5418,0.00021,172.31.33.0-255,66,24454,21,185097
5419,0.000232,172.217.194.0-255,6438,30892,21,185097
5420,0.000234,172.31.33.0-255,66,30958,21,185097
5421,0.000302,172.217.194.0-255,1484,32442,21,185097
5422,0.000305,172.31.33.0-255,66,32508,21,185097
5423,0.00031,172.217.194.0-255,2902,35410,21,185097
5424,0.000312,172.31.33.0-255,66,35476,21,185097
5425,0.000318,172.217.194.0-255,5738,41214,21,185097
5426,0.00032,172.31.33.0-255,66,41280,21,185097
5427,0.000345,172.217.194.0-255,5738,47018,21,185097
5428,0.000348,172.31.33.0-255,66,47084,21,185097
5429,0.000365,172.217.194.0-255,1418,48502,21,185097
5430,0.000367,172.31.33.0-255,66,48568,21,185097
5431,0.000404,172.31.33.0-255,66,48634,21,185097
5432,0.000409,172.217.194.0-255,2902,51536,21,185097
5433,0.000411,172.31.33.0-255,66,51602,21,185097
5434,0.000435,172.31.33.0-255,66,51668,21,185097
5435,0.000467,172.31.33.0-255,66,51734,21,185097
5436,0.000503,172.217.194.0-255,363,52097,21,185097
5437,0.000518,172.217.194.0-255,1484,53581,21,185097
5438,0.00052,172.31.33.0-255,66,53647,21,185097
5439,0.000542,172.217.194.0-255,4320,57967,21,185097
5440,0.000544,172.31.33.0-255,66,58033,21,185097
5441,0.000548,172.217.194.0-255,2902,60935,21,185097
5442,0.00055,172.31.33.0-255,66,61001,21,185097
5443,0.000592,172.31.33.0-255,66,61067,21,185097
5444,0.00062,172.31.33.0-255,66,61133,21,185097
5445,0.000641,172.217.194.0-255,5020,66153,21,185097
5446,0.000644,172.31.33.0-255,66,66219,21,185097
5447,0.000694,172.31.33.0-255,66,66285,21,185097
5448,0.000708,172.31.33.0-255,66,66351,21,185097
5449,0.000713,172.217.194.0-255,3602,69953,21,185097
5450,0.000715,172.31.33.0-255,66,70019,21,185097
5451,0.001015,172.217.194.0-255,1484,71503,21,185097
5452,0.001033,172.217.194.0-255,2902,74405,21,185097
5453,0.001037,172.31.33.0-255,66,74471,21,185097
5454,0.001043,172.217.194.0-255,5738,80209,21,185097
5455,0.001045,172.31.33.0-255,66,80275,21,185097
5456,0.001049,172.217.194.0-255,2902,83177,21,185097
5457,0.001051,172.31.33.0-255,66,83243,21,185097
5458,0.001086,172.31.33.0-255,66,83309,21,185097
5459,0.001129,172.31.33.0-255,66,83375,21,185097
5460,0.001264,172.217.194.0-255,1484,84859,21,185097
5461,0.001269,172.217.194.0-255,2902,87761,21,185097
5462,0.001271,172.31.33.0-255,66,87827,21,185097
5463,0.001293,172.217.194.0-255,5738,93565,21,185097
5464,0.001295,172.31.33.0-255,66,93631,21,185097
5465,0.00133,172.31.33.0-255,66,93697,21,185097
5466,0.001365,172.217.194.0-255,5738,99435,21,185097
5467,0.001368,172.31.33.0-255,66,99501,21,185097
5468,0.00139,172.217.194.0-255,5020,104521,21,185097
5469,0.001393,172.31.33.0-255,66,104587,21,185097
5470,0.001459,172.217.194.0-255,1484,106071,21,185097
5471,0.001465,172.217.194.0-255,2902,108973,21,185097
5472,0.001468,172.31.33.0-255,66,109039,21,185097
5473,0.00149,172.217.194.0-255,5738,114777,21,185097
5474,0.001499,172.31.33.0-255,66,114843,21,185097
5475,0.001511,172.217.194.0-255,2902,117745,21,185097
5476,0.001514,172.31.33.0-255,66,117811,21,185097
5477,0.001524,172.217.194.0-255,4320,122131,21,185097
5478,0.001527,172.31.33.0-255,66,122197,21,185097
5479,0.001542,172.31.33.0-255,66,122263,21,185097
5480,0.001583,172.31.33.0-255,66,122329,21,185097
5481,0.001609,172.217.194.0-255,2184,124513,21,185097
5482,0.001611,172.31.33.0-255,66,124579,21,185097
5483,0.001628,172.31.33.0-255,66,124645,21,185097
5484,0.00164,172.31.33.0-255,66,124711,21,185097
5485,0.001888,172.217.194.0-255,1484,126195,21,185097
5486,0.001894,172.217.194.0-255,2902,129097,21,185097
5487,0.0019,172.31.33.0-255,66,129163,21,185097
5488,0.001916,172.217.194.0-255,5738,134901,21,185097
5489,0.001919,172.31.33.0-255,66,134967,21,185097
5490,0.001925,172.217.194.0-255,5738,140705,21,185097
5491,0.001928,172.31.33.0-255,66,140771,21,185097
5492,0.00193,172.217.194.0-255,1484,142255,21,185097
5493,0.001965,172.31.33.0-255,66,142321,21,185097
5494,0.002002,172.31.33.0-255,66,142387,21,185097
5495,0.002033,172.31.33.0-255,66,142453,21,185097
5496,0.002039,172.217.194.0-255,4320,146773,21,185097
5497,0.002041,172.31.33.0-255,66,146839,21,185097
5498,0.002084,172.31.33.0-255,66,146905,21,185097
5499,0.002118,172.217.194.0-255,3602,150507,21,185097
5500,0.002123,172.31.33.0-255,66,150573,21,185097
5501,0.002141,172.217.194.0-255,2902,153475,21,185097
5502,0.002144,172.31.33.0-255,66,153541,21,185097
5503,0.002172,172.217.194.0-255,1484,155025,21,185097
5504,0.002187,172.217.194.0-255,5738,160763,21,185097
5505,0.002194,172.31.33.0-255,66,160829,21,185097
5506,0.002197,172.31.33.0-255,66,160895,21,185097
5507,0.00222,172.31.33.0-255,66,160961,21,185097
5508,0.002241,172.217.194.0-255,1484,162445,21,185097
5509,0.002253,172.217.194.0-255,2184,164629,21,185097
5510,0.002255,172.31.33.0-255,66,164695,21,185097
5511,0.002386,172.217.194.0-255,1484,166179,21,185097
5512,0.002407,172.217.194.0-255,2902,169081,21,185097
5513,0.002411,172.31.33.0-255,66,169147,21,185097
5514,0.002418,172.217.194.0-255,5738,174885,21,185097
5515,0.00242,172.31.33.0-255,66,174951,21,185097
5516,0.00244,172.217.194.0-255,2902,177853,21,185097
5517,0.002443,172.31.33.0-255,66,177919,21,185097
5518,0.002464,172.217.194.0-255,1504,179423,21,185097
5519,0.002467,172.31.33.0-255,66,179489,21,185097
5520,0.002507,172.217.194.0-255,105,179594,21,185097
5521,0.008793,172.31.33.0-255,66,179660,21,185097
5522,0.008827,172.31.33.0-255,105,179765,21,185097
5523,0.011325,172.217.194.0-255,66,179831,21,185097
5524,0.0342,172.31.33.0-255,172,180003,21,185097
5525,0.03423,172.31.33.0-255,1109,181112,21,185097
5526,0.03429,172.31.33.0-255,1514,182626,21,185097
5527,0.034291,172.31.33.0-255,1514,184140,21,185097
5528,0.034314,172.31.33.0-255,693,184833,21,185097
5529,0.035747,104.244.42.0-255,66,184899,21,185097
5530,0.035774,104.244.42.0-255,66,184965,21,185097
5531,0.035824,104.244.42.0-255,66,185031,21,185097
5532,0.035842,104.244.42.0-255,66,185097,21,185097
5533,0.0,172.31.33.0-255,105,105,21,186007
5534,0.000189,172.31.33.0-255,90,195,21,186007
5535,0.000197,172.31.33.0-255,66,261,21,186007
5536,0.002744,74.125.68.0-255,66,327,21,186007
5537,0.002756,74.125.68.0-255,66,393,21,186007
5538,0.002765,172.31.33.0-255,66,459,21,186007
5539,0.006038,172.217.194.0-255,148,607,21,186007
5540,0.006054,172.31.33.0-255,66,673,21,186007
5541,0.006078,172.217.194.0-255,1484,2157,21,186007
5542,0.006082,172.31.33.0-255,66,2223,21,186007
5543,0.006087,172.217.194.0-255,2902,5125,21,186007
5544,0.00609,172.31.33.0-255,66,5191,21,186007
5545,0.006125,172.217.194.0-255,7156,12347,21,186007
5546,0.006129,172.31.33.0-255,66,12413,21,186007
5547,0.006135,172.217.194.0-255,5738,18151,21,186007
5548,0.006137,172.31.33.0-255,66,18217,21,186007
5549,0.006166,172.217.194.0-255,6302,24519,21,186007
5550,0.006169,172.31.33.0-255,66,24585,21,186007
5551,0.006181,172.217.194.0-255,2902,27487,21,186007
5552,0.006183,172.31.33.0-255,66,27553,21,186007
5553,0.006206,172.217.194.0-255,3961,31514,21,186007
5554,0.006209,172.31.33.0-255,66,31580,21,186007
5555,0.00624,172.217.194.0-255,7156,38736,21,186007
5556,0.006243,172.31.33.0-255,66,38802,21,186007
5557,0.006272,172.217.194.0-255,7156,45958,21,186007
5558,0.006277,172.31.33.0-255,66,46024,21,186007
5559,0.006301,172.217.194.0-255,5738,51762,21,186007
5560,0.006304,172.31.33.0-255,66,51828,21,186007
5561,0.006331,172.217.194.0-255,7156,58984,21,186007
5562,0.006335,172.31.33.0-255,66,59050,21,186007
5563,0.006359,172.217.194.0-255,2902,61952,21,186007
5564,0.006362,172.31.33.0-255,66,62018,21,186007
5565,0.006367,172.217.194.0-255,3602,65620,21,186007
5566,0.006369,172.31.33.0-255,66,65686,21,186007
5567,0.006371,172.217.194.0-255,393,66079,21,186007
5568,0.006374,172.31.33.0-255,66,66145,21,186007
5569,0.00641,172.217.194.0-255,380,66525,21,186007
5570,0.006413,172.31.33.0-255,66,66591,21,186007
5571,0.006536,172.217.194.0-255,1484,68075,21,186007
5572,0.006553,172.217.194.0-255,2902,70977,21,186007
5573,0.006556,172.31.33.0-255,66,71043,21,186007
5574,0.00656,172.217.194.0-255,2902,73945,21,186007
5575,0.006562,172.31.33.0-255,66,74011,21,186007
5576,0.00659,172.217.194.0-255,2902,76913,21,186007
5577,0.006594,172.31.33.0-255,66,76979,21,186007
5578,0.006596,172.217.194.0-255,6797,83776,21,186007
5579,0.006598,172.31.33.0-255,66,83842,21,186007
5580,0.006634,172.217.194.0-255,7156,90998,21,186007
5581,0.006637,172.31.33.0-255,66,91064,21,186007
5582,0.006643,172.217.194.0-255,7156,98220,21,186007
5583,0.006646,172.31.33.0-255,66,98286,21,186007
5584,0.006668,172.217.194.0-255,2543,100829,21,186007
5585,0.006671,172.31.33.0-255,66,100895,21,186007
5586,0.007347,172.217.194.0-255,1484,102379,21,186007
5587,0.00736,172.217.194.0-255,2902,105281,21,186007
5588,0.007365,172.31.33.0-255,66,105347,21,186007
5589,0.007373,172.217.194.0-255,5738,111085,21,186007
5590,0.007375,172.31.33.0-255,66,111151,21,186007
5591,0.007393,172.31.33.0-255,66,111217,21,186007
5592,0.007428,172.217.194.0-255,4320,115537,21,186007
5593,0.00743,172.31.33.0-255,66,115603,21,186007
5594,0.007442,172.31.33.0-255,66,115669,21,186007
5595,0.008623,172.217.194.0-255,1484,117153,21,186007
5596,0.008637,172.217.194.0-255,1484,118637,21,186007
5597,0.008639,172.31.33.0-255,66,118703,21,186007
5598,0.008643,172.217.194.0-255,1484,120187,21,186007
5599,0.008656,172.217.194.0-255,2902,123089,21,186007
5600,0.008658,172.31.33.0-255,66,123155,21,186007
5601,0.008662,172.217.194.0-255,2902,126057,21,186007
5602,0.008663,172.31.33.0-255,66,126123,21,186007
5603,0.008694,172.217.194.0-255,2902,129025,21,186007
5604,0.008696,172.31.33.0-255,66,129091,21,186007
5605,0.008702,172.217.194.0-255,7156,136247,21,186007
5606,0.008703,172.31.33.0-255,66,136313,21,186007
5607,0.008766,172.31.33.0-255,66,136379,21,186007
5608,0.008913,172.217.194.0-255,1484,137863,21,186007
5609,0.00893,172.217.194.0-255,1484,139347,21,186007
5610,0.008932,172.31.33.0-255,66,139413,21,186007
5611,0.008956,172.217.194.0-255,1484,140897,21,186007
5612,0.008961,172.217.194.0-255,5738,146635,21,186007
5613,0.008962,172.31.33.0-255,66,146701,21,186007
5614,0.008972,172.31.33.0-255,66,146767,21,186007
5615,0.009001,172.217.194.0-255,2902,149669,21,186007
5616,0.009003,172.31.33.0-255,66,149735,21,186007
5617,0.009012,172.31.33.0-255,66,149801,21,186007
5618,0.009046,172.31.33.0-255,66,149867,21,186007
5619,0.009083,172.31.33.0-255,66,149933,21,186007
5620,0.009089,172.217.194.0-255,7156,157089,21,186007
5621,0.009091,172.31.33.0-255,66,157155,21,186007
5622,0.009116,172.217.194.0-255,2184,159339,21,186007
5623,0.009118,172.31.33.0-255,66,159405,21,186007
5624,0.009128,172.31.33.0-255,66,159471,21,186007
5625,0.009158,172.31.33.0-255,66,159537,21,186007
5626,0.009163,172.217.194.0-255,6438,165975,21,186007
5627,0.009165,172.31.33.0-255,66,166041,21,186007
5628,0.00921,172.31.33.0-255,66,166107,21,186007
5629,0.009251,172.31.33.0-255,66,166173,21,186007
5630,0.009257,172.217.194.0-255,7156,173329,21,186007
5631,0.009259,172.31.33.0-255,66,173395,21,186007
5632,0.009288,172.31.33.0-255,66,173461,21,186007
5633,0.009327,172.31.33.0-255,66,173527,21,186007
5634,0.009346,172.217.194.0-255,3602,177129,21,186007
5635,0.009349,172.31.33.0-255,66,177195,21,186007
5636,0.009391,172.31.33.0-255,66,177261,21,186007
5637,0.009423,172.31.33.0-255,66,177327,21,186007
5638,0.009435,172.31.33.0-255,66,177393,21,186007
5639,0.00945,172.31.33.0-255,66,177459,21,186007
5640,0.009497,172.31.33.0-255,66,177525,21,186007
5641,0.009509,172.31.33.0-255,66,177591,21,186007
5642,0.009512,172.217.194.0-255,105,177696,21,186007
5643,0.014266,172.31.33.0-255,66,177762,21,186007
5644,0.014294,172.31.33.0-255,105,177867,21,186007
5645,0.016361,172.217.194.0-255,66,177933,21,186007
5646,0.034323,172.31.33.0-255,172,178105,21,186007
5647,0.034348,172.31.33.0-255,1114,179219,21,186007
5648,0.034387,172.31.33.0-255,1514,180733,21,186007
5649,0.034405,172.31.33.0-255,1514,182247,21,186007
5650,0.034408,172.31.33.0-255,1514,183761,21,186007
5651,0.034421,172.31.33.0-255,1514,185275,21,186007
5652,0.034424,172.31.33.0-255,468,185743,21,186007
5653,0.035865,104.244.42.0-255,66,185809,21,186007
5654,0.035912,104.244.42.0-255,66,185875,21,186007
5655,0.035949,104.244.42.0-255,66,185941,21,186007
5656,0.035952,104.244.42.0-255,66,186007,21,186007
5657,0.0,172.31.33.0-255,105,105,21,459
5658,0.000182,172.31.33.0-255,90,195,21,459
5659,0.000191,172.31.33.0-255,66,261,21,459
5660,0.002161,172.217.194.0-255,66,327,21,459
5661,0.002173,172.217.194.0-255,66,393,21,459
5662,0.002183,172.31.33.0-255,66,459,21,459
5663,0.0,172.217.26.0-255,739,739,21,95040
5664,9e-06,172.217.26.0-255,1484,2223,21,95040
5665,1.5e-05,172.31.33.0-255,66,2289,21,95040
5666,2.3e-05,172.217.26.0-255,4320,6609,21,95040
5667,2.7e-05,172.31.33.0-255,66,6675,21,95040
5668,0.000163,172.217.26.0-255,7156,13831,21,95040
5669,0.000168,172.31.33.0-255,66,13897,21,95040
5670,0.000192,172.217.26.0-255,217,14114,21,95040
5671,0.000406,172.217.26.0-255,5738,19852,21,95040
5672,0.000412,172.31.33.0-255,66,19918,21,95040
5673,0.000435,172.217.26.0-255,2902,22820,21,95040
5674,0.000438,172.31.33.0-255,66,22886,21,95040
5675,0.000704,172.217.26.0-255,5738,28624,21,95040
5676,0.00071,172.31.33.0-255,66,28690,21,95040
5677,0.000737,172.217.26.0-255,1484,30174,21,95040
5678,0.001991,172.31.33.0-255,66,30240,21,95040
5679,0.002198,172.217.26.0-255,4320,34560,21,95040
5680,0.002203,172.31.33.0-255,66,34626,21,95040
5681,0.002403,172.31.33.0-255,66,34692,21,95040
5682,0.002998,172.217.26.0-255,5738,40430,21,95040
5683,0.003004,172.31.33.0-255,66,40496,21,95040
5684,0.003359,172.31.33.0-255,66,40562,21,95040
5685,0.003946,172.217.26.0-255,7156,47718,21,95040
5686,0.003953,172.31.33.0-255,66,47784,21,95040
5687,0.004144,172.217.26.0-255,2902,50686,21,95040
5688,0.004231,172.31.33.0-255,66,50752,21,95040
5689,0.004427,172.217.26.0-255,4320,55072,21,95040
5690,0.004433,172.31.33.0-255,66,55138,21,95040
5691,0.004477,172.31.33.0-255,66,55204,21,95040
5692,0.004958,172.31.33.0-255,66,55270,21,95040
5693,0.005,172.31.33.0-255,66,55336,21,95040
5694,0.00592,172.31.33.0-255,66,55402,21,95040
5695,0.005966,172.31.33.0-255,66,55468,21,95040
5696,0.006204,172.217.26.0-255,5738,61206,21,95040
5697,0.006208,172.31.33.0-255,66,61272,21,95040
5698,0.006221,172.217.26.0-255,5738,67010,21,95040
5699,0.006227,172.31.33.0-255,66,67076,21,95040
5700,0.006264,172.31.33.0-255,66,67142,21,95040
5701,0.006289,172.217.26.0-255,1354,68496,21,95040
5702,0.006491,172.217.26.0-255,5738,74234,21,95040
5703,0.006494,172.31.33.0-255,66,74300,21,95040
5704,0.006521,172.217.26.0-255,1614,75914,21,95040
5705,0.006524,172.31.33.0-255,66,75980,21,95040
5706,0.006917,172.217.26.0-255,7156,83136,21,95040
5707,0.006921,172.31.33.0-255,66,83202,21,95040
5708,0.007002,172.31.33.0-255,66,83268,21,95040
5709,0.007013,172.217.26.0-255,1484,84752,21,95040
5710,0.007101,172.217.26.0-255,4320,89072,21,95040
5711,0.007107,172.31.33.0-255,66,89138,21,95040
5712,0.007155,172.31.33.0-255,66,89204,21,95040
5713,0.007192,172.31.33.0-255,66,89270,21,95040
5714,0.007929,172.31.33.0-255,66,89336,21,95040
5715,0.007978,172.31.33.0-255,66,89402,21,95040
5716,0.008006,172.31.33.0-255,66,89468,21,95040
5717,0.008212,172.31.33.0-255,66,89534,21,95040
5718,0.008253,172.31.33.0-255,66,89600,21,95040
5719,0.00872,172.31.33.0-255,105,89705,21,95040
5720,0.014516,172.217.26.0-255,66,89771,21,95040
5721,0.036793,172.31.33.0-255,175,89946,21,95040
5722,0.036821,172.31.33.0-255,1137,91083,21,95040
5723,0.036876,172.31.33.0-255,1514,92597,21,95040
5724,0.036878,172.31.33.0-255,1514,94111,21,95040
5725,0.036899,172.31.33.0-255,665,94776,21,95040
5726,0.03833,104.244.42.0-255,66,94842,21,95040
5727,0.038372,104.244.42.0-255,66,94908,21,95040
5728,0.038421,104.244.42.0-255,66,94974,21,95040
5729,0.038425,104.244.42.0-255,66,95040,21,95040
5730,0.0,172.31.33.0-255,105,105,21,459
5731,0.00017,172.31.33.0-255,90,195,21,459
5732,0.000179,172.31.33.0-255,66,261,21,459
5733,0.002456,172.217.194.0-255,66,327,21,459
5734,0.00247,172.217.194.0-255,66,393,21,459
5735,0.002481,172.31.33.0-255,66,459,21,459
5736,0.0,74.125.200.0-255,153,153,21,388971
5737,2.1e-05,172.31.33.0-255,66,219,21,388971
5738,2.8e-05,74.125.200.0-255,1484,1703,21,388971
5739,3.3e-05,172.31.33.0-255,66,1769,21,388971
5740,4.5e-05,74.125.200.0-255,2902,4671,21,388971
5741,4.9e-05,172.31.33.0-255,66,4737,21,388971
5742,5.6e-05,74.125.200.0-255,7156,11893,21,388971
5743,5.9e-05,172.31.33.0-255,66,11959,21,388971
5744,6.6e-05,74.125.200.0-255,5738,17697,21,388971
5745,6.9e-05,172.31.33.0-255,66,17763,21,388971
5746,8.6e-05,74.125.200.0-255,1959,19722,21,388971
5747,8.8e-05,172.31.33.0-255,66,19788,21,388971
5748,9.8e-05,74.125.200.0-255,5738,25526,21,388971
5749,0.0001,172.31.33.0-255,66,25592,21,388971
5750,0.000126,74.125.200.0-255,4320,29912,21,388971
5751,0.000128,172.31.33.0-255,66,29978,21,388971
5752,0.000131,74.125.200.0-255,1125,31103,21,388971
5753,0.000134,172.31.33.0-255,66,31169,21,388971
5754,0.000213,74.125.200.0-255,1484,32653,21,388971
5755,0.000216,172.31.33.0-255,66,32719,21,388971
5756,0.00022,74.125.200.0-255,1484,34203,21,388971
5757,0.000222,172.31.33.0-255,66,34269,21,388971
5758,0.000234,74.125.200.0-255,1484,35753,21,388971
5759,0.000236,172.31.33.0-255,66,35819,21,388971
5760,0.000239,74.125.200.0-255,1484,37303,21,388971
5761,0.000241,172.31.33.0-255,66,37369,21,388971
5762,0.000245,74.125.200.0-255,2902,40271,21,388971
5763,0.000247,172.31.33.0-255,66,40337,21,388971
5764,0.000275,74.125.200.0-255,5738,46075,21,388971
5765,0.000278,172.31.33.0-255,66,46141,21,388971
5766,0.00028,74.125.200.0-255,1484,47625,21,388971
5767,0.000282,172.31.33.0-255,66,47691,21,388971
5768,0.000329,74.125.200.0-255,2902,50593,21,388971
5769,0.000332,172.31.33.0-255,66,50659,21,388971
5770,0.000335,74.125.200.0-255,1484,52143,21,388971
5771,0.000357,74.125.200.0-255,2902,55045,21,388971
5772,0.000359,172.31.33.0-255,66,55111,21,388971
5773,0.000362,74.125.200.0-255,1484,56595,21,388971
5774,0.000389,74.125.200.0-255,4320,60915,21,388971
5775,0.000392,172.31.33.0-255,66,60981,21,388971
5776,0.000397,74.125.200.0-255,5020,66001,21,388971
5777,0.000399,172.31.33.0-255,66,66067,21,388971
5778,0.00042,74.125.200.0-255,398,66465,21,388971
5779,0.000458,74.125.200.0-255,110,66575,21,388971
5780,0.000559,74.125.200.0-255,1484,68059,21,388971
5781,0.000563,172.31.33.0-255,66,68125,21,388971
5782,0.000568,74.125.200.0-255,2902,71027,21,388971
5783,0.000571,172.31.33.0-255,66,71093,21,388971
5784,0.000599,74.125.200.0-255,5738,76831,21,388971
5785,0.000601,172.31.33.0-255,66,76897,21,388971
5786,0.000605,74.125.200.0-255,2902,79799,21,388971
5787,0.000607,172.31.33.0-255,66,79865,21,388971
5788,0.000611,74.125.200.0-255,4320,84185,21,388971
5789,0.000613,172.31.33.0-255,66,84251,21,388971
5790,0.000653,172.31.33.0-255,66,84317,21,388971
5791,0.000658,74.125.200.0-255,5738,90055,21,388971
5792,0.00066,172.31.33.0-255,66,90121,21,388971
5793,0.0007,74.125.200.0-255,2184,92305,21,388971
5794,0.000703,172.31.33.0-255,66,92371,21,388971
5795,0.000707,74.125.200.0-255,2902,95273,21,388971
5796,0.000709,172.31.33.0-255,66,95339,21,388971
5797,0.00077,74.125.200.0-255,7156,102495,21,388971
5798,0.000773,172.31.33.0-255,66,102561,21,388971
5799,0.000779,74.125.200.0-255,6483,109044,21,388971
5800,0.000781,172.31.33.0-255,66,109110,21,388971
5801,0.000787,74.125.200.0-255,7156,116266,21,388971
5802,0.000789,172.31.33.0-255,66,116332,21,388971
5803,0.00083,172.31.33.0-255,66,116398,21,388971
5804,0.000857,172.31.33.0-255,66,116464,21,388971
5805,0.00088,74.125.200.0-255,2902,119366,21,388971
5806,0.000882,172.31.33.0-255,66,119432,21,388971
5807,0.000912,74.125.200.0-255,2184,121616,21,388971
5808,0.000914,172.31.33.0-255,66,121682,21,388971
5809,0.000957,74.125.200.0-255,1484,123166,21,388971
5810,0.000987,74.125.200.0-255,2902,126068,21,388971
5811,0.00099,172.31.33.0-255,66,126134,21,388971
5812,0.00102,74.125.200.0-255,5738,131872,21,388971
5813,0.001023,172.31.33.0-255,66,131938,21,388971
5814,0.001046,74.125.200.0-255,2902,134840,21,388971
5815,0.001048,172.31.33.0-255,66,134906,21,388971
5816,0.001071,74.125.200.0-255,2902,137808,21,388971
5817,0.001074,172.31.33.0-255,66,137874,21,388971
5818,0.00108,74.125.200.0-255,7156,145030,21,388971
5819,0.001082,172.31.33.0-255,66,145096,21,388971
5820,0.001118,172.31.33.0-255,66,145162,21,388971
5821,0.001144,74.125.200.0-255,766,145928,21,388971
5822,0.001733,74.125.200.0-255,1484,147412,21,388971
5823,0.001737,172.31.33.0-255,66,147478,21,388971
5824,0.001742,74.125.200.0-255,2902,150380,21,388971
5825,0.001744,172.31.33.0-255,66,150446,21,388971
5826,0.001747,74.125.200.0-255,1484,151930,21,388971
5827,0.001784,74.125.200.0-255,4320,156250,21,388971
5828,0.001787,172.31.33.0-255,66,156316,21,388971
5829,0.001791,74.125.200.0-255,2902,159218,21,388971
5830,0.001793,172.31.33.0-255,66,159284,21,388971
5831,0.001798,74.125.200.0-255,4320,163604,21,388971
5832,0.001799,172.31.33.0-255,66,163670,21,388971
5833,0.001804,74.125.200.0-255,5738,169408,21,388971
5834,0.001806,172.31.33.0-255,66,169474,21,388971
5835,0.001834,74.125.200.0-255,2902,172376,21,388971
5836,0.001837,172.31.33.0-255,66,172442,21,388971
5837,0.001842,74.125.200.0-255,5738,178180,21,388971
5838,0.001844,172.31.33.0-255,66,178246,21,388971
5839,0.001864,74.125.200.0-255,2184,180430,21,388971
5840,0.001866,172.31.33.0-255,66,180496,21,388971
5841,0.001948,74.125.200.0-255,1484,181980,21,388971
5842,0.001954,74.125.200.0-255,2902,184882,21,388971
5843,0.001956,172.31.33.0-255,66,184948,21,388971
5844,0.001987,74.125.200.0-255,4320,189268,21,388971
5845,0.00199,172.31.33.0-255,66,189334,21,388971
5846,0.002012,74.125.200.0-255,1484,190818,21,388971
5847,0.002017,74.125.200.0-255,4320,195138,21,388971
5848,0.00202,172.31.33.0-255,66,195204,21,388971
5849,0.002035,74.125.200.0-255,1484,196688,21,388971
5850,0.002058,74.125.200.0-255,7156,203844,21,388971
5851,0.00206,172.31.33.0-255,66,203910,21,388971
5852,0.002065,74.125.200.0-255,4320,208230,21,388971
5853,0.002067,172.31.33.0-255,66,208296,21,388971
5854,0.002082,74.125.200.0-255,4320,212616,21,388971
5855,0.002084,172.31.33.0-255,66,212682,21,388971
5856,0.002104,74.125.200.0-255,1484,214166,21,388971
5857,0.002107,74.125.200.0-255,766,214932,21,388971
5858,0.002109,172.31.33.0-255,66,214998,21,388971
5859,0.002263,74.125.200.0-255,1484,216482,21,388971
5860,0.002276,74.125.200.0-255,2902,219384,21,388971
5861,0.002279,172.31.33.0-255,66,219450,21,388971
5862,0.002302,74.125.200.0-255,4320,223770,21,388971
5863,0.002305,172.31.33.0-255,66,223836,21,388971
5864,0.002333,74.125.200.0-255,1484,225320,21,388971
5865,0.002337,74.125.200.0-255,1484,226804,21,388971
5866,0.002339,172.31.33.0-255,66,226870,21,388971
5867,0.002344,74.125.200.0-255,2902,229772,21,388971
5868,0.002345,172.31.33.0-255,66,229838,21,388971
5869,0.002371,74.125.200.0-255,5738,235576,21,388971
5870,0.002374,172.31.33.0-255,66,235642,21,388971
5871,0.002376,74.125.200.0-255,1484,237126,21,388971
5872,0.002399,74.125.200.0-255,2902,240028,21,388971
5873,0.002401,172.31.33.0-255,66,240094,21,388971
5874,0.004726,74.125.200.0-255,1484,241578,21,388971
5875,0.004747,74.125.200.0-255,4320,245898,21,388971
5876,0.004751,172.31.33.0-255,66,245964,21,388971
5877,0.007127,74.125.200.0-255,5738,251702,21,388971
5878,0.007131,172.31.33.0-255,66,251768,21,388971
5879,0.00949,74.125.200.0-255,5738,257506,21,388971
5880,0.009497,172.31.33.0-255,66,257572,21,388971
5881,0.011862,74.125.200.0-255,5738,263310,21,388971
5882,0.011869,172.31.33.0-255,66,263376,21,388971
5883,0.014247,74.125.200.0-255,5738,269114,21,388971
5884,0.014256,172.31.33.0-255,66,269180,21,388971
5885,0.01662,74.125.200.0-255,5738,274918,21,388971
5886,0.016627,172.31.33.0-255,66,274984,21,388971
5887,0.018976,74.125.200.0-255,5738,280722,21,388971
5888,0.018983,172.31.33.0-255,66,280788,21,388971
5889,0.021325,74.125.200.0-255,5738,286526,21,388971
5890,0.02133,172.31.33.0-255,66,286592,21,388971
5891,0.023706,74.125.200.0-255,5738,292330,21,388971
5892,0.023712,172.31.33.0-255,66,292396,21,388971
5893,0.026072,74.125.200.0-255,5738,298134,21,388971
5894,0.026077,172.31.33.0-255,66,298200,21,388971
5895,0.026923,172.31.33.0-255,172,298372,21,388971
5896,0.026949,172.31.33.0-255,1109,299481,21,388971
5897,0.026996,172.31.33.0-255,1514,300995,21,388971
5898,0.026998,172.31.33.0-255,1514,302509,21,388971
5899,0.02702,172.31.33.0-255,695,303204,21,388971
5900,0.028431,104.244.42.0-255,66,303270,21,388971
5901,0.028446,74.125.200.0-255,5738,309008,21,388971
5902,0.028452,172.31.33.0-255,66,309074,21,388971
5903,0.02863,104.244.42.0-255,66,309140,21,388971
5904,0.028636,104.244.42.0-255,66,309206,21,388971
5905,0.028639,104.244.42.0-255,66,309272,21,388971
5906,0.030803,74.125.200.0-255,5738,315010,21,388971
5907,0.030809,172.31.33.0-255,66,315076,21,388971
5908,0.033162,74.125.200.0-255,5738,320814,21,388971
5909,0.033168,172.31.33.0-255,66,320880,21,388971
5910,0.035534,74.125.200.0-255,5738,326618,21,388971
5911,0.035542,172.31.33.0-255,66,326684,21,388971
5912,0.037912,74.125.200.0-255,5738,332422,21,388971
5913,0.037918,172.31.33.0-255,66,332488,21,388971
5914,0.04027,74.125.200.0-255,5738,338226,21,388971
5915,0.040276,172.31.33.0-255,66,338292,21,388971
5916,0.042629,74.125.200.0-255,5738,344030,21,388971
5917,0.042637,172.31.33.0-255,66,344096,21,388971
5918,0.044985,74.125.200.0-255,5738,349834,21,388971
5919,0.04499,172.31.33.0-255,66,349900,21,388971
5920,0.047338,74.125.200.0-255,5738,355638,21,388971
5921,0.047344,172.31.33.0-255,66,355704,21,388971
5922,0.049718,74.125.200.0-255,5738,361442,21,388971
5923,0.049727,172.31.33.0-255,66,361508,21,388971
5924,0.052088,74.125.200.0-255,5738,367246,21,388971
5925,0.052093,172.31.33.0-255,66,367312,21,388971
5926,0.054443,74.125.200.0-255,5738,373050,21,388971
5927,0.054448,172.31.33.0-255,66,373116,21,388971
5928,0.056801,74.125.200.0-255,5738,378854,21,388971
5929,0.056806,172.31.33.0-255,66,378920,21,388971
5930,0.059164,74.125.200.0-255,5738,384658,21,388971
5931,0.059171,172.31.33.0-255,66,384724,21,388971
5932,0.06152,74.125.200.0-255,4010,388734,21,388971
5933,0.061525,172.31.33.0-255,66,388800,21,388971
5934,0.06168,172.31.33.0-255,105,388905,21,388971
5935,0.063994,74.125.200.0-255,66,388971,21,388971
5936,0.0,74.125.130.0-255,148,148,21,377512
5937,1.2e-05,172.31.33.0-255,66,214,21,377512
5938,4.4e-05,74.125.130.0-255,1484,1698,21,377512
5939,4.8e-05,172.31.33.0-255,66,1764,21,377512
5940,5.2e-05,74.125.130.0-255,2902,4666,21,377512
5941,5.5e-05,172.31.33.0-255,66,4732,21,377512
5942,8.1e-05,74.125.130.0-255,7156,11888,21,377512
5943,8.4e-05,172.31.33.0-255,66,11954,21,377512
5944,0.000133,74.125.130.0-255,1728,13682,21,377512
5945,0.000137,172.31.33.0-255,66,13748,21,377512
5946,0.000285,74.125.130.0-255,1484,15232,21,377512
5947,0.000289,172.31.33.0-255,66,15298,21,377512
5948,0.000294,74.125.130.0-255,2902,18200,21,377512
5949,0.000297,172.31.33.0-255,66,18266,21,377512
5950,0.000331,74.125.130.0-255,4320,22586,21,377512
5951,0.000334,172.31.33.0-255,66,22652,21,377512
5952,0.000366,74.125.130.0-255,5738,28390,21,377512
5953,0.000368,172.31.33.0-255,66,28456,21,377512
5954,0.000383,74.125.130.0-255,2543,30999,21,377512
5955,0.000389,172.31.33.0-255,66,31065,21,377512
5956,0.000393,74.125.130.0-255,2902,33967,21,377512
5957,0.000396,172.31.33.0-255,66,34033,21,377512
5958,0.000428,74.125.130.0-255,5738,39771,21,377512
5959,0.000432,172.31.33.0-255,66,39837,21,377512
5960,0.000442,74.125.130.0-255,1484,41321,21,377512
5961,0.000444,172.31.33.0-255,66,41387,21,377512
5962,0.00046,172.31.33.0-255,66,41453,21,377512
5963,0.000511,172.31.33.0-255,66,41519,21,377512
5964,0.000541,74.125.130.0-255,6438,47957,21,377512
5965,0.000543,74.125.130.0-255,363,48320,21,377512
5966,0.000548,172.31.33.0-255,66,48386,21,377512
5967,0.000674,74.125.130.0-255,1484,49870,21,377512
5968,0.000679,172.31.33.0-255,66,49936,21,377512
5969,0.000705,74.125.130.0-255,2902,52838,21,377512
5970,0.000707,172.31.33.0-255,66,52904,21,377512
5971,0.000711,74.125.130.0-255,1484,54388,21,377512
5972,0.00074,74.125.130.0-255,4320,58708,21,377512
5973,0.000743,172.31.33.0-255,66,58774,21,377512
5974,0.000748,74.125.130.0-255,4320,63094,21,377512
5975,0.000751,172.31.33.0-255,66,63160,21,377512
5976,0.000755,74.125.130.0-255,2902,66062,21,377512
5977,0.000761,172.31.33.0-255,66,66128,21,377512
5978,0.000802,172.31.33.0-255,66,66194,21,377512
5979,0.000807,74.125.130.0-255,4320,70514,21,377512
5980,0.00081,172.31.33.0-255,66,70580,21,377512
5981,0.000838,74.125.130.0-255,3602,74182,21,377512
5982,0.000844,172.31.33.0-255,66,74248,21,377512
5983,0.000848,74.125.130.0-255,380,74628,21,377512
5984,0.000937,74.125.130.0-255,1484,76112,21,377512
5985,0.000941,172.31.33.0-255,66,76178,21,377512
5986,0.000945,74.125.130.0-255,1484,77662,21,377512
5987,0.00097,74.125.130.0-255,1484,79146,21,377512
5988,0.000973,172.31.33.0-255,66,79212,21,377512
5989,0.000977,74.125.130.0-255,1484,80696,21,377512
5990,0.001005,74.125.130.0-255,4320,85016,21,377512
5991,0.001008,172.31.33.0-255,66,85082,21,377512
5992,0.001043,74.125.130.0-255,7156,92238,21,377512
5993,0.001046,172.31.33.0-255,66,92304,21,377512
5994,0.00105,74.125.130.0-255,2902,95206,21,377512
5995,0.001052,172.31.33.0-255,66,95272,21,377512
5996,0.001058,74.125.130.0-255,4320,99592,21,377512
5997,0.001065,172.31.33.0-255,66,99658,21,377512
5998,0.0011,74.125.130.0-255,5738,105396,21,377512
5999,0.001103,172.31.33.0-255,66,105462,21,377512
6000,0.001161,74.125.130.0-255,3602,109064,21,377512
6001,0.001164,172.31.33.0-255,66,109130,21,377512
6002,0.001229,74.125.130.0-255,1484,110614,21,377512
6003,0.001249,74.125.130.0-255,2902,113516,21,377512
6004,0.001254,172.31.33.0-255,66,113582,21,377512
6005,0.001281,74.125.130.0-255,1484,115066,21,377512
6006,0.001308,74.125.130.0-255,4320,119386,21,377512
6007,0.001311,172.31.33.0-255,66,119452,21,377512
6008,0.001316,74.125.130.0-255,2902,122354,21,377512
6009,0.001318,172.31.33.0-255,66,122420,21,377512
6010,0.001324,74.125.130.0-255,4320,126740,21,377512
6011,0.001326,172.31.33.0-255,66,126806,21,377512
6012,0.001341,172.31.33.0-255,66,126872,21,377512
6013,0.001349,74.125.130.0-255,5738,132610,21,377512
6014,0.001351,172.31.33.0-255,66,132676,21,377512
6015,0.001391,74.125.130.0-255,2184,134860,21,377512
6016,0.001393,172.31.33.0-255,66,134926,21,377512
6017,0.001649,74.125.130.0-255,1484,136410,21,377512
6018,0.001668,74.125.130.0-255,2902,139312,21,377512
6019,0.001671,172.31.33.0-255,66,139378,21,377512
6020,0.00169,74.125.130.0-255,4320,143698,21,377512
6021,0.001693,172.31.33.0-255,66,143764,21,377512
6022,0.001696,74.125.130.0-255,1484,145248,21,377512
6023,0.001721,74.125.130.0-255,4320,149568,21,377512
6024,0.001723,172.31.33.0-255,66,149634,21,377512
6025,0.001755,172.31.33.0-255,66,149700,21,377512
6026,0.001795,74.125.130.0-255,2902,152602,21,377512
6027,0.001798,172.31.33.0-255,66,152668,21,377512
6028,0.001809,74.125.130.0-255,5738,158406,21,377512
6029,0.001816,172.31.33.0-255,66,158472,21,377512
6030,0.001833,74.125.130.0-255,2184,160656,21,377512
6031,0.00184,172.31.33.0-255,66,160722,21,377512
6032,0.002024,74.125.130.0-255,1484,162206,21,377512
6033,0.00203,74.125.130.0-255,2902,165108,21,377512
6034,0.002033,172.31.33.0-255,66,165174,21,377512
6035,0.002036,74.125.130.0-255,1484,166658,21,377512
6036,0.002059,74.125.130.0-255,2902,169560,21,377512
6037,0.002061,172.31.33.0-255,66,169626,21,377512
6038,0.00209,74.125.130.0-255,5738,175364,21,377512
6039,0.002094,172.31.33.0-255,66,175430,21,377512
6040,0.0021,74.125.130.0-255,4320,179750,21,377512
6041,0.002102,172.31.33.0-255,66,179816,21,377512
6042,0.002123,74.125.130.0-255,5738,185554,21,377512
6043,0.002126,172.31.33.0-255,66,185620,21,377512
6044,0.002149,74.125.130.0-255,1484,187104,21,377512
6045,0.002171,74.125.130.0-255,7156,194260,21,377512
6046,0.002174,172.31.33.0-255,66,194326,21,377512
6047,0.002177,74.125.130.0-255,766,195092,21,377512
6048,0.004335,74.125.130.0-255,2902,197994,21,377512
6049,0.004341,172.31.33.0-255,66,198060,21,377512
6050,0.004366,74.125.130.0-255,1484,199544,21,377512
6051,0.006511,74.125.130.0-255,4320,203864,21,377512
6052,0.006518,172.31.33.0-255,66,203930,21,377512
6053,0.008674,74.125.130.0-255,5738,209668,21,377512
6054,0.008678,172.31.33.0-255,66,209734,21,377512
6055,0.010836,74.125.130.0-255,5738,215472,21,377512
6056,0.010842,172.31.33.0-255,66,215538,21,377512
6057,0.013008,74.125.130.0-255,5738,221276,21,377512
6058,0.013017,172.31.33.0-255,66,221342,21,377512
6059,0.015195,74.125.130.0-255,5738,227080,21,377512
6060,0.015203,172.31.33.0-255,66,227146,21,377512
6061,0.01738,74.125.130.0-255,5738,232884,21,377512
6062,0.01739,172.31.33.0-255,66,232950,21,377512
6063,0.019547,74.125.130.0-255,5738,238688,21,377512
6064,0.019554,172.31.33.0-255,66,238754,21,377512
6065,0.021713,74.125.130.0-255,5738,244492,21,377512
6066,0.021719,172.31.33.0-255,66,244558,21,377512
6067,0.023883,74.125.130.0-255,5738,250296,21,377512
6068,0.023891,172.31.33.0-255,66,250362,21,377512
6069,0.026057,74.125.130.0-255,5738,256100,21,377512
6070,0.026064,172.31.33.0-255,66,256166,21,377512
6071,0.02823,74.125.130.0-255,5738,261904,21,377512
6072,0.028237,172.31.33.0-255,66,261970,21,377512
6073,0.030396,74.125.130.0-255,5738,267708,21,377512
6074,0.030403,172.31.33.0-255,66,267774,21,377512
6075,0.032611,74.125.130.0-255,5738,273512,21,377512
6076,0.03262,172.31.33.0-255,66,273578,21,377512
6077,0.034772,74.125.130.0-255,5738,279316,21,377512
6078,0.03478,172.31.33.0-255,66,279382,21,377512
6079,0.036581,172.31.33.0-255,172,279554,21,377512
6080,0.036608,172.31.33.0-255,1114,280668,21,377512
6081,0.036662,172.31.33.0-255,1514,282182,21,377512
6082,0.036664,172.31.33.0-255,1514,283696,21,377512
6083,0.036686,172.31.33.0-255,688,284384,21,377512
6084,0.036934,74.125.130.0-255,5738,290122,21,377512
6085,0.036939,172.31.33.0-255,66,290188,21,377512
6086,0.038214,104.244.42.0-255,66,290254,21,377512
6087,0.038243,104.244.42.0-255,66,290320,21,377512
6088,0.038338,104.244.42.0-255,66,290386,21,377512
6089,0.038343,104.244.42.0-255,66,290452,21,377512
6090,0.039108,74.125.130.0-255,5738,296190,21,377512
6091,0.039115,172.31.33.0-255,66,296256,21,377512
6092,0.041283,74.125.130.0-255,5738,301994,21,377512
6093,0.04129,172.31.33.0-255,66,302060,21,377512
6094,0.043448,74.125.130.0-255,5738,307798,21,377512
6095,0.043457,172.31.33.0-255,66,307864,21,377512
6096,0.045633,74.125.130.0-255,5738,313602,21,377512
6097,0.045639,172.31.33.0-255,66,313668,21,377512
6098,0.047825,74.125.130.0-255,5738,319406,21,377512
6099,0.047832,172.31.33.0-255,66,319472,21,377512
6100,0.05,74.125.130.0-255,5738,325210,21,377512
6101,0.050007,172.31.33.0-255,66,325276,21,377512
6102,0.05218,74.125.130.0-255,5738,331014,21,377512
6103,0.052186,172.31.33.0-255,66,331080,21,377512
6104,0.054352,74.125.130.0-255,5738,336818,21,377512
6105,0.054359,172.31.33.0-255,66,336884,21,377512
6106,0.05654,74.125.130.0-255,5738,342622,21,377512
6107,0.056545,172.31.33.0-255,66,342688,21,377512
6108,0.058703,74.125.130.0-255,5738,348426,21,377512
6109,0.058709,172.31.33.0-255,66,348492,21,377512
6110,0.060905,74.125.130.0-255,5738,354230,21,377512
6111,0.060912,172.31.33.0-255,66,354296,21,377512
6112,0.063079,74.125.130.0-255,5738,360034,21,377512
6113,0.063085,172.31.33.0-255,66,360100,21,377512
6114,0.065297,74.125.130.0-255,5738,365838,21,377512
6115,0.065304,172.31.33.0-255,66,365904,21,377512
6116,0.067467,74.125.130.0-255,5738,371642,21,377512
6117,0.067473,172.31.33.0-255,66,371708,21,377512
6118,0.069631,74.125.130.0-255,5738,377446,21,377512
6119,0.069636,172.31.33.0-255,66,377512,21,377512
6120,0.0,172.31.33.0-255,105,105,21,459
6121,0.000192,172.31.33.0-255,90,195,21,459
6122,0.0002,172.31.33.0-255,66,261,21,459
6123,0.002199,172.217.194.0-255,66,327,21,459
6124,0.002224,172.217.194.0-255,66,393,21,459
6125,0.002244,172.31.33.0-255,66,459,21,459
6126,0.0,172.31.33.0-255,105,105,21,459
6127,0.000163,172.31.33.0-255,90,195,21,459
6128,0.000171,172.31.33.0-255,66,261,21,459
6129,0.002158,172.217.194.0-255,66,327,21,459
6130,0.00217,172.217.194.0-255,66,393,21,459
6131,0.00218,172.31.33.0-255,66,459,21,459
6132,0.0,172.31.33.0-255,105,105,21,459
6133,0.000208,172.31.33.0-255,90,195,21,459
6134,0.000216,172.31.33.0-255,66,261,21,459
6135,0.002822,172.217.194.0-255,66,327,21,459
6136,0.002846,172.217.194.0-255,66,393,21,459
6137,0.002864,172.31.33.0-255,66,459,21,459
6138,0.0,172.31.33.0-255,105,105,21,2361
6139,3.3e-05,172.31.33.0-255,105,210,21,2361
6140,8.2e-05,172.31.33.0-255,105,315,21,2361
6141,0.000109,172.31.33.0-255,105,420,21,2361
6142,0.000156,172.31.33.0-255,105,525,21,2361
6143,0.000362,172.31.33.0-255,90,615,21,2361
6144,0.00037,172.31.33.0-255,66,681,21,2361
6145,0.000627,172.31.33.0-255,90,771,21,2361
6146,0.000634,172.31.33.0-255,66,837,21,2361
6147,0.000764,172.31.33.0-255,90,927,21,2361
6148,0.00077,172.31.33.0-255,66,993,21,2361
6149,0.001073,172.31.33.0-255,90,1083,21,2361
6150,0.00108,172.31.33.0-255,66,1149,21,2361
6151,0.001264,172.31.33.0-255,90,1239,21,2361
6152,0.00127,172.31.33.0-255,66,1305,21,2361
6153,0.002661,74.125.68.0-255,66,1371,21,2361
6154,0.002675,74.125.68.0-255,66,1437,21,2361
6155,0.002685,172.31.33.0-255,66,1503,21,2361
6156,0.002974,172.217.194.0-255,66,1569,21,2361
6157,0.002985,172.217.194.0-255,66,1635,21,2361
6158,0.002987,172.31.33.0-255,66,1701,21,2361
6159,0.003288,74.125.68.0-255,66,1767,21,2361
6160,0.003301,74.125.68.0-255,66,1833,21,2361
6161,0.003303,172.31.33.0-255,66,1899,21,2361
6162,0.003433,74.125.24.0-255,66,1965,21,2361
6163,0.003443,74.125.24.0-255,66,2031,21,2361
6164,0.003445,172.31.33.0-255,66,2097,21,2361
6165,0.003784,74.125.24.0-255,66,2163,21,2361
6166,0.003797,74.125.24.0-255,66,2229,21,2361
6167,0.003799,172.31.33.0-255,66,2295,21,2361
6168,0.00382,74.125.24.0-255,66,2361,21,2361
6169,0.0,172.31.33.0-255,66,66,21,66
6170,0.0,172.31.33.0-255,105,105,21,459
6171,0.00019,172.31.33.0-255,90,195,21,459
6172,0.0002,172.31.33.0-255,66,261,21,459
6173,0.002489,172.217.194.0-255,66,327,21,459
6174,0.002499,172.217.194.0-255,66,393,21,459
6175,0.002508,172.31.33.0-255,66,459,21,459
6176,0.0,172.31.33.0-255,66,66,21,66
6177,0.0,74.125.24.0-255,152,152,21,119758
6178,1.4e-05,172.31.33.0-255,66,218,21,119758
6179,2.1e-05,74.125.24.0-255,1484,1702,21,119758
6180,2.5e-05,172.31.33.0-255,66,1768,21,119758
6181,3.1e-05,74.125.24.0-255,2902,4670,21,119758
6182,4.2e-05,172.31.33.0-255,66,4736,21,119758
6183,4.6e-05,74.125.24.0-255,1484,6220,21,119758
6184,4.8e-05,172.31.33.0-255,66,6286,21,119758
6185,8.7e-05,74.125.24.0-255,5738,12024,21,119758
6186,9e-05,172.31.33.0-255,66,12090,21,119758
6187,9.8e-05,74.125.24.0-255,4828,16918,21,119758
6188,0.0001,172.31.33.0-255,66,16984,21,119758
6189,0.000116,172.31.33.0-255,66,17050,21,119758
6190,0.000166,74.125.24.0-255,1484,18534,21,119758
6191,0.000169,172.31.33.0-255,66,18600,21,119758
6192,0.000174,74.125.24.0-255,2902,21502,21,119758
6193,0.000176,172.31.33.0-255,66,21568,21,119758
6194,0.000181,74.125.24.0-255,2902,24470,21,119758
6195,0.000187,172.31.33.0-255,66,24536,21,119758
6196,0.00022,74.125.24.0-255,2902,27438,21,119758
6197,0.000222,172.31.33.0-255,66,27504,21,119758
6198,0.000229,74.125.24.0-255,6797,34301,21,119758
6199,0.000232,172.31.33.0-255,66,34367,21,119758
6200,0.000274,74.125.24.0-255,7156,41523,21,119758
6201,0.000276,172.31.33.0-255,66,41589,21,119758
6202,0.000305,74.125.24.0-255,7156,48745,21,119758
6203,0.000308,172.31.33.0-255,66,48811,21,119758
6204,0.000312,74.125.24.0-255,2823,51634,21,119758
6205,0.000314,172.31.33.0-255,66,51700,21,119758
6206,0.000903,74.125.24.0-255,132,51832,21,119758
6207,0.000909,172.31.33.0-255,66,51898,21,119758
6208,0.000944,74.125.24.0-255,1484,53382,21,119758
6209,0.000968,74.125.24.0-255,2902,56284,21,119758
6210,0.000972,172.31.33.0-255,66,56350,21,119758
6211,0.000977,74.125.24.0-255,2902,59252,21,119758
6212,0.000979,172.31.33.0-255,66,59318,21,119758
6213,0.001016,74.125.24.0-255,2902,62220,21,119758
6214,0.001019,172.31.33.0-255,66,62286,21,119758
6215,0.001033,172.31.33.0-255,66,62352,21,119758
6216,0.001044,172.31.33.0-255,66,62418,21,119758
6217,0.001377,74.125.24.0-255,1484,63902,21,119758
6218,0.001398,74.125.24.0-255,2902,66804,21,119758
6219,0.001402,172.31.33.0-255,66,66870,21,119758
6220,0.00141,74.125.24.0-255,5738,72608,21,119758
6221,0.001411,172.31.33.0-255,66,72674,21,119758
6222,0.001422,74.125.24.0-255,4320,76994,21,119758
6223,0.001424,172.31.33.0-255,66,77060,21,119758
6224,0.001461,172.31.33.0-255,66,77126,21,119758
6225,0.001472,172.31.33.0-255,66,77192,21,119758
6226,0.001508,74.125.24.0-255,5020,82212,21,119758
6227,0.001511,172.31.33.0-255,66,82278,21,119758
6228,0.001524,172.31.33.0-255,66,82344,21,119758
6229,0.001534,172.31.33.0-255,66,82410,21,119758
6230,0.001576,172.31.33.0-255,66,82476,21,119758
6231,0.001579,74.125.24.0-255,1484,83960,21,119758
6232,0.001584,74.125.24.0-255,2902,86862,21,119758
6233,0.001586,172.31.33.0-255,66,86928,21,119758
6234,0.00159,74.125.24.0-255,2902,89830,21,119758
6235,0.001592,172.31.33.0-255,66,89896,21,119758
6236,0.001623,74.125.24.0-255,2902,92798,21,119758
6237,0.00164,172.31.33.0-255,66,92864,21,119758
6238,0.001647,172.31.33.0-255,66,92930,21,119758
6239,0.00165,74.125.24.0-255,1484,94414,21,119758
6240,0.001682,172.31.33.0-255,66,94480,21,119758
6241,0.001693,172.31.33.0-255,66,94546,21,119758
6242,0.001719,74.125.24.0-255,2902,97448,21,119758
6243,0.001722,172.31.33.0-255,66,97514,21,119758
6244,0.001818,74.125.24.0-255,1484,98998,21,119758
6245,0.001824,172.31.33.0-255,66,99064,21,119758
6246,0.001827,172.31.33.0-255,66,99130,21,119758
6247,0.001883,172.31.33.0-255,66,99196,21,119758
6248,0.001905,172.31.33.0-255,66,99262,21,119758
6249,0.001912,74.125.24.0-255,5020,104282,21,119758
6250,0.001915,172.31.33.0-255,66,104348,21,119758
6251,0.001974,172.31.33.0-255,66,104414,21,119758
6252,0.001991,74.125.24.0-255,2902,107316,21,119758
6253,0.001994,172.31.33.0-255,66,107382,21,119758
6254,0.002025,172.31.33.0-255,66,107448,21,119758
6255,0.002043,172.31.33.0-255,66,107514,21,119758
6256,0.002082,74.125.24.0-255,6438,113952,21,119758
6257,0.002085,172.31.33.0-255,66,114018,21,119758
6258,0.002103,172.31.33.0-255,66,114084,21,119758
6259,0.002113,172.31.33.0-255,66,114150,21,119758
6260,0.002115,74.125.24.0-255,105,114255,21,119758
6261,0.008097,172.31.33.0-255,66,114321,21,119758
6262,0.00813,172.31.33.0-255,105,114426,21,119758
6263,0.010473,74.125.24.0-255,66,114492,21,119758
6264,0.028187,172.31.33.0-255,172,114664,21,119758
6265,0.028216,172.31.33.0-255,1109,115773,21,119758
6266,0.028271,172.31.33.0-255,1514,117287,21,119758
6267,0.028272,172.31.33.0-255,1514,118801,21,119758
6268,0.028273,172.31.33.0-255,693,119494,21,119758
6269,0.029747,104.244.42.0-255,66,119560,21,119758
6270,0.029757,104.244.42.0-255,66,119626,21,119758
6271,0.029829,104.244.42.0-255,66,119692,21,119758
6272,0.029833,104.244.42.0-255,66,119758,21,119758
6273,0.0,172.31.33.0-255,105,105,21,459
6274,0.000166,172.31.33.0-255,90,195,21,459
6275,0.000175,172.31.33.0-255,66,261,21,459
6276,0.00221,172.217.194.0-255,66,327,21,459
6277,0.002227,172.217.194.0-255,66,393,21,459
6278,0.002239,172.31.33.0-255,66,459,21,459
6279,0.0,74.125.200.0-255,955,955,21,131042
6280,1.9e-05,74.125.200.0-255,1484,2439,21,131042
6281,2.6e-05,172.31.33.0-255,66,2505,21,131042
6282,3.3e-05,74.125.200.0-255,4320,6825,21,131042
6283,3.5e-05,172.31.33.0-255,66,6891,21,131042
6284,0.000169,74.125.200.0-255,1484,8375,21,131042
6285,0.000229,74.125.200.0-255,1484,9859,21,131042
6286,0.000232,172.31.33.0-255,66,9925,21,131042
6287,0.000261,74.125.200.0-255,3088,13013,21,131042
6288,0.000265,172.31.33.0-255,66,13079,21,131042
6289,0.000398,74.125.200.0-255,2902,15981,21,131042
6290,0.000402,172.31.33.0-255,66,16047,21,131042
6291,0.00043,74.125.200.0-255,5738,21785,21,131042
6292,0.000433,172.31.33.0-255,66,21851,21,131042
6293,0.000724,74.125.200.0-255,4320,26171,21,131042
6294,0.000731,172.31.33.0-255,66,26237,21,131042
6295,0.000759,74.125.200.0-255,3961,30198,21,131042
6296,0.000762,172.31.33.0-255,66,30264,21,131042
6297,0.002157,74.125.200.0-255,5738,36002,21,131042
6298,0.002166,172.31.33.0-255,66,36068,21,131042
6299,0.002352,74.125.200.0-255,4320,40388,21,131042
6300,0.002745,74.125.200.0-255,2902,43290,21,131042
6301,0.00279,74.125.200.0-255,7156,50446,21,131042
6302,0.003436,74.125.200.0-255,2902,53348,21,131042
6303,0.003447,74.125.200.0-255,2902,56250,21,131042
6304,0.003474,74.125.200.0-255,4320,60570,21,131042
6305,0.00403,74.125.200.0-255,4320,64890,21,131042
6306,0.004064,74.125.200.0-255,2902,67792,21,131042
6307,0.004278,74.125.200.0-255,1484,69276,21,131042
6308,0.005802,172.31.33.0-255,66,69342,21,131042
6309,0.006262,172.31.33.0-255,66,69408,21,131042
6310,0.007941,74.125.200.0-255,5738,75146,21,131042
6311,0.007945,172.31.33.0-255,66,75212,21,131042
6312,0.008076,74.125.200.0-255,2902,78114,21,131042
6313,0.008117,74.125.200.0-255,5738,83852,21,131042
6314,0.008127,74.125.200.0-255,1484,85336,21,131042
6315,0.008424,74.125.200.0-255,3134,88470,21,131042
6316,0.008477,74.125.200.0-255,4320,92790,21,131042
6317,0.008515,74.125.200.0-255,2670,95460,21,131042
6318,0.009225,172.31.33.0-255,66,95526,21,131042
6319,0.009256,74.125.200.0-255,4320,99846,21,131042
6320,0.009261,172.31.33.0-255,66,99912,21,131042
6321,0.009308,172.31.33.0-255,66,99978,21,131042
6322,0.011369,172.31.33.0-255,66,100044,21,131042
6323,0.011404,172.31.33.0-255,66,100110,21,131042
6324,0.011516,74.125.200.0-255,1484,101594,21,131042
6325,0.011531,74.125.200.0-255,7156,108750,21,131042
6326,0.011533,172.31.33.0-255,66,108816,21,131042
6327,0.011562,172.31.33.0-255,66,108882,21,131042
6328,0.011605,172.31.33.0-255,66,108948,21,131042
6329,0.01167,172.31.33.0-255,66,109014,21,131042
6330,0.011703,172.31.33.0-255,66,109080,21,131042
6331,0.012316,74.125.200.0-255,5738,114818,21,131042
6332,0.01232,172.31.33.0-255,66,114884,21,131042
6333,0.01237,172.31.33.0-255,66,114950,21,131042
6334,0.012407,172.31.33.0-255,66,115016,21,131042
6335,0.01243,74.125.200.0-255,2902,117918,21,131042
6336,0.012433,172.31.33.0-255,66,117984,21,131042
6337,0.012929,74.125.200.0-255,2902,120886,21,131042
6338,0.012933,172.31.33.0-255,66,120952,21,131042
6339,0.012972,172.31.33.0-255,66,121018,21,131042
6340,0.013534,172.31.33.0-255,66,121084,21,131042
6341,0.013581,172.31.33.0-255,66,121150,21,131042
6342,0.013675,74.125.200.0-255,4320,125470,21,131042
6343,0.013679,172.31.33.0-255,66,125536,21,131042
6344,0.013706,172.31.33.0-255,66,125602,21,131042
6345,0.015758,172.31.33.0-255,105,125707,21,131042
6346,0.017856,74.125.200.0-255,66,125773,21,131042
6347,0.032491,172.31.33.0-255,175,125948,21,131042
6348,0.032517,172.31.33.0-255,1138,127086,21,131042
6349,0.032565,172.31.33.0-255,1514,128600,21,131042
6350,0.032567,172.31.33.0-255,1514,130114,21,131042
6351,0.032568,172.31.33.0-255,664,130778,21,131042
6352,0.034136,104.244.42.0-255,66,130844,21,131042
6353,0.034184,104.244.42.0-255,66,130910,21,131042
6354,0.034288,104.244.42.0-255,66,130976,21,131042
6355,0.034292,104.244.42.0-255,66,131042,21,131042
6356,0.0,172.217.27.0-255,152,152,21,333425
6357,2.7e-05,172.31.33.0-255,66,218,21,333425
6358,3.4e-05,172.217.27.0-255,1484,1702,21,333425
6359,3.9e-05,172.31.33.0-255,66,1768,21,333425
6360,4.4e-05,172.217.27.0-255,2902,4670,21,333425
6361,5.6e-05,172.31.33.0-255,66,4736,21,333425
6362,6.4e-05,172.217.27.0-255,7156,11892,21,333425
6363,6.8e-05,172.31.33.0-255,66,11958,21,333425
6364,7.1e-05,172.217.27.0-255,2013,13971,21,333425
6365,7.5e-05,172.31.33.0-255,66,14037,21,333425
6366,0.000117,172.217.27.0-255,1484,15521,21,333425
6367,0.000119,172.31.33.0-255,66,15587,21,333425
6368,0.000125,172.217.27.0-255,2902,18489,21,333425
6369,0.000127,172.31.33.0-255,66,18555,21,333425
6370,0.000157,172.217.27.0-255,5738,24293,21,333425
6371,0.000161,172.31.33.0-255,66,24359,21,333425
6372,0.000168,172.217.27.0-255,6797,31156,21,333425
6373,0.000171,172.31.33.0-255,66,31222,21,333425
6374,0.000196,172.217.27.0-255,1484,32706,21,333425
6375,0.000199,172.31.33.0-255,66,32772,21,333425
6376,0.000223,172.217.27.0-255,5738,38510,21,333425
6377,0.000226,172.31.33.0-255,66,38576,21,333425
6378,0.000237,172.31.33.0-255,66,38642,21,333425
6379,0.000267,172.217.27.0-255,1125,39767,21,333425
6380,0.00027,172.31.33.0-255,66,39833,21,333425
6381,0.000313,172.217.27.0-255,1484,41317,21,333425
6382,0.000316,172.31.33.0-255,66,41383,21,333425
6383,0.000348,172.217.27.0-255,2902,44285,21,333425
6384,0.00035,172.31.33.0-255,66,44351,21,333425
6385,0.000357,172.217.27.0-255,5738,50089,21,333425
6386,0.00036,172.31.33.0-255,66,50155,21,333425
6387,0.000372,172.217.27.0-255,5738,55893,21,333425
6388,0.000374,172.31.33.0-255,66,55959,21,333425
6389,0.000377,172.217.27.0-255,1125,57084,21,333425
6390,0.000442,172.217.27.0-255,395,57479,21,333425
6391,0.001104,172.217.27.0-255,349,57828,21,333425
6392,0.00111,172.31.33.0-255,66,57894,21,333425
6393,0.001244,172.217.27.0-255,1484,59378,21,333425
6394,0.001251,172.217.27.0-255,2902,62280,21,333425
6395,0.001254,172.31.33.0-255,66,62346,21,333425
6396,0.001261,172.217.27.0-255,4320,66666,21,333425
6397,0.001263,172.31.33.0-255,66,66732,21,333425
6398,0.001284,172.217.27.0-255,1484,68216,21,333425
6399,0.001294,172.217.27.0-255,4320,72536,21,333425
6400,0.001296,172.31.33.0-255,66,72602,21,333425
6401,0.001337,172.31.33.0-255,66,72668,21,333425
6402,0.001348,172.31.33.0-255,66,72734,21,333425
6403,0.001555,172.217.27.0-255,1484,74218,21,333425
6404,0.001562,172.217.27.0-255,2902,77120,21,333425
6405,0.001565,172.31.33.0-255,66,77186,21,333425
6406,0.001572,172.217.27.0-255,4320,81506,21,333425
6407,0.001574,172.31.33.0-255,66,81572,21,333425
6408,0.001602,172.217.27.0-255,1484,83056,21,333425
6409,0.001615,172.31.33.0-255,66,83122,21,333425
6410,0.001642,172.217.27.0-255,2902,86024,21,333425
6411,0.001645,172.31.33.0-255,66,86090,21,333425
6412,0.001653,172.217.27.0-255,7156,93246,21,333425
6413,0.001655,172.31.33.0-255,66,93312,21,333425
6414,0.001665,172.217.27.0-255,3602,96914,21,333425
6415,0.001668,172.31.33.0-255,66,96980,21,333425
6416,0.003297,172.217.27.0-255,5738,102718,21,333425
6417,0.003305,172.31.33.0-255,66,102784,21,333425
6418,0.004956,172.217.27.0-255,5738,108522,21,333425
6419,0.004962,172.31.33.0-255,66,108588,21,333425
6420,0.006613,172.217.27.0-255,5738,114326,21,333425
6421,0.00662,172.31.33.0-255,66,114392,21,333425
6422,0.00827,172.217.27.0-255,5738,120130,21,333425
6423,0.008278,172.31.33.0-255,66,120196,21,333425
6424,0.009921,172.217.27.0-255,5738,125934,21,333425
6425,0.009932,172.31.33.0-255,66,126000,21,333425
6426,0.011573,172.217.27.0-255,5738,131738,21,333425
6427,0.011582,172.31.33.0-255,66,131804,21,333425
6428,0.013229,172.217.27.0-255,5738,137542,21,333425
6429,0.013239,172.31.33.0-255,66,137608,21,333425
6430,0.014886,172.217.27.0-255,5738,143346,21,333425
6431,0.014899,172.31.33.0-255,66,143412,21,333425
6432,0.016586,172.217.27.0-255,5738,149150,21,333425
6433,0.016605,172.31.33.0-255,66,149216,21,333425
6434,0.018255,172.217.27.0-255,5738,154954,21,333425
6435,0.018264,172.31.33.0-255,66,155020,21,333425
6436,0.019911,172.217.27.0-255,5738,160758,21,333425
6437,0.019917,172.31.33.0-255,66,160824,21,333425
6438,0.021569,172.217.27.0-255,5738,166562,21,333425
6439,0.021577,172.31.33.0-255,66,166628,21,333425
6440,0.023228,172.217.27.0-255,5738,172366,21,333425
6441,0.023236,172.31.33.0-255,66,172432,21,333425
6442,0.024892,172.217.27.0-255,5738,178170,21,333425
6443,0.024901,172.31.33.0-255,66,178236,21,333425
6444,0.026553,172.217.27.0-255,5738,183974,21,333425
6445,0.026567,172.31.33.0-255,66,184040,21,333425
6446,0.028215,172.217.27.0-255,5738,189778,21,333425
6447,0.028224,172.31.33.0-255,66,189844,21,333425
6448,0.029867,172.217.27.0-255,5738,195582,21,333425
6449,0.029878,172.31.33.0-255,66,195648,21,333425
6450,0.030127,172.31.33.0-255,172,195820,21,333425
6451,0.030158,172.31.33.0-255,1113,196933,21,333425
6452,0.030221,172.31.33.0-255,1514,198447,21,333425
6453,0.030223,172.31.33.0-255,1288,199735,21,333425
6454,0.031593,172.217.27.0-255,5738,205473,21,333425
6455,0.031603,172.31.33.0-255,66,205539,21,333425
6456,0.031695,104.244.42.0-255,66,205605,21,333425
6457,0.031766,104.244.42.0-255,66,205671,21,333425
6458,0.031796,104.244.42.0-255,66,205737,21,333425
6459,0.033254,172.217.27.0-255,5738,211475,21,333425
6460,0.033263,172.31.33.0-255,66,211541,21,333425
6461,0.034928,172.217.27.0-255,5738,217279,21,333425
6462,0.034938,172.31.33.0-255,66,217345,21,333425
6463,0.036617,172.217.27.0-255,5738,223083,21,333425
6464,0.036636,172.31.33.0-255,66,223149,21,333425
6465,0.038295,172.217.27.0-255,5738,228887,21,333425
6466,0.038315,172.31.33.0-255,66,228953,21,333425
6467,0.039981,172.217.27.0-255,5738,234691,21,333425
6468,0.039999,172.31.33.0-255,66,234757,21,333425
6469,0.04165,172.217.27.0-255,5738,240495,21,333425
6470,0.041668,172.31.33.0-255,66,240561,21,333425
6471,0.043376,172.217.27.0-255,5738,246299,21,333425
6472,0.043393,172.31.33.0-255,66,246365,21,333425
6473,0.045089,172.217.27.0-255,5738,252103,21,333425
6474,0.045106,172.31.33.0-255,66,252169,21,333425
6475,0.046783,172.217.27.0-255,5738,257907,21,333425
6476,0.046799,172.31.33.0-255,66,257973,21,333425
6477,0.048478,172.217.27.0-255,5738,263711,21,333425
6478,0.048496,172.31.33.0-255,66,263777,21,333425
6479,0.050165,172.217.27.0-255,5738,269515,21,333425
6480,0.050182,172.31.33.0-255,66,269581,21,333425
6481,0.051841,172.217.27.0-255,5738,275319,21,333425
6482,0.05185,172.31.33.0-255,66,275385,21,333425
6483,0.053527,172.217.27.0-255,5738,281123,21,333425
6484,0.053534,172.31.33.0-255,66,281189,21,333425
6485,0.05518,172.217.27.0-255,5738,286927,21,333425
6486,0.055187,172.31.33.0-255,66,286993,21,333425
6487,0.056839,172.217.27.0-255,5738,292731,21,333425
6488,0.056846,172.31.33.0-255,66,292797,21,333425
6489,0.058492,172.217.27.0-255,5738,298535,21,333425
6490,0.058499,172.31.33.0-255,66,298601,21,333425
6491,0.060166,172.217.27.0-255,5738,304339,21,333425
6492,0.060173,172.31.33.0-255,66,304405,21,333425
6493,0.061823,172.217.27.0-255,5738,310143,21,333425
6494,0.06183,172.31.33.0-255,66,310209,21,333425
6495,0.063487,172.217.27.0-255,5738,315947,21,333425
6496,0.063497,172.31.33.0-255,66,316013,21,333425
6497,0.065149,172.217.27.0-255,5738,321751,21,333425
6498,0.065159,172.31.33.0-255,66,321817,21,333425
6499,0.066816,172.217.27.0-255,5738,327555,21,333425
6500,0.066834,172.31.33.0-255,66,327621,21,333425
6501,0.06849,172.217.27.0-255,5738,333359,21,333425
6502,0.068505,172.31.33.0-255,66,333425,21,333425
6503,0.0,172.31.33.0-255,105,105,21,1377
6504,6.2e-05,172.31.33.0-255,105,210,21,1377
6505,0.000101,172.31.33.0-255,105,315,21,1377
6506,0.000359,172.31.33.0-255,90,405,21,1377
6507,0.00037,172.31.33.0-255,66,471,21,1377
6508,0.000557,172.31.33.0-255,90,561,21,1377
6509,0.000566,172.31.33.0-255,66,627,21,1377
6510,0.000712,172.31.33.0-255,90,717,21,1377
6511,0.000719,172.31.33.0-255,66,783,21,1377
6512,0.002722,74.125.24.0-255,66,849,21,1377
6513,0.002735,74.125.24.0-255,66,915,21,1377
6514,0.002741,172.31.33.0-255,66,981,21,1377
6515,0.002815,74.125.24.0-255,66,1047,21,1377
6516,0.002831,74.125.24.0-255,66,1113,21,1377
6517,0.002846,172.31.33.0-255,66,1179,21,1377
6518,0.002923,74.125.200.0-255,66,1245,21,1377
6519,0.002943,74.125.200.0-255,66,1311,21,1377
6520,0.002957,172.31.33.0-255,66,1377,21,1377
6521,0.0,74.125.24.0-255,146,146,21,234107
6522,2.1e-05,172.31.33.0-255,66,212,21,234107
6523,2.9e-05,74.125.24.0-255,1484,1696,21,234107
6524,3.3e-05,172.31.33.0-255,66,1762,21,234107
6525,3.9e-05,74.125.24.0-255,2902,4664,21,234107
6526,4.4e-05,172.31.33.0-255,66,4730,21,234107
6527,5.2e-05,74.125.24.0-255,7156,11886,21,234107
6528,5.5e-05,172.31.33.0-255,66,11952,21,234107
6529,5.9e-05,74.125.24.0-255,2091,14043,21,234107
6530,6.2e-05,172.31.33.0-255,66,14109,21,234107
6531,8.6e-05,74.125.24.0-255,5738,19847,21,234107
6532,8.9e-05,172.31.33.0-255,66,19913,21,234107
6533,0.000113,74.125.24.0-255,5738,25651,21,234107
6534,0.000117,172.31.33.0-255,66,25717,21,234107
6535,0.000123,74.125.24.0-255,5379,31096,21,234107
6536,0.000125,172.31.33.0-255,66,31162,21,234107
6537,0.000245,74.125.24.0-255,1484,32646,21,234107
6538,0.00025,172.31.33.0-255,66,32712,21,234107
6539,0.000268,74.125.24.0-255,2902,35614,21,234107
6540,0.000271,172.31.33.0-255,66,35680,21,234107
6541,0.000278,74.125.24.0-255,5738,41418,21,234107
6542,0.000281,172.31.33.0-255,66,41484,21,234107
6543,0.000317,172.31.33.0-255,66,41550,21,234107
6544,0.000336,74.125.24.0-255,5379,46929,21,234107
6545,0.000339,172.31.33.0-255,66,46995,21,234107
6546,0.00035,172.31.33.0-255,66,47061,21,234107
6547,0.000352,74.125.24.0-255,1399,48460,21,234107
6548,0.000354,172.31.33.0-255,66,48526,21,234107
6549,0.000622,74.125.24.0-255,383,48909,21,234107
6550,0.000627,172.31.33.0-255,66,48975,21,234107
6551,0.000646,74.125.24.0-255,1484,50459,21,234107
6552,0.000657,74.125.24.0-255,1484,51943,21,234107
6553,0.000667,74.125.24.0-255,1484,53427,21,234107
6554,0.000679,74.125.24.0-255,1484,54911,21,234107
6555,0.000685,172.31.33.0-255,66,54977,21,234107
6556,0.0007,74.125.24.0-255,4320,59297,21,234107
6557,0.000716,74.125.24.0-255,6797,66094,21,234107
6558,0.000723,172.31.33.0-255,66,66160,21,234107
6559,0.000754,74.125.24.0-255,2902,69062,21,234107
6560,0.000759,172.31.33.0-255,66,69128,21,234107
6561,0.000775,74.125.24.0-255,4320,73448,21,234107
6562,0.000786,172.31.33.0-255,66,73514,21,234107
6563,0.000793,74.125.24.0-255,7156,80670,21,234107
6564,0.000797,172.31.33.0-255,66,80736,21,234107
6565,0.000805,74.125.24.0-255,1484,82220,21,234107
6566,0.000815,74.125.24.0-255,1125,83345,21,234107
6567,0.000829,172.31.33.0-255,66,83411,21,234107
6568,0.001089,74.125.24.0-255,1484,84895,21,234107
6569,0.001104,74.125.24.0-255,2902,87797,21,234107
6570,0.001107,172.31.33.0-255,66,87863,21,234107
6571,0.001112,74.125.24.0-255,2902,90765,21,234107
6572,0.001119,172.31.33.0-255,66,90831,21,234107
6573,0.00113,74.125.24.0-255,2902,93733,21,234107
6574,0.001132,74.125.24.0-255,1484,95217,21,234107
6575,0.001162,172.31.33.0-255,66,95283,21,234107
6576,0.001176,74.125.24.0-255,4320,99603,21,234107
6577,0.001184,172.31.33.0-255,66,99669,21,234107
6578,0.001195,74.125.24.0-255,6438,106107,21,234107
6579,0.001216,172.31.33.0-255,66,106173,21,234107
6580,0.001372,74.125.24.0-255,1484,107657,21,234107
6581,0.001377,74.125.24.0-255,2902,110559,21,234107
6582,0.001379,172.31.33.0-255,66,110625,21,234107
6583,0.001402,74.125.24.0-255,5738,116363,21,234107
6584,0.001406,172.31.33.0-255,66,116429,21,234107
6585,0.001416,74.125.24.0-255,4320,120749,21,234107
6586,0.001436,74.125.24.0-255,1484,122233,21,234107
6587,0.001441,172.31.33.0-255,66,122299,21,234107
6588,0.001462,74.125.24.0-255,5738,128037,21,234107
6589,0.001481,74.125.24.0-255,3602,131639,21,234107
6590,0.001485,172.31.33.0-255,66,131705,21,234107
6591,0.00149,172.31.33.0-255,66,131771,21,234107
6592,0.001525,74.125.24.0-255,4320,136091,21,234107
6593,0.001528,74.125.24.0-255,1484,137575,21,234107
6594,0.001535,172.31.33.0-255,66,137641,21,234107
6595,0.001544,74.125.24.0-255,4320,141961,21,234107
6596,0.001548,74.125.24.0-255,4320,146281,21,234107
6597,0.001558,74.125.24.0-255,2902,149183,21,234107
6598,0.00156,172.31.33.0-255,66,149249,21,234107
6599,0.001574,74.125.24.0-255,4320,153569,21,234107
6600,0.001591,172.31.33.0-255,66,153635,21,234107
6601,0.001607,74.125.24.0-255,3602,157237,21,234107
6602,0.001621,172.31.33.0-255,66,157303,21,234107
6603,0.001638,74.125.24.0-255,1484,158787,21,234107
6604,0.001654,74.125.24.0-255,2902,161689,21,234107
6605,0.001666,172.31.33.0-255,66,161755,21,234107
6606,0.00168,74.125.24.0-255,5738,167493,21,234107
6607,0.001685,74.125.24.0-255,5738,173231,21,234107
6608,0.001695,172.31.33.0-255,66,173297,21,234107
6609,0.001714,172.31.33.0-255,66,173363,21,234107
6610,0.001738,74.125.24.0-255,5020,178383,21,234107
6611,0.001748,172.31.33.0-255,66,178449,21,234107
6612,0.001842,74.125.24.0-255,1484,179933,21,234107
6613,0.001845,74.125.24.0-255,1484,181417,21,234107
6614,0.001856,172.31.33.0-255,66,181483,21,234107
6615,0.001859,74.125.24.0-255,1484,182967,21,234107
6616,0.001881,74.125.24.0-255,5738,188705,21,234107
6617,0.001949,172.31.33.0-255,66,188771,21,234107
6618,0.001962,74.125.24.0-255,2184,190955,21,234107
6619,0.001979,172.31.33.0-255,66,191021,21,234107
6620,0.001986,74.125.24.0-255,1484,192505,21,234107
6621,0.001997,74.125.24.0-255,2902,195407,21,234107
6622,0.002001,74.125.24.0-255,2902,198309,21,234107
6623,0.002013,74.125.24.0-255,2902,201211,21,234107
6624,0.002016,74.125.24.0-255,1484,202695,21,234107
6625,0.002025,172.31.33.0-255,66,202761,21,234107
6626,0.002043,172.31.33.0-255,66,202827,21,234107
6627,0.002058,74.125.24.0-255,2902,205729,21,234107
6628,0.002064,74.125.24.0-255,7156,212885,21,234107
6629,0.002067,74.125.24.0-255,1484,214369,21,234107
6630,0.002075,172.31.33.0-255,66,214435,21,234107
6631,0.002094,172.31.33.0-255,66,214501,21,234107
6632,0.00211,74.125.24.0-255,2902,217403,21,234107
6633,0.002123,74.125.24.0-255,4320,221723,21,234107
6634,0.002131,172.31.33.0-255,66,221789,21,234107
6635,0.002143,74.125.24.0-255,4320,226109,21,234107
6636,0.002155,172.31.33.0-255,66,226175,21,234107
6637,0.002175,172.31.33.0-255,66,226241,21,234107
6638,0.002208,74.125.24.0-255,2184,228425,21,234107
6639,0.002238,172.31.33.0-255,66,228491,21,234107
6640,0.002296,74.125.24.0-255,105,228596,21,234107
6641,0.002308,172.31.33.0-255,66,228662,21,234107
6642,0.015214,172.31.33.0-255,105,228767,21,234107
6643,0.017453,74.125.24.0-255,66,228833,21,234107
6644,0.044126,172.31.33.0-255,172,229005,21,234107
6645,0.044155,172.31.33.0-255,1113,230118,21,234107
6646,0.044211,172.31.33.0-255,1514,231632,21,234107
6647,0.044213,172.31.33.0-255,1514,233146,21,234107
6648,0.044234,172.31.33.0-255,697,233843,21,234107
6649,0.045709,104.244.42.0-255,66,233909,21,234107
6650,0.045748,104.244.42.0-255,66,233975,21,234107
6651,0.045791,104.244.42.0-255,66,234041,21,234107
6652,0.045811,104.244.42.0-255,66,234107,21,234107
6653,0.0,172.31.33.0-255,105,105,21,459
6654,0.000188,172.31.33.0-255,90,195,21,459
6655,0.000198,172.31.33.0-255,66,261,21,459
6656,0.002483,74.125.130.0-255,66,327,21,459
6657,0.002511,74.125.130.0-255,66,393,21,459
6658,0.00253,172.31.33.0-255,66,459,21,459
6659,0.0,172.31.33.0-255,105,105,21,459
6660,0.000167,172.31.33.0-255,90,195,21,459
6661,0.000175,172.31.33.0-255,66,261,21,459
6662,0.002413,74.125.24.0-255,66,327,21,459
6663,0.002424,74.125.24.0-255,66,393,21,459
6664,0.002434,172.31.33.0-255,66,459,21,459
6665,0.0,172.31.33.0-255,105,105,21,459
6666,0.000162,172.31.33.0-255,90,195,21,459
6667,0.00017,172.31.33.0-255,66,261,21,459
6668,0.002441,172.217.194.0-255,66,327,21,459
6669,0.002455,172.217.194.0-255,66,393,21,459
6670,0.002465,172.31.33.0-255,66,459,21,459
6671,0.0,172.217.194.0-255,152,152,21,279618
6672,2e-05,172.31.33.0-255,66,218,21,279618
6673,2.7e-05,172.217.194.0-255,1484,1702,21,279618
6674,3.1e-05,172.31.33.0-255,66,1768,21,279618
6675,3.7e-05,172.217.194.0-255,2902,4670,21,279618
6676,4e-05,172.31.33.0-255,66,4736,21,279618
6677,6.2e-05,172.217.194.0-255,7156,11892,21,279618
6678,6.5e-05,172.31.33.0-255,66,11958,21,279618
6679,9.6e-05,172.217.194.0-255,2053,14011,21,279618
6680,9.9e-05,172.31.33.0-255,66,14077,21,279618
6681,0.000129,172.217.194.0-255,2902,16979,21,279618
6682,0.000132,172.31.33.0-255,66,17045,21,279618
6683,0.000135,172.217.194.0-255,1484,18529,21,279618
6684,0.000137,172.31.33.0-255,66,18595,21,279618
6685,0.000152,172.217.194.0-255,2902,21497,21,279618
6686,0.000156,172.31.33.0-255,66,21563,21,279618
6687,0.000161,172.217.194.0-255,4320,25883,21,279618
6688,0.000163,172.31.33.0-255,66,25949,21,279618
6689,0.000188,172.217.194.0-255,4320,30269,21,279618
6690,0.000191,172.31.33.0-255,66,30335,21,279618
6691,0.000196,172.217.194.0-255,1125,31460,21,279618
6692,0.000198,172.31.33.0-255,66,31526,21,279618
6693,0.000303,172.217.194.0-255,1484,33010,21,279618
6694,0.000307,172.31.33.0-255,66,33076,21,279618
6695,0.000311,172.217.194.0-255,1484,34560,21,279618
6696,0.000316,172.31.33.0-255,66,34626,21,279618
6697,0.000325,172.217.194.0-255,1484,36110,21,279618
6698,0.000327,172.31.33.0-255,66,36176,21,279618
6699,0.000343,172.217.194.0-255,5738,41914,21,279618
6700,0.000347,172.31.33.0-255,66,41980,21,279618
6701,0.000353,172.217.194.0-255,5738,47718,21,279618
6702,0.000356,172.31.33.0-255,66,47784,21,279618
6703,0.00038,172.217.194.0-255,2902,50686,21,279618
6704,0.000384,172.31.33.0-255,66,50752,21,279618
6705,0.000417,172.31.33.0-255,66,50818,21,279618
6706,0.000422,172.217.194.0-255,3961,54779,21,279618
6707,0.000426,172.31.33.0-255,66,54845,21,279618
6708,0.000428,172.217.194.0-255,345,55190,21,279618
6709,0.000462,172.217.194.0-255,121,55311,21,279618
6710,0.00054,172.217.194.0-255,374,55685,21,279618
6711,0.000697,172.217.194.0-255,1484,57169,21,279618
6712,0.000701,172.31.33.0-255,66,57235,21,279618
6713,0.000722,172.217.194.0-255,2902,60137,21,279618
6714,0.000724,172.31.33.0-255,66,60203,21,279618
6715,0.00073,172.217.194.0-255,5738,65941,21,279618
6716,0.000733,172.31.33.0-255,66,66007,21,279618
6717,0.000758,172.31.33.0-255,66,66073,21,279618
6718,0.000786,172.217.194.0-255,4320,70393,21,279618
6719,0.00079,172.31.33.0-255,66,70459,21,279618
6720,0.0008,172.31.33.0-255,66,70525,21,279618
6721,0.000803,172.217.194.0-255,766,71291,21,279618
6722,0.000969,172.217.194.0-255,1484,72775,21,279618
6723,0.000974,172.31.33.0-255,66,72841,21,279618
6724,0.000979,172.217.194.0-255,2902,75743,21,279618
6725,0.000981,172.31.33.0-255,66,75809,21,279618
6726,0.000986,172.217.194.0-255,2902,78711,21,279618
6727,0.000988,172.31.33.0-255,66,78777,21,279618
6728,0.001002,172.217.194.0-255,2902,81679,21,279618
6729,0.001004,172.31.33.0-255,66,81745,21,279618
6730,0.001009,172.217.194.0-255,2902,84647,21,279618
6731,0.001011,172.31.33.0-255,66,84713,21,279618
6732,0.001048,172.31.33.0-255,66,84779,21,279618
6733,0.001059,172.31.33.0-255,66,84845,21,279618
6734,0.001061,172.217.194.0-255,766,85611,21,279618
6735,0.001113,172.217.194.0-255,1484,87095,21,279618
6736,0.001116,172.31.33.0-255,66,87161,21,279618
6737,0.001122,172.217.194.0-255,4320,91481,21,279618
6738,0.001124,172.31.33.0-255,66,91547,21,279618
6739,0.001136,172.31.33.0-255,66,91613,21,279618
6740,0.001143,172.217.194.0-255,7156,98769,21,279618
6741,0.001146,172.31.33.0-255,66,98835,21,279618
6742,0.001161,172.217.194.0-255,1484,100319,21,279618
6743,0.001195,172.217.194.0-255,1484,101803,21,279618
6744,0.001199,172.31.33.0-255,66,101869,21,279618
6745,0.001227,172.31.33.0-255,66,101935,21,279618
6746,0.001273,172.217.194.0-255,1484,103419,21,279618
6747,0.001299,172.217.194.0-255,2902,106321,21,279618
6748,0.001303,172.31.33.0-255,66,106387,21,279618
6749,0.001324,172.217.194.0-255,5738,112125,21,279618
6750,0.001327,172.31.33.0-255,66,112191,21,279618
6751,0.001348,172.217.194.0-255,5738,117929,21,279618
6752,0.001351,172.31.33.0-255,66,117995,21,279618
6753,0.001376,172.217.194.0-255,7156,125151,21,279618
6754,0.001379,172.31.33.0-255,66,125217,21,279618
6755,0.001392,172.217.194.0-255,2902,128119,21,279618
6756,0.001395,172.31.33.0-255,66,128185,21,279618
6757,0.001425,172.31.33.0-255,66,128251,21,279618
6758,0.001442,172.217.194.0-255,1484,129735,21,279618
6759,0.001447,172.217.194.0-255,2902,132637,21,279618
6760,0.001449,172.217.194.0-255,1484,134121,21,279618
6761,0.001451,172.31.33.0-255,66,134187,21,279618
6762,0.001469,172.217.194.0-255,4320,138507,21,279618
6763,0.001473,172.31.33.0-255,66,138573,21,279618
6764,0.001478,172.217.194.0-255,4320,142893,21,279618
6765,0.00148,172.31.33.0-255,66,142959,21,279618
6766,0.001507,172.31.33.0-255,66,143025,21,279618
6767,0.001517,172.31.33.0-255,66,143091,21,279618
6768,0.001537,172.217.194.0-255,1484,144575,21,279618
6769,0.00154,172.217.194.0-255,766,145341,21,279618
6770,0.001543,172.31.33.0-255,66,145407,21,279618
6771,0.001927,172.217.194.0-255,1484,146891,21,279618
6772,0.001933,172.217.194.0-255,2902,149793,21,279618
6773,0.001936,172.31.33.0-255,66,149859,21,279618
6774,0.001944,172.217.194.0-255,5738,155597,21,279618
6775,0.001946,172.31.33.0-255,66,155663,21,279618
6776,0.001963,172.217.194.0-255,1484,157147,21,279618
6777,0.001988,172.217.194.0-255,2902,160049,21,279618
6778,0.001991,172.31.33.0-255,66,160115,21,279618
6779,0.002004,172.31.33.0-255,66,160181,21,279618
6780,0.002007,172.217.194.0-255,1484,161665,21,279618
6781,0.002035,172.217.194.0-255,6438,168103,21,279618
6782,0.002038,172.31.33.0-255,66,168169,21,279618
6783,0.002151,172.217.194.0-255,1484,169653,21,279618
6784,0.002156,172.217.194.0-255,2902,172555,21,279618
6785,0.002158,172.31.33.0-255,66,172621,21,279618
6786,0.002164,172.217.194.0-255,5738,178359,21,279618
6787,0.002166,172.31.33.0-255,66,178425,21,279618
6788,0.00218,172.31.33.0-255,66,178491,21,279618
6789,0.00219,172.31.33.0-255,66,178557,21,279618
6790,0.002215,172.217.194.0-255,2902,181459,21,279618
6791,0.002218,172.31.33.0-255,66,181525,21,279618
6792,0.002237,172.217.194.0-255,1484,183009,21,279618
6793,0.002243,172.217.194.0-255,5738,188747,21,279618
6794,0.002247,172.31.33.0-255,66,188813,21,279618
6795,0.002249,172.217.194.0-255,1484,190297,21,279618
6796,0.002276,172.31.33.0-255,66,190363,21,279618
6797,0.00233,172.217.194.0-255,4320,194683,21,279618
6798,0.002334,172.31.33.0-255,66,194749,21,279618
6799,0.00234,172.217.194.0-255,5738,200487,21,279618
6800,0.002342,172.31.33.0-255,66,200553,21,279618
6801,0.002346,172.217.194.0-255,2184,202737,21,279618
6802,0.002348,172.31.33.0-255,66,202803,21,279618
6803,0.002374,172.217.194.0-255,1484,204287,21,279618
6804,0.002389,172.217.194.0-255,2902,207189,21,279618
6805,0.002393,172.31.33.0-255,66,207255,21,279618
6806,0.002398,172.217.194.0-255,4320,211575,21,279618
6807,0.0024,172.31.33.0-255,66,211641,21,279618
6808,0.002418,172.217.194.0-255,1484,213125,21,279618
6809,0.002425,172.217.194.0-255,4320,217445,21,279618
6810,0.002428,172.31.33.0-255,66,217511,21,279618
6811,0.002449,172.217.194.0-255,5738,223249,21,279618
6812,0.002453,172.31.33.0-255,66,223315,21,279618
6813,0.002466,172.31.33.0-255,66,223381,21,279618
6814,0.00247,172.217.194.0-255,2184,225565,21,279618
6815,0.002472,172.31.33.0-255,66,225631,21,279618
6816,0.004934,172.217.194.0-255,5738,231369,21,279618
6817,0.004941,172.31.33.0-255,66,231435,21,279618
6818,0.007403,172.217.194.0-255,2902,234337,21,279618
6819,0.007407,172.31.33.0-255,66,234403,21,279618
6820,0.007426,172.217.194.0-255,2902,237305,21,279618
6821,0.007428,172.31.33.0-255,66,237371,21,279618
6822,0.009866,172.217.194.0-255,5738,243109,21,279618
6823,0.009874,172.31.33.0-255,66,243175,21,279618
6824,0.012374,172.217.194.0-255,5738,248913,21,279618
6825,0.012383,172.31.33.0-255,66,248979,21,279618
6826,0.014845,172.217.194.0-255,5738,254717,21,279618
6827,0.014861,172.31.33.0-255,66,254783,21,279618
6828,0.017345,172.217.194.0-255,5738,260521,21,279618
6829,0.017361,172.31.33.0-255,66,260587,21,279618
6830,0.019832,172.217.194.0-255,5738,266325,21,279618
6831,0.019846,172.31.33.0-255,66,266391,21,279618
6832,0.022324,172.217.194.0-255,4916,271307,21,279618
6833,0.022339,172.31.33.0-255,66,271373,21,279618
6834,0.02259,172.31.33.0-255,105,271478,21,279618
6835,0.025039,172.217.194.0-255,66,271544,21,279618
6836,0.033365,172.31.33.0-255,172,271716,21,279618
6837,0.033414,172.31.33.0-255,1113,272829,21,279618
6838,0.033479,172.31.33.0-255,1514,274343,21,279618
6839,0.033481,172.31.33.0-255,1514,275857,21,279618
6840,0.033481,172.31.33.0-255,1514,277371,21,279618
6841,0.033482,172.31.33.0-255,1514,278885,21,279618
6842,0.033513,172.31.33.0-255,469,279354,21,279618
6843,0.03504,104.244.42.0-255,66,279420,21,279618
6844,0.035138,104.244.42.0-255,66,279486,21,279618
6845,0.035183,104.244.42.0-255,66,279552,21,279618
6846,0.035197,104.244.42.0-255,66,279618,21,279618
6847,0.0,172.31.33.0-255,105,105,21,525
6848,0.000232,172.31.33.0-255,90,195,21,525
6849,0.00024,172.31.33.0-255,66,261,21,525
6850,0.002682,74.125.24.0-255,66,327,21,525
6851,0.002691,74.125.24.0-255,66,393,21,525
6852,0.002696,172.31.33.0-255,66,459,21,525
6853,0.002709,74.125.24.0-255,66,525,21,525
6854,0.0,74.125.200.0-255,143,143,21,352839
6855,3.2e-05,172.31.33.0-255,66,209,21,352839
6856,3.9e-05,74.125.200.0-255,1484,1693,21,352839
6857,4.4e-05,172.31.33.0-255,66,1759,21,352839
6858,4.7e-05,74.125.200.0-255,1484,3243,21,352839
6859,4.9e-05,172.31.33.0-255,66,3309,21,352839
6860,5.5e-05,74.125.200.0-255,2902,6211,21,352839
6861,5.8e-05,172.31.33.0-255,66,6277,21,352839
6862,6.1e-05,74.125.200.0-255,1484,7761,21,352839
6863,6.3e-05,172.31.33.0-255,66,7827,21,352839
6864,8.8e-05,74.125.200.0-255,4320,12147,21,352839
6865,9.1e-05,172.31.33.0-255,66,12213,21,352839
6866,9.5e-05,74.125.200.0-255,2010,14223,21,352839
6867,9.8e-05,172.31.33.0-255,66,14289,21,352839
6868,0.000102,74.125.200.0-255,2902,17191,21,352839
6869,0.000104,172.31.33.0-255,66,17257,21,352839
6870,0.000138,74.125.200.0-255,4320,21577,21,352839
6871,0.000142,172.31.33.0-255,66,21643,21,352839
6872,0.000162,74.125.200.0-255,2902,24545,21,352839
6873,0.000165,172.31.33.0-255,66,24611,21,352839
6874,0.00017,74.125.200.0-255,2902,27513,21,352839
6875,0.000172,172.31.33.0-255,66,27579,21,352839
6876,0.000179,74.125.200.0-255,4320,31899,21,352839
6877,0.000181,172.31.33.0-255,66,31965,21,352839
6878,0.000192,172.31.33.0-255,66,32031,21,352839
6879,0.000195,74.125.200.0-255,1484,33515,21,352839
6880,0.000197,172.31.33.0-255,66,33581,21,352839
6881,0.000217,74.125.200.0-255,5738,39319,21,352839
6882,0.00022,172.31.33.0-255,66,39385,21,352839
6883,0.000222,74.125.200.0-255,766,40151,21,352839
6884,0.000224,172.31.33.0-255,66,40217,21,352839
6885,0.000309,74.125.200.0-255,1484,41701,21,352839
6886,0.000314,74.125.200.0-255,1484,43185,21,352839
6887,0.000318,172.31.33.0-255,66,43251,21,352839
6888,0.000335,74.125.200.0-255,1484,44735,21,352839
6889,0.000342,74.125.200.0-255,5738,50473,21,352839
6890,0.000347,172.31.33.0-255,66,50539,21,352839
6891,0.000361,74.125.200.0-255,4320,54859,21,352839
6892,0.000364,172.31.33.0-255,66,54925,21,352839
6893,0.000401,74.125.200.0-255,2857,57782,21,352839
6894,0.000404,172.31.33.0-255,66,57848,21,352839
6895,0.000483,74.125.200.0-255,109,57957,21,352839
6896,0.000539,74.125.200.0-255,1484,59441,21,352839
6897,0.000544,172.31.33.0-255,66,59507,21,352839
6898,0.000571,74.125.200.0-255,1484,60991,21,352839
6899,0.000585,74.125.200.0-255,2902,63893,21,352839
6900,0.000589,172.31.33.0-255,66,63959,21,352839
6901,0.000612,74.125.200.0-255,2902,66861,21,352839
6902,0.000614,74.125.200.0-255,1484,68345,21,352839
6903,0.000616,172.31.33.0-255,66,68411,21,352839
6904,0.000626,74.125.200.0-255,2902,71313,21,352839
6905,0.000628,172.31.33.0-255,66,71379,21,352839
6906,0.000663,74.125.200.0-255,3961,75340,21,352839
6907,0.000667,172.31.33.0-255,66,75406,21,352839
6908,0.000712,74.125.200.0-255,1484,76890,21,352839
6909,0.000726,74.125.200.0-255,2902,79792,21,352839
6910,0.00073,172.31.33.0-255,66,79858,21,352839
6911,0.000752,74.125.200.0-255,5738,85596,21,352839
6912,0.000755,172.31.33.0-255,66,85662,21,352839
6913,0.000785,74.125.200.0-255,5738,91400,21,352839
6914,0.000788,172.31.33.0-255,66,91466,21,352839
6915,0.000804,74.125.200.0-255,1368,92834,21,352839
6916,0.001038,74.125.200.0-255,1484,94318,21,352839
6917,0.001043,172.31.33.0-255,66,94384,21,352839
6918,0.001049,74.125.200.0-255,2902,97286,21,352839
6919,0.001052,172.31.33.0-255,66,97352,21,352839
6920,0.001085,74.125.200.0-255,4320,101672,21,352839
6921,0.001088,172.31.33.0-255,66,101738,21,352839
6922,0.001102,74.125.200.0-255,4320,106058,21,352839
6923,0.001105,172.31.33.0-255,66,106124,21,352839
6924,0.001122,74.125.200.0-255,4320,110444,21,352839
6925,0.001124,172.31.33.0-255,66,110510,21,352839
6926,0.001127,74.125.200.0-255,1484,111994,21,352839
6927,0.001131,74.125.200.0-255,2902,114896,21,352839
6928,0.001133,172.31.33.0-255,66,114962,21,352839
6929,0.001148,74.125.200.0-255,1484,116446,21,352839
6930,0.001167,74.125.200.0-255,4320,120766,21,352839
6931,0.00117,172.31.33.0-255,66,120832,21,352839
6932,0.001173,74.125.200.0-255,1484,122316,21,352839
6933,0.001178,74.125.200.0-255,2902,125218,21,352839
6934,0.00118,172.31.33.0-255,66,125284,21,352839
6935,0.001217,74.125.200.0-255,2184,127468,21,352839
6936,0.00122,172.31.33.0-255,66,127534,21,352839
6937,0.001832,74.125.200.0-255,1484,129018,21,352839
6938,0.001843,74.125.200.0-255,2902,131920,21,352839
6939,0.001847,172.31.33.0-255,66,131986,21,352839
6940,0.001853,74.125.200.0-255,2902,134888,21,352839
6941,0.001855,172.31.33.0-255,66,134954,21,352839
6942,0.001869,74.125.200.0-255,2902,137856,21,352839
6943,0.001872,172.31.33.0-255,66,137922,21,352839
6944,0.001877,74.125.200.0-255,4320,142242,21,352839
6945,0.001879,172.31.33.0-255,66,142308,21,352839
6946,0.001903,74.125.200.0-255,1484,143792,21,352839
6947,0.001912,74.125.200.0-255,7156,150948,21,352839
6948,0.001914,172.31.33.0-255,66,151014,21,352839
6949,0.001932,74.125.200.0-255,2902,153916,21,352839
6950,0.001935,172.31.33.0-255,66,153982,21,352839
6951,0.001966,172.31.33.0-255,66,154048,21,352839
6952,0.003983,74.125.200.0-255,5738,159786,21,352839
6953,0.003989,172.31.33.0-255,66,159852,21,352839
6954,0.006068,74.125.200.0-255,5738,165590,21,352839
6955,0.006074,172.31.33.0-255,66,165656,21,352839
6956,0.008099,74.125.200.0-255,5738,171394,21,352839
6957,0.008105,172.31.33.0-255,66,171460,21,352839
6958,0.010127,74.125.200.0-255,5738,177198,21,352839
6959,0.010135,172.31.33.0-255,66,177264,21,352839
6960,0.012163,74.125.200.0-255,5738,183002,21,352839
6961,0.01217,172.31.33.0-255,66,183068,21,352839
6962,0.014205,74.125.200.0-255,5738,188806,21,352839
6963,0.014216,172.31.33.0-255,66,188872,21,352839
6964,0.016236,74.125.200.0-255,5738,194610,21,352839
6965,0.016243,172.31.33.0-255,66,194676,21,352839
6966,0.018275,74.125.200.0-255,5738,200414,21,352839
6967,0.018284,172.31.33.0-255,66,200480,21,352839
6968,0.020321,74.125.200.0-255,4320,204800,21,352839
6969,0.020329,172.31.33.0-255,66,204866,21,352839
6970,0.020365,74.125.200.0-255,1484,206350,21,352839
6971,0.022351,74.125.200.0-255,4320,210670,21,352839
6972,0.022357,172.31.33.0-255,66,210736,21,352839
6973,0.024388,74.125.200.0-255,5738,216474,21,352839
6974,0.024395,172.31.33.0-255,66,216540,21,352839
6975,0.026427,74.125.200.0-255,5738,222278,21,352839
6976,0.026434,172.31.33.0-255,66,222344,21,352839
6977,0.028454,74.125.200.0-255,5738,228082,21,352839
6978,0.028461,172.31.33.0-255,66,228148,21,352839
6979,0.028879,172.31.33.0-255,172,228320,21,352839
6980,0.028908,172.31.33.0-255,1113,229433,21,352839
6981,0.028947,172.31.33.0-255,1514,230947,21,352839
6982,0.028948,172.31.33.0-255,1514,232461,21,352839
6983,0.02895,172.31.33.0-255,1514,233975,21,352839
6984,0.028977,172.31.33.0-255,1068,235043,21,352839
6985,0.030469,104.244.42.0-255,66,235109,21,352839
6986,0.03048,104.244.42.0-255,66,235175,21,352839
6987,0.030509,74.125.200.0-255,5738,240913,21,352839
6988,0.030516,172.31.33.0-255,66,240979,21,352839
6989,0.030524,104.244.42.0-255,66,241045,21,352839
6990,0.030559,104.244.42.0-255,66,241111,21,352839
6991,0.032564,74.125.200.0-255,5738,246849,21,352839
6992,0.032583,172.31.33.0-255,66,246915,21,352839
6993,0.03463,74.125.200.0-255,5738,252653,21,352839
6994,0.034647,172.31.33.0-255,66,252719,21,352839
6995,0.036687,74.125.200.0-255,5738,258457,21,352839
6996,0.036705,172.31.33.0-255,66,258523,21,352839
6997,0.038758,74.125.200.0-255,5738,264261,21,352839
6998,0.038774,172.31.33.0-255,66,264327,21,352839
6999,0.04082,74.125.200.0-255,5738,270065,21,352839
7000,0.040835,172.31.33.0-255,66,270131,21,352839
7001,0.042866,74.125.200.0-255,5738,275869,21,352839
7002,0.042881,172.31.33.0-255,66,275935,21,352839
7003,0.044907,74.125.200.0-255,5738,281673,21,352839
7004,0.044913,172.31.33.0-255,66,281739,21,352839
7005,0.046938,74.125.200.0-255,5738,287477,21,352839
7006,0.046943,172.31.33.0-255,66,287543,21,352839
7007,0.048953,74.125.200.0-255,2902,290445,21,352839
7008,0.048958,172.31.33.0-255,66,290511,21,352839
7009,0.048988,74.125.200.0-255,2902,293413,21,352839
7010,0.048992,172.31.33.0-255,66,293479,21,352839
7011,0.050975,74.125.200.0-255,2902,296381,21,352839
7012,0.050981,172.31.33.0-255,66,296447,21,352839
7013,0.051012,74.125.200.0-255,2902,299349,21,352839
7014,0.051016,172.31.33.0-255,66,299415,21,352839
7015,0.053002,74.125.200.0-255,2902,302317,21,352839
7016,0.053007,172.31.33.0-255,66,302383,21,352839
7017,0.053038,74.125.200.0-255,2902,305285,21,352839
7018,0.053041,172.31.33.0-255,66,305351,21,352839
7019,0.055036,74.125.200.0-255,2902,308253,21,352839
7020,0.055041,172.31.33.0-255,66,308319,21,352839
7021,0.055073,74.125.200.0-255,2902,311221,21,352839
7022,0.055076,172.31.33.0-255,66,311287,21,352839
7023,0.057076,74.125.200.0-255,2902,314189,21,352839
7024,0.057082,172.31.33.0-255,66,314255,21,352839
7025,0.057103,74.125.200.0-255,2902,317157,21,352839
7026,0.057106,172.31.33.0-255,66,317223,21,352839
7027,0.05911,74.125.200.0-255,2902,320125,21,352839
7028,0.059116,172.31.33.0-255,66,320191,21,352839
7029,0.059142,74.125.200.0-255,2902,323093,21,352839
7030,0.059145,172.31.33.0-255,66,323159,21,352839
7031,0.06113,74.125.200.0-255,2902,326061,21,352839
7032,0.06115,172.31.33.0-255,66,326127,21,352839
7033,0.061163,74.125.200.0-255,2902,329029,21,352839
7034,0.061167,172.31.33.0-255,66,329095,21,352839
7035,0.063156,74.125.200.0-255,2902,331997,21,352839
7036,0.063162,172.31.33.0-255,66,332063,21,352839
7037,0.063193,74.125.200.0-255,2902,334965,21,352839
7038,0.063197,172.31.33.0-255,66,335031,21,352839
7039,0.06518,74.125.200.0-255,2902,337933,21,352839
7040,0.065185,172.31.33.0-255,66,337999,21,352839
7041,0.06522,74.125.200.0-255,2902,340901,21,352839
7042,0.065223,172.31.33.0-255,66,340967,21,352839
7043,0.06721,74.125.200.0-255,2902,343869,21,352839
7044,0.067215,172.31.33.0-255,66,343935,21,352839
7045,0.067245,74.125.200.0-255,2902,346837,21,352839
7046,0.067249,172.31.33.0-255,66,346903,21,352839
7047,0.069236,74.125.200.0-255,2902,349805,21,352839
7048,0.069242,172.31.33.0-255,66,349871,21,352839
7049,0.069281,74.125.200.0-255,2902,352773,21,352839
7050,0.069283,172.31.33.0-255,66,352839,21,352839
7051,0.0,172.31.33.0-255,105,105,21,918
7052,4.7e-05,172.31.33.0-255,105,210,21,918
7053,0.000233,172.31.33.0-255,90,300,21,918
7054,0.000242,172.31.33.0-255,66,366,21,918
7055,0.000551,172.31.33.0-255,90,456,21,918
7056,0.000557,172.31.33.0-255,66,522,21,918
7057,0.002366,172.217.194.0-255,66,588,21,918
7058,0.002388,172.217.194.0-255,66,654,21,918
7059,0.002406,172.31.33.0-255,66,720,21,918
7060,0.00275,74.125.24.0-255,66,786,21,918
7061,0.002764,74.125.24.0-255,66,852,21,918
7062,0.002774,172.31.33.0-255,66,918,21,918
7063,0.0,172.31.33.0-255,105,105,21,459
7064,0.000201,172.31.33.0-255,90,195,21,459
7065,0.000209,172.31.33.0-255,66,261,21,459
7066,0.002787,74.125.24.0-255,66,327,21,459
7067,0.002801,74.125.24.0-255,66,393,21,459
7068,0.002809,172.31.33.0-255,66,459,21,459
7069,0.0,74.125.68.0-255,66,66,21,525
7070,0.043603,172.31.33.0-255,105,171,21,525
7071,0.043789,172.31.33.0-255,90,261,21,525
7072,0.043798,172.31.33.0-255,66,327,21,525
7073,0.045878,172.217.194.0-255,66,393,21,525
7074,0.045897,172.217.194.0-255,66,459,21,525
7075,0.045911,172.31.33.0-255,66,525,21,525
7076,0.0,74.125.24.0-255,153,153,21,171038
7077,3.3e-05,172.31.33.0-255,66,219,21,171038
7078,4e-05,74.125.24.0-255,1484,1703,21,171038
7079,4.4e-05,172.31.33.0-255,66,1769,21,171038
7080,4.9e-05,74.125.24.0-255,2902,4671,21,171038
7081,5.9e-05,172.31.33.0-255,66,4737,21,171038
7082,6.5e-05,74.125.24.0-255,5738,10475,21,171038
7083,6.9e-05,172.31.33.0-255,66,10541,21,171038
7084,8.5e-05,172.31.33.0-255,66,10607,21,171038
7085,0.000129,172.31.33.0-255,66,10673,21,171038
7086,0.00023,74.125.24.0-255,1484,12157,21,171038
7087,0.000236,172.31.33.0-255,66,12223,21,171038
7088,0.000241,74.125.24.0-255,2902,15125,21,171038
7089,0.000244,172.31.33.0-255,66,15191,21,171038
7090,0.000258,74.125.24.0-255,5738,20929,21,171038
7091,0.000261,172.31.33.0-255,66,20995,21,171038
7092,0.000294,172.31.33.0-255,66,21061,21,171038
7093,0.0003,74.125.24.0-255,5738,26799,21,171038
7094,0.000304,172.31.33.0-255,66,26865,21,171038
7095,0.000354,74.125.24.0-255,4271,31136,21,171038
7096,0.000358,172.31.33.0-255,66,31202,21,171038
7097,0.000361,74.125.24.0-255,111,31313,21,171038
7098,0.000362,172.31.33.0-255,66,31379,21,171038
7099,0.000468,74.125.24.0-255,1484,32863,21,171038
7100,0.000473,172.31.33.0-255,66,32929,21,171038
7101,0.000478,74.125.24.0-255,2902,35831,21,171038
7102,0.00048,172.31.33.0-255,66,35897,21,171038
7103,0.000491,74.125.24.0-255,5738,41635,21,171038
7104,0.000493,172.31.33.0-255,66,41701,21,171038
7105,0.000499,74.125.24.0-255,5738,47439,21,171038
7106,0.000501,172.31.33.0-255,66,47505,21,171038
7107,0.000527,74.125.24.0-255,1125,48630,21,171038
7108,0.000543,74.125.24.0-255,2808,51438,21,171038
7109,0.000544,172.31.33.0-255,66,51504,21,171038
7110,0.000547,172.31.33.0-255,66,51570,21,171038
7111,0.000657,74.125.24.0-255,1484,53054,21,171038
7112,0.000678,74.125.24.0-255,2902,55956,21,171038
7113,0.000682,74.125.24.0-255,5738,61694,21,171038
7114,0.000685,172.31.33.0-255,66,61760,21,171038
7115,0.000693,172.31.33.0-255,66,61826,21,171038
7116,0.000721,172.31.33.0-255,66,61892,21,171038
7117,0.000749,74.125.24.0-255,2902,64794,21,171038
7118,0.000752,172.31.33.0-255,66,64860,21,171038
7119,0.000776,172.31.33.0-255,66,64926,21,171038
7120,0.001,74.125.24.0-255,1484,66410,21,171038
7121,0.001006,74.125.24.0-255,2902,69312,21,171038
7122,0.00101,172.31.33.0-255,66,69378,21,171038
7123,0.001014,74.125.24.0-255,2902,72280,21,171038
7124,0.001017,172.31.33.0-255,66,72346,21,171038
7125,0.001041,74.125.24.0-255,2902,75248,21,171038
7126,0.001045,172.31.33.0-255,66,75314,21,171038
7127,0.001057,172.31.33.0-255,66,75380,21,171038
7128,0.001064,74.125.24.0-255,7156,82536,21,171038
7129,0.001066,172.31.33.0-255,66,82602,21,171038
7130,0.001095,74.125.24.0-255,2902,85504,21,171038
7131,0.0011,172.31.33.0-255,66,85570,21,171038
7132,0.001103,74.125.24.0-255,766,86336,21,171038
7133,0.001106,74.125.24.0-255,1484,87820,21,171038
7134,0.001107,172.31.33.0-255,66,87886,21,171038
7135,0.001112,74.125.24.0-255,2902,90788,21,171038
7136,0.001114,172.31.33.0-255,66,90854,21,171038
7137,0.001138,74.125.24.0-255,1484,92338,21,171038
7138,0.001152,172.31.33.0-255,66,92404,21,171038
7139,0.001159,74.125.24.0-255,7156,99560,21,171038
7140,0.001161,172.31.33.0-255,66,99626,21,171038
7141,0.0012,172.31.33.0-255,66,99692,21,171038
7142,0.001203,74.125.24.0-255,1484,101176,21,171038
7143,0.001267,172.31.33.0-255,66,101242,21,171038
7144,0.001273,74.125.24.0-255,5020,106262,21,171038
7145,0.001275,172.31.33.0-255,66,106328,21,171038
7146,0.001326,74.125.24.0-255,5738,112066,21,171038
7147,0.001329,172.31.33.0-255,66,112132,21,171038
7148,0.001361,74.125.24.0-255,4320,116452,21,171038
7149,0.001366,172.31.33.0-255,66,116518,21,171038
7150,0.00138,172.31.33.0-255,66,116584,21,171038
7151,0.001393,172.31.33.0-255,66,116650,21,171038
7152,0.001405,172.31.33.0-255,66,116716,21,171038
7153,0.001414,172.31.33.0-255,66,116782,21,171038
7154,0.001465,172.31.33.0-255,66,116848,21,171038
7155,0.00148,172.31.33.0-255,66,116914,21,171038
7156,0.001485,74.125.24.0-255,4320,121234,21,171038
7157,0.001487,172.31.33.0-255,66,121300,21,171038
7158,0.001524,172.31.33.0-255,66,121366,21,171038
7159,0.001531,74.125.24.0-255,5020,126386,21,171038
7160,0.001535,172.31.33.0-255,66,126452,21,171038
7161,0.001579,74.125.24.0-255,1484,127936,21,171038
7162,0.001583,74.125.24.0-255,1484,129420,21,171038
7163,0.001586,172.31.33.0-255,66,129486,21,171038
7164,0.001616,74.125.24.0-255,1484,130970,21,171038
7165,0.001623,74.125.24.0-255,5738,136708,21,171038
7166,0.001626,172.31.33.0-255,66,136774,21,171038
7167,0.001638,172.31.33.0-255,66,136840,21,171038
7168,0.001669,74.125.24.0-255,4320,141160,21,171038
7169,0.001673,172.31.33.0-255,66,141226,21,171038
7170,0.001684,172.31.33.0-255,66,141292,21,171038
7171,0.001687,74.125.24.0-255,2184,143476,21,171038
7172,0.00169,172.31.33.0-255,66,143542,21,171038
7173,0.001695,74.125.24.0-255,2902,146444,21,171038
7174,0.001697,172.31.33.0-255,66,146510,21,171038
7175,0.001737,74.125.24.0-255,7156,153666,21,171038
7176,0.001741,172.31.33.0-255,66,153732,21,171038
7177,0.001757,172.31.33.0-255,66,153798,21,171038
7178,0.00178,74.125.24.0-255,1484,155282,21,171038
7179,0.001789,74.125.24.0-255,7156,162438,21,171038
7180,0.001792,172.31.33.0-255,66,162504,21,171038
7181,0.001824,172.31.33.0-255,66,162570,21,171038
7182,0.001828,74.125.24.0-255,1484,164054,21,171038
7183,0.001831,74.125.24.0-255,1307,165361,21,171038
7184,0.001833,172.31.33.0-255,66,165427,21,171038
7185,0.001865,74.125.24.0-255,105,165532,21,171038
7186,0.003417,172.31.33.0-255,66,165598,21,171038
7187,0.00344,172.31.33.0-255,105,165703,21,171038
7188,0.005726,74.125.24.0-255,66,165769,21,171038
7189,0.025575,172.31.33.0-255,172,165941,21,171038
7190,0.0256,172.31.33.0-255,1113,167054,21,171038
7191,0.025655,172.31.33.0-255,1514,168568,21,171038
7192,0.025657,172.31.33.0-255,1514,170082,21,171038
7193,0.025678,172.31.33.0-255,692,170774,21,171038
7194,0.027098,104.244.42.0-255,66,170840,21,171038
7195,0.027116,104.244.42.0-255,66,170906,21,171038
7196,0.027165,104.244.42.0-255,66,170972,21,171038
7197,0.027168,104.244.42.0-255,66,171038,21,171038
7198,0.0,172.31.33.0-255,105,105,21,459
7199,0.000198,172.31.33.0-255,90,195,21,459
7200,0.000209,172.31.33.0-255,66,261,21,459
7201,0.002394,74.125.130.0-255,66,327,21,459
7202,0.002402,74.125.130.0-255,66,393,21,459
7203,0.002406,172.31.33.0-255,66,459,21,459
7204,0.0,172.31.33.0-255,105,105,21,2295
7205,4.3e-05,172.31.33.0-255,105,210,21,2295
7206,0.0001,172.31.33.0-255,105,315,21,2295
7207,0.000129,172.31.33.0-255,105,420,21,2295
7208,0.000182,172.31.33.0-255,105,525,21,2295
7209,0.00047,172.31.33.0-255,90,615,21,2295
7210,0.00048,172.31.33.0-255,66,681,21,2295
7211,0.000771,172.31.33.0-255,90,771,21,2295
7212,0.000779,172.31.33.0-255,66,837,21,2295
7213,0.001114,172.31.33.0-255,90,927,21,2295
7214,0.001121,172.31.33.0-255,66,993,21,2295
7215,0.001254,172.31.33.0-255,90,1083,21,2295
7216,0.00126,172.31.33.0-255,66,1149,21,2295
7217,0.001391,172.31.33.0-255,90,1239,21,2295
7218,0.001397,172.31.33.0-255,66,1305,21,2295
7219,0.002745,74.125.200.0-255,66,1371,21,2295
7220,0.002773,74.125.200.0-255,66,1437,21,2295
7221,0.002795,172.31.33.0-255,66,1503,21,2295
7222,0.0028,74.125.68.0-255,66,1569,21,2295
7223,0.002818,74.125.68.0-255,66,1635,21,2295
7224,0.002829,172.31.33.0-255,66,1701,21,2295
7225,0.003615,74.125.24.0-255,66,1767,21,2295
7226,0.003629,74.125.24.0-255,66,1833,21,2295
7227,0.00364,172.31.33.0-255,66,1899,21,2295
7228,0.003703,172.217.194.0-255,66,1965,21,2295
7229,0.003717,172.217.194.0-255,66,2031,21,2295
7230,0.003728,172.31.33.0-255,66,2097,21,2295
7231,0.003874,74.125.24.0-255,66,2163,21,2295
7232,0.003889,74.125.24.0-255,66,2229,21,2295
7233,0.0039,172.31.33.0-255,66,2295,21,2295
7234,0.0,172.217.194.0-255,152,152,21,329366
7235,2.3e-05,172.31.33.0-255,66,218,21,329366
7236,2.9e-05,172.217.194.0-255,1484,1702,21,329366
7237,3.3e-05,172.31.33.0-255,66,1768,21,329366
7238,3.7e-05,172.217.194.0-255,2902,4670,21,329366
7239,4e-05,172.31.33.0-255,66,4736,21,329366
7240,5.9e-05,172.217.194.0-255,4320,9056,21,329366
7241,6.1e-05,172.31.33.0-255,66,9122,21,329366
7242,8.5e-05,172.217.194.0-255,4320,13442,21,329366
7243,8.7e-05,172.31.33.0-255,66,13508,21,329366
7244,9.6e-05,172.217.194.0-255,611,14119,21,329366
7245,9.8e-05,172.31.33.0-255,66,14185,21,329366
7246,0.000117,172.217.194.0-255,2902,17087,21,329366
7247,0.00012,172.31.33.0-255,66,17153,21,329366
7248,0.000137,172.217.194.0-255,2902,20055,21,329366
7249,0.000139,172.31.33.0-255,66,20121,21,329366
7250,0.000145,172.217.194.0-255,7156,27277,21,329366
7251,0.000149,172.31.33.0-255,66,27343,21,329366
7252,0.000186,172.217.194.0-255,1484,28827,21,329366
7253,0.000189,172.31.33.0-255,66,28893,21,329366
7254,0.000213,172.31.33.0-255,66,28959,21,329366
7255,0.00026,172.217.194.0-255,4320,33279,21,329366
7256,0.000263,172.31.33.0-255,66,33345,21,329366
7257,0.000281,172.217.194.0-255,1125,34470,21,329366
7258,0.000283,172.31.33.0-255,66,34536,21,329366
7259,0.000341,172.217.194.0-255,1484,36020,21,329366
7260,0.000346,172.31.33.0-255,66,36086,21,329366
7261,0.000371,172.217.194.0-255,2902,38988,21,329366
7262,0.000374,172.31.33.0-255,66,39054,21,329366
7263,0.000396,172.217.194.0-255,5738,44792,21,329366
7264,0.000399,172.31.33.0-255,66,44858,21,329366
7265,0.000404,172.217.194.0-255,4320,49178,21,329366
7266,0.000411,172.31.33.0-255,66,49244,21,329366
7267,0.000445,172.217.194.0-255,2543,51787,21,329366
7268,0.000453,172.31.33.0-255,66,51853,21,329366
7269,0.000482,172.217.194.0-255,378,52231,21,329366
7270,0.000682,172.31.33.0-255,66,52297,21,329366
7271,0.000843,172.217.194.0-255,365,52662,21,329366
7272,0.001134,172.217.194.0-255,1484,54146,21,329366
7273,0.001141,172.217.194.0-255,2902,57048,21,329366
7274,0.001163,172.217.194.0-255,5738,62786,21,329366
7275,0.001168,172.217.194.0-255,2902,65688,21,329366
7276,0.00118,172.217.194.0-255,2902,68590,21,329366
7277,0.00119,172.217.194.0-255,1484,70074,21,329366
7278,0.001205,172.217.194.0-255,5738,75812,21,329366
7279,0.00147,172.217.194.0-255,1484,77296,21,329366
7280,0.001482,172.217.194.0-255,2902,80198,21,329366
7281,0.001498,172.217.194.0-255,4320,84518,21,329366
7282,0.00151,172.217.194.0-255,1484,86002,21,329366
7283,0.001515,172.217.194.0-255,5738,91740,21,329366
7284,0.001555,172.217.194.0-255,4320,96060,21,329366
7285,0.001565,172.217.194.0-255,766,96826,21,329366
7286,0.00159,172.217.194.0-255,2902,99728,21,329366
7287,0.001612,172.217.194.0-255,2902,102630,21,329366
7288,0.001617,172.217.194.0-255,7156,109786,21,329366
7289,0.001632,172.217.194.0-255,5738,115524,21,329366
7290,0.001649,172.217.194.0-255,1484,117008,21,329366
7291,0.001668,172.217.194.0-255,5020,122028,21,329366
7292,0.001705,172.217.194.0-255,2902,124930,21,329366
7293,0.00172,172.217.194.0-255,2902,127832,21,329366
7294,0.001729,172.217.194.0-255,1484,129316,21,329366
7295,0.001743,172.217.194.0-255,1484,130800,21,329366
7296,0.001759,172.217.194.0-255,4320,135120,21,329366
7297,0.001789,172.217.194.0-255,5738,140858,21,329366
7298,0.001794,172.217.194.0-255,6438,147296,21,329366
7299,0.002206,172.217.194.0-255,1484,148780,21,329366
7300,0.002208,172.217.194.0-255,1484,150264,21,329366
7301,0.002221,172.217.194.0-255,1484,151748,21,329366
7302,0.002224,172.217.194.0-255,2902,154650,21,329366
7303,0.002236,172.217.194.0-255,2902,157552,21,329366
7304,0.002246,172.217.194.0-255,1484,159036,21,329366
7305,0.002279,172.217.194.0-255,1484,160520,21,329366
7306,0.002329,172.217.194.0-255,1484,162004,21,329366
7307,0.002331,172.217.194.0-255,766,162770,21,329366
7308,0.004116,172.31.33.0-255,66,162836,21,329366
7309,0.006446,172.217.194.0-255,5738,168574,21,329366
7310,0.006453,172.31.33.0-255,66,168640,21,329366
7311,0.008772,172.217.194.0-255,5738,174378,21,329366
7312,0.008778,172.31.33.0-255,66,174444,21,329366
7313,0.011122,172.217.194.0-255,5738,180182,21,329366
7314,0.011624,172.31.33.0-255,66,180248,21,329366
7315,0.013972,172.217.194.0-255,5738,185986,21,329366
7316,0.013984,172.31.33.0-255,66,186052,21,329366
7317,0.016324,172.217.194.0-255,5738,191790,21,329366
7318,0.016331,172.31.33.0-255,66,191856,21,329366
7319,0.018649,172.217.194.0-255,5738,197594,21,329366
7320,0.018655,172.31.33.0-255,66,197660,21,329366
7321,0.020974,172.217.194.0-255,5738,203398,21,329366
7322,0.02098,172.31.33.0-255,66,203464,21,329366
7323,0.023324,172.217.194.0-255,5738,209202,21,329366
7324,0.023331,172.31.33.0-255,66,209268,21,329366
7325,0.025013,172.31.33.0-255,172,209440,21,329366
7326,0.025039,172.31.33.0-255,1113,210553,21,329366
7327,0.025079,172.31.33.0-255,1514,212067,21,329366
7328,0.02508,172.31.33.0-255,1514,213581,21,329366
7329,0.025084,172.31.33.0-255,1514,215095,21,329366
7330,0.025086,172.31.33.0-255,1514,216609,21,329366
7331,0.025111,172.31.33.0-255,469,217078,21,329366
7332,0.025646,172.217.194.0-255,5738,222816,21,329366
7333,0.025651,172.31.33.0-255,66,222882,21,329366
7334,0.026514,104.244.42.0-255,66,222948,21,329366
7335,0.026534,104.244.42.0-255,66,223014,21,329366
7336,0.026638,104.244.42.0-255,66,223080,21,329366
7337,0.02664,104.244.42.0-255,66,223146,21,329366
7338,0.027962,172.217.194.0-255,4320,227466,21,329366
7339,0.027965,172.31.33.0-255,66,227532,21,329366
7340,0.027987,172.217.194.0-255,1484,229016,21,329366
7341,0.030259,172.217.194.0-255,4320,233336,21,329366
7342,0.030263,172.31.33.0-255,66,233402,21,329366
7343,0.032566,172.217.194.0-255,5738,239140,21,329366
7344,0.032614,172.31.33.0-255,66,239206,21,329366
7345,0.034925,172.217.194.0-255,5738,244944,21,329366
7346,0.03493,172.31.33.0-255,66,245010,21,329366
7347,0.037247,172.217.194.0-255,5738,250748,21,329366
7348,0.037252,172.31.33.0-255,66,250814,21,329366
7349,0.039564,172.217.194.0-255,5738,256552,21,329366
7350,0.039568,172.31.33.0-255,66,256618,21,329366
7351,0.041919,172.217.194.0-255,5738,262356,21,329366
7352,0.041924,172.31.33.0-255,66,262422,21,329366
7353,0.044221,172.217.194.0-255,5738,268160,21,329366
7354,0.044225,172.31.33.0-255,66,268226,21,329366
7355,0.046536,172.217.194.0-255,5738,273964,21,329366
7356,0.04654,172.31.33.0-255,66,274030,21,329366
7357,0.048848,172.217.194.0-255,5738,279768,21,329366
7358,0.048852,172.31.33.0-255,66,279834,21,329366
7359,0.051163,172.217.194.0-255,5738,285572,21,329366
7360,0.051167,172.31.33.0-255,66,285638,21,329366
7361,0.053473,172.217.194.0-255,5738,291376,21,329366
7362,0.053479,172.31.33.0-255,66,291442,21,329366
7363,0.055792,172.217.194.0-255,5738,297180,21,329366
7364,0.055797,172.31.33.0-255,66,297246,21,329366
7365,0.058121,172.217.194.0-255,4320,301566,21,329366
7366,0.058126,172.31.33.0-255,66,301632,21,329366
7367,0.058151,172.217.194.0-255,1484,303116,21,329366
7368,0.060451,172.217.194.0-255,4320,307436,21,329366
7369,0.060455,172.31.33.0-255,66,307502,21,329366
7370,0.062912,172.217.194.0-255,5738,313240,21,329366
7371,0.06297,172.31.33.0-255,66,313306,21,329366
7372,0.065306,172.217.194.0-255,5738,319044,21,329366
7373,0.06531,172.31.33.0-255,66,319110,21,329366
7374,0.067622,172.217.194.0-255,4320,323430,21,329366
7375,0.067627,172.31.33.0-255,66,323496,21,329366
7376,0.067648,172.217.194.0-255,1484,324980,21,329366
7377,0.069937,172.217.194.0-255,4320,329300,21,329366
7378,0.069941,172.31.33.0-255,66,329366,21,329366
7379,0.0,172.31.33.0-255,105,105,21,525
7380,0.000362,172.31.33.0-255,90,195,21,525
7381,0.00039,172.31.33.0-255,66,261,21,525
7382,0.002485,172.217.194.0-255,66,327,21,525
7383,0.002496,172.217.194.0-255,66,393,21,525
7384,0.002502,172.31.33.0-255,66,459,21,525
7385,0.002505,172.217.194.0-255,66,525,21,525
7386,0.0,172.31.33.0-255,105,105,21,1377
7387,8.8e-05,172.31.33.0-255,105,210,21,1377
7388,0.000145,172.31.33.0-255,105,315,21,1377
7389,0.000333,172.31.33.0-255,90,405,21,1377
7390,0.000341,172.31.33.0-255,66,471,21,1377
7391,0.000504,172.31.33.0-255,90,561,21,1377
7392,0.000512,172.31.33.0-255,66,627,21,1377
7393,0.000658,172.31.33.0-255,90,717,21,1377
7394,0.000667,172.31.33.0-255,66,783,21,1377
7395,0.00232,172.217.194.0-255,66,849,21,1377
7396,0.002333,172.217.194.0-255,66,915,21,1377
7397,0.002342,172.31.33.0-255,66,981,21,1377
7398,0.002825,74.125.200.0-255,66,1047,21,1377
7399,0.002846,74.125.200.0-255,66,1113,21,1377
7400,0.002849,172.31.33.0-255,66,1179,21,1377
7401,0.002877,172.217.194.0-255,66,1245,21,1377
7402,0.002892,172.217.194.0-255,66,1311,21,1377
7403,0.002894,172.31.33.0-255,66,1377,21,1377
7404,0.0,74.125.24.0-255,226,226,21,200597
7405,2.4e-05,172.31.33.0-255,66,292,21,200597
7406,3.2e-05,74.125.24.0-255,1484,1776,21,200597
7407,3.6e-05,172.31.33.0-255,66,1842,21,200597
7408,5.1e-05,74.125.24.0-255,4320,6162,21,200597
7409,5.4e-05,172.31.33.0-255,66,6228,21,200597
7410,0.000176,172.31.33.0-255,66,6294,21,200597
7411,0.000547,74.125.24.0-255,7156,13450,21,200597
7412,0.000553,172.31.33.0-255,66,13516,21,200597
7413,0.000586,74.125.24.0-255,7156,20672,21,200597
7414,0.000589,172.31.33.0-255,66,20738,21,200597
7415,0.002304,74.125.24.0-255,2500,23238,21,200597
7416,0.002311,172.31.33.0-255,66,23304,21,200597
7417,0.002841,74.125.24.0-255,2902,26206,21,200597
7418,0.002845,172.31.33.0-255,66,26272,21,200597
7419,0.004552,74.125.24.0-255,2902,29174,21,200597
7420,0.004558,172.31.33.0-255,66,29240,21,200597
7421,0.005071,74.125.24.0-255,2902,32142,21,200597
7422,0.005075,172.31.33.0-255,66,32208,21,200597
7423,0.006825,74.125.24.0-255,2902,35110,21,200597
7424,0.006832,172.31.33.0-255,66,35176,21,200597
7425,0.007306,74.125.24.0-255,468,35644,21,200597
7426,0.007312,172.31.33.0-255,66,35710,21,200597
7427,0.007343,74.125.24.0-255,1484,37194,21,200597
7428,0.007346,172.31.33.0-255,66,37260,21,200597
7429,0.009078,74.125.24.0-255,2902,40162,21,200597
7430,0.009086,172.31.33.0-255,66,40228,21,200597
7431,0.009618,74.125.24.0-255,2902,43130,21,200597
7432,0.009625,172.31.33.0-255,66,43196,21,200597
7433,0.011331,74.125.24.0-255,2902,46098,21,200597
7434,0.011339,172.31.33.0-255,66,46164,21,200597
7435,0.01188,74.125.24.0-255,2902,49066,21,200597
7436,0.011888,172.31.33.0-255,66,49132,21,200597
7437,0.013597,74.125.24.0-255,1484,50616,21,200597
7438,0.013603,172.31.33.0-255,66,50682,21,200597
7439,0.014137,74.125.24.0-255,4320,55002,21,200597
7440,0.014143,172.31.33.0-255,66,55068,21,200597
7441,0.015859,74.125.24.0-255,1484,56552,21,200597
7442,0.015867,172.31.33.0-255,66,56618,21,200597
7443,0.016398,74.125.24.0-255,4320,60938,21,200597
7444,0.016404,172.31.33.0-255,66,61004,21,200597
7445,0.01811,74.125.24.0-255,1484,62488,21,200597
7446,0.018117,172.31.33.0-255,66,62554,21,200597
7447,0.018653,74.125.24.0-255,2902,65456,21,200597
7448,0.018658,172.31.33.0-255,66,65522,21,200597
7449,0.018704,74.125.24.0-255,1484,67006,21,200597
7450,0.018708,172.31.33.0-255,66,67072,21,200597
7451,0.020381,74.125.24.0-255,1484,68556,21,200597
7452,0.02039,172.31.33.0-255,66,68622,21,200597
7453,0.02093,74.125.24.0-255,2902,71524,21,200597
7454,0.020937,172.31.33.0-255,66,71590,21,200597
7455,0.020969,74.125.24.0-255,1484,73074,21,200597
7456,0.022655,74.125.24.0-255,1484,74558,21,200597
7457,0.022663,172.31.33.0-255,66,74624,21,200597
7458,0.023204,74.125.24.0-255,2902,77526,21,200597
7459,0.023211,172.31.33.0-255,66,77592,21,200597
7460,0.024933,74.125.24.0-255,2902,80494,21,200597
7461,0.024939,172.31.33.0-255,66,80560,21,200597
7462,0.025393,172.31.33.0-255,172,80732,21,200597
7463,0.025418,172.31.33.0-255,1113,81845,21,200597
7464,0.025476,74.125.24.0-255,2902,84747,21,200597
7465,0.02548,172.31.33.0-255,66,84813,21,200597
7466,0.025505,172.31.33.0-255,1514,86327,21,200597
7467,0.025506,172.31.33.0-255,1288,87615,21,200597
7468,0.026951,104.244.42.0-255,66,87681,21,200597
7469,0.027034,104.244.42.0-255,66,87747,21,200597
7470,0.027107,104.244.42.0-255,66,87813,21,200597
7471,0.027193,74.125.24.0-255,2902,90715,21,200597
7472,0.027199,172.31.33.0-255,66,90781,21,200597
7473,0.027708,74.125.24.0-255,2902,93683,21,200597
7474,0.027714,172.31.33.0-255,66,93749,21,200597
7475,0.029458,74.125.24.0-255,2902,96651,21,200597
7476,0.029467,172.31.33.0-255,66,96717,21,200597
7477,0.029982,74.125.24.0-255,2902,99619,21,200597
7478,0.029987,172.31.33.0-255,66,99685,21,200597
7479,0.031706,74.125.24.0-255,2902,102587,21,200597
7480,0.031711,172.31.33.0-255,66,102653,21,200597
7481,0.032229,74.125.24.0-255,2902,105555,21,200597
7482,0.032235,172.31.33.0-255,66,105621,21,200597
7483,0.033966,74.125.24.0-255,2902,108523,21,200597
7484,0.033973,172.31.33.0-255,66,108589,21,200597
7485,0.034476,74.125.24.0-255,2902,111491,21,200597
7486,0.034482,172.31.33.0-255,66,111557,21,200597
7487,0.036221,74.125.24.0-255,2902,114459,21,200597
7488,0.036228,172.31.33.0-255,66,114525,21,200597
7489,0.036753,74.125.24.0-255,2902,117427,21,200597
7490,0.03676,172.31.33.0-255,66,117493,21,200597
7491,0.038465,74.125.24.0-255,2902,120395,21,200597
7492,0.038472,172.31.33.0-255,66,120461,21,200597
7493,0.038998,74.125.24.0-255,2902,123363,21,200597
7494,0.039003,172.31.33.0-255,66,123429,21,200597
7495,0.040746,74.125.24.0-255,2902,126331,21,200597
7496,0.040753,172.31.33.0-255,66,126397,21,200597
7497,0.041244,74.125.24.0-255,2902,129299,21,200597
7498,0.041249,172.31.33.0-255,66,129365,21,200597
7499,0.043025,74.125.24.0-255,2902,132267,21,200597
7500,0.043031,172.31.33.0-255,66,132333,21,200597
7501,0.043495,74.125.24.0-255,2902,135235,21,200597
7502,0.0435,172.31.33.0-255,66,135301,21,200597
7503,0.045282,74.125.24.0-255,2902,138203,21,200597
7504,0.045288,172.31.33.0-255,66,138269,21,200597
7505,0.045755,74.125.24.0-255,2902,141171,21,200597
7506,0.045761,172.31.33.0-255,66,141237,21,200597
7507,0.047532,74.125.24.0-255,2902,144139,21,200597
7508,0.047539,172.31.33.0-255,66,144205,21,200597
7509,0.047987,74.125.24.0-255,2902,147107,21,200597
7510,0.047992,172.31.33.0-255,66,147173,21,200597
7511,0.049811,74.125.24.0-255,2902,150075,21,200597
7512,0.049817,172.31.33.0-255,66,150141,21,200597
7513,0.050227,74.125.24.0-255,2902,153043,21,200597
7514,0.050234,172.31.33.0-255,66,153109,21,200597
7515,0.052078,74.125.24.0-255,2902,156011,21,200597
7516,0.052084,172.31.33.0-255,66,156077,21,200597
7517,0.052471,74.125.24.0-255,2902,158979,21,200597
7518,0.052477,172.31.33.0-255,66,159045,21,200597
7519,0.054378,74.125.24.0-255,2902,161947,21,200597
7520,0.054392,172.31.33.0-255,66,162013,21,200597
7521,0.054708,74.125.24.0-255,2902,164915,21,200597
7522,0.054714,172.31.33.0-255,66,164981,21,200597
7523,0.056654,74.125.24.0-255,2902,167883,21,200597
7524,0.05666,172.31.33.0-255,66,167949,21,200597
7525,0.056979,74.125.24.0-255,2902,170851,21,200597
7526,0.056984,172.31.33.0-255,66,170917,21,200597
7527,0.058921,74.125.24.0-255,2902,173819,21,200597
7528,0.058928,172.31.33.0-255,66,173885,21,200597
7529,0.059232,74.125.24.0-255,2902,176787,21,200597
7530,0.059239,172.31.33.0-255,66,176853,21,200597
7531,0.061199,74.125.24.0-255,2902,179755,21,200597
7532,0.061206,172.31.33.0-255,66,179821,21,200597
7533,0.061481,74.125.24.0-255,2902,182723,21,200597
7534,0.061489,172.31.33.0-255,66,182789,21,200597
7535,0.063455,74.125.24.0-255,2902,185691,21,200597
7536,0.063461,172.31.33.0-255,66,185757,21,200597
7537,0.063747,74.125.24.0-255,2902,188659,21,200597
7538,0.063751,172.31.33.0-255,66,188725,21,200597
7539,0.065701,74.125.24.0-255,2902,191627,21,200597
7540,0.065708,172.31.33.0-255,66,191693,21,200597
7541,0.066008,74.125.24.0-255,2902,194595,21,200597
7542,0.066014,172.31.33.0-255,66,194661,21,200597
7543,0.067974,74.125.24.0-255,2902,197563,21,200597
7544,0.06798,172.31.33.0-255,66,197629,21,200597
7545,0.068266,74.125.24.0-255,2902,200531,21,200597
7546,0.068272,172.31.33.0-255,66,200597,21,200597
7547,0.0,172.31.33.0-255,105,105,21,918
7548,7.3e-05,172.31.33.0-255,105,210,21,918
7549,0.00043,172.31.33.0-255,90,300,21,918
7550,0.000439,172.31.33.0-255,66,366,21,918
7551,0.000623,172.31.33.0-255,90,456,21,918
7552,0.000631,172.31.33.0-255,66,522,21,918
7553,0.002948,74.125.24.0-255,66,588,21,918
7554,0.002977,74.125.24.0-255,66,654,21,918
7555,0.002999,172.31.33.0-255,66,720,21,918
7556,0.003003,74.125.24.0-255,66,786,21,918
7557,0.003024,74.125.24.0-255,66,852,21,918
7558,0.003036,172.31.33.0-255,66,918,21,918
7559,0.0,74.125.68.0-255,143,143,21,387034
7560,3.3e-05,172.31.33.0-255,66,209,21,387034
7561,4e-05,74.125.68.0-255,1484,1693,21,387034
7562,4.5e-05,172.31.33.0-255,66,1759,21,387034
7563,4.9e-05,74.125.68.0-255,2902,4661,21,387034
7564,5.2e-05,172.31.33.0-255,66,4727,21,387034
7565,5.5e-05,74.125.68.0-255,1484,6211,21,387034
7566,5.7e-05,172.31.33.0-255,66,6277,21,387034
7567,7.1e-05,74.125.68.0-255,1484,7761,21,387034
7568,7.4e-05,172.31.33.0-255,66,7827,21,387034
7569,9.5e-05,74.125.68.0-255,1484,9311,21,387034
7570,9.8e-05,172.31.33.0-255,66,9377,21,387034
7571,0.000102,74.125.68.0-255,2902,12279,21,387034
7572,0.000104,172.31.33.0-255,66,12345,21,387034
7573,0.000157,74.125.68.0-255,2013,14358,21,387034
7574,0.000161,172.31.33.0-255,66,14424,21,387034
7575,0.000261,74.125.68.0-255,1484,15908,21,387034
7576,0.000265,172.31.33.0-255,66,15974,21,387034
7577,0.000269,74.125.68.0-255,1484,17458,21,387034
7578,0.000271,172.31.33.0-255,66,17524,21,387034
7579,0.000284,74.125.68.0-255,1484,19008,21,387034
7580,0.000286,172.31.33.0-255,66,19074,21,387034
7581,0.000291,74.125.68.0-255,2902,21976,21,387034
7582,0.000293,172.31.33.0-255,66,22042,21,387034
7583,0.000312,74.125.68.0-255,2902,24944,21,387034
7584,0.000314,172.31.33.0-255,66,25010,21,387034
7585,0.000321,74.125.68.0-255,4320,29330,21,387034
7586,0.000324,172.31.33.0-255,66,29396,21,387034
7587,0.000329,74.125.68.0-255,5379,34775,21,387034
7588,0.000331,172.31.33.0-255,66,34841,21,387034
7589,0.000351,74.125.68.0-255,2902,37743,21,387034
7590,0.000354,172.31.33.0-255,66,37809,21,387034
7591,0.000374,74.125.68.0-255,4320,42129,21,387034
7592,0.000377,172.31.33.0-255,66,42195,21,387034
7593,0.000383,74.125.68.0-255,5738,47933,21,387034
7594,0.000386,172.31.33.0-255,66,47999,21,387034
7595,0.000403,74.125.68.0-255,2902,50901,21,387034
7596,0.000407,172.31.33.0-255,66,50967,21,387034
7597,0.000415,74.125.68.0-255,1484,52451,21,387034
7598,0.000436,74.125.68.0-255,5738,58189,21,387034
7599,0.000439,172.31.33.0-255,66,58255,21,387034
7600,0.000459,74.125.68.0-255,5738,63993,21,387034
7601,0.000462,172.31.33.0-255,66,64059,21,387034
7602,0.000466,74.125.68.0-255,2184,66243,21,387034
7603,0.000469,172.31.33.0-255,66,66309,21,387034
7604,0.000764,74.125.68.0-255,400,66709,21,387034
7605,0.000838,74.125.68.0-255,110,66819,21,387034
7606,0.000859,172.31.33.0-255,66,66885,21,387034
7607,0.000878,74.125.68.0-255,1484,68369,21,387034
7608,0.000902,74.125.68.0-255,2902,71271,21,387034
7609,0.000905,172.31.33.0-255,66,71337,21,387034
7610,0.000909,74.125.68.0-255,1484,72821,21,387034
7611,0.000912,74.125.68.0-255,2902,75723,21,387034
7612,0.000914,172.31.33.0-255,66,75789,21,387034
7613,0.000945,74.125.68.0-255,5738,81527,21,387034
7614,0.000949,172.31.33.0-255,66,81593,21,387034
7615,0.000952,74.125.68.0-255,1484,83077,21,387034
7616,0.000978,172.31.33.0-255,66,83143,21,387034
7617,0.000995,74.125.68.0-255,1484,84627,21,387034
7618,0.001013,74.125.68.0-255,4320,88947,21,387034
7619,0.001016,172.31.33.0-255,66,89013,21,387034
7620,0.001055,74.125.68.0-255,3602,92615,21,387034
7621,0.001059,172.31.33.0-255,66,92681,21,387034
7622,0.001306,74.125.68.0-255,1484,94165,21,387034
7623,0.001326,74.125.68.0-255,2902,97067,21,387034
7624,0.001331,172.31.33.0-255,66,97133,21,387034
7625,0.001384,74.125.68.0-255,5738,102871,21,387034
7626,0.001387,172.31.33.0-255,66,102937,21,387034
7627,0.001396,74.125.68.0-255,7156,110093,21,387034
7628,0.001398,172.31.33.0-255,66,110159,21,387034
7629,0.001423,74.125.68.0-255,1484,111643,21,387034
7630,0.001426,74.125.68.0-255,1484,113127,21,387034
7631,0.001429,172.31.33.0-255,66,113193,21,387034
7632,0.001446,74.125.68.0-255,1484,114677,21,387034
7633,0.001452,74.125.68.0-255,5738,120415,21,387034
7634,0.001455,172.31.33.0-255,66,120481,21,387034
7635,0.001459,74.125.68.0-255,2902,123383,21,387034
7636,0.001462,172.31.33.0-255,66,123449,21,387034
7637,0.001487,74.125.68.0-255,3602,127051,21,387034
7638,0.00149,172.31.33.0-255,66,127117,21,387034
7639,0.001628,74.125.68.0-255,1484,128601,21,387034
7640,0.001643,74.125.68.0-255,2902,131503,21,387034
7641,0.001647,172.31.33.0-255,66,131569,21,387034
7642,0.001652,74.125.68.0-255,1484,133053,21,387034
7643,0.001669,74.125.68.0-255,4320,137373,21,387034
7644,0.001672,172.31.33.0-255,66,137439,21,387034
7645,0.001676,74.125.68.0-255,2902,140341,21,387034
7646,0.001678,172.31.33.0-255,66,140407,21,387034
7647,0.001697,74.125.68.0-255,2902,143309,21,387034
7648,0.0017,172.31.33.0-255,66,143375,21,387034
7649,0.001723,74.125.68.0-255,7156,150531,21,387034
7650,0.001725,172.31.33.0-255,66,150597,21,387034
7651,0.001731,74.125.68.0-255,5738,156335,21,387034
7652,0.001734,172.31.33.0-255,66,156401,21,387034
7653,0.001782,74.125.68.0-255,5020,161421,21,387034
7654,0.001787,172.31.33.0-255,66,161487,21,387034
7655,0.001938,74.125.68.0-255,1484,162971,21,387034
7656,0.001944,74.125.68.0-255,2902,165873,21,387034
7657,0.001947,172.31.33.0-255,66,165939,21,387034
7658,0.001968,74.125.68.0-255,5738,171677,21,387034
7659,0.001971,172.31.33.0-255,66,171743,21,387034
7660,0.001975,74.125.68.0-255,2902,174645,21,387034
7661,0.001977,172.31.33.0-255,66,174711,21,387034
7662,0.001979,74.125.68.0-255,1484,176195,21,387034
7663,0.001992,74.125.68.0-255,2902,179097,21,387034
7664,0.001994,172.31.33.0-255,66,179163,21,387034
7665,0.002027,172.31.33.0-255,66,179229,21,387034
7666,0.002034,74.125.68.0-255,7156,186385,21,387034
7667,0.002037,172.31.33.0-255,66,186451,21,387034
7668,0.002066,74.125.68.0-255,5020,191471,21,387034
7669,0.002068,172.31.33.0-255,66,191537,21,387034
7670,0.004077,74.125.68.0-255,1484,193021,21,387034
7671,0.004097,74.125.68.0-255,4320,197341,21,387034
7672,0.0041,172.31.33.0-255,66,197407,21,387034
7673,0.006111,74.125.68.0-255,2902,200309,21,387034
7674,0.006114,172.31.33.0-255,66,200375,21,387034
7675,0.006125,74.125.68.0-255,2902,203277,21,387034
7676,0.006127,172.31.33.0-255,66,203343,21,387034
7677,0.008135,74.125.68.0-255,2902,206245,21,387034
7678,0.008141,172.31.33.0-255,66,206311,21,387034
7679,0.008162,74.125.68.0-255,2902,209213,21,387034
7680,0.008165,172.31.33.0-255,66,209279,21,387034
7681,0.01017,74.125.68.0-255,2902,212181,21,387034
7682,0.010181,172.31.33.0-255,66,212247,21,387034
7683,0.010202,74.125.68.0-255,2902,215149,21,387034
7684,0.010205,172.31.33.0-255,66,215215,21,387034
7685,0.012208,74.125.68.0-255,2902,218117,21,387034
7686,0.012215,172.31.33.0-255,66,218183,21,387034
7687,0.012238,74.125.68.0-255,2902,221085,21,387034
7688,0.012241,172.31.33.0-255,66,221151,21,387034
7689,0.014245,74.125.68.0-255,2902,224053,21,387034
7690,0.014252,172.31.33.0-255,66,224119,21,387034
7691,0.014281,74.125.68.0-255,2902,227021,21,387034
7692,0.014284,172.31.33.0-255,66,227087,21,387034
7693,0.01629,74.125.68.0-255,2902,229989,21,387034
7694,0.016296,172.31.33.0-255,66,230055,21,387034
7695,0.016318,74.125.68.0-255,2902,232957,21,387034
7696,0.016321,172.31.33.0-255,66,233023,21,387034
7697,0.018326,74.125.68.0-255,4320,237343,21,387034
7698,0.01834,172.31.33.0-255,66,237409,21,387034
7699,0.018359,74.125.68.0-255,1484,238893,21,387034
7700,0.020376,74.125.68.0-255,4320,243213,21,387034
7701,0.020392,172.31.33.0-255,66,243279,21,387034
7702,0.022436,74.125.68.0-255,5738,249017,21,387034
7703,0.02245,172.31.33.0-255,66,249083,21,387034
7704,0.024499,74.125.68.0-255,5738,254821,21,387034
7705,0.024516,172.31.33.0-255,66,254887,21,387034
7706,0.026546,74.125.68.0-255,5738,260625,21,387034
7707,0.026558,172.31.33.0-255,66,260691,21,387034
7708,0.028594,74.125.68.0-255,5738,266429,21,387034
7709,0.028605,172.31.33.0-255,66,266495,21,387034
7710,0.030649,74.125.68.0-255,5738,272233,21,387034
7711,0.030662,172.31.33.0-255,66,272299,21,387034
7712,0.032744,74.125.68.0-255,5738,278037,21,387034
7713,0.032753,172.31.33.0-255,66,278103,21,387034
7714,0.034799,74.125.68.0-255,5738,283841,21,387034
7715,0.034814,172.31.33.0-255,66,283907,21,387034
7716,0.036833,74.125.68.0-255,5738,289645,21,387034
7717,0.036839,172.31.33.0-255,66,289711,21,387034
7718,0.038358,172.31.33.0-255,172,289883,21,387034
7719,0.03877,172.31.33.0-255,1113,290996,21,387034
7720,0.03884,172.31.33.0-255,1514,292510,21,387034
7721,0.038842,172.31.33.0-255,1288,293798,21,387034
7722,0.038869,74.125.68.0-255,5738,299536,21,387034
7723,0.038875,172.31.33.0-255,66,299602,21,387034
7724,0.039899,104.244.42.0-255,66,299668,21,387034
7725,0.040404,104.244.42.0-255,66,299734,21,387034
7726,0.040448,104.244.42.0-255,66,299800,21,387034
7727,0.040843,104.244.42.0-255,108,299908,21,387034
7728,0.04085,172.31.33.0-255,66,299974,21,387034
7729,0.040914,74.125.68.0-255,5738,305712,21,387034
7730,0.040918,172.31.33.0-255,66,305778,21,387034
7731,0.042955,74.125.68.0-255,5738,311516,21,387034
7732,0.042962,172.31.33.0-255,66,311582,21,387034
7733,0.045,74.125.68.0-255,5738,317320,21,387034
7734,0.045008,172.31.33.0-255,66,317386,21,387034
7735,0.047044,74.125.68.0-255,5738,323124,21,387034
7736,0.047051,172.31.33.0-255,66,323190,21,387034
7737,0.04908,74.125.68.0-255,5738,328928,21,387034
7738,0.049087,172.31.33.0-255,66,328994,21,387034
7739,0.051124,74.125.68.0-255,5738,334732,21,387034
7740,0.051129,172.31.33.0-255,66,334798,21,387034
7741,0.053166,74.125.68.0-255,5738,340536,21,387034
7742,0.053172,172.31.33.0-255,66,340602,21,387034
7743,0.055201,74.125.68.0-255,5738,346340,21,387034
7744,0.055209,172.31.33.0-255,66,346406,21,387034
7745,0.057247,74.125.68.0-255,5738,352144,21,387034
7746,0.057258,172.31.33.0-255,66,352210,21,387034
7747,0.059297,74.125.68.0-255,5738,357948,21,387034
7748,0.059304,172.31.33.0-255,66,358014,21,387034
7749,0.061344,74.125.68.0-255,5738,363752,21,387034
7750,0.061352,172.31.33.0-255,66,363818,21,387034
7751,0.063388,74.125.68.0-255,5738,369556,21,387034
7752,0.063396,172.31.33.0-255,66,369622,21,387034
7753,0.065427,74.125.68.0-255,5738,375360,21,387034
7754,0.065434,172.31.33.0-255,66,375426,21,387034
7755,0.067449,74.125.68.0-255,5738,381164,21,387034
7756,0.067455,172.31.33.0-255,66,381230,21,387034
7757,0.069489,74.125.68.0-255,5738,386968,21,387034
7758,0.069495,172.31.33.0-255,66,387034,21,387034
7759,0.0,172.31.33.0-255,105,105,21,459
7760,0.000328,172.31.33.0-255,90,195,21,459
7761,0.000337,172.31.33.0-255,66,261,21,459
7762,0.002441,74.125.24.0-255,66,327,21,459
7763,0.002472,74.125.24.0-255,66,393,21,459
7764,0.002495,172.31.33.0-255,66,459,21,459
7765,0.0,74.125.24.0-255,66,66,21,132
7766,0.035596,172.31.33.0-255,66,132,21,132
7767,0.0,172.217.194.0-255,153,153,21,239248
7768,2.8e-05,172.31.33.0-255,66,219,21,239248
7769,3.5e-05,172.217.194.0-255,1484,1703,21,239248
7770,3.9e-05,172.31.33.0-255,66,1769,21,239248
7771,4.2e-05,172.217.194.0-255,2902,4671,21,239248
7772,4.4e-05,172.31.33.0-255,66,4737,21,239248
7773,5.9e-05,172.217.194.0-255,7156,11893,21,239248
7774,6.3e-05,172.31.33.0-255,66,11959,21,239248
7775,9.5e-05,172.217.194.0-255,2076,14035,21,239248
7776,9.7e-05,172.31.33.0-255,66,14101,21,239248
7777,0.000126,172.217.194.0-255,2902,17003,21,239248
7778,0.00013,172.31.33.0-255,66,17069,21,239248
7779,0.000136,172.217.194.0-255,5738,22807,21,239248
7780,0.000139,172.31.33.0-255,66,22873,21,239248
7781,0.000198,172.31.33.0-255,66,22939,21,239248
7782,0.000208,172.31.33.0-255,66,23005,21,239248
7783,0.00025,172.31.33.0-255,66,23071,21,239248
7784,0.00026,172.31.33.0-255,66,23137,21,239248
7785,0.000302,172.31.33.0-255,66,23203,21,239248
7786,0.000495,172.217.194.0-255,119,23322,21,239248
7787,0.000502,172.31.33.0-255,66,23388,21,239248
7788,0.000527,172.217.194.0-255,382,23770,21,239248
7789,0.000531,172.31.33.0-255,66,23836,21,239248
7790,0.000685,172.217.194.0-255,1484,25320,21,239248
7791,0.000689,172.31.33.0-255,66,25386,21,239248
7792,0.000695,172.217.194.0-255,2902,28288,21,239248
7793,0.000697,172.31.33.0-255,66,28354,21,239248
7794,0.000719,172.217.194.0-255,5738,34092,21,239248
7795,0.000722,172.31.33.0-255,66,34158,21,239248
7796,0.000767,172.31.33.0-255,66,34224,21,239248
7797,0.000778,172.31.33.0-255,66,34290,21,239248
7798,0.000781,172.217.194.0-255,766,35056,21,239248
7799,0.00105,172.217.194.0-255,1484,36540,21,239248
7800,0.00105,172.31.33.0-255,66,36606,21,239248
7801,0.001054,172.217.194.0-255,2902,39508,21,239248
7802,0.001056,172.31.33.0-255,66,39574,21,239248
7803,0.001078,172.217.194.0-255,5738,45312,21,239248
7804,0.001081,172.31.33.0-255,66,45378,21,239248
7805,0.001092,172.217.194.0-255,7156,52534,21,239248
7806,0.001095,172.31.33.0-255,66,52600,21,239248
7807,0.001122,172.217.194.0-255,5738,58338,21,239248
7808,0.001126,172.31.33.0-255,66,58404,21,239248
7809,0.001136,172.31.33.0-255,66,58470,21,239248
7810,0.001139,172.217.194.0-255,766,59236,21,239248
7811,0.001245,172.217.194.0-255,1484,60720,21,239248
7812,0.001249,172.31.33.0-255,66,60786,21,239248
7813,0.001253,172.217.194.0-255,1484,62270,21,239248
7814,0.001276,172.217.194.0-255,1484,63754,21,239248
7815,0.001278,172.31.33.0-255,66,63820,21,239248
7816,0.001285,172.217.194.0-255,5738,69558,21,239248
7817,0.001288,172.31.33.0-255,66,69624,21,239248
7818,0.001291,172.217.194.0-255,1484,71108,21,239248
7819,0.001337,172.31.33.0-255,66,71174,21,239248
7820,0.001349,172.31.33.0-255,66,71240,21,239248
7821,0.001378,172.217.194.0-255,1484,72724,21,239248
7822,0.001382,172.217.194.0-255,2902,75626,21,239248
7823,0.001387,172.217.194.0-255,5738,81364,21,239248
7824,0.001387,172.31.33.0-255,66,81430,21,239248
7825,0.00139,172.31.33.0-255,66,81496,21,239248
7826,0.001413,172.217.194.0-255,7156,88652,21,239248
7827,0.001417,172.31.33.0-255,66,88718,21,239248
7828,0.001449,172.217.194.0-255,5738,94456,21,239248
7829,0.001454,172.31.33.0-255,66,94522,21,239248
7830,0.001455,172.217.194.0-255,7156,101678,21,239248
7831,0.001457,172.31.33.0-255,66,101744,21,239248
7832,0.001471,172.217.194.0-255,1484,103228,21,239248
7833,0.001515,172.31.33.0-255,66,103294,21,239248
7834,0.001529,172.31.33.0-255,66,103360,21,239248
7835,0.001535,172.217.194.0-255,6438,109798,21,239248
7836,0.001538,172.31.33.0-255,66,109864,21,239248
7837,0.001793,172.217.194.0-255,1484,111348,21,239248
7838,0.0018,172.217.194.0-255,2902,114250,21,239248
7839,0.001803,172.31.33.0-255,66,114316,21,239248
7840,0.001834,172.217.194.0-255,5738,120054,21,239248
7841,0.001837,172.217.194.0-255,2902,122956,21,239248
7842,0.001838,172.31.33.0-255,66,123022,21,239248
7843,0.001841,172.31.33.0-255,66,123088,21,239248
7844,0.001884,172.31.33.0-255,66,123154,21,239248
7845,0.001898,172.31.33.0-255,66,123220,21,239248
7846,0.002084,172.217.194.0-255,1484,124704,21,239248
7847,0.0021,172.217.194.0-255,2902,127606,21,239248
7848,0.002103,172.31.33.0-255,66,127672,21,239248
7849,0.002108,172.217.194.0-255,2902,130574,21,239248
7850,0.002113,172.31.33.0-255,66,130640,21,239248
7851,0.00213,172.217.194.0-255,2902,133542,21,239248
7852,0.002132,172.31.33.0-255,66,133608,21,239248
7853,0.002147,172.31.33.0-255,66,133674,21,239248
7854,0.002195,172.31.33.0-255,66,133740,21,239248
7855,0.002224,172.217.194.0-255,1484,135224,21,239248
7856,0.002245,172.217.194.0-255,2902,138126,21,239248
7857,0.002248,172.31.33.0-255,66,138192,21,239248
7858,0.002255,172.217.194.0-255,5738,143930,21,239248
7859,0.002257,172.31.33.0-255,66,143996,21,239248
7860,0.002293,172.31.33.0-255,66,144062,21,239248
7861,0.0023,172.217.194.0-255,7156,151218,21,239248
7862,0.002303,172.31.33.0-255,66,151284,21,239248
7863,0.002327,172.217.194.0-255,3602,154886,21,239248
7864,0.002331,172.31.33.0-255,66,154952,21,239248
7865,0.004667,172.217.194.0-255,1484,156436,21,239248
7866,0.004718,172.217.194.0-255,4320,160756,21,239248
7867,0.004722,172.31.33.0-255,66,160822,21,239248
7868,0.00712,172.217.194.0-255,5738,166560,21,239248
7869,0.007126,172.31.33.0-255,66,166626,21,239248
7870,0.009522,172.217.194.0-255,5738,172364,21,239248
7871,0.009542,172.31.33.0-255,66,172430,21,239248
7872,0.011975,172.217.194.0-255,5738,178168,21,239248
7873,0.011986,172.31.33.0-255,66,178234,21,239248
7874,0.01435,172.217.194.0-255,5738,183972,21,239248
7875,0.014356,172.31.33.0-255,66,184038,21,239248
7876,0.016748,172.217.194.0-255,5738,189776,21,239248
7877,0.016755,172.31.33.0-255,66,189842,21,239248
7878,0.019127,172.217.194.0-255,5738,195580,21,239248
7879,0.019141,172.31.33.0-255,66,195646,21,239248
7880,0.021575,172.217.194.0-255,5738,201384,21,239248
7881,0.021583,172.31.33.0-255,66,201450,21,239248
7882,0.023984,172.217.194.0-255,5738,207188,21,239248
7883,0.02399,172.31.33.0-255,66,207254,21,239248
7884,0.026401,172.217.194.0-255,5738,212992,21,239248
7885,0.026407,172.31.33.0-255,66,213058,21,239248
7886,0.028782,172.217.194.0-255,5738,218796,21,239248
7887,0.028799,172.31.33.0-255,66,218862,21,239248
7888,0.031209,172.217.194.0-255,5738,224600,21,239248
7889,0.031216,172.31.33.0-255,66,224666,21,239248
7890,0.033593,172.217.194.0-255,5738,230404,21,239248
7891,0.03361,172.31.33.0-255,66,230470,21,239248
7892,0.035966,172.31.33.0-255,172,230642,21,239248
7893,0.035997,172.31.33.0-255,1113,231755,21,239248
7894,0.036009,172.217.194.0-255,4254,236009,21,239248
7895,0.036014,172.31.33.0-255,66,236075,21,239248
7896,0.036026,172.31.33.0-255,1514,237589,21,239248
7897,0.036027,172.31.33.0-255,1290,238879,21,239248
7898,0.03615,172.31.33.0-255,105,238984,21,239248
7899,0.037472,104.244.42.0-255,66,239050,21,239248
7900,0.037537,104.244.42.0-255,66,239116,21,239248
7901,0.037539,104.244.42.0-255,66,239182,21,239248
7902,0.038464,172.217.194.0-255,66,239248,21,239248
7903,0.0,172.31.33.0-255,105,105,21,459
7904,0.000341,172.31.33.0-255,90,195,21,459
7905,0.000351,172.31.33.0-255,66,261,21,459
7906,0.002369,172.217.194.0-255,66,327,21,459
7907,0.002385,172.217.194.0-255,66,393,21,459
7908,0.002396,172.31.33.0-255,66,459,21,459
7909,0.0,172.31.33.0-255,105,105,21,459
7910,0.000247,172.31.33.0-255,90,195,21,459
7911,0.000257,172.31.33.0-255,66,261,21,459
7912,0.002779,172.217.194.0-255,66,327,21,459
7913,0.002794,172.217.194.0-255,66,393,21,459
7914,0.002807,172.31.33.0-255,66,459,21,459
7915,0.0,74.125.68.0-255,146,146,21,246410
7916,2.7e-05,172.31.33.0-255,66,212,21,246410
7917,3.4e-05,74.125.68.0-255,1484,1696,21,246410
7918,3.9e-05,172.31.33.0-255,66,1762,21,246410
7919,4.4e-05,74.125.68.0-255,2902,4664,21,246410
7920,5.3e-05,172.31.33.0-255,66,4730,21,246410
7921,8e-05,74.125.68.0-255,4320,9050,21,246410
7922,8.2e-05,172.31.33.0-255,66,9116,21,246410
7923,0.000129,74.125.68.0-255,4893,14009,21,246410
7924,0.000133,172.31.33.0-255,66,14075,21,246410
7925,0.000138,74.125.68.0-255,5738,19813,21,246410
7926,0.00014,172.31.33.0-255,66,19879,21,246410
7927,0.000179,172.31.33.0-255,66,19945,21,246410
7928,0.000554,74.125.68.0-255,1484,21429,21,246410
7929,0.000559,172.31.33.0-255,66,21495,21,246410
7930,0.000567,74.125.68.0-255,2902,24397,21,246410
7931,0.000569,172.31.33.0-255,66,24463,21,246410
7932,0.00058,74.125.68.0-255,2902,27365,21,246410
7933,0.000582,172.31.33.0-255,66,27431,21,246410
7934,0.000607,74.125.68.0-255,1484,28915,21,246410
7935,0.00061,172.31.33.0-255,66,28981,21,246410
7936,0.000622,172.31.33.0-255,66,29047,21,246410
7937,0.000626,74.125.68.0-255,4320,33367,21,246410
7938,0.000628,172.31.33.0-255,66,33433,21,246410
7939,0.00067,74.125.68.0-255,5738,39171,21,246410
7940,0.000673,172.31.33.0-255,66,39237,21,246410
7941,0.0007,74.125.68.0-255,5691,44928,21,246410
7942,0.000704,172.31.33.0-255,66,44994,21,246410
7943,0.000777,74.125.68.0-255,345,45339,21,246410
7944,0.00078,172.31.33.0-255,66,45405,21,246410
7945,0.000878,74.125.68.0-255,1484,46889,21,246410
7946,0.000898,74.125.68.0-255,2902,49791,21,246410
7947,0.000932,74.125.68.0-255,2902,52693,21,246410
7948,0.000944,74.125.68.0-255,2902,55595,21,246410
7949,0.000954,74.125.68.0-255,4320,59915,21,246410
7950,0.000966,74.125.68.0-255,2543,62458,21,246410
7951,0.000999,74.125.68.0-255,1484,63942,21,246410
7952,0.001013,74.125.68.0-255,2902,66844,21,246410
7953,0.001026,74.125.68.0-255,1484,68328,21,246410
7954,0.001039,74.125.68.0-255,2902,71230,21,246410
7955,0.001044,74.125.68.0-255,4320,75550,21,246410
7956,0.001057,74.125.68.0-255,1484,77034,21,246410
7957,0.001081,74.125.68.0-255,2543,79577,21,246410
7958,0.005104,172.31.33.0-255,66,79643,21,246410
7959,0.007113,74.125.68.0-255,5738,85381,21,246410
7960,0.007121,172.31.33.0-255,66,85447,21,246410
7961,0.009121,74.125.68.0-255,5738,91185,21,246410
7962,0.009731,172.31.33.0-255,66,91251,21,246410
7963,0.011732,74.125.68.0-255,5738,96989,21,246410
7964,0.011744,172.31.33.0-255,66,97055,21,246410
7965,0.013743,74.125.68.0-255,5738,102793,21,246410
7966,0.013752,172.31.33.0-255,66,102859,21,246410
7967,0.015751,74.125.68.0-255,5738,108597,21,246410
7968,0.015758,172.31.33.0-255,66,108663,21,246410
7969,0.017761,74.125.68.0-255,4320,112983,21,246410
7970,0.017768,172.31.33.0-255,66,113049,21,246410
7971,0.017796,74.125.68.0-255,1484,114533,21,246410
7972,0.019772,74.125.68.0-255,4320,118853,21,246410
7973,0.01978,172.31.33.0-255,66,118919,21,246410
7974,0.02178,74.125.68.0-255,5738,124657,21,246410
7975,0.021838,172.31.33.0-255,66,124723,21,246410
7976,0.023862,74.125.68.0-255,5738,130461,21,246410
7977,0.023869,172.31.33.0-255,66,130527,21,246410
7978,0.02582,172.31.33.0-255,172,130699,21,246410
7979,0.025852,74.125.68.0-255,1484,132183,21,246410
7980,0.025859,172.31.33.0-255,1113,133296,21,246410
7981,0.025879,74.125.68.0-255,4320,137616,21,246410
7982,0.025883,172.31.33.0-255,66,137682,21,246410
7983,0.025974,172.31.33.0-255,1514,139196,21,246410
7984,0.025976,172.31.33.0-255,1290,140486,21,246410
7985,0.027388,104.244.42.0-255,66,140552,21,246410
7986,0.027396,104.244.42.0-255,66,140618,21,246410
7987,0.027524,104.244.42.0-255,66,140684,21,246410
7988,0.027881,74.125.68.0-255,5738,146422,21,246410
7989,0.027888,172.31.33.0-255,66,146488,21,246410
7990,0.029869,74.125.68.0-255,1484,147972,21,246410
7991,0.029893,74.125.68.0-255,4320,152292,21,246410
7992,0.029897,172.31.33.0-255,66,152358,21,246410
7993,0.031883,74.125.68.0-255,1484,153842,21,246410
7994,0.031913,74.125.68.0-255,4320,158162,21,246410
7995,0.031916,172.31.33.0-255,66,158228,21,246410
7996,0.033907,74.125.68.0-255,2902,161130,21,246410
7997,0.033911,172.31.33.0-255,66,161196,21,246410
7998,0.033941,74.125.68.0-255,2902,164098,21,246410
7999,0.03395,172.31.33.0-255,66,164164,21,246410
8000,0.035901,74.125.68.0-255,2902,167066,21,246410
8001,0.035905,172.31.33.0-255,66,167132,21,246410
8002,0.035937,74.125.68.0-255,2902,170034,21,246410
8003,0.035946,172.31.33.0-255,66,170100,21,246410
8004,0.037913,74.125.68.0-255,2902,173002,21,246410
8005,0.037919,172.31.33.0-255,66,173068,21,246410
8006,0.037947,74.125.68.0-255,2902,175970,21,246410
8007,0.037968,172.31.33.0-255,66,176036,21,246410
8008,0.039906,74.125.68.0-255,2902,178938,21,246410
8009,0.03991,172.31.33.0-255,66,179004,21,246410
8010,0.039948,74.125.68.0-255,2902,181906,21,246410
8011,0.039973,172.31.33.0-255,66,181972,21,246410
8012,0.041892,74.125.68.0-255,2902,184874,21,246410
8013,0.041896,172.31.33.0-255,66,184940,21,246410
8014,0.04196,74.125.68.0-255,2902,187842,21,246410
8015,0.041967,172.31.33.0-255,66,187908,21,246410
8016,0.04389,74.125.68.0-255,2902,190810,21,246410
8017,0.043895,172.31.33.0-255,66,190876,21,246410
8018,0.043955,74.125.68.0-255,2902,193778,21,246410
8019,0.043975,172.31.33.0-255,66,193844,21,246410
8020,0.045921,74.125.68.0-255,2902,196746,21,246410
8021,0.045928,172.31.33.0-255,66,196812,21,246410
8022,0.045963,74.125.68.0-255,2902,199714,21,246410
8023,0.047932,74.125.68.0-255,2902,202616,21,246410
8024,0.048852,172.31.33.0-255,66,202682,21,246410
8025,0.050853,74.125.68.0-255,5738,208420,21,246410
8026,0.050859,172.31.33.0-255,66,208486,21,246410
8027,0.05286,74.125.68.0-255,5738,214224,21,246410
8028,0.052867,172.31.33.0-255,66,214290,21,246410
8029,0.05486,74.125.68.0-255,4320,218610,21,246410
8030,0.054864,172.31.33.0-255,66,218676,21,246410
8031,0.054894,74.125.68.0-255,1484,220160,21,246410
8032,0.056849,74.125.68.0-255,2902,223062,21,246410
8033,0.056853,172.31.33.0-255,66,223128,21,246410
8034,0.056883,74.125.68.0-255,1484,224612,21,246410
8035,0.058847,74.125.68.0-255,4320,228932,21,246410
8036,0.058897,172.31.33.0-255,66,228998,21,246410
8037,0.060935,74.125.68.0-255,5738,234736,21,246410
8038,0.064483,172.31.33.0-255,66,234802,21,246410
8039,0.066497,74.125.68.0-255,5738,240540,21,246410
8040,0.066515,172.31.33.0-255,66,240606,21,246410
8041,0.068528,74.125.68.0-255,5738,246344,21,246410
8042,0.068546,172.31.33.0-255,66,246410,21,246410
8043,0.0,172.217.194.0-255,143,143,21,299893
8044,1.7e-05,172.31.33.0-255,66,209,21,299893
8045,2.3e-05,172.217.194.0-255,1484,1693,21,299893
8046,2.7e-05,172.31.33.0-255,66,1759,21,299893
8047,3.2e-05,172.217.194.0-255,2902,4661,21,299893
8048,4.1e-05,172.31.33.0-255,66,4727,21,299893
8049,4.6e-05,172.217.194.0-255,4320,9047,21,299893
8050,4.9e-05,172.31.33.0-255,66,9113,21,299893
8051,7.9e-05,172.217.194.0-255,2902,12015,21,299893
8052,8.1e-05,172.31.33.0-255,66,12081,21,299893
8053,8.6e-05,172.217.194.0-255,2020,14101,21,299893
8054,8.8e-05,172.31.33.0-255,66,14167,21,299893
8055,0.000106,172.217.194.0-255,1484,15651,21,299893
8056,0.000108,172.31.33.0-255,66,15717,21,299893
8057,0.000144,172.31.33.0-255,66,15783,21,299893
8058,0.000151,172.217.194.0-255,5379,21162,21,299893
8059,0.000153,172.31.33.0-255,66,21228,21,299893
8060,0.000176,172.217.194.0-255,1484,22712,21,299893
8061,0.000178,172.31.33.0-255,66,22778,21,299893
8062,0.000182,172.217.194.0-255,2902,25680,21,299893
8063,0.000184,172.31.33.0-255,66,25746,21,299893
8064,0.000189,172.217.194.0-255,2902,28648,21,299893
8065,0.000195,172.31.33.0-255,66,28714,21,299893
8066,0.000219,172.217.194.0-255,2902,31616,21,299893
8067,0.000228,172.217.194.0-255,6797,38413,21,299893
8068,0.000236,172.217.194.0-255,7156,45569,21,299893
8069,0.000241,172.31.33.0-255,66,45635,21,299893
8070,0.000244,172.31.33.0-255,66,45701,21,299893
8071,0.000245,172.31.33.0-255,66,45767,21,299893
8072,0.000268,172.217.194.0-255,7156,52923,21,299893
8073,0.00027,172.31.33.0-255,66,52989,21,299893
8074,0.000274,172.217.194.0-255,2543,55532,21,299893
8075,0.000276,172.31.33.0-255,66,55598,21,299893
8076,0.000306,172.217.194.0-255,645,56243,21,299893
8077,0.000731,172.31.33.0-255,66,56309,21,299893
8078,0.000761,172.217.194.0-255,1484,57793,21,299893
8079,0.000766,172.217.194.0-255,2902,60695,21,299893
8080,0.000769,172.31.33.0-255,66,60761,21,299893
8081,0.000795,172.217.194.0-255,5738,66499,21,299893
8082,0.000798,172.31.33.0-255,66,66565,21,299893
8083,0.000804,172.217.194.0-255,2902,69467,21,299893
8084,0.000806,172.31.33.0-255,66,69533,21,299893
8085,0.000833,172.31.33.0-255,66,69599,21,299893
8086,0.000838,172.217.194.0-255,4320,73919,21,299893
8087,0.000839,172.31.33.0-255,66,73985,21,299893
8088,0.000863,172.217.194.0-255,5738,79723,21,299893
8089,0.000866,172.31.33.0-255,66,79789,21,299893
8090,0.000869,172.217.194.0-255,766,80555,21,299893
8091,0.000995,172.31.33.0-255,66,80621,21,299893
8092,0.001276,172.217.194.0-255,1484,82105,21,299893
8093,0.001285,172.217.194.0-255,2902,85007,21,299893
8094,0.001288,172.31.33.0-255,66,85073,21,299893
8095,0.001337,172.217.194.0-255,5738,90811,21,299893
8096,0.00134,172.31.33.0-255,66,90877,21,299893
8097,0.001346,172.217.194.0-255,5738,96615,21,299893
8098,0.001348,172.31.33.0-255,66,96681,21,299893
8099,0.001372,172.217.194.0-255,4320,101001,21,299893
8100,0.001374,172.31.33.0-255,66,101067,21,299893
8101,0.001398,172.31.33.0-255,66,101133,21,299893
8102,0.001401,172.217.194.0-255,1484,102617,21,299893
8103,0.001428,172.217.194.0-255,3602,106219,21,299893
8104,0.001431,172.31.33.0-255,66,106285,21,299893
8105,0.002181,172.217.194.0-255,1484,107769,21,299893
8106,0.002186,172.217.194.0-255,1484,109253,21,299893
8107,0.002189,172.31.33.0-255,66,109319,21,299893
8108,0.002215,172.217.194.0-255,1484,110803,21,299893
8109,0.002221,172.217.194.0-255,5738,116541,21,299893
8110,0.002223,172.31.33.0-255,66,116607,21,299893
8111,0.002227,172.217.194.0-255,4320,120927,21,299893
8112,0.002229,172.31.33.0-255,66,120993,21,299893
8113,0.002254,172.31.33.0-255,66,121059,21,299893
8114,0.002263,172.31.33.0-255,66,121125,21,299893
8115,0.002266,172.217.194.0-255,2184,123309,21,299893
8116,0.002267,172.31.33.0-255,66,123375,21,299893
8117,0.004469,172.217.194.0-255,2902,126277,21,299893
8118,0.004476,172.31.33.0-255,66,126343,21,299893
8119,0.004505,172.217.194.0-255,2902,129245,21,299893
8120,0.004509,172.31.33.0-255,66,129311,21,299893
8121,0.00665,172.217.194.0-255,2902,132213,21,299893
8122,0.006655,172.31.33.0-255,66,132279,21,299893
8123,0.006705,172.217.194.0-255,1484,133763,21,299893
8124,0.006716,172.217.194.0-255,1484,135247,21,299893
8125,0.006719,172.31.33.0-255,66,135313,21,299893
8126,0.00885,172.217.194.0-255,2902,138215,21,299893
8127,0.008856,172.31.33.0-255,66,138281,21,299893
8128,0.008899,172.217.194.0-255,2902,141183,21,299893
8129,0.008903,172.31.33.0-255,66,141249,21,299893
8130,0.011033,172.217.194.0-255,2902,144151,21,299893
8131,0.01104,172.31.33.0-255,66,144217,21,299893
8132,0.011089,172.217.194.0-255,2902,147119,21,299893
8133,0.011094,172.31.33.0-255,66,147185,21,299893
8134,0.013257,172.217.194.0-255,2902,150087,21,299893
8135,0.013264,172.31.33.0-255,66,150153,21,299893
8136,0.013305,172.217.194.0-255,2902,153055,21,299893
8137,0.013308,172.31.33.0-255,66,153121,21,299893
8138,0.015509,172.217.194.0-255,5738,158859,21,299893
8139,0.015516,172.31.33.0-255,66,158925,21,299893
8140,0.017724,172.217.194.0-255,5738,164663,21,299893
8141,0.017732,172.31.33.0-255,66,164729,21,299893
8142,0.019988,172.217.194.0-255,5738,170467,21,299893
8143,0.019996,172.31.33.0-255,66,170533,21,299893
8144,0.022244,172.217.194.0-255,5738,176271,21,299893
8145,0.022251,172.31.33.0-255,66,176337,21,299893
8146,0.024466,172.217.194.0-255,5738,182075,21,299893
8147,0.024476,172.31.33.0-255,66,182141,21,299893
8148,0.026492,172.31.33.0-255,172,182313,21,299893
8149,0.026523,172.31.33.0-255,1113,183426,21,299893
8150,0.02656,172.31.33.0-255,1514,184940,21,299893
8151,0.026562,172.31.33.0-255,1514,186454,21,299893
8152,0.026585,172.31.33.0-255,689,187143,21,299893
8153,0.026648,172.217.194.0-255,5738,192881,21,299893
8154,0.026653,172.31.33.0-255,66,192947,21,299893
8155,0.028191,104.244.42.0-255,66,193013,21,299893
8156,0.028197,104.244.42.0-255,66,193079,21,299893
8157,0.028264,104.244.42.0-255,66,193145,21,299893
8158,0.028267,104.244.42.0-255,66,193211,21,299893
8159,0.028871,172.217.194.0-255,2902,196113,21,299893
8160,0.028874,172.31.33.0-255,66,196179,21,299893
8161,0.028907,172.217.194.0-255,2902,199081,21,299893
8162,0.02891,172.31.33.0-255,66,199147,21,299893
8163,0.031064,172.217.194.0-255,2902,202049,21,299893
8164,0.031068,172.31.33.0-255,66,202115,21,299893
8165,0.03112,172.217.194.0-255,2902,205017,21,299893
8166,0.031135,172.31.33.0-255,66,205083,21,299893
8167,0.0333,172.217.194.0-255,2902,207985,21,299893
8168,0.033308,172.31.33.0-255,66,208051,21,299893
8169,0.03334,172.217.194.0-255,2902,210953,21,299893
8170,0.033343,172.31.33.0-255,66,211019,21,299893
8171,0.035543,172.217.194.0-255,4320,215339,21,299893
8172,0.035549,172.31.33.0-255,66,215405,21,299893
8173,0.035578,172.217.194.0-255,1484,216889,21,299893
8174,0.037791,172.217.194.0-255,4320,221209,21,299893
8175,0.037797,172.31.33.0-255,66,221275,21,299893
8176,0.040009,172.217.194.0-255,5738,227013,21,299893
8177,0.040016,172.31.33.0-255,66,227079,21,299893
8178,0.042258,172.217.194.0-255,4320,231399,21,299893
8179,0.042263,172.31.33.0-255,66,231465,21,299893
8180,0.042296,172.217.194.0-255,1484,232949,21,299893
8181,0.04447,172.217.194.0-255,4320,237269,21,299893
8182,0.044475,172.31.33.0-255,66,237335,21,299893
8183,0.046646,172.217.194.0-255,5738,243073,21,299893
8184,0.046651,172.31.33.0-255,66,243139,21,299893
8185,0.048875,172.217.194.0-255,5738,248877,21,299893
8186,0.048879,172.31.33.0-255,66,248943,21,299893
8187,0.051133,172.217.194.0-255,5738,254681,21,299893
8188,0.051138,172.31.33.0-255,66,254747,21,299893
8189,0.053356,172.217.194.0-255,5738,260485,21,299893
8190,0.053363,172.31.33.0-255,66,260551,21,299893
8191,0.055541,172.217.194.0-255,5738,266289,21,299893
8192,0.055548,172.31.33.0-255,66,266355,21,299893
8193,0.057805,172.217.194.0-255,1484,267839,21,299893
8194,0.057836,172.217.194.0-255,4320,272159,21,299893
8195,0.057841,172.31.33.0-255,66,272225,21,299893
8196,0.06002,172.217.194.0-255,5738,277963,21,299893
8197,0.060024,172.31.33.0-255,66,278029,21,299893
8198,0.062281,172.217.194.0-255,4320,282349,21,299893
8199,0.062286,172.31.33.0-255,66,282415,21,299893
8200,0.062316,172.217.194.0-255,1484,283899,21,299893
8201,0.064476,172.217.194.0-255,4320,288219,21,299893
8202,0.064482,172.31.33.0-255,66,288285,21,299893
8203,0.066665,172.217.194.0-255,5738,294023,21,299893
8204,0.066671,172.31.33.0-255,66,294089,21,299893
8205,0.068899,172.217.194.0-255,5738,299827,21,299893
8206,0.068905,172.31.33.0-255,66,299893,21,299893
8207,0.0,172.31.33.0-255,105,105,21,459
8208,0.000178,172.31.33.0-255,90,195,21,459
8209,0.000185,172.31.33.0-255,66,261,21,459
8210,0.002414,74.125.24.0-255,66,327,21,459
8211,0.002435,74.125.24.0-255,66,393,21,459
8212,0.002451,172.31.33.0-255,66,459,21,459
8213,0.0,172.31.33.0-255,66,66,21,66
8214,0.0,172.31.33.0-255,105,105,21,2427
8215,2.9e-05,172.31.33.0-255,105,210,21,2427
8216,7.3e-05,172.31.33.0-255,105,315,21,2427
8217,9.8e-05,172.31.33.0-255,105,420,21,2427
8218,0.000148,172.31.33.0-255,105,525,21,2427
8219,0.000438,172.31.33.0-255,90,615,21,2427
8220,0.000446,172.31.33.0-255,66,681,21,2427
8221,0.000572,172.31.33.0-255,90,771,21,2427
8222,0.000579,172.31.33.0-255,66,837,21,2427
8223,0.000846,172.31.33.0-255,90,927,21,2427
8224,0.000852,172.31.33.0-255,66,993,21,2427
8225,0.000972,172.31.33.0-255,90,1083,21,2427
8226,0.000978,172.31.33.0-255,66,1149,21,2427
8227,0.001193,172.31.33.0-255,90,1239,21,2427
8228,0.001201,172.31.33.0-255,66,1305,21,2427
8229,0.002667,74.125.24.0-255,66,1371,21,2427
8230,0.00268,74.125.24.0-255,66,1437,21,2427
8231,0.002689,172.31.33.0-255,66,1503,21,2427
8232,0.002983,74.125.68.0-255,66,1569,21,2427
8233,0.002995,74.125.68.0-255,66,1635,21,2427
8234,0.002998,172.31.33.0-255,66,1701,21,2427
8235,0.003116,172.217.194.0-255,66,1767,21,2427
8236,0.003127,172.217.194.0-255,66,1833,21,2427
8237,0.00313,172.31.33.0-255,66,1899,21,2427
8238,0.003132,172.217.194.0-255,66,1965,21,2427
8239,0.003233,74.125.24.0-255,66,2031,21,2427
8240,0.003242,74.125.24.0-255,66,2097,21,2427
8241,0.003244,172.31.33.0-255,66,2163,21,2427
8242,0.003772,172.217.194.0-255,66,2229,21,2427
8243,0.003782,172.217.194.0-255,66,2295,21,2427
8244,0.003784,172.31.33.0-255,66,2361,21,2427
8245,0.003823,172.217.194.0-255,66,2427,21,2427
8246,0.0,172.31.33.0-255,105,105,21,459
8247,0.000204,172.31.33.0-255,90,195,21,459
8248,0.000212,172.31.33.0-255,66,261,21,459
8249,0.002309,74.125.130.0-255,66,327,21,459
8250,0.002324,74.125.130.0-255,66,393,21,459
8251,0.002334,172.31.33.0-255,66,459,21,459
8252,0.0,172.31.33.0-255,105,105,21,918
8253,9.7e-05,172.31.33.0-255,105,210,21,918
8254,0.000345,172.31.33.0-255,90,300,21,918
8255,0.000356,172.31.33.0-255,66,366,21,918
8256,0.000561,172.31.33.0-255,90,456,21,918
8257,0.00057,172.31.33.0-255,66,522,21,918
8258,0.002387,172.217.194.0-255,66,588,21,918
8259,0.0024,172.217.194.0-255,66,654,21,918
8260,0.002411,172.31.33.0-255,66,720,21,918
8261,0.003157,172.217.194.0-255,66,786,21,918
8262,0.003173,172.217.194.0-255,66,852,21,918
8263,0.003177,172.31.33.0-255,66,918,21,918
8264,0.0,172.217.194.0-255,150,150,21,209809
8265,2.1e-05,172.31.33.0-255,66,216,21,209809
8266,2.7e-05,172.217.194.0-255,1484,1700,21,209809
8267,3.2e-05,172.31.33.0-255,66,1766,21,209809
8268,3.7e-05,172.217.194.0-255,2902,4668,21,209809
8269,4e-05,172.31.33.0-255,66,4734,21,209809
8270,4.5e-05,172.217.194.0-255,4320,9054,21,209809
8271,4.8e-05,172.31.33.0-255,66,9120,21,209809
8272,6.6e-05,172.217.194.0-255,2902,12022,21,209809
8273,6.8e-05,172.31.33.0-255,66,12088,21,209809
8274,7.2e-05,172.217.194.0-255,1983,14071,21,209809
8275,7.5e-05,172.31.33.0-255,66,14137,21,209809
8276,7.9e-05,172.217.194.0-255,2902,17039,21,209809
8277,8e-05,172.31.33.0-255,66,17105,21,209809
8278,0.000111,172.31.33.0-255,66,17171,21,209809
8279,0.000116,172.217.194.0-255,5379,22550,21,209809
8280,0.000118,172.31.33.0-255,66,22616,21,209809
8281,0.000186,172.217.194.0-255,1484,24100,21,209809
8282,0.000188,172.31.33.0-255,66,24166,21,209809
8283,0.000193,172.217.194.0-255,2902,27068,21,209809
8284,0.000195,172.31.33.0-255,66,27134,21,209809
8285,0.000209,172.217.194.0-255,5738,32872,21,209809
8286,0.000211,172.31.33.0-255,66,32938,21,209809
8287,0.000215,172.217.194.0-255,2902,35840,21,209809
8288,0.000217,172.31.33.0-255,66,35906,21,209809
8289,0.000237,172.217.194.0-255,2902,38808,21,209809
8290,0.000239,172.31.33.0-255,66,38874,21,209809
8291,0.000247,172.217.194.0-255,7156,46030,21,209809
8292,0.000248,172.31.33.0-255,66,46096,21,209809
8293,0.000264,172.217.194.0-255,6797,52893,21,209809
8294,0.000266,172.31.33.0-255,66,52959,21,209809
8295,0.000271,172.217.194.0-255,4249,57208,21,209809
8296,0.000273,172.31.33.0-255,66,57274,21,209809
8297,0.000294,172.217.194.0-255,98,57372,21,209809
8298,0.000351,172.217.194.0-255,1484,58856,21,209809
8299,0.000355,172.31.33.0-255,66,58922,21,209809
8300,0.000359,172.217.194.0-255,2902,61824,21,209809
8301,0.000361,172.31.33.0-255,66,61890,21,209809
8302,0.000364,172.217.194.0-255,1484,63374,21,209809
8303,0.000377,172.217.194.0-255,2902,66276,21,209809
8304,0.000379,172.31.33.0-255,66,66342,21,209809
8305,0.000417,172.217.194.0-255,5738,72080,21,209809
8306,0.000419,172.31.33.0-255,66,72146,21,209809
8307,0.000444,172.217.194.0-255,6797,78943,21,209809
8308,0.000446,172.31.33.0-255,66,79009,21,209809
8309,0.000456,172.31.33.0-255,66,79075,21,209809
8310,0.000472,172.217.194.0-255,1484,80559,21,209809
8311,0.000483,172.217.194.0-255,1425,81984,21,209809
8312,0.000485,172.31.33.0-255,66,82050,21,209809
8313,0.000544,172.217.194.0-255,1484,83534,21,209809
8314,0.000549,172.217.194.0-255,2902,86436,21,209809
8315,0.000552,172.31.33.0-255,66,86502,21,209809
8316,0.000592,172.217.194.0-255,5738,92240,21,209809
8317,0.000594,172.31.33.0-255,66,92306,21,209809
8318,0.000598,172.217.194.0-255,2902,95208,21,209809
8319,0.0006,172.31.33.0-255,66,95274,21,209809
8320,0.000604,172.217.194.0-255,4320,99594,21,209809
8321,0.000607,172.31.33.0-255,66,99660,21,209809
8322,0.000616,172.31.33.0-255,66,99726,21,209809
8323,0.000648,172.31.33.0-255,66,99792,21,209809
8324,0.000682,172.217.194.0-255,4320,104112,21,209809
8325,0.000684,172.31.33.0-255,66,104178,21,209809
8326,0.000715,172.31.33.0-255,66,104244,21,209809
8327,0.000728,172.31.33.0-255,66,104310,21,209809
8328,0.000732,172.217.194.0-255,3602,107912,21,209809
8329,0.000735,172.31.33.0-255,66,107978,21,209809
8330,0.00074,172.217.194.0-255,4320,112298,21,209809
8331,0.000742,172.31.33.0-255,66,112364,21,209809
8332,0.000779,172.31.33.0-255,66,112430,21,209809
8333,0.000784,172.217.194.0-255,4320,116750,21,209809
8334,0.000786,172.31.33.0-255,66,116816,21,209809
8335,0.00081,172.31.33.0-255,66,116882,21,209809
8336,0.000831,172.217.194.0-255,7156,124038,21,209809
8337,0.000833,172.31.33.0-255,66,124104,21,209809
8338,0.000861,172.217.194.0-255,1484,125588,21,209809
8339,0.000873,172.31.33.0-255,66,125654,21,209809
8340,0.000887,172.217.194.0-255,4320,129974,21,209809
8341,0.000891,172.31.33.0-255,66,130040,21,209809
8342,0.000906,172.31.33.0-255,66,130106,21,209809
8343,0.000919,172.217.194.0-255,2184,132290,21,209809
8344,0.00092,172.31.33.0-255,66,132356,21,209809
8345,0.000937,172.217.194.0-255,5738,138094,21,209809
8346,0.000939,172.31.33.0-255,66,138160,21,209809
8347,0.00097,172.31.33.0-255,66,138226,21,209809
8348,0.000986,172.31.33.0-255,66,138292,21,209809
8349,0.001026,172.217.194.0-255,4320,142612,21,209809
8350,0.001029,172.31.33.0-255,66,142678,21,209809
8351,0.001048,172.31.33.0-255,66,142744,21,209809
8352,0.001064,172.217.194.0-255,3602,146346,21,209809
8353,0.001066,172.31.33.0-255,66,146412,21,209809
8354,0.001112,172.31.33.0-255,66,146478,21,209809
8355,0.001129,172.217.194.0-255,2902,149380,21,209809
8356,0.001131,172.31.33.0-255,66,149446,21,209809
8357,0.001136,172.217.194.0-255,3602,153048,21,209809
8358,0.001138,172.31.33.0-255,66,153114,21,209809
8359,0.001236,172.217.194.0-255,1484,154598,21,209809
8360,0.001241,172.217.194.0-255,1484,156082,21,209809
8361,0.001243,172.31.33.0-255,66,156148,21,209809
8362,0.001261,172.217.194.0-255,1484,157632,21,209809
8363,0.001268,172.217.194.0-255,5738,163370,21,209809
8364,0.00127,172.31.33.0-255,66,163436,21,209809
8365,0.001276,172.217.194.0-255,5738,169174,21,209809
8366,0.001277,172.31.33.0-255,66,169240,21,209809
8367,0.001291,172.217.194.0-255,2902,172142,21,209809
8368,0.001294,172.31.33.0-255,66,172208,21,209809
8369,0.001322,172.31.33.0-255,66,172274,21,209809
8370,0.001327,172.217.194.0-255,5020,177294,21,209809
8371,0.001329,172.31.33.0-255,66,177360,21,209809
8372,0.001347,172.217.194.0-255,1484,178844,21,209809
8373,0.001362,172.217.194.0-255,4320,183164,21,209809
8374,0.00137,172.31.33.0-255,66,183230,21,209809
8375,0.001377,172.217.194.0-255,7156,190386,21,209809
8376,0.001379,172.31.33.0-255,66,190452,21,209809
8377,0.001391,172.217.194.0-255,2902,193354,21,209809
8378,0.001392,172.31.33.0-255,66,193420,21,209809
8379,0.001404,172.31.33.0-255,66,193486,21,209809
8380,0.00143,172.217.194.0-255,5738,199224,21,209809
8381,0.001433,172.31.33.0-255,66,199290,21,209809
8382,0.001461,172.31.33.0-255,66,199356,21,209809
8383,0.001467,172.217.194.0-255,5738,205094,21,209809
8384,0.001471,172.31.33.0-255,66,205160,21,209809
8385,0.001498,172.31.33.0-255,66,205226,21,209809
8386,0.001508,172.31.33.0-255,66,205292,21,209809
8387,0.00153,172.217.194.0-255,105,205397,21,209809
8388,0.004029,172.31.33.0-255,66,205463,21,209809
8389,0.004061,172.31.33.0-255,105,205568,21,209809
8390,0.006547,172.217.194.0-255,66,205634,21,209809
8391,0.028821,172.31.33.0-255,172,205806,21,209809
8392,0.02885,172.31.33.0-255,1109,206915,21,209809
8393,0.028906,172.31.33.0-255,1514,208429,21,209809
8394,0.028908,172.31.33.0-255,1182,209611,21,209809
8395,0.030318,104.244.42.0-255,66,209677,21,209809
8396,0.030412,104.244.42.0-255,66,209743,21,209809
8397,0.030439,104.244.42.0-255,66,209809,21,209809
8398,0.0,172.31.33.0-255,105,105,21,459
8399,0.000193,172.31.33.0-255,90,195,21,459
8400,0.0002,172.31.33.0-255,66,261,21,459
8401,0.002193,74.125.24.0-255,66,327,21,459
8402,0.002204,74.125.24.0-255,66,393,21,459
8403,0.002212,172.31.33.0-255,66,459,21,459
8404,0.0,172.217.194.0-255,153,153,21,292113
8405,2.6e-05,172.31.33.0-255,66,219,21,292113
8406,3.2e-05,172.217.194.0-255,1484,1703,21,292113
8407,3.6e-05,172.31.33.0-255,66,1769,21,292113
8408,4e-05,172.217.194.0-255,2902,4671,21,292113
8409,4.3e-05,172.31.33.0-255,66,4737,21,292113
8410,5.1e-05,172.217.194.0-255,7156,11893,21,292113
8411,5.4e-05,172.31.33.0-255,66,11959,21,292113
8412,5.8e-05,172.217.194.0-255,2094,14053,21,292113
8413,6.1e-05,172.31.33.0-255,66,14119,21,292113
8414,9.5e-05,172.217.194.0-255,2902,17021,21,292113
8415,9.8e-05,172.31.33.0-255,66,17087,21,292113
8416,0.000105,172.217.194.0-255,7156,24243,21,292113
8417,0.000108,172.31.33.0-255,66,24309,21,292113
8418,0.000114,172.217.194.0-255,5738,30047,21,292113
8419,0.000117,172.31.33.0-255,66,30113,21,292113
8420,0.000154,172.217.194.0-255,1125,31238,21,292113
8421,0.000157,172.31.33.0-255,66,31304,21,292113
8422,0.000235,172.217.194.0-255,1484,32788,21,292113
8423,0.000239,172.31.33.0-255,66,32854,21,292113
8424,0.000244,172.217.194.0-255,2902,35756,21,292113
8425,0.000245,172.31.33.0-255,66,35822,21,292113
8426,0.000251,172.217.194.0-255,4320,40142,21,292113
8427,0.000253,172.31.33.0-255,66,40208,21,292113
8428,0.000268,172.217.194.0-255,1484,41692,21,292113
8429,0.00027,172.31.33.0-255,66,41758,21,292113
8430,0.000277,172.217.194.0-255,6797,48555,21,292113
8431,0.000279,172.31.33.0-255,66,48621,21,292113
8432,0.000297,172.217.194.0-255,4320,52941,21,292113
8433,0.0003,172.31.33.0-255,66,53007,21,292113
8434,0.000328,172.31.33.0-255,66,53073,21,292113
8435,0.000332,172.217.194.0-255,2818,55891,21,292113
8436,0.000334,172.31.33.0-255,66,55957,21,292113
8437,0.000345,172.217.194.0-255,436,56393,21,292113
8438,0.000549,172.217.194.0-255,1484,57877,21,292113
8439,0.000553,172.31.33.0-255,66,57943,21,292113
8440,0.000557,172.217.194.0-255,2902,60845,21,292113
8441,0.000559,172.31.33.0-255,66,60911,21,292113
8442,0.000563,172.217.194.0-255,2902,63813,21,292113
8443,0.000566,172.31.33.0-255,66,63879,21,292113
8444,0.000588,172.217.194.0-255,2902,66781,21,292113
8445,0.000591,172.31.33.0-255,66,66847,21,292113
8446,0.000604,172.31.33.0-255,66,66913,21,292113
8447,0.00064,172.31.33.0-255,66,66979,21,292113
8448,0.000815,172.217.194.0-255,1484,68463,21,292113
8449,0.000821,172.217.194.0-255,2902,71365,21,292113
8450,0.000824,172.31.33.0-255,66,71431,21,292113
8451,0.000828,172.217.194.0-255,2902,74333,21,292113
8452,0.00083,172.31.33.0-255,66,74399,21,292113
8453,0.000846,172.217.194.0-255,2902,77301,21,292113
8454,0.000849,172.31.33.0-255,66,77367,21,292113
8455,0.000855,172.217.194.0-255,5738,83105,21,292113
8456,0.000857,172.31.33.0-255,66,83171,21,292113
8457,0.000892,172.217.194.0-255,7156,90327,21,292113
8458,0.000895,172.31.33.0-255,66,90393,21,292113
8459,0.000906,172.31.33.0-255,66,90459,21,292113
8460,0.001715,172.217.194.0-255,1484,91943,21,292113
8461,0.001726,172.217.194.0-255,2902,94845,21,292113
8462,0.00173,172.31.33.0-255,66,94911,21,292113
8463,0.001737,172.217.194.0-255,4320,99231,21,292113
8464,0.001738,172.31.33.0-255,66,99297,21,292113
8465,0.00175,172.217.194.0-255,1484,100781,21,292113
8466,0.001774,172.217.194.0-255,5738,106519,21,292113
8467,0.001777,172.31.33.0-255,66,106585,21,292113
8468,0.001797,172.217.194.0-255,4320,110905,21,292113
8469,0.0018,172.31.33.0-255,66,110971,21,292113
8470,0.001816,172.31.33.0-255,66,111037,21,292113
8471,0.001885,172.217.194.0-255,1484,112521,21,292113
8472,0.001891,172.217.194.0-255,2902,115423,21,292113
8473,0.001894,172.31.33.0-255,66,115489,21,292113
8474,0.001914,172.217.194.0-255,5738,121227,21,292113
8475,0.001917,172.31.33.0-255,66,121293,21,292113
8476,0.001948,172.31.33.0-255,66,121359,21,292113
8477,0.001962,172.217.194.0-255,4320,125679,21,292113
8478,0.001966,172.31.33.0-255,66,125745,21,292113
8479,0.001975,172.31.33.0-255,66,125811,21,292113
8480,0.002007,172.217.194.0-255,4320,130131,21,292113
8481,0.00201,172.31.33.0-255,66,130197,21,292113
8482,0.002047,172.31.33.0-255,66,130263,21,292113
8483,0.002059,172.31.33.0-255,66,130329,21,292113
8484,0.002133,172.31.33.0-255,66,130395,21,292113
8485,0.00215,172.31.33.0-255,66,130461,21,292113
8486,0.00422,172.217.194.0-255,5738,136199,21,292113
8487,0.004227,172.31.33.0-255,66,136265,21,292113
8488,0.006326,172.217.194.0-255,5738,142003,21,292113
8489,0.006346,172.31.33.0-255,66,142069,21,292113
8490,0.008433,172.217.194.0-255,5738,147807,21,292113
8491,0.008449,172.31.33.0-255,66,147873,21,292113
8492,0.010536,172.217.194.0-255,5738,153611,21,292113
8493,0.010541,172.31.33.0-255,66,153677,21,292113
8494,0.012607,172.217.194.0-255,5738,159415,21,292113
8495,0.012613,172.31.33.0-255,66,159481,21,292113
8496,0.014704,172.217.194.0-255,5738,165219,21,292113
8497,0.014721,172.31.33.0-255,66,165285,21,292113
8498,0.016814,172.217.194.0-255,5738,171023,21,292113
8499,0.016827,172.31.33.0-255,66,171089,21,292113
8500,0.01891,172.217.194.0-255,5738,176827,21,292113
8501,0.018919,172.31.33.0-255,66,176893,21,292113
8502,0.021007,172.217.194.0-255,5738,182631,21,292113
8503,0.021016,172.31.33.0-255,66,182697,21,292113
8504,0.023077,172.217.194.0-255,5738,188435,21,292113
8505,0.023084,172.31.33.0-255,66,188501,21,292113
8506,0.025161,172.217.194.0-255,5738,194239,21,292113
8507,0.025169,172.31.33.0-255,66,194305,21,292113
8508,0.027219,172.217.194.0-255,5738,200043,21,292113
8509,0.027226,172.31.33.0-255,66,200109,21,292113
8510,0.029307,172.217.194.0-255,5738,205847,21,292113
8511,0.029314,172.31.33.0-255,66,205913,21,292113
8512,0.031401,172.217.194.0-255,5738,211651,21,292113
8513,0.031407,172.31.33.0-255,66,211717,21,292113
8514,0.033467,172.217.194.0-255,5738,217455,21,292113
8515,0.033474,172.31.33.0-255,66,217521,21,292113
8516,0.035541,172.217.194.0-255,5738,223259,21,292113
8517,0.035548,172.31.33.0-255,66,223325,21,292113
8518,0.037613,172.217.194.0-255,5738,229063,21,292113
8519,0.037623,172.31.33.0-255,66,229129,21,292113
8520,0.039719,172.217.194.0-255,5738,234867,21,292113
8521,0.039726,172.31.33.0-255,66,234933,21,292113
8522,0.041441,172.31.33.0-255,172,235105,21,292113
8523,0.041469,172.31.33.0-255,1113,236218,21,292113
8524,0.041502,172.31.33.0-255,1514,237732,21,292113
8525,0.041504,172.31.33.0-255,1288,239020,21,292113
8526,0.041822,172.217.194.0-255,5738,244758,21,292113
8527,0.04184,172.31.33.0-255,66,244824,21,292113
8528,0.042987,104.244.42.0-255,66,244890,21,292113
8529,0.042994,104.244.42.0-255,66,244956,21,292113
8530,0.043071,104.244.42.0-255,66,245022,21,292113
8531,0.043911,172.217.194.0-255,2902,247924,21,292113
8532,0.043914,172.31.33.0-255,66,247990,21,292113
8533,0.043946,172.217.194.0-255,2902,250892,21,292113
8534,0.043949,172.31.33.0-255,66,250958,21,292113
8535,0.045972,172.217.194.0-255,2902,253860,21,292113
8536,0.045978,172.31.33.0-255,66,253926,21,292113
8537,0.046015,172.217.194.0-255,2902,256828,21,292113
8538,0.046019,172.31.33.0-255,66,256894,21,292113
8539,0.048061,172.217.194.0-255,2902,259796,21,292113
8540,0.048066,172.31.33.0-255,66,259862,21,292113
8541,0.048101,172.217.194.0-255,2902,262764,21,292113
8542,0.048104,172.31.33.0-255,66,262830,21,292113
8543,0.050161,172.217.194.0-255,2902,265732,21,292113
8544,0.050165,172.31.33.0-255,66,265798,21,292113
8545,0.050196,172.217.194.0-255,2902,268700,21,292113
8546,0.050199,172.31.33.0-255,66,268766,21,292113
8547,0.052244,172.217.194.0-255,2902,271668,21,292113
8548,0.052249,172.31.33.0-255,66,271734,21,292113
8549,0.052274,172.217.194.0-255,2902,274636,21,292113
8550,0.052277,172.31.33.0-255,66,274702,21,292113
8551,0.054331,172.217.194.0-255,2902,277604,21,292113
8552,0.054337,172.31.33.0-255,66,277670,21,292113
8553,0.054367,172.217.194.0-255,2902,280572,21,292113
8554,0.054371,172.31.33.0-255,66,280638,21,292113
8555,0.056391,172.217.194.0-255,2902,283540,21,292113
8556,0.056396,172.31.33.0-255,66,283606,21,292113
8557,0.056431,172.217.194.0-255,2902,286508,21,292113
8558,0.056435,172.31.33.0-255,66,286574,21,292113
8559,0.058463,172.217.194.0-255,2902,289476,21,292113
8560,0.058468,172.31.33.0-255,66,289542,21,292113
8561,0.058501,172.217.194.0-255,2334,291876,21,292113
8562,0.058504,172.31.33.0-255,66,291942,21,292113
8563,0.05869,172.31.33.0-255,105,292047,21,292113
8564,0.060724,172.217.194.0-255,66,292113,21,292113
8565,0.0,172.31.33.0-255,105,105,21,1836
8566,2.7e-05,172.31.33.0-255,105,210,21,1836
8567,4.8e-05,172.31.33.0-255,105,315,21,1836
8568,8.9e-05,172.31.33.0-255,105,420,21,1836
8569,0.000315,172.31.33.0-255,90,510,21,1836
8570,0.000325,172.31.33.0-255,66,576,21,1836
8571,0.000612,172.31.33.0-255,90,666,21,1836
8572,0.000619,172.31.33.0-255,66,732,21,1836
8573,0.000767,172.31.33.0-255,90,822,21,1836
8574,0.000774,172.31.33.0-255,66,888,21,1836
8575,0.000948,172.31.33.0-255,90,978,21,1836
8576,0.000955,172.31.33.0-255,66,1044,21,1836
8577,0.002235,74.125.68.0-255,66,1110,21,1836
8578,0.002256,74.125.68.0-255,66,1176,21,1836
8579,0.002271,172.31.33.0-255,66,1242,21,1836
8580,0.00253,74.125.200.0-255,66,1308,21,1836
8581,0.002541,74.125.200.0-255,66,1374,21,1836
8582,0.002548,172.31.33.0-255,66,1440,21,1836
8583,0.003056,74.125.24.0-255,66,1506,21,1836
8584,0.003068,74.125.24.0-255,66,1572,21,1836
8585,0.003076,172.31.33.0-255,66,1638,21,1836
8586,0.003138,172.217.194.0-255,66,1704,21,1836
8587,0.003147,172.217.194.0-255,66,1770,21,1836
8588,0.003152,172.31.33.0-255,66,1836,21,1836
8589,0.0,172.217.26.0-255,153,153,21,294093
8590,3.1e-05,172.31.33.0-255,66,219,21,294093
8591,3.7e-05,172.217.26.0-255,1484,1703,21,294093
8592,4e-05,172.31.33.0-255,66,1769,21,294093
8593,4.5e-05,172.217.26.0-255,2902,4671,21,294093
8594,4.8e-05,172.31.33.0-255,66,4737,21,294093
8595,6.2e-05,172.217.26.0-255,7156,11893,21,294093
8596,6.5e-05,172.31.33.0-255,66,11959,21,294093
8597,7e-05,172.217.26.0-255,3429,15388,21,294093
8598,7.2e-05,172.31.33.0-255,66,15454,21,294093
8599,7.6e-05,172.217.26.0-255,4320,19774,21,294093
8600,7.8e-05,172.31.33.0-255,66,19840,21,294093
8601,8.2e-05,172.217.26.0-255,2902,22742,21,294093
8602,8.4e-05,172.31.33.0-255,66,22808,21,294093
8603,0.000121,172.217.26.0-255,7156,29964,21,294093
8604,0.000124,172.31.33.0-255,66,30030,21,294093
8605,0.000127,172.217.26.0-255,1125,31155,21,294093
8606,0.000129,172.31.33.0-255,66,31221,21,294093
8607,0.000257,172.217.26.0-255,1484,32705,21,294093
8608,0.000261,172.31.33.0-255,66,32771,21,294093
8609,0.000266,172.217.26.0-255,2902,35673,21,294093
8610,0.000268,172.31.33.0-255,66,35739,21,294093
8611,0.000272,172.217.26.0-255,4320,40059,21,294093
8612,0.000274,172.31.33.0-255,66,40125,21,294093
8613,0.000304,172.217.26.0-255,1484,41609,21,294093
8614,0.000307,172.31.33.0-255,66,41675,21,294093
8615,0.000313,172.217.26.0-255,5738,47413,21,294093
8616,0.000315,172.31.33.0-255,66,47479,21,294093
8617,0.000324,172.217.26.0-255,3961,51440,21,294093
8618,0.000327,172.31.33.0-255,66,51506,21,294093
8619,0.000332,172.217.26.0-255,4320,55826,21,294093
8620,0.000334,172.31.33.0-255,66,55892,21,294093
8621,0.000344,172.31.33.0-255,66,55958,21,294093
8622,0.000346,172.217.26.0-255,358,56316,21,294093
8623,0.000348,172.31.33.0-255,66,56382,21,294093
8624,0.001116,172.217.26.0-255,137,56519,21,294093
8625,0.001121,172.31.33.0-255,66,56585,21,294093
8626,0.001238,172.217.26.0-255,1484,58069,21,294093
8627,0.001243,172.31.33.0-255,66,58135,21,294093
8628,0.001248,172.217.26.0-255,2902,61037,21,294093
8629,0.00125,172.31.33.0-255,66,61103,21,294093
8630,0.001276,172.217.26.0-255,5738,66841,21,294093
8631,0.001278,172.31.33.0-255,66,66907,21,294093
8632,0.001284,172.217.26.0-255,5738,72645,21,294093
8633,0.001285,172.31.33.0-255,66,72711,21,294093
8634,0.001321,172.217.26.0-255,1125,73836,21,294093
8635,0.001323,172.31.33.0-255,66,73902,21,294093
8636,0.001326,172.217.26.0-255,1484,75386,21,294093
8637,0.001346,172.217.26.0-255,4320,79706,21,294093
8638,0.001348,172.31.33.0-255,66,79772,21,294093
8639,0.001375,172.31.33.0-255,66,79838,21,294093
8640,0.001398,172.217.26.0-255,1484,81322,21,294093
8641,0.001401,172.217.26.0-255,1125,82447,21,294093
8642,0.001402,172.31.33.0-255,66,82513,21,294093
8643,0.003316,172.217.26.0-255,2902,85415,21,294093
8644,0.003319,172.31.33.0-255,66,85481,21,294093
8645,0.003368,172.217.26.0-255,2902,88383,21,294093
8646,0.00337,172.31.33.0-255,66,88449,21,294093
8647,0.005268,172.217.26.0-255,2902,91351,21,294093
8648,0.005273,172.31.33.0-255,66,91417,21,294093
8649,0.005305,172.217.26.0-255,2902,94319,21,294093
8650,0.005308,172.31.33.0-255,66,94385,21,294093
8651,0.007215,172.217.26.0-255,2902,97287,21,294093
8652,0.007221,172.31.33.0-255,66,97353,21,294093
8653,0.007246,172.217.26.0-255,2902,100255,21,294093
8654,0.007249,172.31.33.0-255,66,100321,21,294093
8655,0.009173,172.217.26.0-255,2902,103223,21,294093
8656,0.00918,172.31.33.0-255,66,103289,21,294093
8657,0.009205,172.217.26.0-255,2902,106191,21,294093
8658,0.009208,172.31.33.0-255,66,106257,21,294093
8659,0.011131,172.217.26.0-255,2902,109159,21,294093
8660,0.01114,172.31.33.0-255,66,109225,21,294093
8661,0.011173,172.217.26.0-255,2902,112127,21,294093
8662,0.011177,172.31.33.0-255,66,112193,21,294093
8663,0.013091,172.217.26.0-255,2902,115095,21,294093
8664,0.013097,172.31.33.0-255,66,115161,21,294093
8665,0.013122,172.217.26.0-255,2902,118063,21,294093
8666,0.013125,172.31.33.0-255,66,118129,21,294093
8667,0.015049,172.217.26.0-255,2902,121031,21,294093
8668,0.015056,172.31.33.0-255,66,121097,21,294093
8669,0.015094,172.217.26.0-255,2902,123999,21,294093
8670,0.015099,172.31.33.0-255,66,124065,21,294093
8671,0.016998,172.217.26.0-255,2902,126967,21,294093
8672,0.017005,172.31.33.0-255,66,127033,21,294093
8673,0.017047,172.217.26.0-255,2902,129935,21,294093
8674,0.017051,172.31.33.0-255,66,130001,21,294093
8675,0.018951,172.217.26.0-255,2902,132903,21,294093
8676,0.018957,172.31.33.0-255,66,132969,21,294093
8677,0.018988,172.217.26.0-255,2902,135871,21,294093
8678,0.018991,172.31.33.0-255,66,135937,21,294093
8679,0.020899,172.217.26.0-255,2902,138839,21,294093
8680,0.020904,172.31.33.0-255,66,138905,21,294093
8681,0.020932,172.217.26.0-255,2902,141807,21,294093
8682,0.020935,172.31.33.0-255,66,141873,21,294093
8683,0.021241,172.31.33.0-255,172,142045,21,294093
8684,0.021266,172.31.33.0-255,1109,143154,21,294093
8685,0.0213,172.31.33.0-255,1514,144668,21,294093
8686,0.021301,172.31.33.0-255,1514,146182,21,294093
8687,0.021307,172.31.33.0-255,1514,147696,21,294093
8688,0.021308,172.31.33.0-255,1514,149210,21,294093
8689,0.021332,172.31.33.0-255,475,149685,21,294093
8690,0.022777,104.244.42.0-255,66,149751,21,294093
8691,0.022834,104.244.42.0-255,66,149817,21,294093
8692,0.022838,172.217.26.0-255,1484,151301,21,294093
8693,0.022851,172.217.26.0-255,1484,152785,21,294093
8694,0.022855,172.31.33.0-255,66,152851,21,294093
8695,0.022866,172.217.26.0-255,2902,155753,21,294093
8696,0.022872,172.31.33.0-255,66,155819,21,294093
8697,0.022898,104.244.42.0-255,66,155885,21,294093
8698,0.022903,104.244.42.0-255,66,155951,21,294093
8699,0.024796,172.217.26.0-255,5738,161689,21,294093
8700,0.024803,172.31.33.0-255,66,161755,21,294093
8701,0.026751,172.217.26.0-255,5738,167493,21,294093
8702,0.026759,172.31.33.0-255,66,167559,21,294093
8703,0.028709,172.217.26.0-255,5738,173297,21,294093
8704,0.028713,172.31.33.0-255,66,173363,21,294093
8705,0.030663,172.217.26.0-255,5738,179101,21,294093
8706,0.030667,172.31.33.0-255,66,179167,21,294093
8707,0.032611,172.217.26.0-255,5738,184905,21,294093
8708,0.032615,172.31.33.0-255,66,184971,21,294093
8709,0.034563,172.217.26.0-255,4320,189291,21,294093
8710,0.034567,172.31.33.0-255,66,189357,21,294093
8711,0.034604,172.217.26.0-255,1484,190841,21,294093
8712,0.036516,172.217.26.0-255,4320,195161,21,294093
8713,0.036522,172.31.33.0-255,66,195227,21,294093
8714,0.038473,172.217.26.0-255,1484,196711,21,294093
8715,0.038495,172.217.26.0-255,4320,201031,21,294093
8716,0.038499,172.31.33.0-255,66,201097,21,294093
8717,0.040441,172.217.26.0-255,5738,206835,21,294093
8718,0.040446,172.31.33.0-255,66,206901,21,294093
8719,0.042401,172.217.26.0-255,5738,212639,21,294093
8720,0.042406,172.31.33.0-255,66,212705,21,294093
8721,0.044351,172.217.26.0-255,5738,218443,21,294093
8722,0.044356,172.31.33.0-255,66,218509,21,294093
8723,0.046288,172.217.26.0-255,1484,219993,21,294093
8724,0.046322,172.217.26.0-255,4320,224313,21,294093
8725,0.046327,172.31.33.0-255,66,224379,21,294093
8726,0.048279,172.217.26.0-255,5738,230117,21,294093
8727,0.048283,172.31.33.0-255,66,230183,21,294093
8728,0.050236,172.217.26.0-255,5738,235921,21,294093
8729,0.050241,172.31.33.0-255,66,235987,21,294093
8730,0.052186,172.217.26.0-255,5738,241725,21,294093
8731,0.052191,172.31.33.0-255,66,241791,21,294093
8732,0.054137,172.217.26.0-255,5738,247529,21,294093
8733,0.054143,172.31.33.0-255,66,247595,21,294093
8734,0.056095,172.217.26.0-255,5738,253333,21,294093
8735,0.056101,172.31.33.0-255,66,253399,21,294093
8736,0.058042,172.217.26.0-255,5738,259137,21,294093
8737,0.058048,172.31.33.0-255,66,259203,21,294093
8738,0.059991,172.217.26.0-255,5738,264941,21,294093
8739,0.059996,172.31.33.0-255,66,265007,21,294093
8740,0.061947,172.217.26.0-255,5738,270745,21,294093
8741,0.061953,172.31.33.0-255,66,270811,21,294093
8742,0.063922,172.217.26.0-255,5738,276549,21,294093
8743,0.063926,172.31.33.0-255,66,276615,21,294093
8744,0.065869,172.217.26.0-255,5738,282353,21,294093
8745,0.065874,172.31.33.0-255,66,282419,21,294093
8746,0.067801,172.217.26.0-255,1484,283903,21,294093
8747,0.067819,172.217.26.0-255,4320,288223,21,294093
8748,0.067823,172.31.33.0-255,66,288289,21,294093
8749,0.069765,172.217.26.0-255,5738,294027,21,294093
8750,0.069771,172.31.33.0-255,66,294093,21,294093
8751,0.0,172.31.33.0-255,105,105,21,276
8752,0.001774,157.240.7.0-255,105,210,21,276
8753,0.001786,172.31.33.0-255,66,276,21,276
8754,0.0,74.125.24.0-255,151,151,21,310035
8755,2.3e-05,172.31.33.0-255,66,217,21,310035
8756,2.8e-05,74.125.24.0-255,1484,1701,21,310035
8757,3.2e-05,172.31.33.0-255,66,1767,21,310035
8758,3.6e-05,74.125.24.0-255,2902,4669,21,310035
8759,3.9e-05,172.31.33.0-255,66,4735,21,310035
8760,4.1e-05,74.125.24.0-255,1484,6219,21,310035
8761,4.3e-05,172.31.33.0-255,66,6285,21,310035
8762,6.9e-05,74.125.24.0-255,5738,12023,21,310035
8763,7.1e-05,172.31.33.0-255,66,12089,21,310035
8764,7.6e-05,74.125.24.0-255,1957,14046,21,310035
8765,7.8e-05,172.31.33.0-255,66,14112,21,310035
8766,0.000112,172.31.33.0-255,66,14178,21,310035
8767,0.000117,74.125.24.0-255,5379,19557,21,310035
8768,0.000119,172.31.33.0-255,66,19623,21,310035
8769,0.000162,74.125.24.0-255,2902,22525,21,310035
8770,0.000165,172.31.33.0-255,66,22591,21,310035
8771,0.000175,74.125.24.0-255,2902,25493,21,310035
8772,0.000178,172.31.33.0-255,66,25559,21,310035
8773,0.000183,74.125.24.0-255,7156,32715,21,310035
8774,0.000185,172.31.33.0-255,66,32781,21,310035
8775,0.000218,74.125.24.0-255,3961,36742,21,310035
8776,0.000221,172.31.33.0-255,66,36808,21,310035
8777,0.000879,74.125.24.0-255,1484,38292,21,310035
8778,0.000884,172.31.33.0-255,66,38358,21,310035
8779,0.000893,74.125.24.0-255,2902,41260,21,310035
8780,0.000895,172.31.33.0-255,66,41326,21,310035
8781,0.000899,74.125.24.0-255,2902,44228,21,310035
8782,0.0009,172.31.33.0-255,66,44294,21,310035
8783,0.000926,74.125.24.0-255,2902,47196,21,310035
8784,0.000929,172.31.33.0-255,66,47262,21,310035
8785,0.000936,74.125.24.0-255,6797,54059,21,310035
8786,0.000937,172.31.33.0-255,66,54125,21,310035
8787,0.001066,74.125.24.0-255,1484,55609,21,310035
8788,0.001083,74.125.24.0-255,2902,58511,21,310035
8789,0.001087,172.31.33.0-255,66,58577,21,310035
8790,0.001101,74.125.24.0-255,1484,60061,21,310035
8791,0.001117,74.125.24.0-255,4320,64381,21,310035
8792,0.001119,172.31.33.0-255,66,64447,21,310035
8793,0.001144,74.125.24.0-255,6797,71244,21,310035
8794,0.001148,172.31.33.0-255,66,71310,21,310035
8795,0.00117,74.125.24.0-255,5738,77048,21,310035
8796,0.001172,172.31.33.0-255,66,77114,21,310035
8797,0.001188,74.125.24.0-255,1484,78598,21,310035
8798,0.001194,74.125.24.0-255,7156,85754,21,310035
8799,0.001196,172.31.33.0-255,66,85820,21,310035
8800,0.001217,74.125.24.0-255,2543,88363,21,310035
8801,0.00122,172.31.33.0-255,66,88429,21,310035
8802,0.001672,74.125.24.0-255,1484,89913,21,310035
8803,0.001708,74.125.24.0-255,1484,91397,21,310035
8804,0.001711,172.31.33.0-255,66,91463,21,310035
8805,0.001714,74.125.24.0-255,1484,92947,21,310035
8806,0.001729,74.125.24.0-255,1484,94431,21,310035
8807,0.001731,172.31.33.0-255,66,94497,21,310035
8808,0.001734,74.125.24.0-255,1484,95981,21,310035
8809,0.001751,74.125.24.0-255,4320,100301,21,310035
8810,0.001753,74.125.24.0-255,1484,101785,21,310035
8811,0.001755,172.31.33.0-255,66,101851,21,310035
8812,0.001793,74.125.24.0-255,5738,107589,21,310035
8813,0.001795,172.31.33.0-255,66,107655,21,310035
8814,0.001807,74.125.24.0-255,2902,110557,21,310035
8815,0.001809,172.31.33.0-255,66,110623,21,310035
8816,0.001811,74.125.24.0-255,1484,112107,21,310035
8817,0.001851,74.125.24.0-255,2902,115009,21,310035
8818,0.001853,172.31.33.0-255,66,115075,21,310035
8819,0.001877,172.31.33.0-255,66,115141,21,310035
8820,0.002162,74.125.24.0-255,1484,116625,21,310035
8821,0.002175,74.125.24.0-255,2902,119527,21,310035
8822,0.002178,172.31.33.0-255,66,119593,21,310035
8823,0.002181,74.125.24.0-255,1484,121077,21,310035
8824,0.002198,74.125.24.0-255,4320,125397,21,310035
8825,0.0022,172.31.33.0-255,66,125463,21,310035
8826,0.002206,74.125.24.0-255,5738,131201,21,310035
8827,0.002207,172.31.33.0-255,66,131267,21,310035
8828,0.002258,172.31.33.0-255,66,131333,21,310035
8829,0.002264,74.125.24.0-255,6438,137771,21,310035
8830,0.002265,172.31.33.0-255,66,137837,21,310035
8831,0.002306,74.125.24.0-255,1484,139321,21,310035
8832,0.002337,172.31.33.0-255,66,139387,21,310035
8833,0.002356,74.125.24.0-255,1484,140871,21,310035
8834,0.002366,172.31.33.0-255,66,140937,21,310035
8835,0.002384,74.125.24.0-255,2902,143839,21,310035
8836,0.002387,172.31.33.0-255,66,143905,21,310035
8837,0.004733,74.125.24.0-255,2902,146807,21,310035
8838,0.004738,172.31.33.0-255,66,146873,21,310035
8839,0.004756,74.125.24.0-255,2902,149775,21,310035
8840,0.004758,172.31.33.0-255,66,149841,21,310035
8841,0.007115,74.125.24.0-255,5738,155579,21,310035
8842,0.007122,172.31.33.0-255,66,155645,21,310035
8843,0.009469,74.125.24.0-255,2902,158547,21,310035
8844,0.009475,172.31.33.0-255,66,158613,21,310035
8845,0.009497,74.125.24.0-255,2902,161515,21,310035
8846,0.009499,172.31.33.0-255,66,161581,21,310035
8847,0.011858,74.125.24.0-255,5738,167319,21,310035
8848,0.011864,172.31.33.0-255,66,167385,21,310035
8849,0.014233,74.125.24.0-255,5738,173123,21,310035
8850,0.01424,172.31.33.0-255,66,173189,21,310035
8851,0.016587,74.125.24.0-255,5738,178927,21,310035
8852,0.016596,172.31.33.0-255,66,178993,21,310035
8853,0.018958,74.125.24.0-255,5738,184731,21,310035
8854,0.018966,172.31.33.0-255,66,184797,21,310035
8855,0.021322,74.125.24.0-255,5738,190535,21,310035
8856,0.021328,172.31.33.0-255,66,190601,21,310035
8857,0.022541,172.31.33.0-255,172,190773,21,310035
8858,0.022592,172.31.33.0-255,1109,191882,21,310035
8859,0.022654,172.31.33.0-255,1514,193396,21,310035
8860,0.022656,172.31.33.0-255,1514,194910,21,310035
8861,0.022679,172.31.33.0-255,693,195603,21,310035
8862,0.023691,74.125.24.0-255,5738,201341,21,310035
8863,0.023697,172.31.33.0-255,66,201407,21,310035
8864,0.024068,104.244.42.0-255,66,201473,21,310035
8865,0.024129,104.244.42.0-255,66,201539,21,310035
8866,0.024236,104.244.42.0-255,66,201605,21,310035
8867,0.024242,104.244.42.0-255,66,201671,21,310035
8868,0.026065,74.125.24.0-255,5738,207409,21,310035
8869,0.026072,172.31.33.0-255,66,207475,21,310035
8870,0.028439,74.125.24.0-255,1484,208959,21,310035
8871,0.028456,74.125.24.0-255,4320,213279,21,310035
8872,0.02846,172.31.33.0-255,66,213345,21,310035
8873,0.030848,74.125.24.0-255,2902,216247,21,310035
8874,0.030853,172.31.33.0-255,66,216313,21,310035
8875,0.030868,74.125.24.0-255,2902,219215,21,310035
8876,0.030871,172.31.33.0-255,66,219281,21,310035
8877,0.033208,74.125.24.0-255,5738,225019,21,310035
8878,0.033214,172.31.33.0-255,66,225085,21,310035
8879,0.035587,74.125.24.0-255,5738,230823,21,310035
8880,0.035592,172.31.33.0-255,66,230889,21,310035
8881,0.037948,74.125.24.0-255,4320,235209,21,310035
8882,0.037952,172.31.33.0-255,66,235275,21,310035
8883,0.037979,74.125.24.0-255,1484,236759,21,310035
8884,0.040317,74.125.24.0-255,4320,241079,21,310035
8885,0.040323,172.31.33.0-255,66,241145,21,310035
8886,0.042679,74.125.24.0-255,5738,246883,21,310035
8887,0.042683,172.31.33.0-255,66,246949,21,310035
8888,0.045062,74.125.24.0-255,5738,252687,21,310035
8889,0.045066,172.31.33.0-255,66,252753,21,310035
8890,0.047433,74.125.24.0-255,5738,258491,21,310035
8891,0.047438,172.31.33.0-255,66,258557,21,310035
8892,0.049814,74.125.24.0-255,5738,264295,21,310035
8893,0.049819,172.31.33.0-255,66,264361,21,310035
8894,0.052183,74.125.24.0-255,4320,268681,21,310035
8895,0.052188,172.31.33.0-255,66,268747,21,310035
8896,0.052212,74.125.24.0-255,1484,270231,21,310035
8897,0.054556,74.125.24.0-255,1484,271715,21,310035
8898,0.054561,172.31.33.0-255,66,271781,21,310035
8899,0.05458,74.125.24.0-255,2902,274683,21,310035
8900,0.054583,172.31.33.0-255,66,274749,21,310035
8901,0.056916,74.125.24.0-255,2902,277651,21,310035
8902,0.056922,172.31.33.0-255,66,277717,21,310035
8903,0.056948,74.125.24.0-255,2902,280619,21,310035
8904,0.056951,172.31.33.0-255,66,280685,21,310035
8905,0.059283,74.125.24.0-255,2902,283587,21,310035
8906,0.059288,172.31.33.0-255,66,283653,21,310035
8907,0.05932,74.125.24.0-255,2902,286555,21,310035
8908,0.059323,172.31.33.0-255,66,286621,21,310035
8909,0.061676,74.125.24.0-255,2902,289523,21,310035
8910,0.06168,172.31.33.0-255,66,289589,21,310035
8911,0.061722,74.125.24.0-255,2902,292491,21,310035
8912,0.061727,172.31.33.0-255,66,292557,21,310035
8913,0.064133,74.125.24.0-255,5738,298295,21,310035
8914,0.064139,172.31.33.0-255,66,298361,21,310035
8915,0.066513,74.125.24.0-255,5738,304099,21,310035
8916,0.066517,172.31.33.0-255,66,304165,21,310035
8917,0.068888,74.125.24.0-255,4320,308485,21,310035
8918,0.068893,172.31.33.0-255,66,308551,21,310035
8919,0.068917,74.125.24.0-255,1484,310035,21,310035
8920,0.0,172.31.33.0-255,105,105,21,459
8921,0.000163,172.31.33.0-255,90,195,21,459
8922,0.00017,172.31.33.0-255,66,261,21,459
8923,0.002445,172.217.194.0-255,66,327,21,459
8924,0.002455,172.217.194.0-255,66,393,21,459
8925,0.002463,172.31.33.0-255,66,459,21,459
8926,0.0,74.125.24.0-255,153,153,21,307274
8927,2.2e-05,172.31.33.0-255,66,219,21,307274
8928,2.9e-05,74.125.24.0-255,1484,1703,21,307274
8929,3.3e-05,172.31.33.0-255,66,1769,21,307274
8930,3.7e-05,74.125.24.0-255,2902,4671,21,307274
8931,4e-05,172.31.33.0-255,66,4737,21,307274
8932,4.8e-05,74.125.24.0-255,7156,11893,21,307274
8933,5e-05,172.31.33.0-255,66,11959,21,307274
8934,5.4e-05,74.125.24.0-255,2095,14054,21,307274
8935,5.6e-05,172.31.33.0-255,66,14120,21,307274
8936,0.000295,74.125.24.0-255,1484,15604,21,307274
8937,0.0003,172.31.33.0-255,66,15670,21,307274
8938,0.000306,74.125.24.0-255,2902,18572,21,307274
8939,0.000309,172.31.33.0-255,66,18638,21,307274
8940,0.000314,74.125.24.0-255,4320,22958,21,307274
8941,0.000316,172.31.33.0-255,66,23024,21,307274
8942,0.000332,74.125.24.0-255,1484,24508,21,307274
8943,0.000334,172.31.33.0-255,66,24574,21,307274
8944,0.000368,74.125.24.0-255,6797,31371,21,307274
8945,0.000371,172.31.33.0-255,66,31437,21,307274
8946,0.00072,74.125.24.0-255,1484,32921,21,307274
8947,0.000725,172.31.33.0-255,66,32987,21,307274
8948,0.000732,74.125.24.0-255,2902,35889,21,307274
8949,0.000733,172.31.33.0-255,66,35955,21,307274
8950,0.000739,74.125.24.0-255,4320,40275,21,307274
8951,0.00074,172.31.33.0-255,66,40341,21,307274
8952,0.000762,74.125.24.0-255,1484,41825,21,307274
8953,0.000764,172.31.33.0-255,66,41891,21,307274
8954,0.000771,74.125.24.0-255,6797,48688,21,307274
8955,0.000772,172.31.33.0-255,66,48754,21,307274
8956,0.000775,74.125.24.0-255,1484,50238,21,307274
8957,0.000777,172.31.33.0-255,66,50304,21,307274
8958,0.000799,74.125.24.0-255,5738,56042,21,307274
8959,0.000801,172.31.33.0-255,66,56108,21,307274
8960,0.000804,74.125.24.0-255,1484,57592,21,307274
8961,0.000819,74.125.24.0-255,5738,63330,21,307274
8962,0.000821,172.31.33.0-255,66,63396,21,307274
8963,0.000844,74.125.24.0-255,2818,66214,21,307274
8964,0.000846,172.31.33.0-255,66,66280,21,307274
8965,0.000891,74.125.24.0-255,124,66404,21,307274
8966,0.001023,74.125.24.0-255,1484,67888,21,307274
8967,0.001029,172.31.33.0-255,66,67954,21,307274
8968,0.001034,74.125.24.0-255,2902,70856,21,307274
8969,0.001037,172.31.33.0-255,66,70922,21,307274
8970,0.001039,74.125.24.0-255,1484,72406,21,307274
8971,0.001058,74.125.24.0-255,4320,76726,21,307274
8972,0.00106,172.31.33.0-255,66,76792,21,307274
8973,0.001064,74.125.24.0-255,2902,79694,21,307274
8974,0.001066,172.31.33.0-255,66,79760,21,307274
8975,0.001086,74.125.24.0-255,5379,85139,21,307274
8976,0.001089,172.31.33.0-255,66,85205,21,307274
8977,0.001092,74.125.24.0-255,1484,86689,21,307274
8978,0.001122,172.31.33.0-255,66,86755,21,307274
8979,0.00114,74.125.24.0-255,1125,87880,21,307274
8980,0.001795,74.125.24.0-255,1484,89364,21,307274
8981,0.001803,172.31.33.0-255,66,89430,21,307274
8982,0.001809,74.125.24.0-255,2902,92332,21,307274
8983,0.001812,172.31.33.0-255,66,92398,21,307274
8984,0.001818,74.125.24.0-255,5738,98136,21,307274
8985,0.001821,172.31.33.0-255,66,98202,21,307274
8986,0.001829,74.125.24.0-255,7156,105358,21,307274
8987,0.001831,172.31.33.0-255,66,105424,21,307274
8988,0.001893,172.31.33.0-255,66,105490,21,307274
8989,0.001897,74.125.24.0-255,2184,107674,21,307274
8990,0.0019,172.31.33.0-255,66,107740,21,307274
8991,0.002118,74.125.24.0-255,1484,109224,21,307274
8992,0.002136,74.125.24.0-255,2902,112126,21,307274
8993,0.002139,172.31.33.0-255,66,112192,21,307274
8994,0.002142,74.125.24.0-255,1484,113676,21,307274
8995,0.002175,74.125.24.0-255,4320,117996,21,307274
8996,0.002179,172.31.33.0-255,66,118062,21,307274
8997,0.002193,172.31.33.0-255,66,118128,21,307274
8998,0.002206,172.31.33.0-255,66,118194,21,307274
8999,0.002233,74.125.24.0-255,5738,123932,21,307274
9000,0.002236,172.31.33.0-255,66,123998,21,307274
9001,0.002243,74.125.24.0-255,5738,129736,21,307274
9002,0.002245,172.31.33.0-255,66,129802,21,307274
9003,0.002269,74.125.24.0-255,1484,131286,21,307274
9004,0.002284,172.31.33.0-255,66,131352,21,307274
9005,0.002292,74.125.24.0-255,6438,137790,21,307274
9006,0.002294,172.31.33.0-255,66,137856,21,307274
9007,0.004647,74.125.24.0-255,5738,143594,21,307274
9008,0.004652,172.31.33.0-255,66,143660,21,307274
9009,0.007046,74.125.24.0-255,5738,149398,21,307274
9010,0.007053,172.31.33.0-255,66,149464,21,307274
9011,0.009427,74.125.24.0-255,5738,155202,21,307274
9012,0.009435,172.31.33.0-255,66,155268,21,307274
9013,0.011808,74.125.24.0-255,5738,161006,21,307274
9014,0.011817,172.31.33.0-255,66,161072,21,307274
9015,0.014188,74.125.24.0-255,5738,166810,21,307274
9016,0.014197,172.31.33.0-255,66,166876,21,307274
9017,0.016568,74.125.24.0-255,5738,172614,21,307274
9018,0.016577,172.31.33.0-255,66,172680,21,307274
9019,0.018933,74.125.24.0-255,5738,178418,21,307274
9020,0.018942,172.31.33.0-255,66,178484,21,307274
9021,0.021342,74.125.24.0-255,5738,184222,21,307274
9022,0.021352,172.31.33.0-255,66,184288,21,307274
9023,0.023704,74.125.24.0-255,5738,190026,21,307274
9024,0.023713,172.31.33.0-255,66,190092,21,307274
9025,0.026153,74.125.24.0-255,5738,195830,21,307274
9026,0.026196,172.31.33.0-255,66,195896,21,307274
9027,0.028583,74.125.24.0-255,5738,201634,21,307274
9028,0.028602,172.31.33.0-255,66,201700,21,307274
9029,0.030969,74.125.24.0-255,5738,207438,21,307274
9030,0.030985,172.31.33.0-255,66,207504,21,307274
9031,0.033355,74.125.24.0-255,5738,213242,21,307274
9032,0.033371,172.31.33.0-255,66,213308,21,307274
9033,0.03573,74.125.24.0-255,4320,217628,21,307274
9034,0.035738,172.31.33.0-255,66,217694,21,307274
9035,0.035759,74.125.24.0-255,1484,219178,21,307274
9036,0.038121,74.125.24.0-255,4320,223498,21,307274
9037,0.03813,172.31.33.0-255,66,223564,21,307274
9038,0.040511,74.125.24.0-255,5738,229302,21,307274
9039,0.040519,172.31.33.0-255,66,229368,21,307274
9040,0.041188,172.31.33.0-255,172,229540,21,307274
9041,0.041218,172.31.33.0-255,1113,230653,21,307274
9042,0.041276,172.31.33.0-255,1514,232167,21,307274
9043,0.041277,172.31.33.0-255,1514,233681,21,307274
9044,0.041278,172.31.33.0-255,1514,235195,21,307274
9045,0.041279,172.31.33.0-255,1514,236709,21,307274
9046,0.041306,172.31.33.0-255,479,237188,21,307274
9047,0.042787,104.244.42.0-255,66,237254,21,307274
9048,0.042821,104.244.42.0-255,66,237320,21,307274
9049,0.042878,104.244.42.0-255,66,237386,21,307274
9050,0.042899,104.244.42.0-255,66,237452,21,307274
9051,0.042955,74.125.24.0-255,5738,243190,21,307274
9052,0.04296,172.31.33.0-255,66,243256,21,307274
9053,0.044255,104.244.42.0-255,108,243364,21,307274
9054,0.044265,172.31.33.0-255,66,243430,21,307274
9055,0.045324,74.125.24.0-255,5738,249168,21,307274
9056,0.045329,172.31.33.0-255,66,249234,21,307274
9057,0.047685,74.125.24.0-255,5738,254972,21,307274
9058,0.047692,172.31.33.0-255,66,255038,21,307274
9059,0.050056,74.125.24.0-255,5738,260776,21,307274
9060,0.050062,172.31.33.0-255,66,260842,21,307274
9061,0.052441,74.125.24.0-255,5738,266580,21,307274
9062,0.052447,172.31.33.0-255,66,266646,21,307274
9063,0.054834,74.125.24.0-255,5738,272384,21,307274
9064,0.054844,172.31.33.0-255,66,272450,21,307274
9065,0.057212,74.125.24.0-255,5738,278188,21,307274
9066,0.057225,172.31.33.0-255,66,278254,21,307274
9067,0.059632,74.125.24.0-255,5738,283992,21,307274
9068,0.059639,172.31.33.0-255,66,284058,21,307274
9069,0.062015,74.125.24.0-255,5738,289796,21,307274
9070,0.062021,172.31.33.0-255,66,289862,21,307274
9071,0.064393,74.125.24.0-255,5738,295600,21,307274
9072,0.064399,172.31.33.0-255,66,295666,21,307274
9073,0.06677,74.125.24.0-255,5738,301404,21,307274
9074,0.066777,172.31.33.0-255,66,301470,21,307274
9075,0.069125,74.125.24.0-255,5738,307208,21,307274
9076,0.06913,172.31.33.0-255,66,307274,21,307274
9077,0.0,172.31.33.0-255,105,105,21,459
9078,0.000175,172.31.33.0-255,90,195,21,459
9079,0.000183,172.31.33.0-255,66,261,21,459
9080,0.002425,74.125.130.0-255,66,327,21,459
9081,0.002436,74.125.130.0-255,66,393,21,459
9082,0.002445,172.31.33.0-255,66,459,21,459
9083,0.0,172.31.33.0-255,105,105,21,459
9084,0.000249,172.31.33.0-255,90,195,21,459
9085,0.00026,172.31.33.0-255,66,261,21,459
9086,0.002503,74.125.200.0-255,66,327,21,459
9087,0.002521,74.125.200.0-255,66,393,21,459
9088,0.002533,172.31.33.0-255,66,459,21,459
