,TIME,SRC,PACKET_SIZE,CUMULATIVE_PACKET_SIZE,PAGE_NUMBER,TOTAL_PACKET_SIZE
0,0.0,74.125.200.0-255,295,295,9,297915
1,2.6e-05,172.31.36.0-255,66,361,9,297915
2,3.3e-05,74.125.200.0-255,1484,1845,9,297915
3,3.7e-05,172.31.36.0-255,66,1911,9,297915
4,4.1e-05,74.125.200.0-255,2902,4813,9,297915
5,4.5e-05,172.31.36.0-255,66,4879,9,297915
6,5e-05,74.125.200.0-255,4320,9199,9,297915
7,5.2e-05,172.31.36.0-255,66,9265,9,297915
8,7.9e-05,74.125.200.0-255,2902,12167,9,297915
9,8.4e-05,172.31.36.0-255,66,12233,9,297915
10,0.000102,74.125.200.0-255,1838,14071,9,297915
11,0.000105,172.31.36.0-255,66,14137,9,297915
12,0.000191,74.125.200.0-255,1484,15621,9,297915
13,0.000195,172.31.36.0-255,66,15687,9,297915
14,0.000213,74.125.200.0-255,2902,18589,9,297915
15,0.000216,172.31.36.0-255,66,18655,9,297915
16,0.000235,74.125.200.0-255,2902,21557,9,297915
17,0.000237,172.31.36.0-255,66,21623,9,297915
18,0.000257,74.125.200.0-255,4320,25943,9,297915
19,0.000259,172.31.36.0-255,66,26009,9,297915
20,0.000287,74.125.200.0-255,2902,28911,9,297915
21,0.00029,172.31.36.0-255,66,28977,9,297915
22,0.00031,74.125.200.0-255,2543,31520,9,297915
23,0.000312,172.31.36.0-255,66,31586,9,297915
24,0.000319,74.125.200.0-255,5738,37324,9,297915
25,0.000321,172.31.36.0-255,66,37390,9,297915
26,0.000367,172.31.36.0-255,66,37456,9,297915
27,0.000875,74.125.200.0-255,1484,38940,9,297915
28,0.000881,172.31.36.0-255,66,39006,9,297915
29,0.00089,74.125.200.0-255,2902,41908,9,297915
30,0.000893,172.31.36.0-255,66,41974,9,297915
31,0.000899,74.125.200.0-255,2902,44876,9,297915
32,0.0009,172.31.36.0-255,66,44942,9,297915
33,0.000918,74.125.200.0-255,1484,46426,9,297915
34,0.000947,172.31.36.0-255,66,46492,9,297915
35,0.001048,74.125.200.0-255,1484,47976,9,297915
36,0.001053,74.125.200.0-255,1484,49460,9,297915
37,0.001056,172.31.36.0-255,66,49526,9,297915
38,0.001078,74.125.200.0-255,1484,51010,9,297915
39,0.001086,74.125.200.0-255,5738,56748,9,297915
40,0.001088,172.31.36.0-255,66,56814,9,297915
41,0.001092,74.125.200.0-255,1484,58298,9,297915
42,0.001108,74.125.200.0-255,2902,61200,9,297915
43,0.001111,172.31.36.0-255,66,61266,9,297915
44,0.00113,74.125.200.0-255,5379,66645,9,297915
45,0.001132,172.31.36.0-255,66,66711,9,297915
46,0.001153,74.125.200.0-255,5738,72449,9,297915
47,0.001155,172.31.36.0-255,66,72515,9,297915
48,0.001177,74.125.200.0-255,4320,76835,9,297915
49,0.00118,172.31.36.0-255,66,76901,9,297915
50,0.001185,74.125.200.0-255,3961,80862,9,297915
51,0.001187,172.31.36.0-255,66,80928,9,297915
52,0.001595,74.125.200.0-255,1484,82412,9,297915
53,0.001615,74.125.200.0-255,2902,85314,9,297915
54,0.001619,172.31.36.0-255,66,85380,9,297915
55,0.001634,74.125.200.0-255,4320,89700,9,297915
56,0.001636,172.31.36.0-255,66,89766,9,297915
57,0.001652,74.125.200.0-255,1484,91250,9,297915
58,0.001656,74.125.200.0-255,2902,94152,9,297915
59,0.001657,172.31.36.0-255,66,94218,9,297915
60,0.00167,74.125.200.0-255,1484,95702,9,297915
61,0.001685,74.125.200.0-255,4320,100022,9,297915
62,0.001687,172.31.36.0-255,66,100088,9,297915
63,0.001707,74.125.200.0-255,4320,104408,9,297915
64,0.001709,172.31.36.0-255,66,104474,9,297915
65,0.001714,74.125.200.0-255,4320,108794,9,297915
66,0.001716,172.31.36.0-255,66,108860,9,297915
67,0.00173,74.125.200.0-255,2902,111762,9,297915
68,0.001731,172.31.36.0-255,66,111828,9,297915
69,0.001734,74.125.200.0-255,1484,113312,9,297915
70,0.001747,74.125.200.0-255,2184,115496,9,297915
71,0.00175,172.31.36.0-255,66,115562,9,297915
72,0.002035,74.125.200.0-255,1484,117046,9,297915
73,0.002049,74.125.200.0-255,2902,119948,9,297915
74,0.002052,172.31.36.0-255,66,120014,9,297915
75,0.002073,74.125.200.0-255,5738,125752,9,297915
76,0.002075,172.31.36.0-255,66,125818,9,297915
77,0.002122,74.125.200.0-255,1484,127302,9,297915
78,0.002148,172.31.36.0-255,66,127368,9,297915
79,0.002154,74.125.200.0-255,5738,133106,9,297915
80,0.002156,172.31.36.0-255,66,133172,9,297915
81,0.002161,74.125.200.0-255,5020,138192,9,297915
82,0.002163,172.31.36.0-255,66,138258,9,297915
83,0.004284,74.125.200.0-255,5738,143996,9,297915
84,0.004291,172.31.36.0-255,66,144062,9,297915
85,0.006414,74.125.200.0-255,5738,149800,9,297915
86,0.006419,172.31.36.0-255,66,149866,9,297915
87,0.008555,74.125.200.0-255,4320,154186,9,297915
88,0.00856,172.31.36.0-255,66,154252,9,297915
89,0.00859,74.125.200.0-255,1484,155736,9,297915
90,0.010684,74.125.200.0-255,4320,160056,9,297915
91,0.010691,172.31.36.0-255,66,160122,9,297915
92,0.012822,74.125.200.0-255,5738,165860,9,297915
93,0.012828,172.31.36.0-255,66,165926,9,297915
94,0.014969,74.125.200.0-255,2902,168828,9,297915
95,0.014975,172.31.36.0-255,66,168894,9,297915
96,0.014995,74.125.200.0-255,2902,171796,9,297915
97,0.014998,172.31.36.0-255,66,171862,9,297915
98,0.017102,74.125.200.0-255,4320,176182,9,297915
99,0.01711,172.31.36.0-255,66,176248,9,297915
100,0.017151,74.125.200.0-255,1484,177732,9,297915
101,0.019239,74.125.200.0-255,4320,182052,9,297915
102,0.019247,172.31.36.0-255,66,182118,9,297915
103,0.021373,74.125.200.0-255,5738,187856,9,297915
104,0.02138,172.31.36.0-255,66,187922,9,297915
105,0.023525,74.125.200.0-255,5738,193660,9,297915
106,0.023531,172.31.36.0-255,66,193726,9,297915
107,0.025668,74.125.200.0-255,2902,196628,9,297915
108,0.025674,172.31.36.0-255,66,196694,9,297915
109,0.02571,74.125.200.0-255,2902,199596,9,297915
110,0.025714,172.31.36.0-255,66,199662,9,297915
111,0.027804,74.125.200.0-255,2902,202564,9,297915
112,0.027811,172.31.36.0-255,66,202630,9,297915
113,0.027844,74.125.200.0-255,2902,205532,9,297915
114,0.027847,172.31.36.0-255,66,205598,9,297915
115,0.029928,74.125.200.0-255,2902,208500,9,297915
116,0.029935,172.31.36.0-255,66,208566,9,297915
117,0.029969,74.125.200.0-255,2902,211468,9,297915
118,0.029973,172.31.36.0-255,66,211534,9,297915
119,0.032066,74.125.200.0-255,2902,214436,9,297915
120,0.032073,172.31.36.0-255,66,214502,9,297915
121,0.032094,74.125.200.0-255,2902,217404,9,297915
122,0.032097,172.31.36.0-255,66,217470,9,297915
123,0.034209,74.125.200.0-255,2902,220372,9,297915
124,0.034216,172.31.36.0-255,66,220438,9,297915
125,0.034237,74.125.200.0-255,2902,223340,9,297915
126,0.03424,172.31.36.0-255,66,223406,9,297915
127,0.036329,74.125.200.0-255,2902,226308,9,297915
128,0.036338,172.31.36.0-255,66,226374,9,297915
129,0.036373,74.125.200.0-255,2902,229276,9,297915
130,0.036376,172.31.36.0-255,66,229342,9,297915
131,0.038487,74.125.200.0-255,2902,232244,9,297915
132,0.038493,172.31.36.0-255,66,232310,9,297915
133,0.038531,74.125.200.0-255,2902,235212,9,297915
134,0.038535,172.31.36.0-255,66,235278,9,297915
135,0.04062,74.125.200.0-255,2902,238180,9,297915
136,0.040627,172.31.36.0-255,66,238246,9,297915
137,0.040663,74.125.200.0-255,2902,241148,9,297915
138,0.040667,172.31.36.0-255,66,241214,9,297915
139,0.042745,74.125.200.0-255,2902,244116,9,297915
140,0.042752,172.31.36.0-255,66,244182,9,297915
141,0.042778,74.125.200.0-255,2902,247084,9,297915
142,0.042781,172.31.36.0-255,66,247150,9,297915
143,0.04447,172.31.36.0-255,176,247326,9,297915
144,0.044499,172.31.36.0-255,1116,248442,9,297915
145,0.044543,172.31.36.0-255,1514,249956,9,297915
146,0.044545,172.31.36.0-255,1514,251470,9,297915
147,0.044551,172.31.36.0-255,1514,252984,9,297915
148,0.044552,172.31.36.0-255,609,253593,9,297915
149,0.044863,74.125.200.0-255,2902,256495,9,297915
150,0.044869,172.31.36.0-255,66,256561,9,297915
151,0.044892,74.125.200.0-255,2902,259463,9,297915
152,0.044895,172.31.36.0-255,66,259529,9,297915
153,0.046121,104.244.42.0-255,66,259595,9,297915
154,0.046154,104.244.42.0-255,66,259661,9,297915
155,0.046208,104.244.42.0-255,66,259727,9,297915
156,0.04621,104.244.42.0-255,66,259793,9,297915
157,0.046993,74.125.200.0-255,1484,261277,9,297915
158,0.047022,74.125.200.0-255,4320,265597,9,297915
159,0.047027,172.31.36.0-255,66,265663,9,297915
160,0.049163,74.125.200.0-255,5738,271401,9,297915
161,0.049168,172.31.36.0-255,66,271467,9,297915
162,0.051283,74.125.200.0-255,4320,275787,9,297915
163,0.051288,172.31.36.0-255,66,275853,9,297915
164,0.051315,74.125.200.0-255,1484,277337,9,297915
165,0.053409,74.125.200.0-255,4320,281657,9,297915
166,0.053415,172.31.36.0-255,66,281723,9,297915
167,0.055548,74.125.200.0-255,4320,286043,9,297915
168,0.055554,172.31.36.0-255,66,286109,9,297915
169,0.055582,74.125.200.0-255,1484,287593,9,297915
170,0.05767,74.125.200.0-255,4320,291913,9,297915
171,0.057675,172.31.36.0-255,66,291979,9,297915
172,0.059799,74.125.200.0-255,2902,294881,9,297915
173,0.059805,172.31.36.0-255,66,294947,9,297915
174,0.059832,74.125.200.0-255,2902,297849,9,297915
175,0.059834,172.31.36.0-255,66,297915,9,297915
176,0.0,172.31.36.0-255,105,105,9,459
177,0.00036,172.31.36.0-255,90,195,9,459
178,0.000371,172.31.36.0-255,66,261,9,459
179,0.00263,74.125.200.0-255,66,327,9,459
180,0.002662,74.125.200.0-255,66,393,9,459
181,0.002686,172.31.36.0-255,66,459,9,459
182,0.0,74.125.24.0-255,262,262,9,197255
183,3e-05,74.125.24.0-255,1484,1746,9,197255
184,3.8e-05,74.125.24.0-255,4320,6066,9,197255
185,5e-05,74.125.24.0-255,1484,7550,9,197255
186,6.9e-05,74.125.24.0-255,6284,13834,9,197255
187,0.000105,172.31.36.0-255,66,13900,9,197255
188,0.000121,74.125.24.0-255,4320,18220,9,197255
189,0.000151,74.125.24.0-255,4320,22540,9,197255
190,0.000154,74.125.24.0-255,1484,24024,9,197255
191,0.000177,74.125.24.0-255,6797,30821,9,197255
192,0.000255,74.125.24.0-255,1484,32305,9,197255
193,0.000261,74.125.24.0-255,1484,33789,9,197255
194,0.000273,74.125.24.0-255,1484,35273,9,197255
195,0.000276,74.125.24.0-255,1484,36757,9,197255
196,0.000293,74.125.24.0-255,4320,41077,9,197255
197,0.000307,74.125.24.0-255,2902,43979,9,197255
198,0.000323,74.125.24.0-255,3961,47940,9,197255
199,0.000354,74.125.24.0-255,5738,53678,9,197255
200,0.000363,172.31.36.0-255,66,53744,9,197255
201,0.000374,74.125.24.0-255,1484,55228,9,197255
202,0.000385,74.125.24.0-255,4320,59548,9,197255
203,0.000391,172.31.36.0-255,66,59614,9,197255
204,0.000422,74.125.24.0-255,5670,65284,9,197255
205,0.000428,172.31.36.0-255,66,65350,9,197255
206,0.000435,74.125.24.0-255,386,65736,9,197255
207,0.000737,74.125.24.0-255,1484,67220,9,197255
208,0.000744,74.125.24.0-255,2902,70122,9,197255
209,0.000748,74.125.24.0-255,2902,73024,9,197255
210,0.00075,172.31.36.0-255,66,73090,9,197255
211,0.000759,172.31.36.0-255,66,73156,9,197255
212,0.000762,74.125.24.0-255,2902,76058,9,197255
213,0.000771,74.125.24.0-255,2902,78960,9,197255
214,0.000777,172.31.36.0-255,66,79026,9,197255
215,0.000811,74.125.24.0-255,4320,83346,9,197255
216,0.000821,172.31.36.0-255,66,83412,9,197255
217,0.000828,74.125.24.0-255,2184,85596,9,197255
218,0.000838,172.31.36.0-255,66,85662,9,197255
219,0.001221,74.125.24.0-255,1484,87146,9,197255
220,0.001228,74.125.24.0-255,2902,90048,9,197255
221,0.001233,172.31.36.0-255,66,90114,9,197255
222,0.001238,74.125.24.0-255,2902,93016,9,197255
223,0.00125,172.31.36.0-255,66,93082,9,197255
224,0.001265,74.125.24.0-255,2902,95984,9,197255
225,0.001273,172.31.36.0-255,66,96050,9,197255
226,0.001297,172.31.36.0-255,66,96116,9,197255
227,0.001315,74.125.24.0-255,4320,100436,9,197255
228,0.001325,172.31.36.0-255,66,100502,9,197255
229,0.001327,74.125.24.0-255,2184,102686,9,197255
230,0.001334,172.31.36.0-255,66,102752,9,197255
231,0.002628,74.125.24.0-255,1484,104236,9,197255
232,0.002653,74.125.24.0-255,2902,107138,9,197255
233,0.002658,172.31.36.0-255,66,107204,9,197255
234,0.002665,74.125.24.0-255,4320,111524,9,197255
235,0.002682,172.31.36.0-255,66,111590,9,197255
236,0.002688,172.31.36.0-255,66,111656,9,197255
237,0.002722,172.31.36.0-255,66,111722,9,197255
238,0.002739,74.125.24.0-255,5020,116742,9,197255
239,0.002748,74.125.24.0-255,1484,118226,9,197255
240,0.002752,172.31.36.0-255,66,118292,9,197255
241,0.002773,74.125.24.0-255,2902,121194,9,197255
242,0.002779,74.125.24.0-255,5738,126932,9,197255
243,0.00278,172.31.36.0-255,66,126998,9,197255
244,0.002785,172.31.36.0-255,66,127064,9,197255
245,0.002832,74.125.24.0-255,7156,134220,9,197255
246,0.002836,172.31.36.0-255,66,134286,9,197255
247,0.002871,74.125.24.0-255,3602,137888,9,197255
248,0.002876,172.31.36.0-255,66,137954,9,197255
249,0.002933,74.125.24.0-255,1484,139438,9,197255
250,0.002938,74.125.24.0-255,2902,142340,9,197255
251,0.002953,74.125.24.0-255,5738,148078,9,197255
252,0.002954,172.31.36.0-255,66,148144,9,197255
253,0.002959,172.31.36.0-255,66,148210,9,197255
254,0.003005,74.125.24.0-255,2902,151112,9,197255
255,0.003012,172.31.36.0-255,66,151178,9,197255
256,0.003051,172.31.36.0-255,66,151244,9,197255
257,0.003143,74.125.24.0-255,1484,152728,9,197255
258,0.003149,74.125.24.0-255,2902,155630,9,197255
259,0.003152,172.31.36.0-255,66,155696,9,197255
260,0.003158,74.125.24.0-255,5738,161434,9,197255
261,0.003168,172.31.36.0-255,66,161500,9,197255
262,0.003212,172.31.36.0-255,66,161566,9,197255
263,0.003234,74.125.24.0-255,4320,165886,9,197255
264,0.003238,172.31.36.0-255,66,165952,9,197255
265,0.003244,74.125.24.0-255,5738,171690,9,197255
266,0.003256,172.31.36.0-255,66,171756,9,197255
267,0.003267,74.125.24.0-255,2902,174658,9,197255
268,0.00327,172.31.36.0-255,66,174724,9,197255
269,0.003326,172.31.36.0-255,66,174790,9,197255
270,0.00334,172.31.36.0-255,66,174856,9,197255
271,0.003376,74.125.24.0-255,2902,177758,9,197255
272,0.003388,172.31.36.0-255,66,177824,9,197255
273,0.003393,172.31.36.0-255,66,177890,9,197255
274,0.003407,172.31.36.0-255,66,177956,9,197255
275,0.00346,172.31.36.0-255,66,178022,9,197255
276,0.003485,172.31.36.0-255,66,178088,9,197255
277,0.003503,172.31.36.0-255,66,178154,9,197255
278,0.003538,74.125.24.0-255,5738,183892,9,197255
279,0.003543,172.31.36.0-255,66,183958,9,197255
280,0.003569,74.125.24.0-255,5542,189500,9,197255
281,0.003573,74.125.24.0-255,105,189605,9,197255
282,0.00358,172.31.36.0-255,66,189671,9,197255
283,0.005302,172.31.36.0-255,105,189776,9,197255
284,0.00764,74.125.24.0-255,66,189842,9,197255
285,0.023023,172.31.36.0-255,172,190014,9,197255
286,0.023057,172.31.36.0-255,1115,191129,9,197255
287,0.023101,172.31.36.0-255,1514,192643,9,197255
288,0.023103,172.31.36.0-255,1514,194157,9,197255
289,0.023108,172.31.36.0-255,1514,195671,9,197255
290,0.02311,172.31.36.0-255,1320,196991,9,197255
291,0.024616,104.244.42.0-255,66,197057,9,197255
292,0.024646,104.244.42.0-255,66,197123,9,197255
293,0.024713,104.244.42.0-255,66,197189,9,197255
294,0.024718,104.244.42.0-255,66,197255,9,197255
295,0.0,74.125.24.0-255,160,160,9,306155
296,3.6e-05,172.31.36.0-255,66,226,9,306155
297,4.4e-05,74.125.24.0-255,1484,1710,9,306155
298,4.8e-05,172.31.36.0-255,66,1776,9,306155
299,5.3e-05,74.125.24.0-255,2902,4678,9,306155
300,6.3e-05,172.31.36.0-255,66,4744,9,306155
301,7.1e-05,74.125.24.0-255,7156,11900,9,306155
302,7.3e-05,172.31.36.0-255,66,11966,9,306155
303,0.000113,74.125.24.0-255,2072,14038,9,306155
304,0.000116,172.31.36.0-255,66,14104,9,306155
305,0.000182,74.125.24.0-255,1484,15588,9,306155
306,0.000185,172.31.36.0-255,66,15654,9,306155
307,0.000191,74.125.24.0-255,2902,18556,9,306155
308,0.000194,172.31.36.0-255,66,18622,9,306155
309,0.000229,74.125.24.0-255,2902,21524,9,306155
310,0.000232,172.31.36.0-255,66,21590,9,306155
311,0.00028,74.125.24.0-255,4320,25910,9,306155
312,0.000284,172.31.36.0-255,66,25976,9,306155
313,0.000291,74.125.24.0-255,5379,31355,9,306155
314,0.000293,172.31.36.0-255,66,31421,9,306155
315,0.000343,74.125.24.0-255,1484,32905,9,306155
316,0.000347,172.31.36.0-255,66,32971,9,306155
317,0.000352,74.125.24.0-255,2902,35873,9,306155
318,0.000354,172.31.36.0-255,66,35939,9,306155
319,0.000366,74.125.24.0-255,5738,41677,9,306155
320,0.000369,172.31.36.0-255,66,41743,9,306155
321,0.000377,74.125.24.0-255,6797,48540,9,306155
322,0.00038,172.31.36.0-255,66,48606,9,306155
323,0.000454,74.125.24.0-255,1484,50090,9,306155
324,0.000458,172.31.36.0-255,66,50156,9,306155
325,0.000463,74.125.24.0-255,2902,53058,9,306155
326,0.000465,172.31.36.0-255,66,53124,9,306155
327,0.000495,74.125.24.0-255,5738,58862,9,306155
328,0.000498,172.31.36.0-255,66,58928,9,306155
329,0.00053,74.125.24.0-255,6797,65725,9,306155
330,0.000533,172.31.36.0-255,66,65791,9,306155
331,0.000897,74.125.24.0-255,645,66436,9,306155
332,0.000919,74.125.24.0-255,1484,67920,9,306155
333,0.000922,172.31.36.0-255,66,67986,9,306155
334,0.000943,74.125.24.0-255,4320,72306,9,306155
335,0.000946,172.31.36.0-255,66,72372,9,306155
336,0.000951,74.125.24.0-255,2902,75274,9,306155
337,0.000954,172.31.36.0-255,66,75340,9,306155
338,0.00099,74.125.24.0-255,7156,82496,9,306155
339,0.000999,172.31.36.0-255,66,82562,9,306155
340,0.001011,172.31.36.0-255,66,82628,9,306155
341,0.001051,172.31.36.0-255,66,82694,9,306155
342,0.001139,74.125.24.0-255,1484,84178,9,306155
343,0.001154,74.125.24.0-255,2902,87080,9,306155
344,0.001157,172.31.36.0-255,66,87146,9,306155
345,0.001185,74.125.24.0-255,4320,91466,9,306155
346,0.001188,172.31.36.0-255,66,91532,9,306155
347,0.001213,74.125.24.0-255,1484,93016,9,306155
348,0.001239,74.125.24.0-255,6249,99265,9,306155
349,0.001243,172.31.36.0-255,66,99331,9,306155
350,0.001379,74.125.24.0-255,1484,100815,9,306155
351,0.001397,74.125.24.0-255,2902,103717,9,306155
352,0.0014,74.125.24.0-255,1484,105201,9,306155
353,0.001401,172.31.36.0-255,66,105267,9,306155
354,0.00143,74.125.24.0-255,4320,109587,9,306155
355,0.001434,172.31.36.0-255,66,109653,9,306155
356,0.001435,74.125.24.0-255,4320,113973,9,306155
357,0.001437,172.31.36.0-255,66,114039,9,306155
358,0.001463,74.125.24.0-255,5738,119777,9,306155
359,0.001467,172.31.36.0-255,66,119843,9,306155
360,0.0015,74.125.24.0-255,5738,125581,9,306155
361,0.001503,172.31.36.0-255,66,125647,9,306155
362,0.001514,172.31.36.0-255,66,125713,9,306155
363,0.001637,74.125.24.0-255,1484,127197,9,306155
364,0.001654,74.125.24.0-255,2902,130099,9,306155
365,0.001657,172.31.36.0-255,66,130165,9,306155
366,0.001662,74.125.24.0-255,2902,133067,9,306155
367,0.001664,172.31.36.0-255,66,133133,9,306155
368,0.001687,74.125.24.0-255,2902,136035,9,306155
369,0.001694,172.31.36.0-255,66,136101,9,306155
370,0.001733,172.31.36.0-255,66,136167,9,306155
371,0.001746,172.31.36.0-255,66,136233,9,306155
372,0.001777,74.125.24.0-255,3602,139835,9,306155
373,0.001782,172.31.36.0-255,66,139901,9,306155
374,0.001788,172.31.36.0-255,66,139967,9,306155
375,0.001832,74.125.24.0-255,5738,145705,9,306155
376,0.001836,172.31.36.0-255,66,145771,9,306155
377,0.001857,172.31.36.0-255,66,145837,9,306155
378,0.001943,74.125.24.0-255,1484,147321,9,306155
379,0.001955,74.125.24.0-255,2902,150223,9,306155
380,0.001958,172.31.36.0-255,66,150289,9,306155
381,0.001986,74.125.24.0-255,5738,156027,9,306155
382,0.001989,172.31.36.0-255,66,156093,9,306155
383,0.002025,172.31.36.0-255,66,156159,9,306155
384,0.002028,74.125.24.0-255,1484,157643,9,306155
385,0.002062,172.31.36.0-255,66,157709,9,306155
386,0.002111,74.125.24.0-255,2184,159893,9,306155
387,0.002115,172.31.36.0-255,66,159959,9,306155
388,0.002262,74.125.24.0-255,1484,161443,9,306155
389,0.002279,74.125.24.0-255,2902,164345,9,306155
390,0.002284,172.31.36.0-255,66,164411,9,306155
391,0.002291,74.125.24.0-255,4320,168731,9,306155
392,0.002293,172.31.36.0-255,66,168797,9,306155
393,0.002313,74.125.24.0-255,1484,170281,9,306155
394,0.002323,74.125.24.0-255,2902,173183,9,306155
395,0.002326,172.31.36.0-255,66,173249,9,306155
396,0.002364,172.31.36.0-255,66,173315,9,306155
397,0.00237,74.125.24.0-255,4320,177635,9,306155
398,0.002372,172.31.36.0-255,66,177701,9,306155
399,0.002375,74.125.24.0-255,1484,179185,9,306155
400,0.00241,74.125.24.0-255,5020,184205,9,306155
401,0.002414,172.31.36.0-255,66,184271,9,306155
402,0.005064,74.125.24.0-255,5738,190009,9,306155
403,0.005085,172.31.36.0-255,66,190075,9,306155
404,0.007732,74.125.24.0-255,5738,195813,9,306155
405,0.007743,172.31.36.0-255,66,195879,9,306155
406,0.010403,74.125.24.0-255,5738,201617,9,306155
407,0.010429,172.31.36.0-255,66,201683,9,306155
408,0.013052,74.125.24.0-255,5738,207421,9,306155
409,0.013068,172.31.36.0-255,66,207487,9,306155
410,0.015682,74.125.24.0-255,5738,213225,9,306155
411,0.015687,172.31.36.0-255,66,213291,9,306155
412,0.018323,74.125.24.0-255,5738,219029,9,306155
413,0.018332,172.31.36.0-255,66,219095,9,306155
414,0.020939,74.125.24.0-255,5738,224833,9,306155
415,0.020953,172.31.36.0-255,66,224899,9,306155
416,0.023572,74.125.24.0-255,5738,230637,9,306155
417,0.023583,172.31.36.0-255,66,230703,9,306155
418,0.026221,74.125.24.0-255,5738,236441,9,306155
419,0.026231,172.31.36.0-255,66,236507,9,306155
420,0.028838,74.125.24.0-255,5738,242245,9,306155
421,0.028846,172.31.36.0-255,66,242311,9,306155
422,0.031468,74.125.24.0-255,5738,248049,9,306155
423,0.031475,172.31.36.0-255,66,248115,9,306155
424,0.03409,74.125.24.0-255,5738,253853,9,306155
425,0.034098,172.31.36.0-255,66,253919,9,306155
426,0.036749,74.125.24.0-255,5738,259657,9,306155
427,0.036762,172.31.36.0-255,66,259723,9,306155
428,0.039381,74.125.24.0-255,5738,265461,9,306155
429,0.039393,172.31.36.0-255,66,265527,9,306155
430,0.042017,74.125.24.0-255,5738,271265,9,306155
431,0.042031,172.31.36.0-255,66,271331,9,306155
432,0.044662,74.125.24.0-255,5738,277069,9,306155
433,0.044671,172.31.36.0-255,66,277135,9,306155
434,0.047285,74.125.24.0-255,5738,282873,9,306155
435,0.047296,172.31.36.0-255,66,282939,9,306155
436,0.049901,74.125.24.0-255,5738,288677,9,306155
437,0.049909,172.31.36.0-255,66,288743,9,306155
438,0.052522,74.125.24.0-255,5738,294481,9,306155
439,0.052531,172.31.36.0-255,66,294547,9,306155
440,0.055145,74.125.24.0-255,5738,300285,9,306155
441,0.055153,172.31.36.0-255,66,300351,9,306155
442,0.057779,74.125.24.0-255,5738,306089,9,306155
443,0.057788,172.31.36.0-255,66,306155,9,306155
444,0.0,172.217.27.0-255,152,152,9,290031
445,3e-05,172.31.36.0-255,66,218,9,290031
446,3.7e-05,172.217.27.0-255,1484,1702,9,290031
447,4.2e-05,172.31.36.0-255,66,1768,9,290031
448,4.7e-05,172.217.27.0-255,2902,4670,9,290031
449,5e-05,172.31.36.0-255,66,4736,9,290031
450,5.7e-05,172.217.27.0-255,7156,11892,9,290031
451,6e-05,172.31.36.0-255,66,11958,9,290031
452,8e-05,172.217.27.0-255,2079,14037,9,290031
453,8.3e-05,172.31.36.0-255,66,14103,9,290031
454,0.000215,172.217.27.0-255,1484,15587,9,290031
455,0.00022,172.31.36.0-255,66,15653,9,290031
456,0.000226,172.217.27.0-255,2902,18555,9,290031
457,0.000229,172.31.36.0-255,66,18621,9,290031
458,0.000233,172.217.27.0-255,1484,20105,9,290031
459,0.000235,172.31.36.0-255,66,20171,9,290031
460,0.000261,172.217.27.0-255,4320,24491,9,290031
461,0.000265,172.31.36.0-255,66,24557,9,290031
462,0.000271,172.217.27.0-255,6797,31354,9,290031
463,0.000274,172.31.36.0-255,66,31420,9,290031
464,0.000311,172.217.27.0-255,1484,32904,9,290031
465,0.000314,172.31.36.0-255,66,32970,9,290031
466,0.000338,172.217.27.0-255,2902,35872,9,290031
467,0.000341,172.31.36.0-255,66,35938,9,290031
468,0.000348,172.217.27.0-255,5738,41676,9,290031
469,0.000351,172.31.36.0-255,66,41742,9,290031
470,0.000405,172.217.27.0-255,6797,48539,9,290031
471,0.000409,172.31.36.0-255,66,48605,9,290031
472,0.000498,172.217.27.0-255,1484,50089,9,290031
473,0.000501,172.31.36.0-255,66,50155,9,290031
474,0.000515,172.217.27.0-255,2902,53057,9,290031
475,0.000518,172.31.36.0-255,66,53123,9,290031
476,0.000544,172.217.27.0-255,4320,57443,9,290031
477,0.000547,172.31.36.0-255,66,57509,9,290031
478,0.000552,172.217.27.0-255,2902,60411,9,290031
479,0.000554,172.31.36.0-255,66,60477,9,290031
480,0.000571,172.217.27.0-255,5674,66151,9,290031
481,0.000575,172.31.36.0-255,66,66217,9,290031
482,0.00101,172.217.27.0-255,136,66353,9,290031
483,0.001019,172.217.27.0-255,342,66695,9,290031
484,0.001408,172.217.27.0-255,1484,68179,9,290031
485,0.001414,172.31.36.0-255,66,68245,9,290031
486,0.001421,172.217.27.0-255,2902,71147,9,290031
487,0.001423,172.31.36.0-255,66,71213,9,290031
488,0.001429,172.217.27.0-255,5738,76951,9,290031
489,0.001432,172.31.36.0-255,66,77017,9,290031
490,0.001437,172.217.27.0-255,4320,81337,9,290031
491,0.001439,172.31.36.0-255,66,81403,9,290031
492,0.001457,172.217.27.0-255,2902,84305,9,290031
493,0.001459,172.31.36.0-255,66,84371,9,290031
494,0.001491,172.31.36.0-255,66,84437,9,290031
495,0.001497,172.217.27.0-255,5738,90175,9,290031
496,0.001499,172.31.36.0-255,66,90241,9,290031
497,0.001514,172.217.27.0-255,2184,92425,9,290031
498,0.001516,172.31.36.0-255,66,92491,9,290031
499,0.003249,172.217.27.0-255,2902,95393,9,290031
500,0.003252,172.31.36.0-255,66,95459,9,290031
501,0.003277,172.217.27.0-255,2902,98361,9,290031
502,0.00328,172.31.36.0-255,66,98427,9,290031
503,0.005004,172.217.27.0-255,2902,101329,9,290031
504,0.005007,172.31.36.0-255,66,101395,9,290031
505,0.005025,172.217.27.0-255,2902,104297,9,290031
506,0.005027,172.31.36.0-255,66,104363,9,290031
507,0.006764,172.217.27.0-255,2902,107265,9,290031
508,0.006769,172.31.36.0-255,66,107331,9,290031
509,0.006788,172.217.27.0-255,2902,110233,9,290031
510,0.006791,172.31.36.0-255,66,110299,9,290031
511,0.008522,172.217.27.0-255,2902,113201,9,290031
512,0.008531,172.31.36.0-255,66,113267,9,290031
513,0.008552,172.217.27.0-255,2902,116169,9,290031
514,0.008555,172.31.36.0-255,66,116235,9,290031
515,0.010284,172.217.27.0-255,2902,119137,9,290031
516,0.010291,172.31.36.0-255,66,119203,9,290031
517,0.010311,172.217.27.0-255,2902,122105,9,290031
518,0.010313,172.31.36.0-255,66,122171,9,290031
519,0.012059,172.217.27.0-255,5738,127909,9,290031
520,0.012066,172.31.36.0-255,66,127975,9,290031
521,0.013852,172.217.27.0-255,5738,133713,9,290031
522,0.01386,172.31.36.0-255,66,133779,9,290031
523,0.015637,172.217.27.0-255,5738,139517,9,290031
524,0.015644,172.31.36.0-255,66,139583,9,290031
525,0.017413,172.217.27.0-255,5738,145321,9,290031
526,0.01742,172.31.36.0-255,66,145387,9,290031
527,0.019186,172.217.27.0-255,5738,151125,9,290031
528,0.019193,172.31.36.0-255,66,151191,9,290031
529,0.02097,172.217.27.0-255,5738,156929,9,290031
530,0.020977,172.31.36.0-255,66,156995,9,290031
531,0.022742,172.217.27.0-255,5738,162733,9,290031
532,0.022749,172.31.36.0-255,66,162799,9,290031
533,0.024517,172.217.27.0-255,4320,167119,9,290031
534,0.024526,172.31.36.0-255,66,167185,9,290031
535,0.02456,172.217.27.0-255,1484,168669,9,290031
536,0.026279,172.217.27.0-255,4320,172989,9,290031
537,0.026286,172.31.36.0-255,66,173055,9,290031
538,0.028057,172.217.27.0-255,5738,178793,9,290031
539,0.028064,172.31.36.0-255,66,178859,9,290031
540,0.029825,172.217.27.0-255,5738,184597,9,290031
541,0.029831,172.31.36.0-255,66,184663,9,290031
542,0.031601,172.217.27.0-255,5738,190401,9,290031
543,0.031608,172.31.36.0-255,66,190467,9,290031
544,0.03337,172.217.27.0-255,4320,194787,9,290031
545,0.033377,172.31.36.0-255,66,194853,9,290031
546,0.033396,172.217.27.0-255,1484,196337,9,290031
547,0.035131,172.217.27.0-255,4320,200657,9,290031
548,0.035138,172.31.36.0-255,66,200723,9,290031
549,0.036908,172.217.27.0-255,2902,203625,9,290031
550,0.036914,172.31.36.0-255,66,203691,9,290031
551,0.03695,172.217.27.0-255,2902,206593,9,290031
552,0.036953,172.31.36.0-255,66,206659,9,290031
553,0.038685,172.217.27.0-255,2902,209561,9,290031
554,0.038692,172.31.36.0-255,66,209627,9,290031
555,0.038734,172.217.27.0-255,2902,212529,9,290031
556,0.038738,172.31.36.0-255,66,212595,9,290031
557,0.040455,172.217.27.0-255,2902,215497,9,290031
558,0.040462,172.31.36.0-255,66,215563,9,290031
559,0.040535,172.217.27.0-255,2902,218465,9,290031
560,0.040541,172.31.36.0-255,66,218531,9,290031
561,0.042235,172.217.27.0-255,2902,221433,9,290031
562,0.042241,172.31.36.0-255,66,221499,9,290031
563,0.042286,172.217.27.0-255,2902,224401,9,290031
564,0.042289,172.31.36.0-255,66,224467,9,290031
565,0.044008,172.217.27.0-255,2902,227369,9,290031
566,0.044015,172.31.36.0-255,66,227435,9,290031
567,0.044051,172.217.27.0-255,2902,230337,9,290031
568,0.044055,172.31.36.0-255,66,230403,9,290031
569,0.045766,172.217.27.0-255,2902,233305,9,290031
570,0.045772,172.31.36.0-255,66,233371,9,290031
571,0.045812,172.217.27.0-255,2902,236273,9,290031
572,0.045815,172.31.36.0-255,66,236339,9,290031
573,0.047526,172.217.27.0-255,2902,239241,9,290031
574,0.047532,172.31.36.0-255,66,239307,9,290031
575,0.047582,172.217.27.0-255,2902,242209,9,290031
576,0.047586,172.31.36.0-255,66,242275,9,290031
577,0.049304,172.217.27.0-255,2902,245177,9,290031
578,0.049311,172.31.36.0-255,66,245243,9,290031
579,0.049375,172.217.27.0-255,2902,248145,9,290031
580,0.04938,172.31.36.0-255,66,248211,9,290031
581,0.051073,172.217.27.0-255,2902,251113,9,290031
582,0.05108,172.31.36.0-255,66,251179,9,290031
583,0.051144,172.217.27.0-255,2902,254081,9,290031
584,0.051148,172.31.36.0-255,66,254147,9,290031
585,0.051915,172.31.36.0-255,176,254323,9,290031
586,0.051946,172.31.36.0-255,1116,255439,9,290031
587,0.051986,172.31.36.0-255,1514,256953,9,290031
588,0.051988,172.31.36.0-255,1514,258467,9,290031
589,0.051993,172.31.36.0-255,1514,259981,9,290031
590,0.051994,172.31.36.0-255,106,260087,9,290031
591,0.052837,172.217.27.0-255,2902,262989,9,290031
592,0.052844,172.31.36.0-255,66,263055,9,290031
593,0.052899,172.217.27.0-255,2902,265957,9,290031
594,0.052904,172.31.36.0-255,66,266023,9,290031
595,0.053661,104.244.42.0-255,66,266089,9,290031
596,0.053669,104.244.42.0-255,66,266155,9,290031
597,0.053671,104.244.42.0-255,66,266221,9,290031
598,0.053675,104.244.42.0-255,66,266287,9,290031
599,0.054606,172.217.27.0-255,2902,269189,9,290031
600,0.054612,172.31.36.0-255,66,269255,9,290031
601,0.054655,172.217.27.0-255,2902,272157,9,290031
602,0.054658,172.31.36.0-255,66,272223,9,290031
603,0.05637,172.217.27.0-255,2902,275125,9,290031
604,0.056375,172.31.36.0-255,66,275191,9,290031
605,0.056417,172.217.27.0-255,2902,278093,9,290031
606,0.056421,172.31.36.0-255,66,278159,9,290031
607,0.058128,172.217.27.0-255,2902,281061,9,290031
608,0.058134,172.31.36.0-255,66,281127,9,290031
609,0.058167,172.217.27.0-255,2902,284029,9,290031
610,0.058169,172.31.36.0-255,66,284095,9,290031
611,0.059886,172.217.27.0-255,2902,286997,9,290031
612,0.059891,172.31.36.0-255,66,287063,9,290031
613,0.059927,172.217.27.0-255,2902,289965,9,290031
614,0.05993,172.31.36.0-255,66,290031,9,290031
615,0.0,74.125.24.0-255,153,153,9,366576
616,2.9e-05,172.31.36.0-255,66,219,9,366576
617,3.5e-05,74.125.24.0-255,1484,1703,9,366576
618,3.9e-05,172.31.36.0-255,66,1769,9,366576
619,4.4e-05,74.125.24.0-255,2902,4671,9,366576
620,4.6e-05,172.31.36.0-255,66,4737,9,366576
621,6.1e-05,74.125.24.0-255,7156,11893,9,366576
622,6.3e-05,172.31.36.0-255,66,11959,9,366576
623,9.8e-05,74.125.24.0-255,2011,13970,9,366576
624,0.000101,172.31.36.0-255,66,14036,9,366576
625,0.000126,74.125.24.0-255,2902,16938,9,366576
626,0.000129,172.31.36.0-255,66,17004,9,366576
627,0.000134,74.125.24.0-255,4320,21324,9,366576
628,0.000136,172.31.36.0-255,66,21390,9,366576
629,0.000141,74.125.24.0-255,2902,24292,9,366576
630,0.000142,172.31.36.0-255,66,24358,9,366576
631,0.000164,74.125.24.0-255,5738,30096,9,366576
632,0.000173,172.31.36.0-255,66,30162,9,366576
633,0.000176,74.125.24.0-255,1125,31287,9,366576
634,0.000178,172.31.36.0-255,66,31353,9,366576
635,0.000494,74.125.24.0-255,1484,32837,9,366576
636,0.000497,74.125.24.0-255,1484,34321,9,366576
637,0.0005,172.31.36.0-255,66,34387,9,366576
638,0.000504,172.31.36.0-255,66,34453,9,366576
639,0.000534,74.125.24.0-255,1484,35937,9,366576
640,0.000541,172.31.36.0-255,66,36003,9,366576
641,0.000547,74.125.24.0-255,5738,41741,9,366576
642,0.000549,172.31.36.0-255,66,41807,9,366576
643,0.000556,74.125.24.0-255,6797,48604,9,366576
644,0.000558,172.31.36.0-255,66,48670,9,366576
645,0.000587,74.125.24.0-255,5738,54408,9,366576
646,0.00059,172.31.36.0-255,66,54474,9,366576
647,0.000632,74.125.24.0-255,2854,57328,9,366576
648,0.000633,172.31.36.0-255,66,57394,9,366576
649,0.000639,172.31.36.0-255,66,57460,9,366576
650,0.000658,74.125.24.0-255,111,57571,9,366576
651,0.000807,74.125.24.0-255,1484,59055,9,366576
652,0.000811,172.31.36.0-255,66,59121,9,366576
653,0.000817,74.125.24.0-255,2902,62023,9,366576
654,0.00082,74.125.24.0-255,1484,63507,9,366576
655,0.000835,172.31.36.0-255,66,63573,9,366576
656,0.000839,74.125.24.0-255,4320,67893,9,366576
657,0.000852,172.31.36.0-255,66,67959,9,366576
658,0.000863,74.125.24.0-255,7156,75115,9,366576
659,0.000869,172.31.36.0-255,66,75181,9,366576
660,0.000892,74.125.24.0-255,3961,79142,9,366576
661,0.000903,172.31.36.0-255,66,79208,9,366576
662,0.000918,172.31.36.0-255,66,79274,9,366576
663,0.000926,74.125.24.0-255,1125,80399,9,366576
664,0.001119,172.31.36.0-255,66,80465,9,366576
665,0.001223,74.125.24.0-255,330,80795,9,366576
666,0.001475,74.125.24.0-255,1484,82279,9,366576
667,0.001483,74.125.24.0-255,2902,85181,9,366576
668,0.001505,74.125.24.0-255,5738,90919,9,366576
669,0.001524,74.125.24.0-255,5738,96657,9,366576
670,0.001541,74.125.24.0-255,7156,103813,9,366576
671,0.001547,74.125.24.0-255,7156,110969,9,366576
672,0.001565,74.125.24.0-255,3602,114571,9,366576
673,0.001666,74.125.24.0-255,1484,116055,9,366576
674,0.001672,74.125.24.0-255,2902,118957,9,366576
675,0.001688,74.125.24.0-255,5738,124695,9,366576
676,0.001741,74.125.24.0-255,2902,127597,9,366576
677,0.001757,74.125.24.0-255,7156,134753,9,366576
678,0.001797,74.125.24.0-255,2902,137655,9,366576
679,0.001814,74.125.24.0-255,766,138421,9,366576
680,0.001819,74.125.24.0-255,4320,142741,9,366576
681,0.00183,74.125.24.0-255,1484,144225,9,366576
682,0.001855,74.125.24.0-255,4320,148545,9,366576
683,0.001874,74.125.24.0-255,5738,154283,9,366576
684,0.001901,74.125.24.0-255,4320,158603,9,366576
685,0.001915,74.125.24.0-255,5020,163623,9,366576
686,0.001942,74.125.24.0-255,7156,170779,9,366576
687,0.001955,74.125.24.0-255,2902,173681,9,366576
688,0.00196,74.125.24.0-255,5738,179419,9,366576
689,0.001975,74.125.24.0-255,2902,182321,9,366576
690,0.00206,74.125.24.0-255,2902,185223,9,366576
691,0.002094,74.125.24.0-255,3602,188825,9,366576
692,0.002157,74.125.24.0-255,1484,190309,9,366576
693,0.002161,74.125.24.0-255,2902,193211,9,366576
694,0.002166,74.125.24.0-255,5738,198949,9,366576
695,0.002173,74.125.24.0-255,7156,206105,9,366576
696,0.002195,74.125.24.0-255,2902,209007,9,366576
697,0.002217,74.125.24.0-255,5738,214745,9,366576
698,0.002221,74.125.24.0-255,2902,217647,9,366576
699,0.002243,74.125.24.0-255,5020,222667,9,366576
700,0.005325,172.31.36.0-255,66,222733,9,366576
701,0.007681,74.125.24.0-255,5738,228471,9,366576
702,0.007689,172.31.36.0-255,66,228537,9,366576
703,0.01003,74.125.24.0-255,5738,234275,9,366576
704,0.010041,172.31.36.0-255,66,234341,9,366576
705,0.012343,74.125.24.0-255,5738,240079,9,366576
706,0.012976,172.31.36.0-255,66,240145,9,366576
707,0.015323,74.125.24.0-255,5738,245883,9,366576
708,0.015337,172.31.36.0-255,66,245949,9,366576
709,0.017678,74.125.24.0-255,5738,251687,9,366576
710,0.017725,172.31.36.0-255,66,251753,9,366576
711,0.020044,74.125.24.0-255,5738,257491,9,366576
712,0.020051,172.31.36.0-255,66,257557,9,366576
713,0.022361,74.125.24.0-255,5738,263295,9,366576
714,0.022368,172.31.36.0-255,66,263361,9,366576
715,0.024713,74.125.24.0-255,5738,269099,9,366576
716,0.02472,172.31.36.0-255,66,269165,9,366576
717,0.027046,74.125.24.0-255,5738,274903,9,366576
718,0.027054,172.31.36.0-255,66,274969,9,366576
719,0.029384,74.125.24.0-255,5738,280707,9,366576
720,0.029391,172.31.36.0-255,66,280773,9,366576
721,0.03171,74.125.24.0-255,5738,286511,9,366576
722,0.031717,172.31.36.0-255,66,286577,9,366576
723,0.03406,74.125.24.0-255,5738,292315,9,366576
724,0.034068,172.31.36.0-255,66,292381,9,366576
725,0.035395,172.31.36.0-255,176,292557,9,366576
726,0.035425,172.31.36.0-255,1112,293669,9,366576
727,0.035468,172.31.36.0-255,1514,295183,9,366576
728,0.03547,172.31.36.0-255,1514,296697,9,366576
729,0.035471,172.31.36.0-255,1514,298211,9,366576
730,0.035473,172.31.36.0-255,1514,299725,9,366576
731,0.035497,172.31.36.0-255,1489,301214,9,366576
732,0.036446,74.125.24.0-255,5738,306952,9,366576
733,0.036453,172.31.36.0-255,66,307018,9,366576
734,0.036975,104.244.42.0-255,66,307084,9,366576
735,0.036983,104.244.42.0-255,66,307150,9,366576
736,0.037039,104.244.42.0-255,66,307216,9,366576
737,0.038754,74.125.24.0-255,2902,310118,9,366576
738,0.038759,172.31.36.0-255,66,310184,9,366576
739,0.038799,74.125.24.0-255,2902,313086,9,366576
740,0.038817,172.31.36.0-255,66,313152,9,366576
741,0.041067,74.125.24.0-255,2902,316054,9,366576
742,0.041073,172.31.36.0-255,66,316120,9,366576
743,0.041107,74.125.24.0-255,2902,319022,9,366576
744,0.041128,172.31.36.0-255,66,319088,9,366576
745,0.043386,74.125.24.0-255,2902,321990,9,366576
746,0.043392,172.31.36.0-255,66,322056,9,366576
747,0.043445,74.125.24.0-255,2902,324958,9,366576
748,0.043475,172.31.36.0-255,66,325024,9,366576
749,0.045694,74.125.24.0-255,2902,327926,9,366576
750,0.045699,172.31.36.0-255,66,327992,9,366576
751,0.045769,74.125.24.0-255,2902,330894,9,366576
752,0.045779,172.31.36.0-255,66,330960,9,366576
753,0.047983,74.125.24.0-255,2902,333862,9,366576
754,0.047989,172.31.36.0-255,66,333928,9,366576
755,0.048078,74.125.24.0-255,2902,336830,9,366576
756,0.048082,172.31.36.0-255,66,336896,9,366576
757,0.050309,74.125.24.0-255,2902,339798,9,366576
758,0.050314,172.31.36.0-255,66,339864,9,366576
759,0.050366,74.125.24.0-255,2902,342766,9,366576
760,0.050388,172.31.36.0-255,66,342832,9,366576
761,0.052603,74.125.24.0-255,2902,345734,9,366576
762,0.052608,172.31.36.0-255,66,345800,9,366576
763,0.052705,74.125.24.0-255,2902,348702,9,366576
764,0.05271,172.31.36.0-255,66,348768,9,366576
765,0.054908,74.125.24.0-255,2902,351670,9,366576
766,0.054913,172.31.36.0-255,66,351736,9,366576
767,0.055013,74.125.24.0-255,2902,354638,9,366576
768,0.055017,172.31.36.0-255,66,354704,9,366576
769,0.057225,74.125.24.0-255,2902,357606,9,366576
770,0.057231,172.31.36.0-255,66,357672,9,366576
771,0.057323,74.125.24.0-255,2902,360574,9,366576
772,0.057328,172.31.36.0-255,66,360640,9,366576
773,0.059528,74.125.24.0-255,2902,363542,9,366576
774,0.059533,172.31.36.0-255,66,363608,9,366576
775,0.059636,74.125.24.0-255,2902,366510,9,366576
776,0.059641,172.31.36.0-255,66,366576,9,366576
777,0.0,172.31.36.0-255,105,105,9,459
778,0.000371,172.31.36.0-255,90,195,9,459
779,0.000379,172.31.36.0-255,66,261,9,459
780,0.003026,74.125.24.0-255,66,327,9,459
781,0.003059,74.125.24.0-255,66,393,9,459
782,0.003081,172.31.36.0-255,66,459,9,459
783,0.0,172.31.36.0-255,105,105,9,105
784,0.0,172.31.36.0-255,105,105,9,105
785,0.0,74.125.24.0-255,153,153,9,280550
786,2.3e-05,172.31.36.0-255,66,219,9,280550
787,3e-05,74.125.24.0-255,1484,1703,9,280550
788,3.4e-05,172.31.36.0-255,66,1769,9,280550
789,4e-05,74.125.24.0-255,2902,4671,9,280550
790,4.3e-05,172.31.36.0-255,66,4737,9,280550
791,6e-05,74.125.24.0-255,7156,11893,9,280550
792,6.3e-05,172.31.36.0-255,66,11959,9,280550
793,6.7e-05,74.125.24.0-255,2085,14044,9,280550
794,7e-05,172.31.36.0-255,66,14110,9,280550
795,7.6e-05,74.125.24.0-255,2902,17012,9,280550
796,7.9e-05,172.31.36.0-255,66,17078,9,280550
797,0.000123,172.31.36.0-255,66,17144,9,280550
798,0.00013,74.125.24.0-255,5379,22523,9,280550
799,0.000133,172.31.36.0-255,66,22589,9,280550
800,0.000603,74.125.24.0-255,1484,24073,9,280550
801,0.000608,172.31.36.0-255,66,24139,9,280550
802,0.000613,74.125.24.0-255,2902,27041,9,280550
803,0.000615,172.31.36.0-255,66,27107,9,280550
804,0.000642,74.125.24.0-255,5738,32845,9,280550
805,0.000644,172.31.36.0-255,66,32911,9,280550
806,0.000695,172.31.36.0-255,66,32977,9,280550
807,0.000717,74.125.24.0-255,1484,34461,9,280550
808,0.000719,172.31.36.0-255,66,34527,9,280550
809,0.000726,74.125.24.0-255,7156,41683,9,280550
810,0.000727,172.31.36.0-255,66,41749,9,280550
811,0.000746,74.125.24.0-255,2902,44651,9,280550
812,0.000751,172.31.36.0-255,66,44717,9,280550
813,0.000754,74.125.24.0-255,766,45483,9,280550
814,0.000756,172.31.36.0-255,66,45549,9,280550
815,0.000792,74.125.24.0-255,425,45974,9,280550
816,0.000894,74.125.24.0-255,1484,47458,9,280550
817,0.000907,172.31.36.0-255,66,47524,9,280550
818,0.000935,74.125.24.0-255,2902,50426,9,280550
819,0.000949,74.125.24.0-255,1484,51910,9,280550
820,0.000954,172.31.36.0-255,66,51976,9,280550
821,0.000964,74.125.24.0-255,4320,56296,9,280550
822,0.000972,74.125.24.0-255,2902,59198,9,280550
823,0.000983,74.125.24.0-255,1484,60682,9,280550
824,0.001012,172.31.36.0-255,66,60748,9,280550
825,0.001022,74.125.24.0-255,7156,67904,9,280550
826,0.001027,172.31.36.0-255,66,67970,9,280550
827,0.001046,74.125.24.0-255,3602,71572,9,280550
828,0.001064,172.31.36.0-255,66,71638,9,280550
829,0.001089,74.125.24.0-255,348,71986,9,280550
830,0.001124,74.125.24.0-255,1484,73470,9,280550
831,0.001127,74.125.24.0-255,1484,74954,9,280550
832,0.001141,172.31.36.0-255,66,75020,9,280550
833,0.001153,74.125.24.0-255,2902,77922,9,280550
834,0.001169,172.31.36.0-255,66,77988,9,280550
835,0.001189,74.125.24.0-255,2902,80890,9,280550
836,0.001194,172.31.36.0-255,66,80956,9,280550
837,0.00122,74.125.24.0-255,1484,82440,9,280550
838,0.001236,74.125.24.0-255,5738,88178,9,280550
839,0.001245,172.31.36.0-255,66,88244,9,280550
840,0.001252,74.125.24.0-255,2902,91146,9,280550
841,0.001257,172.31.36.0-255,66,91212,9,280550
842,0.001284,74.125.24.0-255,5020,96232,9,280550
843,0.001291,172.31.36.0-255,66,96298,9,280550
844,0.001464,74.125.24.0-255,1484,97782,9,280550
845,0.001492,74.125.24.0-255,2902,100684,9,280550
846,0.001495,172.31.36.0-255,66,100750,9,280550
847,0.001526,74.125.24.0-255,5738,106488,9,280550
848,0.001538,74.125.24.0-255,4320,110808,9,280550
849,0.001543,172.31.36.0-255,66,110874,9,280550
850,0.001564,74.125.24.0-255,1484,112358,9,280550
851,0.001569,74.125.24.0-255,4320,116678,9,280550
852,0.001574,172.31.36.0-255,66,116744,9,280550
853,0.001614,74.125.24.0-255,5020,121764,9,280550
854,0.001619,172.31.36.0-255,66,121830,9,280550
855,0.002263,74.125.24.0-255,1484,123314,9,280550
856,0.002284,74.125.24.0-255,2902,126216,9,280550
857,0.002288,172.31.36.0-255,66,126282,9,280550
858,0.002292,74.125.24.0-255,1484,127766,9,280550
859,0.002319,74.125.24.0-255,4320,132086,9,280550
860,0.002333,74.125.24.0-255,1484,133570,9,280550
861,0.002391,74.125.24.0-255,4320,137890,9,280550
862,0.002406,74.125.24.0-255,5738,143628,9,280550
863,0.002432,74.125.24.0-255,2184,145812,9,280550
864,0.002611,74.125.24.0-255,1484,147296,9,280550
865,0.002632,74.125.24.0-255,1484,148780,9,280550
866,0.002665,74.125.24.0-255,2902,151682,9,280550
867,0.002676,74.125.24.0-255,1484,153166,9,280550
868,0.002697,74.125.24.0-255,5738,158904,9,280550
869,0.002721,74.125.24.0-255,2902,161806,9,280550
870,0.002738,74.125.24.0-255,1484,163290,9,280550
871,0.002764,74.125.24.0-255,4320,167610,9,280550
872,0.00278,74.125.24.0-255,2902,170512,9,280550
873,0.002782,74.125.24.0-255,766,171278,9,280550
874,0.002817,74.125.24.0-255,1484,172762,9,280550
875,0.002829,74.125.24.0-255,2902,175664,9,280550
876,0.002843,74.125.24.0-255,1484,177148,9,280550
877,0.002849,74.125.24.0-255,5738,182886,9,280550
878,0.002873,74.125.24.0-255,2902,185788,9,280550
879,0.002898,74.125.24.0-255,4320,190108,9,280550
880,0.002963,74.125.24.0-255,1484,191592,9,280550
881,0.002977,74.125.24.0-255,5020,196612,9,280550
882,0.003124,74.125.24.0-255,1484,198096,9,280550
883,0.003139,74.125.24.0-255,2902,200998,9,280550
884,0.003153,74.125.24.0-255,4320,205318,9,280550
885,0.003163,74.125.24.0-255,1484,206802,9,280550
886,0.003186,74.125.24.0-255,5738,212540,9,280550
887,0.003206,74.125.24.0-255,5738,218278,9,280550
888,0.003211,74.125.24.0-255,5738,224016,9,280550
889,0.003246,74.125.24.0-255,6438,230454,9,280550
890,0.003342,74.125.24.0-255,1484,231938,9,280550
891,0.003357,74.125.24.0-255,2902,234840,9,280550
892,0.003361,74.125.24.0-255,2902,237742,9,280550
893,0.003377,74.125.24.0-255,2902,240644,9,280550
894,0.003379,74.125.24.0-255,1484,242128,9,280550
895,0.003418,74.125.24.0-255,5738,247866,9,280550
896,0.00345,74.125.24.0-255,4320,252186,9,280550
897,0.003488,74.125.24.0-255,1484,253670,9,280550
898,0.003529,74.125.24.0-255,766,254436,9,280550
899,0.003534,74.125.24.0-255,5738,260174,9,280550
900,0.003537,74.125.24.0-255,1484,261658,9,280550
901,0.00354,74.125.24.0-255,2902,264560,9,280550
902,0.003559,74.125.24.0-255,2902,267462,9,280550
903,0.003588,74.125.24.0-255,4320,271782,9,280550
904,0.003606,74.125.24.0-255,7156,278938,9,280550
905,0.003608,74.125.24.0-255,1270,280208,9,280550
906,0.00365,74.125.24.0-255,105,280313,9,280550
907,0.00935,172.31.36.0-255,66,280379,9,280550
908,0.011338,172.31.36.0-255,105,280484,9,280550
909,0.013908,74.125.24.0-255,66,280550,9,280550
910,0.0,74.125.24.0-255,143,143,9,208408
911,2.6e-05,172.31.36.0-255,66,209,9,208408
912,3.4e-05,74.125.24.0-255,1484,1693,9,208408
913,3.9e-05,172.31.36.0-255,66,1759,9,208408
914,4.6e-05,74.125.24.0-255,2902,4661,9,208408
915,5e-05,172.31.36.0-255,66,4727,9,208408
916,5.7e-05,74.125.24.0-255,7156,11883,9,208408
917,6.1e-05,172.31.36.0-255,66,11949,9,208408
918,6.5e-05,74.125.24.0-255,2070,14019,9,208408
919,6.7e-05,172.31.36.0-255,66,14085,9,208408
920,0.000125,74.125.24.0-255,1484,15569,9,208408
921,0.000128,172.31.36.0-255,66,15635,9,208408
922,0.000132,74.125.24.0-255,2902,18537,9,208408
923,0.000135,172.31.36.0-255,66,18603,9,208408
924,0.000155,74.125.24.0-255,5738,24341,9,208408
925,0.000158,172.31.36.0-255,66,24407,9,208408
926,0.000163,74.125.24.0-255,2902,27309,9,208408
927,0.000164,172.31.36.0-255,66,27375,9,208408
928,0.000185,74.125.24.0-255,3961,31336,9,208408
929,0.000187,172.31.36.0-255,66,31402,9,208408
930,0.0002,172.31.36.0-255,66,31468,9,208408
931,0.00022,74.125.24.0-255,4320,35788,9,208408
932,0.000222,172.31.36.0-255,66,35854,9,208408
933,0.000234,172.31.36.0-255,66,35920,9,208408
934,0.000253,74.125.24.0-255,4320,40240,9,208408
935,0.000256,172.31.36.0-255,66,40306,9,208408
936,0.000262,74.125.24.0-255,3895,44201,9,208408
937,0.000264,172.31.36.0-255,66,44267,9,208408
938,0.000526,74.125.24.0-255,139,44406,9,208408
939,0.000532,172.31.36.0-255,66,44472,9,208408
940,0.000553,74.125.24.0-255,1484,45956,9,208408
941,0.000576,74.125.24.0-255,2902,48858,9,208408
942,0.000579,172.31.36.0-255,66,48924,9,208408
943,0.000586,74.125.24.0-255,5738,54662,9,208408
944,0.000589,172.31.36.0-255,66,54728,9,208408
945,0.000634,172.31.36.0-255,66,54794,9,208408
946,0.000644,172.31.36.0-255,66,54860,9,208408
947,0.000659,74.125.24.0-255,2184,57044,9,208408
948,0.000661,172.31.36.0-255,66,57110,9,208408
949,0.000665,74.125.24.0-255,2902,60012,9,208408
950,0.000667,172.31.36.0-255,66,60078,9,208408
951,0.000697,74.125.24.0-255,7156,67234,9,208408
952,0.0007,172.31.36.0-255,66,67300,9,208408
953,0.000719,74.125.24.0-255,4320,71620,9,208408
954,0.000722,172.31.36.0-255,66,71686,9,208408
955,0.000753,74.125.24.0-255,5738,77424,9,208408
956,0.000756,172.31.36.0-255,66,77490,9,208408
957,0.000769,172.31.36.0-255,66,77556,9,208408
958,0.000812,172.31.36.0-255,66,77622,9,208408
959,0.000829,74.125.24.0-255,2184,79806,9,208408
960,0.000831,172.31.36.0-255,66,79872,9,208408
961,0.000845,172.31.36.0-255,66,79938,9,208408
962,0.000858,172.31.36.0-255,66,80004,9,208408
963,0.001066,74.125.24.0-255,1484,81488,9,208408
964,0.001072,74.125.24.0-255,2902,84390,9,208408
965,0.001075,172.31.36.0-255,66,84456,9,208408
966,0.001083,74.125.24.0-255,5738,90194,9,208408
967,0.001085,172.31.36.0-255,66,90260,9,208408
968,0.001124,74.125.24.0-255,6797,97057,9,208408
969,0.001127,172.31.36.0-255,66,97123,9,208408
970,0.001266,74.125.24.0-255,1484,98607,9,208408
971,0.001272,74.125.24.0-255,2902,101509,9,208408
972,0.001275,172.31.36.0-255,66,101575,9,208408
973,0.001304,74.125.24.0-255,4320,105895,9,208408
974,0.001307,172.31.36.0-255,66,105961,9,208408
975,0.001329,74.125.24.0-255,1484,107445,9,208408
976,0.001344,172.31.36.0-255,66,107511,9,208408
977,0.001366,74.125.24.0-255,7156,114667,9,208408
978,0.001369,172.31.36.0-255,66,114733,9,208408
979,0.001383,74.125.24.0-255,3602,118335,9,208408
980,0.001386,172.31.36.0-255,66,118401,9,208408
981,0.001459,74.125.24.0-255,1484,119885,9,208408
982,0.001466,74.125.24.0-255,2902,122787,9,208408
983,0.001469,172.31.36.0-255,66,122853,9,208408
984,0.001472,74.125.24.0-255,1484,124337,9,208408
985,0.001493,74.125.24.0-255,4320,128657,9,208408
986,0.001496,172.31.36.0-255,66,128723,9,208408
987,0.001499,74.125.24.0-255,1484,130207,9,208408
988,0.00154,74.125.24.0-255,5379,135586,9,208408
989,0.001543,172.31.36.0-255,66,135652,9,208408
990,0.001625,74.125.24.0-255,1484,137136,9,208408
991,0.001649,74.125.24.0-255,2902,140038,9,208408
992,0.001653,172.31.36.0-255,66,140104,9,208408
993,0.00166,74.125.24.0-255,5738,145842,9,208408
994,0.001662,172.31.36.0-255,66,145908,9,208408
995,0.001666,74.125.24.0-255,1484,147392,9,208408
996,0.001711,172.31.36.0-255,66,147458,9,208408
997,0.001715,74.125.24.0-255,2902,150360,9,208408
998,0.001718,172.31.36.0-255,66,150426,9,208408
999,0.001738,74.125.24.0-255,5738,156164,9,208408
1000,0.001741,172.31.36.0-255,66,156230,9,208408
1001,0.001762,74.125.24.0-255,2184,158414,9,208408
1002,0.001765,172.31.36.0-255,66,158480,9,208408
1003,0.001824,74.125.24.0-255,1484,159964,9,208408
1004,0.00183,74.125.24.0-255,2902,162866,9,208408
1005,0.001833,172.31.36.0-255,66,162932,9,208408
1006,0.001838,74.125.24.0-255,2902,165834,9,208408
1007,0.001841,172.31.36.0-255,66,165900,9,208408
1008,0.001854,74.125.24.0-255,2902,168802,9,208408
1009,0.001857,172.31.36.0-255,66,168868,9,208408
1010,0.001865,74.125.24.0-255,7156,176024,9,208408
1011,0.001868,172.31.36.0-255,66,176090,9,208408
1012,0.001894,74.125.24.0-255,5738,181828,9,208408
1013,0.001897,172.31.36.0-255,66,181894,9,208408
1014,0.0019,74.125.24.0-255,1484,183378,9,208408
1015,0.001904,74.125.24.0-255,2902,186280,9,208408
1016,0.001907,172.31.36.0-255,66,186346,9,208408
1017,0.001913,74.125.24.0-255,4320,190666,9,208408
1018,0.001915,172.31.36.0-255,66,190732,9,208408
1019,0.001929,74.125.24.0-255,1484,192216,9,208408
1020,0.001949,172.31.36.0-255,66,192282,9,208408
1021,0.001974,74.125.24.0-255,5020,197302,9,208408
1022,0.001978,172.31.36.0-255,66,197368,9,208408
1023,0.001992,172.31.36.0-255,66,197434,9,208408
1024,0.00203,74.125.24.0-255,4320,201754,9,208408
1025,0.002032,172.31.36.0-255,66,201820,9,208408
1026,0.002077,172.31.36.0-255,66,201886,9,208408
1027,0.002094,172.31.36.0-255,66,201952,9,208408
1028,0.002106,172.31.36.0-255,66,202018,9,208408
1029,0.002134,172.31.36.0-255,66,202084,9,208408
1030,0.002147,172.31.36.0-255,66,202150,9,208408
1031,0.002153,74.125.24.0-255,5196,207346,9,208408
1032,0.002156,172.31.36.0-255,66,207412,9,208408
1033,0.002187,74.125.24.0-255,105,207517,9,208408
1034,0.00436,74.125.24.0-255,129,207646,9,208408
1035,0.004942,172.31.36.0-255,105,207751,9,208408
1036,0.004993,172.31.36.0-255,105,207856,9,208408
1037,0.005224,172.31.36.0-255,90,207946,9,208408
1038,0.005235,172.31.36.0-255,66,208012,9,208408
1039,0.007142,74.125.24.0-255,66,208078,9,208408
1040,0.00716,74.125.24.0-255,66,208144,9,208408
1041,0.007371,74.125.24.0-255,66,208210,9,208408
1042,0.007401,74.125.24.0-255,66,208276,9,208408
1043,0.007415,172.31.36.0-255,66,208342,9,208408
1044,0.00742,74.125.24.0-255,66,208408,9,208408
1045,0.0,74.125.24.0-255,152,152,9,185474
1046,1.3e-05,172.31.36.0-255,66,218,9,185474
1047,2.6e-05,74.125.24.0-255,1484,1702,9,185474
1048,3.1e-05,172.31.36.0-255,66,1768,9,185474
1049,4.9e-05,74.125.24.0-255,2902,4670,9,185474
1050,5.2e-05,172.31.36.0-255,66,4736,9,185474
1051,8.3e-05,74.125.24.0-255,7156,11892,9,185474
1052,8.6e-05,172.31.36.0-255,66,11958,9,185474
1053,0.000124,172.31.36.0-255,66,12024,9,185474
1054,0.000189,74.125.24.0-255,7156,19180,9,185474
1055,0.000192,172.31.36.0-255,66,19246,9,185474
1056,0.000217,74.125.24.0-255,3961,23207,9,185474
1057,0.00022,172.31.36.0-255,66,23273,9,185474
1058,0.000545,74.125.24.0-255,1484,24757,9,185474
1059,0.00055,172.31.36.0-255,66,24823,9,185474
1060,0.000557,74.125.24.0-255,2902,27725,9,185474
1061,0.000559,172.31.36.0-255,66,27791,9,185474
1062,0.000581,74.125.24.0-255,5738,33529,9,185474
1063,0.000584,172.31.36.0-255,66,33595,9,185474
1064,0.00062,74.125.24.0-255,5738,39333,9,185474
1065,0.000624,172.31.36.0-255,66,39399,9,185474
1066,0.00068,74.125.24.0-255,5738,45137,9,185474
1067,0.000683,172.31.36.0-255,66,45203,9,185474
1068,0.000708,172.31.36.0-255,66,45269,9,185474
1069,0.000797,74.125.24.0-255,4229,49498,9,185474
1070,0.000801,172.31.36.0-255,66,49564,9,185474
1071,0.000823,74.125.24.0-255,417,49981,9,185474
1072,0.000826,172.31.36.0-255,66,50047,9,185474
1073,0.000918,74.125.24.0-255,1484,51531,9,185474
1074,0.000922,172.31.36.0-255,66,51597,9,185474
1075,0.000928,74.125.24.0-255,2902,54499,9,185474
1076,0.000948,74.125.24.0-255,5738,60237,9,185474
1077,0.000953,172.31.36.0-255,66,60303,9,185474
1078,0.001008,172.31.36.0-255,66,60369,9,185474
1079,0.00102,74.125.24.0-255,1484,61853,9,185474
1080,0.001112,74.125.24.0-255,7156,69009,9,185474
1081,0.001124,74.125.24.0-255,3602,72611,9,185474
1082,0.001128,172.31.36.0-255,66,72677,9,185474
1083,0.001159,172.31.36.0-255,66,72743,9,185474
1084,0.001453,74.125.24.0-255,1484,74227,9,185474
1085,0.001467,74.125.24.0-255,2902,77129,9,185474
1086,0.001471,172.31.36.0-255,66,77195,9,185474
1087,0.001477,74.125.24.0-255,5738,82933,9,185474
1088,0.001479,172.31.36.0-255,66,82999,9,185474
1089,0.001541,74.125.24.0-255,4320,87319,9,185474
1090,0.001544,172.31.36.0-255,66,87385,9,185474
1091,0.001562,74.125.24.0-255,5738,93123,9,185474
1092,0.001565,172.31.36.0-255,66,93189,9,185474
1093,0.001614,74.125.24.0-255,7156,100345,9,185474
1094,0.001617,172.31.36.0-255,66,100411,9,185474
1095,0.001638,74.125.24.0-255,4320,104731,9,185474
1096,0.00164,172.31.36.0-255,66,104797,9,185474
1097,0.001721,74.125.24.0-255,2184,106981,9,185474
1098,0.001724,172.31.36.0-255,66,107047,9,185474
1099,0.001746,74.125.24.0-255,5738,112785,9,185474
1100,0.001753,172.31.36.0-255,66,112851,9,185474
1101,0.001786,74.125.24.0-255,2902,115753,9,185474
1102,0.001791,172.31.36.0-255,66,115819,9,185474
1103,0.001811,74.125.24.0-255,7156,122975,9,185474
1104,0.001819,172.31.36.0-255,66,123041,9,185474
1105,0.001894,172.31.36.0-255,66,123107,9,185474
1106,0.00191,74.125.24.0-255,6438,129545,9,185474
1107,0.00193,172.31.36.0-255,66,129611,9,185474
1108,0.00206,74.125.24.0-255,2902,132513,9,185474
1109,0.002884,74.125.24.0-255,5020,137533,9,185474
1110,0.010416,172.31.36.0-255,66,137599,9,185474
1111,0.01075,172.31.36.0-255,101,137700,9,185474
1112,0.012986,74.125.24.0-255,5738,143438,9,185474
1113,0.013,172.31.36.0-255,66,143504,9,185474
1114,0.013283,74.125.24.0-255,66,143570,9,185474
1115,0.015584,74.125.24.0-255,4320,147890,9,185474
1116,0.015593,172.31.36.0-255,66,147956,9,185474
1117,0.015609,74.125.24.0-255,1484,149440,9,185474
1118,0.018149,74.125.24.0-255,4320,153760,9,185474
1119,0.018158,172.31.36.0-255,66,153826,9,185474
1120,0.020726,74.125.24.0-255,5738,159564,9,185474
1121,0.020735,172.31.36.0-255,66,159630,9,185474
1122,0.023319,74.125.24.0-255,5738,165368,9,185474
1123,0.023331,172.31.36.0-255,66,165434,9,185474
1124,0.025914,74.125.24.0-255,5738,171172,9,185474
1125,0.025927,172.31.36.0-255,66,171238,9,185474
1126,0.028479,74.125.24.0-255,5738,176976,9,185474
1127,0.028489,172.31.36.0-255,66,177042,9,185474
1128,0.031073,74.125.24.0-255,5738,182780,9,185474
1129,0.031082,172.31.36.0-255,66,182846,9,185474
1130,0.033619,74.125.24.0-255,1079,183925,9,185474
1131,0.033798,172.31.36.0-255,105,184030,9,185474
1132,0.0401,74.125.24.0-255,66,184096,9,185474
1133,0.042873,172.31.36.0-255,176,184272,9,185474
1134,0.042929,172.31.36.0-255,1070,185342,9,185474
1135,0.044438,104.244.42.0-255,66,185408,9,185474
1136,0.044465,104.244.42.0-255,66,185474,9,185474
1137,0.0,172.31.36.0-255,66,66,9,66
1138,0.0,172.31.36.0-255,66,66,9,66
1139,0.0,74.125.24.0-255,149,149,9,248481
1140,3.6e-05,172.31.36.0-255,66,215,9,248481
1141,4.4e-05,74.125.24.0-255,1484,1699,9,248481
1142,4.8e-05,172.31.36.0-255,66,1765,9,248481
1143,5.3e-05,74.125.24.0-255,2902,4667,9,248481
1144,5.5e-05,172.31.36.0-255,66,4733,9,248481
1145,7.2e-05,74.125.24.0-255,2902,7635,9,248481
1146,7.5e-05,172.31.36.0-255,66,7701,9,248481
1147,9.9e-05,74.125.24.0-255,1484,9185,9,248481
1148,0.000104,74.125.24.0-255,4913,14098,9,248481
1149,0.000104,172.31.36.0-255,66,14164,9,248481
1150,0.000108,172.31.36.0-255,66,14230,9,248481
1151,0.000149,74.125.24.0-255,1484,15714,9,248481
1152,0.000152,172.31.36.0-255,66,15780,9,248481
1153,0.000175,74.125.24.0-255,2902,18682,9,248481
1154,0.000178,172.31.36.0-255,66,18748,9,248481
1155,0.000183,74.125.24.0-255,5738,24486,9,248481
1156,0.000186,172.31.36.0-255,66,24552,9,248481
1157,0.000223,74.125.24.0-255,2902,27454,9,248481
1158,0.000226,172.31.36.0-255,66,27520,9,248481
1159,0.000243,74.125.24.0-255,3961,31481,9,248481
1160,0.000246,172.31.36.0-255,66,31547,9,248481
1161,0.000313,74.125.24.0-255,1484,33031,9,248481
1162,0.000316,172.31.36.0-255,66,33097,9,248481
1163,0.000333,74.125.24.0-255,2902,35999,9,248481
1164,0.000336,172.31.36.0-255,66,36065,9,248481
1165,0.000341,74.125.24.0-255,2902,38967,9,248481
1166,0.000343,172.31.36.0-255,66,39033,9,248481
1167,0.000359,74.125.24.0-255,2902,41935,9,248481
1168,0.000362,172.31.36.0-255,66,42001,9,248481
1169,0.000386,74.125.24.0-255,1484,43485,9,248481
1170,0.000389,172.31.36.0-255,66,43551,9,248481
1171,0.000412,74.125.24.0-255,5738,49289,9,248481
1172,0.000415,172.31.36.0-255,66,49355,9,248481
1173,0.00044,74.125.24.0-255,6797,56152,9,248481
1174,0.000443,172.31.36.0-255,66,56218,9,248481
1175,0.00051,74.125.24.0-255,1484,57702,9,248481
1176,0.000518,74.125.24.0-255,4320,62022,9,248481
1177,0.000522,172.31.36.0-255,66,62088,9,248481
1178,0.000537,74.125.24.0-255,4253,66341,9,248481
1179,0.000541,172.31.36.0-255,66,66407,9,248481
1180,0.000583,74.125.24.0-255,415,66822,9,248481
1181,0.000757,74.125.24.0-255,1484,68306,9,248481
1182,0.000762,172.31.36.0-255,66,68372,9,248481
1183,0.000777,74.125.24.0-255,2902,71274,9,248481
1184,0.000779,172.31.36.0-255,66,71340,9,248481
1185,0.000795,74.125.24.0-255,4320,75660,9,248481
1186,0.000798,172.31.36.0-255,66,75726,9,248481
1187,0.000806,74.125.24.0-255,1484,77210,9,248481
1188,0.000834,74.125.24.0-255,4320,81530,9,248481
1189,0.000837,172.31.36.0-255,66,81596,9,248481
1190,0.000862,172.31.36.0-255,66,81662,9,248481
1191,0.00095,74.125.24.0-255,4320,85982,9,248481
1192,0.000954,172.31.36.0-255,66,86048,9,248481
1193,0.000971,74.125.24.0-255,6438,92486,9,248481
1194,0.000974,172.31.36.0-255,66,92552,9,248481
1195,0.001044,74.125.24.0-255,7156,99708,9,248481
1196,0.001047,172.31.36.0-255,66,99774,9,248481
1197,0.001068,74.125.24.0-255,4320,104094,9,248481
1198,0.001071,172.31.36.0-255,66,104160,9,248481
1199,0.001129,74.125.24.0-255,2902,107062,9,248481
1200,0.001132,172.31.36.0-255,66,107128,9,248481
1201,0.001173,172.31.36.0-255,66,107194,9,248481
1202,0.001328,74.125.24.0-255,7156,114350,9,248481
1203,0.001333,172.31.36.0-255,66,114416,9,248481
1204,0.001393,74.125.24.0-255,2902,117318,9,248481
1205,0.001398,172.31.36.0-255,66,117384,9,248481
1206,0.00143,172.31.36.0-255,66,117450,9,248481
1207,0.001458,172.31.36.0-255,66,117516,9,248481
1208,0.001639,74.125.24.0-255,2902,120418,9,248481
1209,0.001643,172.31.36.0-255,66,120484,9,248481
1210,0.001674,172.31.36.0-255,66,120550,9,248481
1211,0.001688,74.125.24.0-255,2902,123452,9,248481
1212,0.001691,172.31.36.0-255,66,123518,9,248481
1213,0.001746,74.125.24.0-255,4320,127838,9,248481
1214,0.00175,172.31.36.0-255,66,127904,9,248481
1215,0.001779,172.31.36.0-255,66,127970,9,248481
1216,0.001964,74.125.24.0-255,1484,129454,9,248481
1217,0.001974,74.125.24.0-255,2902,132356,9,248481
1218,0.001977,172.31.36.0-255,66,132422,9,248481
1219,0.001981,74.125.24.0-255,1484,133906,9,248481
1220,0.002001,74.125.24.0-255,4320,138226,9,248481
1221,0.002004,172.31.36.0-255,66,138292,9,248481
1222,0.002021,74.125.24.0-255,4320,142612,9,248481
1223,0.002024,172.31.36.0-255,66,142678,9,248481
1224,0.00206,172.31.36.0-255,66,142744,9,248481
1225,0.002123,74.125.24.0-255,5738,148482,9,248481
1226,0.002128,172.31.36.0-255,66,148548,9,248481
1227,0.002158,172.31.36.0-255,66,148614,9,248481
1228,0.002177,74.125.24.0-255,5738,154352,9,248481
1229,0.002181,172.31.36.0-255,66,154418,9,248481
1230,0.002203,74.125.24.0-255,2184,156602,9,248481
1231,0.002207,172.31.36.0-255,66,156668,9,248481
1232,0.002383,172.31.36.0-255,66,156734,9,248481
1233,0.002407,74.125.24.0-255,6438,163172,9,248481
1234,0.00241,172.31.36.0-255,66,163238,9,248481
1235,0.002558,74.125.24.0-255,1484,164722,9,248481
1236,0.002563,74.125.24.0-255,1484,166206,9,248481
1237,0.002567,172.31.36.0-255,66,166272,9,248481
1238,0.002588,74.125.24.0-255,1484,167756,9,248481
1239,0.002593,74.125.24.0-255,4320,172076,9,248481
1240,0.002597,172.31.36.0-255,66,172142,9,248481
1241,0.002611,74.125.24.0-255,1484,173626,9,248481
1242,0.002627,74.125.24.0-255,1484,175110,9,248481
1243,0.00263,172.31.36.0-255,66,175176,9,248481
1244,0.002662,172.31.36.0-255,66,175242,9,248481
1245,0.00274,74.125.24.0-255,1484,176726,9,248481
1246,0.002755,74.125.24.0-255,1484,178210,9,248481
1247,0.002759,172.31.36.0-255,66,178276,9,248481
1248,0.002764,74.125.24.0-255,2902,181178,9,248481
1249,0.002767,172.31.36.0-255,66,181244,9,248481
1250,0.002789,74.125.24.0-255,5020,186264,9,248481
1251,0.002792,172.31.36.0-255,66,186330,9,248481
1252,0.002829,74.125.24.0-255,2902,189232,9,248481
1253,0.002833,172.31.36.0-255,66,189298,9,248481
1254,0.002852,74.125.24.0-255,7156,196454,9,248481
1255,0.002855,172.31.36.0-255,66,196520,9,248481
1256,0.002879,74.125.24.0-255,4320,200840,9,248481
1257,0.002883,172.31.36.0-255,66,200906,9,248481
1258,0.002965,172.31.36.0-255,66,200972,9,248481
1259,0.003007,172.31.36.0-255,66,201038,9,248481
1260,0.003217,74.125.24.0-255,7156,208194,9,248481
1261,0.003223,172.31.36.0-255,66,208260,9,248481
1262,0.00329,172.31.36.0-255,66,208326,9,248481
1263,0.003316,172.31.36.0-255,66,208392,9,248481
1264,0.003544,74.125.24.0-255,1484,209876,9,248481
1265,0.003567,74.125.24.0-255,7156,217032,9,248481
1266,0.00357,172.31.36.0-255,66,217098,9,248481
1267,0.003587,74.125.24.0-255,2902,220000,9,248481
1268,0.00359,172.31.36.0-255,66,220066,9,248481
1269,0.003646,74.125.24.0-255,4320,224386,9,248481
1270,0.00365,172.31.36.0-255,66,224452,9,248481
1271,0.003669,74.125.24.0-255,3602,228054,9,248481
1272,0.003672,172.31.36.0-255,66,228120,9,248481
1273,0.003713,74.125.24.0-255,2902,231022,9,248481
1274,0.003716,172.31.36.0-255,66,231088,9,248481
1275,0.003741,74.125.24.0-255,7156,238244,9,248481
1276,0.003744,172.31.36.0-255,66,238310,9,248481
1277,0.003761,74.125.24.0-255,3559,241869,9,248481
1278,0.003763,172.31.36.0-255,66,241935,9,248481
1279,0.0038,74.125.24.0-255,105,242040,9,248481
1280,0.004489,172.31.36.0-255,66,242106,9,248481
1281,0.004524,172.31.36.0-255,105,242211,9,248481
1282,0.006642,74.125.24.0-255,66,242277,9,248481
1283,0.044375,172.31.36.0-255,176,242453,9,248481
1284,0.044468,172.31.36.0-255,1116,243569,9,248481
1285,0.044779,172.31.36.0-255,1514,245083,9,248481
1286,0.044782,172.31.36.0-255,1514,246597,9,248481
1287,0.044788,172.31.36.0-255,1514,248111,9,248481
1288,0.044789,172.31.36.0-255,106,248217,9,248481
1289,0.046046,104.244.42.0-255,66,248283,9,248481
1290,0.046129,104.244.42.0-255,66,248349,9,248481
1291,0.046481,104.244.42.0-255,66,248415,9,248481
1292,0.046514,104.244.42.0-255,66,248481,9,248481
1293,0.0,74.125.68.0-255,153,153,9,375219
1294,2.9e-05,172.31.36.0-255,66,219,9,375219
1295,3.6e-05,74.125.68.0-255,1484,1703,9,375219
1296,4.1e-05,172.31.36.0-255,66,1769,9,375219
1297,5.3e-05,74.125.68.0-255,2902,4671,9,375219
1298,5.6e-05,172.31.36.0-255,66,4737,9,375219
1299,6e-05,74.125.68.0-255,2902,7639,9,375219
1300,6.3e-05,172.31.36.0-255,66,7705,9,375219
1301,6.6e-05,74.125.68.0-255,1484,9189,9,375219
1302,6.8e-05,172.31.36.0-255,66,9255,9,375219
1303,0.0001,74.125.68.0-255,2902,12157,9,375219
1304,0.000103,172.31.36.0-255,66,12223,9,375219
1305,0.000114,74.125.68.0-255,1484,13707,9,375219
1306,0.000121,172.31.36.0-255,66,13773,9,375219
1307,0.000148,172.31.36.0-255,66,13839,9,375219
1308,0.00016,172.31.36.0-255,66,13905,9,375219
1309,0.000237,74.125.68.0-255,1484,15389,9,375219
1310,0.00024,172.31.36.0-255,66,15455,9,375219
1311,0.000245,74.125.68.0-255,2902,18357,9,375219
1312,0.000247,74.125.68.0-255,1484,19841,9,375219
1313,0.000248,172.31.36.0-255,66,19907,9,375219
1314,0.000253,172.31.36.0-255,66,19973,9,375219
1315,0.000269,74.125.68.0-255,2902,22875,9,375219
1316,0.000276,172.31.36.0-255,66,22941,9,375219
1317,0.000283,74.125.68.0-255,4320,27261,9,375219
1318,0.000286,172.31.36.0-255,66,27327,9,375219
1319,0.000316,74.125.68.0-255,1484,28811,9,375219
1320,0.000318,172.31.36.0-255,66,28877,9,375219
1321,0.000325,74.125.68.0-255,5379,34256,9,375219
1322,0.000327,172.31.36.0-255,66,34322,9,375219
1323,0.000339,74.125.68.0-255,5738,40060,9,375219
1324,0.000342,172.31.36.0-255,66,40126,9,375219
1325,0.000376,74.125.68.0-255,7156,47282,9,375219
1326,0.00038,172.31.36.0-255,66,47348,9,375219
1327,0.000404,74.125.68.0-255,1402,48750,9,375219
1328,0.000408,74.125.68.0-255,131,48881,9,375219
1329,0.000469,74.125.68.0-255,1484,50365,9,375219
1330,0.000473,172.31.36.0-255,66,50431,9,375219
1331,0.000479,74.125.68.0-255,2902,53333,9,375219
1332,0.000481,172.31.36.0-255,66,53399,9,375219
1333,0.000514,74.125.68.0-255,5738,59137,9,375219
1334,0.000518,172.31.36.0-255,66,59203,9,375219
1335,0.000524,74.125.68.0-255,4320,63523,9,375219
1336,0.000527,172.31.36.0-255,66,63589,9,375219
1337,0.000537,74.125.68.0-255,2902,66491,9,375219
1338,0.000541,172.31.36.0-255,66,66557,9,375219
1339,0.000566,74.125.68.0-255,2902,69459,9,375219
1340,0.000573,172.31.36.0-255,66,69525,9,375219
1341,0.000586,172.31.36.0-255,66,69591,9,375219
1342,0.00059,74.125.68.0-255,2184,71775,9,375219
1343,0.000593,172.31.36.0-255,66,71841,9,375219
1344,0.000797,74.125.68.0-255,1484,73325,9,375219
1345,0.000812,74.125.68.0-255,1484,74809,9,375219
1346,0.000816,172.31.36.0-255,66,74875,9,375219
1347,0.000843,74.125.68.0-255,1484,76359,9,375219
1348,0.000849,74.125.68.0-255,5738,82097,9,375219
1349,0.000852,172.31.36.0-255,66,82163,9,375219
1350,0.000856,74.125.68.0-255,1484,83647,9,375219
1351,0.000887,172.31.36.0-255,66,83713,9,375219
1352,0.000893,74.125.68.0-255,5738,89451,9,375219
1353,0.000896,172.31.36.0-255,66,89517,9,375219
1354,0.000919,74.125.68.0-255,5738,95255,9,375219
1355,0.000923,172.31.36.0-255,66,95321,9,375219
1356,0.000927,74.125.68.0-255,2184,97505,9,375219
1357,0.000929,172.31.36.0-255,66,97571,9,375219
1358,0.000959,74.125.68.0-255,1484,99055,9,375219
1359,0.000978,74.125.68.0-255,2902,101957,9,375219
1360,0.000981,172.31.36.0-255,66,102023,9,375219
1361,0.000988,74.125.68.0-255,4320,106343,9,375219
1362,0.00099,172.31.36.0-255,66,106409,9,375219
1363,0.001009,74.125.68.0-255,1484,107893,9,375219
1364,0.001016,74.125.68.0-255,4320,112213,9,375219
1365,0.001018,172.31.36.0-255,66,112279,9,375219
1366,0.001031,74.125.68.0-255,5738,118017,9,375219
1367,0.001033,172.31.36.0-255,66,118083,9,375219
1368,0.001075,74.125.68.0-255,5738,123821,9,375219
1369,0.001079,172.31.36.0-255,66,123887,9,375219
1370,0.001108,74.125.68.0-255,5738,129625,9,375219
1371,0.001111,172.31.36.0-255,66,129691,9,375219
1372,0.001115,74.125.68.0-255,2184,131875,9,375219
1373,0.001117,172.31.36.0-255,66,131941,9,375219
1374,0.001214,74.125.68.0-255,1484,133425,9,375219
1375,0.001219,74.125.68.0-255,2902,136327,9,375219
1376,0.001222,172.31.36.0-255,66,136393,9,375219
1377,0.001256,74.125.68.0-255,5738,142131,9,375219
1378,0.001259,172.31.36.0-255,66,142197,9,375219
1379,0.001278,74.125.68.0-255,2902,145099,9,375219
1380,0.001281,172.31.36.0-255,66,145165,9,375219
1381,0.001319,172.31.36.0-255,66,145231,9,375219
1382,0.001325,74.125.68.0-255,4320,149551,9,375219
1383,0.001328,172.31.36.0-255,66,149617,9,375219
1384,0.00136,74.125.68.0-255,6438,156055,9,375219
1385,0.001364,172.31.36.0-255,66,156121,9,375219
1386,0.001572,74.125.68.0-255,1484,157605,9,375219
1387,0.001605,74.125.68.0-255,2902,160507,9,375219
1388,0.001609,172.31.36.0-255,66,160573,9,375219
1389,0.001613,74.125.68.0-255,1484,162057,9,375219
1390,0.001637,74.125.68.0-255,4320,166377,9,375219
1391,0.00164,172.31.36.0-255,66,166443,9,375219
1392,0.001664,74.125.68.0-255,7156,173599,9,375219
1393,0.001667,172.31.36.0-255,66,173665,9,375219
1394,0.001673,74.125.68.0-255,4320,177985,9,375219
1395,0.001675,172.31.36.0-255,66,178051,9,375219
1396,0.001736,74.125.68.0-255,5738,183789,9,375219
1397,0.001741,74.125.68.0-255,4320,188109,9,375219
1398,0.001742,172.31.36.0-255,66,188175,9,375219
1399,0.001746,172.31.36.0-255,66,188241,9,375219
1400,0.001775,74.125.68.0-255,2184,190425,9,375219
1401,0.001778,172.31.36.0-255,66,190491,9,375219
1402,0.001856,74.125.68.0-255,1484,191975,9,375219
1403,0.001869,74.125.68.0-255,1484,193459,9,375219
1404,0.001872,172.31.36.0-255,66,193525,9,375219
1405,0.001876,74.125.68.0-255,1484,195009,9,375219
1406,0.001897,74.125.68.0-255,1484,196493,9,375219
1407,0.0019,172.31.36.0-255,66,196559,9,375219
1408,0.001907,74.125.68.0-255,5738,202297,9,375219
1409,0.00191,172.31.36.0-255,66,202363,9,375219
1410,0.001948,172.31.36.0-255,66,202429,9,375219
1411,0.001977,74.125.68.0-255,5738,208167,9,375219
1412,0.00198,172.31.36.0-255,66,208233,9,375219
1413,0.001999,74.125.68.0-255,4320,212553,9,375219
1414,0.002002,172.31.36.0-255,66,212619,9,375219
1415,0.002025,74.125.68.0-255,1484,214103,9,375219
1416,0.002039,74.125.68.0-255,1484,215587,9,375219
1417,0.002042,172.31.36.0-255,66,215653,9,375219
1418,0.00206,74.125.68.0-255,3602,219255,9,375219
1419,0.002063,172.31.36.0-255,66,219321,9,375219
1420,0.00207,74.125.68.0-255,5738,225059,9,375219
1421,0.002073,172.31.36.0-255,66,225125,9,375219
1422,0.002086,74.125.68.0-255,1484,226609,9,375219
1423,0.002091,74.125.68.0-255,2902,229511,9,375219
1424,0.002098,172.31.36.0-255,66,229577,9,375219
1425,0.002104,74.125.68.0-255,4320,233897,9,375219
1426,0.002107,172.31.36.0-255,66,233963,9,375219
1427,0.002145,74.125.68.0-255,1484,235447,9,375219
1428,0.00216,74.125.68.0-255,2902,238349,9,375219
1429,0.002162,172.31.36.0-255,66,238415,9,375219
1430,0.002166,74.125.68.0-255,1484,239899,9,375219
1431,0.004279,74.125.68.0-255,4320,244219,9,375219
1432,0.004285,172.31.36.0-255,66,244285,9,375219
1433,0.006391,74.125.68.0-255,5738,250023,9,375219
1434,0.006397,172.31.36.0-255,66,250089,9,375219
1435,0.008507,74.125.68.0-255,2902,252991,9,375219
1436,0.00851,172.31.36.0-255,66,253057,9,375219
1437,0.008538,74.125.68.0-255,2902,255959,9,375219
1438,0.00854,172.31.36.0-255,66,256025,9,375219
1439,0.01062,74.125.68.0-255,2902,258927,9,375219
1440,0.010626,172.31.36.0-255,66,258993,9,375219
1441,0.010647,74.125.68.0-255,2902,261895,9,375219
1442,0.010651,172.31.36.0-255,66,261961,9,375219
1443,0.012737,74.125.68.0-255,4320,266281,9,375219
1444,0.012744,172.31.36.0-255,66,266347,9,375219
1445,0.012764,74.125.68.0-255,1484,267831,9,375219
1446,0.01486,74.125.68.0-255,4320,272151,9,375219
1447,0.014866,172.31.36.0-255,66,272217,9,375219
1448,0.016973,74.125.68.0-255,5738,277955,9,375219
1449,0.016983,172.31.36.0-255,66,278021,9,375219
1450,0.019167,74.125.68.0-255,5738,283759,9,375219
1451,0.019175,172.31.36.0-255,66,283825,9,375219
1452,0.021288,74.125.68.0-255,5738,289563,9,375219
1453,0.021298,172.31.36.0-255,66,289629,9,375219
1454,0.023404,74.125.68.0-255,4320,293949,9,375219
1455,0.023412,172.31.36.0-255,66,294015,9,375219
1456,0.023452,74.125.68.0-255,1484,295499,9,375219
1457,0.025519,74.125.68.0-255,4320,299819,9,375219
1458,0.025526,172.31.36.0-255,66,299885,9,375219
1459,0.02764,74.125.68.0-255,5738,305623,9,375219
1460,0.027648,172.31.36.0-255,66,305689,9,375219
1461,0.029756,74.125.68.0-255,5738,311427,9,375219
1462,0.029765,172.31.36.0-255,66,311493,9,375219
1463,0.031879,74.125.68.0-255,5738,317231,9,375219
1464,0.031886,172.31.36.0-255,66,317297,9,375219
1465,0.033993,74.125.68.0-255,5738,323035,9,375219
1466,0.033999,172.31.36.0-255,66,323101,9,375219
1467,0.036108,74.125.68.0-255,5738,328839,9,375219
1468,0.036115,172.31.36.0-255,66,328905,9,375219
1469,0.038228,74.125.68.0-255,5738,334643,9,375219
1470,0.038236,172.31.36.0-255,66,334709,9,375219
1471,0.040338,74.125.68.0-255,5738,340447,9,375219
1472,0.040344,172.31.36.0-255,66,340513,9,375219
1473,0.042458,74.125.68.0-255,5738,346251,9,375219
1474,0.042466,172.31.36.0-255,66,346317,9,375219
1475,0.044573,74.125.68.0-255,5738,352055,9,375219
1476,0.044582,172.31.36.0-255,66,352121,9,375219
1477,0.044892,172.31.36.0-255,172,352293,9,375219
1478,0.044934,172.31.36.0-255,1116,353409,9,375219
1479,0.045003,172.31.36.0-255,1514,354923,9,375219
1480,0.045005,172.31.36.0-255,1514,356437,9,375219
1481,0.045037,172.31.36.0-255,1514,357951,9,375219
1482,0.045038,172.31.36.0-255,186,358137,9,375219
1483,0.04648,104.244.42.0-255,66,358203,9,375219
1484,0.046518,104.244.42.0-255,66,358269,9,375219
1485,0.046635,104.244.42.0-255,66,358335,9,375219
1486,0.04664,104.244.42.0-255,66,358401,9,375219
1487,0.046681,74.125.68.0-255,5738,364139,9,375219
1488,0.046687,172.31.36.0-255,66,364205,9,375219
1489,0.048788,74.125.68.0-255,5738,369943,9,375219
1490,0.048794,172.31.36.0-255,66,370009,9,375219
1491,0.050893,74.125.68.0-255,2902,372911,9,375219
1492,0.050899,172.31.36.0-255,66,372977,9,375219
1493,0.050941,74.125.68.0-255,2005,374982,9,375219
1494,0.050944,172.31.36.0-255,66,375048,9,375219
1495,0.051093,172.31.36.0-255,105,375153,9,375219
1496,0.053159,74.125.68.0-255,66,375219,9,375219
1497,0.0,74.125.24.0-255,226,226,9,175630
1498,2.4e-05,172.31.36.0-255,66,292,9,175630
1499,3.1e-05,74.125.24.0-255,1484,1776,9,175630
1500,3.6e-05,172.31.36.0-255,66,1842,9,175630
1501,4.3e-05,74.125.24.0-255,4320,6162,9,175630
1502,5.5e-05,172.31.36.0-255,66,6228,9,175630
1503,0.00026,74.125.24.0-255,7156,13384,9,175630
1504,0.000267,172.31.36.0-255,66,13450,9,175630
1505,0.000595,74.125.24.0-255,622,14072,9,175630
1506,0.000601,172.31.36.0-255,66,14138,9,175630
1507,0.000648,74.125.24.0-255,5738,19876,9,175630
1508,0.000651,172.31.36.0-255,66,19942,9,175630
1509,0.00068,74.125.24.0-255,4320,24262,9,175630
1510,0.000683,172.31.36.0-255,66,24328,9,175630
1511,0.001137,74.125.24.0-255,5738,30066,9,175630
1512,0.001144,172.31.36.0-255,66,30132,9,175630
1513,0.001173,74.125.24.0-255,1326,31458,9,175630
1514,0.001177,172.31.36.0-255,66,31524,9,175630
1515,0.003489,74.125.24.0-255,4320,35844,9,175630
1516,0.003499,172.31.36.0-255,66,35910,9,175630
1517,0.003564,74.125.24.0-255,1484,37394,9,175630
1518,0.003568,172.31.36.0-255,66,37460,9,175630
1519,0.005819,74.125.24.0-255,4320,41780,9,175630
1520,0.005827,172.31.36.0-255,66,41846,9,175630
1521,0.005898,74.125.24.0-255,1484,43330,9,175630
1522,0.005901,172.31.36.0-255,66,43396,9,175630
1523,0.008214,74.125.24.0-255,2902,46298,9,175630
1524,0.008227,172.31.36.0-255,66,46364,9,175630
1525,0.008261,74.125.24.0-255,2902,49266,9,175630
1526,0.008264,172.31.36.0-255,66,49332,9,175630
1527,0.010552,74.125.24.0-255,2902,52234,9,175630
1528,0.010561,172.31.36.0-255,66,52300,9,175630
1529,0.010592,74.125.24.0-255,2902,55202,9,175630
1530,0.010595,172.31.36.0-255,66,55268,9,175630
1531,0.012874,74.125.24.0-255,2902,58170,9,175630
1532,0.012885,172.31.36.0-255,66,58236,9,175630
1533,0.012947,74.125.24.0-255,2902,61138,9,175630
1534,0.01295,172.31.36.0-255,66,61204,9,175630
1535,0.015274,74.125.24.0-255,2902,64106,9,175630
1536,0.015282,172.31.36.0-255,66,64172,9,175630
1537,0.015313,74.125.24.0-255,1484,65656,9,175630
1538,0.015316,172.31.36.0-255,66,65722,9,175630
1539,0.015337,74.125.24.0-255,1484,67206,9,175630
1540,0.015339,172.31.36.0-255,66,67272,9,175630
1541,0.017653,74.125.24.0-255,2902,70174,9,175630
1542,0.01766,172.31.36.0-255,66,70240,9,175630
1543,0.017709,74.125.24.0-255,2902,73142,9,175630
1544,0.017713,172.31.36.0-255,66,73208,9,175630
1545,0.020046,74.125.24.0-255,2902,76110,9,175630
1546,0.020053,172.31.36.0-255,66,76176,9,175630
1547,0.020096,74.125.24.0-255,2902,79078,9,175630
1548,0.020099,172.31.36.0-255,66,79144,9,175630
1549,0.022404,74.125.24.0-255,2902,82046,9,175630
1550,0.022413,172.31.36.0-255,66,82112,9,175630
1551,0.022472,74.125.24.0-255,2902,85014,9,175630
1552,0.022476,172.31.36.0-255,66,85080,9,175630
1553,0.024769,74.125.24.0-255,2902,87982,9,175630
1554,0.024778,172.31.36.0-255,66,88048,9,175630
1555,0.024814,74.125.24.0-255,2902,90950,9,175630
1556,0.024817,172.31.36.0-255,66,91016,9,175630
1557,0.027113,74.125.24.0-255,2902,93918,9,175630
1558,0.027121,172.31.36.0-255,66,93984,9,175630
1559,0.027173,74.125.24.0-255,1484,95468,9,175630
1560,0.027188,74.125.24.0-255,1484,96952,9,175630
1561,0.027191,172.31.36.0-255,66,97018,9,175630
1562,0.029451,74.125.24.0-255,2902,99920,9,175630
1563,0.02946,172.31.36.0-255,66,99986,9,175630
1564,0.029526,74.125.24.0-255,1484,101470,9,175630
1565,0.029543,74.125.24.0-255,1484,102954,9,175630
1566,0.029546,172.31.36.0-255,66,103020,9,175630
1567,0.031779,74.125.24.0-255,2902,105922,9,175630
1568,0.031787,172.31.36.0-255,66,105988,9,175630
1569,0.031914,74.125.24.0-255,2902,108890,9,175630
1570,0.031918,172.31.36.0-255,66,108956,9,175630
1571,0.034111,74.125.24.0-255,2902,111858,9,175630
1572,0.034119,172.31.36.0-255,66,111924,9,175630
1573,0.034296,74.125.24.0-255,2902,114826,9,175630
1574,0.034301,172.31.36.0-255,66,114892,9,175630
1575,0.036521,74.125.24.0-255,2902,117794,9,175630
1576,0.036529,172.31.36.0-255,66,117860,9,175630
1577,0.036659,74.125.24.0-255,2902,120762,9,175630
1578,0.036664,172.31.36.0-255,66,120828,9,175630
1579,0.038895,74.125.24.0-255,2902,123730,9,175630
1580,0.038904,172.31.36.0-255,66,123796,9,175630
1581,0.038996,74.125.24.0-255,2902,126698,9,175630
1582,0.039,172.31.36.0-255,66,126764,9,175630
1583,0.041255,74.125.24.0-255,2902,129666,9,175630
1584,0.041263,172.31.36.0-255,66,129732,9,175630
1585,0.041305,74.125.24.0-255,2902,132634,9,175630
1586,0.041308,172.31.36.0-255,66,132700,9,175630
1587,0.04361,74.125.24.0-255,2902,135602,9,175630
1588,0.043616,172.31.36.0-255,66,135668,9,175630
1589,0.043664,74.125.24.0-255,2902,138570,9,175630
1590,0.043667,172.31.36.0-255,66,138636,9,175630
1591,0.045942,74.125.24.0-255,2902,141538,9,175630
1592,0.04595,172.31.36.0-255,66,141604,9,175630
1593,0.045984,74.125.24.0-255,2902,144506,9,175630
1594,0.045987,172.31.36.0-255,66,144572,9,175630
1595,0.048345,74.125.24.0-255,2902,147474,9,175630
1596,0.048354,172.31.36.0-255,66,147540,9,175630
1597,0.048386,74.125.24.0-255,2902,150442,9,175630
1598,0.048389,172.31.36.0-255,66,150508,9,175630
1599,0.050705,74.125.24.0-255,2902,153410,9,175630
1600,0.050714,172.31.36.0-255,66,153476,9,175630
1601,0.050757,74.125.24.0-255,2902,156378,9,175630
1602,0.050761,172.31.36.0-255,66,156444,9,175630
1603,0.053087,74.125.24.0-255,1484,157928,9,175630
1604,0.053093,172.31.36.0-255,66,157994,9,175630
1605,0.053127,74.125.24.0-255,4320,162314,9,175630
1606,0.053131,172.31.36.0-255,66,162380,9,175630
1607,0.053293,172.31.36.0-255,176,162556,9,175630
1608,0.053321,172.31.36.0-255,1070,163626,9,175630
1609,0.054844,104.244.42.0-255,66,163692,9,175630
1610,0.054866,104.244.42.0-255,66,163758,9,175630
1611,0.05543,74.125.24.0-255,1484,165242,9,175630
1612,0.055437,172.31.36.0-255,66,165308,9,175630
1613,0.055481,74.125.24.0-255,4320,169628,9,175630
1614,0.055484,172.31.36.0-255,66,169694,9,175630
1615,0.057802,74.125.24.0-255,1484,171178,9,175630
1616,0.057811,172.31.36.0-255,66,171244,9,175630
1617,0.057844,74.125.24.0-255,4320,175564,9,175630
1618,0.057847,172.31.36.0-255,66,175630,9,175630
1619,0.0,74.125.24.0-255,150,150,9,232893
1620,1.4e-05,172.31.36.0-255,66,216,9,232893
1621,2e-05,74.125.24.0-255,1484,1700,9,232893
1622,2.4e-05,172.31.36.0-255,66,1766,9,232893
1623,4.3e-05,74.125.24.0-255,2902,4668,9,232893
1624,4.6e-05,172.31.36.0-255,66,4734,9,232893
1625,5.2e-05,74.125.24.0-255,4320,9054,9,232893
1626,5.4e-05,172.31.36.0-255,66,9120,9,232893
1627,7.6e-05,74.125.24.0-255,2902,12022,9,232893
1628,7.8e-05,172.31.36.0-255,66,12088,9,232893
1629,8.3e-05,74.125.24.0-255,2031,14119,9,232893
1630,8.6e-05,172.31.36.0-255,66,14185,9,232893
1631,8.9e-05,74.125.24.0-255,1484,15669,9,232893
1632,9.2e-05,172.31.36.0-255,66,15735,9,232893
1633,0.000127,172.31.36.0-255,66,15801,9,232893
1634,0.000139,172.31.36.0-255,66,15867,9,232893
1635,0.000159,74.125.24.0-255,2902,18769,9,232893
1636,0.000161,172.31.36.0-255,66,18835,9,232893
1637,0.000199,74.125.24.0-255,2902,21737,9,232893
1638,0.000201,172.31.36.0-255,66,21803,9,232893
1639,0.00022,74.125.24.0-255,6438,28241,9,232893
1640,0.000223,172.31.36.0-255,66,28307,9,232893
1641,0.000283,74.125.24.0-255,1484,29791,9,232893
1642,0.000287,172.31.36.0-255,66,29857,9,232893
1643,0.000294,74.125.24.0-255,2902,32759,9,232893
1644,0.000296,172.31.36.0-255,66,32825,9,232893
1645,0.000299,74.125.24.0-255,1484,34309,9,232893
1646,0.000302,172.31.36.0-255,66,34375,9,232893
1647,0.000325,74.125.24.0-255,4320,38695,9,232893
1648,0.000327,172.31.36.0-255,66,38761,9,232893
1649,0.000335,74.125.24.0-255,7107,45868,9,232893
1650,0.000338,172.31.36.0-255,66,45934,9,232893
1651,0.000341,74.125.24.0-255,110,46044,9,232893
1652,0.000396,74.125.24.0-255,1484,47528,9,232893
1653,0.000399,172.31.36.0-255,66,47594,9,232893
1654,0.000404,74.125.24.0-255,2902,50496,9,232893
1655,0.000406,172.31.36.0-255,66,50562,9,232893
1656,0.000434,74.125.24.0-255,2902,53464,9,232893
1657,0.000437,172.31.36.0-255,66,53530,9,232893
1658,0.000456,74.125.24.0-255,4320,57850,9,232893
1659,0.000458,172.31.36.0-255,66,57916,9,232893
1660,0.000463,74.125.24.0-255,2902,60818,9,232893
1661,0.000465,172.31.36.0-255,66,60884,9,232893
1662,0.000483,74.125.24.0-255,2902,63786,9,232893
1663,0.000486,172.31.36.0-255,66,63852,9,232893
1664,0.000492,74.125.24.0-255,4320,68172,9,232893
1665,0.000494,172.31.36.0-255,66,68238,9,232893
1666,0.000523,172.31.36.0-255,66,68304,9,232893
1667,0.000568,74.125.24.0-255,2184,70488,9,232893
1668,0.000571,172.31.36.0-255,66,70554,9,232893
1669,0.000582,74.125.24.0-255,1484,72038,9,232893
1670,0.000593,74.125.24.0-255,1484,73522,9,232893
1671,0.000595,172.31.36.0-255,66,73588,9,232893
1672,0.000613,74.125.24.0-255,1484,75072,9,232893
1673,0.000618,74.125.24.0-255,2902,77974,9,232893
1674,0.00062,172.31.36.0-255,66,78040,9,232893
1675,0.000638,74.125.24.0-255,2902,80942,9,232893
1676,0.000641,172.31.36.0-255,66,81008,9,232893
1677,0.000658,74.125.24.0-255,4320,85328,9,232893
1678,0.000661,172.31.36.0-255,66,85394,9,232893
1679,0.000693,74.125.24.0-255,5738,91132,9,232893
1680,0.000696,172.31.36.0-255,66,91198,9,232893
1681,0.000711,172.31.36.0-255,66,91264,9,232893
1682,0.000754,74.125.24.0-255,1484,92748,9,232893
1683,0.000759,74.125.24.0-255,2902,95650,9,232893
1684,0.000762,172.31.36.0-255,66,95716,9,232893
1685,0.000779,74.125.24.0-255,5738,101454,9,232893
1686,0.000782,172.31.36.0-255,66,101520,9,232893
1687,0.000803,74.125.24.0-255,5738,107258,9,232893
1688,0.000806,172.31.36.0-255,66,107324,9,232893
1689,0.000833,74.125.24.0-255,7156,114480,9,232893
1690,0.000836,172.31.36.0-255,66,114546,9,232893
1691,0.000847,172.31.36.0-255,66,114612,9,232893
1692,0.000871,74.125.24.0-255,2184,116796,9,232893
1693,0.000875,172.31.36.0-255,66,116862,9,232893
1694,0.000929,74.125.24.0-255,1484,118346,9,232893
1695,0.000934,74.125.24.0-255,2902,121248,9,232893
1696,0.000937,172.31.36.0-255,66,121314,9,232893
1697,0.000959,74.125.24.0-255,5738,127052,9,232893
1698,0.000961,172.31.36.0-255,66,127118,9,232893
1699,0.000982,74.125.24.0-255,5738,132856,9,232893
1700,0.000985,172.31.36.0-255,66,132922,9,232893
1701,0.00101,74.125.24.0-255,4320,137242,9,232893
1702,0.001013,172.31.36.0-255,66,137308,9,232893
1703,0.001026,172.31.36.0-255,66,137374,9,232893
1704,0.00103,74.125.24.0-255,2184,139558,9,232893
1705,0.001032,172.31.36.0-255,66,139624,9,232893
1706,0.001036,74.125.24.0-255,2902,142526,9,232893
1707,0.001038,172.31.36.0-255,66,142592,9,232893
1708,0.001041,74.125.24.0-255,1484,144076,9,232893
1709,0.001065,74.125.24.0-255,5738,149814,9,232893
1710,0.001067,172.31.36.0-255,66,149880,9,232893
1711,0.001072,74.125.24.0-255,2902,152782,9,232893
1712,0.001074,172.31.36.0-255,66,152848,9,232893
1713,0.001106,172.31.36.0-255,66,152914,9,232893
1714,0.00111,74.125.24.0-255,2902,155816,9,232893
1715,0.001112,172.31.36.0-255,66,155882,9,232893
1716,0.001147,172.31.36.0-255,66,155948,9,232893
1717,0.001172,74.125.24.0-255,766,156714,9,232893
1718,0.00119,172.31.36.0-255,66,156780,9,232893
1719,0.001205,172.31.36.0-255,66,156846,9,232893
1720,0.001239,74.125.24.0-255,1484,158330,9,232893
1721,0.001244,74.125.24.0-255,2902,161232,9,232893
1722,0.001248,172.31.36.0-255,66,161298,9,232893
1723,0.001267,74.125.24.0-255,5738,167036,9,232893
1724,0.001269,172.31.36.0-255,66,167102,9,232893
1725,0.001326,74.125.24.0-255,6483,173585,9,232893
1726,0.001338,172.31.36.0-255,66,173651,9,232893
1727,0.001341,172.31.36.0-255,66,173717,9,232893
1728,0.001359,74.125.24.0-255,5738,179455,9,232893
1729,0.001362,172.31.36.0-255,66,179521,9,232893
1730,0.001366,74.125.24.0-255,2902,182423,9,232893
1731,0.001369,172.31.36.0-255,66,182489,9,232893
1732,0.001395,74.125.24.0-255,4320,186809,9,232893
1733,0.001398,172.31.36.0-255,66,186875,9,232893
1734,0.001415,74.125.24.0-255,2902,189777,9,232893
1735,0.001417,172.31.36.0-255,66,189843,9,232893
1736,0.001442,172.31.36.0-255,66,189909,9,232893
1737,0.001526,74.125.24.0-255,1484,191393,9,232893
1738,0.001532,74.125.24.0-255,2902,194295,9,232893
1739,0.001535,172.31.36.0-255,66,194361,9,232893
1740,0.001554,74.125.24.0-255,5738,200099,9,232893
1741,0.001557,172.31.36.0-255,66,200165,9,232893
1742,0.001578,74.125.24.0-255,5738,205903,9,232893
1743,0.001581,172.31.36.0-255,66,205969,9,232893
1744,0.001616,74.125.24.0-255,7156,213125,9,232893
1745,0.001619,172.31.36.0-255,66,213191,9,232893
1746,0.001631,172.31.36.0-255,66,213257,9,232893
1747,0.001652,74.125.24.0-255,4320,217577,9,232893
1748,0.001656,172.31.36.0-255,66,217643,9,232893
1749,0.001673,172.31.36.0-255,66,217709,9,232893
1750,0.001694,74.125.24.0-255,6438,224147,9,232893
1751,0.001697,172.31.36.0-255,66,224213,9,232893
1752,0.0017,74.125.24.0-255,1484,225697,9,232893
1753,0.001725,172.31.36.0-255,66,225763,9,232893
1754,0.001774,172.31.36.0-255,66,225829,9,232893
1755,0.001796,172.31.36.0-255,66,225895,9,232893
1756,0.001798,74.125.24.0-255,456,226351,9,232893
1757,0.001819,74.125.24.0-255,105,226456,9,232893
1758,0.008785,172.31.36.0-255,66,226522,9,232893
1759,0.010908,172.31.36.0-255,105,226627,9,232893
1760,0.013627,74.125.24.0-255,66,226693,9,232893
1761,0.041579,172.31.36.0-255,172,226865,9,232893
1762,0.041611,172.31.36.0-255,1116,227981,9,232893
1763,0.041694,172.31.36.0-255,1514,229495,9,232893
1764,0.041696,172.31.36.0-255,1514,231009,9,232893
1765,0.041698,172.31.36.0-255,1514,232523,9,232893
1766,0.041698,172.31.36.0-255,106,232629,9,232893
1767,0.043259,104.244.42.0-255,66,232695,9,232893
1768,0.043402,104.244.42.0-255,66,232761,9,232893
1769,0.043408,104.244.42.0-255,66,232827,9,232893
1770,0.043412,104.244.42.0-255,66,232893,9,232893
1771,0.0,74.125.24.0-255,153,153,9,237954
1772,1.6e-05,172.31.36.0-255,66,219,9,237954
1773,2.3e-05,74.125.24.0-255,1484,1703,9,237954
1774,2.8e-05,172.31.36.0-255,66,1769,9,237954
1775,3.4e-05,74.125.24.0-255,2902,4671,9,237954
1776,3.8e-05,172.31.36.0-255,66,4737,9,237954
1777,4.7e-05,74.125.24.0-255,7156,11893,9,237954
1778,5.1e-05,172.31.36.0-255,66,11959,9,237954
1779,7.7e-05,74.125.24.0-255,2035,13994,9,237954
1780,7.9e-05,172.31.36.0-255,66,14060,9,237954
1781,0.000354,74.125.24.0-255,1484,15544,9,237954
1782,0.000359,172.31.36.0-255,66,15610,9,237954
1783,0.000366,74.125.24.0-255,2902,18512,9,237954
1784,0.000369,172.31.36.0-255,66,18578,9,237954
1785,0.000395,74.125.24.0-255,5738,24316,9,237954
1786,0.000398,172.31.36.0-255,66,24382,9,237954
1787,0.000405,74.125.24.0-255,5738,30120,9,237954
1788,0.000407,172.31.36.0-255,66,30186,9,237954
1789,0.00043,74.125.24.0-255,1125,31311,9,237954
1790,0.000432,172.31.36.0-255,66,31377,9,237954
1791,0.000533,74.125.24.0-255,1484,32861,9,237954
1792,0.000537,172.31.36.0-255,66,32927,9,237954
1793,0.000566,74.125.24.0-255,2902,35829,9,237954
1794,0.00057,172.31.36.0-255,66,35895,9,237954
1795,0.000608,74.125.24.0-255,5738,41633,9,237954
1796,0.000612,172.31.36.0-255,66,41699,9,237954
1797,0.000615,74.125.24.0-255,1484,43183,9,237954
1798,0.000617,172.31.36.0-255,66,43249,9,237954
1799,0.000626,74.125.24.0-255,7156,50405,9,237954
1800,0.000629,172.31.36.0-255,66,50471,9,237954
1801,0.000643,74.125.24.0-255,2543,53014,9,237954
1802,0.00065,74.125.24.0-255,7156,60170,9,237954
1803,0.000658,172.31.36.0-255,66,60236,9,237954
1804,0.000667,74.125.24.0-255,5379,65615,9,237954
1805,0.000672,172.31.36.0-255,66,65681,9,237954
1806,0.000941,74.125.24.0-255,412,66093,9,237954
1807,0.00098,74.125.24.0-255,330,66423,9,237954
1808,0.0011,172.31.36.0-255,66,66489,9,237954
1809,0.00154,74.125.24.0-255,1484,67973,9,237954
1810,0.001551,74.125.24.0-255,2902,70875,9,237954
1811,0.001556,172.31.36.0-255,66,70941,9,237954
1812,0.001565,74.125.24.0-255,5738,76679,9,237954
1813,0.001567,172.31.36.0-255,66,76745,9,237954
1814,0.00157,74.125.24.0-255,1484,78229,9,237954
1815,0.001615,74.125.24.0-255,5738,83967,9,237954
1816,0.001626,74.125.24.0-255,1484,85451,9,237954
1817,0.001644,74.125.24.0-255,6438,91889,9,237954
1818,0.002903,172.31.36.0-255,66,91955,9,237954
1819,0.005155,74.125.24.0-255,5738,97693,9,237954
1820,0.005168,172.31.36.0-255,66,97759,9,237954
1821,0.007437,74.125.24.0-255,5738,103497,9,237954
1822,0.007444,172.31.36.0-255,66,103563,9,237954
1823,0.009732,74.125.24.0-255,5738,109301,9,237954
1824,0.009739,172.31.36.0-255,66,109367,9,237954
1825,0.012112,74.125.24.0-255,5738,115105,9,237954
1826,0.012131,172.31.36.0-255,66,115171,9,237954
1827,0.014375,74.125.24.0-255,5738,120909,9,237954
1828,0.014393,172.31.36.0-255,66,120975,9,237954
1829,0.016668,74.125.24.0-255,5738,126713,9,237954
1830,0.016685,172.31.36.0-255,66,126779,9,237954
1831,0.018971,74.125.24.0-255,5738,132517,9,237954
1832,0.018991,172.31.36.0-255,66,132583,9,237954
1833,0.02129,74.125.24.0-255,5738,138321,9,237954
1834,0.021305,172.31.36.0-255,66,138387,9,237954
1835,0.023565,74.125.24.0-255,5738,144125,9,237954
1836,0.023578,172.31.36.0-255,66,144191,9,237954
1837,0.025814,74.125.24.0-255,5738,149929,9,237954
1838,0.025827,172.31.36.0-255,66,149995,9,237954
1839,0.028073,74.125.24.0-255,5738,155733,9,237954
1840,0.028088,172.31.36.0-255,66,155799,9,237954
1841,0.030407,74.125.24.0-255,5738,161537,9,237954
1842,0.03042,172.31.36.0-255,66,161603,9,237954
1843,0.032718,74.125.24.0-255,5738,167341,9,237954
1844,0.032733,172.31.36.0-255,66,167407,9,237954
1845,0.034988,74.125.24.0-255,5738,173145,9,237954
1846,0.035005,172.31.36.0-255,66,173211,9,237954
1847,0.037322,74.125.24.0-255,5738,178949,9,237954
1848,0.037339,172.31.36.0-255,66,179015,9,237954
1849,0.039664,74.125.24.0-255,5738,184753,9,237954
1850,0.039685,172.31.36.0-255,66,184819,9,237954
1851,0.041929,74.125.24.0-255,5738,190557,9,237954
1852,0.041937,172.31.36.0-255,66,190623,9,237954
1853,0.044203,74.125.24.0-255,5738,196361,9,237954
1854,0.044212,172.31.36.0-255,66,196427,9,237954
1855,0.04601,172.31.36.0-255,172,196599,9,237954
1856,0.046047,172.31.36.0-255,1116,197715,9,237954
1857,0.046111,172.31.36.0-255,1514,199229,9,237954
1858,0.046113,172.31.36.0-255,1514,200743,9,237954
1859,0.046119,172.31.36.0-255,1514,202257,9,237954
1860,0.04612,172.31.36.0-255,609,202866,9,237954
1861,0.046481,74.125.24.0-255,5738,208604,9,237954
1862,0.046488,172.31.36.0-255,66,208670,9,237954
1863,0.047668,104.244.42.0-255,66,208736,9,237954
1864,0.047703,104.244.42.0-255,66,208802,9,237954
1865,0.047794,104.244.42.0-255,66,208868,9,237954
1866,0.04785,104.244.42.0-255,66,208934,9,237954
1867,0.048787,74.125.24.0-255,5738,214672,9,237954
1868,0.048792,172.31.36.0-255,66,214738,9,237954
1869,0.051121,74.125.24.0-255,5738,220476,9,237954
1870,0.051128,172.31.36.0-255,66,220542,9,237954
1871,0.053431,74.125.24.0-255,5738,226280,9,237954
1872,0.053437,172.31.36.0-255,66,226346,9,237954
1873,0.055705,74.125.24.0-255,5738,232084,9,237954
1874,0.055712,172.31.36.0-255,66,232150,9,237954
1875,0.05803,74.125.24.0-255,5738,237888,9,237954
1876,0.058036,172.31.36.0-255,66,237954,9,237954
1877,0.0,74.125.24.0-255,153,153,9,207783
1878,1.6e-05,172.31.36.0-255,66,219,9,207783
1879,2.2e-05,74.125.24.0-255,1484,1703,9,207783
1880,2.6e-05,172.31.36.0-255,66,1769,9,207783
1881,3.3e-05,74.125.24.0-255,2902,4671,9,207783
1882,4.4e-05,172.31.36.0-255,66,4737,9,207783
1883,5.2e-05,74.125.24.0-255,7156,11893,9,207783
1884,5.5e-05,172.31.36.0-255,66,11959,9,207783
1885,5.9e-05,74.125.24.0-255,2029,13988,9,207783
1886,6.2e-05,172.31.36.0-255,66,14054,9,207783
1887,9.7e-05,74.125.24.0-255,2902,16956,9,207783
1888,0.000101,172.31.36.0-255,66,17022,9,207783
1889,0.000107,74.125.24.0-255,4320,21342,9,207783
1890,0.00011,172.31.36.0-255,66,21408,9,207783
1891,0.000135,74.125.24.0-255,5738,27146,9,207783
1892,0.000138,172.31.36.0-255,66,27212,9,207783
1893,0.000167,74.125.24.0-255,3961,31173,9,207783
1894,0.000169,172.31.36.0-255,66,31239,9,207783
1895,0.000303,74.125.24.0-255,1484,32723,9,207783
1896,0.000308,172.31.36.0-255,66,32789,9,207783
1897,0.000314,74.125.24.0-255,2902,35691,9,207783
1898,0.000316,172.31.36.0-255,66,35757,9,207783
1899,0.000352,74.125.24.0-255,5738,41495,9,207783
1900,0.000355,172.31.36.0-255,66,41561,9,207783
1901,0.000383,74.125.24.0-255,6797,48358,9,207783
1902,0.000386,172.31.36.0-255,66,48424,9,207783
1903,0.00039,74.125.24.0-255,2902,51326,9,207783
1904,0.000392,172.31.36.0-255,66,51392,9,207783
1905,0.000416,74.125.24.0-255,4320,55712,9,207783
1906,0.000419,172.31.36.0-255,66,55778,9,207783
1907,0.000431,172.31.36.0-255,66,55844,9,207783
1908,0.001087,74.125.24.0-255,108,55952,9,207783
1909,0.001148,74.125.24.0-255,333,56285,9,207783
1910,0.001332,74.125.24.0-255,1484,57769,9,207783
1911,0.001338,172.31.36.0-255,66,57835,9,207783
1912,0.001344,74.125.24.0-255,2902,60737,9,207783
1913,0.001369,74.125.24.0-255,5738,66475,9,207783
1914,0.001386,74.125.24.0-255,4320,70795,9,207783
1915,0.001406,74.125.24.0-255,5738,76533,9,207783
1916,0.001423,74.125.24.0-255,2902,79435,9,207783
1917,0.001446,74.125.24.0-255,1484,80919,9,207783
1918,0.005686,172.31.36.0-255,66,80985,9,207783
1919,0.008211,74.125.24.0-255,5738,86723,9,207783
1920,0.008219,172.31.36.0-255,66,86789,9,207783
1921,0.010665,74.125.24.0-255,5738,92527,9,207783
1922,0.010675,172.31.36.0-255,66,92593,9,207783
1923,0.013194,74.125.24.0-255,5738,98331,9,207783
1924,0.013202,172.31.36.0-255,66,98397,9,207783
1925,0.015721,74.125.24.0-255,5738,104135,9,207783
1926,0.015732,172.31.36.0-255,66,104201,9,207783
1927,0.018227,74.125.24.0-255,5738,109939,9,207783
1928,0.018237,172.31.36.0-255,66,110005,9,207783
1929,0.02076,74.125.24.0-255,5738,115743,9,207783
1930,0.020768,172.31.36.0-255,66,115809,9,207783
1931,0.023243,74.125.24.0-255,5738,121547,9,207783
1932,0.023251,172.31.36.0-255,66,121613,9,207783
1933,0.025721,74.125.24.0-255,5738,127351,9,207783
1934,0.025729,172.31.36.0-255,66,127417,9,207783
1935,0.028261,74.125.24.0-255,5738,133155,9,207783
1936,0.028269,172.31.36.0-255,66,133221,9,207783
1937,0.030776,74.125.24.0-255,5738,138959,9,207783
1938,0.030784,172.31.36.0-255,66,139025,9,207783
1939,0.033286,74.125.24.0-255,5738,144763,9,207783
1940,0.033295,172.31.36.0-255,66,144829,9,207783
1941,0.035753,74.125.24.0-255,5738,150567,9,207783
1942,0.035761,172.31.36.0-255,66,150633,9,207783
1943,0.03822,74.125.24.0-255,5738,156371,9,207783
1944,0.038232,172.31.36.0-255,66,156437,9,207783
1945,0.040788,74.125.24.0-255,5738,162175,9,207783
1946,0.040797,172.31.36.0-255,66,162241,9,207783
1947,0.043028,172.31.36.0-255,172,162413,9,207783
1948,0.043059,172.31.36.0-255,1116,163529,9,207783
1949,0.043139,172.31.36.0-255,1514,165043,9,207783
1950,0.043141,172.31.36.0-255,1514,166557,9,207783
1951,0.043142,172.31.36.0-255,1514,168071,9,207783
1952,0.043143,172.31.36.0-255,106,168177,9,207783
1953,0.043277,74.125.24.0-255,5738,173915,9,207783
1954,0.043282,172.31.36.0-255,66,173981,9,207783
1955,0.044692,104.244.42.0-255,66,174047,9,207783
1956,0.044784,104.244.42.0-255,66,174113,9,207783
1957,0.044826,104.244.42.0-255,66,174179,9,207783
1958,0.04483,104.244.42.0-255,66,174245,9,207783
1959,0.045773,74.125.24.0-255,4320,178565,9,207783
1960,0.045779,172.31.36.0-255,66,178631,9,207783
1961,0.045807,74.125.24.0-255,1484,180115,9,207783
1962,0.048288,74.125.24.0-255,4320,184435,9,207783
1963,0.048295,172.31.36.0-255,66,184501,9,207783
1964,0.050812,74.125.24.0-255,5738,190239,9,207783
1965,0.050862,172.31.36.0-255,66,190305,9,207783
1966,0.053348,74.125.24.0-255,5738,196043,9,207783
1967,0.053355,172.31.36.0-255,66,196109,9,207783
1968,0.055834,74.125.24.0-255,5738,201847,9,207783
1969,0.055841,172.31.36.0-255,66,201913,9,207783
1970,0.058307,74.125.24.0-255,4320,206233,9,207783
1971,0.058314,172.31.36.0-255,66,206299,9,207783
1972,0.058337,74.125.24.0-255,1484,207783,9,207783
1973,0.0,172.31.36.0-255,105,105,9,459
1974,0.000182,172.31.36.0-255,90,195,9,459
1975,0.000191,172.31.36.0-255,66,261,9,459
1976,0.002155,74.125.130.0-255,66,327,9,459
1977,0.002171,74.125.130.0-255,66,393,9,459
1978,0.002182,172.31.36.0-255,66,459,9,459
1979,0.0,74.125.24.0-255,150,150,9,208635
1980,2.3e-05,172.31.36.0-255,66,216,9,208635
1981,3.1e-05,74.125.24.0-255,1484,1700,9,208635
1982,3.6e-05,172.31.36.0-255,66,1766,9,208635
1983,4.2e-05,74.125.24.0-255,2902,4668,9,208635
1984,4.6e-05,172.31.36.0-255,66,4734,9,208635
1985,5.3e-05,74.125.24.0-255,5738,10472,9,208635
1986,5.6e-05,172.31.36.0-255,66,10538,9,208635
1987,0.000101,172.31.36.0-255,66,10604,9,208635
1988,0.000108,74.125.24.0-255,6797,17401,9,208635
1989,0.000111,172.31.36.0-255,66,17467,9,208635
1990,0.000161,74.125.24.0-255,1484,18951,9,208635
1991,0.000163,172.31.36.0-255,66,19017,9,208635
1992,0.000169,74.125.24.0-255,2902,21919,9,208635
1993,0.00017,172.31.36.0-255,66,21985,9,208635
1994,0.000193,74.125.24.0-255,2902,24887,9,208635
1995,0.000195,172.31.36.0-255,66,24953,9,208635
1996,0.0002,74.125.24.0-255,4320,29273,9,208635
1997,0.000203,172.31.36.0-255,66,29339,9,208635
1998,0.000207,74.125.24.0-255,1484,30823,9,208635
1999,0.000208,172.31.36.0-255,66,30889,9,208635
2000,0.000243,74.125.24.0-255,7156,38045,9,208635
2001,0.000246,172.31.36.0-255,66,38111,9,208635
2002,0.000257,172.31.36.0-255,66,38177,9,208635
2003,0.000295,74.125.24.0-255,5323,43500,9,208635
2004,0.000299,172.31.36.0-255,66,43566,9,208635
2005,0.000316,74.125.24.0-255,374,43940,9,208635
2006,0.000318,172.31.36.0-255,66,44006,9,208635
2007,0.000595,74.125.24.0-255,1484,45490,9,208635
2008,0.0006,172.31.36.0-255,66,45556,9,208635
2009,0.000607,74.125.24.0-255,2902,48458,9,208635
2010,0.00061,172.31.36.0-255,66,48524,9,208635
2011,0.00063,74.125.24.0-255,4320,52844,9,208635
2012,0.000635,172.31.36.0-255,66,52910,9,208635
2013,0.000654,74.125.24.0-255,1484,54394,9,208635
2014,0.000663,74.125.24.0-255,5738,60132,9,208635
2015,0.000666,172.31.36.0-255,66,60198,9,208635
2016,0.000669,74.125.24.0-255,1484,61682,9,208635
2017,0.000695,172.31.36.0-255,66,61748,9,208635
2018,0.000718,74.125.24.0-255,5020,66768,9,208635
2019,0.000721,172.31.36.0-255,66,66834,9,208635
2020,0.000806,74.125.24.0-255,1484,68318,9,208635
2021,0.000823,74.125.24.0-255,2902,71220,9,208635
2022,0.000826,172.31.36.0-255,66,71286,9,208635
2023,0.00083,74.125.24.0-255,1484,72770,9,208635
2024,0.000846,74.125.24.0-255,4320,77090,9,208635
2025,0.00085,172.31.36.0-255,66,77156,9,208635
2026,0.000866,74.125.24.0-255,2902,80058,9,208635
2027,0.000869,172.31.36.0-255,66,80124,9,208635
2028,0.000893,74.125.24.0-255,3412,83536,9,208635
2029,0.000896,172.31.36.0-255,66,83602,9,208635
2030,0.000917,74.125.24.0-255,2902,86504,9,208635
2031,0.00092,172.31.36.0-255,66,86570,9,208635
2032,0.000937,74.125.24.0-255,1484,88054,9,208635
2033,0.00094,74.125.24.0-255,1484,89538,9,208635
2034,0.000942,172.31.36.0-255,66,89604,9,208635
2035,0.000976,172.31.36.0-255,66,89670,9,208635
2036,0.000981,74.125.24.0-255,4320,93990,9,208635
2037,0.000983,172.31.36.0-255,66,94056,9,208635
2038,0.001028,74.125.24.0-255,4320,98376,9,208635
2039,0.001031,172.31.36.0-255,66,98442,9,208635
2040,0.001063,172.31.36.0-255,66,98508,9,208635
2041,0.001243,74.125.24.0-255,1484,99992,9,208635
2042,0.001281,74.125.24.0-255,1484,101476,9,208635
2043,0.001284,172.31.36.0-255,66,101542,9,208635
2044,0.00129,74.125.24.0-255,2902,104444,9,208635
2045,0.001292,172.31.36.0-255,66,104510,9,208635
2046,0.001328,74.125.24.0-255,1484,105994,9,208635
2047,0.001342,74.125.24.0-255,2902,108896,9,208635
2048,0.001345,172.31.36.0-255,66,108962,9,208635
2049,0.001384,74.125.24.0-255,1484,110446,9,208635
2050,0.001397,74.125.24.0-255,2902,113348,9,208635
2051,0.001399,172.31.36.0-255,66,113414,9,208635
2052,0.001403,74.125.24.0-255,1484,114898,9,208635
2053,0.001438,74.125.24.0-255,2902,117800,9,208635
2054,0.001441,172.31.36.0-255,66,117866,9,208635
2055,0.001461,74.125.24.0-255,2902,120768,9,208635
2056,0.001463,172.31.36.0-255,66,120834,9,208635
2057,0.001469,74.125.24.0-255,4320,125154,9,208635
2058,0.001471,172.31.36.0-255,66,125220,9,208635
2059,0.001485,74.125.24.0-255,4320,129540,9,208635
2060,0.001488,172.31.36.0-255,66,129606,9,208635
2061,0.001507,74.125.24.0-255,1484,131090,9,208635
2062,0.00152,74.125.24.0-255,2184,133274,9,208635
2063,0.001522,172.31.36.0-255,66,133340,9,208635
2064,0.001789,74.125.24.0-255,1484,134824,9,208635
2065,0.001806,74.125.24.0-255,2902,137726,9,208635
2066,0.001808,74.125.24.0-255,1484,139210,9,208635
2067,0.001813,172.31.36.0-255,66,139276,9,208635
2068,0.001827,74.125.24.0-255,2902,142178,9,208635
2069,0.001829,172.31.36.0-255,66,142244,9,208635
2070,0.001835,74.125.24.0-255,5738,147982,9,208635
2071,0.001837,172.31.36.0-255,66,148048,9,208635
2072,0.001862,74.125.24.0-255,1484,149532,9,208635
2073,0.001883,74.125.24.0-255,7156,156688,9,208635
2074,0.001886,172.31.36.0-255,66,156754,9,208635
2075,0.001901,74.125.24.0-255,2902,159656,9,208635
2076,0.001904,172.31.36.0-255,66,159722,9,208635
2077,0.001917,172.31.36.0-255,66,159788,9,208635
2078,0.001925,74.125.24.0-255,7156,166944,9,208635
2079,0.001928,172.31.36.0-255,66,167010,9,208635
2080,0.001954,74.125.24.0-255,5738,172748,9,208635
2081,0.001957,172.31.36.0-255,66,172814,9,208635
2082,0.001979,74.125.24.0-255,5738,178552,9,208635
2083,0.001982,172.31.36.0-255,66,178618,9,208635
2084,0.002097,172.31.36.0-255,66,178684,9,208635
2085,0.002111,74.125.24.0-255,2184,180868,9,208635
2086,0.002185,74.125.24.0-255,4320,185188,9,208635
2087,0.002289,74.125.24.0-255,7156,192344,9,208635
2088,0.002341,74.125.24.0-255,4320,196664,9,208635
2089,0.002388,74.125.24.0-255,3351,200015,9,208635
2090,0.008317,172.31.36.0-255,66,200081,9,208635
2091,0.008324,172.31.36.0-255,66,200147,9,208635
2092,0.008328,172.31.36.0-255,66,200213,9,208635
2093,0.00833,172.31.36.0-255,66,200279,9,208635
2094,0.008343,172.31.36.0-255,66,200345,9,208635
2095,0.008347,172.31.36.0-255,66,200411,9,208635
2096,0.00835,172.31.36.0-255,66,200477,9,208635
2097,0.008354,172.31.36.0-255,66,200543,9,208635
2098,0.008357,172.31.36.0-255,66,200609,9,208635
2099,0.00836,172.31.36.0-255,66,200675,9,208635
2100,0.008363,172.31.36.0-255,66,200741,9,208635
2101,0.008367,172.31.36.0-255,66,200807,9,208635
2102,0.00837,172.31.36.0-255,66,200873,9,208635
2103,0.008373,172.31.36.0-255,66,200939,9,208635
2104,0.008377,172.31.36.0-255,66,201005,9,208635
2105,0.00838,172.31.36.0-255,66,201071,9,208635
2106,0.008383,172.31.36.0-255,66,201137,9,208635
2107,0.010748,74.125.24.0-255,105,201242,9,208635
2108,0.01087,172.31.36.0-255,66,201308,9,208635
2109,0.010916,172.31.36.0-255,105,201413,9,208635
2110,0.013335,74.125.24.0-255,66,201479,9,208635
2111,0.032315,172.31.36.0-255,171,201650,9,208635
2112,0.032348,172.31.36.0-255,1140,202790,9,208635
2113,0.032412,172.31.36.0-255,1514,204304,9,208635
2114,0.032414,172.31.36.0-255,1514,205818,9,208635
2115,0.032415,172.31.36.0-255,1514,207332,9,208635
2116,0.032441,172.31.36.0-255,1039,208371,9,208635
2117,0.033943,104.244.42.0-255,66,208437,9,208635
2118,0.033972,104.244.42.0-255,66,208503,9,208635
2119,0.034036,104.244.42.0-255,66,208569,9,208635
2120,0.034069,104.244.42.0-255,66,208635,9,208635
2121,0.0,74.125.130.0-255,153,153,9,325796
2122,3.3e-05,172.31.36.0-255,66,219,9,325796
2123,4e-05,74.125.130.0-255,1484,1703,9,325796
2124,4.4e-05,172.31.36.0-255,66,1769,9,325796
2125,5e-05,74.125.130.0-255,2902,4671,9,325796
2126,5.3e-05,172.31.36.0-255,66,4737,9,325796
2127,5.9e-05,74.125.130.0-255,4320,9057,9,325796
2128,6.2e-05,172.31.36.0-255,66,9123,9,325796
2129,7.9e-05,74.125.130.0-255,1484,10607,9,325796
2130,8.2e-05,172.31.36.0-255,66,10673,9,325796
2131,8.5e-05,74.125.130.0-255,1484,12157,9,325796
2132,8.7e-05,172.31.36.0-255,66,12223,9,325796
2133,0.000123,74.125.130.0-255,2036,14259,9,325796
2134,0.000126,172.31.36.0-255,66,14325,9,325796
2135,0.000394,74.125.130.0-255,1484,15809,9,325796
2136,0.000398,172.31.36.0-255,66,15875,9,325796
2137,0.000405,74.125.130.0-255,2902,18777,9,325796
2138,0.000407,172.31.36.0-255,66,18843,9,325796
2139,0.000437,74.125.130.0-255,5738,24581,9,325796
2140,0.00044,74.125.130.0-255,1484,26065,9,325796
2141,0.000442,172.31.36.0-255,66,26131,9,325796
2142,0.000445,172.31.36.0-255,66,26197,9,325796
2143,0.000454,74.125.130.0-255,5379,31576,9,325796
2144,0.000457,172.31.36.0-255,66,31642,9,325796
2145,0.000472,74.125.130.0-255,1484,33126,9,325796
2146,0.000475,172.31.36.0-255,66,33192,9,325796
2147,0.000495,74.125.130.0-255,2902,36094,9,325796
2148,0.000498,172.31.36.0-255,66,36160,9,325796
2149,0.000532,74.125.130.0-255,5738,41898,9,325796
2150,0.000536,172.31.36.0-255,66,41964,9,325796
2151,0.000542,74.125.130.0-255,4320,46284,9,325796
2152,0.000545,172.31.36.0-255,66,46350,9,325796
2153,0.000576,74.125.130.0-255,2543,48893,9,325796
2154,0.00058,172.31.36.0-255,66,48959,9,325796
2155,0.000789,74.125.130.0-255,1484,50443,9,325796
2156,0.000799,74.125.130.0-255,2902,53345,9,325796
2157,0.000802,172.31.36.0-255,66,53411,9,325796
2158,0.000829,74.125.130.0-255,5738,59149,9,325796
2159,0.000834,74.125.130.0-255,2902,62051,9,325796
2160,0.000838,74.125.130.0-255,3961,66012,9,325796
2161,0.000859,172.31.36.0-255,66,66078,9,325796
2162,0.001,74.125.130.0-255,1484,67562,9,325796
2163,0.001007,74.125.130.0-255,2902,70464,9,325796
2164,0.001021,74.125.130.0-255,1484,71948,9,325796
2165,0.001045,74.125.130.0-255,4320,76268,9,325796
2166,0.001062,74.125.130.0-255,4320,80588,9,325796
2167,0.001075,172.31.36.0-255,66,80654,9,325796
2168,0.00108,74.125.130.0-255,2833,83487,9,325796
2169,0.001084,74.125.130.0-255,2902,86389,9,325796
2170,0.001096,74.125.130.0-255,1484,87873,9,325796
2171,0.001102,172.31.36.0-255,66,87939,9,325796
2172,0.001114,74.125.130.0-255,2902,90841,9,325796
2173,0.00113,74.125.130.0-255,2902,93743,9,325796
2174,0.001138,74.125.130.0-255,6797,100540,9,325796
2175,0.001163,172.31.36.0-255,66,100606,9,325796
2176,0.001224,74.125.130.0-255,1484,102090,9,325796
2177,0.001229,74.125.130.0-255,1484,103574,9,325796
2178,0.001235,172.31.36.0-255,66,103640,9,325796
2179,0.001252,74.125.130.0-255,1484,105124,9,325796
2180,0.001258,74.125.130.0-255,5738,110862,9,325796
2181,0.001279,74.125.130.0-255,1484,112346,9,325796
2182,0.001298,172.31.36.0-255,66,112412,9,325796
2183,0.001305,74.125.130.0-255,5738,118150,9,325796
2184,0.00131,74.125.130.0-255,2902,121052,9,325796
2185,0.001316,172.31.36.0-255,66,121118,9,325796
2186,0.001329,74.125.130.0-255,5738,126856,9,325796
2187,0.001333,74.125.130.0-255,4320,131176,9,325796
2188,0.001382,74.125.130.0-255,3602,134778,9,325796
2189,0.001387,172.31.36.0-255,66,134844,9,325796
2190,0.001399,172.31.36.0-255,66,134910,9,325796
2191,0.001492,74.125.130.0-255,1484,136394,9,325796
2192,0.001496,74.125.130.0-255,1484,137878,9,325796
2193,0.001508,74.125.130.0-255,1484,139362,9,325796
2194,0.001512,172.31.36.0-255,66,139428,9,325796
2195,0.001535,74.125.130.0-255,5738,145166,9,325796
2196,0.001537,74.125.130.0-255,1484,146650,9,325796
2197,0.001552,74.125.130.0-255,5738,152388,9,325796
2198,0.001571,74.125.130.0-255,2902,155290,9,325796
2199,0.001575,74.125.130.0-255,2902,158192,9,325796
2200,0.001578,172.31.36.0-255,66,158258,9,325796
2201,0.001584,172.31.36.0-255,66,158324,9,325796
2202,0.0016,74.125.130.0-255,5738,164062,9,325796
2203,0.001628,172.31.36.0-255,66,164128,9,325796
2204,0.001639,74.125.130.0-255,5318,169446,9,325796
2205,0.001651,172.31.36.0-255,66,169512,9,325796
2206,0.00379,74.125.130.0-255,5738,175250,9,325796
2207,0.003796,172.31.36.0-255,66,175316,9,325796
2208,0.005947,74.125.130.0-255,1484,176800,9,325796
2209,0.005969,74.125.130.0-255,4320,181120,9,325796
2210,0.005973,172.31.36.0-255,66,181186,9,325796
2211,0.008129,74.125.130.0-255,5738,186924,9,325796
2212,0.008134,172.31.36.0-255,66,186990,9,325796
2213,0.010301,74.125.130.0-255,5738,192728,9,325796
2214,0.01031,172.31.36.0-255,66,192794,9,325796
2215,0.012466,74.125.130.0-255,5738,198532,9,325796
2216,0.012476,172.31.36.0-255,66,198598,9,325796
2217,0.014641,74.125.130.0-255,5738,204336,9,325796
2218,0.01465,172.31.36.0-255,66,204402,9,325796
2219,0.016796,74.125.130.0-255,5738,210140,9,325796
2220,0.016804,172.31.36.0-255,66,210206,9,325796
2221,0.018959,74.125.130.0-255,5738,215944,9,325796
2222,0.018968,172.31.36.0-255,66,216010,9,325796
2223,0.02116,74.125.130.0-255,5738,221748,9,325796
2224,0.021167,172.31.36.0-255,66,221814,9,325796
2225,0.023317,74.125.130.0-255,4320,226134,9,325796
2226,0.023324,172.31.36.0-255,66,226200,9,325796
2227,0.023344,74.125.130.0-255,1484,227684,9,325796
2228,0.025478,74.125.130.0-255,4320,232004,9,325796
2229,0.025485,172.31.36.0-255,66,232070,9,325796
2230,0.027652,74.125.130.0-255,5738,237808,9,325796
2231,0.027697,172.31.36.0-255,66,237874,9,325796
2232,0.029848,74.125.130.0-255,5738,243612,9,325796
2233,0.029855,172.31.36.0-255,66,243678,9,325796
2234,0.032018,74.125.130.0-255,5738,249416,9,325796
2235,0.032025,172.31.36.0-255,66,249482,9,325796
2236,0.034202,74.125.130.0-255,5738,255220,9,325796
2237,0.034209,172.31.36.0-255,66,255286,9,325796
2238,0.03636,74.125.130.0-255,5738,261024,9,325796
2239,0.036368,172.31.36.0-255,66,261090,9,325796
2240,0.038593,74.125.130.0-255,5738,266828,9,325796
2241,0.0386,172.31.36.0-255,66,266894,9,325796
2242,0.040748,74.125.130.0-255,5738,272632,9,325796
2243,0.040755,172.31.36.0-255,66,272698,9,325796
2244,0.041973,172.31.36.0-255,176,272874,9,325796
2245,0.042028,172.31.36.0-255,1116,273990,9,325796
2246,0.042101,172.31.36.0-255,1514,275504,9,325796
2247,0.042104,172.31.36.0-255,1514,277018,9,325796
2248,0.042108,172.31.36.0-255,1514,278532,9,325796
2249,0.042109,172.31.36.0-255,106,278638,9,325796
2250,0.042936,74.125.130.0-255,5738,284376,9,325796
2251,0.042942,172.31.36.0-255,66,284442,9,325796
2252,0.043623,104.244.42.0-255,66,284508,9,325796
2253,0.043721,104.244.42.0-255,66,284574,9,325796
2254,0.043835,104.244.42.0-255,66,284640,9,325796
2255,0.043837,104.244.42.0-255,66,284706,9,325796
2256,0.04509,74.125.130.0-255,2902,287608,9,325796
2257,0.045094,172.31.36.0-255,66,287674,9,325796
2258,0.045123,74.125.130.0-255,2902,290576,9,325796
2259,0.04515,172.31.36.0-255,66,290642,9,325796
2260,0.04724,74.125.130.0-255,2902,293544,9,325796
2261,0.047246,172.31.36.0-255,66,293610,9,325796
2262,0.047285,74.125.130.0-255,2902,296512,9,325796
2263,0.047292,172.31.36.0-255,66,296578,9,325796
2264,0.049385,74.125.130.0-255,2902,299480,9,325796
2265,0.04939,172.31.36.0-255,66,299546,9,325796
2266,0.049446,74.125.130.0-255,2902,302448,9,325796
2267,0.049527,172.31.36.0-255,66,302514,9,325796
2268,0.05154,74.125.130.0-255,1484,303998,9,325796
2269,0.051665,74.125.130.0-255,4320,308318,9,325796
2270,0.051972,172.31.36.0-255,66,308384,9,325796
2271,0.054121,74.125.130.0-255,5738,314122,9,325796
2272,0.054126,172.31.36.0-255,66,314188,9,325796
2273,0.056274,74.125.130.0-255,5738,319926,9,325796
2274,0.05628,172.31.36.0-255,66,319992,9,325796
2275,0.058512,74.125.130.0-255,5738,325730,9,325796
2276,0.058517,172.31.36.0-255,66,325796,9,325796
2277,0.0,172.31.36.0-255,105,105,9,105
2278,0.0,74.125.24.0-255,153,153,9,270867
2279,2.6e-05,74.125.24.0-255,1484,1637,9,270867
2280,3.3e-05,172.31.36.0-255,66,1703,9,270867
2281,4.1e-05,74.125.24.0-255,2902,4605,9,270867
2282,4.4e-05,172.31.36.0-255,66,4671,9,270867
2283,4.9e-05,74.125.24.0-255,2902,7573,9,270867
2284,5.1e-05,172.31.36.0-255,66,7639,9,270867
2285,7.3e-05,74.125.24.0-255,4320,11959,9,270867
2286,7.5e-05,172.31.36.0-255,66,12025,9,270867
2287,8e-05,74.125.24.0-255,2035,14060,9,270867
2288,8.4e-05,172.31.36.0-255,66,14126,9,270867
2289,0.000207,74.125.24.0-255,1484,15610,9,270867
2290,0.000213,74.125.24.0-255,2902,18512,9,270867
2291,0.000217,172.31.36.0-255,66,18578,9,270867
2292,0.000242,74.125.24.0-255,5738,24316,9,270867
2293,0.000245,172.31.36.0-255,66,24382,9,270867
2294,0.000275,74.125.24.0-255,4320,28702,9,270867
2295,0.000278,172.31.36.0-255,66,28768,9,270867
2296,0.000291,74.125.24.0-255,2543,31311,9,270867
2297,0.000295,172.31.36.0-255,66,31377,9,270867
2298,0.000705,74.125.24.0-255,1484,32861,9,270867
2299,0.000715,74.125.24.0-255,2902,35763,9,270867
2300,0.000719,172.31.36.0-255,66,35829,9,270867
2301,0.000743,74.125.24.0-255,4320,40149,9,270867
2302,0.000747,172.31.36.0-255,66,40215,9,270867
2303,0.000763,74.125.24.0-255,1484,41699,9,270867
2304,0.000771,74.125.24.0-255,6797,48496,9,270867
2305,0.000774,172.31.36.0-255,66,48562,9,270867
2306,0.000811,74.125.24.0-255,7156,55718,9,270867
2307,0.000815,172.31.36.0-255,66,55784,9,270867
2308,0.000838,74.125.24.0-255,7156,62940,9,270867
2309,0.00084,172.31.36.0-255,66,63006,9,270867
2310,0.000845,74.125.24.0-255,2819,65825,9,270867
2311,0.000848,172.31.36.0-255,66,65891,9,270867
2312,0.00085,74.125.24.0-255,378,66269,9,270867
2313,0.00113,74.125.24.0-255,1484,67753,9,270867
2314,0.001136,172.31.36.0-255,66,67819,9,270867
2315,0.001142,74.125.24.0-255,2902,70721,9,270867
2316,0.001145,172.31.36.0-255,66,70787,9,270867
2317,0.001173,74.125.24.0-255,5738,76525,9,270867
2318,0.001176,172.31.36.0-255,66,76591,9,270867
2319,0.00118,74.125.24.0-255,4320,80911,9,270867
2320,0.001182,172.31.36.0-255,66,80977,9,270867
2321,0.001221,74.125.24.0-255,1484,82461,9,270867
2322,0.001239,74.125.24.0-255,5379,87840,9,270867
2323,0.001241,172.31.36.0-255,66,87906,9,270867
2324,0.001245,74.125.24.0-255,2902,90808,9,270867
2325,0.001247,172.31.36.0-255,66,90874,9,270867
2326,0.001262,74.125.24.0-255,4320,95194,9,270867
2327,0.001265,172.31.36.0-255,66,95260,9,270867
2328,0.001288,74.125.24.0-255,5379,100639,9,270867
2329,0.00129,172.31.36.0-255,66,100705,9,270867
2330,0.002099,74.125.24.0-255,1484,102189,9,270867
2331,0.002119,74.125.24.0-255,2902,105091,9,270867
2332,0.002122,172.31.36.0-255,66,105157,9,270867
2333,0.00214,74.125.24.0-255,5738,110895,9,270867
2334,0.002143,172.31.36.0-255,66,110961,9,270867
2335,0.002174,74.125.24.0-255,1484,112445,9,270867
2336,0.002199,74.125.24.0-255,4320,116765,9,270867
2337,0.002202,172.31.36.0-255,66,116831,9,270867
2338,0.002215,172.31.36.0-255,66,116897,9,270867
2339,0.002221,74.125.24.0-255,5020,121917,9,270867
2340,0.002223,172.31.36.0-255,66,121983,9,270867
2341,0.002511,74.125.24.0-255,1484,123467,9,270867
2342,0.002528,74.125.24.0-255,2902,126369,9,270867
2343,0.00253,172.31.36.0-255,66,126435,9,270867
2344,0.002533,74.125.24.0-255,1484,127919,9,270867
2345,0.002551,74.125.24.0-255,1484,129403,9,270867
2346,0.002553,172.31.36.0-255,66,129469,9,270867
2347,0.002557,74.125.24.0-255,2902,132371,9,270867
2348,0.002559,172.31.36.0-255,66,132437,9,270867
2349,0.002588,74.125.24.0-255,5738,138175,9,270867
2350,0.00259,172.31.36.0-255,66,138241,9,270867
2351,0.002602,172.31.36.0-255,66,138307,9,270867
2352,0.002605,74.125.24.0-255,1484,139791,9,270867
2353,0.002609,74.125.24.0-255,3602,143393,9,270867
2354,0.002611,172.31.36.0-255,66,143459,9,270867
2355,0.002649,74.125.24.0-255,5738,149197,9,270867
2356,0.002651,172.31.36.0-255,66,149263,9,270867
2357,0.002654,74.125.24.0-255,1484,150747,9,270867
2358,0.002656,74.125.24.0-255,1484,152231,9,270867
2359,0.002658,172.31.36.0-255,66,152297,9,270867
2360,0.002683,74.125.24.0-255,2902,155199,9,270867
2361,0.002685,172.31.36.0-255,66,155265,9,270867
2362,0.002708,172.31.36.0-255,66,155331,9,270867
2363,0.002712,74.125.24.0-255,2902,158233,9,270867
2364,0.002714,172.31.36.0-255,66,158299,9,270867
2365,0.002731,74.125.24.0-255,4320,162619,9,270867
2366,0.002733,172.31.36.0-255,66,162685,9,270867
2367,0.002775,74.125.24.0-255,6438,169123,9,270867
2368,0.002778,172.31.36.0-255,66,169189,9,270867
2369,0.002785,74.125.24.0-255,7156,176345,9,270867
2370,0.002787,172.31.36.0-255,66,176411,9,270867
2371,0.002825,172.31.36.0-255,66,176477,9,270867
2372,0.002859,172.31.36.0-255,66,176543,9,270867
2373,0.00288,74.125.24.0-255,1484,178027,9,270867
2374,0.00289,172.31.36.0-255,66,178093,9,270867
2375,0.002924,74.125.24.0-255,5738,183831,9,270867
2376,0.002927,172.31.36.0-255,66,183897,9,270867
2377,0.002968,172.31.36.0-255,66,183963,9,270867
2378,0.002985,172.31.36.0-255,66,184029,9,270867
2379,0.002988,74.125.24.0-255,2184,186213,9,270867
2380,0.002991,172.31.36.0-255,66,186279,9,270867
2381,0.003013,74.125.24.0-255,5738,192017,9,270867
2382,0.003016,172.31.36.0-255,66,192083,9,270867
2383,0.00306,172.31.36.0-255,66,192149,9,270867
2384,0.003066,74.125.24.0-255,5738,197887,9,270867
2385,0.003068,172.31.36.0-255,66,197953,9,270867
2386,0.003139,172.31.36.0-255,66,198019,9,270867
2387,0.003154,172.31.36.0-255,66,198085,9,270867
2388,0.003165,172.31.36.0-255,66,198151,9,270867
2389,0.003167,74.125.24.0-255,766,198917,9,270867
2390,0.00317,74.125.24.0-255,1484,200401,9,270867
2391,0.003173,172.31.36.0-255,66,200467,9,270867
2392,0.003189,74.125.24.0-255,2902,203369,9,270867
2393,0.003192,172.31.36.0-255,66,203435,9,270867
2394,0.003209,74.125.24.0-255,7156,210591,9,270867
2395,0.003212,172.31.36.0-255,66,210657,9,270867
2396,0.003219,74.125.24.0-255,7156,217813,9,270867
2397,0.003221,172.31.36.0-255,66,217879,9,270867
2398,0.003242,74.125.24.0-255,4320,222199,9,270867
2399,0.003244,172.31.36.0-255,66,222265,9,270867
2400,0.003251,74.125.24.0-255,7156,229421,9,270867
2401,0.003254,172.31.36.0-255,66,229487,9,270867
2402,0.003261,74.125.24.0-255,7156,236643,9,270867
2403,0.003264,172.31.36.0-255,66,236709,9,270867
2404,0.003289,74.125.24.0-255,766,237475,9,270867
2405,0.003297,74.125.24.0-255,7156,244631,9,270867
2406,0.003299,172.31.36.0-255,66,244697,9,270867
2407,0.00331,172.31.36.0-255,66,244763,9,270867
2408,0.003338,74.125.24.0-255,7156,251919,9,270867
2409,0.003341,172.31.36.0-255,66,251985,9,270867
2410,0.003364,74.125.24.0-255,6438,258423,9,270867
2411,0.003366,172.31.36.0-255,66,258489,9,270867
2412,0.003412,172.31.36.0-255,66,258555,9,270867
2413,0.003431,74.125.24.0-255,2768,261323,9,270867
2414,0.003434,172.31.36.0-255,66,261389,9,270867
2415,0.003451,74.125.24.0-255,105,261494,9,270867
2416,0.006188,172.31.36.0-255,105,261599,9,270867
2417,0.008502,74.125.24.0-255,66,261665,9,270867
2418,0.033744,172.31.36.0-255,172,261837,9,270867
2419,0.033776,172.31.36.0-255,1115,262952,9,270867
2420,0.033821,172.31.36.0-255,1514,264466,9,270867
2421,0.033823,172.31.36.0-255,1514,265980,9,270867
2422,0.033824,172.31.36.0-255,1514,267494,9,270867
2423,0.033825,172.31.36.0-255,1514,269008,9,270867
2424,0.03385,172.31.36.0-255,1487,270495,9,270867
2425,0.035314,104.244.42.0-255,66,270561,9,270867
2426,0.035323,104.244.42.0-255,66,270627,9,270867
2427,0.035431,104.244.42.0-255,66,270693,9,270867
2428,0.03671,104.244.42.0-255,108,270801,9,270867
2429,0.036716,172.31.36.0-255,66,270867,9,270867
2430,0.0,74.125.24.0-255,153,153,9,273612
2431,1.4e-05,172.31.36.0-255,66,219,9,273612
2432,2.1e-05,74.125.24.0-255,1484,1703,9,273612
2433,2.6e-05,172.31.36.0-255,66,1769,9,273612
2434,4e-05,74.125.24.0-255,2902,4671,9,273612
2435,4.4e-05,172.31.36.0-255,66,4737,9,273612
2436,5.2e-05,74.125.24.0-255,7156,11893,9,273612
2437,5.6e-05,172.31.36.0-255,66,11959,9,273612
2438,6.2e-05,74.125.24.0-255,4320,16279,9,273612
2439,6.4e-05,172.31.36.0-255,66,16345,9,273612
2440,9.6e-05,74.125.24.0-255,2020,18365,9,273612
2441,9.9e-05,172.31.36.0-255,66,18431,9,273612
2442,0.000102,74.125.24.0-255,1484,19915,9,273612
2443,0.000105,172.31.36.0-255,66,19981,9,273612
2444,0.000136,172.31.36.0-255,66,20047,9,273612
2445,0.000175,74.125.24.0-255,2902,22949,9,273612
2446,0.000178,172.31.36.0-255,66,23015,9,273612
2447,0.000188,74.125.24.0-255,4320,27335,9,273612
2448,0.000191,172.31.36.0-255,66,27401,9,273612
2449,0.000201,172.31.36.0-255,66,27467,9,273612
2450,0.000228,74.125.24.0-255,4320,31787,9,273612
2451,0.00023,172.31.36.0-255,66,31853,9,273612
2452,0.000272,172.31.36.0-255,66,31919,9,273612
2453,0.000368,74.125.24.0-255,645,32564,9,273612
2454,0.000371,172.31.36.0-255,66,32630,9,273612
2455,0.001004,74.125.24.0-255,1484,34114,9,273612
2456,0.001011,172.31.36.0-255,66,34180,9,273612
2457,0.001017,74.125.24.0-255,2902,37082,9,273612
2458,0.001019,172.31.36.0-255,66,37148,9,273612
2459,0.001022,74.125.24.0-255,1484,38632,9,273612
2460,0.001052,74.125.24.0-255,4320,42952,9,273612
2461,0.001055,172.31.36.0-255,66,43018,9,273612
2462,0.001069,172.31.36.0-255,66,43084,9,273612
2463,0.001104,172.31.36.0-255,66,43150,9,273612
2464,0.001574,74.125.24.0-255,1484,44634,9,273612
2465,0.001583,74.125.24.0-255,2902,47536,9,273612
2466,0.001587,172.31.36.0-255,66,47602,9,273612
2467,0.001595,74.125.24.0-255,5738,53340,9,273612
2468,0.001598,172.31.36.0-255,66,53406,9,273612
2469,0.00165,172.31.36.0-255,66,53472,9,273612
2470,0.001663,172.31.36.0-255,66,53538,9,273612
2471,0.001693,74.125.24.0-255,766,54304,9,273612
2472,0.001777,74.125.24.0-255,1484,55788,9,273612
2473,0.001781,172.31.36.0-255,66,55854,9,273612
2474,0.001788,74.125.24.0-255,2902,58756,9,273612
2475,0.00179,172.31.36.0-255,66,58822,9,273612
2476,0.0018,74.125.24.0-255,2902,61724,9,273612
2477,0.001802,172.31.36.0-255,66,61790,9,273612
2478,0.001817,74.125.24.0-255,2902,64692,9,273612
2479,0.001819,172.31.36.0-255,66,64758,9,273612
2480,0.001839,172.31.36.0-255,66,64824,9,273612
2481,0.001866,74.125.24.0-255,1484,66308,9,273612
2482,0.00188,172.31.36.0-255,66,66374,9,273612
2483,0.001883,74.125.24.0-255,766,67140,9,273612
2484,0.002124,74.125.24.0-255,1484,68624,9,273612
2485,0.002131,172.31.36.0-255,66,68690,9,273612
2486,0.002139,74.125.24.0-255,2902,71592,9,273612
2487,0.002142,172.31.36.0-255,66,71658,9,273612
2488,0.002152,74.125.24.0-255,5738,77396,9,273612
2489,0.002155,172.31.36.0-255,66,77462,9,273612
2490,0.002161,74.125.24.0-255,4320,81782,9,273612
2491,0.002164,172.31.36.0-255,66,81848,9,273612
2492,0.00219,74.125.24.0-255,1484,83332,9,273612
2493,0.002198,74.125.24.0-255,7156,90488,9,273612
2494,0.002201,172.31.36.0-255,66,90554,9,273612
2495,0.002208,74.125.24.0-255,4320,94874,9,273612
2496,0.002211,172.31.36.0-255,66,94940,9,273612
2497,0.002249,74.125.24.0-255,6438,101378,9,273612
2498,0.002252,172.31.36.0-255,66,101444,9,273612
2499,0.002275,74.125.24.0-255,1484,102928,9,273612
2500,0.00228,74.125.24.0-255,2902,105830,9,273612
2501,0.002282,172.31.36.0-255,66,105896,9,273612
2502,0.002311,74.125.24.0-255,5738,111634,9,273612
2503,0.002314,172.31.36.0-255,66,111700,9,273612
2504,0.002352,74.125.24.0-255,5738,117438,9,273612
2505,0.002354,172.31.36.0-255,66,117504,9,273612
2506,0.00239,74.125.24.0-255,7156,124660,9,273612
2507,0.002393,172.31.36.0-255,66,124726,9,273612
2508,0.002406,172.31.36.0-255,66,124792,9,273612
2509,0.004723,74.125.24.0-255,5738,130530,9,273612
2510,0.004729,172.31.36.0-255,66,130596,9,273612
2511,0.007047,74.125.24.0-255,5738,136334,9,273612
2512,0.007052,172.31.36.0-255,66,136400,9,273612
2513,0.009351,74.125.24.0-255,2902,139302,9,273612
2514,0.009356,172.31.36.0-255,66,139368,9,273612
2515,0.009388,74.125.24.0-255,2902,142270,9,273612
2516,0.00939,172.31.36.0-255,66,142336,9,273612
2517,0.011672,74.125.24.0-255,2902,145238,9,273612
2518,0.011679,172.31.36.0-255,66,145304,9,273612
2519,0.011707,74.125.24.0-255,2902,148206,9,273612
2520,0.01171,172.31.36.0-255,66,148272,9,273612
2521,0.01401,74.125.24.0-255,2902,151174,9,273612
2522,0.014018,172.31.36.0-255,66,151240,9,273612
2523,0.014048,74.125.24.0-255,2902,154142,9,273612
2524,0.014051,172.31.36.0-255,66,154208,9,273612
2525,0.016307,74.125.24.0-255,2902,157110,9,273612
2526,0.016316,172.31.36.0-255,66,157176,9,273612
2527,0.016352,74.125.24.0-255,2902,160078,9,273612
2528,0.016355,172.31.36.0-255,66,160144,9,273612
2529,0.018632,74.125.24.0-255,2902,163046,9,273612
2530,0.01864,172.31.36.0-255,66,163112,9,273612
2531,0.018669,74.125.24.0-255,2902,166014,9,273612
2532,0.018672,172.31.36.0-255,66,166080,9,273612
2533,0.020964,74.125.24.0-255,2902,168982,9,273612
2534,0.020972,172.31.36.0-255,66,169048,9,273612
2535,0.021007,74.125.24.0-255,2902,171950,9,273612
2536,0.02101,172.31.36.0-255,66,172016,9,273612
2537,0.023292,74.125.24.0-255,2902,174918,9,273612
2538,0.023302,172.31.36.0-255,66,174984,9,273612
2539,0.023333,74.125.24.0-255,2902,177886,9,273612
2540,0.023336,172.31.36.0-255,66,177952,9,273612
2541,0.025618,74.125.24.0-255,2902,180854,9,273612
2542,0.025626,172.31.36.0-255,66,180920,9,273612
2543,0.02566,74.125.24.0-255,2902,183822,9,273612
2544,0.025663,172.31.36.0-255,66,183888,9,273612
2545,0.027946,74.125.24.0-255,2902,186790,9,273612
2546,0.027955,172.31.36.0-255,66,186856,9,273612
2547,0.027988,74.125.24.0-255,2902,189758,9,273612
2548,0.027991,172.31.36.0-255,66,189824,9,273612
2549,0.030282,74.125.24.0-255,2902,192726,9,273612
2550,0.03029,172.31.36.0-255,66,192792,9,273612
2551,0.030322,74.125.24.0-255,2902,195694,9,273612
2552,0.030325,172.31.36.0-255,66,195760,9,273612
2553,0.032594,74.125.24.0-255,2902,198662,9,273612
2554,0.032603,172.31.36.0-255,66,198728,9,273612
2555,0.032631,74.125.24.0-255,2902,201630,9,273612
2556,0.032634,172.31.36.0-255,66,201696,9,273612
2557,0.03492,74.125.24.0-255,2902,204598,9,273612
2558,0.03493,172.31.36.0-255,66,204664,9,273612
2559,0.03496,74.125.24.0-255,2902,207566,9,273612
2560,0.034964,172.31.36.0-255,66,207632,9,273612
2561,0.036674,172.31.36.0-255,172,207804,9,273612
2562,0.036704,172.31.36.0-255,1112,208916,9,273612
2563,0.036778,172.31.36.0-255,1514,210430,9,273612
2564,0.03678,172.31.36.0-255,1514,211944,9,273612
2565,0.036781,172.31.36.0-255,1514,213458,9,273612
2566,0.036782,172.31.36.0-255,1514,214972,9,273612
2567,0.036813,172.31.36.0-255,1490,216462,9,273612
2568,0.037221,74.125.24.0-255,2902,219364,9,273612
2569,0.037229,172.31.36.0-255,66,219430,9,273612
2570,0.037289,74.125.24.0-255,2902,222332,9,273612
2571,0.037293,172.31.36.0-255,66,222398,9,273612
2572,0.038208,104.244.42.0-255,66,222464,9,273612
2573,0.038306,104.244.42.0-255,66,222530,9,273612
2574,0.038349,104.244.42.0-255,66,222596,9,273612
2575,0.039531,74.125.24.0-255,2902,225498,9,273612
2576,0.03954,172.31.36.0-255,66,225564,9,273612
2577,0.03957,74.125.24.0-255,2902,228466,9,273612
2578,0.039574,172.31.36.0-255,66,228532,9,273612
2579,0.041867,74.125.24.0-255,5738,234270,9,273612
2580,0.041874,172.31.36.0-255,66,234336,9,273612
2581,0.044216,74.125.24.0-255,5738,240074,9,273612
2582,0.044225,172.31.36.0-255,66,240140,9,273612
2583,0.046559,74.125.24.0-255,5738,245878,9,273612
2584,0.046569,172.31.36.0-255,66,245944,9,273612
2585,0.048919,74.125.24.0-255,5738,251682,9,273612
2586,0.048926,172.31.36.0-255,66,251748,9,273612
2587,0.05126,74.125.24.0-255,5738,257486,9,273612
2588,0.051268,172.31.36.0-255,66,257552,9,273612
2589,0.053593,74.125.24.0-255,5738,263290,9,273612
2590,0.053617,172.31.36.0-255,66,263356,9,273612
2591,0.055951,74.125.24.0-255,4320,267676,9,273612
2592,0.055959,172.31.36.0-255,66,267742,9,273612
2593,0.055985,74.125.24.0-255,1484,269226,9,273612
2594,0.058267,74.125.24.0-255,4320,273546,9,273612
2595,0.058274,172.31.36.0-255,66,273612,9,273612
2596,0.0,74.125.24.0-255,153,153,9,240363
2597,2.9e-05,172.31.36.0-255,66,219,9,240363
2598,3.6e-05,74.125.24.0-255,1484,1703,9,240363
2599,4.1e-05,172.31.36.0-255,66,1769,9,240363
2600,4.7e-05,74.125.24.0-255,2902,4671,9,240363
2601,5e-05,172.31.36.0-255,66,4737,9,240363
2602,5.8e-05,74.125.24.0-255,7156,11893,9,240363
2603,6.1e-05,172.31.36.0-255,66,11959,9,240363
2604,6.6e-05,74.125.24.0-255,3468,15427,9,240363
2605,6.9e-05,172.31.36.0-255,66,15493,9,240363
2606,7.6e-05,74.125.24.0-255,5738,21231,9,240363
2607,7.9e-05,172.31.36.0-255,66,21297,9,240363
2608,0.000108,74.125.24.0-255,7156,28453,9,240363
2609,0.000111,172.31.36.0-255,66,28519,9,240363
2610,0.000115,74.125.24.0-255,2543,31062,9,240363
2611,0.000117,172.31.36.0-255,66,31128,9,240363
2612,0.000187,74.125.24.0-255,1484,32612,9,240363
2613,0.000191,172.31.36.0-255,66,32678,9,240363
2614,0.000207,74.125.24.0-255,2902,35580,9,240363
2615,0.000209,172.31.36.0-255,66,35646,9,240363
2616,0.000229,74.125.24.0-255,5738,41384,9,240363
2617,0.000231,172.31.36.0-255,66,41450,9,240363
2618,0.000259,74.125.24.0-255,5738,47188,9,240363
2619,0.000261,172.31.36.0-255,66,47254,9,240363
2620,0.000284,74.125.24.0-255,3961,51215,9,240363
2621,0.000287,172.31.36.0-255,66,51281,9,240363
2622,0.000299,172.31.36.0-255,66,51347,9,240363
2623,0.000302,74.125.24.0-255,1484,52831,9,240363
2624,0.000304,172.31.36.0-255,66,52897,9,240363
2625,0.000331,74.125.24.0-255,2817,55714,9,240363
2626,0.000333,172.31.36.0-255,66,55780,9,240363
2627,0.000336,74.125.24.0-255,381,56161,9,240363
2628,0.000408,74.125.24.0-255,1484,57645,9,240363
2629,0.000411,172.31.36.0-255,66,57711,9,240363
2630,0.000416,74.125.24.0-255,2902,60613,9,240363
2631,0.000418,172.31.36.0-255,66,60679,9,240363
2632,0.000443,74.125.24.0-255,5738,66417,9,240363
2633,0.000446,172.31.36.0-255,66,66483,9,240363
2634,0.000474,74.125.24.0-255,4320,70803,9,240363
2635,0.000477,172.31.36.0-255,66,70869,9,240363
2636,0.000503,74.125.24.0-255,5379,76248,9,240363
2637,0.000506,172.31.36.0-255,66,76314,9,240363
2638,0.000518,172.31.36.0-255,66,76380,9,240363
2639,0.000538,74.125.24.0-255,3412,79792,9,240363
2640,0.000541,172.31.36.0-255,66,79858,9,240363
2641,0.000719,74.125.24.0-255,1484,81342,9,240363
2642,0.000764,74.125.24.0-255,1484,82826,9,240363
2643,0.000768,172.31.36.0-255,66,82892,9,240363
2644,0.000774,74.125.24.0-255,2902,85794,9,240363
2645,0.000777,172.31.36.0-255,66,85860,9,240363
2646,0.000832,74.125.24.0-255,4320,90180,9,240363
2647,0.000836,172.31.36.0-255,66,90246,9,240363
2648,0.000855,74.125.24.0-255,1484,91730,9,240363
2649,0.000858,74.125.24.0-255,1484,93214,9,240363
2650,0.000861,172.31.36.0-255,66,93280,9,240363
2651,0.000866,74.125.24.0-255,2902,96182,9,240363
2652,0.000867,172.31.36.0-255,66,96248,9,240363
2653,0.000872,74.125.24.0-255,2902,99150,9,240363
2654,0.000874,172.31.36.0-255,66,99216,9,240363
2655,0.000879,74.125.24.0-255,4320,103536,9,240363
2656,0.000882,172.31.36.0-255,66,103602,9,240363
2657,0.000885,74.125.24.0-255,1484,105086,9,240363
2658,0.000908,74.125.24.0-255,7156,112242,9,240363
2659,0.00091,172.31.36.0-255,66,112308,9,240363
2660,0.000914,74.125.24.0-255,2184,114492,9,240363
2661,0.000916,172.31.36.0-255,66,114558,9,240363
2662,0.001254,74.125.24.0-255,1484,116042,9,240363
2663,0.001272,74.125.24.0-255,2902,118944,9,240363
2664,0.001276,172.31.36.0-255,66,119010,9,240363
2665,0.001282,74.125.24.0-255,4320,123330,9,240363
2666,0.001284,172.31.36.0-255,66,123396,9,240363
2667,0.001305,74.125.24.0-255,1484,124880,9,240363
2668,0.00132,172.31.36.0-255,66,124946,9,240363
2669,0.001323,74.125.24.0-255,1484,126430,9,240363
2670,0.001359,172.31.36.0-255,66,126496,9,240363
2671,0.001733,74.125.24.0-255,1484,127980,9,240363
2672,0.001738,74.125.24.0-255,2902,130882,9,240363
2673,0.001744,172.31.36.0-255,66,130948,9,240363
2674,0.001757,74.125.24.0-255,2902,133850,9,240363
2675,0.00176,172.31.36.0-255,66,133916,9,240363
2676,0.001787,74.125.24.0-255,2902,136818,9,240363
2677,0.00179,172.31.36.0-255,66,136884,9,240363
2678,0.001797,74.125.24.0-255,7156,144040,9,240363
2679,0.001799,172.31.36.0-255,66,144106,9,240363
2680,0.001815,74.125.24.0-255,5738,149844,9,240363
2681,0.001818,172.31.36.0-255,66,149910,9,240363
2682,0.001841,74.125.24.0-255,2902,152812,9,240363
2683,0.001843,172.31.36.0-255,66,152878,9,240363
2684,0.001872,172.31.36.0-255,66,152944,9,240363
2685,0.002092,74.125.24.0-255,1484,154428,9,240363
2686,0.002098,74.125.24.0-255,2902,157330,9,240363
2687,0.002101,172.31.36.0-255,66,157396,9,240363
2688,0.002106,74.125.24.0-255,1484,158880,9,240363
2689,0.002122,74.125.24.0-255,4320,163200,9,240363
2690,0.002125,172.31.36.0-255,66,163266,9,240363
2691,0.002137,74.125.24.0-255,1484,164750,9,240363
2692,0.002159,74.125.24.0-255,7156,171906,9,240363
2693,0.002162,172.31.36.0-255,66,171972,9,240363
2694,0.002198,74.125.24.0-255,2902,174874,9,240363
2695,0.0022,172.31.36.0-255,66,174940,9,240363
2696,0.002227,74.125.24.0-255,4320,179260,9,240363
2697,0.002238,172.31.36.0-255,66,179326,9,240363
2698,0.002246,172.31.36.0-255,66,179392,9,240363
2699,0.00225,74.125.24.0-255,1484,180876,9,240363
2700,0.00227,74.125.24.0-255,7156,188032,9,240363
2701,0.002274,172.31.36.0-255,66,188098,9,240363
2702,0.002317,172.31.36.0-255,66,188164,9,240363
2703,0.002338,74.125.24.0-255,5738,193902,9,240363
2704,0.002341,172.31.36.0-255,66,193968,9,240363
2705,0.002364,172.31.36.0-255,66,194034,9,240363
2706,0.002372,74.125.24.0-255,7156,201190,9,240363
2707,0.002375,172.31.36.0-255,66,201256,9,240363
2708,0.002392,74.125.24.0-255,2902,204158,9,240363
2709,0.002394,172.31.36.0-255,66,204224,9,240363
2710,0.002398,74.125.24.0-255,2902,207126,9,240363
2711,0.0024,172.31.36.0-255,66,207192,9,240363
2712,0.002436,172.31.36.0-255,66,207258,9,240363
2713,0.002496,172.31.36.0-255,66,207324,9,240363
2714,0.0025,74.125.24.0-255,2902,210226,9,240363
2715,0.002502,172.31.36.0-255,66,210292,9,240363
2716,0.002532,172.31.36.0-255,66,210358,9,240363
2717,0.002552,74.125.24.0-255,7156,217514,9,240363
2718,0.002555,172.31.36.0-255,66,217580,9,240363
2719,0.00259,172.31.36.0-255,66,217646,9,240363
2720,0.002596,74.125.24.0-255,5738,223384,9,240363
2721,0.002599,172.31.36.0-255,66,223450,9,240363
2722,0.002624,172.31.36.0-255,66,223516,9,240363
2723,0.002636,172.31.36.0-255,66,223582,9,240363
2724,0.002661,74.125.24.0-255,4320,227902,9,240363
2725,0.002664,172.31.36.0-255,66,227968,9,240363
2726,0.002676,172.31.36.0-255,66,228034,9,240363
2727,0.002679,74.125.24.0-255,1484,229518,9,240363
2728,0.00269,172.31.36.0-255,66,229584,9,240363
2729,0.002711,74.125.24.0-255,5020,234604,9,240363
2730,0.002714,172.31.36.0-255,66,234670,9,240363
2731,0.002718,74.125.24.0-255,3141,237811,9,240363
2732,0.002721,172.31.36.0-255,66,237877,9,240363
2733,0.002725,74.125.24.0-255,97,237974,9,240363
2734,0.002777,74.125.24.0-255,105,238079,9,240363
2735,0.01045,172.31.36.0-255,66,238145,9,240363
2736,0.010491,172.31.36.0-255,105,238250,9,240363
2737,0.013002,74.125.24.0-255,66,238316,9,240363
2738,0.041422,172.31.36.0-255,172,238488,9,240363
2739,0.041458,172.31.36.0-255,1112,239600,9,240363
2740,0.041512,172.31.36.0-255,565,240165,9,240363
2741,0.043001,104.244.42.0-255,66,240231,9,240363
2742,0.043013,104.244.42.0-255,66,240297,9,240363
2743,0.043015,104.244.42.0-255,66,240363,9,240363
2744,0.0,172.217.194.0-255,153,153,9,214782
2745,1.4e-05,172.217.194.0-255,1484,1637,9,214782
2746,2.1e-05,172.31.36.0-255,66,1703,9,214782
2747,3.2e-05,172.217.194.0-255,2902,4605,9,214782
2748,3.6e-05,172.31.36.0-255,66,4671,9,214782
2749,5e-05,172.217.194.0-255,4320,8991,9,214782
2750,5.4e-05,172.31.36.0-255,66,9057,9,214782
2751,6.1e-05,172.217.194.0-255,4866,13923,9,214782
2752,6.4e-05,172.31.36.0-255,66,13989,9,214782
2753,0.00012,172.217.194.0-255,1484,15473,9,214782
2754,0.000123,172.217.194.0-255,1484,16957,9,214782
2755,0.000126,172.31.36.0-255,66,17023,9,214782
2756,0.000151,172.217.194.0-255,1484,18507,9,214782
2757,0.000158,172.217.194.0-255,5738,24245,9,214782
2758,0.000161,172.31.36.0-255,66,24311,9,214782
2759,0.000169,172.217.194.0-255,6797,31108,9,214782
2760,0.000172,172.31.36.0-255,66,31174,9,214782
2761,0.000223,172.217.194.0-255,1484,32658,9,214782
2762,0.000264,172.217.194.0-255,2902,35560,9,214782
2763,0.000266,172.31.36.0-255,66,35626,9,214782
2764,0.000273,172.217.194.0-255,5738,41364,9,214782
2765,0.000276,172.31.36.0-255,66,41430,9,214782
2766,0.000305,172.217.194.0-255,2902,44332,9,214782
2767,0.000308,172.31.36.0-255,66,44398,9,214782
2768,0.000343,172.31.36.0-255,66,44464,9,214782
2769,0.00036,172.31.36.0-255,66,44530,9,214782
2770,0.000363,172.217.194.0-255,1125,45655,9,214782
2771,0.000772,172.217.194.0-255,645,46300,9,214782
2772,0.000778,172.31.36.0-255,66,46366,9,214782
2773,0.001184,172.217.194.0-255,1484,47850,9,214782
2774,0.001193,172.217.194.0-255,2902,50752,9,214782
2775,0.001198,172.31.36.0-255,66,50818,9,214782
2776,0.001205,172.217.194.0-255,5738,56556,9,214782
2777,0.001207,172.31.36.0-255,66,56622,9,214782
2778,0.001217,172.217.194.0-255,2902,59524,9,214782
2779,0.00122,172.31.36.0-255,66,59590,9,214782
2780,0.001252,172.217.194.0-255,5738,65328,9,214782
2781,0.001254,172.31.36.0-255,66,65394,9,214782
2782,0.001284,172.217.194.0-255,5738,71132,9,214782
2783,0.001286,172.31.36.0-255,66,71198,9,214782
2784,0.001326,172.31.36.0-255,66,71264,9,214782
2785,0.001453,172.217.194.0-255,1484,72748,9,214782
2786,0.00146,172.217.194.0-255,2902,75650,9,214782
2787,0.001464,172.31.36.0-255,66,75716,9,214782
2788,0.00151,172.217.194.0-255,5738,81454,9,214782
2789,0.001513,172.31.36.0-255,66,81520,9,214782
2790,0.001527,172.31.36.0-255,66,81586,9,214782
2791,0.001544,172.31.36.0-255,66,81652,9,214782
2792,0.001568,172.217.194.0-255,766,82418,9,214782
2793,0.002329,172.217.194.0-255,1484,83902,9,214782
2794,0.002336,172.31.36.0-255,66,83968,9,214782
2795,0.002343,172.217.194.0-255,2902,86870,9,214782
2796,0.002347,172.31.36.0-255,66,86936,9,214782
2797,0.002359,172.217.194.0-255,5738,92674,9,214782
2798,0.002362,172.31.36.0-255,66,92740,9,214782
2799,0.002369,172.217.194.0-255,7156,99896,9,214782
2800,0.002373,172.31.36.0-255,66,99962,9,214782
2801,0.002378,172.217.194.0-255,4320,104282,9,214782
2802,0.002381,172.31.36.0-255,66,104348,9,214782
2803,0.002427,172.31.36.0-255,66,104414,9,214782
2804,0.002431,172.217.194.0-255,2184,106598,9,214782
2805,0.002433,172.31.36.0-255,66,106664,9,214782
2806,0.002614,172.217.194.0-255,1484,108148,9,214782
2807,0.002638,172.217.194.0-255,2902,111050,9,214782
2808,0.002641,172.31.36.0-255,66,111116,9,214782
2809,0.002668,172.217.194.0-255,4320,115436,9,214782
2810,0.002671,172.31.36.0-255,66,115502,9,214782
2811,0.002677,172.217.194.0-255,5738,121240,9,214782
2812,0.00268,172.31.36.0-255,66,121306,9,214782
2813,0.00271,172.217.194.0-255,2902,124208,9,214782
2814,0.002712,172.31.36.0-255,66,124274,9,214782
2815,0.002718,172.217.194.0-255,4320,128594,9,214782
2816,0.002721,172.31.36.0-255,66,128660,9,214782
2817,0.002728,172.217.194.0-255,1484,130144,9,214782
2818,0.002733,172.217.194.0-255,2902,133046,9,214782
2819,0.002735,172.31.36.0-255,66,133112,9,214782
2820,0.002741,172.217.194.0-255,5738,138850,9,214782
2821,0.002744,172.31.36.0-255,66,138916,9,214782
2822,0.002748,172.217.194.0-255,2184,141100,9,214782
2823,0.002751,172.31.36.0-255,66,141166,9,214782
2824,0.003196,172.217.194.0-255,1484,142650,9,214782
2825,0.003218,172.217.194.0-255,2902,145552,9,214782
2826,0.003221,172.31.36.0-255,66,145618,9,214782
2827,0.003225,172.217.194.0-255,2902,148520,9,214782
2828,0.003228,172.31.36.0-255,66,148586,9,214782
2829,0.003257,172.217.194.0-255,2902,151488,9,214782
2830,0.00326,172.31.36.0-255,66,151554,9,214782
2831,0.003311,172.31.36.0-255,66,151620,9,214782
2832,0.003342,172.217.194.0-255,2902,154522,9,214782
2833,0.003345,172.31.36.0-255,66,154588,9,214782
2834,0.003363,172.31.36.0-255,66,154654,9,214782
2835,0.003391,172.31.36.0-255,66,154720,9,214782
2836,0.003394,172.217.194.0-255,1484,156204,9,214782
2837,0.003401,172.217.194.0-255,6438,162642,9,214782
2838,0.003404,172.31.36.0-255,66,162708,9,214782
2839,0.003459,172.217.194.0-255,1484,164192,9,214782
2840,0.003477,172.217.194.0-255,2902,167094,9,214782
2841,0.00348,172.31.36.0-255,66,167160,9,214782
2842,0.003524,172.217.194.0-255,5738,172898,9,214782
2843,0.003527,172.31.36.0-255,66,172964,9,214782
2844,0.00355,172.31.36.0-255,66,173030,9,214782
2845,0.003583,172.217.194.0-255,1484,174514,9,214782
2846,0.003611,172.31.36.0-255,66,174580,9,214782
2847,0.00366,172.217.194.0-255,1484,176064,9,214782
2848,0.003665,172.217.194.0-255,2902,178966,9,214782
2849,0.003669,172.31.36.0-255,66,179032,9,214782
2850,0.003674,172.217.194.0-255,2902,181934,9,214782
2851,0.003676,172.31.36.0-255,66,182000,9,214782
2852,0.003709,172.217.194.0-255,2902,184902,9,214782
2853,0.003712,172.31.36.0-255,66,184968,9,214782
2854,0.003726,172.31.36.0-255,66,185034,9,214782
2855,0.003744,172.31.36.0-255,66,185100,9,214782
2856,0.003748,172.217.194.0-255,2902,188002,9,214782
2857,0.003751,172.31.36.0-255,66,188068,9,214782
2858,0.003801,172.31.36.0-255,66,188134,9,214782
2859,0.003809,172.217.194.0-255,7156,195290,9,214782
2860,0.003811,172.31.36.0-255,66,195356,9,214782
2861,0.00387,172.31.36.0-255,66,195422,9,214782
2862,0.003881,172.31.36.0-255,66,195488,9,214782
2863,0.003918,172.217.194.0-255,7156,202644,9,214782
2864,0.003921,172.31.36.0-255,66,202710,9,214782
2865,0.003924,172.217.194.0-255,1484,204194,9,214782
2866,0.003929,172.217.194.0-255,4320,208514,9,214782
2867,0.003931,172.31.36.0-255,66,208580,9,214782
2868,0.00397,172.31.36.0-255,66,208646,9,214782
2869,0.003973,172.217.194.0-255,1484,210130,9,214782
2870,0.003979,172.217.194.0-255,4143,214273,9,214782
2871,0.003981,172.31.36.0-255,66,214339,9,214782
2872,0.004047,172.217.194.0-255,105,214444,9,214782
2873,0.012001,172.31.36.0-255,101,214545,9,214782
2874,0.012392,172.31.36.0-255,105,214650,9,214782
2875,0.014371,172.217.194.0-255,66,214716,9,214782
2876,0.014859,172.217.194.0-255,66,214782,9,214782
2877,0.0,172.217.27.0-255,298,298,9,286329
2878,1.7e-05,172.31.36.0-255,66,364,9,286329
2879,2.2e-05,172.217.27.0-255,1484,1848,9,286329
2880,2.6e-05,172.31.36.0-255,66,1914,9,286329
2881,3.4e-05,172.217.27.0-255,4320,6234,9,286329
2882,4.5e-05,172.31.36.0-255,66,6300,9,286329
2883,5e-05,172.217.27.0-255,2902,9202,9,286329
2884,5.3e-05,172.31.36.0-255,66,9268,9,286329
2885,7.8e-05,172.217.27.0-255,6069,15337,9,286329
2886,8.1e-05,172.31.36.0-255,66,15403,9,286329
2887,9.3e-05,172.217.27.0-255,7156,22559,9,286329
2888,9.6e-05,172.31.36.0-255,66,22625,9,286329
2889,0.000107,172.31.36.0-255,66,22691,9,286329
2890,0.000149,172.217.27.0-255,1484,24175,9,286329
2891,0.000152,172.31.36.0-255,66,24241,9,286329
2892,0.000157,172.217.27.0-255,2902,27143,9,286329
2893,0.000159,172.31.36.0-255,66,27209,9,286329
2894,0.000164,172.217.27.0-255,4320,31529,9,286329
2895,0.000173,172.31.36.0-255,66,31595,9,286329
2896,0.000179,172.217.27.0-255,5738,37333,9,286329
2897,0.000182,172.31.36.0-255,66,37399,9,286329
2898,0.000211,172.217.27.0-255,2543,39942,9,286329
2899,0.000213,172.31.36.0-255,66,40008,9,286329
2900,0.000266,172.217.27.0-255,1484,41492,9,286329
2901,0.00027,172.31.36.0-255,66,41558,9,286329
2902,0.000275,172.217.27.0-255,2902,44460,9,286329
2903,0.000277,172.31.36.0-255,66,44526,9,286329
2904,0.000309,172.217.27.0-255,5738,50264,9,286329
2905,0.000312,172.31.36.0-255,66,50330,9,286329
2906,0.000341,172.217.27.0-255,6797,57127,9,286329
2907,0.000344,172.31.36.0-255,66,57193,9,286329
2908,0.001248,172.217.27.0-255,645,57838,9,286329
2909,0.001613,172.217.27.0-255,1484,59322,9,286329
2910,0.001622,172.31.36.0-255,66,59388,9,286329
2911,0.00163,172.217.27.0-255,2902,62290,9,286329
2912,0.001633,172.31.36.0-255,66,62356,9,286329
2913,0.001645,172.217.27.0-255,5738,68094,9,286329
2914,0.001647,172.31.36.0-255,66,68160,9,286329
2915,0.001653,172.217.27.0-255,4320,72480,9,286329
2916,0.001655,172.31.36.0-255,66,72546,9,286329
2917,0.001662,172.217.27.0-255,5738,78284,9,286329
2918,0.001665,172.31.36.0-255,66,78350,9,286329
2919,0.001668,172.217.27.0-255,1484,79834,9,286329
2920,0.001714,172.31.36.0-255,66,79900,9,286329
2921,0.001717,172.217.27.0-255,1484,81384,9,286329
2922,0.003368,172.217.27.0-255,4320,85704,9,286329
2923,0.003376,172.31.36.0-255,66,85770,9,286329
2924,0.005046,172.217.27.0-255,5738,91508,9,286329
2925,0.005053,172.31.36.0-255,66,91574,9,286329
2926,0.006712,172.217.27.0-255,5738,97312,9,286329
2927,0.006719,172.31.36.0-255,66,97378,9,286329
2928,0.008382,172.217.27.0-255,5738,103116,9,286329
2929,0.008387,172.31.36.0-255,66,103182,9,286329
2930,0.010053,172.217.27.0-255,5738,108920,9,286329
2931,0.010061,172.31.36.0-255,66,108986,9,286329
2932,0.011733,172.217.27.0-255,5738,114724,9,286329
2933,0.011745,172.31.36.0-255,66,114790,9,286329
2934,0.013418,172.217.27.0-255,5738,120528,9,286329
2935,0.013431,172.31.36.0-255,66,120594,9,286329
2936,0.015171,172.217.27.0-255,5738,126332,9,286329
2937,0.015186,172.31.36.0-255,66,126398,9,286329
2938,0.016866,172.217.27.0-255,5738,132136,9,286329
2939,0.016881,172.31.36.0-255,66,132202,9,286329
2940,0.018553,172.217.27.0-255,5738,137940,9,286329
2941,0.018567,172.31.36.0-255,66,138006,9,286329
2942,0.020239,172.217.27.0-255,5738,143744,9,286329
2943,0.020247,172.31.36.0-255,66,143810,9,286329
2944,0.021906,172.217.27.0-255,5738,149548,9,286329
2945,0.021914,172.31.36.0-255,66,149614,9,286329
2946,0.023583,172.217.27.0-255,5738,155352,9,286329
2947,0.02359,172.31.36.0-255,66,155418,9,286329
2948,0.025264,172.217.27.0-255,5738,161156,9,286329
2949,0.025273,172.31.36.0-255,66,161222,9,286329
2950,0.026936,172.217.27.0-255,5738,166960,9,286329
2951,0.026944,172.31.36.0-255,66,167026,9,286329
2952,0.028626,172.217.27.0-255,5738,172764,9,286329
2953,0.028634,172.31.36.0-255,66,172830,9,286329
2954,0.030294,172.217.27.0-255,5738,178568,9,286329
2955,0.030305,172.31.36.0-255,66,178634,9,286329
2956,0.031974,172.217.27.0-255,5738,184372,9,286329
2957,0.03198,172.31.36.0-255,66,184438,9,286329
2958,0.032924,172.31.36.0-255,172,184610,9,286329
2959,0.032956,172.31.36.0-255,1112,185722,9,286329
2960,0.03302,172.31.36.0-255,1514,187236,9,286329
2961,0.033023,172.31.36.0-255,1514,188750,9,286329
2962,0.033029,172.31.36.0-255,1514,190264,9,286329
2963,0.03303,172.31.36.0-255,1514,191778,9,286329
2964,0.033048,172.31.36.0-255,1489,193267,9,286329
2965,0.033651,172.217.27.0-255,5738,199005,9,286329
2966,0.033659,172.31.36.0-255,66,199071,9,286329
2967,0.034463,104.244.42.0-255,66,199137,9,286329
2968,0.034508,104.244.42.0-255,66,199203,9,286329
2969,0.034649,104.244.42.0-255,66,199269,9,286329
2970,0.035332,172.217.27.0-255,5738,205007,9,286329
2971,0.035339,172.31.36.0-255,66,205073,9,286329
2972,0.037013,172.217.27.0-255,5738,210811,9,286329
2973,0.03702,172.31.36.0-255,66,210877,9,286329
2974,0.038687,172.217.27.0-255,5738,216615,9,286329
2975,0.038696,172.31.36.0-255,66,216681,9,286329
2976,0.040367,172.217.27.0-255,5738,222419,9,286329
2977,0.040373,172.31.36.0-255,66,222485,9,286329
2978,0.042046,172.217.27.0-255,5738,228223,9,286329
2979,0.042053,172.31.36.0-255,66,228289,9,286329
2980,0.043727,172.217.27.0-255,5738,234027,9,286329
2981,0.043733,172.31.36.0-255,66,234093,9,286329
2982,0.045407,172.217.27.0-255,5738,239831,9,286329
2983,0.045414,172.31.36.0-255,66,239897,9,286329
2984,0.047089,172.217.27.0-255,5738,245635,9,286329
2985,0.047096,172.31.36.0-255,66,245701,9,286329
2986,0.048768,172.217.27.0-255,5738,251439,9,286329
2987,0.048776,172.31.36.0-255,66,251505,9,286329
2988,0.050441,172.217.27.0-255,5738,257243,9,286329
2989,0.050449,172.31.36.0-255,66,257309,9,286329
2990,0.05212,172.217.27.0-255,5738,263047,9,286329
2991,0.052127,172.31.36.0-255,66,263113,9,286329
2992,0.053812,172.217.27.0-255,5738,268851,9,286329
2993,0.053819,172.31.36.0-255,66,268917,9,286329
2994,0.055487,172.217.27.0-255,5738,274655,9,286329
2995,0.055495,172.31.36.0-255,66,274721,9,286329
2996,0.057165,172.217.27.0-255,5738,280459,9,286329
2997,0.057172,172.31.36.0-255,66,280525,9,286329
2998,0.058836,172.217.27.0-255,5738,286263,9,286329
2999,0.058843,172.31.36.0-255,66,286329,9,286329
3000,0.0,74.125.130.0-255,150,150,9,372651
3001,3e-05,172.31.36.0-255,66,216,9,372651
3002,5.2e-05,74.125.130.0-255,1484,1700,9,372651
3003,5.7e-05,172.31.36.0-255,66,1766,9,372651
3004,6.1e-05,74.125.130.0-255,1484,3250,9,372651
3005,6.4e-05,172.31.36.0-255,66,3316,9,372651
3006,8.9e-05,74.125.130.0-255,2902,6218,9,372651
3007,9.2e-05,172.31.36.0-255,66,6284,9,372651
3008,0.000109,74.125.130.0-255,4320,10604,9,372651
3009,0.000113,172.31.36.0-255,66,10670,9,372651
3010,0.000128,74.125.130.0-255,1484,12154,9,372651
3011,0.000131,172.31.36.0-255,66,12220,9,372651
3012,0.000165,74.125.130.0-255,2048,14268,9,372651
3013,0.000168,172.31.36.0-255,66,14334,9,372651
3014,0.000237,74.125.130.0-255,1484,15818,9,372651
3015,0.000241,172.31.36.0-255,66,15884,9,372651
3016,0.000254,74.125.130.0-255,1484,17368,9,372651
3017,0.000256,172.31.36.0-255,66,17434,9,372651
3018,0.000273,74.125.130.0-255,2902,20336,9,372651
3019,0.000276,172.31.36.0-255,66,20402,9,372651
3020,0.000298,74.125.130.0-255,4320,24722,9,372651
3021,0.000301,172.31.36.0-255,66,24788,9,372651
3022,0.000316,74.125.130.0-255,1484,26272,9,372651
3023,0.000319,172.31.36.0-255,66,26338,9,372651
3024,0.000324,74.125.130.0-255,2902,29240,9,372651
3025,0.000326,172.31.36.0-255,66,29306,9,372651
3026,0.000361,74.125.130.0-255,2543,31849,9,372651
3027,0.000365,172.31.36.0-255,66,31915,9,372651
3028,0.000494,74.125.130.0-255,1484,33399,9,372651
3029,0.000501,172.31.36.0-255,66,33465,9,372651
3030,0.000514,74.125.130.0-255,2902,36367,9,372651
3031,0.000517,172.31.36.0-255,66,36433,9,372651
3032,0.000536,74.125.130.0-255,4320,40753,9,372651
3033,0.000538,172.31.36.0-255,66,40819,9,372651
3034,0.000557,74.125.130.0-255,1484,42303,9,372651
3035,0.000564,74.125.130.0-255,4320,46623,9,372651
3036,0.000567,172.31.36.0-255,66,46689,9,372651
3037,0.000583,74.125.130.0-255,2543,49232,9,372651
3038,0.000586,172.31.36.0-255,66,49298,9,372651
3039,0.000726,74.125.130.0-255,1484,50782,9,372651
3040,0.000748,74.125.130.0-255,2902,53684,9,372651
3041,0.000752,172.31.36.0-255,66,53750,9,372651
3042,0.000775,74.125.130.0-255,2902,56652,9,372651
3043,0.000778,172.31.36.0-255,66,56718,9,372651
3044,0.000785,74.125.130.0-255,4320,61038,9,372651
3045,0.000786,172.31.36.0-255,66,61104,9,372651
3046,0.000817,74.125.130.0-255,1484,62588,9,372651
3047,0.000836,74.125.130.0-255,5379,67967,9,372651
3048,0.000841,172.31.36.0-255,66,68033,9,372651
3049,0.000843,74.125.130.0-255,5738,73771,9,372651
3050,0.000845,172.31.36.0-255,66,73837,9,372651
3051,0.000856,74.125.130.0-255,1484,75321,9,372651
3052,0.000859,74.125.130.0-255,1484,76805,9,372651
3053,0.000861,172.31.36.0-255,66,76871,9,372651
3054,0.00089,74.125.130.0-255,6797,83668,9,372651
3055,0.000893,172.31.36.0-255,66,83734,9,372651
3056,0.001007,74.125.130.0-255,1484,85218,9,372651
3057,0.001029,74.125.130.0-255,2902,88120,9,372651
3058,0.001033,172.31.36.0-255,66,88186,9,372651
3059,0.001064,74.125.130.0-255,1484,89670,9,372651
3060,0.001075,74.125.130.0-255,2902,92572,9,372651
3061,0.001078,172.31.36.0-255,66,92638,9,372651
3062,0.001096,74.125.130.0-255,4320,96958,9,372651
3063,0.001099,172.31.36.0-255,66,97024,9,372651
3064,0.001118,74.125.130.0-255,1484,98508,9,372651
3065,0.001123,74.125.130.0-255,4320,102828,9,372651
3066,0.001126,172.31.36.0-255,66,102894,9,372651
3067,0.001143,74.125.130.0-255,1484,104378,9,372651
3068,0.001161,74.125.130.0-255,4320,108698,9,372651
3069,0.001164,172.31.36.0-255,66,108764,9,372651
3070,0.001189,74.125.130.0-255,2902,111666,9,372651
3071,0.001192,172.31.36.0-255,66,111732,9,372651
3072,0.00121,74.125.130.0-255,2902,114634,9,372651
3073,0.001213,172.31.36.0-255,66,114700,9,372651
3074,0.001226,74.125.130.0-255,1484,116184,9,372651
3075,0.001241,74.125.130.0-255,2069,118253,9,372651
3076,0.001243,172.31.36.0-255,66,118319,9,372651
3077,0.00481,74.125.130.0-255,1484,119803,9,372651
3078,0.004831,74.125.130.0-255,1484,121287,9,372651
3079,0.004841,172.31.36.0-255,66,121353,9,372651
3080,0.004851,74.125.130.0-255,2902,124255,9,372651
3081,0.004855,172.31.36.0-255,66,124321,9,372651
3082,0.004864,74.125.130.0-255,5738,130059,9,372651
3083,0.004868,172.31.36.0-255,66,130125,9,372651
3084,0.004873,74.125.130.0-255,2902,133027,9,372651
3085,0.004875,172.31.36.0-255,66,133093,9,372651
3086,0.004881,74.125.130.0-255,4320,137413,9,372651
3087,0.004884,172.31.36.0-255,66,137479,9,372651
3088,0.004914,74.125.130.0-255,2902,140381,9,372651
3089,0.004917,172.31.36.0-255,66,140447,9,372651
3090,0.004944,74.125.130.0-255,5738,146185,9,372651
3091,0.004948,172.31.36.0-255,66,146251,9,372651
3092,0.004989,74.125.130.0-255,1484,147735,9,372651
3093,0.00501,74.125.130.0-255,5020,152755,9,372651
3094,0.005013,172.31.36.0-255,66,152821,9,372651
3095,0.005165,74.125.130.0-255,1484,154305,9,372651
3096,0.005187,74.125.130.0-255,2902,157207,9,372651
3097,0.005191,172.31.36.0-255,66,157273,9,372651
3098,0.00521,74.125.130.0-255,5738,163011,9,372651
3099,0.005214,172.31.36.0-255,66,163077,9,372651
3100,0.005245,74.125.130.0-255,7156,170233,9,372651
3101,0.005248,172.31.36.0-255,66,170299,9,372651
3102,0.005272,74.125.130.0-255,5738,176037,9,372651
3103,0.005277,172.31.36.0-255,66,176103,9,372651
3104,0.005283,74.125.130.0-255,4320,180423,9,372651
3105,0.005285,172.31.36.0-255,66,180489,9,372651
3106,0.005301,74.125.130.0-255,2902,183391,9,372651
3107,0.005304,172.31.36.0-255,66,183457,9,372651
3108,0.005308,74.125.130.0-255,2902,186359,9,372651
3109,0.005311,172.31.36.0-255,66,186425,9,372651
3110,0.005322,74.125.130.0-255,766,187191,9,372651
3111,0.005346,74.125.130.0-255,4320,191511,9,372651
3112,0.005349,172.31.36.0-255,66,191577,9,372651
3113,0.005363,74.125.130.0-255,2902,194479,9,372651
3114,0.005365,172.31.36.0-255,66,194545,9,372651
3115,0.005391,74.125.130.0-255,4320,198865,9,372651
3116,0.005394,172.31.36.0-255,66,198931,9,372651
3117,0.005398,74.125.130.0-255,2902,201833,9,372651
3118,0.0054,172.31.36.0-255,66,201899,9,372651
3119,0.00542,74.125.130.0-255,5738,207637,9,372651
3120,0.005423,172.31.36.0-255,66,207703,9,372651
3121,0.005443,74.125.130.0-255,2902,210605,9,372651
3122,0.005445,172.31.36.0-255,66,210671,9,372651
3123,0.005467,74.125.130.0-255,7156,217827,9,372651
3124,0.005469,172.31.36.0-255,66,217893,9,372651
3125,0.005474,74.125.130.0-255,3602,221495,9,372651
3126,0.005476,172.31.36.0-255,66,221561,9,372651
3127,0.005493,74.125.130.0-255,1484,223045,9,372651
3128,0.005504,74.125.130.0-255,2902,225947,9,372651
3129,0.005506,172.31.36.0-255,66,226013,9,372651
3130,0.00551,74.125.130.0-255,1484,227497,9,372651
3131,0.005526,74.125.130.0-255,2902,230399,9,372651
3132,0.005528,172.31.36.0-255,66,230465,9,372651
3133,0.005548,74.125.130.0-255,4320,234785,9,372651
3134,0.00555,172.31.36.0-255,66,234851,9,372651
3135,0.005569,74.125.130.0-255,1484,236335,9,372651
3136,0.005574,74.125.130.0-255,2902,239237,9,372651
3137,0.005576,172.31.36.0-255,66,239303,9,372651
3138,0.005582,74.125.130.0-255,4320,243623,9,372651
3139,0.005586,172.31.36.0-255,66,243689,9,372651
3140,0.005641,172.31.36.0-255,66,243755,9,372651
3141,0.005668,74.125.130.0-255,1484,245239,9,372651
3142,0.005681,74.125.130.0-255,2184,247423,9,372651
3143,0.005683,172.31.36.0-255,66,247489,9,372651
3144,0.005688,74.125.130.0-255,4320,251809,9,372651
3145,0.005691,172.31.36.0-255,66,251875,9,372651
3146,0.00572,74.125.130.0-255,4320,256195,9,372651
3147,0.005723,172.31.36.0-255,66,256261,9,372651
3148,0.005742,74.125.130.0-255,4320,260581,9,372651
3149,0.005744,172.31.36.0-255,66,260647,9,372651
3150,0.005749,74.125.130.0-255,4320,264967,9,372651
3151,0.005751,172.31.36.0-255,66,265033,9,372651
3152,0.005775,74.125.130.0-255,5738,270771,9,372651
3153,0.005777,172.31.36.0-255,66,270837,9,372651
3154,0.005781,74.125.130.0-255,1484,272321,9,372651
3155,0.005813,74.125.130.0-255,1484,273805,9,372651
3156,0.005816,172.31.36.0-255,66,273871,9,372651
3157,0.005845,172.31.36.0-255,66,273937,9,372651
3158,0.005876,74.125.130.0-255,1484,275421,9,372651
3159,0.00588,172.31.36.0-255,66,275487,9,372651
3160,0.005925,74.125.130.0-255,7156,282643,9,372651
3161,0.005929,172.31.36.0-255,66,282709,9,372651
3162,0.005953,74.125.130.0-255,5738,288447,9,372651
3163,0.005956,172.31.36.0-255,66,288513,9,372651
3164,0.005963,74.125.130.0-255,2902,291415,9,372651
3165,0.005965,172.31.36.0-255,66,291481,9,372651
3166,0.006013,74.125.130.0-255,5738,297219,9,372651
3167,0.006016,172.31.36.0-255,66,297285,9,372651
3168,0.006037,74.125.130.0-255,2184,299469,9,372651
3169,0.00604,172.31.36.0-255,66,299535,9,372651
3170,0.006052,172.31.36.0-255,66,299601,9,372651
3171,0.0061,74.125.130.0-255,4320,303921,9,372651
3172,0.006103,172.31.36.0-255,66,303987,9,372651
3173,0.006129,74.125.130.0-255,5738,309725,9,372651
3174,0.006133,172.31.36.0-255,66,309791,9,372651
3175,0.006147,172.31.36.0-255,66,309857,9,372651
3176,0.006154,74.125.130.0-255,7156,317013,9,372651
3177,0.006157,172.31.36.0-255,66,317079,9,372651
3178,0.00618,74.125.130.0-255,2902,319981,9,372651
3179,0.006183,172.31.36.0-255,66,320047,9,372651
3180,0.006194,172.31.36.0-255,66,320113,9,372651
3181,0.006214,74.125.130.0-255,2902,323015,9,372651
3182,0.006216,172.31.36.0-255,66,323081,9,372651
3183,0.006222,74.125.130.0-255,5738,328819,9,372651
3184,0.006225,172.31.36.0-255,66,328885,9,372651
3185,0.006231,74.125.130.0-255,6438,335323,9,372651
3186,0.006234,172.31.36.0-255,66,335389,9,372651
3187,0.006251,74.125.130.0-255,2902,338291,9,372651
3188,0.006253,172.31.36.0-255,66,338357,9,372651
3189,0.006278,74.125.130.0-255,1484,339841,9,372651
3190,0.006285,74.125.130.0-255,5738,345579,9,372651
3191,0.006289,172.31.36.0-255,66,345645,9,372651
3192,0.006294,74.125.130.0-255,4320,349965,9,372651
3193,0.006296,172.31.36.0-255,66,350031,9,372651
3194,0.006315,74.125.130.0-255,7156,357187,9,372651
3195,0.006318,172.31.36.0-255,66,357253,9,372651
3196,0.006323,74.125.130.0-255,4320,361573,9,372651
3197,0.006325,172.31.36.0-255,66,361639,9,372651
3198,0.006358,74.125.130.0-255,4404,366043,9,372651
3199,0.00637,172.31.36.0-255,66,366109,9,372651
3200,0.006381,74.125.130.0-255,105,366214,9,372651
3201,0.008174,172.31.36.0-255,66,366280,9,372651
3202,0.008202,172.31.36.0-255,105,366385,9,372651
3203,0.010568,74.125.130.0-255,66,366451,9,372651
3204,0.048819,172.31.36.0-255,172,366623,9,372651
3205,0.048848,172.31.36.0-255,1116,367739,9,372651
3206,0.048917,172.31.36.0-255,1514,369253,9,372651
3207,0.048919,172.31.36.0-255,1514,370767,9,372651
3208,0.048921,172.31.36.0-255,1514,372281,9,372651
3209,0.048922,172.31.36.0-255,106,372387,9,372651
3210,0.050475,104.244.42.0-255,66,372453,9,372651
3211,0.050526,104.244.42.0-255,66,372519,9,372651
3212,0.050627,104.244.42.0-255,66,372585,9,372651
3213,0.050629,104.244.42.0-255,66,372651,9,372651
3214,0.0,74.125.24.0-255,146,146,9,225647
3215,3.1e-05,172.31.36.0-255,66,212,9,225647
3216,3.7e-05,74.125.24.0-255,1484,1696,9,225647
3217,4.1e-05,172.31.36.0-255,66,1762,9,225647
3218,4.6e-05,74.125.24.0-255,2902,4664,9,225647
3219,5e-05,172.31.36.0-255,66,4730,9,225647
3220,5.8e-05,74.125.24.0-255,7156,11886,9,225647
3221,6e-05,172.31.36.0-255,66,11952,9,225647
3222,7.6e-05,172.31.36.0-255,66,12018,9,225647
3223,8.3e-05,74.125.24.0-255,5738,17756,9,225647
3224,8.5e-05,172.31.36.0-255,66,17822,9,225647
3225,0.000111,74.125.24.0-255,4320,22142,9,225647
3226,0.000114,172.31.36.0-255,66,22208,9,225647
3227,0.000139,74.125.24.0-255,7156,29364,9,225647
3228,0.000141,172.31.36.0-255,66,29430,9,225647
3229,0.000165,74.125.24.0-255,6438,35868,9,225647
3230,0.000168,172.31.36.0-255,66,35934,9,225647
3231,0.000241,74.125.24.0-255,1484,37418,9,225647
3232,0.000244,172.31.36.0-255,66,37484,9,225647
3233,0.000249,74.125.24.0-255,2902,40386,9,225647
3234,0.000252,172.31.36.0-255,66,40452,9,225647
3235,0.000273,74.125.24.0-255,5738,46190,9,225647
3236,0.000278,172.31.36.0-255,66,46256,9,225647
3237,0.000282,74.125.24.0-255,2902,49158,9,225647
3238,0.000285,172.31.36.0-255,66,49224,9,225647
3239,0.000301,74.125.24.0-255,4229,53453,9,225647
3240,0.000305,172.31.36.0-255,66,53519,9,225647
3241,0.000308,74.125.24.0-255,135,53654,9,225647
3242,0.000311,172.31.36.0-255,66,53720,9,225647
3243,0.000356,74.125.24.0-255,1484,55204,9,225647
3244,0.000359,172.31.36.0-255,66,55270,9,225647
3245,0.000375,74.125.24.0-255,2902,58172,9,225647
3246,0.000378,172.31.36.0-255,66,58238,9,225647
3247,0.000384,74.125.24.0-255,5738,63976,9,225647
3248,0.000387,172.31.36.0-255,66,64042,9,225647
3249,0.000391,74.125.24.0-255,2902,66944,9,225647
3250,0.000393,172.31.36.0-255,66,67010,9,225647
3251,0.000415,74.125.24.0-255,4320,71330,9,225647
3252,0.000419,172.31.36.0-255,66,71396,9,225647
3253,0.000457,172.31.36.0-255,66,71462,9,225647
3254,0.000479,74.125.24.0-255,2902,74364,9,225647
3255,0.000482,172.31.36.0-255,66,74430,9,225647
3256,0.000486,74.125.24.0-255,1887,76317,9,225647
3257,0.000489,172.31.36.0-255,66,76383,9,225647
3258,0.000536,74.125.24.0-255,1484,77867,9,225647
3259,0.000553,74.125.24.0-255,2902,80769,9,225647
3260,0.000556,172.31.36.0-255,66,80835,9,225647
3261,0.000562,74.125.24.0-255,5738,86573,9,225647
3262,0.000565,172.31.36.0-255,66,86639,9,225647
3263,0.00058,74.125.24.0-255,4320,90959,9,225647
3264,0.000583,172.31.36.0-255,66,91025,9,225647
3265,0.000606,172.31.36.0-255,66,91091,9,225647
3266,0.000613,74.125.24.0-255,5738,96829,9,225647
3267,0.000615,172.31.36.0-255,66,96895,9,225647
3268,0.000646,74.125.24.0-255,5020,101915,9,225647
3269,0.00065,172.31.36.0-255,66,101981,9,225647
3270,0.000962,74.125.24.0-255,1484,103465,9,225647
3271,0.000969,74.125.24.0-255,2902,106367,9,225647
3272,0.000972,172.31.36.0-255,66,106433,9,225647
3273,0.000977,74.125.24.0-255,2902,109335,9,225647
3274,0.000979,172.31.36.0-255,66,109401,9,225647
3275,0.001001,74.125.24.0-255,5738,115139,9,225647
3276,0.001004,172.31.36.0-255,66,115205,9,225647
3277,0.001019,74.125.24.0-255,1484,116689,9,225647
3278,0.001023,74.125.24.0-255,1484,118173,9,225647
3279,0.001025,172.31.36.0-255,66,118239,9,225647
3280,0.001054,172.31.36.0-255,66,118305,9,225647
3281,0.001076,74.125.24.0-255,2902,121207,9,225647
3282,0.001079,172.31.36.0-255,66,121273,9,225647
3283,0.001084,74.125.24.0-255,3602,124875,9,225647
3284,0.001091,172.31.36.0-255,66,124941,9,225647
3285,0.001119,74.125.24.0-255,1484,126425,9,225647
3286,0.001124,74.125.24.0-255,2902,129327,9,225647
3287,0.001127,172.31.36.0-255,66,129393,9,225647
3288,0.001134,74.125.24.0-255,5738,135131,9,225647
3289,0.001136,172.31.36.0-255,66,135197,9,225647
3290,0.001141,74.125.24.0-255,4320,139517,9,225647
3291,0.001145,172.31.36.0-255,66,139583,9,225647
3292,0.001148,74.125.24.0-255,1484,141067,9,225647
3293,0.001183,172.31.36.0-255,66,141133,9,225647
3294,0.00119,74.125.24.0-255,5738,146871,9,225647
3295,0.001192,172.31.36.0-255,66,146937,9,225647
3296,0.001208,74.125.24.0-255,2184,149121,9,225647
3297,0.001211,172.31.36.0-255,66,149187,9,225647
3298,0.001263,74.125.24.0-255,1484,150671,9,225647
3299,0.001268,74.125.24.0-255,2902,153573,9,225647
3300,0.001271,172.31.36.0-255,66,153639,9,225647
3301,0.001287,74.125.24.0-255,5738,159377,9,225647
3302,0.00129,172.31.36.0-255,66,159443,9,225647
3303,0.001324,172.31.36.0-255,66,159509,9,225647
3304,0.001368,172.31.36.0-255,66,159575,9,225647
3305,0.001386,74.125.24.0-255,5020,164595,9,225647
3306,0.001391,172.31.36.0-255,66,164661,9,225647
3307,0.001428,74.125.24.0-255,1484,166145,9,225647
3308,0.001442,74.125.24.0-255,2902,169047,9,225647
3309,0.001446,172.31.36.0-255,66,169113,9,225647
3310,0.001451,74.125.24.0-255,2902,172015,9,225647
3311,0.001454,172.31.36.0-255,66,172081,9,225647
3312,0.001468,74.125.24.0-255,2902,174983,9,225647
3313,0.001471,172.31.36.0-255,66,175049,9,225647
3314,0.001474,74.125.24.0-255,1484,176533,9,225647
3315,0.001519,172.31.36.0-255,66,176599,9,225647
3316,0.001531,172.31.36.0-255,66,176665,9,225647
3317,0.001552,74.125.24.0-255,7156,183821,9,225647
3318,0.001556,172.31.36.0-255,66,183887,9,225647
3319,0.001582,172.31.36.0-255,66,183953,9,225647
3320,0.001594,172.31.36.0-255,66,184019,9,225647
3321,0.001675,172.31.36.0-255,66,184085,9,225647
3322,0.001687,172.31.36.0-255,66,184151,9,225647
3323,0.001729,172.31.36.0-255,101,184252,9,225647
3324,0.001889,74.125.24.0-255,1484,185736,9,225647
3325,0.001895,74.125.24.0-255,2902,188638,9,225647
3326,0.001899,172.31.36.0-255,66,188704,9,225647
3327,0.001921,74.125.24.0-255,5738,194442,9,225647
3328,0.001924,172.31.36.0-255,66,194508,9,225647
3329,0.001949,172.31.36.0-255,66,194574,9,225647
3330,0.001972,74.125.24.0-255,2902,197476,9,225647
3331,0.001975,172.31.36.0-255,66,197542,9,225647
3332,0.001987,172.31.36.0-255,66,197608,9,225647
3333,0.002019,74.125.24.0-255,7156,204764,9,225647
3334,0.002023,172.31.36.0-255,66,204830,9,225647
3335,0.002046,74.125.24.0-255,4320,209150,9,225647
3336,0.002049,172.31.36.0-255,66,209216,9,225647
3337,0.002062,172.31.36.0-255,66,209282,9,225647
3338,0.002066,74.125.24.0-255,1484,210766,9,225647
3339,0.002096,172.31.36.0-255,66,210832,9,225647
3340,0.002114,74.125.24.0-255,6438,217270,9,225647
3341,0.002118,172.31.36.0-255,66,217336,9,225647
3342,0.002125,74.125.24.0-255,6986,224322,9,225647
3343,0.002127,172.31.36.0-255,66,224388,9,225647
3344,0.002131,74.125.24.0-255,105,224493,9,225647
3345,0.004025,74.125.24.0-255,66,224559,9,225647
3346,0.007925,172.31.36.0-255,105,224664,9,225647
3347,0.010257,74.125.24.0-255,66,224730,9,225647
3348,0.028041,172.31.36.0-255,172,224902,9,225647
3349,0.028071,172.31.36.0-255,613,225515,9,225647
3350,0.029551,104.244.42.0-255,66,225581,9,225647
3351,0.029612,104.244.42.0-255,66,225647,9,225647
3352,0.0,172.217.194.0-255,293,293,9,232724
3353,2.6e-05,172.31.36.0-255,66,359,9,232724
3354,3.3e-05,172.217.194.0-255,1484,1843,9,232724
3355,3.6e-05,172.31.36.0-255,66,1909,9,232724
3356,6.1e-05,172.217.194.0-255,1484,3393,9,232724
3357,6.4e-05,172.31.36.0-255,66,3459,9,232724
3358,7e-05,172.217.194.0-255,2902,6361,9,232724
3359,7.2e-05,172.31.36.0-255,66,6427,9,232724
3360,7.8e-05,172.217.194.0-255,5738,12165,9,232724
3361,8.1e-05,172.31.36.0-255,66,12231,9,232724
3362,0.000112,172.217.194.0-255,4320,16551,9,232724
3363,0.000115,172.31.36.0-255,66,16617,9,232724
3364,0.000154,172.31.36.0-255,66,16683,9,232724
3365,0.00016,172.217.194.0-255,5379,22062,9,232724
3366,0.000162,172.31.36.0-255,66,22128,9,232724
3367,0.000191,172.217.194.0-255,1484,23612,9,232724
3368,0.000194,172.31.36.0-255,66,23678,9,232724
3369,0.0002,172.217.194.0-255,2902,26580,9,232724
3370,0.000202,172.31.36.0-255,66,26646,9,232724
3371,0.000205,172.217.194.0-255,1484,28130,9,232724
3372,0.000213,172.31.36.0-255,66,28196,9,232724
3373,0.000239,172.217.194.0-255,4320,32516,9,232724
3374,0.000242,172.31.36.0-255,66,32582,9,232724
3375,0.000248,172.217.194.0-255,5738,38320,9,232724
3376,0.00025,172.31.36.0-255,66,38386,9,232724
3377,0.000255,172.217.194.0-255,2902,41288,9,232724
3378,0.000257,172.31.36.0-255,66,41354,9,232724
3379,0.000306,172.31.36.0-255,66,41420,9,232724
3380,0.000311,172.217.194.0-255,4210,45630,9,232724
3381,0.000314,172.31.36.0-255,66,45696,9,232724
3382,0.000342,172.217.194.0-255,121,45817,9,232724
3383,0.000391,172.217.194.0-255,1484,47301,9,232724
3384,0.000394,172.31.36.0-255,66,47367,9,232724
3385,0.000421,172.217.194.0-255,2902,50269,9,232724
3386,0.000424,172.31.36.0-255,66,50335,9,232724
3387,0.000431,172.217.194.0-255,7156,57491,9,232724
3388,0.000434,172.31.36.0-255,66,57557,9,232724
3389,0.000497,172.217.194.0-255,1484,59041,9,232724
3390,0.000508,172.217.194.0-255,1484,60525,9,232724
3391,0.00051,172.31.36.0-255,66,60591,9,232724
3392,0.000547,172.31.36.0-255,66,60657,9,232724
3393,0.000551,172.217.194.0-255,2902,63559,9,232724
3394,0.000554,172.31.36.0-255,66,63625,9,232724
3395,0.000591,172.217.194.0-255,7113,70738,9,232724
3396,0.000595,172.31.36.0-255,66,70804,9,232724
3397,0.000883,172.217.194.0-255,1484,72288,9,232724
3398,0.000888,172.217.194.0-255,2902,75190,9,232724
3399,0.000891,172.31.36.0-255,66,75256,9,232724
3400,0.000919,172.217.194.0-255,5738,80994,9,232724
3401,0.000923,172.31.36.0-255,66,81060,9,232724
3402,0.000934,172.217.194.0-255,1484,82544,9,232724
3403,0.00095,172.217.194.0-255,4320,86864,9,232724
3404,0.000953,172.31.36.0-255,66,86930,9,232724
3405,0.000987,172.217.194.0-255,7156,94086,9,232724
3406,0.00099,172.31.36.0-255,66,94152,9,232724
3407,0.001001,172.31.36.0-255,66,94218,9,232724
3408,0.001025,172.217.194.0-255,2184,96402,9,232724
3409,0.001028,172.31.36.0-255,66,96468,9,232724
3410,0.001071,172.217.194.0-255,1484,97952,9,232724
3411,0.001076,172.217.194.0-255,2902,100854,9,232724
3412,0.00108,172.31.36.0-255,66,100920,9,232724
3413,0.001081,172.217.194.0-255,5738,106658,9,232724
3414,0.001083,172.31.36.0-255,66,106724,9,232724
3415,0.001146,172.217.194.0-255,5738,112462,9,232724
3416,0.00115,172.31.36.0-255,66,112528,9,232724
3417,0.001179,172.217.194.0-255,7156,119684,9,232724
3418,0.001183,172.31.36.0-255,66,119750,9,232724
3419,0.001188,172.217.194.0-255,2902,122652,9,232724
3420,0.00119,172.31.36.0-255,66,122718,9,232724
3421,0.001206,172.217.194.0-255,1484,124202,9,232724
3422,0.00123,172.217.194.0-255,2902,127104,9,232724
3423,0.001233,172.31.36.0-255,66,127170,9,232724
3424,0.001262,172.217.194.0-255,3602,130772,9,232724
3425,0.001264,172.31.36.0-255,66,130838,9,232724
3426,0.001267,172.217.194.0-255,1484,132322,9,232724
3427,0.001271,172.217.194.0-255,2902,135224,9,232724
3428,0.001273,172.31.36.0-255,66,135290,9,232724
3429,0.001282,172.217.194.0-255,1484,136774,9,232724
3430,0.001308,172.217.194.0-255,4320,141094,9,232724
3431,0.001312,172.31.36.0-255,66,141160,9,232724
3432,0.001317,172.217.194.0-255,4320,145480,9,232724
3433,0.001319,172.31.36.0-255,66,145546,9,232724
3434,0.001349,172.31.36.0-255,66,145612,9,232724
3435,0.001356,172.217.194.0-255,7156,152768,9,232724
3436,0.001358,172.31.36.0-255,66,152834,9,232724
3437,0.00138,172.217.194.0-255,1484,154318,9,232724
3438,0.001406,172.217.194.0-255,2184,156502,9,232724
3439,0.001409,172.31.36.0-255,66,156568,9,232724
3440,0.001508,172.217.194.0-255,1484,158052,9,232724
3441,0.001534,172.217.194.0-255,2902,160954,9,232724
3442,0.001538,172.31.36.0-255,66,161020,9,232724
3443,0.001541,172.217.194.0-255,1484,162504,9,232724
3444,0.001578,172.217.194.0-255,4320,166824,9,232724
3445,0.001581,172.31.36.0-255,66,166890,9,232724
3446,0.001588,172.217.194.0-255,7156,174046,9,232724
3447,0.00159,172.31.36.0-255,66,174112,9,232724
3448,0.001625,172.217.194.0-255,5738,179850,9,232724
3449,0.001628,172.31.36.0-255,66,179916,9,232724
3450,0.001638,172.31.36.0-255,66,179982,9,232724
3451,0.001686,172.217.194.0-255,2184,182166,9,232724
3452,0.001689,172.31.36.0-255,66,182232,9,232724
3453,0.00174,172.217.194.0-255,2902,185134,9,232724
3454,0.001744,172.31.36.0-255,66,185200,9,232724
3455,0.00175,172.217.194.0-255,5738,190938,9,232724
3456,0.001752,172.31.36.0-255,66,191004,9,232724
3457,0.001762,172.217.194.0-255,2902,193906,9,232724
3458,0.001765,172.31.36.0-255,66,193972,9,232724
3459,0.001798,172.217.194.0-255,7156,201128,9,232724
3460,0.001801,172.31.36.0-255,66,201194,9,232724
3461,0.001817,172.31.36.0-255,66,201260,9,232724
3462,0.00182,172.217.194.0-255,1484,202744,9,232724
3463,0.001824,172.217.194.0-255,2902,205646,9,232724
3464,0.001826,172.31.36.0-255,66,205712,9,232724
3465,0.001855,172.217.194.0-255,5738,211450,9,232724
3466,0.001858,172.31.36.0-255,66,211516,9,232724
3467,0.001872,172.31.36.0-255,66,211582,9,232724
3468,0.001878,172.217.194.0-255,4320,215902,9,232724
3469,0.001879,172.31.36.0-255,66,215968,9,232724
3470,0.001902,172.217.194.0-255,2902,218870,9,232724
3471,0.001906,172.31.36.0-255,66,218936,9,232724
3472,0.001911,172.217.194.0-255,4320,223256,9,232724
3473,0.001913,172.31.36.0-255,66,223322,9,232724
3474,0.001963,172.31.36.0-255,66,223388,9,232724
3475,0.001978,172.31.36.0-255,66,223454,9,232724
3476,0.002019,172.217.194.0-255,4320,227774,9,232724
3477,0.002023,172.31.36.0-255,66,227840,9,232724
3478,0.00208,172.31.36.0-255,66,227906,9,232724
3479,0.002092,172.31.36.0-255,66,227972,9,232724
3480,0.002111,172.31.36.0-255,66,228038,9,232724
3481,0.002123,172.31.36.0-255,66,228104,9,232724
3482,0.002126,172.217.194.0-255,105,228209,9,232724
3483,0.003669,172.31.36.0-255,66,228275,9,232724
3484,0.003696,172.31.36.0-255,105,228380,9,232724
3485,0.006039,172.217.194.0-255,66,228446,9,232724
3486,0.030142,172.31.36.0-255,167,228613,9,232724
3487,0.030172,172.31.36.0-255,1116,229729,9,232724
3488,0.030211,172.31.36.0-255,1514,231243,9,232724
3489,0.030212,172.31.36.0-255,1283,232526,9,232724
3490,0.031792,104.244.42.0-255,66,232592,9,232724
3491,0.031815,104.244.42.0-255,66,232658,9,232724
3492,0.031857,104.244.42.0-255,66,232724,9,232724
3493,0.0,172.217.194.0-255,153,153,9,170917
3494,1.7e-05,172.31.36.0-255,66,219,9,170917
3495,2.3e-05,172.217.194.0-255,1484,1703,9,170917
3496,2.7e-05,172.31.36.0-255,66,1769,9,170917
3497,3.4e-05,172.217.194.0-255,2902,4671,9,170917
3498,4.6e-05,172.31.36.0-255,66,4737,9,170917
3499,5.4e-05,172.217.194.0-255,7156,11893,9,170917
3500,5.7e-05,172.31.36.0-255,66,11959,9,170917
3501,6.1e-05,172.217.194.0-255,2048,14007,9,170917
3502,6.3e-05,172.31.36.0-255,66,14073,9,170917
3503,7.7e-05,172.31.36.0-255,66,14139,9,170917
3504,0.0001,172.217.194.0-255,1484,15623,9,170917
3505,0.000103,172.31.36.0-255,66,15689,9,170917
3506,0.000144,172.217.194.0-255,3961,19650,9,170917
3507,0.000153,172.31.36.0-255,66,19716,9,170917
3508,0.000181,172.217.194.0-255,1484,21200,9,170917
3509,0.000184,172.31.36.0-255,66,21266,9,170917
3510,0.000189,172.217.194.0-255,2902,24168,9,170917
3511,0.000192,172.31.36.0-255,66,24234,9,170917
3512,0.000204,172.217.194.0-255,5738,29972,9,170917
3513,0.000206,172.31.36.0-255,66,30038,9,170917
3514,0.000209,172.217.194.0-255,1484,31522,9,170917
3515,0.000211,172.31.36.0-255,66,31588,9,170917
3516,0.000273,172.31.36.0-255,66,31654,9,170917
3517,0.000279,172.217.194.0-255,4320,35974,9,170917
3518,0.000281,172.31.36.0-255,66,36040,9,170917
3519,0.000288,172.217.194.0-255,1484,37524,9,170917
3520,0.000291,172.31.36.0-255,66,37590,9,170917
3521,0.000329,172.217.194.0-255,7053,44643,9,170917
3522,0.000331,172.31.36.0-255,66,44709,9,170917
3523,0.000334,172.217.194.0-255,116,44825,9,170917
3524,0.00038,172.217.194.0-255,1484,46309,9,170917
3525,0.000383,172.31.36.0-255,66,46375,9,170917
3526,0.000388,172.217.194.0-255,2902,49277,9,170917
3527,0.00039,172.31.36.0-255,66,49343,9,170917
3528,0.000431,172.217.194.0-255,5738,55081,9,170917
3529,0.000434,172.31.36.0-255,66,55147,9,170917
3530,0.000448,172.31.36.0-255,66,55213,9,170917
3531,0.000461,172.217.194.0-255,7156,62369,9,170917
3532,0.000463,172.31.36.0-255,66,62435,9,170917
3533,0.000506,172.217.194.0-255,3602,66037,9,170917
3534,0.000509,172.31.36.0-255,66,66103,9,170917
3535,0.000512,172.217.194.0-255,1484,67587,9,170917
3536,0.000538,172.217.194.0-255,2902,70489,9,170917
3537,0.00054,172.31.36.0-255,66,70555,9,170917
3538,0.000545,172.217.194.0-255,2902,73457,9,170917
3539,0.000547,172.31.36.0-255,66,73523,9,170917
3540,0.000565,172.217.194.0-255,1484,75007,9,170917
3541,0.000575,172.217.194.0-255,5738,80745,9,170917
3542,0.000578,172.31.36.0-255,66,80811,9,170917
3543,0.000612,172.31.36.0-255,66,80877,9,170917
3544,0.000618,172.217.194.0-255,5738,86615,9,170917
3545,0.000621,172.31.36.0-255,66,86681,9,170917
3546,0.000628,172.217.194.0-255,6438,93119,9,170917
3547,0.00063,172.31.36.0-255,66,93185,9,170917
3548,0.000689,172.31.36.0-255,66,93251,9,170917
3549,0.000701,172.31.36.0-255,66,93317,9,170917
3550,0.000732,172.217.194.0-255,6438,99755,9,170917
3551,0.000735,172.31.36.0-255,66,99821,9,170917
3552,0.000792,172.217.194.0-255,1484,101305,9,170917
3553,0.000811,172.217.194.0-255,2902,104207,9,170917
3554,0.000814,172.31.36.0-255,66,104273,9,170917
3555,0.000847,172.217.194.0-255,5738,110011,9,170917
3556,0.00085,172.31.36.0-255,66,110077,9,170917
3557,0.000869,172.31.36.0-255,66,110143,9,170917
3558,0.000875,172.217.194.0-255,4320,114463,9,170917
3559,0.000877,172.31.36.0-255,66,114529,9,170917
3560,0.000882,172.217.194.0-255,2902,117431,9,170917
3561,0.000884,172.31.36.0-255,66,117497,9,170917
3562,0.000917,172.217.194.0-255,2902,120399,9,170917
3563,0.00092,172.31.36.0-255,66,120465,9,170917
3564,0.000923,172.217.194.0-255,766,121231,9,170917
3565,0.001025,172.217.194.0-255,1484,122715,9,170917
3566,0.001029,172.31.36.0-255,66,122781,9,170917
3567,0.001035,172.217.194.0-255,2902,125683,9,170917
3568,0.001039,172.31.36.0-255,66,125749,9,170917
3569,0.00105,172.217.194.0-255,5738,131487,9,170917
3570,0.001052,172.31.36.0-255,66,131553,9,170917
3571,0.0011,172.217.194.0-255,1484,133037,9,170917
3572,0.001133,172.31.36.0-255,66,133103,9,170917
3573,0.001145,172.31.36.0-255,66,133169,9,170917
3574,0.001154,172.217.194.0-255,2184,135353,9,170917
3575,0.001156,172.31.36.0-255,66,135419,9,170917
3576,0.00116,172.217.194.0-255,2902,138321,9,170917
3577,0.001162,172.31.36.0-255,66,138387,9,170917
3578,0.001169,172.217.194.0-255,7156,145543,9,170917
3579,0.001173,172.31.36.0-255,66,145609,9,170917
3580,0.001177,172.217.194.0-255,2902,148511,9,170917
3581,0.001179,172.31.36.0-255,66,148577,9,170917
3582,0.00123,172.31.36.0-255,66,148643,9,170917
3583,0.001246,172.31.36.0-255,66,148709,9,170917
3584,0.001267,172.31.36.0-255,66,148775,9,170917
3585,0.001294,172.217.194.0-255,5738,154513,9,170917
3586,0.001297,172.31.36.0-255,66,154579,9,170917
3587,0.001348,172.31.36.0-255,66,154645,9,170917
3588,0.001363,172.31.36.0-255,66,154711,9,170917
3589,0.001403,172.31.36.0-255,66,154777,9,170917
3590,0.001425,172.31.36.0-255,66,154843,9,170917
3591,0.001461,172.31.36.0-255,66,154909,9,170917
3592,0.00152,172.31.36.0-255,66,154975,9,170917
3593,0.001554,172.217.194.0-255,6438,161413,9,170917
3594,0.001557,172.31.36.0-255,66,161479,9,170917
3595,0.001576,172.31.36.0-255,66,161545,9,170917
3596,0.001579,172.217.194.0-255,105,161650,9,170917
3597,0.010043,172.31.36.0-255,66,161716,9,170917
3598,0.010087,172.31.36.0-255,105,161821,9,170917
3599,0.012662,172.217.194.0-255,66,161887,9,170917
3600,0.041051,172.31.36.0-255,172,162059,9,170917
3601,0.041082,172.31.36.0-255,1112,163171,9,170917
3602,0.041152,172.31.36.0-255,1514,164685,9,170917
3603,0.041153,172.31.36.0-255,1514,166199,9,170917
3604,0.041154,172.31.36.0-255,1514,167713,9,170917
3605,0.041156,172.31.36.0-255,1514,169227,9,170917
3606,0.041183,172.31.36.0-255,1492,170719,9,170917
3607,0.042538,104.244.42.0-255,66,170785,9,170917
3608,0.042575,104.244.42.0-255,66,170851,9,170917
3609,0.042675,104.244.42.0-255,66,170917,9,170917
3610,0.0,172.217.194.0-255,153,153,9,209512
3611,3.6e-05,172.31.36.0-255,66,219,9,209512
3612,4.3e-05,172.217.194.0-255,1484,1703,9,209512
3613,4.7e-05,172.31.36.0-255,66,1769,9,209512
3614,5.2e-05,172.217.194.0-255,2902,4671,9,209512
3615,5.5e-05,172.31.36.0-255,66,4737,9,209512
3616,6.9e-05,172.217.194.0-255,7156,11893,9,209512
3617,7.3e-05,172.31.36.0-255,66,11959,9,209512
3618,7.7e-05,172.217.194.0-255,2048,14007,9,209512
3619,7.9e-05,172.31.36.0-255,66,14073,9,209512
3620,8.3e-05,172.217.194.0-255,2902,16975,9,209512
3621,8.5e-05,172.31.36.0-255,66,17041,9,209512
3622,0.000119,172.217.194.0-255,7156,24197,9,209512
3623,0.000122,172.31.36.0-255,66,24263,9,209512
3624,0.00014,172.217.194.0-255,5738,30001,9,209512
3625,0.000147,172.31.36.0-255,66,30067,9,209512
3626,0.000172,172.217.194.0-255,1125,31192,9,209512
3627,0.000176,172.31.36.0-255,66,31258,9,209512
3628,0.000271,172.217.194.0-255,1484,32742,9,209512
3629,0.000274,172.31.36.0-255,66,32808,9,209512
3630,0.000279,172.217.194.0-255,2902,35710,9,209512
3631,0.000281,172.31.36.0-255,66,35776,9,209512
3632,0.000288,172.217.194.0-255,5738,41514,9,209512
3633,0.000291,172.31.36.0-255,66,41580,9,209512
3634,0.000304,172.217.194.0-255,6797,48377,9,209512
3635,0.000306,172.31.36.0-255,66,48443,9,209512
3636,0.000354,172.217.194.0-255,1484,49927,9,209512
3637,0.000357,172.31.36.0-255,66,49993,9,209512
3638,0.000362,172.217.194.0-255,2902,52895,9,209512
3639,0.000364,172.31.36.0-255,66,52961,9,209512
3640,0.000371,172.217.194.0-255,5738,58699,9,209512
3641,0.000373,172.31.36.0-255,66,58765,9,209512
3642,0.000384,172.217.194.0-255,4320,63085,9,209512
3643,0.000387,172.31.36.0-255,66,63151,9,209512
3644,0.000412,172.217.194.0-255,2543,65694,9,209512
3645,0.000416,172.31.36.0-255,66,65760,9,209512
3646,0.000524,172.217.194.0-255,645,66405,9,209512
3647,0.000653,172.217.194.0-255,1484,67889,9,209512
3648,0.000657,172.31.36.0-255,66,67955,9,209512
3649,0.000663,172.217.194.0-255,2902,70857,9,209512
3650,0.000665,172.31.36.0-255,66,70923,9,209512
3651,0.000677,172.217.194.0-255,5738,76661,9,209512
3652,0.000679,172.31.36.0-255,66,76727,9,209512
3653,0.000684,172.217.194.0-255,2902,79629,9,209512
3654,0.000686,172.31.36.0-255,66,79695,9,209512
3655,0.000711,172.217.194.0-255,3961,83656,9,209512
3656,0.000714,172.31.36.0-255,66,83722,9,209512
3657,0.000721,172.217.194.0-255,7156,90878,9,209512
3658,0.000724,172.217.194.0-255,1484,92362,9,209512
3659,0.000726,172.31.36.0-255,66,92428,9,209512
3660,0.00077,172.31.36.0-255,66,92494,9,209512
3661,0.001106,172.217.194.0-255,1484,93978,9,209512
3662,0.001113,172.217.194.0-255,2902,96880,9,209512
3663,0.001118,172.31.36.0-255,66,96946,9,209512
3664,0.001157,172.217.194.0-255,4320,101266,9,209512
3665,0.00116,172.31.36.0-255,66,101332,9,209512
3666,0.001198,172.217.194.0-255,1484,102816,9,209512
3667,0.001212,172.31.36.0-255,66,102882,9,209512
3668,0.00123,172.31.36.0-255,66,102948,9,209512
3669,0.001234,172.217.194.0-255,2184,105132,9,209512
3670,0.001236,172.31.36.0-255,66,105198,9,209512
3671,0.001804,172.217.194.0-255,1484,106682,9,209512
3672,0.001814,172.217.194.0-255,2902,109584,9,209512
3673,0.001817,172.31.36.0-255,66,109650,9,209512
3674,0.001825,172.217.194.0-255,5738,115388,9,209512
3675,0.001827,172.31.36.0-255,66,115454,9,209512
3676,0.001888,172.31.36.0-255,66,115520,9,209512
3677,0.001901,172.31.36.0-255,66,115586,9,209512
3678,0.002105,172.217.194.0-255,1484,117070,9,209512
3679,0.002112,172.217.194.0-255,2902,119972,9,209512
3680,0.002116,172.31.36.0-255,66,120038,9,209512
3681,0.002119,172.217.194.0-255,1484,121522,9,209512
3682,0.002146,172.217.194.0-255,4320,125842,9,209512
3683,0.002148,172.31.36.0-255,66,125908,9,209512
3684,0.002153,172.217.194.0-255,2902,128810,9,209512
3685,0.002154,172.31.36.0-255,66,128876,9,209512
3686,0.00219,172.31.36.0-255,66,128942,9,209512
3687,0.0022,172.31.36.0-255,66,129008,9,209512
3688,0.002211,172.217.194.0-255,1484,130492,9,209512
3689,0.002239,172.217.194.0-255,766,131258,9,209512
3690,0.002242,172.31.36.0-255,66,131324,9,209512
3691,0.002279,172.217.194.0-255,1484,132808,9,209512
3692,0.002306,172.217.194.0-255,2902,135710,9,209512
3693,0.002309,172.31.36.0-255,66,135776,9,209512
3694,0.002311,172.217.194.0-255,1484,137260,9,209512
3695,0.002337,172.217.194.0-255,4320,141580,9,209512
3696,0.00234,172.31.36.0-255,66,141646,9,209512
3697,0.002346,172.217.194.0-255,5738,147384,9,209512
3698,0.002348,172.31.36.0-255,66,147450,9,209512
3699,0.00238,172.31.36.0-255,66,147516,9,209512
3700,0.002386,172.217.194.0-255,5020,152536,9,209512
3701,0.002388,172.31.36.0-255,66,152602,9,209512
3702,0.002832,172.217.194.0-255,1484,154086,9,209512
3703,0.002851,172.217.194.0-255,2902,156988,9,209512
3704,0.002854,172.31.36.0-255,66,157054,9,209512
3705,0.002857,172.217.194.0-255,1484,158538,9,209512
3706,0.002875,172.217.194.0-255,4320,162858,9,209512
3707,0.002878,172.31.36.0-255,66,162924,9,209512
3708,0.002908,172.217.194.0-255,7156,170080,9,209512
3709,0.00291,172.31.36.0-255,66,170146,9,209512
3710,0.00293,172.217.194.0-255,2902,173048,9,209512
3711,0.002933,172.31.36.0-255,66,173114,9,209512
3712,0.002944,172.31.36.0-255,66,173180,9,209512
3713,0.002948,172.217.194.0-255,2184,175364,9,209512
3714,0.002949,172.31.36.0-255,66,175430,9,209512
3715,0.004207,172.217.194.0-255,1484,176914,9,209512
3716,0.004214,172.217.194.0-255,2902,179816,9,209512
3717,0.004217,172.31.36.0-255,66,179882,9,209512
3718,0.004222,172.217.194.0-255,2902,182784,9,209512
3719,0.004224,172.31.36.0-255,66,182850,9,209512
3720,0.004248,172.217.194.0-255,1484,184334,9,209512
3721,0.004276,172.31.36.0-255,66,184400,9,209512
3722,0.004286,172.31.36.0-255,66,184466,9,209512
3723,0.004369,172.31.36.0-255,66,184532,9,209512
3724,0.004412,172.31.36.0-255,66,184598,9,209512
3725,0.004662,172.217.194.0-255,1484,186082,9,209512
3726,0.004675,172.217.194.0-255,2902,188984,9,209512
3727,0.004677,172.31.36.0-255,66,189050,9,209512
3728,0.00468,172.217.194.0-255,1484,190534,9,209512
3729,0.004723,172.31.36.0-255,66,190600,9,209512
3730,0.004726,172.217.194.0-255,1484,192084,9,209512
3731,0.004772,172.31.36.0-255,66,192150,9,209512
3732,0.004775,172.217.194.0-255,766,192916,9,209512
3733,0.004923,172.217.194.0-255,1484,194400,9,209512
3734,0.004925,172.31.36.0-255,66,194466,9,209512
3735,0.004942,172.217.194.0-255,2902,197368,9,209512
3736,0.004945,172.31.36.0-255,66,197434,9,209512
3737,0.004948,172.217.194.0-255,1484,198918,9,209512
3738,0.004975,172.217.194.0-255,4320,203238,9,209512
3739,0.004978,172.31.36.0-255,66,203304,9,209512
3740,0.004994,172.31.36.0-255,66,203370,9,209512
3741,0.004997,172.217.194.0-255,1484,204854,9,209512
3742,0.005036,172.31.36.0-255,66,204920,9,209512
3743,0.005048,172.31.36.0-255,66,204986,9,209512
3744,0.005056,172.217.194.0-255,2740,207726,9,209512
3745,0.005058,172.31.36.0-255,66,207792,9,209512
3746,0.005081,172.217.194.0-255,105,207897,9,209512
3747,0.012404,172.31.36.0-255,66,207963,9,209512
3748,0.012433,172.31.36.0-255,105,208068,9,209512
3749,0.014786,172.217.194.0-255,66,208134,9,209512
3750,0.040684,172.31.36.0-255,176,208310,9,209512
3751,0.040728,172.31.36.0-255,1070,209380,9,209512
3752,0.042244,104.244.42.0-255,66,209446,9,209512
3753,0.042297,104.244.42.0-255,66,209512,9,209512
3754,0.0,74.125.68.0-255,150,150,9,249067
3755,2.4e-05,172.31.36.0-255,66,216,9,249067
3756,3.1e-05,74.125.68.0-255,1484,1700,9,249067
3757,3.6e-05,172.31.36.0-255,66,1766,9,249067
3758,5.1e-05,74.125.68.0-255,2902,4668,9,249067
3759,5.4e-05,172.31.36.0-255,66,4734,9,249067
3760,6e-05,74.125.68.0-255,2902,7636,9,249067
3761,6.2e-05,172.31.36.0-255,66,7702,9,249067
3762,0.000102,74.125.68.0-255,4320,12022,9,249067
3763,0.000107,172.31.36.0-255,66,12088,9,249067
3764,0.000111,74.125.68.0-255,2045,14133,9,249067
3765,0.000113,172.31.36.0-255,66,14199,9,249067
3766,0.000279,74.125.68.0-255,1484,15683,9,249067
3767,0.000284,172.31.36.0-255,66,15749,9,249067
3768,0.000313,74.125.68.0-255,2902,18651,9,249067
3769,0.000317,172.31.36.0-255,66,18717,9,249067
3770,0.000321,74.125.68.0-255,2902,21619,9,249067
3771,0.000323,172.31.36.0-255,66,21685,9,249067
3772,0.000348,74.125.68.0-255,2902,24587,9,249067
3773,0.000351,172.31.36.0-255,66,24653,9,249067
3774,0.000364,74.125.68.0-255,6797,31450,9,249067
3775,0.000366,172.31.36.0-255,66,31516,9,249067
3776,0.000394,74.125.68.0-255,1484,33000,9,249067
3777,0.000397,172.31.36.0-255,66,33066,9,249067
3778,0.000401,74.125.68.0-255,2902,35968,9,249067
3779,0.000404,172.31.36.0-255,66,36034,9,249067
3780,0.000414,74.125.68.0-255,5738,41772,9,249067
3781,0.000417,172.31.36.0-255,66,41838,9,249067
3782,0.000453,74.125.68.0-255,6797,48635,9,249067
3783,0.000457,172.31.36.0-255,66,48701,9,249067
3784,0.000533,74.125.68.0-255,1484,50185,9,249067
3785,0.000537,172.31.36.0-255,66,50251,9,249067
3786,0.000541,74.125.68.0-255,1484,51735,9,249067
3787,0.000565,74.125.68.0-255,1484,53219,9,249067
3788,0.000571,74.125.68.0-255,5738,58957,9,249067
3789,0.000572,172.31.36.0-255,66,59023,9,249067
3790,0.000578,172.31.36.0-255,66,59089,9,249067
3791,0.000596,74.125.68.0-255,5738,64827,9,249067
3792,0.000607,172.31.36.0-255,66,64893,9,249067
3793,0.00062,74.125.68.0-255,1125,66018,9,249067
3794,0.000665,74.125.68.0-255,397,66415,9,249067
3795,0.000762,74.125.68.0-255,111,66526,9,249067
3796,0.000767,172.31.36.0-255,66,66592,9,249067
3797,0.000967,74.125.68.0-255,1484,68076,9,249067
3798,0.000981,74.125.68.0-255,2902,70978,9,249067
3799,0.000984,172.31.36.0-255,66,71044,9,249067
3800,0.000991,74.125.68.0-255,5738,76782,9,249067
3801,0.000994,74.125.68.0-255,1484,78266,9,249067
3802,0.001002,172.31.36.0-255,66,78332,9,249067
3803,0.00101,74.125.68.0-255,1484,79816,9,249067
3804,0.001036,74.125.68.0-255,1484,81300,9,249067
3805,0.001044,172.31.36.0-255,66,81366,9,249067
3806,0.001052,74.125.68.0-255,5738,87104,9,249067
3807,0.001059,172.31.36.0-255,66,87170,9,249067
3808,0.001094,74.125.68.0-255,5379,92549,9,249067
3809,0.001099,172.31.36.0-255,66,92615,9,249067
3810,0.002294,74.125.68.0-255,1484,94099,9,249067
3811,0.002329,74.125.68.0-255,2902,97001,9,249067
3812,0.002333,172.31.36.0-255,66,97067,9,249067
3813,0.002376,74.125.68.0-255,4320,101387,9,249067
3814,0.002386,74.125.68.0-255,1484,102871,9,249067
3815,0.002395,74.125.68.0-255,1484,104355,9,249067
3816,0.00241,74.125.68.0-255,5738,110093,9,249067
3817,0.002422,74.125.68.0-255,1484,111577,9,249067
3818,0.002447,74.125.68.0-255,7156,118733,9,249067
3819,0.002466,74.125.68.0-255,7156,125889,9,249067
3820,0.002469,74.125.68.0-255,766,126655,9,249067
3821,0.00725,172.31.36.0-255,66,126721,9,249067
3822,0.00974,74.125.68.0-255,5738,132459,9,249067
3823,0.009759,172.31.36.0-255,66,132525,9,249067
3824,0.012266,74.125.68.0-255,5738,138263,9,249067
3825,0.012281,172.31.36.0-255,66,138329,9,249067
3826,0.014775,74.125.68.0-255,5738,144067,9,249067
3827,0.01479,172.31.36.0-255,66,144133,9,249067
3828,0.017287,74.125.68.0-255,5738,149871,9,249067
3829,0.017956,172.31.36.0-255,66,149937,9,249067
3830,0.020437,74.125.68.0-255,5738,155675,9,249067
3831,0.02045,172.31.36.0-255,66,155741,9,249067
3832,0.022951,74.125.68.0-255,5738,161479,9,249067
3833,0.02296,172.31.36.0-255,66,161545,9,249067
3834,0.025445,74.125.68.0-255,5738,167283,9,249067
3835,0.025453,172.31.36.0-255,66,167349,9,249067
3836,0.027926,74.125.68.0-255,5738,173087,9,249067
3837,0.027936,172.31.36.0-255,66,173153,9,249067
3838,0.030412,74.125.68.0-255,1484,174637,9,249067
3839,0.030438,74.125.68.0-255,4320,178957,9,249067
3840,0.030445,172.31.36.0-255,66,179023,9,249067
3841,0.033018,74.125.68.0-255,5738,184761,9,249067
3842,0.033026,172.31.36.0-255,66,184827,9,249067
3843,0.035516,74.125.68.0-255,5738,190565,9,249067
3844,0.035531,172.31.36.0-255,66,190631,9,249067
3845,0.038014,74.125.68.0-255,5738,196369,9,249067
3846,0.038034,172.31.36.0-255,66,196435,9,249067
3847,0.040538,74.125.68.0-255,5738,202173,9,249067
3848,0.040563,172.31.36.0-255,66,202239,9,249067
3849,0.043047,74.125.68.0-255,5738,207977,9,249067
3850,0.043058,172.31.36.0-255,66,208043,9,249067
3851,0.043177,172.31.36.0-255,172,208215,9,249067
3852,0.043206,172.31.36.0-255,1116,209331,9,249067
3853,0.04333,172.31.36.0-255,1514,210845,9,249067
3854,0.043332,172.31.36.0-255,1514,212359,9,249067
3855,0.043334,172.31.36.0-255,1514,213873,9,249067
3856,0.043335,172.31.36.0-255,106,213979,9,249067
3857,0.044825,104.244.42.0-255,66,214045,9,249067
3858,0.044957,104.244.42.0-255,66,214111,9,249067
3859,0.045002,104.244.42.0-255,66,214177,9,249067
3860,0.045014,104.244.42.0-255,66,214243,9,249067
3861,0.045537,74.125.68.0-255,5738,219981,9,249067
3862,0.045544,172.31.36.0-255,66,220047,9,249067
3863,0.048025,74.125.68.0-255,5738,225785,9,249067
3864,0.048035,172.31.36.0-255,66,225851,9,249067
3865,0.050526,74.125.68.0-255,5738,231589,9,249067
3866,0.050537,172.31.36.0-255,66,231655,9,249067
3867,0.053014,74.125.68.0-255,5738,237393,9,249067
3868,0.053027,172.31.36.0-255,66,237459,9,249067
3869,0.055508,74.125.68.0-255,5738,243197,9,249067
3870,0.055516,172.31.36.0-255,66,243263,9,249067
3871,0.058004,74.125.68.0-255,5738,249001,9,249067
3872,0.058011,172.31.36.0-255,66,249067,9,249067
3873,0.0,172.217.194.0-255,209,209,9,139936
3874,1.9e-05,172.217.194.0-255,1484,1693,9,139936
3875,3e-05,172.31.36.0-255,66,1759,9,139936
3876,3.9e-05,172.217.194.0-255,4320,6079,9,139936
3877,4.4e-05,172.31.36.0-255,66,6145,9,139936
3878,8.5e-05,172.31.36.0-255,66,6211,9,139936
3879,9.6e-05,172.31.36.0-255,66,6277,9,139936
3880,0.00014,172.31.36.0-255,66,6343,9,139936
3881,0.000212,172.217.194.0-255,1484,7827,9,139936
3882,0.000218,172.217.194.0-255,2902,10729,9,139936
3883,0.000221,172.31.36.0-255,66,10795,9,139936
3884,0.00025,172.217.194.0-255,5738,16533,9,139936
3885,0.000254,172.31.36.0-255,66,16599,9,139936
3886,0.000266,172.31.36.0-255,66,16665,9,139936
3887,0.000301,172.217.194.0-255,3961,20626,9,139936
3888,0.000303,172.31.36.0-255,66,20692,9,139936
3889,0.000312,172.217.194.0-255,7156,27848,9,139936
3890,0.000319,172.31.36.0-255,66,27914,9,139936
3891,0.000383,172.217.194.0-255,2818,30732,9,139936
3892,0.000386,172.31.36.0-255,66,30798,9,139936
3893,0.000451,172.217.194.0-255,119,30917,9,139936
3894,0.000486,172.217.194.0-255,380,31297,9,139936
3895,0.000659,172.217.194.0-255,1484,32781,9,139936
3896,0.000664,172.31.36.0-255,66,32847,9,139936
3897,0.00067,172.217.194.0-255,2902,35749,9,139936
3898,0.000673,172.31.36.0-255,66,35815,9,139936
3899,0.000676,172.217.194.0-255,1484,37299,9,139936
3900,0.000705,172.217.194.0-255,4320,41619,9,139936
3901,0.000708,172.31.36.0-255,66,41685,9,139936
3902,0.000727,172.31.36.0-255,66,41751,9,139936
3903,0.00073,172.217.194.0-255,1484,43235,9,139936
3904,0.000764,172.31.36.0-255,66,43301,9,139936
3905,0.000782,172.217.194.0-255,2902,46203,9,139936
3906,0.000784,172.31.36.0-255,66,46269,9,139936
3907,0.00079,172.217.194.0-255,4320,50589,9,139936
3908,0.000793,172.31.36.0-255,66,50655,9,139936
3909,0.000797,172.217.194.0-255,2902,53557,9,139936
3910,0.0008,172.31.36.0-255,66,53623,9,139936
3911,0.00084,172.217.194.0-255,5738,59361,9,139936
3912,0.000843,172.31.36.0-255,66,59427,9,139936
3913,0.000864,172.31.36.0-255,66,59493,9,139936
3914,0.000891,172.217.194.0-255,2184,61677,9,139936
3915,0.000894,172.31.36.0-255,66,61743,9,139936
3916,0.001023,172.217.194.0-255,1484,63227,9,139936
3917,0.001045,172.217.194.0-255,2902,66129,9,139936
3918,0.001048,172.31.36.0-255,66,66195,9,139936
3919,0.001056,172.217.194.0-255,5738,71933,9,139936
3920,0.001058,172.31.36.0-255,66,71999,9,139936
3921,0.001077,172.31.36.0-255,66,72065,9,139936
3922,0.001083,172.217.194.0-255,2902,74967,9,139936
3923,0.001086,172.31.36.0-255,66,75033,9,139936
3924,0.00113,172.31.36.0-255,66,75099,9,139936
3925,0.001288,172.217.194.0-255,1484,76583,9,139936
3926,0.001292,172.217.194.0-255,1484,78067,9,139936
3927,0.001298,172.31.36.0-255,66,78133,9,139936
3928,0.001316,172.217.194.0-255,1484,79617,9,139936
3929,0.001323,172.217.194.0-255,5738,85355,9,139936
3930,0.001326,172.31.36.0-255,66,85421,9,139936
3931,0.001334,172.217.194.0-255,7156,92577,9,139936
3932,0.001336,172.31.36.0-255,66,92643,9,139936
3933,0.001379,172.31.36.0-255,66,92709,9,139936
3934,0.001383,172.217.194.0-255,2184,94893,9,139936
3935,0.001385,172.31.36.0-255,66,94959,9,139936
3936,0.001839,172.217.194.0-255,1484,96443,9,139936
3937,0.001844,172.217.194.0-255,2902,99345,9,139936
3938,0.001848,172.31.36.0-255,66,99411,9,139936
3939,0.001852,172.217.194.0-255,1484,100895,9,139936
3940,0.001884,172.217.194.0-255,4320,105215,9,139936
3941,0.001887,172.31.36.0-255,66,105281,9,139936
3942,0.001906,172.31.36.0-255,66,105347,9,139936
3943,0.001934,172.217.194.0-255,4320,109667,9,139936
3944,0.001936,172.31.36.0-255,66,109733,9,139936
3945,0.001969,172.217.194.0-255,6438,116171,9,139936
3946,0.001971,172.31.36.0-255,66,116237,9,139936
3947,0.002053,172.217.194.0-255,1484,117721,9,139936
3948,0.002059,172.217.194.0-255,2902,120623,9,139936
3949,0.002063,172.31.36.0-255,66,120689,9,139936
3950,0.002071,172.217.194.0-255,5738,126427,9,139936
3951,0.002073,172.31.36.0-255,66,126493,9,139936
3952,0.002098,172.31.36.0-255,66,126559,9,139936
3953,0.002191,172.31.36.0-255,66,126625,9,139936
3954,0.002211,172.31.36.0-255,66,126691,9,139936
3955,0.002227,172.31.36.0-255,66,126757,9,139936
3956,0.00228,172.31.36.0-255,66,126823,9,139936
3957,0.002301,172.31.36.0-255,66,126889,9,139936
3958,0.002336,172.31.36.0-255,66,126955,9,139936
3959,0.002411,172.217.194.0-255,2184,129139,9,139936
3960,0.002414,172.217.194.0-255,1427,130566,9,139936
3961,0.002416,172.217.194.0-255,105,130671,9,139936
3962,0.0064,172.31.36.0-255,66,130737,9,139936
3963,0.008833,172.31.36.0-255,105,130842,9,139936
3964,0.011085,172.217.194.0-255,66,130908,9,139936
3965,0.036422,172.31.36.0-255,172,131080,9,139936
3966,0.036458,172.31.36.0-255,1115,132195,9,139936
3967,0.036525,172.31.36.0-255,1514,133709,9,139936
3968,0.036527,172.31.36.0-255,1514,135223,9,139936
3969,0.036532,172.31.36.0-255,1514,136737,9,139936
3970,0.036533,172.31.36.0-255,1514,138251,9,139936
3971,0.036552,172.31.36.0-255,1487,139738,9,139936
3972,0.037952,104.244.42.0-255,66,139804,9,139936
3973,0.03798,104.244.42.0-255,66,139870,9,139936
3974,0.03808,104.244.42.0-255,66,139936,9,139936
3975,0.0,172.31.36.0-255,105,105,9,459
3976,0.00017,172.31.36.0-255,90,195,9,459
3977,0.000177,172.31.36.0-255,66,261,9,459
3978,0.002886,74.125.200.0-255,66,327,9,459
3979,0.0029,74.125.200.0-255,66,393,9,459
3980,0.002911,172.31.36.0-255,66,459,9,459
3981,0.0,74.125.24.0-255,152,152,9,256154
3982,4.2e-05,172.31.36.0-255,66,218,9,256154
3983,4.9e-05,74.125.24.0-255,1484,1702,9,256154
3984,5.4e-05,172.31.36.0-255,66,1768,9,256154
3985,5.8e-05,74.125.24.0-255,2902,4670,9,256154
3986,6.9e-05,172.31.36.0-255,66,4736,9,256154
3987,7.6e-05,74.125.24.0-255,7156,11892,9,256154
3988,7.8e-05,172.31.36.0-255,66,11958,9,256154
3989,8.9e-05,172.31.36.0-255,66,12024,9,256154
3990,9.9e-05,172.31.36.0-255,66,12090,9,256154
3991,0.000132,74.125.24.0-255,2543,14633,9,256154
3992,0.000136,172.31.36.0-255,66,14699,9,256154
3993,0.000197,74.125.24.0-255,1484,16183,9,256154
3994,0.000201,172.31.36.0-255,66,16249,9,256154
3995,0.000233,74.125.24.0-255,2902,19151,9,256154
3996,0.000235,172.31.36.0-255,66,19217,9,256154
3997,0.000242,74.125.24.0-255,5738,24955,9,256154
3998,0.000244,172.31.36.0-255,66,25021,9,256154
3999,0.00028,172.31.36.0-255,66,25087,9,256154
4000,0.000292,172.31.36.0-255,66,25153,9,256154
4001,0.000345,74.125.24.0-255,375,25528,9,256154
4002,0.000348,172.31.36.0-255,66,25594,9,256154
4003,0.000441,74.125.24.0-255,1484,27078,9,256154
4004,0.000445,172.31.36.0-255,66,27144,9,256154
4005,0.00045,74.125.24.0-255,2902,30046,9,256154
4006,0.000452,172.31.36.0-255,66,30112,9,256154
4007,0.000455,74.125.24.0-255,1484,31596,9,256154
4008,0.000464,172.31.36.0-255,66,31662,9,256154
4009,0.0005,74.125.24.0-255,4320,35982,9,256154
4010,0.000506,74.125.24.0-255,5738,41720,9,256154
4011,0.000506,172.31.36.0-255,66,41786,9,256154
4012,0.000512,172.31.36.0-255,66,41852,9,256154
4013,0.000525,74.125.24.0-255,1125,42977,9,256154
4014,0.000573,74.125.24.0-255,1484,44461,9,256154
4015,0.000586,172.31.36.0-255,66,44527,9,256154
4016,0.000588,74.125.24.0-255,2902,47429,9,256154
4017,0.000591,74.125.24.0-255,1484,48913,9,256154
4018,0.000591,172.31.36.0-255,66,48979,9,256154
4019,0.000625,74.125.24.0-255,4320,53299,9,256154
4020,0.000638,172.31.36.0-255,66,53365,9,256154
4021,0.000639,74.125.24.0-255,2902,56267,9,256154
4022,0.000643,172.31.36.0-255,66,56333,9,256154
4023,0.000677,74.125.24.0-255,3961,60294,9,256154
4024,0.000681,172.31.36.0-255,66,60360,9,256154
4025,0.001577,74.125.24.0-255,1484,61844,9,256154
4026,0.001588,74.125.24.0-255,2902,64746,9,256154
4027,0.001592,172.31.36.0-255,66,64812,9,256154
4028,0.001596,74.125.24.0-255,1484,66296,9,256154
4029,0.0016,74.125.24.0-255,1484,67780,9,256154
4030,0.001623,74.125.24.0-255,4320,72100,9,256154
4031,0.001627,74.125.24.0-255,2902,75002,9,256154
4032,0.001648,74.125.24.0-255,1484,76486,9,256154
4033,0.001705,74.125.24.0-255,5738,82224,9,256154
4034,0.001723,74.125.24.0-255,2184,84408,9,256154
4035,0.00181,74.125.24.0-255,1484,85892,9,256154
4036,0.00183,74.125.24.0-255,2902,88794,9,256154
4037,0.001865,74.125.24.0-255,2902,91696,9,256154
4038,0.001881,74.125.24.0-255,2902,94598,9,256154
4039,0.001908,74.125.24.0-255,5738,100336,9,256154
4040,0.001999,74.125.24.0-255,1484,101820,9,256154
4041,0.002008,74.125.24.0-255,1484,103304,9,256154
4042,0.002018,74.125.24.0-255,1484,104788,9,256154
4043,0.002033,74.125.24.0-255,2902,107690,9,256154
4044,0.002048,74.125.24.0-255,2902,110592,9,256154
4045,0.004073,172.31.36.0-255,66,110658,9,256154
4046,0.006071,74.125.24.0-255,5738,116396,9,256154
4047,0.006076,172.31.36.0-255,66,116462,9,256154
4048,0.008066,74.125.24.0-255,5738,122200,9,256154
4049,0.008073,172.31.36.0-255,66,122266,9,256154
4050,0.01011,74.125.24.0-255,5738,128004,9,256154
4051,0.010121,172.31.36.0-255,66,128070,9,256154
4052,0.012131,74.125.24.0-255,5738,133808,9,256154
4053,0.012138,172.31.36.0-255,66,133874,9,256154
4054,0.014116,74.125.24.0-255,5738,139612,9,256154
4055,0.014125,172.31.36.0-255,66,139678,9,256154
4056,0.01613,74.125.24.0-255,5738,145416,9,256154
4057,0.016138,172.31.36.0-255,66,145482,9,256154
4058,0.01816,74.125.24.0-255,5738,151220,9,256154
4059,0.024124,172.31.36.0-255,66,151286,9,256154
4060,0.026105,74.125.24.0-255,5738,157024,9,256154
4061,0.026115,172.31.36.0-255,66,157090,9,256154
4062,0.028126,74.125.24.0-255,5738,162828,9,256154
4063,0.028134,172.31.36.0-255,66,162894,9,256154
4064,0.03018,74.125.24.0-255,5738,168632,9,256154
4065,0.030187,172.31.36.0-255,66,168698,9,256154
4066,0.032184,74.125.24.0-255,5738,174436,9,256154
4067,0.032191,172.31.36.0-255,66,174502,9,256154
4068,0.034221,74.125.24.0-255,5738,180240,9,256154
4069,0.034228,172.31.36.0-255,66,180306,9,256154
4070,0.036233,74.125.24.0-255,5738,186044,9,256154
4071,0.036241,172.31.36.0-255,66,186110,9,256154
4072,0.038278,74.125.24.0-255,5738,191848,9,256154
4073,0.038287,172.31.36.0-255,66,191914,9,256154
4074,0.03974,172.31.36.0-255,172,192086,9,256154
4075,0.03977,172.31.36.0-255,1117,193203,9,256154
4076,0.039843,172.31.36.0-255,1514,194717,9,256154
4077,0.039844,172.31.36.0-255,1514,196231,9,256154
4078,0.039846,172.31.36.0-255,1514,197745,9,256154
4079,0.039847,172.31.36.0-255,105,197850,9,256154
4080,0.040291,74.125.24.0-255,5738,203588,9,256154
4081,0.040297,172.31.36.0-255,66,203654,9,256154
4082,0.041297,104.244.42.0-255,66,203720,9,256154
4083,0.041333,104.244.42.0-255,66,203786,9,256154
4084,0.041435,104.244.42.0-255,66,203852,9,256154
4085,0.041456,104.244.42.0-255,66,203918,9,256154
4086,0.042274,74.125.24.0-255,5738,209656,9,256154
4087,0.042279,172.31.36.0-255,66,209722,9,256154
4088,0.044272,74.125.24.0-255,5738,215460,9,256154
4089,0.044279,172.31.36.0-255,66,215526,9,256154
4090,0.04626,74.125.24.0-255,5738,221264,9,256154
4091,0.046266,172.31.36.0-255,66,221330,9,256154
4092,0.048269,74.125.24.0-255,5738,227068,9,256154
4093,0.048276,172.31.36.0-255,66,227134,9,256154
4094,0.050349,74.125.24.0-255,5738,232872,9,256154
4095,0.050355,172.31.36.0-255,66,232938,9,256154
4096,0.052336,74.125.24.0-255,5738,238676,9,256154
4097,0.052342,172.31.36.0-255,66,238742,9,256154
4098,0.054351,74.125.24.0-255,5738,244480,9,256154
4099,0.054359,172.31.36.0-255,66,244546,9,256154
4100,0.056368,74.125.24.0-255,5738,250284,9,256154
4101,0.056391,172.31.36.0-255,66,250350,9,256154
4102,0.058385,74.125.24.0-255,5738,256088,9,256154
4103,0.058398,172.31.36.0-255,66,256154,9,256154
4104,0.0,172.217.24.0-255,146,146,9,288452
4105,2.2e-05,172.217.24.0-255,1484,1630,9,288452
4106,3e-05,172.31.36.0-255,66,1696,9,288452
4107,3.7e-05,172.217.24.0-255,2902,4598,9,288452
4108,4e-05,172.31.36.0-255,66,4664,9,288452
4109,4.8e-05,172.217.24.0-255,5738,10402,9,288452
4110,5.9e-05,172.31.36.0-255,66,10468,9,288452
4111,8.6e-05,172.217.24.0-255,1484,11952,9,288452
4112,9.1e-05,172.217.24.0-255,1993,13945,9,288452
4113,9.4e-05,172.31.36.0-255,66,14011,9,288452
4114,0.000185,172.217.24.0-255,1484,15495,9,288452
4115,0.00019,172.217.24.0-255,1484,16979,9,288452
4116,0.000193,172.31.36.0-255,66,17045,9,288452
4117,0.00022,172.217.24.0-255,1484,18529,9,288452
4118,0.000225,172.217.24.0-255,2902,21431,9,288452
4119,0.000227,172.31.36.0-255,66,21497,9,288452
4120,0.000232,172.217.24.0-255,4320,25817,9,288452
4121,0.000235,172.31.36.0-255,66,25883,9,288452
4122,0.000269,172.217.24.0-255,2902,28785,9,288452
4123,0.000272,172.31.36.0-255,66,28851,9,288452
4124,0.000301,172.217.24.0-255,2543,31394,9,288452
4125,0.000305,172.31.36.0-255,66,31460,9,288452
4126,0.000308,172.217.24.0-255,1484,32944,9,288452
4127,0.000311,172.217.24.0-255,1484,34428,9,288452
4128,0.000313,172.31.36.0-255,66,34494,9,288452
4129,0.00034,172.217.24.0-255,1484,35978,9,288452
4130,0.000348,172.217.24.0-255,5738,41716,9,288452
4131,0.000351,172.31.36.0-255,66,41782,9,288452
4132,0.000357,172.217.24.0-255,6797,48579,9,288452
4133,0.00036,172.31.36.0-255,66,48645,9,288452
4134,0.001299,172.217.24.0-255,1484,50129,9,288452
4135,0.001309,172.217.24.0-255,1484,51613,9,288452
4136,0.001313,172.31.36.0-255,66,51679,9,288452
4137,0.001319,172.217.24.0-255,2902,54581,9,288452
4138,0.001321,172.31.36.0-255,66,54647,9,288452
4139,0.001336,172.217.24.0-255,5738,60385,9,288452
4140,0.001338,172.31.36.0-255,66,60451,9,288452
4141,0.001368,172.217.24.0-255,5959,66410,9,288452
4142,0.001372,172.31.36.0-255,66,66476,9,288452
4143,0.001502,172.217.24.0-255,1484,67960,9,288452
4144,0.001509,172.217.24.0-255,2902,70862,9,288452
4145,0.001512,172.31.36.0-255,66,70928,9,288452
4146,0.001518,172.217.24.0-255,2902,73830,9,288452
4147,0.00152,172.31.36.0-255,66,73896,9,288452
4148,0.001537,172.217.24.0-255,2902,76798,9,288452
4149,0.001539,172.31.36.0-255,66,76864,9,288452
4150,0.001572,172.217.24.0-255,6797,83661,9,288452
4151,0.001575,172.31.36.0-255,66,83727,9,288452
4152,0.001596,172.217.24.0-255,1484,85211,9,288452
4153,0.001608,172.217.24.0-255,1484,86695,9,288452
4154,0.00161,172.31.36.0-255,66,86761,9,288452
4155,0.001613,172.217.24.0-255,1484,88245,9,288452
4156,0.001641,172.217.24.0-255,2902,91147,9,288452
4157,0.001643,172.31.36.0-255,66,91213,9,288452
4158,0.001652,172.31.36.0-255,66,91279,9,288452
4159,0.001657,172.217.24.0-255,4320,95599,9,288452
4160,0.001665,172.31.36.0-255,66,95665,9,288452
4161,0.001695,172.31.36.0-255,66,95731,9,288452
4162,0.001713,172.217.24.0-255,3294,99025,9,288452
4163,0.001715,172.31.36.0-255,66,99091,9,288452
4164,0.002503,172.217.24.0-255,1484,100575,9,288452
4165,0.002507,172.217.24.0-255,1484,102059,9,288452
4166,0.00251,172.31.36.0-255,66,102125,9,288452
4167,0.002536,172.217.24.0-255,1484,103609,9,288452
4168,0.002542,172.217.24.0-255,5738,109347,9,288452
4169,0.002545,172.31.36.0-255,66,109413,9,288452
4170,0.002575,172.31.36.0-255,66,109479,9,288452
4171,0.002611,172.217.24.0-255,4320,113799,9,288452
4172,0.002614,172.31.36.0-255,66,113865,9,288452
4173,0.002618,172.217.24.0-255,1484,115349,9,288452
4174,0.002639,172.217.24.0-255,4320,119669,9,288452
4175,0.002642,172.31.36.0-255,66,119735,9,288452
4176,0.002646,172.217.24.0-255,2902,122637,9,288452
4177,0.002649,172.31.36.0-255,66,122703,9,288452
4178,0.002693,172.31.36.0-255,66,122769,9,288452
4179,0.002705,172.31.36.0-255,66,122835,9,288452
4180,0.003466,172.217.24.0-255,1484,124319,9,288452
4181,0.00348,172.217.24.0-255,2902,127221,9,288452
4182,0.003482,172.31.36.0-255,66,127287,9,288452
4183,0.003514,172.217.24.0-255,5738,133025,9,288452
4184,0.003517,172.31.36.0-255,66,133091,9,288452
4185,0.003527,172.31.36.0-255,66,133157,9,288452
4186,0.003556,172.217.24.0-255,4320,137477,9,288452
4187,0.003559,172.31.36.0-255,66,137543,9,288452
4188,0.003568,172.31.36.0-255,66,137609,9,288452
4189,0.00358,172.217.24.0-255,1484,139093,9,288452
4190,0.003583,172.217.24.0-255,766,139859,9,288452
4191,0.003585,172.31.36.0-255,66,139925,9,288452
4192,0.003588,172.217.24.0-255,1484,141409,9,288452
4193,0.003599,172.217.24.0-255,2902,144311,9,288452
4194,0.003602,172.31.36.0-255,66,144377,9,288452
4195,0.00363,172.217.24.0-255,5738,150115,9,288452
4196,0.003632,172.31.36.0-255,66,150181,9,288452
4197,0.003636,172.217.24.0-255,1484,151665,9,288452
4198,0.003638,172.217.24.0-255,1484,153149,9,288452
4199,0.003641,172.31.36.0-255,78,153227,9,288452
4200,0.00365,172.217.24.0-255,4320,157547,9,288452
4201,0.003653,172.31.36.0-255,66,157613,9,288452
4202,0.003701,172.217.24.0-255,5738,163351,9,288452
4203,0.003706,172.31.36.0-255,66,163417,9,288452
4204,0.003729,172.217.24.0-255,2902,166319,9,288452
4205,0.003732,172.31.36.0-255,66,166385,9,288452
4206,0.003736,172.217.24.0-255,4320,170705,9,288452
4207,0.003738,172.31.36.0-255,66,170771,9,288452
4208,0.003741,172.217.24.0-255,1484,172255,9,288452
4209,0.003745,172.217.24.0-255,2184,174439,9,288452
4210,0.003747,172.31.36.0-255,66,174505,9,288452
4211,0.00375,172.217.24.0-255,1484,175989,9,288452
4212,0.003754,172.217.24.0-255,2902,178891,9,288452
4213,0.003757,172.31.36.0-255,66,178957,9,288452
4214,0.003763,172.217.24.0-255,5738,184695,9,288452
4215,0.003766,172.31.36.0-255,66,184761,9,288452
4216,0.003807,172.31.36.0-255,66,184827,9,288452
4217,0.003833,172.217.24.0-255,4320,189147,9,288452
4218,0.003836,172.31.36.0-255,66,189213,9,288452
4219,0.00384,172.217.24.0-255,2902,192115,9,288452
4220,0.003843,172.31.36.0-255,66,192181,9,288452
4221,0.003883,172.31.36.0-255,66,192247,9,288452
4222,0.003902,172.217.24.0-255,2902,195149,9,288452
4223,0.003905,172.31.36.0-255,66,195215,9,288452
4224,0.003942,172.31.36.0-255,66,195281,9,288452
4225,0.00395,172.217.24.0-255,7156,202437,9,288452
4226,0.003952,172.31.36.0-255,66,202503,9,288452
4227,0.003956,172.217.24.0-255,2902,205405,9,288452
4228,0.003958,172.31.36.0-255,66,205471,9,288452
4229,0.004001,172.31.36.0-255,66,205537,9,288452
4230,0.004024,172.217.24.0-255,1484,207021,9,288452
4231,0.004045,172.217.24.0-255,2902,209923,9,288452
4232,0.004049,172.31.36.0-255,66,209989,9,288452
4233,0.004055,172.217.24.0-255,5738,215727,9,288452
4234,0.004058,172.31.36.0-255,66,215793,9,288452
4235,0.004062,172.217.24.0-255,4320,220113,9,288452
4236,0.004064,172.31.36.0-255,66,220179,9,288452
4237,0.004095,172.217.24.0-255,2902,223081,9,288452
4238,0.004098,172.31.36.0-255,66,223147,9,288452
4239,0.004103,172.217.24.0-255,4320,227467,9,288452
4240,0.004106,172.31.36.0-255,66,227533,9,288452
4241,0.004145,172.31.36.0-255,66,227599,9,288452
4242,0.004148,172.217.24.0-255,2184,229783,9,288452
4243,0.00415,172.31.36.0-255,66,229849,9,288452
4244,0.004298,172.217.24.0-255,1484,231333,9,288452
4245,0.004302,172.217.24.0-255,1484,232817,9,288452
4246,0.004305,172.31.36.0-255,66,232883,9,288452
4247,0.004319,172.217.24.0-255,1484,234367,9,288452
4248,0.004331,172.217.24.0-255,5738,240105,9,288452
4249,0.004333,172.31.36.0-255,66,240171,9,288452
4250,0.004362,172.217.24.0-255,7156,247327,9,288452
4251,0.004365,172.31.36.0-255,66,247393,9,288452
4252,0.004385,172.217.24.0-255,5738,253131,9,288452
4253,0.004388,172.31.36.0-255,66,253197,9,288452
4254,0.004391,172.217.24.0-255,1484,254681,9,288452
4255,0.004429,172.217.24.0-255,7156,261837,9,288452
4256,0.004448,172.217.24.0-255,4320,266157,9,288452
4257,0.004479,172.217.24.0-255,7156,273313,9,288452
4258,0.004485,172.217.24.0-255,4320,277633,9,288452
4259,0.00452,172.217.24.0-255,3064,280697,9,288452
4260,0.004569,172.217.24.0-255,105,280802,9,288452
4261,0.006753,172.31.36.0-255,66,280868,9,288452
4262,0.009747,172.31.36.0-255,105,280973,9,288452
4263,0.011766,172.217.24.0-255,66,281039,9,288452
4264,0.030023,172.31.36.0-255,172,281211,9,288452
4265,0.030059,172.31.36.0-255,1115,282326,9,288452
4266,0.030099,172.31.36.0-255,1514,283840,9,288452
4267,0.030101,172.31.36.0-255,1514,285354,9,288452
4268,0.030122,172.31.36.0-255,1514,286868,9,288452
4269,0.030124,172.31.36.0-255,1320,288188,9,288452
4270,0.031685,104.244.42.0-255,66,288254,9,288452
4271,0.03176,104.244.42.0-255,66,288320,9,288452
4272,0.031794,104.244.42.0-255,66,288386,9,288452
4273,0.031797,104.244.42.0-255,66,288452,9,288452
4274,0.0,172.31.36.0-255,105,105,9,105
4275,0.0,172.217.194.0-255,150,150,9,276698
4276,1.7e-05,172.31.36.0-255,66,216,9,276698
4277,2.4e-05,172.217.194.0-255,1484,1700,9,276698
4278,2.8e-05,172.31.36.0-255,66,1766,9,276698
4279,3.4e-05,172.217.194.0-255,2902,4668,9,276698
4280,3.8e-05,172.31.36.0-255,66,4734,9,276698
4281,5.6e-05,172.217.194.0-255,4320,9054,9,276698
4282,6e-05,172.31.36.0-255,66,9120,9,276698
4283,0.000111,172.217.194.0-255,4909,14029,9,276698
4284,0.000114,172.31.36.0-255,66,14095,9,276698
4285,0.000144,172.217.194.0-255,1484,15579,9,276698
4286,0.000146,172.31.36.0-255,66,15645,9,276698
4287,0.000161,172.217.194.0-255,4320,19965,9,276698
4288,0.000163,172.31.36.0-255,66,20031,9,276698
4289,0.00019,172.217.194.0-255,7156,27187,9,276698
4290,0.000192,172.31.36.0-255,66,27253,9,276698
4291,0.000196,172.217.194.0-255,1484,28737,9,276698
4292,0.000198,172.31.36.0-255,66,28803,9,276698
4293,0.000233,172.31.36.0-255,66,28869,9,276698
4294,0.000252,172.217.194.0-255,5738,34607,9,276698
4295,0.000254,172.31.36.0-255,66,34673,9,276698
4296,0.000275,172.217.194.0-255,2543,37216,9,276698
4297,0.000277,172.31.36.0-255,66,37282,9,276698
4298,0.000282,172.217.194.0-255,2902,40184,9,276698
4299,0.000284,172.31.36.0-255,66,40250,9,276698
4300,0.000307,172.217.194.0-255,5738,45988,9,276698
4301,0.00031,172.31.36.0-255,66,46054,9,276698
4302,0.000317,172.217.194.0-255,7156,53210,9,276698
4303,0.000319,172.31.36.0-255,66,53276,9,276698
4304,0.00034,172.217.194.0-255,1422,54698,9,276698
4305,0.000343,172.31.36.0-255,66,54764,9,276698
4306,0.000377,172.217.194.0-255,379,55143,9,276698
4307,0.000565,172.217.194.0-255,1484,56627,9,276698
4308,0.000571,172.217.194.0-255,2902,59529,9,276698
4309,0.000582,172.31.36.0-255,66,59595,9,276698
4310,0.000586,172.31.36.0-255,66,59661,9,276698
4311,0.000602,172.217.194.0-255,2902,62563,9,276698
4312,0.000605,172.31.36.0-255,66,62629,9,276698
4313,0.00061,172.217.194.0-255,2902,65531,9,276698
4314,0.000612,172.31.36.0-255,66,65597,9,276698
4315,0.000637,172.217.194.0-255,1484,67081,9,276698
4316,0.000651,172.31.36.0-255,66,67147,9,276698
4317,0.000668,172.31.36.0-255,66,67213,9,276698
4318,0.000684,172.217.194.0-255,3054,70267,9,276698
4319,0.000686,172.31.36.0-255,66,70333,9,276698
4320,0.000718,172.217.194.0-255,4320,74653,9,276698
4321,0.000722,172.217.194.0-255,2543,77196,9,276698
4322,0.000726,172.31.36.0-255,66,77262,9,276698
4323,0.000732,172.31.36.0-255,66,77328,9,276698
4324,0.001055,172.217.194.0-255,1484,78812,9,276698
4325,0.001061,172.217.194.0-255,1484,80296,9,276698
4326,0.001064,172.31.36.0-255,66,80362,9,276698
4327,0.00108,172.217.194.0-255,1484,81846,9,276698
4328,0.001087,172.217.194.0-255,5738,87584,9,276698
4329,0.001089,172.31.36.0-255,66,87650,9,276698
4330,0.001095,172.217.194.0-255,4320,91970,9,276698
4331,0.001098,172.31.36.0-255,66,92036,9,276698
4332,0.001118,172.31.36.0-255,66,92102,9,276698
4333,0.001125,172.217.194.0-255,7156,99258,9,276698
4334,0.001127,172.31.36.0-255,66,99324,9,276698
4335,0.001149,172.217.194.0-255,2902,102226,9,276698
4336,0.001152,172.217.194.0-255,766,102992,9,276698
4337,0.001161,172.31.36.0-255,66,103058,9,276698
4338,0.001381,172.217.194.0-255,1484,104542,9,276698
4339,0.001388,172.217.194.0-255,2902,107444,9,276698
4340,0.001392,172.31.36.0-255,66,107510,9,276698
4341,0.001396,172.217.194.0-255,1484,108994,9,276698
4342,0.001419,172.217.194.0-255,4320,113314,9,276698
4343,0.001421,172.31.36.0-255,66,113380,9,276698
4344,0.001427,172.217.194.0-255,4320,117700,9,276698
4345,0.001429,172.31.36.0-255,66,117766,9,276698
4346,0.001443,172.217.194.0-255,2543,120309,9,276698
4347,0.001445,172.31.36.0-255,66,120375,9,276698
4348,0.001562,172.217.194.0-255,1484,121859,9,276698
4349,0.001568,172.217.194.0-255,2902,124761,9,276698
4350,0.001571,172.31.36.0-255,66,124827,9,276698
4351,0.001631,172.217.194.0-255,5738,130565,9,276698
4352,0.001634,172.31.36.0-255,66,130631,9,276698
4353,0.001645,172.31.36.0-255,66,130697,9,276698
4354,0.00165,172.217.194.0-255,4320,135017,9,276698
4355,0.001653,172.31.36.0-255,66,135083,9,276698
4356,0.001669,172.217.194.0-255,7156,142239,9,276698
4357,0.001674,172.217.194.0-255,2184,144423,9,276698
4358,0.001679,172.31.36.0-255,66,144489,9,276698
4359,0.001818,172.217.194.0-255,1484,145973,9,276698
4360,0.001825,172.217.194.0-255,2902,148875,9,276698
4361,0.001828,172.31.36.0-255,66,148941,9,276698
4362,0.001833,172.217.194.0-255,2902,151843,9,276698
4363,0.001834,172.31.36.0-255,66,151909,9,276698
4364,0.00186,172.217.194.0-255,2902,154811,9,276698
4365,0.001862,172.31.36.0-255,66,154877,9,276698
4366,0.00187,172.217.194.0-255,5738,160615,9,276698
4367,0.001878,172.31.36.0-255,66,160681,9,276698
4368,0.001909,172.217.194.0-255,7156,167837,9,276698
4369,0.001941,172.31.36.0-255,66,167903,9,276698
4370,0.002316,172.217.194.0-255,1484,169387,9,276698
4371,0.002323,172.217.194.0-255,2902,172289,9,276698
4372,0.002327,172.31.36.0-255,66,172355,9,276698
4373,0.002333,172.217.194.0-255,2902,175257,9,276698
4374,0.002335,172.31.36.0-255,66,175323,9,276698
4375,0.002349,172.217.194.0-255,2902,178225,9,276698
4376,0.002352,172.31.36.0-255,66,178291,9,276698
4377,0.002355,172.217.194.0-255,1484,179775,9,276698
4378,0.002394,172.31.36.0-255,66,179841,9,276698
4379,0.002402,172.217.194.0-255,7156,186997,9,276698
4380,0.002437,172.217.194.0-255,3602,190599,9,276698
4381,0.00244,172.217.194.0-255,1484,192083,9,276698
4382,0.002453,172.217.194.0-255,2902,194985,9,276698
4383,0.002501,172.217.194.0-255,1484,196469,9,276698
4384,0.002565,172.217.194.0-255,2184,198653,9,276698
4385,0.002629,172.217.194.0-255,1484,200137,9,276698
4386,0.002633,172.217.194.0-255,1484,201621,9,276698
4387,0.002653,172.217.194.0-255,1484,203105,9,276698
4388,0.00266,172.217.194.0-255,5738,208843,9,276698
4389,0.002674,172.217.194.0-255,1484,210327,9,276698
4390,0.002712,172.217.194.0-255,4320,214647,9,276698
4391,0.002737,172.217.194.0-255,6438,221085,9,276698
4392,0.002775,172.217.194.0-255,4320,225405,9,276698
4393,0.002793,172.217.194.0-255,7156,232561,9,276698
4394,0.002797,172.217.194.0-255,1484,234045,9,276698
4395,0.0028,172.217.194.0-255,1484,235529,9,276698
4396,0.002848,172.217.194.0-255,4320,239849,9,276698
4397,0.002877,172.217.194.0-255,2184,242033,9,276698
4398,0.002879,172.217.194.0-255,1484,243517,9,276698
4399,0.002884,172.217.194.0-255,4320,247837,9,276698
4400,0.002902,172.217.194.0-255,5738,253575,9,276698
4401,0.002904,172.217.194.0-255,1484,255059,9,276698
4402,0.00291,172.217.194.0-255,4320,259379,9,276698
4403,0.002925,172.217.194.0-255,5020,264399,9,276698
4404,0.002928,172.217.194.0-255,1484,265883,9,276698
4405,0.002952,172.217.194.0-255,1484,267367,9,276698
4406,0.002995,172.217.194.0-255,105,267472,9,276698
4407,0.007362,172.31.36.0-255,66,267538,9,276698
4408,0.00917,172.31.36.0-255,105,267643,9,276698
4409,0.011813,172.217.194.0-255,66,267709,9,276698
4410,0.056165,172.31.36.0-255,172,267881,9,276698
4411,0.056198,172.31.36.0-255,1116,268997,9,276698
4412,0.056279,172.31.36.0-255,1514,270511,9,276698
4413,0.056281,172.31.36.0-255,1514,272025,9,276698
4414,0.056285,172.31.36.0-255,1514,273539,9,276698
4415,0.056287,172.31.36.0-255,1514,275053,9,276698
4416,0.056305,172.31.36.0-255,1381,276434,9,276698
4417,0.057837,104.244.42.0-255,66,276500,9,276698
4418,0.057868,104.244.42.0-255,66,276566,9,276698
4419,0.057999,104.244.42.0-255,66,276632,9,276698
4420,0.058012,104.244.42.0-255,66,276698,9,276698
4421,0.0,172.31.36.0-255,105,105,9,459
4422,0.000233,172.31.36.0-255,90,195,9,459
4423,0.000243,172.31.36.0-255,66,261,9,459
4424,0.002827,74.125.24.0-255,66,327,9,459
4425,0.002857,74.125.24.0-255,66,393,9,459
4426,0.002881,172.31.36.0-255,66,459,9,459
4427,0.0,74.125.24.0-255,152,152,9,297885
4428,2.3e-05,172.31.36.0-255,66,218,9,297885
4429,3e-05,74.125.24.0-255,1484,1702,9,297885
4430,3.5e-05,172.31.36.0-255,66,1768,9,297885
4431,4.1e-05,74.125.24.0-255,2902,4670,9,297885
4432,5.2e-05,172.31.36.0-255,66,4736,9,297885
4433,6e-05,74.125.24.0-255,7156,11892,9,297885
4434,6.3e-05,172.31.36.0-255,66,11958,9,297885
4435,6.8e-05,74.125.24.0-255,2080,14038,9,297885
4436,7e-05,172.31.36.0-255,66,14104,9,297885
4437,0.000108,74.125.24.0-255,1484,15588,9,297885
4438,0.00011,172.31.36.0-255,66,15654,9,297885
4439,0.000115,74.125.24.0-255,2902,18556,9,297885
4440,0.000117,172.31.36.0-255,66,18622,9,297885
4441,0.00013,74.125.24.0-255,5738,24360,9,297885
4442,0.000133,172.31.36.0-255,66,24426,9,297885
4443,0.00014,74.125.24.0-255,6797,31223,9,297885
4444,0.000142,172.31.36.0-255,66,31289,9,297885
4445,0.000176,74.125.24.0-255,7156,38445,9,297885
4446,0.000179,172.31.36.0-255,66,38511,9,297885
4447,0.000185,74.125.24.0-255,5738,44249,9,297885
4448,0.000187,172.31.36.0-255,66,44315,9,297885
4449,0.000219,74.125.24.0-255,3961,48276,9,297885
4450,0.000221,172.31.36.0-255,66,48342,9,297885
4451,0.000239,74.125.24.0-255,1484,49826,9,297885
4452,0.000241,172.31.36.0-255,66,49892,9,297885
4453,0.000246,74.125.24.0-255,2902,52794,9,297885
4454,0.000248,172.31.36.0-255,66,52860,9,297885
4455,0.000255,74.125.24.0-255,5738,58598,9,297885
4456,0.00026,172.31.36.0-255,66,58664,9,297885
4457,0.000292,74.125.24.0-255,6797,65461,9,297885
4458,0.000294,172.31.36.0-255,66,65527,9,297885
4459,0.000321,74.125.24.0-255,401,65928,9,297885
4460,0.000352,74.125.24.0-255,341,66269,9,297885
4461,0.000741,74.125.24.0-255,1484,67753,9,297885
4462,0.000746,172.31.36.0-255,66,67819,9,297885
4463,0.000752,74.125.24.0-255,2902,70721,9,297885
4464,0.000754,172.31.36.0-255,66,70787,9,297885
4465,0.000766,74.125.24.0-255,5738,76525,9,297885
4466,0.000768,172.31.36.0-255,66,76591,9,297885
4467,0.000822,172.31.36.0-255,66,76657,9,297885
4468,0.000835,172.31.36.0-255,66,76723,9,297885
4469,0.000838,74.125.24.0-255,766,77489,9,297885
4470,0.001095,74.125.24.0-255,1484,78973,9,297885
4471,0.001099,172.31.36.0-255,66,79039,9,297885
4472,0.001104,74.125.24.0-255,2902,81941,9,297885
4473,0.001106,172.31.36.0-255,66,82007,9,297885
4474,0.001117,74.125.24.0-255,5738,87745,9,297885
4475,0.001119,172.31.36.0-255,66,87811,9,297885
4476,0.001125,74.125.24.0-255,5738,93549,9,297885
4477,0.001127,172.31.36.0-255,66,93615,9,297885
4478,0.001165,74.125.24.0-255,7156,100771,9,297885
4479,0.001168,172.31.36.0-255,66,100837,9,297885
4480,0.001181,172.31.36.0-255,66,100903,9,297885
4481,0.001287,74.125.24.0-255,1484,102387,9,297885
4482,0.001292,74.125.24.0-255,2902,105289,9,297885
4483,0.001295,172.31.36.0-255,66,105355,9,297885
4484,0.0013,74.125.24.0-255,2902,108257,9,297885
4485,0.001303,172.31.36.0-255,66,108323,9,297885
4486,0.001335,74.125.24.0-255,2902,111225,9,297885
4487,0.001338,172.31.36.0-255,66,111291,9,297885
4488,0.001351,172.31.36.0-255,66,111357,9,297885
4489,0.001381,172.31.36.0-255,66,111423,9,297885
4490,0.001971,74.125.24.0-255,1484,112907,9,297885
4491,0.001977,74.125.24.0-255,2902,115809,9,297885
4492,0.001983,172.31.36.0-255,66,115875,9,297885
4493,0.002006,74.125.24.0-255,5738,121613,9,297885
4494,0.002008,172.31.36.0-255,66,121679,9,297885
4495,0.002015,74.125.24.0-255,5738,127417,9,297885
4496,0.002017,172.31.36.0-255,66,127483,9,297885
4497,0.00202,74.125.24.0-255,1484,128967,9,297885
4498,0.002065,172.31.36.0-255,66,129033,9,297885
4499,0.002072,74.125.24.0-255,5020,134053,9,297885
4500,0.002074,172.31.36.0-255,66,134119,9,297885
4501,0.002437,74.125.24.0-255,1484,135603,9,297885
4502,0.002454,74.125.24.0-255,2902,138505,9,297885
4503,0.002458,172.31.36.0-255,66,138571,9,297885
4504,0.002478,74.125.24.0-255,5738,144309,9,297885
4505,0.002481,172.31.36.0-255,66,144375,9,297885
4506,0.002507,74.125.24.0-255,2902,147277,9,297885
4507,0.00251,172.31.36.0-255,66,147343,9,297885
4508,0.002528,74.125.24.0-255,2902,150245,9,297885
4509,0.002531,172.31.36.0-255,66,150311,9,297885
4510,0.002536,74.125.24.0-255,2902,153213,9,297885
4511,0.002538,172.31.36.0-255,66,153279,9,297885
4512,0.002569,74.125.24.0-255,4320,157599,9,297885
4513,0.002572,172.31.36.0-255,66,157665,9,297885
4514,0.002596,74.125.24.0-255,2902,160567,9,297885
4515,0.002599,172.31.36.0-255,66,160633,9,297885
4516,0.002626,74.125.24.0-255,2902,163535,9,297885
4517,0.002629,172.31.36.0-255,66,163601,9,297885
4518,0.002635,74.125.24.0-255,5020,168621,9,297885
4519,0.002637,172.31.36.0-255,66,168687,9,297885
4520,0.005214,74.125.24.0-255,5738,174425,9,297885
4521,0.005221,172.31.36.0-255,66,174491,9,297885
4522,0.007813,74.125.24.0-255,5738,180229,9,297885
4523,0.007822,172.31.36.0-255,66,180295,9,297885
4524,0.010402,74.125.24.0-255,5738,186033,9,297885
4525,0.010409,172.31.36.0-255,66,186099,9,297885
4526,0.013005,74.125.24.0-255,5738,191837,9,297885
4527,0.013016,172.31.36.0-255,66,191903,9,297885
4528,0.015633,74.125.24.0-255,5738,197641,9,297885
4529,0.01565,172.31.36.0-255,66,197707,9,297885
4530,0.018263,74.125.24.0-255,5738,203445,9,297885
4531,0.01828,172.31.36.0-255,66,203511,9,297885
4532,0.020876,74.125.24.0-255,5738,209249,9,297885
4533,0.02089,172.31.36.0-255,66,209315,9,297885
4534,0.023475,74.125.24.0-255,5738,215053,9,297885
4535,0.023487,172.31.36.0-255,66,215119,9,297885
4536,0.026077,74.125.24.0-255,5738,220857,9,297885
4537,0.02609,172.31.36.0-255,66,220923,9,297885
4538,0.028662,74.125.24.0-255,5738,226661,9,297885
4539,0.028671,172.31.36.0-255,66,226727,9,297885
4540,0.031276,74.125.24.0-255,5738,232465,9,297885
4541,0.031285,172.31.36.0-255,66,232531,9,297885
4542,0.033856,74.125.24.0-255,5738,238269,9,297885
4543,0.033865,172.31.36.0-255,66,238335,9,297885
4544,0.036467,74.125.24.0-255,5738,244073,9,297885
4545,0.036478,172.31.36.0-255,66,244139,9,297885
4546,0.039066,74.125.24.0-255,5738,249877,9,297885
4547,0.039075,172.31.36.0-255,66,249943,9,297885
4548,0.0395,172.31.36.0-255,176,250119,9,297885
4549,0.039532,172.31.36.0-255,1070,251189,9,297885
4550,0.041053,104.244.42.0-255,66,251255,9,297885
4551,0.041062,104.244.42.0-255,66,251321,9,297885
4552,0.041653,74.125.24.0-255,2902,254223,9,297885
4553,0.041663,172.31.36.0-255,66,254289,9,297885
4554,0.041692,74.125.24.0-255,2902,257191,9,297885
4555,0.041696,172.31.36.0-255,66,257257,9,297885
4556,0.044267,74.125.24.0-255,5738,262995,9,297885
4557,0.044275,172.31.36.0-255,66,263061,9,297885
4558,0.046859,74.125.24.0-255,5738,268799,9,297885
4559,0.046866,172.31.36.0-255,66,268865,9,297885
4560,0.049474,74.125.24.0-255,5738,274603,9,297885
4561,0.04948,172.31.36.0-255,66,274669,9,297885
4562,0.052067,74.125.24.0-255,5738,280407,9,297885
4563,0.052074,172.31.36.0-255,66,280473,9,297885
4564,0.054644,74.125.24.0-255,5738,286211,9,297885
4565,0.054651,172.31.36.0-255,66,286277,9,297885
4566,0.05724,74.125.24.0-255,5738,292015,9,297885
4567,0.057248,172.31.36.0-255,66,292081,9,297885
4568,0.059833,74.125.24.0-255,5738,297819,9,297885
4569,0.059839,172.31.36.0-255,66,297885,9,297885
4570,0.0,172.31.36.0-255,66,66,9,66
4571,0.0,172.31.36.0-255,105,105,9,105
4572,0.0,172.217.27.0-255,153,153,9,276759
4573,2e-05,172.31.36.0-255,66,219,9,276759
4574,2.7e-05,172.217.27.0-255,1484,1703,9,276759
4575,3.1e-05,172.31.36.0-255,66,1769,9,276759
4576,3.5e-05,172.217.27.0-255,2902,4671,9,276759
4577,3.8e-05,172.31.36.0-255,66,4737,9,276759
4578,5.3e-05,172.217.27.0-255,7156,11893,9,276759
4579,5.6e-05,172.31.36.0-255,66,11959,9,276759
4580,5.9e-05,172.217.27.0-255,2012,13971,9,276759
4581,6.2e-05,172.31.36.0-255,66,14037,9,276759
4582,0.000113,172.217.27.0-255,1484,15521,9,276759
4583,0.000115,172.31.36.0-255,66,15587,9,276759
4584,0.00012,172.217.27.0-255,2902,18489,9,276759
4585,0.000122,172.31.36.0-255,66,18555,9,276759
4586,0.000153,172.217.27.0-255,5738,24293,9,276759
4587,0.000156,172.31.36.0-255,66,24359,9,276759
4588,0.000161,172.217.27.0-255,4320,28679,9,276759
4589,0.000163,172.31.36.0-255,66,28745,9,276759
4590,0.000203,172.217.27.0-255,2543,31288,9,276759
4591,0.000205,172.31.36.0-255,66,31354,9,276759
4592,0.000346,172.217.27.0-255,1484,32838,9,276759
4593,0.00035,172.31.36.0-255,66,32904,9,276759
4594,0.000355,172.217.27.0-255,2902,35806,9,276759
4595,0.000358,172.31.36.0-255,66,35872,9,276759
4596,0.00036,172.217.27.0-255,1484,37356,9,276759
4597,0.000362,172.31.36.0-255,66,37422,9,276759
4598,0.000389,172.217.27.0-255,4320,41742,9,276759
4599,0.000391,172.31.36.0-255,66,41808,9,276759
4600,0.000399,172.217.27.0-255,2902,44710,9,276759
4601,0.000401,172.31.36.0-255,66,44776,9,276759
4602,0.000442,172.31.36.0-255,66,44842,9,276759
4603,0.000452,172.31.36.0-255,66,44908,9,276759
4604,0.000459,172.217.27.0-255,394,45302,9,276759
4605,0.001083,172.31.36.0-255,66,45368,9,276759
4606,0.001155,172.217.27.0-255,115,45483,9,276759
4607,0.00118,172.31.36.0-255,66,45549,9,276759
4608,0.001296,172.217.27.0-255,1484,47033,9,276759
4609,0.001304,172.217.27.0-255,2902,49935,9,276759
4610,0.001308,172.31.36.0-255,66,50001,9,276759
4611,0.001315,172.217.27.0-255,5738,55739,9,276759
4612,0.001316,172.31.36.0-255,66,55805,9,276759
4613,0.001321,172.217.27.0-255,4320,60125,9,276759
4614,0.001328,172.31.36.0-255,66,60191,9,276759
4615,0.001372,172.217.27.0-255,4320,64511,9,276759
4616,0.001374,172.31.36.0-255,66,64577,9,276759
4617,0.001398,172.217.27.0-255,1125,65702,9,276759
4618,0.001404,172.217.27.0-255,5738,71440,9,276759
4619,0.001405,172.31.36.0-255,66,71506,9,276759
4620,0.001434,172.31.36.0-255,66,71572,9,276759
4621,0.003064,172.217.27.0-255,5738,77310,9,276759
4622,0.003071,172.31.36.0-255,66,77376,9,276759
4623,0.004705,172.217.27.0-255,5738,83114,9,276759
4624,0.004714,172.31.36.0-255,66,83180,9,276759
4625,0.00637,172.217.27.0-255,5738,88918,9,276759
4626,0.006374,172.31.36.0-255,66,88984,9,276759
4627,0.008014,172.217.27.0-255,5738,94722,9,276759
4628,0.008021,172.31.36.0-255,66,94788,9,276759
4629,0.009862,172.217.27.0-255,5738,100526,9,276759
4630,0.009923,172.31.36.0-255,66,100592,9,276759
4631,0.01157,172.217.27.0-255,5738,106330,9,276759
4632,0.011577,172.31.36.0-255,66,106396,9,276759
4633,0.013218,172.217.27.0-255,5738,112134,9,276759
4634,0.013227,172.31.36.0-255,66,112200,9,276759
4635,0.014857,172.217.27.0-255,5738,117938,9,276759
4636,0.014864,172.31.36.0-255,66,118004,9,276759
4637,0.016516,172.217.27.0-255,5738,123742,9,276759
4638,0.016523,172.31.36.0-255,66,123808,9,276759
4639,0.018173,172.217.27.0-255,5738,129546,9,276759
4640,0.018183,172.31.36.0-255,66,129612,9,276759
4641,0.01982,172.217.27.0-255,5738,135350,9,276759
4642,0.019829,172.31.36.0-255,66,135416,9,276759
4643,0.021459,172.217.27.0-255,5738,141154,9,276759
4644,0.021466,172.31.36.0-255,66,141220,9,276759
4645,0.023104,172.217.27.0-255,5738,146958,9,276759
4646,0.023111,172.31.36.0-255,66,147024,9,276759
4647,0.024755,172.217.27.0-255,5738,152762,9,276759
4648,0.024761,172.31.36.0-255,66,152828,9,276759
4649,0.026382,172.217.27.0-255,5738,158566,9,276759
4650,0.026386,172.31.36.0-255,66,158632,9,276759
4651,0.02803,172.217.27.0-255,5738,164370,9,276759
4652,0.028035,172.31.36.0-255,66,164436,9,276759
4653,0.029669,172.217.27.0-255,5738,170174,9,276759
4654,0.029675,172.31.36.0-255,66,170240,9,276759
4655,0.030017,172.31.36.0-255,172,170412,9,276759
4656,0.03005,172.31.36.0-255,1112,171524,9,276759
4657,0.030093,172.31.36.0-255,565,172089,9,276759
4658,0.031331,172.217.27.0-255,5738,177827,9,276759
4659,0.031337,172.31.36.0-255,66,177893,9,276759
4660,0.031537,104.244.42.0-255,66,177959,9,276759
4661,0.031578,104.244.42.0-255,66,178025,9,276759
4662,0.031623,104.244.42.0-255,66,178091,9,276759
4663,0.032965,172.217.27.0-255,5738,183829,9,276759
4664,0.032971,172.31.36.0-255,66,183895,9,276759
4665,0.034606,172.217.27.0-255,5738,189633,9,276759
4666,0.034613,172.31.36.0-255,66,189699,9,276759
4667,0.036244,172.217.27.0-255,5738,195437,9,276759
4668,0.03625,172.31.36.0-255,66,195503,9,276759
4669,0.037871,172.217.27.0-255,5738,201241,9,276759
4670,0.037877,172.31.36.0-255,66,201307,9,276759
4671,0.039507,172.217.27.0-255,5738,207045,9,276759
4672,0.039513,172.31.36.0-255,66,207111,9,276759
4673,0.04118,172.217.27.0-255,5738,212849,9,276759
4674,0.0412,172.31.36.0-255,66,212915,9,276759
4675,0.042824,172.217.27.0-255,5738,218653,9,276759
4676,0.042828,172.31.36.0-255,66,218719,9,276759
4677,0.044473,172.217.27.0-255,5738,224457,9,276759
4678,0.044479,172.31.36.0-255,66,224523,9,276759
4679,0.046113,172.217.27.0-255,5738,230261,9,276759
4680,0.04612,172.31.36.0-255,66,230327,9,276759
4681,0.047745,172.217.27.0-255,5738,236065,9,276759
4682,0.047751,172.31.36.0-255,66,236131,9,276759
4683,0.04938,172.217.27.0-255,5738,241869,9,276759
4684,0.049388,172.31.36.0-255,66,241935,9,276759
4685,0.051026,172.217.27.0-255,5738,247673,9,276759
4686,0.051032,172.31.36.0-255,66,247739,9,276759
4687,0.052674,172.217.27.0-255,5738,253477,9,276759
4688,0.052681,172.31.36.0-255,66,253543,9,276759
4689,0.054317,172.217.27.0-255,5738,259281,9,276759
4690,0.054322,172.31.36.0-255,66,259347,9,276759
4691,0.055957,172.217.27.0-255,5738,265085,9,276759
4692,0.055963,172.31.36.0-255,66,265151,9,276759
4693,0.057594,172.217.27.0-255,5738,270889,9,276759
4694,0.0576,172.31.36.0-255,66,270955,9,276759
4695,0.059271,172.217.27.0-255,5738,276693,9,276759
4696,0.059275,172.31.36.0-255,66,276759,9,276759
4697,0.0,172.217.194.0-255,146,146,9,208464
4698,3.4e-05,172.31.36.0-255,66,212,9,208464
4699,4.1e-05,172.217.194.0-255,1484,1696,9,208464
4700,4.6e-05,172.31.36.0-255,66,1762,9,208464
4701,5.2e-05,172.217.194.0-255,2902,4664,9,208464
4702,5.5e-05,172.31.36.0-255,66,4730,9,208464
4703,5.9e-05,172.217.194.0-255,2902,7632,9,208464
4704,6.2e-05,172.31.36.0-255,66,7698,9,208464
4705,6.8e-05,172.217.194.0-255,4320,12018,9,208464
4706,7e-05,172.31.36.0-255,66,12084,9,208464
4707,9.2e-05,172.217.194.0-255,3453,15537,9,208464
4708,9.5e-05,172.217.194.0-255,2902,18439,9,208464
4709,9.7e-05,172.31.36.0-255,66,18505,9,208464
4710,0.0001,172.31.36.0-255,66,18571,9,208464
4711,0.000119,172.217.194.0-255,7156,25727,9,208464
4712,0.000121,172.31.36.0-255,66,25793,9,208464
4713,0.000148,172.217.194.0-255,5379,31172,9,208464
4714,0.000151,172.31.36.0-255,66,31238,9,208464
4715,0.000183,172.217.194.0-255,1484,32722,9,208464
4716,0.000186,172.31.36.0-255,66,32788,9,208464
4717,0.000193,172.217.194.0-255,2902,35690,9,208464
4718,0.000195,172.31.36.0-255,66,35756,9,208464
4719,0.0002,172.217.194.0-255,4320,40076,9,208464
4720,0.000202,172.31.36.0-255,66,40142,9,208464
4721,0.000232,172.31.36.0-255,66,40208,9,208464
4722,0.000241,172.217.194.0-255,1125,41333,9,208464
4723,0.000244,172.31.36.0-255,66,41399,9,208464
4724,0.000285,172.31.36.0-255,66,41465,9,208464
4725,0.00035,172.217.194.0-255,377,41842,9,208464
4726,0.000353,172.31.36.0-255,66,41908,9,208464
4727,0.000457,172.217.194.0-255,1484,43392,9,208464
4728,0.000461,172.31.36.0-255,66,43458,9,208464
4729,0.000466,172.217.194.0-255,2902,46360,9,208464
4730,0.000469,172.31.36.0-255,66,46426,9,208464
4731,0.000473,172.217.194.0-255,1484,47910,9,208464
4732,0.000475,172.31.36.0-255,66,47976,9,208464
4733,0.000507,172.217.194.0-255,4320,52296,9,208464
4734,0.00051,172.31.36.0-255,66,52362,9,208464
4735,0.000521,172.31.36.0-255,66,52428,9,208464
4736,0.000528,172.217.194.0-255,5738,58166,9,208464
4737,0.000532,172.31.36.0-255,66,58232,9,208464
4738,0.000551,172.217.194.0-255,2902,61134,9,208464
4739,0.000554,172.31.36.0-255,66,61200,9,208464
4740,0.000561,172.217.194.0-255,6517,67717,9,208464
4741,0.000574,172.31.36.0-255,66,67783,9,208464
4742,0.00062,172.217.194.0-255,1484,69267,9,208464
4743,0.000625,172.217.194.0-255,2902,72169,9,208464
4744,0.000627,172.217.194.0-255,1484,73653,9,208464
4745,0.000629,172.31.36.0-255,66,73719,9,208464
4746,0.000649,172.217.194.0-255,4320,78039,9,208464
4747,0.000652,172.217.194.0-255,1484,79523,9,208464
4748,0.000657,172.31.36.0-255,66,79589,9,208464
4749,0.000683,172.217.194.0-255,1484,81073,9,208464
4750,0.000685,172.31.36.0-255,66,81139,9,208464
4751,0.000708,172.217.194.0-255,2902,84041,9,208464
4752,0.000723,172.31.36.0-255,66,84107,9,208464
4753,0.000735,172.217.194.0-255,6438,90545,9,208464
4754,0.000744,172.31.36.0-255,66,90611,9,208464
4755,0.000772,172.217.194.0-255,1484,92095,9,208464
4756,0.000808,172.31.36.0-255,66,92161,9,208464
4757,0.000824,172.31.36.0-255,66,92227,9,208464
4758,0.000864,172.31.36.0-255,66,92293,9,208464
4759,0.000883,172.217.194.0-255,2543,94836,9,208464
4760,0.000894,172.31.36.0-255,66,94902,9,208464
4761,0.00105,172.217.194.0-255,1484,96386,9,208464
4762,0.001056,172.217.194.0-255,2902,99288,9,208464
4763,0.001059,172.31.36.0-255,66,99354,9,208464
4764,0.001083,172.217.194.0-255,5738,105092,9,208464
4765,0.001089,172.31.36.0-255,66,105158,9,208464
4766,0.001115,172.31.36.0-255,66,105224,9,208464
4767,0.001133,172.217.194.0-255,7156,112380,9,208464
4768,0.001139,172.31.36.0-255,66,112446,9,208464
4769,0.001147,172.217.194.0-255,3602,116048,9,208464
4770,0.001155,172.31.36.0-255,66,116114,9,208464
4771,0.001255,172.217.194.0-255,1484,117598,9,208464
4772,0.00126,172.217.194.0-255,2902,120500,9,208464
4773,0.001263,172.31.36.0-255,66,120566,9,208464
4774,0.001269,172.217.194.0-255,2902,123468,9,208464
4775,0.001281,172.31.36.0-255,66,123534,9,208464
4776,0.001285,172.217.194.0-255,2902,126436,9,208464
4777,0.001288,172.217.194.0-255,1484,127920,9,208464
4778,0.001294,172.31.36.0-255,66,127986,9,208464
4779,0.001336,172.31.36.0-255,66,128052,9,208464
4780,0.00135,172.31.36.0-255,66,128118,9,208464
4781,0.001831,172.217.194.0-255,1484,129602,9,208464
4782,0.001837,172.217.194.0-255,2902,132504,9,208464
4783,0.001841,172.31.36.0-255,66,132570,9,208464
4784,0.001847,172.217.194.0-255,4320,136890,9,208464
4785,0.001858,172.31.36.0-255,66,136956,9,208464
4786,0.001863,172.217.194.0-255,1484,138440,9,208464
4787,0.00187,172.217.194.0-255,5738,144178,9,208464
4788,0.001879,172.31.36.0-255,66,144244,9,208464
4789,0.001888,172.217.194.0-255,7156,151400,9,208464
4790,0.001892,172.217.194.0-255,2902,154302,9,208464
4791,0.001898,172.31.36.0-255,66,154368,9,208464
4792,0.001923,172.31.36.0-255,66,154434,9,208464
4793,0.002469,172.217.194.0-255,1484,155918,9,208464
4794,0.002475,172.31.36.0-255,66,155984,9,208464
4795,0.00248,172.217.194.0-255,2902,158886,9,208464
4796,0.002483,172.31.36.0-255,66,158952,9,208464
4797,0.002487,172.217.194.0-255,2902,161854,9,208464
4798,0.002491,172.31.36.0-255,66,161920,9,208464
4799,0.002502,172.217.194.0-255,2902,164822,9,208464
4800,0.002518,172.217.194.0-255,4320,169142,9,208464
4801,0.002524,172.31.36.0-255,66,169208,9,208464
4802,0.002548,172.31.36.0-255,66,169274,9,208464
4803,0.002563,172.31.36.0-255,66,169340,9,208464
4804,0.002603,172.217.194.0-255,1484,170824,9,208464
4805,0.002622,172.217.194.0-255,2902,173726,9,208464
4806,0.002626,172.31.36.0-255,66,173792,9,208464
4807,0.002632,172.217.194.0-255,5738,179530,9,208464
4808,0.002641,172.31.36.0-255,66,179596,9,208464
4809,0.002656,172.31.36.0-255,66,179662,9,208464
4810,0.002666,172.217.194.0-255,2902,182564,9,208464
4811,0.002672,172.31.36.0-255,66,182630,9,208464
4812,0.002686,172.31.36.0-255,66,182696,9,208464
4813,0.002722,172.31.36.0-255,66,182762,9,208464
4814,0.002734,172.217.194.0-255,2902,185664,9,208464
4815,0.00275,172.31.36.0-255,66,185730,9,208464
4816,0.00275,172.217.194.0-255,4320,190050,9,208464
4817,0.002754,172.31.36.0-255,66,190116,9,208464
4818,0.002793,172.217.194.0-255,4320,194436,9,208464
4819,0.002793,172.31.36.0-255,66,194502,9,208464
4820,0.002798,172.31.36.0-255,66,194568,9,208464
4821,0.002808,172.217.194.0-255,4320,198888,9,208464
4822,0.002811,172.31.36.0-255,66,198954,9,208464
4823,0.002821,172.217.194.0-255,2902,201856,9,208464
4824,0.002826,172.31.36.0-255,66,201922,9,208464
4825,0.002845,172.217.194.0-255,105,202027,9,208464
4826,0.002849,172.31.36.0-255,66,202093,9,208464
4827,0.003758,172.31.36.0-255,105,202198,9,208464
4828,0.00628,172.217.194.0-255,66,202264,9,208464
4829,0.04683,172.31.36.0-255,172,202436,9,208464
4830,0.046858,172.31.36.0-255,1117,203553,9,208464
4831,0.046928,172.31.36.0-255,1514,205067,9,208464
4832,0.04693,172.31.36.0-255,1514,206581,9,208464
4833,0.046935,172.31.36.0-255,1514,208095,9,208464
4834,0.046936,172.31.36.0-255,105,208200,9,208464
4835,0.048414,104.244.42.0-255,66,208266,9,208464
4836,0.048467,104.244.42.0-255,66,208332,9,208464
4837,0.048472,104.244.42.0-255,66,208398,9,208464
4838,0.048498,104.244.42.0-255,66,208464,9,208464
4839,0.0,172.31.36.0-255,105,105,9,252366
4840,0.000261,172.31.36.0-255,90,195,9,252366
4841,0.000271,172.31.36.0-255,66,261,9,252366
4842,0.002553,74.125.200.0-255,66,327,9,252366
4843,0.002584,74.125.200.0-255,66,393,9,252366
4844,0.002608,172.31.36.0-255,66,459,9,252366
4845,0.027912,172.217.194.0-255,143,602,9,252366
4846,0.02794,172.217.194.0-255,1484,2086,9,252366
4847,0.027948,172.31.36.0-255,66,2152,9,252366
4848,0.027955,172.217.194.0-255,2902,5054,9,252366
4849,0.027958,172.31.36.0-255,66,5120,9,252366
4850,0.027966,172.217.194.0-255,7156,12276,9,252366
4851,0.02797,172.31.36.0-255,66,12342,9,252366
4852,0.027974,172.217.194.0-255,2025,14367,9,252366
4853,0.027977,172.31.36.0-255,66,14433,9,252366
4854,0.028044,172.217.194.0-255,1484,15917,9,252366
4855,0.028066,172.217.194.0-255,2902,18819,9,252366
4856,0.02807,172.31.36.0-255,66,18885,9,252366
4857,0.028077,172.217.194.0-255,5738,24623,9,252366
4858,0.028079,172.31.36.0-255,66,24689,9,252366
4859,0.028109,172.217.194.0-255,7156,31845,9,252366
4860,0.028111,172.31.36.0-255,66,31911,9,252366
4861,0.028147,172.217.194.0-255,6797,38708,9,252366
4862,0.028151,172.31.36.0-255,66,38774,9,252366
4863,0.028162,172.31.36.0-255,66,38840,9,252366
4864,0.028838,172.217.194.0-255,1484,40324,9,252366
4865,0.028848,172.217.194.0-255,2902,43226,9,252366
4866,0.028853,172.31.36.0-255,66,43292,9,252366
4867,0.028862,172.217.194.0-255,5738,49030,9,252366
4868,0.028864,172.31.36.0-255,66,49096,9,252366
4869,0.028907,172.217.194.0-255,7074,56170,9,252366
4870,0.028909,172.31.36.0-255,66,56236,9,252366
4871,0.029456,172.217.194.0-255,1484,57720,9,252366
4872,0.029465,172.217.194.0-255,2902,60622,9,252366
4873,0.029469,172.31.36.0-255,66,60688,9,252366
4874,0.029477,172.217.194.0-255,5738,66426,9,252366
4875,0.029479,172.31.36.0-255,66,66492,9,252366
4876,0.029523,172.31.36.0-255,66,66558,9,252366
4877,0.02953,172.217.194.0-255,4320,70878,9,252366
4878,0.029532,172.31.36.0-255,66,70944,9,252366
4879,0.029554,172.31.36.0-255,66,71010,9,252366
4880,0.029562,172.217.194.0-255,7156,78166,9,252366
4881,0.029565,172.31.36.0-255,66,78232,9,252366
4882,0.029594,172.31.36.0-255,66,78298,9,252366
4883,0.029597,172.217.194.0-255,1484,79782,9,252366
4884,0.029602,172.217.194.0-255,2902,82684,9,252366
4885,0.029604,172.31.36.0-255,66,82750,9,252366
4886,0.029607,172.217.194.0-255,1484,84234,9,252366
4887,0.029632,172.217.194.0-255,4320,88554,9,252366
4888,0.029635,172.31.36.0-255,66,88620,9,252366
4889,0.029639,172.217.194.0-255,2902,91522,9,252366
4890,0.029641,172.31.36.0-255,66,91588,9,252366
4891,0.029657,172.217.194.0-255,4084,95672,9,252366
4892,0.029659,172.31.36.0-255,66,95738,9,252366
4893,0.029688,172.217.194.0-255,7156,102894,9,252366
4894,0.029691,172.31.36.0-255,66,102960,9,252366
4895,0.029698,172.217.194.0-255,5738,108698,9,252366
4896,0.0297,172.31.36.0-255,66,108764,9,252366
4897,0.029704,172.217.194.0-255,2902,111666,9,252366
4898,0.029707,172.31.36.0-255,66,111732,9,252366
4899,0.029723,172.217.194.0-255,4320,116052,9,252366
4900,0.029725,172.31.36.0-255,66,116118,9,252366
4901,0.029769,172.31.36.0-255,66,116184,9,252366
4902,0.029874,172.217.194.0-255,1484,117668,9,252366
4903,0.029881,172.217.194.0-255,2902,120570,9,252366
4904,0.029884,172.31.36.0-255,66,120636,9,252366
4905,0.029902,172.217.194.0-255,5738,126374,9,252366
4906,0.029905,172.31.36.0-255,66,126440,9,252366
4907,0.029926,172.217.194.0-255,4320,130760,9,252366
4908,0.029929,172.31.36.0-255,66,130826,9,252366
4909,0.029954,172.31.36.0-255,66,130892,9,252366
4910,0.029967,172.31.36.0-255,66,130958,9,252366
4911,0.029983,172.217.194.0-255,2902,133860,9,252366
4912,0.029985,172.31.36.0-255,66,133926,9,252366
4913,0.030012,172.31.36.0-255,66,133992,9,252366
4914,0.030024,172.31.36.0-255,66,134058,9,252366
4915,0.030058,172.217.194.0-255,1484,135542,9,252366
4916,0.030093,172.31.36.0-255,66,135608,9,252366
4917,0.030175,172.217.194.0-255,1484,137092,9,252366
4918,0.030179,172.217.194.0-255,1484,138576,9,252366
4919,0.030181,172.31.36.0-255,66,138642,9,252366
4920,0.030197,172.217.194.0-255,1484,140126,9,252366
4921,0.030203,172.217.194.0-255,5738,145864,9,252366
4922,0.030205,172.31.36.0-255,66,145930,9,252366
4923,0.03025,172.217.194.0-255,2902,148832,9,252366
4924,0.030253,172.31.36.0-255,66,148898,9,252366
4925,0.030281,172.217.194.0-255,4320,153218,9,252366
4926,0.030288,172.31.36.0-255,66,153284,9,252366
4927,0.030304,172.31.36.0-255,66,153350,9,252366
4928,0.03031,172.217.194.0-255,5020,158370,9,252366
4929,0.030312,172.31.36.0-255,66,158436,9,252366
4930,0.030319,172.217.194.0-255,5738,164174,9,252366
4931,0.030322,172.31.36.0-255,66,164240,9,252366
4932,0.030337,172.31.36.0-255,66,164306,9,252366
4933,0.030347,172.31.36.0-255,66,164372,9,252366
4934,0.03035,172.217.194.0-255,1484,165856,9,252366
4935,0.030353,172.217.194.0-255,1484,167340,9,252366
4936,0.030356,172.31.36.0-255,66,167406,9,252366
4937,0.030359,172.217.194.0-255,766,168172,9,252366
4938,0.030362,172.217.194.0-255,645,168817,9,252366
4939,0.030365,172.217.194.0-255,1484,170301,9,252366
4940,0.030368,172.31.36.0-255,66,170367,9,252366
4941,0.030391,172.217.194.0-255,4320,174687,9,252366
4942,0.030394,172.31.36.0-255,66,174753,9,252366
4943,0.030399,172.217.194.0-255,4320,179073,9,252366
4944,0.030401,172.31.36.0-255,66,179139,9,252366
4945,0.030416,172.217.194.0-255,4320,183459,9,252366
4946,0.030418,172.31.36.0-255,66,183525,9,252366
4947,0.030426,172.217.194.0-255,7156,190681,9,252366
4948,0.030429,172.31.36.0-255,66,190747,9,252366
4949,0.030454,172.217.194.0-255,2902,193649,9,252366
4950,0.030457,172.31.36.0-255,66,193715,9,252366
4951,0.030462,172.217.194.0-255,4320,198035,9,252366
4952,0.030464,172.31.36.0-255,66,198101,9,252366
4953,0.030481,172.217.194.0-255,5020,203121,9,252366
4954,0.030483,172.31.36.0-255,66,203187,9,252366
4955,0.030496,172.217.194.0-255,2902,206089,9,252366
4956,0.030498,172.31.36.0-255,66,206155,9,252366
4957,0.030525,172.217.194.0-255,7156,213311,9,252366
4958,0.030528,172.31.36.0-255,66,213377,9,252366
4959,0.030531,172.217.194.0-255,1484,214861,9,252366
4960,0.030545,172.217.194.0-255,4320,219181,9,252366
4961,0.030549,172.31.36.0-255,66,219247,9,252366
4962,0.030582,172.31.36.0-255,66,219313,9,252366
4963,0.030604,172.217.194.0-255,4320,223633,9,252366
4964,0.030606,172.31.36.0-255,66,223699,9,252366
4965,0.030623,172.217.194.0-255,2184,225883,9,252366
4966,0.030625,172.31.36.0-255,66,225949,9,252366
4967,0.030662,172.217.194.0-255,1484,227433,9,252366
4968,0.03068,172.217.194.0-255,2902,230335,9,252366
4969,0.030683,172.31.36.0-255,66,230401,9,252366
4970,0.030688,172.217.194.0-255,2902,233303,9,252366
4971,0.03069,172.31.36.0-255,66,233369,9,252366
4972,0.030703,172.217.194.0-255,2902,236271,9,252366
4973,0.030705,172.31.36.0-255,66,236337,9,252366
4974,0.030709,172.217.194.0-255,1484,237821,9,252366
4975,0.030737,172.31.36.0-255,66,237887,9,252366
4976,0.030768,172.31.36.0-255,66,237953,9,252366
4977,0.030837,172.217.194.0-255,1484,239437,9,252366
4978,0.030843,172.217.194.0-255,2902,242339,9,252366
4979,0.030846,172.31.36.0-255,66,242405,9,252366
4980,0.030853,172.217.194.0-255,5738,248143,9,252366
4981,0.030855,172.31.36.0-255,66,248209,9,252366
4982,0.030877,172.217.194.0-255,3815,252024,9,252366
4983,0.030879,172.31.36.0-255,66,252090,9,252366
4984,0.030912,172.217.194.0-255,105,252195,9,252366
4985,0.035324,172.31.36.0-255,105,252300,9,252366
4986,0.037621,172.217.194.0-255,66,252366,9,252366
4987,0.0,172.31.36.0-255,105,105,9,105
4988,0.0,172.31.36.0-255,105,105,9,105
4989,0.0,172.31.36.0-255,66,66,9,66
4990,0.0,74.125.24.0-255,296,296,9,255674
4991,1.4e-05,172.31.36.0-255,66,362,9,255674
4992,2.1e-05,74.125.24.0-255,1484,1846,9,255674
4993,2.5e-05,172.31.36.0-255,66,1912,9,255674
4994,3.2e-05,74.125.24.0-255,4320,6232,9,255674
4995,4.4e-05,172.31.36.0-255,66,6298,9,255674
4996,5.2e-05,74.125.24.0-255,7156,13454,9,255674
4997,5.5e-05,172.31.36.0-255,66,13520,9,255674
4998,5.8e-05,74.125.24.0-255,395,13915,9,255674
4999,6e-05,172.31.36.0-255,66,13981,9,255674
5000,0.0001,74.125.24.0-255,1484,15465,9,255674
5001,0.000103,172.31.36.0-255,66,15531,9,255674
5002,0.000109,74.125.24.0-255,4320,19851,9,255674
5003,0.000111,172.31.36.0-255,66,19917,9,255674
5004,0.000128,172.31.36.0-255,66,19983,9,255674
5005,0.000155,74.125.24.0-255,1484,21467,9,255674
5006,0.000157,172.31.36.0-255,66,21533,9,255674
5007,0.000161,74.125.24.0-255,1125,22658,9,255674
5008,0.000163,172.31.36.0-255,66,22724,9,255674
5009,0.000182,172.31.36.0-255,66,22790,9,255674
5010,0.000209,74.125.24.0-255,1484,24274,9,255674
5011,0.000211,172.31.36.0-255,66,24340,9,255674
5012,0.000217,74.125.24.0-255,3961,28301,9,255674
5013,0.00022,172.31.36.0-255,66,28367,9,255674
5014,0.000264,172.31.36.0-255,66,28433,9,255674
5015,0.000291,74.125.24.0-255,3961,32394,9,255674
5016,0.000293,172.31.36.0-255,66,32460,9,255674
5017,0.000296,74.125.24.0-255,396,32856,9,255674
5018,0.000298,172.31.36.0-255,66,32922,9,255674
5019,0.000329,74.125.24.0-255,113,33035,9,255674
5020,0.000474,74.125.24.0-255,1484,34519,9,255674
5021,0.000479,172.31.36.0-255,66,34585,9,255674
5022,0.000483,74.125.24.0-255,1484,36069,9,255674
5023,0.000508,74.125.24.0-255,1484,37553,9,255674
5024,0.00051,172.31.36.0-255,66,37619,9,255674
5025,0.000518,74.125.24.0-255,5738,43357,9,255674
5026,0.00052,172.31.36.0-255,66,43423,9,255674
5027,0.000529,74.125.24.0-255,2902,46325,9,255674
5028,0.000532,172.31.36.0-255,66,46391,9,255674
5029,0.000583,172.31.36.0-255,66,46457,9,255674
5030,0.000595,172.31.36.0-255,66,46523,9,255674
5031,0.000602,74.125.24.0-255,330,46853,9,255674
5032,0.000771,74.125.24.0-255,1484,48337,9,255674
5033,0.000776,172.31.36.0-255,66,48403,9,255674
5034,0.000782,74.125.24.0-255,2902,51305,9,255674
5035,0.000785,172.31.36.0-255,66,51371,9,255674
5036,0.000797,74.125.24.0-255,5738,57109,9,255674
5037,0.000799,172.31.36.0-255,66,57175,9,255674
5038,0.000812,172.31.36.0-255,66,57241,9,255674
5039,0.000823,74.125.24.0-255,1484,58725,9,255674
5040,0.00086,74.125.24.0-255,5738,64463,9,255674
5041,0.000864,172.31.36.0-255,66,64529,9,255674
5042,0.000895,74.125.24.0-255,5020,69549,9,255674
5043,0.000899,172.31.36.0-255,66,69615,9,255674
5044,0.00098,74.125.24.0-255,1484,71099,9,255674
5045,0.000984,74.125.24.0-255,1484,72583,9,255674
5046,0.000987,172.31.36.0-255,66,72649,9,255674
5047,0.001015,74.125.24.0-255,1484,74133,9,255674
5048,0.001022,74.125.24.0-255,5738,79871,9,255674
5049,0.001025,172.31.36.0-255,66,79937,9,255674
5050,0.001032,74.125.24.0-255,7156,87093,9,255674
5051,0.001034,172.31.36.0-255,66,87159,9,255674
5052,0.001041,74.125.24.0-255,5738,92897,9,255674
5053,0.001048,172.31.36.0-255,66,92963,9,255674
5054,0.00109,172.31.36.0-255,66,93029,9,255674
5055,0.001095,74.125.24.0-255,2184,95213,9,255674
5056,0.001097,172.31.36.0-255,66,95279,9,255674
5057,0.001455,74.125.24.0-255,1484,96763,9,255674
5058,0.001462,74.125.24.0-255,2902,99665,9,255674
5059,0.001465,172.31.36.0-255,66,99731,9,255674
5060,0.001496,74.125.24.0-255,2902,102633,9,255674
5061,0.001499,172.31.36.0-255,66,102699,9,255674
5062,0.001508,74.125.24.0-255,7156,109855,9,255674
5063,0.00151,172.31.36.0-255,66,109921,9,255674
5064,0.001536,74.125.24.0-255,1484,111405,9,255674
5065,0.001564,172.31.36.0-255,66,111471,9,255674
5066,0.001627,74.125.24.0-255,5020,116491,9,255674
5067,0.001629,172.31.36.0-255,66,116557,9,255674
5068,0.00257,74.125.24.0-255,1484,118041,9,255674
5069,0.002577,74.125.24.0-255,2902,120943,9,255674
5070,0.002581,172.31.36.0-255,66,121009,9,255674
5071,0.002615,74.125.24.0-255,5738,126747,9,255674
5072,0.002618,172.31.36.0-255,66,126813,9,255674
5073,0.002637,172.31.36.0-255,66,126879,9,255674
5074,0.005234,74.125.24.0-255,5738,132617,9,255674
5075,0.005243,172.31.36.0-255,66,132683,9,255674
5076,0.007868,74.125.24.0-255,5738,138421,9,255674
5077,0.007876,172.31.36.0-255,66,138487,9,255674
5078,0.0105,74.125.24.0-255,5738,144225,9,255674
5079,0.010508,172.31.36.0-255,66,144291,9,255674
5080,0.013128,74.125.24.0-255,4320,148611,9,255674
5081,0.013136,172.31.36.0-255,66,148677,9,255674
5082,0.013168,74.125.24.0-255,1484,150161,9,255674
5083,0.015764,74.125.24.0-255,4320,154481,9,255674
5084,0.015772,172.31.36.0-255,66,154547,9,255674
5085,0.018389,74.125.24.0-255,5738,160285,9,255674
5086,0.018402,172.31.36.0-255,66,160351,9,255674
5087,0.021007,74.125.24.0-255,5738,166089,9,255674
5088,0.021016,172.31.36.0-255,66,166155,9,255674
5089,0.023611,74.125.24.0-255,5738,171893,9,255674
5090,0.023618,172.31.36.0-255,66,171959,9,255674
5091,0.026239,74.125.24.0-255,5738,177697,9,255674
5092,0.026248,172.31.36.0-255,66,177763,9,255674
5093,0.028882,74.125.24.0-255,5738,183501,9,255674
5094,0.028891,172.31.36.0-255,66,183567,9,255674
5095,0.031496,74.125.24.0-255,5738,189305,9,255674
5096,0.031504,172.31.36.0-255,66,189371,9,255674
5097,0.033493,172.31.36.0-255,190,189561,9,255674
5098,0.033527,172.31.36.0-255,1112,190673,9,255674
5099,0.033594,172.31.36.0-255,1514,192187,9,255674
5100,0.033596,172.31.36.0-255,1514,193701,9,255674
5101,0.033597,172.31.36.0-255,1514,195215,9,255674
5102,0.033598,172.31.36.0-255,1514,196729,9,255674
5103,0.033625,172.31.36.0-255,1489,198218,9,255674
5104,0.034121,74.125.24.0-255,5738,203956,9,255674
5105,0.034128,172.31.36.0-255,66,204022,9,255674
5106,0.034991,104.244.42.0-255,66,204088,9,255674
5107,0.035107,104.244.42.0-255,66,204154,9,255674
5108,0.03516,104.244.42.0-255,66,204220,9,255674
5109,0.035203,104.244.42.0-255,66,204286,9,255674
5110,0.035945,104.244.42.0-255,108,204394,9,255674
5111,0.035955,172.31.36.0-255,66,204460,9,255674
5112,0.036736,74.125.24.0-255,4320,208780,9,255674
5113,0.036742,172.31.36.0-255,66,208846,9,255674
5114,0.036786,74.125.24.0-255,1484,210330,9,255674
5115,0.039359,74.125.24.0-255,4320,214650,9,255674
5116,0.039367,172.31.36.0-255,66,214716,9,255674
5117,0.041986,74.125.24.0-255,5738,220454,9,255674
5118,0.041993,172.31.36.0-255,66,220520,9,255674
5119,0.044618,74.125.24.0-255,5738,226258,9,255674
5120,0.044625,172.31.36.0-255,66,226324,9,255674
5121,0.047243,74.125.24.0-255,5738,232062,9,255674
5122,0.04725,172.31.36.0-255,66,232128,9,255674
5123,0.049864,74.125.24.0-255,5738,237866,9,255674
5124,0.04987,172.31.36.0-255,66,237932,9,255674
5125,0.052501,74.125.24.0-255,2902,240834,9,255674
5126,0.052508,172.31.36.0-255,66,240900,9,255674
5127,0.052597,74.125.24.0-255,2902,243802,9,255674
5128,0.052602,172.31.36.0-255,66,243868,9,255674
5129,0.055179,74.125.24.0-255,2902,246770,9,255674
5130,0.055186,172.31.36.0-255,66,246836,9,255674
5131,0.055208,74.125.24.0-255,2902,249738,9,255674
5132,0.055212,172.31.36.0-255,66,249804,9,255674
5133,0.057802,74.125.24.0-255,4320,254124,9,255674
5134,0.057809,172.31.36.0-255,66,254190,9,255674
5135,0.057839,74.125.24.0-255,1484,255674,9,255674
5136,0.0,74.125.24.0-255,149,149,9,231545
5137,2.4e-05,172.31.36.0-255,66,215,9,231545
5138,3.2e-05,74.125.24.0-255,1484,1699,9,231545
5139,3.7e-05,172.31.36.0-255,66,1765,9,231545
5140,5.1e-05,74.125.24.0-255,2902,4667,9,231545
5141,5.4e-05,172.31.36.0-255,66,4733,9,231545
5142,5.7e-05,74.125.24.0-255,1484,6217,9,231545
5143,6e-05,172.31.36.0-255,66,6283,9,231545
5144,6.6e-05,74.125.24.0-255,2902,9185,9,231545
5145,7e-05,172.31.36.0-255,66,9251,9,231545
5146,7.8e-05,74.125.24.0-255,6310,15561,9,231545
5147,8.1e-05,172.31.36.0-255,66,15627,9,231545
5148,8.4e-05,74.125.24.0-255,1484,17111,9,231545
5149,8.6e-05,172.31.36.0-255,66,17177,9,231545
5150,0.00013,74.125.24.0-255,5738,22915,9,231545
5151,0.000133,172.31.36.0-255,66,22981,9,231545
5152,0.000144,172.31.36.0-255,66,23047,9,231545
5153,0.000153,74.125.24.0-255,1484,24531,9,231545
5154,0.000155,172.31.36.0-255,66,24597,9,231545
5155,0.00016,74.125.24.0-255,2902,27499,9,231545
5156,0.000162,172.31.36.0-255,66,27565,9,231545
5157,0.000188,74.125.24.0-255,1484,29049,9,231545
5158,0.00019,172.31.36.0-255,66,29115,9,231545
5159,0.000195,74.125.24.0-255,2902,32017,9,231545
5160,0.000198,172.31.36.0-255,66,32083,9,231545
5161,0.00021,74.125.24.0-255,5738,37821,9,231545
5162,0.000212,172.31.36.0-255,66,37887,9,231545
5163,0.000243,74.125.24.0-255,2543,40430,9,231545
5164,0.000249,172.31.36.0-255,66,40496,9,231545
5165,0.000385,74.125.24.0-255,1484,41980,9,231545
5166,0.00039,172.31.36.0-255,66,42046,9,231545
5167,0.00041,74.125.24.0-255,2902,44948,9,231545
5168,0.000416,74.125.24.0-255,2902,47850,9,231545
5169,0.00044,74.125.24.0-255,2902,50752,9,231545
5170,0.000446,74.125.24.0-255,5738,56490,9,231545
5171,0.000478,74.125.24.0-255,1416,57906,9,231545
5172,0.000549,74.125.24.0-255,135,58041,9,231545
5173,0.000568,172.31.36.0-255,66,58107,9,231545
5174,0.000631,74.125.24.0-255,347,58454,9,231545
5175,0.001119,172.31.36.0-255,66,58520,9,231545
5176,0.001606,74.125.24.0-255,1484,60004,9,231545
5177,0.001617,74.125.24.0-255,2902,62906,9,231545
5178,0.001643,74.125.24.0-255,5738,68644,9,231545
5179,0.001646,74.125.24.0-255,1484,70128,9,231545
5180,0.001673,74.125.24.0-255,5738,75866,9,231545
5181,0.001698,74.125.24.0-255,7156,83022,9,231545
5182,0.002302,74.125.24.0-255,1484,84506,9,231545
5183,0.002895,172.31.36.0-255,66,84572,9,231545
5184,0.005189,74.125.24.0-255,5738,90310,9,231545
5185,0.005195,172.31.36.0-255,66,90376,9,231545
5186,0.007504,74.125.24.0-255,5738,96114,9,231545
5187,0.007512,172.31.36.0-255,66,96180,9,231545
5188,0.009766,74.125.24.0-255,5738,101918,9,231545
5189,0.009774,172.31.36.0-255,66,101984,9,231545
5190,0.01203,74.125.24.0-255,5738,107722,9,231545
5191,0.012039,172.31.36.0-255,66,107788,9,231545
5192,0.014327,74.125.24.0-255,5738,113526,9,231545
5193,0.014337,172.31.36.0-255,66,113592,9,231545
5194,0.01662,74.125.24.0-255,5738,119330,9,231545
5195,0.01663,172.31.36.0-255,66,119396,9,231545
5196,0.018878,74.125.24.0-255,5738,125134,9,231545
5197,0.018887,172.31.36.0-255,66,125200,9,231545
5198,0.021187,74.125.24.0-255,5738,130938,9,231545
5199,0.021195,172.31.36.0-255,66,131004,9,231545
5200,0.023478,74.125.24.0-255,5738,136742,9,231545
5201,0.023487,172.31.36.0-255,66,136808,9,231545
5202,0.025754,74.125.24.0-255,5738,142546,9,231545
5203,0.025762,172.31.36.0-255,66,142612,9,231545
5204,0.028022,74.125.24.0-255,5738,148350,9,231545
5205,0.028031,172.31.36.0-255,66,148416,9,231545
5206,0.030308,74.125.24.0-255,5738,154154,9,231545
5207,0.030317,172.31.36.0-255,66,154220,9,231545
5208,0.032596,74.125.24.0-255,5738,159958,9,231545
5209,0.032603,172.31.36.0-255,66,160024,9,231545
5210,0.03489,74.125.24.0-255,5738,165762,9,231545
5211,0.034898,172.31.36.0-255,66,165828,9,231545
5212,0.037187,74.125.24.0-255,5738,171566,9,231545
5213,0.037197,172.31.36.0-255,66,171632,9,231545
5214,0.038655,172.31.36.0-255,172,171804,9,231545
5215,0.038687,172.31.36.0-255,1112,172916,9,231545
5216,0.038755,172.31.36.0-255,1514,174430,9,231545
5217,0.038756,172.31.36.0-255,1514,175944,9,231545
5218,0.038762,172.31.36.0-255,1514,177458,9,231545
5219,0.038763,172.31.36.0-255,1514,178972,9,231545
5220,0.03878,172.31.36.0-255,1491,180463,9,231545
5221,0.039482,74.125.24.0-255,5738,186201,9,231545
5222,0.039493,172.31.36.0-255,66,186267,9,231545
5223,0.04022,104.244.42.0-255,66,186333,9,231545
5224,0.040245,104.244.42.0-255,66,186399,9,231545
5225,0.040317,104.244.42.0-255,66,186465,9,231545
5226,0.04176,74.125.24.0-255,4320,190785,9,231545
5227,0.041768,172.31.36.0-255,66,190851,9,231545
5228,0.041795,74.125.24.0-255,1484,192335,9,231545
5229,0.044019,74.125.24.0-255,4320,196655,9,231545
5230,0.044027,172.31.36.0-255,66,196721,9,231545
5231,0.046313,74.125.24.0-255,5738,202459,9,231545
5232,0.046354,172.31.36.0-255,66,202525,9,231545
5233,0.048661,74.125.24.0-255,5738,208263,9,231545
5234,0.048668,172.31.36.0-255,66,208329,9,231545
5235,0.050958,74.125.24.0-255,5738,214067,9,231545
5236,0.050968,172.31.36.0-255,66,214133,9,231545
5237,0.053297,74.125.24.0-255,5738,219871,9,231545
5238,0.053303,172.31.36.0-255,66,219937,9,231545
5239,0.055555,74.125.24.0-255,5738,225675,9,231545
5240,0.055562,172.31.36.0-255,66,225741,9,231545
5241,0.057837,74.125.24.0-255,5738,231479,9,231545
5242,0.057845,172.31.36.0-255,66,231545,9,231545
5243,0.0,74.125.24.0-255,153,153,9,236929
5244,1.5e-05,172.31.36.0-255,66,219,9,236929
5245,2.2e-05,74.125.24.0-255,1484,1703,9,236929
5246,2.7e-05,172.31.36.0-255,66,1769,9,236929
5247,3.3e-05,74.125.24.0-255,2902,4671,9,236929
5248,3.7e-05,172.31.36.0-255,66,4737,9,236929
5249,4.6e-05,74.125.24.0-255,7156,11893,9,236929
5250,5e-05,172.31.36.0-255,66,11959,9,236929
5251,5.4e-05,74.125.24.0-255,2080,14039,9,236929
5252,5.6e-05,172.31.36.0-255,66,14105,9,236929
5253,0.000103,74.125.24.0-255,1484,15589,9,236929
5254,0.000105,172.31.36.0-255,66,15655,9,236929
5255,0.00011,74.125.24.0-255,2902,18557,9,236929
5256,0.000112,172.31.36.0-255,66,18623,9,236929
5257,0.000138,74.125.24.0-255,5738,24361,9,236929
5258,0.00014,172.31.36.0-255,66,24427,9,236929
5259,0.000178,74.125.24.0-255,6797,31224,9,236929
5260,0.00018,172.31.36.0-255,66,31290,9,236929
5261,0.000187,74.125.24.0-255,7156,38446,9,236929
5262,0.000189,172.31.36.0-255,66,38512,9,236929
5263,0.000213,172.31.36.0-255,66,38578,9,236929
5264,0.000436,74.125.24.0-255,1484,40062,9,236929
5265,0.000441,172.31.36.0-255,66,40128,9,236929
5266,0.000447,74.125.24.0-255,2902,43030,9,236929
5267,0.000449,172.31.36.0-255,66,43096,9,236929
5268,0.000457,74.125.24.0-255,5738,48834,9,236929
5269,0.00046,172.31.36.0-255,66,48900,9,236929
5270,0.000514,172.31.36.0-255,66,48966,9,236929
5271,0.000541,172.31.36.0-255,66,49032,9,236929
5272,0.000561,74.125.24.0-255,5738,54770,9,236929
5273,0.000563,172.31.36.0-255,66,54836,9,236929
5274,0.000588,74.125.24.0-255,3961,58797,9,236929
5275,0.000591,172.31.36.0-255,66,58863,9,236929
5276,0.000617,74.125.24.0-255,4320,63183,9,236929
5277,0.000621,172.31.36.0-255,66,63249,9,236929
5278,0.00065,172.31.36.0-255,66,63315,9,236929
5279,0.000783,74.125.24.0-255,1484,64799,9,236929
5280,0.000789,74.125.24.0-255,2902,67701,9,236929
5281,0.000792,172.31.36.0-255,66,67767,9,236929
5282,0.000799,74.125.24.0-255,5738,73505,9,236929
5283,0.000801,172.31.36.0-255,66,73571,9,236929
5284,0.000807,74.125.24.0-255,4320,77891,9,236929
5285,0.00081,172.31.36.0-255,66,77957,9,236929
5286,0.00083,74.125.24.0-255,2902,80859,9,236929
5287,0.000833,172.31.36.0-255,66,80925,9,236929
5288,0.000869,74.125.24.0-255,1138,82063,9,236929
5289,0.000881,172.31.36.0-255,66,82129,9,236929
5290,0.000955,74.125.24.0-255,1484,83613,9,236929
5291,0.000961,74.125.24.0-255,2902,86515,9,236929
5292,0.000964,172.31.36.0-255,66,86581,9,236929
5293,0.000988,74.125.24.0-255,5738,92319,9,236929
5294,0.000991,172.31.36.0-255,66,92385,9,236929
5295,0.000995,74.125.24.0-255,2902,95287,9,236929
5296,0.000997,172.31.36.0-255,66,95353,9,236929
5297,0.001021,74.125.24.0-255,1484,96837,9,236929
5298,0.001026,172.31.36.0-255,66,96903,9,236929
5299,0.001068,172.31.36.0-255,66,96969,9,236929
5300,0.001136,74.125.24.0-255,1484,98453,9,236929
5301,0.001157,74.125.24.0-255,2902,101355,9,236929
5302,0.001163,74.125.24.0-255,5738,107093,9,236929
5303,0.001169,172.31.36.0-255,66,107159,9,236929
5304,0.001178,74.125.24.0-255,2902,110061,9,236929
5305,0.001183,172.31.36.0-255,66,110127,9,236929
5306,0.001194,74.125.24.0-255,4320,114447,9,236929
5307,0.00121,74.125.24.0-255,5738,120185,9,236929
5308,0.001217,74.125.24.0-255,7156,127341,9,236929
5309,0.001236,74.125.24.0-255,3602,130943,9,236929
5310,0.001239,172.31.36.0-255,66,131009,9,236929
5311,0.001244,172.31.36.0-255,66,131075,9,236929
5312,0.001311,74.125.24.0-255,1484,132559,9,236929
5313,0.001316,74.125.24.0-255,2902,135461,9,236929
5314,0.001321,172.31.36.0-255,66,135527,9,236929
5315,0.001365,74.125.24.0-255,4320,139847,9,236929
5316,0.00137,172.31.36.0-255,66,139913,9,236929
5317,0.001389,74.125.24.0-255,1484,141397,9,236929
5318,0.001414,74.125.24.0-255,2184,143581,9,236929
5319,0.001419,172.31.36.0-255,66,143647,9,236929
5320,0.001461,74.125.24.0-255,2902,146549,9,236929
5321,0.001464,74.125.24.0-255,1484,148033,9,236929
5322,0.001468,74.125.24.0-255,1484,149517,9,236929
5323,0.001482,74.125.24.0-255,4320,153837,9,236929
5324,0.001498,74.125.24.0-255,4320,158157,9,236929
5325,0.001506,172.31.36.0-255,66,158223,9,236929
5326,0.001561,172.31.36.0-255,66,158289,9,236929
5327,0.001609,74.125.24.0-255,1484,159773,9,236929
5328,0.001612,74.125.24.0-255,1484,161257,9,236929
5329,0.001626,74.125.24.0-255,1484,162741,9,236929
5330,0.001634,74.125.24.0-255,5738,168479,9,236929
5331,0.001637,172.31.36.0-255,66,168545,9,236929
5332,0.001647,74.125.24.0-255,1484,170029,9,236929
5333,0.001654,172.31.36.0-255,66,170095,9,236929
5334,0.001676,74.125.24.0-255,2902,172997,9,236929
5335,0.001709,172.31.36.0-255,66,173063,9,236929
5336,0.001728,74.125.24.0-255,4320,177383,9,236929
5337,0.001761,172.31.36.0-255,66,177449,9,236929
5338,0.001768,74.125.24.0-255,7156,184605,9,236929
5339,0.001773,74.125.24.0-255,4320,188925,9,236929
5340,0.001779,172.31.36.0-255,66,188991,9,236929
5341,0.00179,74.125.24.0-255,3602,192593,9,236929
5342,0.001809,74.125.24.0-255,2902,195495,9,236929
5343,0.001815,172.31.36.0-255,66,195561,9,236929
5344,0.001825,74.125.24.0-255,5738,201299,9,236929
5345,0.001831,74.125.24.0-255,4320,205619,9,236929
5346,0.001835,172.31.36.0-255,66,205685,9,236929
5347,0.001843,74.125.24.0-255,1484,207169,9,236929
5348,0.001881,172.31.36.0-255,66,207235,9,236929
5349,0.0019,74.125.24.0-255,1484,208719,9,236929
5350,0.001921,172.31.36.0-255,66,208785,9,236929
5351,0.00193,74.125.24.0-255,7156,215941,9,236929
5352,0.001943,172.31.36.0-255,66,216007,9,236929
5353,0.001956,74.125.24.0-255,7156,223163,9,236929
5354,0.001994,74.125.24.0-255,4320,227483,9,236929
5355,0.002041,74.125.24.0-255,105,227588,9,236929
5356,0.006914,172.31.36.0-255,66,227654,9,236929
5357,0.00975,172.31.36.0-255,105,227759,9,236929
5358,0.012079,74.125.24.0-255,66,227825,9,236929
5359,0.051601,172.31.36.0-255,167,227992,9,236929
5360,0.051637,172.31.36.0-255,1116,229108,9,236929
5361,0.05172,172.31.36.0-255,1514,230622,9,236929
5362,0.051722,172.31.36.0-255,1514,232136,9,236929
5363,0.051723,172.31.36.0-255,1514,233650,9,236929
5364,0.051725,172.31.36.0-255,1514,235164,9,236929
5365,0.051754,172.31.36.0-255,1501,236665,9,236929
5366,0.053237,104.244.42.0-255,66,236731,9,236929
5367,0.05334,104.244.42.0-255,66,236797,9,236929
5368,0.053397,104.244.42.0-255,66,236863,9,236929
5369,0.053439,104.244.42.0-255,66,236929,9,236929
5370,0.0,172.31.36.0-255,66,66,9,66
5371,0.0,172.31.36.0-255,66,66,9,66
5372,0.0,172.31.36.0-255,66,66,9,66
5373,0.0,172.217.194.0-255,153,153,9,207623
5374,2.6e-05,172.31.36.0-255,66,219,9,207623
5375,3.3e-05,172.217.194.0-255,1484,1703,9,207623
5376,3.6e-05,172.31.36.0-255,66,1769,9,207623
5377,4.1e-05,172.217.194.0-255,2902,4671,9,207623
5378,5.2e-05,172.31.36.0-255,66,4737,9,207623
5379,5.9e-05,172.217.194.0-255,7156,11893,9,207623
5380,6.2e-05,172.31.36.0-255,66,11959,9,207623
5381,6.6e-05,172.217.194.0-255,2049,14008,9,207623
5382,6.9e-05,172.31.36.0-255,66,14074,9,207623
5383,0.00133,172.217.194.0-255,1484,15558,9,207623
5384,0.001337,172.31.36.0-255,66,15624,9,207623
5385,0.001346,172.217.194.0-255,2902,18526,9,207623
5386,0.001348,172.31.36.0-255,66,18592,9,207623
5387,0.001361,172.217.194.0-255,5738,24330,9,207623
5388,0.001363,172.31.36.0-255,66,24396,9,207623
5389,0.00138,172.217.194.0-255,1484,25880,9,207623
5390,0.001383,172.31.36.0-255,66,25946,9,207623
5391,0.001412,172.217.194.0-255,5379,31325,9,207623
5392,0.001416,172.31.36.0-255,66,31391,9,207623
5393,0.003425,172.217.194.0-255,5738,37129,9,207623
5394,0.003431,172.31.36.0-255,66,37195,9,207623
5395,0.005441,172.217.194.0-255,5738,42933,9,207623
5396,0.005448,172.31.36.0-255,66,42999,9,207623
5397,0.007458,172.217.194.0-255,5738,48737,9,207623
5398,0.007466,172.31.36.0-255,66,48803,9,207623
5399,0.009452,172.217.194.0-255,5738,54541,9,207623
5400,0.009461,172.31.36.0-255,66,54607,9,207623
5401,0.011427,172.217.194.0-255,5738,60345,9,207623
5402,0.011436,172.31.36.0-255,66,60411,9,207623
5403,0.013419,172.217.194.0-255,5738,66149,9,207623
5404,0.013426,172.31.36.0-255,66,66215,9,207623
5405,0.015415,172.217.194.0-255,5738,71953,9,207623
5406,0.015428,172.31.36.0-255,66,72019,9,207623
5407,0.0174,172.217.194.0-255,5738,77757,9,207623
5408,0.017408,172.31.36.0-255,66,77823,9,207623
5409,0.019401,172.217.194.0-255,5738,83561,9,207623
5410,0.019408,172.31.36.0-255,66,83627,9,207623
5411,0.021386,172.217.194.0-255,5738,89365,9,207623
5412,0.021394,172.31.36.0-255,66,89431,9,207623
5413,0.023402,172.217.194.0-255,5738,95169,9,207623
5414,0.023407,172.31.36.0-255,66,95235,9,207623
5415,0.024116,172.31.36.0-255,172,95407,9,207623
5416,0.024159,172.31.36.0-255,1112,96519,9,207623
5417,0.024234,172.31.36.0-255,1514,98033,9,207623
5418,0.024236,172.31.36.0-255,1514,99547,9,207623
5419,0.024238,172.31.36.0-255,1514,101061,9,207623
5420,0.024239,172.31.36.0-255,1514,102575,9,207623
5421,0.024269,172.31.36.0-255,1490,104065,9,207623
5422,0.025396,172.217.194.0-255,5738,109803,9,207623
5423,0.025402,172.31.36.0-255,66,109869,9,207623
5424,0.025672,104.244.42.0-255,66,109935,9,207623
5425,0.025726,104.244.42.0-255,66,110001,9,207623
5426,0.02584,104.244.42.0-255,66,110067,9,207623
5427,0.027022,104.244.42.0-255,108,110175,9,207623
5428,0.027044,172.31.36.0-255,66,110241,9,207623
5429,0.027389,172.217.194.0-255,1484,111725,9,207623
5430,0.02742,172.217.194.0-255,4320,116045,9,207623
5431,0.027425,172.31.36.0-255,66,116111,9,207623
5432,0.029411,172.217.194.0-255,5738,121849,9,207623
5433,0.029416,172.31.36.0-255,66,121915,9,207623
5434,0.031399,172.217.194.0-255,5738,127653,9,207623
5435,0.031405,172.31.36.0-255,66,127719,9,207623
5436,0.033413,172.217.194.0-255,5738,133457,9,207623
5437,0.033419,172.31.36.0-255,66,133523,9,207623
5438,0.035397,172.217.194.0-255,5738,139261,9,207623
5439,0.035403,172.31.36.0-255,66,139327,9,207623
5440,0.037369,172.217.194.0-255,5738,145065,9,207623
5441,0.037375,172.31.36.0-255,66,145131,9,207623
5442,0.039364,172.217.194.0-255,5738,150869,9,207623
5443,0.039369,172.31.36.0-255,66,150935,9,207623
5444,0.041347,172.217.194.0-255,5738,156673,9,207623
5445,0.041352,172.31.36.0-255,66,156739,9,207623
5446,0.043383,172.217.194.0-255,5738,162477,9,207623
5447,0.043389,172.31.36.0-255,66,162543,9,207623
5448,0.045373,172.217.194.0-255,5738,168281,9,207623
5449,0.045379,172.31.36.0-255,66,168347,9,207623
5450,0.047344,172.217.194.0-255,5738,174085,9,207623
5451,0.04735,172.31.36.0-255,66,174151,9,207623
5452,0.049339,172.217.194.0-255,5738,179889,9,207623
5453,0.049344,172.31.36.0-255,66,179955,9,207623
5454,0.051326,172.217.194.0-255,5738,185693,9,207623
5455,0.051332,172.31.36.0-255,66,185759,9,207623
5456,0.053304,172.217.194.0-255,5738,191497,9,207623
5457,0.053309,172.31.36.0-255,66,191563,9,207623
5458,0.055271,172.217.194.0-255,4320,195883,9,207623
5459,0.055276,172.31.36.0-255,66,195949,9,207623
5460,0.055307,172.217.194.0-255,1484,197433,9,207623
5461,0.057264,172.217.194.0-255,4320,201753,9,207623
5462,0.057269,172.31.36.0-255,66,201819,9,207623
5463,0.059253,172.217.194.0-255,5738,207557,9,207623
5464,0.059258,172.31.36.0-255,66,207623,9,207623
5465,0.0,172.217.194.0-255,152,152,9,246371
5466,2.5e-05,172.31.36.0-255,66,218,9,246371
5467,3.2e-05,172.217.194.0-255,1484,1702,9,246371
5468,3.6e-05,172.31.36.0-255,66,1768,9,246371
5469,4.1e-05,172.217.194.0-255,2902,4670,9,246371
5470,4.4e-05,172.31.36.0-255,66,4736,9,246371
5471,5.2e-05,172.217.194.0-255,7156,11892,9,246371
5472,5.4e-05,172.31.36.0-255,66,11958,9,246371
5473,8e-05,172.217.194.0-255,2046,14004,9,246371
5474,8.3e-05,172.31.36.0-255,66,14070,9,246371
5475,8.6e-05,172.217.194.0-255,1484,15554,9,246371
5476,8.9e-05,172.31.36.0-255,66,15620,9,246371
5477,0.000102,172.217.194.0-255,1484,17104,9,246371
5478,0.000104,172.31.36.0-255,66,17170,9,246371
5479,0.000109,172.217.194.0-255,2902,20072,9,246371
5480,0.000111,172.31.36.0-255,66,20138,9,246371
5481,0.000134,172.217.194.0-255,4320,24458,9,246371
5482,0.000137,172.31.36.0-255,66,24524,9,246371
5483,0.000139,172.217.194.0-255,1484,26008,9,246371
5484,0.000141,172.31.36.0-255,66,26074,9,246371
5485,0.000169,172.217.194.0-255,4320,30394,9,246371
5486,0.000172,172.31.36.0-255,66,30460,9,246371
5487,0.00019,172.217.194.0-255,1125,31585,9,246371
5488,0.000192,172.31.36.0-255,66,31651,9,246371
5489,0.000196,172.217.194.0-255,1484,33135,9,246371
5490,0.000198,172.31.36.0-255,66,33201,9,246371
5491,0.000212,172.217.194.0-255,4320,37521,9,246371
5492,0.000215,172.31.36.0-255,66,37587,9,246371
5493,0.000238,172.217.194.0-255,4320,41907,9,246371
5494,0.00024,172.31.36.0-255,66,41973,9,246371
5495,0.000275,172.31.36.0-255,66,42039,9,246371
5496,0.000279,172.217.194.0-255,2902,44941,9,246371
5497,0.000281,172.31.36.0-255,66,45007,9,246371
5498,0.000316,172.31.36.0-255,66,45073,9,246371
5499,0.000319,172.217.194.0-255,366,45439,9,246371
5500,0.000521,172.217.194.0-255,1484,46923,9,246371
5501,0.000525,172.31.36.0-255,66,46989,9,246371
5502,0.000531,172.217.194.0-255,2902,49891,9,246371
5503,0.000532,172.31.36.0-255,66,49957,9,246371
5504,0.000535,172.217.194.0-255,1484,51441,9,246371
5505,0.000557,172.217.194.0-255,4320,55761,9,246371
5506,0.000559,172.31.36.0-255,66,55827,9,246371
5507,0.000582,172.217.194.0-255,5738,61565,9,246371
5508,0.000584,172.31.36.0-255,66,61631,9,246371
5509,0.000613,172.217.194.0-255,7156,68787,9,246371
5510,0.000617,172.31.36.0-255,66,68853,9,246371
5511,0.000675,172.31.36.0-255,66,68919,9,246371
5512,0.000764,172.217.194.0-255,1484,70403,9,246371
5513,0.00077,172.217.194.0-255,2902,73305,9,246371
5514,0.000772,172.31.36.0-255,66,73371,9,246371
5515,0.000798,172.217.194.0-255,5738,79109,9,246371
5516,0.000801,172.31.36.0-255,66,79175,9,246371
5517,0.000805,172.217.194.0-255,2902,82077,9,246371
5518,0.000807,172.31.36.0-255,66,82143,9,246371
5519,0.000837,172.31.36.0-255,66,82209,9,246371
5520,0.00085,172.31.36.0-255,66,82275,9,246371
5521,0.002991,172.217.194.0-255,5738,88013,9,246371
5522,0.002997,172.31.36.0-255,66,88079,9,246371
5523,0.005111,172.217.194.0-255,5738,93817,9,246371
5524,0.005118,172.31.36.0-255,66,93883,9,246371
5525,0.007243,172.217.194.0-255,5738,99621,9,246371
5526,0.007249,172.31.36.0-255,66,99687,9,246371
5527,0.009418,172.217.194.0-255,5738,105425,9,246371
5528,0.009425,172.31.36.0-255,66,105491,9,246371
5529,0.011565,172.217.194.0-255,5738,111229,9,246371
5530,0.011574,172.31.36.0-255,66,111295,9,246371
5531,0.013706,172.217.194.0-255,5738,117033,9,246371
5532,0.013713,172.31.36.0-255,66,117099,9,246371
5533,0.015865,172.217.194.0-255,5738,122837,9,246371
5534,0.015876,172.31.36.0-255,66,122903,9,246371
5535,0.018012,172.217.194.0-255,5738,128641,9,246371
5536,0.018023,172.31.36.0-255,66,128707,9,246371
5537,0.020193,172.217.194.0-255,5738,134445,9,246371
5538,0.020201,172.31.36.0-255,66,134511,9,246371
5539,0.022349,172.217.194.0-255,5738,140249,9,246371
5540,0.022356,172.31.36.0-255,66,140315,9,246371
5541,0.024503,172.217.194.0-255,5738,146053,9,246371
5542,0.02451,172.31.36.0-255,66,146119,9,246371
5543,0.026723,172.217.194.0-255,5738,151857,9,246371
5544,0.02673,172.31.36.0-255,66,151923,9,246371
5545,0.029195,172.217.194.0-255,5738,157661,9,246371
5546,0.029202,172.31.36.0-255,66,157727,9,246371
5547,0.031562,172.217.194.0-255,5738,163465,9,246371
5548,0.031568,172.31.36.0-255,66,163531,9,246371
5549,0.03384,172.217.194.0-255,5738,169269,9,246371
5550,0.033847,172.31.36.0-255,66,169335,9,246371
5551,0.035978,172.217.194.0-255,5738,175073,9,246371
5552,0.036002,172.31.36.0-255,66,175139,9,246371
5553,0.038126,172.217.194.0-255,5738,180877,9,246371
5554,0.038134,172.31.36.0-255,66,180943,9,246371
5555,0.039559,172.31.36.0-255,172,181115,9,246371
5556,0.039599,172.31.36.0-255,1116,182231,9,246371
5557,0.039669,172.31.36.0-255,1514,183745,9,246371
5558,0.039671,172.31.36.0-255,1514,185259,9,246371
5559,0.03968,172.31.36.0-255,1514,186773,9,246371
5560,0.039681,172.31.36.0-255,106,186879,9,246371
5561,0.0403,172.217.194.0-255,5738,192617,9,246371
5562,0.04031,172.31.36.0-255,66,192683,9,246371
5563,0.041191,104.244.42.0-255,66,192749,9,246371
5564,0.041245,104.244.42.0-255,66,192815,9,246371
5565,0.041327,104.244.42.0-255,66,192881,9,246371
5566,0.041333,104.244.42.0-255,66,192947,9,246371
5567,0.042436,172.217.194.0-255,2902,195849,9,246371
5568,0.042441,172.31.36.0-255,66,195915,9,246371
5569,0.042472,172.217.194.0-255,2902,198817,9,246371
5570,0.042475,172.31.36.0-255,66,198883,9,246371
5571,0.044586,172.217.194.0-255,2902,201785,9,246371
5572,0.044593,172.31.36.0-255,66,201851,9,246371
5573,0.044616,172.217.194.0-255,2902,204753,9,246371
5574,0.04462,172.31.36.0-255,66,204819,9,246371
5575,0.046725,172.217.194.0-255,2902,207721,9,246371
5576,0.046731,172.31.36.0-255,66,207787,9,246371
5577,0.046765,172.217.194.0-255,2902,210689,9,246371
5578,0.046768,172.31.36.0-255,66,210755,9,246371
5579,0.048858,172.217.194.0-255,2902,213657,9,246371
5580,0.048863,172.31.36.0-255,66,213723,9,246371
5581,0.048892,172.217.194.0-255,2902,216625,9,246371
5582,0.048895,172.31.36.0-255,66,216691,9,246371
5583,0.050974,172.217.194.0-255,2902,219593,9,246371
5584,0.050979,172.31.36.0-255,66,219659,9,246371
5585,0.05108,172.217.194.0-255,2902,222561,9,246371
5586,0.051085,172.31.36.0-255,66,222627,9,246371
5587,0.053086,172.217.194.0-255,2902,225529,9,246371
5588,0.053092,172.31.36.0-255,66,225595,9,246371
5589,0.053184,172.217.194.0-255,2902,228497,9,246371
5590,0.053189,172.31.36.0-255,66,228563,9,246371
5591,0.055203,172.217.194.0-255,2902,231465,9,246371
5592,0.055208,172.31.36.0-255,66,231531,9,246371
5593,0.055304,172.217.194.0-255,2902,234433,9,246371
5594,0.055309,172.31.36.0-255,66,234499,9,246371
5595,0.057328,172.217.194.0-255,2902,237401,9,246371
5596,0.057333,172.31.36.0-255,66,237467,9,246371
5597,0.057427,172.217.194.0-255,2902,240369,9,246371
5598,0.057432,172.31.36.0-255,66,240435,9,246371
5599,0.059452,172.217.194.0-255,2902,243337,9,246371
5600,0.059457,172.31.36.0-255,66,243403,9,246371
5601,0.059565,172.217.194.0-255,2902,246305,9,246371
5602,0.05957,172.31.36.0-255,66,246371,9,246371
5603,0.0,74.125.24.0-255,189,189,9,266075
5604,1.5e-05,74.125.24.0-255,1484,1673,9,266075
5605,2.3e-05,172.31.36.0-255,66,1739,9,266075
5606,3.3e-05,74.125.24.0-255,2902,4641,9,266075
5607,3.8e-05,172.31.36.0-255,66,4707,9,266075
5608,4.6e-05,74.125.24.0-255,7156,11863,9,266075
5609,4.9e-05,172.31.36.0-255,66,11929,9,266075
5610,6.7e-05,74.125.24.0-255,2902,14831,9,266075
5611,7e-05,172.31.36.0-255,66,14897,9,266075
5612,9.3e-05,74.125.24.0-255,4878,19775,9,266075
5613,9.6e-05,172.31.36.0-255,66,19841,9,266075
5614,0.000104,74.125.24.0-255,7156,26997,9,266075
5615,0.000106,172.31.36.0-255,66,27063,9,266075
5616,0.000178,74.125.24.0-255,1484,28547,9,266075
5617,0.000198,74.125.24.0-255,766,29313,9,266075
5618,0.000219,172.31.36.0-255,66,29379,9,266075
5619,0.000383,74.125.24.0-255,1484,30863,9,266075
5620,0.000403,74.125.24.0-255,2902,33765,9,266075
5621,0.000409,74.125.24.0-255,4320,38085,9,266075
5622,0.000441,74.125.24.0-255,131,38216,9,266075
5623,0.000465,172.31.36.0-255,66,38282,9,266075
5624,0.000475,74.125.24.0-255,1484,39766,9,266075
5625,0.000493,74.125.24.0-255,2902,42668,9,266075
5626,0.000497,74.125.24.0-255,2902,45570,9,266075
5627,0.000513,74.125.24.0-255,2902,48472,9,266075
5628,0.000566,74.125.24.0-255,1484,49956,9,266075
5629,0.000573,74.125.24.0-255,5738,55694,9,266075
5630,0.000578,172.31.36.0-255,66,55760,9,266075
5631,0.00061,74.125.24.0-255,2902,58662,9,266075
5632,0.000616,172.31.36.0-255,66,58728,9,266075
5633,0.000627,74.125.24.0-255,2467,61195,9,266075
5634,0.000652,172.31.36.0-255,66,61261,9,266075
5635,0.000701,74.125.24.0-255,1484,62745,9,266075
5636,0.000705,74.125.24.0-255,1484,64229,9,266075
5637,0.000717,172.31.36.0-255,66,64295,9,266075
5638,0.00073,74.125.24.0-255,1484,65779,9,266075
5639,0.000738,74.125.24.0-255,5738,71517,9,266075
5640,0.000749,74.125.24.0-255,1484,73001,9,266075
5641,0.000756,172.31.36.0-255,66,73067,9,266075
5642,0.000804,172.31.36.0-255,66,73133,9,266075
5643,0.00141,74.125.24.0-255,1484,74617,9,266075
5644,0.001417,74.125.24.0-255,2902,77519,9,266075
5645,0.001421,172.31.36.0-255,66,77585,9,266075
5646,0.001443,74.125.24.0-255,5738,83323,9,266075
5647,0.001459,172.31.36.0-255,66,83389,9,266075
5648,0.001477,74.125.24.0-255,1484,84873,9,266075
5649,0.001507,74.125.24.0-255,5738,90611,9,266075
5650,0.001515,172.31.36.0-255,66,90677,9,266075
5651,0.001526,74.125.24.0-255,5020,95697,9,266075
5652,0.001531,172.31.36.0-255,66,95763,9,266075
5653,0.00181,74.125.24.0-255,1484,97247,9,266075
5654,0.001816,74.125.24.0-255,2902,100149,9,266075
5655,0.00182,172.31.36.0-255,66,100215,9,266075
5656,0.001849,74.125.24.0-255,5738,105953,9,266075
5657,0.001855,74.125.24.0-255,4320,110273,9,266075
5658,0.001862,172.31.36.0-255,66,110339,9,266075
5659,0.001872,74.125.24.0-255,4320,114659,9,266075
5660,0.001877,172.31.36.0-255,66,114725,9,266075
5661,0.001888,74.125.24.0-255,5738,120463,9,266075
5662,0.001914,74.125.24.0-255,7156,127619,9,266075
5663,0.001928,74.125.24.0-255,4320,131939,9,266075
5664,0.001941,172.31.36.0-255,66,132005,9,266075
5665,0.001963,74.125.24.0-255,4320,136325,9,266075
5666,0.001976,172.31.36.0-255,66,136391,9,266075
5667,0.002015,74.125.24.0-255,4320,140711,9,266075
5668,0.002029,74.125.24.0-255,5738,146449,9,266075
5669,0.002042,74.125.24.0-255,5738,152187,9,266075
5670,0.002058,74.125.24.0-255,1484,153671,9,266075
5671,0.00206,172.31.36.0-255,66,153737,9,266075
5672,0.002136,74.125.24.0-255,6438,160175,9,266075
5673,0.002226,74.125.24.0-255,1484,161659,9,266075
5674,0.002232,74.125.24.0-255,2902,164561,9,266075
5675,0.002235,74.125.24.0-255,1484,166045,9,266075
5676,0.002247,74.125.24.0-255,4320,170365,9,266075
5677,0.002253,74.125.24.0-255,4320,174685,9,266075
5678,0.002269,74.125.24.0-255,2902,177587,9,266075
5679,0.002274,74.125.24.0-255,2902,180489,9,266075
5680,0.00229,74.125.24.0-255,5738,186227,9,266075
5681,0.002314,74.125.24.0-255,5738,191965,9,266075
5682,0.002319,74.125.24.0-255,2902,194867,9,266075
5683,0.002346,74.125.24.0-255,6438,201305,9,266075
5684,0.002372,74.125.24.0-255,1484,202789,9,266075
5685,0.002379,74.125.24.0-255,7156,209945,9,266075
5686,0.002407,74.125.24.0-255,1484,211429,9,266075
5687,0.002433,74.125.24.0-255,7156,218585,9,266075
5688,0.002436,74.125.24.0-255,1484,220069,9,266075
5689,0.002486,74.125.24.0-255,3602,223671,9,266075
5690,0.002491,74.125.24.0-255,4320,227991,9,266075
5691,0.002494,74.125.24.0-255,1484,229475,9,266075
5692,0.002504,74.125.24.0-255,1484,230959,9,266075
5693,0.002531,74.125.24.0-255,5738,236697,9,266075
5694,0.002534,74.125.24.0-255,1484,238181,9,266075
5695,0.002537,74.125.24.0-255,1484,239665,9,266075
5696,0.002543,74.125.24.0-255,5738,245403,9,266075
5697,0.002584,74.125.24.0-255,7156,252559,9,266075
5698,0.002618,74.125.24.0-255,1484,254043,9,266075
5699,0.002622,74.125.24.0-255,2659,256702,9,266075
5700,0.002624,74.125.24.0-255,105,256807,9,266075
5701,0.005982,172.31.36.0-255,66,256873,9,266075
5702,0.008084,172.31.36.0-255,105,256978,9,266075
5703,0.010346,74.125.24.0-255,66,257044,9,266075
5704,0.04737,172.31.36.0-255,176,257220,9,266075
5705,0.047404,172.31.36.0-255,1115,258335,9,266075
5706,0.04747,172.31.36.0-255,1514,259849,9,266075
5707,0.047471,172.31.36.0-255,1514,261363,9,266075
5708,0.047476,172.31.36.0-255,1514,262877,9,266075
5709,0.047477,172.31.36.0-255,1514,264391,9,266075
5710,0.047496,172.31.36.0-255,1486,265877,9,266075
5711,0.048967,104.244.42.0-255,66,265943,9,266075
5712,0.049007,104.244.42.0-255,66,266009,9,266075
5713,0.049064,104.244.42.0-255,66,266075,9,266075
5714,0.0,74.125.68.0-255,146,146,9,378087
5715,5.1e-05,74.125.68.0-255,1484,1630,9,378087
5716,6e-05,172.31.36.0-255,66,1696,9,378087
5717,6.7e-05,74.125.68.0-255,2902,4598,9,378087
5718,7e-05,172.31.36.0-255,66,4664,9,378087
5719,9.4e-05,74.125.68.0-255,1484,6148,9,378087
5720,0.000111,74.125.68.0-255,2902,9050,9,378087
5721,0.000117,172.31.36.0-255,66,9116,9,378087
5722,0.000124,74.125.68.0-255,4871,13987,9,378087
5723,0.000126,172.31.36.0-255,66,14053,9,378087
5724,0.000327,74.125.68.0-255,1484,15537,9,378087
5725,0.000356,74.125.68.0-255,2902,18439,9,378087
5726,0.00036,172.31.36.0-255,66,18505,9,378087
5727,0.000381,74.125.68.0-255,1484,19989,9,378087
5728,0.000385,74.125.68.0-255,1484,21473,9,378087
5729,0.000387,172.31.36.0-255,66,21539,9,378087
5730,0.0004,74.125.68.0-255,1484,23023,9,378087
5731,0.000404,74.125.68.0-255,1484,24507,9,378087
5732,0.000406,172.31.36.0-255,66,24573,9,378087
5733,0.000433,74.125.68.0-255,4320,28893,9,378087
5734,0.000437,172.31.36.0-255,66,28959,9,378087
5735,0.000442,74.125.68.0-255,2543,31502,9,378087
5736,0.000444,172.31.36.0-255,66,31568,9,378087
5737,0.000558,74.125.68.0-255,1484,33052,9,378087
5738,0.000571,74.125.68.0-255,1484,34536,9,378087
5739,0.000574,172.31.36.0-255,66,34602,9,378087
5740,0.000579,74.125.68.0-255,1484,36086,9,378087
5741,0.000593,74.125.68.0-255,1484,37570,9,378087
5742,0.000595,172.31.36.0-255,66,37636,9,378087
5743,0.000598,74.125.68.0-255,1484,39120,9,378087
5744,0.000622,74.125.68.0-255,4320,43440,9,378087
5745,0.000624,172.31.36.0-255,66,43506,9,378087
5746,0.000631,74.125.68.0-255,5379,48885,9,378087
5747,0.000633,172.31.36.0-255,66,48951,9,378087
5748,0.000671,74.125.68.0-255,5738,54689,9,378087
5749,0.000675,172.31.36.0-255,66,54755,9,378087
5750,0.000679,74.125.68.0-255,2902,57657,9,378087
5751,0.000682,172.31.36.0-255,66,57723,9,378087
5752,0.000694,74.125.68.0-255,1484,59207,9,378087
5753,0.000711,74.125.68.0-255,2902,62109,9,378087
5754,0.000714,172.31.36.0-255,66,62175,9,378087
5755,0.00073,74.125.68.0-255,2902,65077,9,378087
5756,0.000732,172.31.36.0-255,66,65143,9,378087
5757,0.000735,74.125.68.0-255,1402,66545,9,378087
5758,0.000863,74.125.68.0-255,126,66671,9,378087
5759,0.000882,172.31.36.0-255,66,66737,9,378087
5760,0.001213,74.125.68.0-255,1484,68221,9,378087
5761,0.001222,74.125.68.0-255,2902,71123,9,378087
5762,0.001227,172.31.36.0-255,66,71189,9,378087
5763,0.001232,74.125.68.0-255,1484,72673,9,378087
5764,0.001237,74.125.68.0-255,2902,75575,9,378087
5765,0.001239,172.31.36.0-255,66,75641,9,378087
5766,0.001258,74.125.68.0-255,4320,79961,9,378087
5767,0.001262,172.31.36.0-255,66,80027,9,378087
5768,0.001278,74.125.68.0-255,1484,81511,9,378087
5769,0.001283,74.125.68.0-255,2902,84413,9,378087
5770,0.001286,172.31.36.0-255,66,84479,9,378087
5771,0.001313,74.125.68.0-255,7156,91635,9,378087
5772,0.001316,172.31.36.0-255,66,91701,9,378087
5773,0.001348,74.125.68.0-255,5738,97439,9,378087
5774,0.001351,172.31.36.0-255,66,97505,9,378087
5775,0.001365,74.125.68.0-255,5020,102525,9,378087
5776,0.00137,172.31.36.0-255,66,102591,9,378087
5777,0.001377,74.125.68.0-255,7156,109747,9,378087
5778,0.00138,172.31.36.0-255,66,109813,9,378087
5779,0.001408,74.125.68.0-255,4320,114133,9,378087
5780,0.001411,172.31.36.0-255,66,114199,9,378087
5781,0.001418,74.125.68.0-255,7156,121355,9,378087
5782,0.00142,172.31.36.0-255,66,121421,9,378087
5783,0.00143,172.31.36.0-255,66,121487,9,378087
5784,0.001436,74.125.68.0-255,5020,126507,9,378087
5785,0.001438,172.31.36.0-255,66,126573,9,378087
5786,0.001456,74.125.68.0-255,4320,130893,9,378087
5787,0.001459,172.31.36.0-255,66,130959,9,378087
5788,0.001477,74.125.68.0-255,1484,132443,9,378087
5789,0.001494,74.125.68.0-255,4320,136763,9,378087
5790,0.001497,172.31.36.0-255,66,136829,9,378087
5791,0.001519,74.125.68.0-255,5738,142567,9,378087
5792,0.001522,172.31.36.0-255,66,142633,9,378087
5793,0.001525,74.125.68.0-255,1484,144117,9,378087
5794,0.001546,74.125.68.0-255,7156,151273,9,378087
5795,0.00155,172.31.36.0-255,66,151339,9,378087
5796,0.001568,74.125.68.0-255,2902,154241,9,378087
5797,0.001571,172.31.36.0-255,66,154307,9,378087
5798,0.001578,74.125.68.0-255,4320,158627,9,378087
5799,0.001582,172.31.36.0-255,66,158693,9,378087
5800,0.001619,74.125.68.0-255,2184,160877,9,378087
5801,0.001622,172.31.36.0-255,66,160943,9,378087
5802,0.002236,74.125.68.0-255,1484,162427,9,378087
5803,0.002239,74.125.68.0-255,1484,163911,9,378087
5804,0.002241,172.31.36.0-255,66,163977,9,378087
5805,0.002255,74.125.68.0-255,1484,165461,9,378087
5806,0.002266,74.125.68.0-255,2902,168363,9,378087
5807,0.002268,172.31.36.0-255,66,168429,9,378087
5808,0.002286,74.125.68.0-255,2902,171331,9,378087
5809,0.002289,172.31.36.0-255,66,171397,9,378087
5810,0.002292,74.125.68.0-255,1484,172881,9,378087
5811,0.002309,74.125.68.0-255,7156,180037,9,378087
5812,0.002311,172.31.36.0-255,66,180103,9,378087
5813,0.002331,74.125.68.0-255,1484,181587,9,378087
5814,0.002344,172.31.36.0-255,66,181653,9,378087
5815,0.002347,74.125.68.0-255,2184,183837,9,378087
5816,0.002349,172.31.36.0-255,66,183903,9,378087
5817,0.002393,74.125.68.0-255,1484,185387,9,378087
5818,0.002413,74.125.68.0-255,2902,188289,9,378087
5819,0.002416,172.31.36.0-255,66,188355,9,378087
5820,0.002438,74.125.68.0-255,5738,194093,9,378087
5821,0.00244,172.31.36.0-255,66,194159,9,378087
5822,0.002443,74.125.68.0-255,1484,195643,9,378087
5823,0.002446,74.125.68.0-255,1484,197127,9,378087
5824,0.002447,172.31.36.0-255,66,197193,9,378087
5825,0.002462,74.125.68.0-255,2902,200095,9,378087
5826,0.002464,172.31.36.0-255,66,200161,9,378087
5827,0.00249,74.125.68.0-255,5738,205899,9,378087
5828,0.002492,172.31.36.0-255,66,205965,9,378087
5829,0.002497,74.125.68.0-255,5738,211703,9,378087
5830,0.002499,172.31.36.0-255,66,211769,9,378087
5831,0.002523,74.125.68.0-255,6438,218207,9,378087
5832,0.002525,172.31.36.0-255,66,218273,9,378087
5833,0.002579,74.125.68.0-255,1484,219757,9,378087
5834,0.002583,74.125.68.0-255,2902,222659,9,378087
5835,0.002585,172.31.36.0-255,66,222725,9,378087
5836,0.002591,74.125.68.0-255,5738,228463,9,378087
5837,0.002593,172.31.36.0-255,66,228529,9,378087
5838,0.002616,74.125.68.0-255,7156,235685,9,378087
5839,0.002619,172.31.36.0-255,66,235751,9,378087
5840,0.00263,172.31.36.0-255,66,235817,9,378087
5841,0.002659,172.31.36.0-255,66,235883,9,378087
5842,0.002691,74.125.68.0-255,4320,240203,9,378087
5843,0.002694,172.31.36.0-255,66,240269,9,378087
5844,0.002706,74.125.68.0-255,2902,243171,9,378087
5845,0.002709,172.31.36.0-255,66,243237,9,378087
5846,0.002712,74.125.68.0-255,1484,244721,9,378087
5847,0.002716,74.125.68.0-255,2902,247623,9,378087
5848,0.002719,172.31.36.0-255,66,247689,9,378087
5849,0.002721,74.125.68.0-255,1484,249173,9,378087
5850,0.002739,74.125.68.0-255,1484,250657,9,378087
5851,0.002742,172.31.36.0-255,66,250723,9,378087
5852,0.002767,74.125.68.0-255,7156,257879,9,378087
5853,0.00277,172.31.36.0-255,66,257945,9,378087
5854,0.002773,74.125.68.0-255,1484,259429,9,378087
5855,0.0028,74.125.68.0-255,4320,263749,9,378087
5856,0.002803,172.31.36.0-255,66,263815,9,378087
5857,0.002827,74.125.68.0-255,6438,270253,9,378087
5858,0.00283,172.31.36.0-255,66,270319,9,378087
5859,0.002836,74.125.68.0-255,4320,274639,9,378087
5860,0.002838,172.31.36.0-255,66,274705,9,378087
5861,0.002855,74.125.68.0-255,7156,281861,9,378087
5862,0.002861,74.125.68.0-255,4320,286181,9,378087
5863,0.002898,74.125.68.0-255,4320,290501,9,378087
5864,0.002917,74.125.68.0-255,4320,294821,9,378087
5865,0.002936,74.125.68.0-255,5738,300559,9,378087
5866,0.002949,74.125.68.0-255,3602,304161,9,378087
5867,0.002965,74.125.68.0-255,2902,307063,9,378087
5868,0.002983,74.125.68.0-255,1484,308547,9,378087
5869,0.002999,74.125.68.0-255,2902,311449,9,378087
5870,0.003001,74.125.68.0-255,1484,312933,9,378087
5871,0.003003,74.125.68.0-255,1484,314417,9,378087
5872,0.003004,172.31.36.0-255,66,314483,9,378087
5873,0.003012,172.31.36.0-255,66,314549,9,378087
5874,0.003033,74.125.68.0-255,2902,317451,9,378087
5875,0.003044,172.31.36.0-255,66,317517,9,378087
5876,0.003047,74.125.68.0-255,5738,323255,9,378087
5877,0.00305,74.125.68.0-255,1484,324739,9,378087
5878,0.003052,74.125.68.0-255,1484,326223,9,378087
5879,0.003054,74.125.68.0-255,1484,327707,9,378087
5880,0.003061,172.31.36.0-255,66,327773,9,378087
5881,0.003077,74.125.68.0-255,2902,330675,9,378087
5882,0.003081,74.125.68.0-255,1484,332159,9,378087
5883,0.003087,172.31.36.0-255,66,332225,9,378087
5884,0.003101,74.125.68.0-255,4320,336545,9,378087
5885,0.003105,74.125.68.0-255,2184,338729,9,378087
5886,0.00311,172.31.36.0-255,66,338795,9,378087
5887,0.003147,74.125.68.0-255,1484,340279,9,378087
5888,0.003161,74.125.68.0-255,1484,341763,9,378087
5889,0.003164,74.125.68.0-255,1484,343247,9,378087
5890,0.003169,172.31.36.0-255,66,343313,9,378087
5891,0.003182,74.125.68.0-255,2902,346215,9,378087
5892,0.003186,172.31.36.0-255,66,346281,9,378087
5893,0.003189,74.125.68.0-255,5738,352019,9,378087
5894,0.003207,172.31.36.0-255,66,352085,9,378087
5895,0.003214,74.125.68.0-255,2902,354987,9,378087
5896,0.003217,74.125.68.0-255,1484,356471,9,378087
5897,0.003221,172.31.36.0-255,66,356537,9,378087
5898,0.003237,74.125.68.0-255,5738,362275,9,378087
5899,0.003242,172.31.36.0-255,66,362341,9,378087
5900,0.00326,74.125.68.0-255,1484,363825,9,378087
5901,0.003291,172.31.36.0-255,66,363891,9,378087
5902,0.003308,74.125.68.0-255,1484,365375,9,378087
5903,0.003338,172.31.36.0-255,66,365441,9,378087
5904,0.003375,74.125.68.0-255,3277,368718,9,378087
5905,0.003388,172.31.36.0-255,66,368784,9,378087
5906,0.003424,74.125.68.0-255,105,368889,9,378087
5907,0.005779,172.31.36.0-255,105,368994,9,378087
5908,0.008058,74.125.68.0-255,66,369060,9,378087
5909,0.039779,172.31.36.0-255,172,369232,9,378087
5910,0.039811,172.31.36.0-255,1115,370347,9,378087
5911,0.039872,172.31.36.0-255,1514,371861,9,378087
5912,0.039874,172.31.36.0-255,1514,373375,9,378087
5913,0.039875,172.31.36.0-255,1514,374889,9,378087
5914,0.039876,172.31.36.0-255,1514,376403,9,378087
5915,0.039902,172.31.36.0-255,1486,377889,9,378087
5916,0.041312,104.244.42.0-255,66,377955,9,378087
5917,0.041357,104.244.42.0-255,66,378021,9,378087
5918,0.041497,104.244.42.0-255,66,378087,9,378087
5919,0.0,74.125.68.0-255,153,153,9,309015
5920,3.3e-05,172.31.36.0-255,66,219,9,309015
5921,6.3e-05,74.125.68.0-255,1484,1703,9,309015
5922,6.8e-05,172.31.36.0-255,66,1769,9,309015
5923,7.3e-05,74.125.68.0-255,2902,4671,9,309015
5924,7.6e-05,172.31.36.0-255,66,4737,9,309015
5925,8.1e-05,74.125.68.0-255,4320,9057,9,309015
5926,8.4e-05,172.31.36.0-255,66,9123,9,309015
5927,0.00011,74.125.68.0-255,1484,10607,9,309015
5928,0.000113,172.31.36.0-255,66,10673,9,309015
5929,0.000119,74.125.68.0-255,3464,14137,9,309015
5930,0.000122,172.31.36.0-255,66,14203,9,309015
5931,0.000127,74.125.68.0-255,4320,18523,9,309015
5932,0.000129,172.31.36.0-255,66,18589,9,309015
5933,0.000173,172.31.36.0-255,66,18655,9,309015
5934,0.000179,74.125.68.0-255,2543,21198,9,309015
5935,0.000181,172.31.36.0-255,66,21264,9,309015
5936,0.000249,74.125.68.0-255,1484,22748,9,309015
5937,0.000253,172.31.36.0-255,66,22814,9,309015
5938,0.000283,74.125.68.0-255,2902,25716,9,309015
5939,0.000287,172.31.36.0-255,66,25782,9,309015
5940,0.000293,74.125.68.0-255,5738,31520,9,309015
5941,0.000296,172.31.36.0-255,66,31586,9,309015
5942,0.00032,74.125.68.0-255,2902,34488,9,309015
5943,0.000323,172.31.36.0-255,66,34554,9,309015
5944,0.000328,74.125.68.0-255,3961,38515,9,309015
5945,0.000331,172.31.36.0-255,66,38581,9,309015
5946,0.000372,74.125.68.0-255,1484,40065,9,309015
5947,0.000375,172.31.36.0-255,66,40131,9,309015
5948,0.00038,74.125.68.0-255,2902,43033,9,309015
5949,0.000382,172.31.36.0-255,66,43099,9,309015
5950,0.000417,74.125.68.0-255,5738,48837,9,309015
5951,0.000422,74.125.68.0-255,2902,51739,9,309015
5952,0.000423,172.31.36.0-255,66,51805,9,309015
5953,0.000427,74.125.68.0-255,4268,56073,9,309015
5954,0.00043,74.125.68.0-255,114,56187,9,309015
5955,0.000432,172.31.36.0-255,66,56253,9,309015
5956,0.00056,74.125.68.0-255,1484,57737,9,309015
5957,0.000567,74.125.68.0-255,2902,60639,9,309015
5958,0.000573,172.31.36.0-255,66,60705,9,309015
5959,0.000601,74.125.68.0-255,5738,66443,9,309015
5960,0.000609,172.31.36.0-255,66,66509,9,309015
5961,0.000619,74.125.68.0-255,1484,67993,9,309015
5962,0.000638,74.125.68.0-255,2902,70895,9,309015
5963,0.000641,172.31.36.0-255,66,70961,9,309015
5964,0.000671,74.125.68.0-255,5738,76699,9,309015
5965,0.000676,74.125.68.0-255,2902,79601,9,309015
5966,0.00068,172.31.36.0-255,66,79667,9,309015
5967,0.000714,74.125.68.0-255,1484,81151,9,309015
5968,0.000737,74.125.68.0-255,2902,84053,9,309015
5969,0.000741,172.31.36.0-255,66,84119,9,309015
5970,0.000748,74.125.68.0-255,1484,85603,9,309015
5971,0.000776,74.125.68.0-255,4320,89923,9,309015
5972,0.00078,74.125.68.0-255,766,90689,9,309015
5973,0.00079,172.31.36.0-255,66,90755,9,309015
5974,0.000906,74.125.68.0-255,1484,92239,9,309015
5975,0.00091,74.125.68.0-255,1484,93723,9,309015
5976,0.000913,172.31.36.0-255,66,93789,9,309015
5977,0.000941,74.125.68.0-255,2902,96691,9,309015
5978,0.000947,74.125.68.0-255,5738,102429,9,309015
5979,0.000953,172.31.36.0-255,66,102495,9,309015
5980,0.00097,74.125.68.0-255,2902,105397,9,309015
5981,0.00098,172.31.36.0-255,66,105463,9,309015
5982,0.000986,74.125.68.0-255,5738,111201,9,309015
5983,0.000989,74.125.68.0-255,1484,112685,9,309015
5984,0.000994,172.31.36.0-255,66,112751,9,309015
5985,0.001036,74.125.68.0-255,3602,116353,9,309015
5986,0.001036,172.31.36.0-255,66,116419,9,309015
5987,0.001041,172.31.36.0-255,66,116485,9,309015
5988,0.001116,74.125.68.0-255,1484,117969,9,309015
5989,0.001143,74.125.68.0-255,2902,120871,9,309015
5990,0.001147,172.31.36.0-255,66,120937,9,309015
5991,0.001179,74.125.68.0-255,1484,122421,9,309015
5992,0.001192,74.125.68.0-255,2902,125323,9,309015
5993,0.001203,172.31.36.0-255,66,125389,9,309015
5994,0.001235,74.125.68.0-255,1484,126873,9,309015
5995,0.001278,74.125.68.0-255,1484,128357,9,309015
5996,0.001284,172.31.36.0-255,66,128423,9,309015
5997,0.001322,74.125.68.0-255,1484,129907,9,309015
5998,0.001335,74.125.68.0-255,1484,131391,9,309015
5999,0.001338,172.31.36.0-255,66,131457,9,309015
6000,0.001345,74.125.68.0-255,5738,137195,9,309015
6001,0.001349,172.31.36.0-255,66,137261,9,309015
6002,0.00135,74.125.68.0-255,4320,141581,9,309015
6003,0.001353,172.31.36.0-255,66,141647,9,309015
6004,0.001361,74.125.68.0-255,5738,147385,9,309015
6005,0.001365,172.31.36.0-255,66,147451,9,309015
6006,0.001391,74.125.68.0-255,3602,151053,9,309015
6007,0.001403,172.31.36.0-255,66,151119,9,309015
6008,0.001519,74.125.68.0-255,1484,152603,9,309015
6009,0.001524,74.125.68.0-255,2902,155505,9,309015
6010,0.001527,172.31.36.0-255,66,155571,9,309015
6011,0.001531,74.125.68.0-255,1484,157055,9,309015
6012,0.00156,74.125.68.0-255,4320,161375,9,309015
6013,0.001564,172.31.36.0-255,66,161441,9,309015
6014,0.001587,74.125.68.0-255,7156,168597,9,309015
6015,0.00159,172.31.36.0-255,66,168663,9,309015
6016,0.00161,74.125.68.0-255,4320,172983,9,309015
6017,0.001621,172.31.36.0-255,66,173049,9,309015
6018,0.001626,172.31.36.0-255,66,173115,9,309015
6019,0.001635,74.125.68.0-255,2184,175299,9,309015
6020,0.001642,74.125.68.0-255,1484,176783,9,309015
6021,0.001642,172.31.36.0-255,66,176849,9,309015
6022,0.001645,74.125.68.0-255,2902,179751,9,309015
6023,0.001648,74.125.68.0-255,1484,181235,9,309015
6024,0.001657,172.31.36.0-255,66,181301,9,309015
6025,0.001677,74.125.68.0-255,4320,185621,9,309015
6026,0.001679,172.31.36.0-255,66,185687,9,309015
6027,0.001687,74.125.68.0-255,7156,192843,9,309015
6028,0.00169,172.31.36.0-255,66,192909,9,309015
6029,0.001728,74.125.68.0-255,5738,198647,9,309015
6030,0.001733,172.31.36.0-255,66,198713,9,309015
6031,0.001766,74.125.68.0-255,6438,205151,9,309015
6032,0.001771,74.125.68.0-255,2902,208053,9,309015
6033,0.001781,172.31.36.0-255,66,208119,9,309015
6034,0.00181,74.125.68.0-255,5738,213857,9,309015
6035,0.001815,172.31.36.0-255,66,213923,9,309015
6036,0.00185,74.125.68.0-255,5738,219661,9,309015
6037,0.001855,172.31.36.0-255,66,219727,9,309015
6038,0.001867,74.125.68.0-255,2902,222629,9,309015
6039,0.001871,172.31.36.0-255,66,222695,9,309015
6040,0.001899,74.125.68.0-255,6438,229133,9,309015
6041,0.001904,74.125.68.0-255,2902,232035,9,309015
6042,0.001908,172.31.36.0-255,66,232101,9,309015
6043,0.001918,74.125.68.0-255,4320,236421,9,309015
6044,0.001927,172.31.36.0-255,66,236487,9,309015
6045,0.001969,74.125.68.0-255,5738,242225,9,309015
6046,0.001971,172.31.36.0-255,66,242291,9,309015
6047,0.001975,172.31.36.0-255,66,242357,9,309015
6048,0.00201,172.31.36.0-255,66,242423,9,309015
6049,0.002038,74.125.68.0-255,5020,247443,9,309015
6050,0.002048,172.31.36.0-255,66,247509,9,309015
6051,0.002065,172.31.36.0-255,66,247575,9,309015
6052,0.002081,74.125.68.0-255,1484,249059,9,309015
6053,0.002088,74.125.68.0-255,5738,254797,9,309015
6054,0.002098,172.31.36.0-255,66,254863,9,309015
6055,0.002169,172.31.36.0-255,66,254929,9,309015
6056,0.002177,74.125.68.0-255,5738,260667,9,309015
6057,0.002184,172.31.36.0-255,66,260733,9,309015
6058,0.002206,74.125.68.0-255,6438,267171,9,309015
6059,0.002222,172.31.36.0-255,66,267237,9,309015
6060,0.002225,74.125.68.0-255,1484,268721,9,309015
6061,0.002253,74.125.68.0-255,5738,274459,9,309015
6062,0.002259,74.125.68.0-255,4320,278779,9,309015
6063,0.002263,74.125.68.0-255,4320,283099,9,309015
6064,0.002266,172.31.36.0-255,66,283165,9,309015
6065,0.002271,172.31.36.0-255,66,283231,9,309015
6066,0.002274,74.125.68.0-255,1484,284715,9,309015
6067,0.002302,74.125.68.0-255,7156,291871,9,309015
6068,0.002313,172.31.36.0-255,66,291937,9,309015
6069,0.002329,74.125.68.0-255,4320,296257,9,309015
6070,0.002332,74.125.68.0-255,766,297023,9,309015
6071,0.002334,172.31.36.0-255,66,297089,9,309015
6072,0.002359,74.125.68.0-255,4320,301409,9,309015
6073,0.002371,172.31.36.0-255,66,301475,9,309015
6074,0.002392,74.125.68.0-255,97,301572,9,309015
6075,0.002406,172.31.36.0-255,66,301638,9,309015
6076,0.002407,74.125.68.0-255,105,301743,9,309015
6077,0.002436,74.125.68.0-255,129,301872,9,309015
6078,0.003019,172.31.36.0-255,101,301973,9,309015
6079,0.003845,172.31.36.0-255,105,302078,9,309015
6080,0.00387,172.31.36.0-255,105,302183,9,309015
6081,0.00408,172.31.36.0-255,90,302273,9,309015
6082,0.00409,172.31.36.0-255,66,302339,9,309015
6083,0.005627,74.125.68.0-255,66,302405,9,309015
6084,0.006434,74.125.68.0-255,66,302471,9,309015
6085,0.006449,74.125.68.0-255,66,302537,9,309015
6086,0.006661,74.125.68.0-255,66,302603,9,309015
6087,0.006698,74.125.68.0-255,66,302669,9,309015
6088,0.006703,172.31.36.0-255,66,302735,9,309015
6089,0.043595,172.31.36.0-255,172,302907,9,309015
6090,0.043626,172.31.36.0-255,1116,304023,9,309015
6091,0.043686,172.31.36.0-255,1514,305537,9,309015
6092,0.043687,172.31.36.0-255,1514,307051,9,309015
6093,0.043692,172.31.36.0-255,1514,308565,9,309015
6094,0.043693,172.31.36.0-255,186,308751,9,309015
6095,0.04523,104.244.42.0-255,66,308817,9,309015
6096,0.045299,104.244.42.0-255,66,308883,9,309015
6097,0.045332,104.244.42.0-255,66,308949,9,309015
6098,0.045335,104.244.42.0-255,66,309015,9,309015
6099,0.0,172.31.36.0-255,105,105,9,105
6100,0.0,172.31.36.0-255,105,105,9,105
6101,0.0,74.125.200.0-255,153,153,9,361177
6102,1.5e-05,172.31.36.0-255,66,219,9,361177
6103,2.3e-05,74.125.200.0-255,1484,1703,9,361177
6104,2.7e-05,172.31.36.0-255,66,1769,9,361177
6105,3.2e-05,74.125.200.0-255,2902,4671,9,361177
6106,3.5e-05,172.31.36.0-255,66,4737,9,361177
6107,3.8e-05,74.125.200.0-255,1484,6221,9,361177
6108,4.1e-05,172.31.36.0-255,66,6287,9,361177
6109,4.8e-05,74.125.200.0-255,2902,9189,9,361177
6110,5e-05,172.31.36.0-255,66,9255,9,361177
6111,9.2e-05,74.125.200.0-255,4886,14141,9,361177
6112,9.6e-05,172.31.36.0-255,66,14207,9,361177
6113,0.000266,74.125.200.0-255,1484,15691,9,361177
6114,0.000271,172.31.36.0-255,66,15757,9,361177
6115,0.000277,74.125.200.0-255,2902,18659,9,361177
6116,0.00028,172.31.36.0-255,66,18725,9,361177
6117,0.000305,74.125.200.0-255,1484,20209,9,361177
6118,0.000308,172.31.36.0-255,66,20275,9,361177
6119,0.000313,74.125.200.0-255,2902,23177,9,361177
6120,0.000315,172.31.36.0-255,66,23243,9,361177
6121,0.000322,74.125.200.0-255,5738,28981,9,361177
6122,0.000324,172.31.36.0-255,66,29047,9,361177
6123,0.000346,74.125.200.0-255,2543,31590,9,361177
6124,0.000348,172.31.36.0-255,66,31656,9,361177
6125,0.000479,74.125.200.0-255,1484,33140,9,361177
6126,0.000484,172.31.36.0-255,66,33206,9,361177
6127,0.00049,74.125.200.0-255,2902,36108,9,361177
6128,0.000492,172.31.36.0-255,66,36174,9,361177
6129,0.000511,74.125.200.0-255,5738,41912,9,361177
6130,0.000513,172.31.36.0-255,66,41978,9,361177
6131,0.000535,74.125.200.0-255,5738,47716,9,361177
6132,0.000538,172.31.36.0-255,66,47782,9,361177
6133,0.00056,74.125.200.0-255,3961,51743,9,361177
6134,0.000566,74.125.200.0-255,7156,58899,9,361177
6135,0.000571,172.31.36.0-255,66,58965,9,361177
6136,0.000574,172.31.36.0-255,66,59031,9,361177
6137,0.000585,74.125.200.0-255,2902,61933,9,361177
6138,0.000587,172.31.36.0-255,66,61999,9,361177
6139,0.000621,74.125.200.0-255,3961,65960,9,361177
6140,0.000623,172.31.36.0-255,66,66026,9,361177
6141,0.001138,74.125.200.0-255,646,66672,9,361177
6142,0.00128,74.125.200.0-255,1484,68156,9,361177
6143,0.001286,172.31.36.0-255,66,68222,9,361177
6144,0.001292,74.125.200.0-255,2902,71124,9,361177
6145,0.001295,172.31.36.0-255,66,71190,9,361177
6146,0.001299,74.125.200.0-255,2902,74092,9,361177
6147,0.001301,172.31.36.0-255,66,74158,9,361177
6148,0.001307,74.125.200.0-255,4320,78478,9,361177
6149,0.001309,172.31.36.0-255,66,78544,9,361177
6150,0.001343,172.31.36.0-255,66,78610,9,361177
6151,0.001368,74.125.200.0-255,7156,85766,9,361177
6152,0.001371,172.31.36.0-255,66,85832,9,361177
6153,0.001405,74.125.200.0-255,4320,90152,9,361177
6154,0.001407,172.31.36.0-255,66,90218,9,361177
6155,0.001425,74.125.200.0-255,2184,92402,9,361177
6156,0.001428,172.31.36.0-255,66,92468,9,361177
6157,0.001474,74.125.200.0-255,1484,93952,9,361177
6158,0.001478,74.125.200.0-255,1484,95436,9,361177
6159,0.00148,172.31.36.0-255,66,95502,9,361177
6160,0.0015,74.125.200.0-255,1484,96986,9,361177
6161,0.001507,74.125.200.0-255,4320,101306,9,361177
6162,0.001509,172.31.36.0-255,66,101372,9,361177
6163,0.001533,74.125.200.0-255,5738,107110,9,361177
6164,0.001535,172.31.36.0-255,66,107176,9,361177
6165,0.001557,74.125.200.0-255,5738,112914,9,361177
6166,0.001559,172.31.36.0-255,66,112980,9,361177
6167,0.001577,74.125.200.0-255,5738,118718,9,361177
6168,0.001579,172.31.36.0-255,66,118784,9,361177
6169,0.001616,74.125.200.0-255,5738,124522,9,361177
6170,0.001619,172.31.36.0-255,66,124588,9,361177
6171,0.001637,74.125.200.0-255,2184,126772,9,361177
6172,0.001639,172.31.36.0-255,66,126838,9,361177
6173,0.001645,74.125.200.0-255,2902,129740,9,361177
6174,0.001646,172.31.36.0-255,66,129806,9,361177
6175,0.001671,74.125.200.0-255,5738,135544,9,361177
6176,0.001674,172.31.36.0-255,66,135610,9,361177
6177,0.001678,74.125.200.0-255,2902,138512,9,361177
6178,0.00168,172.31.36.0-255,66,138578,9,361177
6179,0.001696,74.125.200.0-255,1484,140062,9,361177
6180,0.001711,74.125.200.0-255,5738,145800,9,361177
6181,0.001714,172.31.36.0-255,66,145866,9,361177
6182,0.001738,74.125.200.0-255,5738,151604,9,361177
6183,0.001741,172.31.36.0-255,66,151670,9,361177
6184,0.001747,74.125.200.0-255,5738,157408,9,361177
6185,0.001749,172.31.36.0-255,66,157474,9,361177
6186,0.001774,74.125.200.0-255,3602,161076,9,361177
6187,0.001777,172.31.36.0-255,66,161142,9,361177
6188,0.001885,74.125.200.0-255,1484,162626,9,361177
6189,0.001892,74.125.200.0-255,2902,165528,9,361177
6190,0.001896,172.31.36.0-255,66,165594,9,361177
6191,0.00192,74.125.200.0-255,5738,171332,9,361177
6192,0.001923,172.31.36.0-255,66,171398,9,361177
6193,0.00193,74.125.200.0-255,5738,177136,9,361177
6194,0.001932,172.31.36.0-255,66,177202,9,361177
6195,0.001947,74.125.200.0-255,1484,178686,9,361177
6196,0.001963,74.125.200.0-255,7156,185842,9,361177
6197,0.001965,172.31.36.0-255,66,185908,9,361177
6198,0.001991,74.125.200.0-255,7156,193064,9,361177
6199,0.001993,172.31.36.0-255,66,193130,9,361177
6200,0.001997,74.125.200.0-255,2184,195314,9,361177
6201,0.001999,172.31.36.0-255,66,195380,9,361177
6202,0.002135,74.125.200.0-255,1484,196864,9,361177
6203,0.002147,74.125.200.0-255,1484,198348,9,361177
6204,0.00215,172.31.36.0-255,66,198414,9,361177
6205,0.002166,74.125.200.0-255,1484,199898,9,361177
6206,0.002169,74.125.200.0-255,1484,201382,9,361177
6207,0.002171,172.31.36.0-255,66,201448,9,361177
6208,0.002195,74.125.200.0-255,4320,205768,9,361177
6209,0.002197,172.31.36.0-255,66,205834,9,361177
6210,0.002204,74.125.200.0-255,7156,212990,9,361177
6211,0.002206,172.31.36.0-255,66,213056,9,361177
6212,0.002218,74.125.200.0-255,1484,214540,9,361177
6213,0.002244,172.31.36.0-255,66,214606,9,361177
6214,0.00228,74.125.200.0-255,5020,219626,9,361177
6215,0.002283,172.31.36.0-255,66,219692,9,361177
6216,0.002311,74.125.200.0-255,5738,225430,9,361177
6217,0.002314,172.31.36.0-255,66,225496,9,361177
6218,0.002334,74.125.200.0-255,2902,228398,9,361177
6219,0.002338,172.31.36.0-255,66,228464,9,361177
6220,0.002397,74.125.200.0-255,4320,232784,9,361177
6221,0.002405,172.31.36.0-255,66,232850,9,361177
6222,0.002409,74.125.200.0-255,2902,235752,9,361177
6223,0.002412,172.31.36.0-255,66,235818,9,361177
6224,0.002415,74.125.200.0-255,1484,237302,9,361177
6225,0.002489,74.125.200.0-255,2902,240204,9,361177
6226,0.002492,172.31.36.0-255,66,240270,9,361177
6227,0.002498,74.125.200.0-255,4320,244590,9,361177
6228,0.0025,172.31.36.0-255,66,244656,9,361177
6229,0.002517,74.125.200.0-255,4320,248976,9,361177
6230,0.002519,172.31.36.0-255,66,249042,9,361177
6231,0.002523,74.125.200.0-255,2902,251944,9,361177
6232,0.002525,172.31.36.0-255,66,252010,9,361177
6233,0.002569,74.125.200.0-255,5738,257748,9,361177
6234,0.002572,172.31.36.0-255,66,257814,9,361177
6235,0.002593,74.125.200.0-255,3602,261416,9,361177
6236,0.002595,172.31.36.0-255,66,261482,9,361177
6237,0.002598,74.125.200.0-255,1484,262966,9,361177
6238,0.002603,74.125.200.0-255,4320,267286,9,361177
6239,0.002605,172.31.36.0-255,66,267352,9,361177
6240,0.002643,172.31.36.0-255,66,267418,9,361177
6241,0.002661,74.125.200.0-255,2902,270320,9,361177
6242,0.002663,172.31.36.0-255,66,270386,9,361177
6243,0.00267,74.125.200.0-255,5020,275406,9,361177
6244,0.002672,172.31.36.0-255,66,275472,9,361177
6245,0.002691,74.125.200.0-255,2902,278374,9,361177
6246,0.002693,172.31.36.0-255,66,278440,9,361177
6247,0.002709,74.125.200.0-255,7156,285596,9,361177
6248,0.002712,172.31.36.0-255,66,285662,9,361177
6249,0.002716,74.125.200.0-255,2902,288564,9,361177
6250,0.002718,172.31.36.0-255,66,288630,9,361177
6251,0.002747,172.31.36.0-255,66,288696,9,361177
6252,0.00275,74.125.200.0-255,1484,290180,9,361177
6253,0.00277,172.31.36.0-255,66,290246,9,361177
6254,0.002775,74.125.200.0-255,2184,292430,9,361177
6255,0.002777,172.31.36.0-255,66,292496,9,361177
6256,0.00278,74.125.200.0-255,1484,293980,9,361177
6257,0.002792,74.125.200.0-255,1484,295464,9,361177
6258,0.002795,172.31.36.0-255,66,295530,9,361177
6259,0.002815,74.125.200.0-255,1484,297014,9,361177
6260,0.00282,74.125.200.0-255,2902,299916,9,361177
6261,0.002822,172.31.36.0-255,66,299982,9,361177
6262,0.002839,74.125.200.0-255,1484,301466,9,361177
6263,0.002846,74.125.200.0-255,5738,307204,9,361177
6264,0.002848,172.31.36.0-255,66,307270,9,361177
6265,0.002856,74.125.200.0-255,7156,314426,9,361177
6266,0.002858,172.31.36.0-255,66,314492,9,361177
6267,0.002901,172.31.36.0-255,66,314558,9,361177
6268,0.00295,74.125.200.0-255,2902,317460,9,361177
6269,0.002952,172.31.36.0-255,66,317526,9,361177
6270,0.002982,172.31.36.0-255,66,317592,9,361177
6271,0.002986,74.125.200.0-255,2902,320494,9,361177
6272,0.002988,172.31.36.0-255,66,320560,9,361177
6273,0.002991,74.125.200.0-255,1484,322044,9,361177
6274,0.002998,74.125.200.0-255,5738,327782,9,361177
6275,0.003,172.31.36.0-255,66,327848,9,361177
6276,0.003021,74.125.200.0-255,2902,330750,9,361177
6277,0.003023,172.31.36.0-255,66,330816,9,361177
6278,0.003026,74.125.200.0-255,1484,332300,9,361177
6279,0.003051,74.125.200.0-255,2902,335202,9,361177
6280,0.003053,172.31.36.0-255,66,335268,9,361177
6281,0.003072,74.125.200.0-255,3602,338870,9,361177
6282,0.003075,172.31.36.0-255,66,338936,9,361177
6283,0.003095,74.125.200.0-255,4320,343256,9,361177
6284,0.003097,172.31.36.0-255,66,343322,9,361177
6285,0.003101,74.125.200.0-255,1484,344806,9,361177
6286,0.003104,74.125.200.0-255,1484,346290,9,361177
6287,0.003106,172.31.36.0-255,66,346356,9,361177
6288,0.003112,74.125.200.0-255,4320,350676,9,361177
6289,0.003114,172.31.36.0-255,66,350742,9,361177
6290,0.003132,74.125.200.0-255,999,351741,9,361177
6291,0.003174,74.125.200.0-255,105,351846,9,361177
6292,0.008814,172.31.36.0-255,66,351912,9,361177
6293,0.008853,172.31.36.0-255,105,352017,9,361177
6294,0.011302,74.125.200.0-255,66,352083,9,361177
6295,0.038445,172.31.36.0-255,172,352255,9,361177
6296,0.038476,172.31.36.0-255,1112,353367,9,361177
6297,0.038544,172.31.36.0-255,1514,354881,9,361177
6298,0.038546,172.31.36.0-255,1514,356395,9,361177
6299,0.038547,172.31.36.0-255,1514,357909,9,361177
6300,0.038548,172.31.36.0-255,1514,359423,9,361177
6301,0.038576,172.31.36.0-255,1490,360913,9,361177
6302,0.040011,104.244.42.0-255,66,360979,9,361177
6303,0.040057,104.244.42.0-255,66,361045,9,361177
6304,0.040106,104.244.42.0-255,66,361111,9,361177
6305,0.040201,104.244.42.0-255,66,361177,9,361177
6306,0.0,172.31.36.0-255,105,105,9,105
6307,0.0,172.217.194.0-255,153,153,9,214657
6308,2.6e-05,172.31.36.0-255,66,219,9,214657
6309,3.2e-05,172.217.194.0-255,1484,1703,9,214657
6310,3.6e-05,172.31.36.0-255,66,1769,9,214657
6311,4.2e-05,172.217.194.0-255,2902,4671,9,214657
6312,4.5e-05,172.31.36.0-255,66,4737,9,214657
6313,5.2e-05,172.217.194.0-255,7156,11893,9,214657
6314,5.4e-05,172.31.36.0-255,66,11959,9,214657
6315,7.9e-05,172.217.194.0-255,2011,13970,9,214657
6316,8.1e-05,172.31.36.0-255,66,14036,9,214657
6317,0.000148,172.217.194.0-255,1484,15520,9,214657
6318,0.000153,172.31.36.0-255,66,15586,9,214657
6319,0.000159,172.217.194.0-255,2902,18488,9,214657
6320,0.000161,172.31.36.0-255,66,18554,9,214657
6321,0.000167,172.217.194.0-255,4320,22874,9,214657
6322,0.000169,172.31.36.0-255,66,22940,9,214657
6323,0.000196,172.217.194.0-255,1484,24424,9,214657
6324,0.000199,172.31.36.0-255,66,24490,9,214657
6325,0.000206,172.217.194.0-255,6797,31287,9,214657
6326,0.000208,172.31.36.0-255,66,31353,9,214657
6327,0.000223,172.217.194.0-255,1484,32837,9,214657
6328,0.000226,172.31.36.0-255,66,32903,9,214657
6329,0.000252,172.31.36.0-255,66,32969,9,214657
6330,0.000269,172.217.194.0-255,1484,34453,9,214657
6331,0.000272,172.31.36.0-255,66,34519,9,214657
6332,0.000276,172.217.194.0-255,2543,37062,9,214657
6333,0.000279,172.31.36.0-255,66,37128,9,214657
6334,0.000715,172.217.194.0-255,1484,38612,9,214657
6335,0.00072,172.31.36.0-255,66,38678,9,214657
6336,0.00073,172.217.194.0-255,2902,41580,9,214657
6337,0.000732,172.31.36.0-255,66,41646,9,214657
6338,0.00074,172.217.194.0-255,5738,47384,9,214657
6339,0.000743,172.31.36.0-255,66,47450,9,214657
6340,0.000792,172.217.194.0-255,4320,51770,9,214657
6341,0.000796,172.31.36.0-255,66,51836,9,214657
6342,0.000818,172.217.194.0-255,3122,54958,9,214657
6343,0.000821,172.31.36.0-255,66,55024,9,214657
6344,0.000832,172.31.36.0-255,66,55090,9,214657
6345,0.000838,172.217.194.0-255,5738,60828,9,214657
6346,0.000841,172.31.36.0-255,66,60894,9,214657
6347,0.000892,172.31.36.0-255,66,60960,9,214657
6348,0.000928,172.31.36.0-255,66,61026,9,214657
6349,0.000932,172.217.194.0-255,2543,63569,9,214657
6350,0.000935,172.31.36.0-255,66,63635,9,214657
6351,0.001355,172.217.194.0-255,1484,65119,9,214657
6352,0.001363,172.217.194.0-255,2902,68021,9,214657
6353,0.001367,172.31.36.0-255,66,68087,9,214657
6354,0.001373,172.217.194.0-255,5738,73825,9,214657
6355,0.001375,172.31.36.0-255,66,73891,9,214657
6356,0.001393,172.217.194.0-255,4320,78211,9,214657
6357,0.001395,172.31.36.0-255,66,78277,9,214657
6358,0.001414,172.31.36.0-255,66,78343,9,214657
6359,0.001417,172.217.194.0-255,1484,79827,9,214657
6360,0.001465,172.217.194.0-255,7156,86983,9,214657
6361,0.001468,172.31.36.0-255,66,87049,9,214657
6362,0.001488,172.217.194.0-255,2184,89233,9,214657
6363,0.00149,172.31.36.0-255,66,89299,9,214657
6364,0.001493,172.217.194.0-255,1484,90783,9,214657
6365,0.001509,172.217.194.0-255,2902,93685,9,214657
6366,0.001511,172.31.36.0-255,66,93751,9,214657
6367,0.001535,172.217.194.0-255,5738,99489,9,214657
6368,0.001537,172.31.36.0-255,66,99555,9,214657
6369,0.001555,172.217.194.0-255,5738,105293,9,214657
6370,0.001558,172.31.36.0-255,66,105359,9,214657
6371,0.001578,172.217.194.0-255,5738,111097,9,214657
6372,0.001581,172.31.36.0-255,66,111163,9,214657
6373,0.001599,172.217.194.0-255,1484,112647,9,214657
6374,0.001622,172.31.36.0-255,66,112713,9,214657
6375,0.00164,172.217.194.0-255,2184,114897,9,214657
6376,0.001642,172.31.36.0-255,66,114963,9,214657
6377,0.001658,172.217.194.0-255,1484,116447,9,214657
6378,0.001662,172.217.194.0-255,2902,119349,9,214657
6379,0.001664,172.31.36.0-255,66,119415,9,214657
6380,0.001683,172.217.194.0-255,4320,123735,9,214657
6381,0.001686,172.31.36.0-255,66,123801,9,214657
6382,0.001696,172.217.194.0-255,1484,125285,9,214657
6383,0.001722,172.217.194.0-255,4320,129605,9,214657
6384,0.001727,172.31.36.0-255,66,129671,9,214657
6385,0.001744,172.217.194.0-255,4320,133991,9,214657
6386,0.001746,172.31.36.0-255,66,134057,9,214657
6387,0.001771,172.217.194.0-255,4320,138377,9,214657
6388,0.001773,172.31.36.0-255,66,138443,9,214657
6389,0.001789,172.217.194.0-255,2902,141345,9,214657
6390,0.00179,172.31.36.0-255,66,141411,9,214657
6391,0.001821,172.31.36.0-255,66,141477,9,214657
6392,0.001864,172.217.194.0-255,1484,142961,9,214657
6393,0.001869,172.217.194.0-255,2902,145863,9,214657
6394,0.001871,172.31.36.0-255,66,145929,9,214657
6395,0.001877,172.217.194.0-255,5738,151667,9,214657
6396,0.001879,172.31.36.0-255,66,151733,9,214657
6397,0.00189,172.217.194.0-255,1484,153217,9,214657
6398,0.001911,172.217.194.0-255,2902,156119,9,214657
6399,0.001914,172.31.36.0-255,66,156185,9,214657
6400,0.00194,172.31.36.0-255,66,156251,9,214657
6401,0.001951,172.31.36.0-255,66,156317,9,214657
6402,0.001957,172.217.194.0-255,5738,162055,9,214657
6403,0.001959,172.31.36.0-255,66,162121,9,214657
6404,0.002008,172.31.36.0-255,66,162187,9,214657
6405,0.00202,172.31.36.0-255,66,162253,9,214657
6406,0.002055,172.31.36.0-255,66,162319,9,214657
6407,0.002068,172.31.36.0-255,66,162385,9,214657
6408,0.002073,172.217.194.0-255,5738,168123,9,214657
6409,0.002076,172.31.36.0-255,66,168189,9,214657
6410,0.002108,172.217.194.0-255,3602,171791,9,214657
6411,0.002111,172.31.36.0-255,66,171857,9,214657
6412,0.002122,172.31.36.0-255,66,171923,9,214657
6413,0.002164,172.217.194.0-255,4320,176243,9,214657
6414,0.002166,172.31.36.0-255,66,176309,9,214657
6415,0.002198,172.31.36.0-255,66,176375,9,214657
6416,0.002208,172.31.36.0-255,66,176441,9,214657
6417,0.002242,172.31.36.0-255,66,176507,9,214657
6418,0.002255,172.217.194.0-255,2184,178691,9,214657
6419,0.002258,172.31.36.0-255,66,178757,9,214657
6420,0.002262,172.217.194.0-255,2902,181659,9,214657
6421,0.002265,172.31.36.0-255,66,181725,9,214657
6422,0.002319,172.217.194.0-255,766,182491,9,214657
6423,0.002352,172.217.194.0-255,4320,186811,9,214657
6424,0.002356,172.217.194.0-255,3602,190413,9,214657
6425,0.002376,172.217.194.0-255,4320,194733,9,214657
6426,0.002395,172.217.194.0-255,7156,201889,9,214657
6427,0.002415,172.217.194.0-255,3093,204982,9,214657
6428,0.002622,172.31.36.0-255,66,205048,9,214657
6429,0.004855,172.217.194.0-255,105,205153,9,214657
6430,0.011733,172.31.36.0-255,66,205219,9,214657
6431,0.011792,172.31.36.0-255,105,205324,9,214657
6432,0.014064,172.217.194.0-255,66,205390,9,214657
6433,0.037483,172.31.36.0-255,172,205562,9,214657
6434,0.037545,172.31.36.0-255,1112,206674,9,214657
6435,0.037626,172.31.36.0-255,1514,208188,9,214657
6436,0.037628,172.31.36.0-255,1514,209702,9,214657
6437,0.037629,172.31.36.0-255,1514,211216,9,214657
6438,0.03763,172.31.36.0-255,1514,212730,9,214657
6439,0.037667,172.31.36.0-255,1489,214219,9,214657
6440,0.039045,104.244.42.0-255,66,214285,9,214657
6441,0.039088,104.244.42.0-255,66,214351,9,214657
6442,0.039227,104.244.42.0-255,66,214417,9,214657
6443,0.039276,104.244.42.0-255,66,214483,9,214657
6444,0.040365,104.244.42.0-255,108,214591,9,214657
6445,0.040372,172.31.36.0-255,66,214657,9,214657
6446,0.0,172.217.27.0-255,150,150,9,290135
6447,2.2e-05,172.31.36.0-255,66,216,9,290135
6448,2.9e-05,172.217.27.0-255,1484,1700,9,290135
6449,3.5e-05,172.31.36.0-255,66,1766,9,290135
6450,4e-05,172.217.27.0-255,2902,4668,9,290135
6451,4.4e-05,172.31.36.0-255,66,4734,9,290135
6452,5.1e-05,172.217.27.0-255,5738,10472,9,290135
6453,5.4e-05,172.31.36.0-255,66,10538,9,290135
6454,7.8e-05,172.217.27.0-255,6302,16840,9,290135
6455,8.1e-05,172.31.36.0-255,66,16906,9,290135
6456,8.4e-05,172.217.27.0-255,1484,18390,9,290135
6457,8.7e-05,172.31.36.0-255,66,18456,9,290135
6458,0.000119,172.217.27.0-255,4320,22776,9,290135
6459,0.000122,172.31.36.0-255,66,22842,9,290135
6460,0.00013,172.217.27.0-255,7156,29998,9,290135
6461,0.000133,172.31.36.0-255,66,30064,9,290135
6462,0.000135,172.217.27.0-255,1125,31189,9,290135
6463,0.000137,172.31.36.0-255,66,31255,9,290135
6464,0.000253,172.217.27.0-255,1484,32739,9,290135
6465,0.000258,172.31.36.0-255,66,32805,9,290135
6466,0.000263,172.217.27.0-255,2902,35707,9,290135
6467,0.000266,172.31.36.0-255,66,35773,9,290135
6468,0.000269,172.217.27.0-255,1484,37257,9,290135
6469,0.000272,172.31.36.0-255,66,37323,9,290135
6470,0.000295,172.217.27.0-255,4320,41643,9,290135
6471,0.000298,172.31.36.0-255,66,41709,9,290135
6472,0.000309,172.31.36.0-255,66,41775,9,290135
6473,0.000314,172.217.27.0-255,4320,46095,9,290135
6474,0.000316,172.31.36.0-255,66,46161,9,290135
6475,0.000331,172.217.27.0-255,4320,50481,9,290135
6476,0.000334,172.31.36.0-255,66,50547,9,290135
6477,0.000353,172.217.27.0-255,7065,57612,9,290135
6478,0.000472,172.31.36.0-255,66,57678,9,290135
6479,0.000636,172.217.27.0-255,132,57810,9,290135
6480,0.000806,172.217.27.0-255,1484,59294,9,290135
6481,0.000813,172.217.27.0-255,2902,62196,9,290135
6482,0.000817,172.217.27.0-255,2902,65098,9,290135
6483,0.000832,172.217.27.0-255,2902,68000,9,290135
6484,0.000839,172.31.36.0-255,66,68066,9,290135
6485,0.000853,172.217.27.0-255,5738,73804,9,290135
6486,0.00092,172.31.36.0-255,66,73870,9,290135
6487,0.000928,172.31.36.0-255,66,73936,9,290135
6488,0.001577,172.217.27.0-255,1484,75420,9,290135
6489,0.001585,172.217.27.0-255,2902,78322,9,290135
6490,0.00159,172.31.36.0-255,66,78388,9,290135
6491,0.001597,172.217.27.0-255,4320,82708,9,290135
6492,0.001641,172.217.27.0-255,7156,89864,9,290135
6493,0.001657,172.217.27.0-255,4320,94184,9,290135
6494,0.00166,172.217.27.0-255,1484,95668,9,290135
6495,0.00168,172.217.27.0-255,3602,99270,9,290135
6496,0.005462,172.31.36.0-255,66,99336,9,290135
6497,0.00713,172.217.27.0-255,5738,105074,9,290135
6498,0.007136,172.31.36.0-255,66,105140,9,290135
6499,0.008792,172.217.27.0-255,5738,110878,9,290135
6500,0.008799,172.31.36.0-255,66,110944,9,290135
6501,0.010445,172.217.27.0-255,5738,116682,9,290135
6502,0.012179,172.31.36.0-255,66,116748,9,290135
6503,0.013832,172.217.27.0-255,5738,122486,9,290135
6504,0.013846,172.31.36.0-255,66,122552,9,290135
6505,0.015499,172.217.27.0-255,5738,128290,9,290135
6506,0.015513,172.31.36.0-255,66,128356,9,290135
6507,0.017173,172.217.27.0-255,5738,134094,9,290135
6508,0.017184,172.31.36.0-255,66,134160,9,290135
6509,0.018837,172.217.27.0-255,5738,139898,9,290135
6510,0.018845,172.31.36.0-255,66,139964,9,290135
6511,0.020496,172.217.27.0-255,5738,145702,9,290135
6512,0.020509,172.31.36.0-255,66,145768,9,290135
6513,0.022157,172.217.27.0-255,5738,151506,9,290135
6514,0.022166,172.31.36.0-255,66,151572,9,290135
6515,0.02381,172.217.27.0-255,5738,157310,9,290135
6516,0.023818,172.31.36.0-255,66,157376,9,290135
6517,0.025461,172.217.27.0-255,5738,163114,9,290135
6518,0.025468,172.31.36.0-255,66,163180,9,290135
6519,0.027108,172.217.27.0-255,5738,168918,9,290135
6520,0.027115,172.31.36.0-255,66,168984,9,290135
6521,0.028755,172.217.27.0-255,5738,174722,9,290135
6522,0.028762,172.31.36.0-255,66,174788,9,290135
6523,0.030415,172.217.27.0-255,5738,180526,9,290135
6524,0.030422,172.31.36.0-255,66,180592,9,290135
6525,0.032073,172.217.27.0-255,5738,186330,9,290135
6526,0.032081,172.31.36.0-255,66,186396,9,290135
6527,0.033732,172.217.27.0-255,5738,192134,9,290135
6528,0.03374,172.31.36.0-255,66,192200,9,290135
6529,0.035389,172.217.27.0-255,5738,197938,9,290135
6530,0.035397,172.31.36.0-255,66,198004,9,290135
6531,0.03704,172.217.27.0-255,2902,200906,9,290135
6532,0.037046,172.31.36.0-255,66,200972,9,290135
6533,0.03708,172.217.27.0-255,2902,203874,9,290135
6534,0.037232,172.31.36.0-255,66,203940,9,290135
6535,0.037638,172.31.36.0-255,172,204112,9,290135
6536,0.03767,172.31.36.0-255,1112,205224,9,290135
6537,0.03774,172.31.36.0-255,1514,206738,9,290135
6538,0.037742,172.31.36.0-255,1514,208252,9,290135
6539,0.037743,172.31.36.0-255,1514,209766,9,290135
6540,0.037747,172.31.36.0-255,1514,211280,9,290135
6541,0.037749,172.31.36.0-255,1489,212769,9,290135
6542,0.038686,172.217.27.0-255,2902,215671,9,290135
6543,0.038693,172.31.36.0-255,66,215737,9,290135
6544,0.038865,172.217.27.0-255,2902,218639,9,290135
6545,0.038871,172.31.36.0-255,66,218705,9,290135
6546,0.039184,104.244.42.0-255,66,218771,9,290135
6547,0.039278,104.244.42.0-255,66,218837,9,290135
6548,0.039314,104.244.42.0-255,66,218903,9,290135
6549,0.040342,172.217.27.0-255,2902,221805,9,290135
6550,0.040349,172.31.36.0-255,66,221871,9,290135
6551,0.040503,172.217.27.0-255,2902,224773,9,290135
6552,0.040508,172.31.36.0-255,66,224839,9,290135
6553,0.042009,172.217.27.0-255,2902,227741,9,290135
6554,0.042016,172.31.36.0-255,66,227807,9,290135
6555,0.042137,172.217.27.0-255,2902,230709,9,290135
6556,0.042143,172.31.36.0-255,66,230775,9,290135
6557,0.043713,172.217.27.0-255,2902,233677,9,290135
6558,0.043719,172.31.36.0-255,66,233743,9,290135
6559,0.043765,172.217.27.0-255,2902,236645,9,290135
6560,0.043797,172.31.36.0-255,66,236711,9,290135
6561,0.045366,172.217.27.0-255,2902,239613,9,290135
6562,0.045386,172.31.36.0-255,66,239679,9,290135
6563,0.045444,172.217.27.0-255,2902,242581,9,290135
6564,0.045458,172.31.36.0-255,66,242647,9,290135
6565,0.047046,172.217.27.0-255,2902,245549,9,290135
6566,0.047052,172.31.36.0-255,66,245615,9,290135
6567,0.047089,172.217.27.0-255,2902,248517,9,290135
6568,0.047159,172.31.36.0-255,66,248583,9,290135
6569,0.048698,172.217.27.0-255,2902,251485,9,290135
6570,0.048705,172.31.36.0-255,66,251551,9,290135
6571,0.048784,172.217.27.0-255,2902,254453,9,290135
6572,0.048788,172.31.36.0-255,66,254519,9,290135
6573,0.050393,172.217.27.0-255,2902,257421,9,290135
6574,0.050401,172.31.36.0-255,66,257487,9,290135
6575,0.050427,172.217.27.0-255,2902,260389,9,290135
6576,0.050453,172.31.36.0-255,66,260455,9,290135
6577,0.052055,172.217.27.0-255,2902,263357,9,290135
6578,0.052066,172.31.36.0-255,66,263423,9,290135
6579,0.052086,172.217.27.0-255,2902,266325,9,290135
6580,0.0522,172.31.36.0-255,66,266391,9,290135
6581,0.053714,172.217.27.0-255,2902,269293,9,290135
6582,0.053721,172.31.36.0-255,66,269359,9,290135
6583,0.053834,172.217.27.0-255,2902,272261,9,290135
6584,0.053839,172.31.36.0-255,66,272327,9,290135
6585,0.055378,172.217.27.0-255,2902,275229,9,290135
6586,0.055384,172.31.36.0-255,66,275295,9,290135
6587,0.055469,172.217.27.0-255,2902,278197,9,290135
6588,0.055488,172.31.36.0-255,66,278263,9,290135
6589,0.05703,172.217.27.0-255,2902,281165,9,290135
6590,0.057036,172.31.36.0-255,66,281231,9,290135
6591,0.057116,172.217.27.0-255,2902,284133,9,290135
6592,0.057123,172.31.36.0-255,66,284199,9,290135
6593,0.05868,172.217.27.0-255,2902,287101,9,290135
6594,0.058686,172.31.36.0-255,66,287167,9,290135
6595,0.058757,172.217.27.0-255,2902,290069,9,290135
6596,0.058781,172.31.36.0-255,66,290135,9,290135
6597,0.0,74.125.24.0-255,151,151,9,258854
6598,2.5e-05,172.31.36.0-255,66,217,9,258854
6599,3.2e-05,74.125.24.0-255,1484,1701,9,258854
6600,3.8e-05,172.31.36.0-255,66,1767,9,258854
6601,4.4e-05,74.125.24.0-255,2902,4669,9,258854
6602,4.8e-05,172.31.36.0-255,66,4735,9,258854
6603,5.6e-05,74.125.24.0-255,7156,11891,9,258854
6604,6e-05,172.31.36.0-255,66,11957,9,258854
6605,6.4e-05,74.125.24.0-255,2038,13995,9,258854
6606,6.7e-05,172.31.36.0-255,66,14061,9,258854
6607,9.7e-05,74.125.24.0-255,4320,18381,9,258854
6608,0.0001,172.31.36.0-255,66,18447,9,258854
6609,0.00012,74.125.24.0-255,7156,25603,9,258854
6610,0.000123,172.31.36.0-255,66,25669,9,258854
6611,0.000139,74.125.24.0-255,1484,27153,9,258854
6612,0.000141,172.31.36.0-255,66,27219,9,258854
6613,0.000162,74.125.24.0-255,3961,31180,9,258854
6614,0.000165,172.31.36.0-255,66,31246,9,258854
6615,0.000203,74.125.24.0-255,1484,32730,9,258854
6616,0.000206,172.31.36.0-255,66,32796,9,258854
6617,0.00021,74.125.24.0-255,2902,35698,9,258854
6618,0.000212,172.31.36.0-255,66,35764,9,258854
6619,0.000239,74.125.24.0-255,5738,41502,9,258854
6620,0.000242,172.31.36.0-255,66,41568,9,258854
6621,0.00025,74.125.24.0-255,6797,48365,9,258854
6622,0.000252,172.31.36.0-255,66,48431,9,258854
6623,0.000342,74.125.24.0-255,1484,49915,9,258854
6624,0.000346,172.31.36.0-255,66,49981,9,258854
6625,0.000351,74.125.24.0-255,2902,52883,9,258854
6626,0.000353,172.31.36.0-255,66,52949,9,258854
6627,0.00036,74.125.24.0-255,5738,58687,9,258854
6628,0.000363,172.31.36.0-255,66,58753,9,258854
6629,0.000401,74.125.24.0-255,6797,65550,9,258854
6630,0.000404,172.31.36.0-255,66,65616,9,258854
6631,0.000681,74.125.24.0-255,645,66261,9,258854
6632,0.00109,172.31.36.0-255,66,66327,9,258854
6633,0.001544,74.125.24.0-255,1484,67811,9,258854
6634,0.001555,74.125.24.0-255,2902,70713,9,258854
6635,0.001559,172.31.36.0-255,66,70779,9,258854
6636,0.001568,74.125.24.0-255,5738,76517,9,258854
6637,0.00157,172.31.36.0-255,66,76583,9,258854
6638,0.001577,74.125.24.0-255,5738,82321,9,258854
6639,0.00158,172.31.36.0-255,66,82387,9,258854
6640,0.001599,74.125.24.0-255,2902,85289,9,258854
6641,0.001601,172.31.36.0-255,66,85355,9,258854
6642,0.001635,74.125.24.0-255,5738,91093,9,258854
6643,0.001638,172.31.36.0-255,66,91159,9,258854
6644,0.001666,172.31.36.0-255,66,91225,9,258854
6645,0.001905,74.125.24.0-255,1484,92709,9,258854
6646,0.001913,74.125.24.0-255,2902,95611,9,258854
6647,0.001917,172.31.36.0-255,66,95677,9,258854
6648,0.001925,74.125.24.0-255,5738,101415,9,258854
6649,0.001928,172.31.36.0-255,66,101481,9,258854
6650,0.001932,74.125.24.0-255,2902,104383,9,258854
6651,0.001934,172.31.36.0-255,66,104449,9,258854
6652,0.001957,74.125.24.0-255,5738,110187,9,258854
6653,0.00196,172.31.36.0-255,66,110253,9,258854
6654,0.001976,74.125.24.0-255,1484,111737,9,258854
6655,0.002014,172.31.36.0-255,66,111803,9,258854
6656,0.004373,74.125.24.0-255,2902,114705,9,258854
6657,0.004377,172.31.36.0-255,66,114771,9,258854
6658,0.004395,74.125.24.0-255,2902,117673,9,258854
6659,0.004398,172.31.36.0-255,66,117739,9,258854
6660,0.006732,74.125.24.0-255,2902,120641,9,258854
6661,0.006739,172.31.36.0-255,66,120707,9,258854
6662,0.006761,74.125.24.0-255,2902,123609,9,258854
6663,0.006764,172.31.36.0-255,66,123675,9,258854
6664,0.009119,74.125.24.0-255,4320,127995,9,258854
6665,0.009126,172.31.36.0-255,66,128061,9,258854
6666,0.009145,74.125.24.0-255,1484,129545,9,258854
6667,0.011514,74.125.24.0-255,4320,133865,9,258854
6668,0.011523,172.31.36.0-255,66,133931,9,258854
6669,0.013931,74.125.24.0-255,5738,139669,9,258854
6670,0.01394,172.31.36.0-255,66,139735,9,258854
6671,0.016294,74.125.24.0-255,5738,145473,9,258854
6672,0.016303,172.31.36.0-255,66,145539,9,258854
6673,0.01866,74.125.24.0-255,5738,151277,9,258854
6674,0.01867,172.31.36.0-255,66,151343,9,258854
6675,0.021049,74.125.24.0-255,5738,157081,9,258854
6676,0.021058,172.31.36.0-255,66,157147,9,258854
6677,0.023443,74.125.24.0-255,5738,162885,9,258854
6678,0.023451,172.31.36.0-255,66,162951,9,258854
6679,0.025827,74.125.24.0-255,5738,168689,9,258854
6680,0.025835,172.31.36.0-255,66,168755,9,258854
6681,0.028217,74.125.24.0-255,5738,174493,9,258854
6682,0.028232,172.31.36.0-255,66,174559,9,258854
6683,0.030615,74.125.24.0-255,5738,180297,9,258854
6684,0.030629,172.31.36.0-255,66,180363,9,258854
6685,0.033007,74.125.24.0-255,5738,186101,9,258854
6686,0.033015,172.31.36.0-255,66,186167,9,258854
6687,0.035379,74.125.24.0-255,5738,191905,9,258854
6688,0.035388,172.31.36.0-255,66,191971,9,258854
6689,0.037754,74.125.24.0-255,5738,197709,9,258854
6690,0.037763,172.31.36.0-255,66,197775,9,258854
6691,0.039675,172.31.36.0-255,171,197946,9,258854
6692,0.039705,172.31.36.0-255,1140,199086,9,258854
6693,0.039772,172.31.36.0-255,1514,200600,9,258854
6694,0.039774,172.31.36.0-255,1514,202114,9,258854
6695,0.039775,172.31.36.0-255,1514,203628,9,258854
6696,0.039776,172.31.36.0-255,1514,205142,9,258854
6697,0.039805,172.31.36.0-255,1080,206222,9,258854
6698,0.040144,74.125.24.0-255,2902,209124,9,258854
6699,0.04015,172.31.36.0-255,66,209190,9,258854
6700,0.04017,74.125.24.0-255,2902,212092,9,258854
6701,0.040172,172.31.36.0-255,66,212158,9,258854
6702,0.041309,104.244.42.0-255,66,212224,9,258854
6703,0.041367,104.244.42.0-255,66,212290,9,258854
6704,0.041485,104.244.42.0-255,66,212356,9,258854
6705,0.04149,104.244.42.0-255,66,212422,9,258854
6706,0.042532,74.125.24.0-255,5738,218160,9,258854
6707,0.04254,172.31.36.0-255,66,218226,9,258854
6708,0.044931,74.125.24.0-255,5738,223964,9,258854
6709,0.044937,172.31.36.0-255,66,224030,9,258854
6710,0.04732,74.125.24.0-255,5738,229768,9,258854
6711,0.047329,172.31.36.0-255,66,229834,9,258854
6712,0.04969,74.125.24.0-255,5738,235572,9,258854
6713,0.049696,172.31.36.0-255,66,235638,9,258854
6714,0.052083,74.125.24.0-255,5738,241376,9,258854
6715,0.05209,172.31.36.0-255,66,241442,9,258854
6716,0.054457,74.125.24.0-255,5738,247180,9,258854
6717,0.054465,172.31.36.0-255,66,247246,9,258854
6718,0.056833,74.125.24.0-255,5738,252984,9,258854
6719,0.05684,172.31.36.0-255,66,253050,9,258854
6720,0.059202,74.125.24.0-255,5738,258788,9,258854
6721,0.059211,172.31.36.0-255,66,258854,9,258854
6722,0.0,172.31.36.0-255,105,105,9,105
6723,0.0,104.244.42.0-255,66,66,9,66
6724,0.0,216.58.221.0-255,152,152,9,289785
6725,2.8e-05,172.31.36.0-255,66,218,9,289785
6726,3.5e-05,216.58.221.0-255,1484,1702,9,289785
6727,3.9e-05,172.31.36.0-255,66,1768,9,289785
6728,4.4e-05,216.58.221.0-255,2902,4670,9,289785
6729,4.7e-05,172.31.36.0-255,66,4736,9,289785
6730,5.1e-05,216.58.221.0-255,2902,7638,9,289785
6731,5.2e-05,172.31.36.0-255,66,7704,9,289785
6732,5.8e-05,216.58.221.0-255,4320,12024,9,289785
6733,6.1e-05,172.31.36.0-255,66,12090,9,289785
6734,7.9e-05,216.58.221.0-255,2021,14111,9,289785
6735,8.4e-05,172.31.36.0-255,66,14177,9,289785
6736,0.000132,216.58.221.0-255,1484,15661,9,289785
6737,0.000135,172.31.36.0-255,66,15727,9,289785
6738,0.00015,216.58.221.0-255,2902,18629,9,289785
6739,0.000152,172.31.36.0-255,66,18695,9,289785
6740,0.000178,216.58.221.0-255,5738,24433,9,289785
6741,0.000181,172.31.36.0-255,66,24499,9,289785
6742,0.000222,216.58.221.0-255,2902,27401,9,289785
6743,0.000224,172.31.36.0-255,66,27467,9,289785
6744,0.000243,216.58.221.0-255,3961,31428,9,289785
6745,0.000245,172.31.36.0-255,66,31494,9,289785
6746,0.000622,216.58.221.0-255,1484,32978,9,289785
6747,0.000628,172.31.36.0-255,66,33044,9,289785
6748,0.000638,216.58.221.0-255,2902,35946,9,289785
6749,0.000641,172.31.36.0-255,66,36012,9,289785
6750,0.000645,216.58.221.0-255,2902,38914,9,289785
6751,0.000647,172.31.36.0-255,66,38980,9,289785
6752,0.000652,216.58.221.0-255,2902,41882,9,289785
6753,0.000654,172.31.36.0-255,66,41948,9,289785
6754,0.000679,216.58.221.0-255,1484,43432,9,289785
6755,0.000682,172.31.36.0-255,66,43498,9,289785
6756,0.000719,216.58.221.0-255,5379,48877,9,289785
6757,0.000723,172.31.36.0-255,66,48943,9,289785
6758,0.000763,216.58.221.0-255,1484,50427,9,289785
6759,0.000769,216.58.221.0-255,2902,53329,9,289785
6760,0.000773,172.31.36.0-255,66,53395,9,289785
6761,0.000777,216.58.221.0-255,1484,54879,9,289785
6762,0.000804,216.58.221.0-255,4320,59199,9,289785
6763,0.000808,172.31.36.0-255,66,59265,9,289785
6764,0.000814,216.58.221.0-255,4320,63585,9,289785
6765,0.000816,172.31.36.0-255,66,63651,9,289785
6766,0.000838,216.58.221.0-255,1484,65135,9,289785
6767,0.000849,216.58.221.0-255,1453,66588,9,289785
6768,0.000852,172.31.36.0-255,66,66654,9,289785
6769,0.001312,216.58.221.0-255,115,66769,9,289785
6770,0.001354,172.31.36.0-255,66,66835,9,289785
6771,0.001495,216.58.221.0-255,1484,68319,9,289785
6772,0.001518,216.58.221.0-255,2902,71221,9,289785
6773,0.001521,172.31.36.0-255,66,71287,9,289785
6774,0.001526,216.58.221.0-255,2902,74189,9,289785
6775,0.001528,172.31.36.0-255,66,74255,9,289785
6776,0.001549,216.58.221.0-255,2902,77157,9,289785
6777,0.001551,172.31.36.0-255,66,77223,9,289785
6778,0.00158,216.58.221.0-255,5738,82961,9,289785
6779,0.001583,172.31.36.0-255,66,83027,9,289785
6780,0.001589,216.58.221.0-255,6797,89824,9,289785
6781,0.001592,172.31.36.0-255,66,89890,9,289785
6782,0.001602,172.31.36.0-255,66,89956,9,289785
6783,0.001623,216.58.221.0-255,2543,92499,9,289785
6784,0.001626,172.31.36.0-255,66,92565,9,289785
6785,0.00175,216.58.221.0-255,1484,94049,9,289785
6786,0.001756,216.58.221.0-255,2902,96951,9,289785
6787,0.00176,172.31.36.0-255,66,97017,9,289785
6788,0.001763,216.58.221.0-255,1484,98501,9,289785
6789,0.001783,216.58.221.0-255,4320,102821,9,289785
6790,0.001785,172.31.36.0-255,66,102887,9,289785
6791,0.001788,216.58.221.0-255,1484,104371,9,289785
6792,0.00181,172.31.36.0-255,66,104437,9,289785
6793,0.001854,172.31.36.0-255,66,104503,9,289785
6794,0.001892,216.58.221.0-255,4320,108823,9,289785
6795,0.001895,172.31.36.0-255,66,108889,9,289785
6796,0.001917,216.58.221.0-255,5738,114627,9,289785
6797,0.001919,172.31.36.0-255,66,114693,9,289785
6798,0.00193,172.31.36.0-255,66,114759,9,289785
6799,0.001966,172.31.36.0-255,66,114825,9,289785
6800,0.002046,172.31.36.0-255,101,114926,9,289785
6801,0.003891,216.58.221.0-255,5738,120664,9,289785
6802,0.003898,172.31.36.0-255,66,120730,9,289785
6803,0.003931,216.58.221.0-255,66,120796,9,289785
6804,0.00583,216.58.221.0-255,5738,126534,9,289785
6805,0.005835,172.31.36.0-255,66,126600,9,289785
6806,0.007767,216.58.221.0-255,5738,132338,9,289785
6807,0.007774,172.31.36.0-255,66,132404,9,289785
6808,0.009708,216.58.221.0-255,5738,138142,9,289785
6809,0.009714,172.31.36.0-255,66,138208,9,289785
6810,0.011685,216.58.221.0-255,5738,143946,9,289785
6811,0.011693,172.31.36.0-255,66,144012,9,289785
6812,0.01363,216.58.221.0-255,5738,149750,9,289785
6813,0.013638,172.31.36.0-255,66,149816,9,289785
6814,0.015574,216.58.221.0-255,5738,155554,9,289785
6815,0.015582,172.31.36.0-255,66,155620,9,289785
6816,0.01751,216.58.221.0-255,5738,161358,9,289785
6817,0.017516,172.31.36.0-255,66,161424,9,289785
6818,0.019459,216.58.221.0-255,5738,167162,9,289785
6819,0.019467,172.31.36.0-255,66,167228,9,289785
6820,0.021406,216.58.221.0-255,5738,172966,9,289785
6821,0.021413,172.31.36.0-255,66,173032,9,289785
6822,0.023351,216.58.221.0-255,5738,178770,9,289785
6823,0.023357,172.31.36.0-255,66,178836,9,289785
6824,0.025305,216.58.221.0-255,5738,184574,9,289785
6825,0.025312,172.31.36.0-255,66,184640,9,289785
6826,0.027252,216.58.221.0-255,5738,190378,9,289785
6827,0.027258,172.31.36.0-255,66,190444,9,289785
6828,0.029223,216.58.221.0-255,5738,196182,9,289785
6829,0.02923,172.31.36.0-255,66,196248,9,289785
6830,0.031208,216.58.221.0-255,5738,201986,9,289785
6831,0.031217,172.31.36.0-255,66,202052,9,289785
6832,0.033146,216.58.221.0-255,5738,207790,9,289785
6833,0.033153,172.31.36.0-255,66,207856,9,289785
6834,0.035096,216.58.221.0-255,5738,213594,9,289785
6835,0.035104,172.31.36.0-255,66,213660,9,289785
6836,0.037039,216.58.221.0-255,5738,219398,9,289785
6837,0.037044,172.31.36.0-255,66,219464,9,289785
6838,0.038367,172.31.36.0-255,317,219781,9,289785
6839,0.038459,172.31.36.0-255,1112,220893,9,289785
6840,0.038727,172.31.36.0-255,1514,222407,9,289785
6841,0.03873,172.31.36.0-255,1514,223921,9,289785
6842,0.038731,172.31.36.0-255,1514,225435,9,289785
6843,0.038732,172.31.36.0-255,110,225545,9,289785
6844,0.038973,216.58.221.0-255,5738,231283,9,289785
6845,0.03898,172.31.36.0-255,66,231349,9,289785
6846,0.039898,104.244.42.0-255,66,231415,9,289785
6847,0.03999,104.244.42.0-255,66,231481,9,289785
6848,0.040244,104.244.42.0-255,66,231547,9,289785
6849,0.040286,104.244.42.0-255,66,231613,9,289785
6850,0.040908,216.58.221.0-255,5738,237351,9,289785
6851,0.040913,172.31.36.0-255,66,237417,9,289785
6852,0.042837,216.58.221.0-255,5738,243155,9,289785
6853,0.042843,172.31.36.0-255,66,243221,9,289785
6854,0.044768,216.58.221.0-255,2902,246123,9,289785
6855,0.044774,172.31.36.0-255,66,246189,9,289785
6856,0.044803,216.58.221.0-255,2902,249091,9,289785
6857,0.044807,172.31.36.0-255,66,249157,9,289785
6858,0.046718,216.58.221.0-255,5738,254895,9,289785
6859,0.046723,172.31.36.0-255,66,254961,9,289785
6860,0.04867,216.58.221.0-255,5738,260699,9,289785
6861,0.048676,172.31.36.0-255,66,260765,9,289785
6862,0.050603,216.58.221.0-255,5738,266503,9,289785
6863,0.050607,172.31.36.0-255,66,266569,9,289785
6864,0.052539,216.58.221.0-255,5738,272307,9,289785
6865,0.052544,172.31.36.0-255,66,272373,9,289785
6866,0.054475,216.58.221.0-255,5738,278111,9,289785
6867,0.05448,172.31.36.0-255,66,278177,9,289785
6868,0.056417,216.58.221.0-255,5738,283915,9,289785
6869,0.056422,172.31.36.0-255,66,283981,9,289785
6870,0.058355,216.58.221.0-255,5738,289719,9,289785
6871,0.05836,172.31.36.0-255,66,289785,9,289785
6872,0.0,104.244.42.0-255,66,66,9,66
6873,0.0,172.217.194.0-255,153,153,9,201055
6874,2.2e-05,172.31.36.0-255,66,219,9,201055
6875,2.9e-05,172.217.194.0-255,1484,1703,9,201055
6876,3.5e-05,172.31.36.0-255,66,1769,9,201055
6877,4.1e-05,172.217.194.0-255,2902,4671,9,201055
6878,4.5e-05,172.31.36.0-255,66,4737,9,201055
6879,5.2e-05,172.217.194.0-255,7156,11893,9,201055
6880,5.5e-05,172.31.36.0-255,66,11959,9,201055
6881,0.000109,172.31.36.0-255,66,12025,9,201055
6882,0.000121,172.217.194.0-255,619,12644,9,201055
6883,0.000123,172.31.36.0-255,66,12710,9,201055
6884,0.000128,172.217.194.0-255,1484,14194,9,201055
6885,0.00013,172.31.36.0-255,66,14260,9,201055
6886,0.000158,172.31.36.0-255,66,14326,9,201055
6887,0.00018,172.217.194.0-255,6438,20764,9,201055
6888,0.000183,172.31.36.0-255,66,20830,9,201055
6889,0.000197,172.31.36.0-255,66,20896,9,201055
6890,0.000212,172.217.194.0-255,4549,25445,9,201055
6891,0.000214,172.31.36.0-255,66,25511,9,201055
6892,0.00025,172.217.194.0-255,1484,26995,9,201055
6893,0.000252,172.31.36.0-255,66,27061,9,201055
6894,0.000257,172.217.194.0-255,2902,29963,9,201055
6895,0.000259,172.31.36.0-255,66,30029,9,201055
6896,0.000265,172.217.194.0-255,5738,35767,9,201055
6897,0.000268,172.31.36.0-255,66,35833,9,201055
6898,0.000275,172.217.194.0-255,7156,42989,9,201055
6899,0.000278,172.31.36.0-255,66,43055,9,201055
6900,0.000314,172.31.36.0-255,66,43121,9,201055
6901,0.000318,172.217.194.0-255,2184,45305,9,201055
6902,0.000369,172.217.194.0-255,1484,46789,9,201055
6903,0.000385,172.217.194.0-255,2902,49691,9,201055
6904,0.000391,172.217.194.0-255,4320,54011,9,201055
6905,0.000407,172.217.194.0-255,1484,55495,9,201055
6906,0.00041,172.217.194.0-255,1484,56979,9,201055
6907,0.000441,172.217.194.0-255,2902,59881,9,201055
6908,0.000487,172.217.194.0-255,2902,62783,9,201055
6909,0.000507,172.217.194.0-255,4472,67255,9,201055
6910,0.000516,172.217.194.0-255,7156,74411,9,201055
6911,0.000526,172.217.194.0-255,1484,75895,9,201055
6912,0.000533,172.217.194.0-255,5738,81633,9,201055
6913,0.00055,172.217.194.0-255,4320,85953,9,201055
6914,0.000584,172.217.194.0-255,4320,90273,9,201055
6915,0.000665,172.31.36.0-255,66,90339,9,201055
6916,0.000746,172.217.194.0-255,1484,91823,9,201055
6917,0.000761,172.217.194.0-255,2902,94725,9,201055
6918,0.000782,172.217.194.0-255,5738,100463,9,201055
6919,0.000789,172.217.194.0-255,5738,106201,9,201055
6920,0.000801,172.217.194.0-255,1484,107685,9,201055
6921,0.000805,172.31.36.0-255,66,107751,9,201055
6922,0.000848,172.217.194.0-255,1484,109235,9,201055
6923,0.000852,172.217.194.0-255,2184,111419,9,201055
6924,0.000855,172.31.36.0-255,66,111485,9,201055
6925,0.000861,172.31.36.0-255,66,111551,9,201055
6926,0.001481,172.217.194.0-255,1484,113035,9,201055
6927,0.001498,172.217.194.0-255,2902,115937,9,201055
6928,0.001503,172.31.36.0-255,66,116003,9,201055
6929,0.00151,172.217.194.0-255,5738,121741,9,201055
6930,0.001545,172.217.194.0-255,1484,123225,9,201055
6931,0.001585,172.217.194.0-255,4320,127545,9,201055
6932,0.001588,172.31.36.0-255,66,127611,9,201055
6933,0.001594,172.31.36.0-255,66,127677,9,201055
6934,0.001647,172.31.36.0-255,66,127743,9,201055
6935,0.001659,172.217.194.0-255,2902,130645,9,201055
6936,0.001688,172.31.36.0-255,66,130711,9,201055
6937,0.001702,172.217.194.0-255,7156,137867,9,201055
6938,0.001707,172.31.36.0-255,66,137933,9,201055
6939,0.00174,172.217.194.0-255,5020,142953,9,201055
6940,0.001757,172.217.194.0-255,1484,144437,9,201055
6941,0.001761,172.217.194.0-255,2902,147339,9,201055
6942,0.001767,172.217.194.0-255,5738,153077,9,201055
6943,0.001781,172.217.194.0-255,1484,154561,9,201055
6944,0.001784,172.31.36.0-255,66,154627,9,201055
6945,0.001829,172.31.36.0-255,66,154693,9,201055
6946,0.001848,172.217.194.0-255,2902,157595,9,201055
6947,0.001868,172.217.194.0-255,7156,164751,9,201055
6948,0.00187,172.217.194.0-255,1484,166235,9,201055
6949,0.001891,172.217.194.0-255,7156,173391,9,201055
6950,0.001894,172.31.36.0-255,66,173457,9,201055
6951,0.0019,172.31.36.0-255,66,173523,9,201055
6952,0.001912,172.217.194.0-255,2902,176425,9,201055
6953,0.001918,172.217.194.0-255,5738,182163,9,201055
6954,0.001947,172.217.194.0-255,7156,189319,9,201055
6955,0.001956,172.31.36.0-255,66,189385,9,201055
6956,0.002046,172.217.194.0-255,1484,190869,9,201055
6957,0.002071,172.217.194.0-255,3644,194513,9,201055
6958,0.002073,172.217.194.0-255,105,194618,9,201055
6959,0.004609,172.31.36.0-255,66,194684,9,201055
6960,0.008939,172.31.36.0-255,105,194789,9,201055
6961,0.011256,172.217.194.0-255,66,194855,9,201055
6962,0.045325,172.31.36.0-255,172,195027,9,201055
6963,0.045358,172.31.36.0-255,1117,196144,9,201055
6964,0.045445,172.31.36.0-255,1514,197658,9,201055
6965,0.045447,172.31.36.0-255,1514,199172,9,201055
6966,0.045452,172.31.36.0-255,1514,200686,9,201055
6967,0.045453,172.31.36.0-255,105,200791,9,201055
6968,0.046875,104.244.42.0-255,66,200857,9,201055
6969,0.046886,104.244.42.0-255,66,200923,9,201055
6970,0.046979,104.244.42.0-255,66,200989,9,201055
6971,0.046985,104.244.42.0-255,66,201055,9,201055
6972,0.0,74.125.24.0-255,153,153,9,350026
6973,2.1e-05,172.31.36.0-255,66,219,9,350026
6974,2.7e-05,74.125.24.0-255,1484,1703,9,350026
6975,3.1e-05,172.31.36.0-255,66,1769,9,350026
6976,3.7e-05,74.125.24.0-255,2902,4671,9,350026
6977,3.9e-05,172.31.36.0-255,66,4737,9,350026
6978,4.5e-05,74.125.24.0-255,5738,10475,9,350026
6979,4.8e-05,172.31.36.0-255,66,10541,9,350026
6980,5.3e-05,74.125.24.0-255,4320,14861,9,350026
6981,5.5e-05,172.31.36.0-255,66,14927,9,350026
6982,7.4e-05,74.125.24.0-255,6283,21210,9,350026
6983,7.7e-05,172.31.36.0-255,66,21276,9,350026
6984,8.9e-05,172.31.36.0-255,66,21342,9,350026
6985,0.000118,74.125.24.0-255,2902,24244,9,350026
6986,0.00012,172.31.36.0-255,66,24310,9,350026
6987,0.000135,74.125.24.0-255,4320,28630,9,350026
6988,0.000137,172.31.36.0-255,66,28696,9,350026
6989,0.00014,74.125.24.0-255,1484,30180,9,350026
6990,0.000142,172.31.36.0-255,66,30246,9,350026
6991,0.000173,74.125.24.0-255,7156,37402,9,350026
6992,0.000177,172.31.36.0-255,66,37468,9,350026
6993,0.000181,74.125.24.0-255,1125,38593,9,350026
6994,0.000183,172.31.36.0-255,66,38659,9,350026
6995,0.000186,74.125.24.0-255,1484,40143,9,350026
6996,0.000188,172.31.36.0-255,66,40209,9,350026
6997,0.000229,74.125.24.0-255,4320,44529,9,350026
6998,0.000233,172.31.36.0-255,66,44595,9,350026
6999,0.000243,172.31.36.0-255,66,44661,9,350026
7000,0.000265,74.125.24.0-255,1484,46145,9,350026
7001,0.000268,172.31.36.0-255,66,46211,9,350026
7002,0.000271,74.125.24.0-255,1454,47665,9,350026
7003,0.000303,74.125.24.0-255,348,48013,9,350026
7004,0.000397,74.125.24.0-255,1484,49497,9,350026
7005,0.000404,74.125.24.0-255,2902,52399,9,350026
7006,0.00041,74.125.24.0-255,5738,58137,9,350026
7007,0.000439,74.125.24.0-255,6797,64934,9,350026
7008,0.000503,74.125.24.0-255,4320,69254,9,350026
7009,0.000532,74.125.24.0-255,1994,71248,9,350026
7010,0.000535,74.125.24.0-255,2902,74150,9,350026
7011,0.000589,74.125.24.0-255,1484,75634,9,350026
7012,0.000609,74.125.24.0-255,5738,81372,9,350026
7013,0.000617,172.31.36.0-255,66,81438,9,350026
7014,0.000664,172.31.36.0-255,66,81504,9,350026
7015,0.000927,74.125.24.0-255,1484,82988,9,350026
7016,0.000945,74.125.24.0-255,2902,85890,9,350026
7017,0.00096,74.125.24.0-255,1484,87374,9,350026
7018,0.000964,172.31.36.0-255,66,87440,9,350026
7019,0.000984,74.125.24.0-255,2902,90342,9,350026
7020,0.000986,172.31.36.0-255,66,90408,9,350026
7021,0.001013,74.125.24.0-255,2902,93310,9,350026
7022,0.001029,172.31.36.0-255,66,93376,9,350026
7023,0.001035,74.125.24.0-255,5738,99114,9,350026
7024,0.00104,172.31.36.0-255,66,99180,9,350026
7025,0.001051,74.125.24.0-255,4320,103500,9,350026
7026,0.001067,74.125.24.0-255,1484,104984,9,350026
7027,0.001077,172.31.36.0-255,66,105050,9,350026
7028,0.00109,74.125.24.0-255,7156,112206,9,350026
7029,0.001095,172.31.36.0-255,66,112272,9,350026
7030,0.001106,74.125.24.0-255,3602,115874,9,350026
7031,0.001108,74.125.24.0-255,1484,117358,9,350026
7032,0.001125,74.125.24.0-255,2902,120260,9,350026
7033,0.001142,74.125.24.0-255,2902,123162,9,350026
7034,0.001146,172.31.36.0-255,66,123228,9,350026
7035,0.001155,74.125.24.0-255,2902,126130,9,350026
7036,0.001175,74.125.24.0-255,1484,127614,9,350026
7037,0.001187,74.125.24.0-255,2902,130516,9,350026
7038,0.001192,172.31.36.0-255,66,130582,9,350026
7039,0.001214,74.125.24.0-255,5738,136320,9,350026
7040,0.001218,74.125.24.0-255,2902,139222,9,350026
7041,0.001223,172.31.36.0-255,66,139288,9,350026
7042,0.001244,74.125.24.0-255,2184,141472,9,350026
7043,0.001264,172.31.36.0-255,66,141538,9,350026
7044,0.001362,74.125.24.0-255,1484,143022,9,350026
7045,0.001367,74.125.24.0-255,2902,145924,9,350026
7046,0.001369,74.125.24.0-255,1484,147408,9,350026
7047,0.001376,172.31.36.0-255,66,147474,9,350026
7048,0.001383,74.125.24.0-255,1484,148958,9,350026
7049,0.001387,74.125.24.0-255,4320,153278,9,350026
7050,0.001402,74.125.24.0-255,2902,156180,9,350026
7051,0.001412,172.31.36.0-255,66,156246,9,350026
7052,0.001422,74.125.24.0-255,5738,161984,9,350026
7053,0.001428,172.31.36.0-255,66,162050,9,350026
7054,0.001437,74.125.24.0-255,2902,164952,9,350026
7055,0.001451,74.125.24.0-255,2902,167854,9,350026
7056,0.001469,74.125.24.0-255,7156,175010,9,350026
7057,0.001471,74.125.24.0-255,766,175776,9,350026
7058,0.001474,172.31.36.0-255,66,175842,9,350026
7059,0.001478,172.31.36.0-255,66,175908,9,350026
7060,0.001656,74.125.24.0-255,1484,177392,9,350026
7061,0.001704,74.125.24.0-255,2902,180294,9,350026
7062,0.001708,172.31.36.0-255,66,180360,9,350026
7063,0.001712,74.125.24.0-255,1484,181844,9,350026
7064,0.001732,74.125.24.0-255,2902,184746,9,350026
7065,0.001739,74.125.24.0-255,7156,191902,9,350026
7066,0.001752,74.125.24.0-255,1484,193386,9,350026
7067,0.001757,172.31.36.0-255,66,193452,9,350026
7068,0.001777,74.125.24.0-255,4320,197772,9,350026
7069,0.001805,172.31.36.0-255,66,197838,9,350026
7070,0.001809,172.31.36.0-255,66,197904,9,350026
7071,0.001874,74.125.24.0-255,3602,201506,9,350026
7072,0.001939,172.31.36.0-255,66,201572,9,350026
7073,0.001949,74.125.24.0-255,1484,203056,9,350026
7074,0.001953,74.125.24.0-255,2902,205958,9,350026
7075,0.001965,74.125.24.0-255,2902,208860,9,350026
7076,0.001969,172.31.36.0-255,66,208926,9,350026
7077,0.001977,74.125.24.0-255,2902,211828,9,350026
7078,0.002009,74.125.24.0-255,5738,217566,9,350026
7079,0.002016,74.125.24.0-255,4320,221886,9,350026
7080,0.002032,74.125.24.0-255,2902,224788,9,350026
7081,0.002038,172.31.36.0-255,66,224854,9,350026
7082,0.002072,74.125.24.0-255,766,225620,9,350026
7083,0.002091,172.31.36.0-255,66,225686,9,350026
7084,0.00431,74.125.24.0-255,5738,231424,9,350026
7085,0.004324,172.31.36.0-255,66,231490,9,350026
7086,0.006521,74.125.24.0-255,5738,237228,9,350026
7087,0.008852,172.31.36.0-255,66,237294,9,350026
7088,0.01109,74.125.24.0-255,5738,243032,9,350026
7089,0.011102,172.31.36.0-255,66,243098,9,350026
7090,0.013261,74.125.24.0-255,5738,248836,9,350026
7091,0.013271,172.31.36.0-255,66,248902,9,350026
7092,0.01546,74.125.24.0-255,5738,254640,9,350026
7093,0.015471,172.31.36.0-255,66,254706,9,350026
7094,0.017692,74.125.24.0-255,5738,260444,9,350026
7095,0.017701,172.31.36.0-255,66,260510,9,350026
7096,0.019863,74.125.24.0-255,5738,266248,9,350026
7097,0.019868,172.31.36.0-255,66,266314,9,350026
7098,0.022021,74.125.24.0-255,5738,272052,9,350026
7099,0.022028,172.31.36.0-255,66,272118,9,350026
7100,0.024182,74.125.24.0-255,5738,277856,9,350026
7101,0.024189,172.31.36.0-255,66,277922,9,350026
7102,0.026416,74.125.24.0-255,5738,283660,9,350026
7103,0.026423,172.31.36.0-255,66,283726,9,350026
7104,0.028558,74.125.24.0-255,5738,289464,9,350026
7105,0.028567,172.31.36.0-255,66,289530,9,350026
7106,0.030764,74.125.24.0-255,5738,295268,9,350026
7107,0.030771,172.31.36.0-255,66,295334,9,350026
7108,0.032955,74.125.24.0-255,5738,301072,9,350026
7109,0.032965,172.31.36.0-255,66,301138,9,350026
7110,0.035134,74.125.24.0-255,4320,305458,9,350026
7111,0.035142,172.31.36.0-255,66,305524,9,350026
7112,0.035176,74.125.24.0-255,1484,307008,9,350026
7113,0.037313,74.125.24.0-255,4320,311328,9,350026
7114,0.03732,172.31.36.0-255,66,311394,9,350026
7115,0.039508,74.125.24.0-255,5738,317132,9,350026
7116,0.039515,172.31.36.0-255,66,317198,9,350026
7117,0.041708,74.125.24.0-255,5738,322936,9,350026
7118,0.041715,172.31.36.0-255,66,323002,9,350026
7119,0.043925,74.125.24.0-255,5738,328740,9,350026
7120,0.043931,172.31.36.0-255,66,328806,9,350026
7121,0.046075,74.125.24.0-255,5738,334544,9,350026
7122,0.04608,172.31.36.0-255,66,334610,9,350026
7123,0.048241,74.125.24.0-255,5738,340348,9,350026
7124,0.04825,172.31.36.0-255,66,340414,9,350026
7125,0.050414,74.125.24.0-255,3175,343589,9,350026
7126,0.050421,172.31.36.0-255,66,343655,9,350026
7127,0.050801,172.31.36.0-255,105,343760,9,350026
7128,0.052678,172.31.36.0-255,172,343932,9,350026
7129,0.052712,172.31.36.0-255,1116,345048,9,350026
7130,0.052763,172.31.36.0-255,1514,346562,9,350026
7131,0.052764,172.31.36.0-255,1514,348076,9,350026
7132,0.052769,172.31.36.0-255,1514,349590,9,350026
7133,0.05277,172.31.36.0-255,106,349696,9,350026
7134,0.052904,74.125.24.0-255,66,349762,9,350026
7135,0.054334,104.244.42.0-255,66,349828,9,350026
7136,0.054404,104.244.42.0-255,66,349894,9,350026
7137,0.054408,104.244.42.0-255,66,349960,9,350026
7138,0.054448,104.244.42.0-255,66,350026,9,350026
7139,0.0,172.217.194.0-255,232,232,9,215695
7140,3.1e-05,172.217.194.0-255,1484,1716,9,215695
7141,4.2e-05,172.31.36.0-255,66,1782,9,215695
7142,5e-05,172.217.194.0-255,4320,6102,9,215695
7143,5.4e-05,172.31.36.0-255,66,6168,9,215695
7144,5.9e-05,172.217.194.0-255,2902,9070,9,215695
7145,6.2e-05,172.31.36.0-255,66,9136,9,215695
7146,8.7e-05,172.217.194.0-255,4837,13973,9,215695
7147,9.2e-05,172.31.36.0-255,66,14039,9,215695
7148,0.000109,172.217.194.0-255,1484,15523,9,215695
7149,0.00013,172.217.194.0-255,2902,18425,9,215695
7150,0.000134,172.31.36.0-255,66,18491,9,215695
7151,0.00014,172.217.194.0-255,5738,24229,9,215695
7152,0.000142,172.31.36.0-255,66,24295,9,215695
7153,0.000172,172.217.194.0-255,6797,31092,9,215695
7154,0.000175,172.31.36.0-255,66,31158,9,215695
7155,0.000281,172.217.194.0-255,1484,32642,9,215695
7156,0.000299,172.217.194.0-255,2902,35544,9,215695
7157,0.000302,172.31.36.0-255,66,35610,9,215695
7158,0.000307,172.217.194.0-255,2902,38512,9,215695
7159,0.000309,172.31.36.0-255,66,38578,9,215695
7160,0.000323,172.217.194.0-255,2902,41480,9,215695
7161,0.000326,172.31.36.0-255,66,41546,9,215695
7162,0.000333,172.217.194.0-255,5738,47284,9,215695
7163,0.000335,172.31.36.0-255,66,47350,9,215695
7164,0.000357,172.217.194.0-255,1125,48475,9,215695
7165,0.000374,172.31.36.0-255,66,48541,9,215695
7166,0.000378,172.217.194.0-255,2855,51396,9,215695
7167,0.00038,172.31.36.0-255,66,51462,9,215695
7168,0.000516,172.217.194.0-255,365,51827,9,215695
7169,0.000628,172.217.194.0-255,1484,53311,9,215695
7170,0.000632,172.31.36.0-255,66,53377,9,215695
7171,0.000639,172.217.194.0-255,2902,56279,9,215695
7172,0.000641,172.31.36.0-255,66,56345,9,215695
7173,0.000645,172.217.194.0-255,1484,57829,9,215695
7174,0.000666,172.217.194.0-255,4320,62149,9,215695
7175,0.00067,172.31.36.0-255,66,62215,9,215695
7176,0.000702,172.31.36.0-255,66,62281,9,215695
7177,0.000759,172.31.36.0-255,66,62347,9,215695
7178,0.000868,172.217.194.0-255,1484,63831,9,215695
7179,0.000873,172.217.194.0-255,2902,66733,9,215695
7180,0.000876,172.31.36.0-255,66,66799,9,215695
7181,0.000883,172.217.194.0-255,4320,71119,9,215695
7182,0.000887,172.31.36.0-255,66,71185,9,215695
7183,0.000897,172.217.194.0-255,1484,72669,9,215695
7184,0.00091,172.217.194.0-255,4320,76989,9,215695
7185,0.000913,172.31.36.0-255,66,77055,9,215695
7186,0.000928,172.217.194.0-255,4320,81375,9,215695
7187,0.00093,172.31.36.0-255,66,81441,9,215695
7188,0.00096,172.217.194.0-255,1484,82925,9,215695
7189,0.000974,172.31.36.0-255,66,82991,9,215695
7190,0.001158,172.31.36.0-255,101,83092,9,215695
7191,0.001476,172.217.194.0-255,1484,84576,9,215695
7192,0.001485,172.217.194.0-255,2902,87478,9,215695
7193,0.001489,172.31.36.0-255,66,87544,9,215695
7194,0.001513,172.217.194.0-255,5738,93282,9,215695
7195,0.001516,172.31.36.0-255,66,93348,9,215695
7196,0.00154,172.217.194.0-255,7156,100504,9,215695
7197,0.001542,172.31.36.0-255,66,100570,9,215695
7198,0.001567,172.217.194.0-255,5738,106308,9,215695
7199,0.001571,172.31.36.0-255,66,106374,9,215695
7200,0.001585,172.31.36.0-255,66,106440,9,215695
7201,0.001756,172.217.194.0-255,1484,107924,9,215695
7202,0.001761,172.217.194.0-255,2902,110826,9,215695
7203,0.001773,172.31.36.0-255,66,110892,9,215695
7204,0.001781,172.217.194.0-255,5738,116630,9,215695
7205,0.001784,172.31.36.0-255,66,116696,9,215695
7206,0.001805,172.217.194.0-255,5738,122434,9,215695
7207,0.00181,172.31.36.0-255,66,122500,9,215695
7208,0.001837,172.217.194.0-255,4320,126820,9,215695
7209,0.001841,172.31.36.0-255,66,126886,9,215695
7210,0.001853,172.31.36.0-255,66,126952,9,215695
7211,0.001859,172.217.194.0-255,4320,131272,9,215695
7212,0.00188,172.31.36.0-255,66,131338,9,215695
7213,0.00191,172.217.194.0-255,2184,133522,9,215695
7214,0.001914,172.31.36.0-255,66,133588,9,215695
7215,0.001922,172.217.194.0-255,7156,140744,9,215695
7216,0.001925,172.31.36.0-255,66,140810,9,215695
7217,0.001939,172.31.36.0-255,66,140876,9,215695
7218,0.001947,172.217.194.0-255,6438,147314,9,215695
7219,0.001951,172.31.36.0-255,66,147380,9,215695
7220,0.001968,172.217.194.0-255,5738,153118,9,215695
7221,0.001972,172.31.36.0-255,66,153184,9,215695
7222,0.002026,172.31.36.0-255,66,153250,9,215695
7223,0.00204,172.31.36.0-255,66,153316,9,215695
7224,0.002063,172.217.194.0-255,1484,154800,9,215695
7225,0.002106,172.217.194.0-255,1484,156284,9,215695
7226,0.00211,172.31.36.0-255,66,156350,9,215695
7227,0.00213,172.217.194.0-255,1484,157834,9,215695
7228,0.002138,172.217.194.0-255,5738,163572,9,215695
7229,0.002142,172.31.36.0-255,66,163638,9,215695
7230,0.002146,172.217.194.0-255,2902,166540,9,215695
7231,0.002149,172.31.36.0-255,66,166606,9,215695
7232,0.002161,172.31.36.0-255,66,166672,9,215695
7233,0.002166,172.217.194.0-255,4320,170992,9,215695
7234,0.002169,172.31.36.0-255,66,171058,9,215695
7235,0.002205,172.217.194.0-255,6438,177496,9,215695
7236,0.002209,172.31.36.0-255,66,177562,9,215695
7237,0.002222,172.31.36.0-255,66,177628,9,215695
7238,0.002239,172.31.36.0-255,66,177694,9,215695
7239,0.002275,172.217.194.0-255,7156,184850,9,215695
7240,0.002279,172.31.36.0-255,66,184916,9,215695
7241,0.002313,172.31.36.0-255,66,184982,9,215695
7242,0.002319,172.217.194.0-255,5738,190720,9,215695
7243,0.002322,172.31.36.0-255,66,190786,9,215695
7244,0.002347,172.31.36.0-255,66,190852,9,215695
7245,0.002362,172.217.194.0-255,3602,194454,9,215695
7246,0.002365,172.31.36.0-255,66,194520,9,215695
7247,0.002373,172.217.194.0-255,7156,201676,9,215695
7248,0.002376,172.31.36.0-255,66,201742,9,215695
7249,0.002419,172.31.36.0-255,66,201808,9,215695
7250,0.002424,172.217.194.0-255,4320,206128,9,215695
7251,0.002427,172.31.36.0-255,66,206194,9,215695
7252,0.00247,172.31.36.0-255,66,206260,9,215695
7253,0.002473,172.217.194.0-255,105,206365,9,215695
7254,0.00347,172.217.194.0-255,66,206431,9,215695
7255,0.004417,172.31.36.0-255,105,206536,9,215695
7256,0.006723,172.217.194.0-255,66,206602,9,215695
7257,0.032828,172.31.36.0-255,172,206774,9,215695
7258,0.032876,172.31.36.0-255,1115,207889,9,215695
7259,0.032956,172.31.36.0-255,1514,209403,9,215695
7260,0.032959,172.31.36.0-255,1514,210917,9,215695
7261,0.03296,172.31.36.0-255,1514,212431,9,215695
7262,0.032961,172.31.36.0-255,1514,213945,9,215695
7263,0.032993,172.31.36.0-255,1486,215431,9,215695
7264,0.034352,104.244.42.0-255,66,215497,9,215695
7265,0.034428,104.244.42.0-255,66,215563,9,215695
7266,0.034572,104.244.42.0-255,66,215629,9,215695
7267,0.034631,104.244.42.0-255,66,215695,9,215695
7268,0.0,74.125.68.0-255,153,153,9,387618
7269,1.6e-05,172.31.36.0-255,66,219,9,387618
7270,2.2e-05,74.125.68.0-255,1484,1703,9,387618
7271,2.5e-05,172.31.36.0-255,66,1769,9,387618
7272,5.4e-05,74.125.68.0-255,2902,4671,9,387618
7273,5.7e-05,172.31.36.0-255,66,4737,9,387618
7274,6.4e-05,74.125.68.0-255,5738,10475,9,387618
7275,6.6e-05,172.31.36.0-255,66,10541,9,387618
7276,8.9e-05,74.125.68.0-255,3464,14005,9,387618
7277,9.2e-05,172.31.36.0-255,66,14071,9,387618
7278,0.000143,74.125.68.0-255,1484,15555,9,387618
7279,0.000147,172.31.36.0-255,66,15621,9,387618
7280,0.000151,74.125.68.0-255,2902,18523,9,387618
7281,0.000153,172.31.36.0-255,66,18589,9,387618
7282,0.000198,74.125.68.0-255,5738,24327,9,387618
7283,0.000201,172.31.36.0-255,66,24393,9,387618
7284,0.000221,74.125.68.0-255,5738,30131,9,387618
7285,0.000224,172.31.36.0-255,66,30197,9,387618
7286,0.000242,74.125.68.0-255,1125,31322,9,387618
7287,0.000245,172.31.36.0-255,66,31388,9,387618
7288,0.000278,74.125.68.0-255,7156,38544,9,387618
7289,0.000282,172.31.36.0-255,66,38610,9,387618
7290,0.000289,74.125.68.0-255,5738,44348,9,387618
7291,0.000291,172.31.36.0-255,66,44414,9,387618
7292,0.000335,74.125.68.0-255,3961,48375,9,387618
7293,0.000339,172.31.36.0-255,66,48441,9,387618
7294,0.000373,74.125.68.0-255,4320,52761,9,387618
7295,0.000376,172.31.36.0-255,66,52827,9,387618
7296,0.00038,74.125.68.0-255,1484,54311,9,387618
7297,0.000381,172.31.36.0-255,66,54377,9,387618
7298,0.000401,74.125.68.0-255,4320,58697,9,387618
7299,0.000404,172.31.36.0-255,66,58763,9,387618
7300,0.000411,74.125.68.0-255,6797,65560,9,387618
7301,0.000417,172.31.36.0-255,66,65626,9,387618
7302,0.00043,74.125.68.0-255,401,66027,9,387618
7303,0.000457,74.125.68.0-255,342,66369,9,387618
7304,0.00054,74.125.68.0-255,1484,67853,9,387618
7305,0.000544,172.31.36.0-255,66,67919,9,387618
7306,0.00056,74.125.68.0-255,2902,70821,9,387618
7307,0.000563,172.31.36.0-255,66,70887,9,387618
7308,0.000569,74.125.68.0-255,4320,75207,9,387618
7309,0.000571,172.31.36.0-255,66,75273,9,387618
7310,0.000583,74.125.68.0-255,1484,76757,9,387618
7311,0.000588,74.125.68.0-255,2902,79659,9,387618
7312,0.00059,172.31.36.0-255,66,79725,9,387618
7313,0.000602,74.125.68.0-255,2902,82627,9,387618
7314,0.000604,172.31.36.0-255,66,82693,9,387618
7315,0.000632,74.125.68.0-255,6797,89490,9,387618
7316,0.000639,172.31.36.0-255,66,89556,9,387618
7317,0.000658,172.31.36.0-255,66,89622,9,387618
7318,0.000681,74.125.68.0-255,2543,92165,9,387618
7319,0.000684,172.31.36.0-255,66,92231,9,387618
7320,0.000854,74.125.68.0-255,1484,93715,9,387618
7321,0.000872,74.125.68.0-255,2902,96617,9,387618
7322,0.000876,172.31.36.0-255,66,96683,9,387618
7323,0.000881,74.125.68.0-255,2902,99585,9,387618
7324,0.000883,172.31.36.0-255,66,99651,9,387618
7325,0.000898,74.125.68.0-255,2902,102553,9,387618
7326,0.0009,172.31.36.0-255,66,102619,9,387618
7327,0.000905,74.125.68.0-255,2902,105521,9,387618
7328,0.000907,172.31.36.0-255,66,105587,9,387618
7329,0.000912,74.125.68.0-255,4320,109907,9,387618
7330,0.000915,172.31.36.0-255,66,109973,9,387618
7331,0.000958,172.31.36.0-255,66,110039,9,387618
7332,0.000963,74.125.68.0-255,2902,112941,9,387618
7333,0.000965,172.31.36.0-255,66,113007,9,387618
7334,0.000999,74.125.68.0-255,2902,115909,9,387618
7335,0.001002,172.31.36.0-255,66,115975,9,387618
7336,0.001019,74.125.68.0-255,2184,118159,9,387618
7337,0.001022,172.31.36.0-255,66,118225,9,387618
7338,0.001451,74.125.68.0-255,1484,119709,9,387618
7339,0.00146,74.125.68.0-255,2902,122611,9,387618
7340,0.001464,172.31.36.0-255,66,122677,9,387618
7341,0.001468,74.125.68.0-255,1484,124161,9,387618
7342,0.001486,74.125.68.0-255,2902,127063,9,387618
7343,0.001488,172.31.36.0-255,66,127129,9,387618
7344,0.001509,74.125.68.0-255,5738,132867,9,387618
7345,0.001511,172.31.36.0-255,66,132933,9,387618
7346,0.00153,74.125.68.0-255,2902,135835,9,387618
7347,0.001533,172.31.36.0-255,66,135901,9,387618
7348,0.001556,74.125.68.0-255,7156,143057,9,387618
7349,0.001559,172.31.36.0-255,66,143123,9,387618
7350,0.001576,74.125.68.0-255,1484,144607,9,387618
7351,0.001605,172.31.36.0-255,66,144673,9,387618
7352,0.001672,74.125.68.0-255,1484,146157,9,387618
7353,0.001679,74.125.68.0-255,2902,149059,9,387618
7354,0.001681,172.31.36.0-255,66,149125,9,387618
7355,0.001702,74.125.68.0-255,5738,154863,9,387618
7356,0.001705,172.31.36.0-255,66,154929,9,387618
7357,0.001734,74.125.68.0-255,5738,160667,9,387618
7358,0.001737,172.31.36.0-255,66,160733,9,387618
7359,0.001758,74.125.68.0-255,4320,165053,9,387618
7360,0.001761,172.31.36.0-255,66,165119,9,387618
7361,0.001775,74.125.68.0-255,2184,167303,9,387618
7362,0.001897,74.125.68.0-255,1484,168787,9,387618
7363,0.001919,74.125.68.0-255,2902,171689,9,387618
7364,0.001941,74.125.68.0-255,5738,177427,9,387618
7365,0.001953,74.125.68.0-255,2902,180329,9,387618
7366,0.001967,74.125.68.0-255,4320,184649,9,387618
7367,0.001984,74.125.68.0-255,4320,188969,9,387618
7368,0.002001,74.125.68.0-255,7156,196125,9,387618
7369,0.002058,74.125.68.0-255,5020,201145,9,387618
7370,0.00216,74.125.68.0-255,1484,202629,9,387618
7371,0.002167,74.125.68.0-255,2902,205531,9,387618
7372,0.002186,74.125.68.0-255,2902,208433,9,387618
7373,0.002199,74.125.68.0-255,2902,211335,9,387618
7374,0.002216,74.125.68.0-255,1484,212819,9,387618
7375,0.002228,74.125.68.0-255,5738,218557,9,387618
7376,0.002247,74.125.68.0-255,2902,221459,9,387618
7377,0.002253,74.125.68.0-255,4320,225779,9,387618
7378,0.002274,74.125.68.0-255,1484,227263,9,387618
7379,0.002281,74.125.68.0-255,7156,234419,9,387618
7380,0.002284,74.125.68.0-255,766,235185,9,387618
7381,0.002286,74.125.68.0-255,1484,236669,9,387618
7382,0.002303,74.125.68.0-255,4320,240989,9,387618
7383,0.002334,74.125.68.0-255,1484,242473,9,387618
7384,0.002352,74.125.68.0-255,7156,249629,9,387618
7385,0.002374,74.125.68.0-255,1484,251113,9,387618
7386,0.002395,74.125.68.0-255,1484,252597,9,387618
7387,0.002398,74.125.68.0-255,2902,255499,9,387618
7388,0.002438,74.125.68.0-255,1484,256983,9,387618
7389,0.002457,74.125.68.0-255,3602,260585,9,387618
7390,0.002488,74.125.68.0-255,2902,263487,9,387618
7391,0.0025,74.125.68.0-255,1484,264971,9,387618
7392,0.002515,74.125.68.0-255,1484,266455,9,387618
7393,0.002528,74.125.68.0-255,4320,270775,9,387618
7394,0.002539,74.125.68.0-255,2902,273677,9,387618
7395,0.00255,74.125.68.0-255,1484,275161,9,387618
7396,0.002552,74.125.68.0-255,1484,276645,9,387618
7397,0.003383,172.31.36.0-255,66,276711,9,387618
7398,0.00593,74.125.68.0-255,5738,282449,9,387618
7399,0.005937,172.31.36.0-255,66,282515,9,387618
7400,0.00847,74.125.68.0-255,5738,288253,9,387618
7401,0.008475,172.31.36.0-255,66,288319,9,387618
7402,0.011002,74.125.68.0-255,5738,294057,9,387618
7403,0.011009,172.31.36.0-255,66,294123,9,387618
7404,0.013549,74.125.68.0-255,5738,299861,9,387618
7405,0.013558,172.31.36.0-255,66,299927,9,387618
7406,0.01609,74.125.68.0-255,5738,305665,9,387618
7407,0.016098,172.31.36.0-255,66,305731,9,387618
7408,0.018631,74.125.68.0-255,5738,311469,9,387618
7409,0.018643,172.31.36.0-255,66,311535,9,387618
7410,0.02118,74.125.68.0-255,5738,317273,9,387618
7411,0.021188,172.31.36.0-255,66,317339,9,387618
7412,0.02373,74.125.68.0-255,5738,323077,9,387618
7413,0.023737,172.31.36.0-255,66,323143,9,387618
7414,0.026268,74.125.68.0-255,5738,328881,9,387618
7415,0.026276,172.31.36.0-255,66,328947,9,387618
7416,0.028809,74.125.68.0-255,2902,331849,9,387618
7417,0.028817,172.31.36.0-255,66,331915,9,387618
7418,0.028842,74.125.68.0-255,2902,334817,9,387618
7419,0.028846,172.31.36.0-255,66,334883,9,387618
7420,0.031349,74.125.68.0-255,4320,339203,9,387618
7421,0.031358,172.31.36.0-255,66,339269,9,387618
7422,0.03138,74.125.68.0-255,1484,340753,9,387618
7423,0.03391,74.125.68.0-255,4320,345073,9,387618
7424,0.033916,172.31.36.0-255,66,345139,9,387618
7425,0.034325,172.31.36.0-255,172,345311,9,387618
7426,0.034369,172.31.36.0-255,1112,346423,9,387618
7427,0.034444,172.31.36.0-255,1514,347937,9,387618
7428,0.034447,172.31.36.0-255,1514,349451,9,387618
7429,0.034452,172.31.36.0-255,1514,350965,9,387618
7430,0.034453,172.31.36.0-255,1514,352479,9,387618
7431,0.034475,172.31.36.0-255,1491,353970,9,387618
7432,0.035868,104.244.42.0-255,66,354036,9,387618
7433,0.035887,104.244.42.0-255,66,354102,9,387618
7434,0.035974,104.244.42.0-255,66,354168,9,387618
7435,0.036024,104.244.42.0-255,66,354234,9,387618
7436,0.036439,74.125.68.0-255,4320,358554,9,387618
7437,0.036443,172.31.36.0-255,66,358620,9,387618
7438,0.036484,74.125.68.0-255,1484,360104,9,387618
7439,0.03897,74.125.68.0-255,4320,364424,9,387618
7440,0.038992,172.31.36.0-255,66,364490,9,387618
7441,0.041517,74.125.68.0-255,5738,370228,9,387618
7442,0.041523,172.31.36.0-255,66,370294,9,387618
7443,0.04404,74.125.68.0-255,5738,376032,9,387618
7444,0.044046,172.31.36.0-255,66,376098,9,387618
7445,0.046599,74.125.68.0-255,5738,381836,9,387618
7446,0.046604,172.31.36.0-255,66,381902,9,387618
7447,0.049136,74.125.68.0-255,5479,387381,9,387618
7448,0.049141,172.31.36.0-255,66,387447,9,387618
7449,0.049332,172.31.36.0-255,105,387552,9,387618
7450,0.051826,74.125.68.0-255,66,387618,9,387618
7451,0.0,74.125.68.0-255,152,152,9,355311
7452,1.8e-05,172.31.36.0-255,66,218,9,355311
7453,2.5e-05,74.125.68.0-255,1484,1702,9,355311
7454,3e-05,172.31.36.0-255,66,1768,9,355311
7455,3.5e-05,74.125.68.0-255,2902,4670,9,355311
7456,3.9e-05,172.31.36.0-255,66,4736,9,355311
7457,4.5e-05,74.125.68.0-255,5738,10474,9,355311
7458,4.9e-05,172.31.36.0-255,66,10540,9,355311
7459,5.5e-05,74.125.68.0-255,3428,13968,9,355311
7460,5.8e-05,172.31.36.0-255,66,14034,9,355311
7461,0.000175,74.125.68.0-255,1484,15518,9,355311
7462,0.000179,172.31.36.0-255,66,15584,9,355311
7463,0.000184,74.125.68.0-255,2902,18486,9,355311
7464,0.000187,172.31.36.0-255,66,18552,9,355311
7465,0.000217,74.125.68.0-255,5738,24290,9,355311
7466,0.000221,172.31.36.0-255,66,24356,9,355311
7467,0.000229,74.125.68.0-255,6797,31153,9,355311
7468,0.000231,172.31.36.0-255,66,31219,9,355311
7469,0.00025,74.125.68.0-255,1484,32703,9,355311
7470,0.000252,172.31.36.0-255,66,32769,9,355311
7471,0.000276,74.125.68.0-255,2902,35671,9,355311
7472,0.000278,172.31.36.0-255,66,35737,9,355311
7473,0.000285,74.125.68.0-255,5738,41475,9,355311
7474,0.000287,172.31.36.0-255,66,41541,9,355311
7475,0.000309,74.125.68.0-255,6797,48338,9,355311
7476,0.000311,172.31.36.0-255,66,48404,9,355311
7477,0.000401,74.125.68.0-255,1484,49888,9,355311
7478,0.000404,172.31.36.0-255,66,49954,9,355311
7479,0.000409,74.125.68.0-255,2902,52856,9,355311
7480,0.000412,172.31.36.0-255,66,52922,9,355311
7481,0.000433,74.125.68.0-255,2902,55824,9,355311
7482,0.000436,172.31.36.0-255,66,55890,9,355311
7483,0.000456,74.125.68.0-255,2902,58792,9,355311
7484,0.000459,172.31.36.0-255,66,58858,9,355311
7485,0.000466,74.125.68.0-255,5738,64596,9,355311
7486,0.000468,172.31.36.0-255,66,64662,9,355311
7487,0.0005,74.125.68.0-255,1435,66097,9,355311
7488,0.000531,74.125.68.0-255,113,66210,9,355311
7489,0.000713,74.125.68.0-255,329,66539,9,355311
7490,0.000718,172.31.36.0-255,66,66605,9,355311
7491,0.000985,74.125.68.0-255,1484,68089,9,355311
7492,0.000991,74.125.68.0-255,2902,70991,9,355311
7493,0.000995,172.31.36.0-255,66,71057,9,355311
7494,0.001018,74.125.68.0-255,5738,76795,9,355311
7495,0.001021,172.31.36.0-255,66,76861,9,355311
7496,0.001025,74.125.68.0-255,1484,78345,9,355311
7497,0.001042,74.125.68.0-255,5738,84083,9,355311
7498,0.001045,172.31.36.0-255,66,84149,9,355311
7499,0.001069,74.125.68.0-255,5738,89887,9,355311
7500,0.001071,172.31.36.0-255,66,89953,9,355311
7501,0.001098,172.31.36.0-255,66,90019,9,355311
7502,0.001111,74.125.68.0-255,2184,92203,9,355311
7503,0.001114,172.31.36.0-255,66,92269,9,355311
7504,0.001363,74.125.68.0-255,1484,93753,9,355311
7505,0.001369,74.125.68.0-255,2902,96655,9,355311
7506,0.001373,172.31.36.0-255,66,96721,9,355311
7507,0.001377,74.125.68.0-255,1484,98205,9,355311
7508,0.001396,74.125.68.0-255,4320,102525,9,355311
7509,0.001399,172.31.36.0-255,66,102591,9,355311
7510,0.001416,74.125.68.0-255,5738,108329,9,355311
7511,0.001418,172.31.36.0-255,66,108395,9,355311
7512,0.001451,74.125.68.0-255,7156,115551,9,355311
7513,0.001454,172.31.36.0-255,66,115617,9,355311
7514,0.00146,74.125.68.0-255,4320,119937,9,355311
7515,0.001462,172.31.36.0-255,66,120003,9,355311
7516,0.00148,74.125.68.0-255,6438,126441,9,355311
7517,0.001482,172.31.36.0-255,66,126507,9,355311
7518,0.001692,74.125.68.0-255,1484,127991,9,355311
7519,0.001698,74.125.68.0-255,2902,130893,9,355311
7520,0.001702,172.31.36.0-255,66,130959,9,355311
7521,0.001726,74.125.68.0-255,5738,136697,9,355311
7522,0.001729,74.125.68.0-255,1484,138181,9,355311
7523,0.001733,172.31.36.0-255,66,138247,9,355311
7524,0.001743,74.125.68.0-255,2902,141149,9,355311
7525,0.001745,172.31.36.0-255,66,141215,9,355311
7526,0.001765,74.125.68.0-255,5738,146953,9,355311
7527,0.001767,172.31.36.0-255,66,147019,9,355311
7528,0.00178,74.125.68.0-255,1484,148503,9,355311
7529,0.001797,74.125.68.0-255,7156,155659,9,355311
7530,0.0018,172.31.36.0-255,66,155725,9,355311
7531,0.001821,74.125.68.0-255,5020,160745,9,355311
7532,0.001824,172.31.36.0-255,66,160811,9,355311
7533,0.001851,74.125.68.0-255,1484,162295,9,355311
7534,0.001867,74.125.68.0-255,2902,165197,9,355311
7535,0.00187,172.31.36.0-255,66,165263,9,355311
7536,0.001875,74.125.68.0-255,2902,168165,9,355311
7537,0.001878,172.31.36.0-255,66,168231,9,355311
7538,0.001891,74.125.68.0-255,1484,169715,9,355311
7539,0.00191,74.125.68.0-255,5738,175453,9,355311
7540,0.001914,172.31.36.0-255,66,175519,9,355311
7541,0.001954,172.31.36.0-255,66,175585,9,355311
7542,0.001959,74.125.68.0-255,4320,179905,9,355311
7543,0.001962,172.31.36.0-255,66,179971,9,355311
7544,0.001985,74.125.68.0-255,3602,183573,9,355311
7545,0.001987,172.31.36.0-255,66,183639,9,355311
7546,0.003948,74.125.68.0-255,1484,185123,9,355311
7547,0.003977,74.125.68.0-255,4320,189443,9,355311
7548,0.003982,172.31.36.0-255,66,189509,9,355311
7549,0.00599,74.125.68.0-255,5738,195247,9,355311
7550,0.005994,172.31.36.0-255,66,195313,9,355311
7551,0.007989,74.125.68.0-255,5738,201051,9,355311
7552,0.007995,172.31.36.0-255,66,201117,9,355311
7553,0.010001,74.125.68.0-255,5738,206855,9,355311
7554,0.010008,172.31.36.0-255,66,206921,9,355311
7555,0.012018,74.125.68.0-255,5738,212659,9,355311
7556,0.012027,172.31.36.0-255,66,212725,9,355311
7557,0.014036,74.125.68.0-255,5738,218463,9,355311
7558,0.014044,172.31.36.0-255,66,218529,9,355311
7559,0.01605,74.125.68.0-255,5738,224267,9,355311
7560,0.016058,172.31.36.0-255,66,224333,9,355311
7561,0.018064,74.125.68.0-255,5738,230071,9,355311
7562,0.018073,172.31.36.0-255,66,230137,9,355311
7563,0.02009,74.125.68.0-255,5738,235875,9,355311
7564,0.020099,172.31.36.0-255,66,235941,9,355311
7565,0.022101,74.125.68.0-255,5738,241679,9,355311
7566,0.022108,172.31.36.0-255,66,241745,9,355311
7567,0.02413,74.125.68.0-255,5738,247483,9,355311
7568,0.024137,172.31.36.0-255,66,247549,9,355311
7569,0.026153,74.125.68.0-255,5738,253287,9,355311
7570,0.02616,172.31.36.0-255,66,253353,9,355311
7571,0.028161,74.125.68.0-255,5738,259091,9,355311
7572,0.028169,172.31.36.0-255,66,259157,9,355311
7573,0.030171,74.125.68.0-255,5738,264895,9,355311
7574,0.030179,172.31.36.0-255,66,264961,9,355311
7575,0.032176,74.125.68.0-255,5738,270699,9,355311
7576,0.032184,172.31.36.0-255,66,270765,9,355311
7577,0.034193,74.125.68.0-255,5738,276503,9,355311
7578,0.034201,172.31.36.0-255,66,276569,9,355311
7579,0.036202,74.125.68.0-255,5738,282307,9,355311
7580,0.03621,172.31.36.0-255,66,282373,9,355311
7581,0.03741,172.31.36.0-255,172,282545,9,355311
7582,0.037441,172.31.36.0-255,1112,283657,9,355311
7583,0.037506,172.31.36.0-255,1514,285171,9,355311
7584,0.037508,172.31.36.0-255,1514,286685,9,355311
7585,0.037509,172.31.36.0-255,1514,288199,9,355311
7586,0.03751,172.31.36.0-255,1514,289713,9,355311
7587,0.03754,172.31.36.0-255,1490,291203,9,355311
7588,0.038228,74.125.68.0-255,5738,296941,9,355311
7589,0.038235,172.31.36.0-255,66,297007,9,355311
7590,0.038944,104.244.42.0-255,66,297073,9,355311
7591,0.038998,104.244.42.0-255,66,297139,9,355311
7592,0.039085,104.244.42.0-255,66,297205,9,355311
7593,0.039091,104.244.42.0-255,66,297271,9,355311
7594,0.040256,74.125.68.0-255,5738,303009,9,355311
7595,0.040263,172.31.36.0-255,66,303075,9,355311
7596,0.042318,74.125.68.0-255,5738,308813,9,355311
7597,0.042325,172.31.36.0-255,66,308879,9,355311
7598,0.044347,74.125.68.0-255,5738,314617,9,355311
7599,0.044357,172.31.36.0-255,66,314683,9,355311
7600,0.046377,74.125.68.0-255,5738,320421,9,355311
7601,0.046383,172.31.36.0-255,66,320487,9,355311
7602,0.048409,74.125.68.0-255,5738,326225,9,355311
7603,0.048416,172.31.36.0-255,66,326291,9,355311
7604,0.050423,74.125.68.0-255,5738,332029,9,355311
7605,0.05043,172.31.36.0-255,66,332095,9,355311
7606,0.052441,74.125.68.0-255,5738,337833,9,355311
7607,0.052447,172.31.36.0-255,66,337899,9,355311
7608,0.054466,74.125.68.0-255,5738,343637,9,355311
7609,0.054473,172.31.36.0-255,66,343703,9,355311
7610,0.056504,74.125.68.0-255,5738,349441,9,355311
7611,0.056511,172.31.36.0-255,66,349507,9,355311
7612,0.058522,74.125.68.0-255,5738,355245,9,355311
7613,0.05853,172.31.36.0-255,66,355311,9,355311
7614,0.0,74.125.68.0-255,147,147,9,344079
7615,2.9e-05,172.31.36.0-255,66,213,9,344079
7616,3.6e-05,74.125.68.0-255,1484,1697,9,344079
7617,4.1e-05,172.31.36.0-255,66,1763,9,344079
7618,4.6e-05,74.125.68.0-255,2902,4665,9,344079
7619,4.8e-05,172.31.36.0-255,66,4731,9,344079
7620,7.3e-05,74.125.68.0-255,5738,10469,9,344079
7621,7.6e-05,172.31.36.0-255,66,10535,9,344079
7622,7.8e-05,74.125.68.0-255,1484,12019,9,344079
7623,8e-05,172.31.36.0-255,66,12085,9,344079
7624,0.000109,74.125.68.0-255,3493,15578,9,344079
7625,0.000112,172.31.36.0-255,66,15644,9,344079
7626,0.000118,74.125.68.0-255,5738,21382,9,344079
7627,0.00012,172.31.36.0-255,66,21448,9,344079
7628,0.000134,74.125.68.0-255,1484,22932,9,344079
7629,0.000137,172.31.36.0-255,66,22998,9,344079
7630,0.000153,74.125.68.0-255,7156,30154,9,344079
7631,0.000155,172.31.36.0-255,66,30220,9,344079
7632,0.000175,74.125.68.0-255,1125,31345,9,344079
7633,0.000177,172.31.36.0-255,66,31411,9,344079
7634,0.000218,74.125.68.0-255,1484,32895,9,344079
7635,0.000221,172.31.36.0-255,66,32961,9,344079
7636,0.000236,74.125.68.0-255,2902,35863,9,344079
7637,0.000238,172.31.36.0-255,66,35929,9,344079
7638,0.000262,74.125.68.0-255,4320,40249,9,344079
7639,0.000266,172.31.36.0-255,66,40315,9,344079
7640,0.000284,74.125.68.0-255,1484,41799,9,344079
7641,0.000286,172.31.36.0-255,66,41865,9,344079
7642,0.000292,74.125.68.0-255,4320,46185,9,344079
7643,0.000294,172.31.36.0-255,66,46251,9,344079
7644,0.000309,74.125.68.0-255,2543,48794,9,344079
7645,0.000313,172.31.36.0-255,66,48860,9,344079
7646,0.00032,74.125.68.0-255,7156,56016,9,344079
7647,0.000322,172.31.36.0-255,66,56082,9,344079
7648,0.000325,74.125.68.0-255,1484,57566,9,344079
7649,0.000346,74.125.68.0-255,2902,60468,9,344079
7650,0.000349,172.31.36.0-255,66,60534,9,344079
7651,0.000356,74.125.68.0-255,5379,65913,9,344079
7652,0.000359,172.31.36.0-255,66,65979,9,344079
7653,0.000361,74.125.68.0-255,359,66338,9,344079
7654,0.000399,74.125.68.0-255,384,66722,9,344079
7655,0.000723,74.125.68.0-255,1484,68206,9,344079
7656,0.000727,172.31.36.0-255,66,68272,9,344079
7657,0.000732,74.125.68.0-255,1484,69756,9,344079
7658,0.00075,74.125.68.0-255,1484,71240,9,344079
7659,0.000753,172.31.36.0-255,66,71306,9,344079
7660,0.000758,74.125.68.0-255,4320,75626,9,344079
7661,0.00076,172.31.36.0-255,66,75692,9,344079
7662,0.000767,74.125.68.0-255,5738,81430,9,344079
7663,0.000769,172.31.36.0-255,66,81496,9,344079
7664,0.000793,74.125.68.0-255,2902,84398,9,344079
7665,0.000796,172.31.36.0-255,66,84464,9,344079
7666,0.000807,172.31.36.0-255,66,84530,9,344079
7667,0.000838,74.125.68.0-255,2902,87432,9,344079
7668,0.000841,172.31.36.0-255,66,87498,9,344079
7669,0.000863,74.125.68.0-255,4471,91969,9,344079
7670,0.000866,172.31.36.0-255,66,92035,9,344079
7671,0.00111,74.125.68.0-255,1484,93519,9,344079
7672,0.001119,74.125.68.0-255,2902,96421,9,344079
7673,0.001122,172.31.36.0-255,66,96487,9,344079
7674,0.001141,74.125.68.0-255,5738,102225,9,344079
7675,0.001144,172.31.36.0-255,66,102291,9,344079
7676,0.00115,74.125.68.0-255,2902,105193,9,344079
7677,0.001151,172.31.36.0-255,66,105259,9,344079
7678,0.001168,74.125.68.0-255,1484,106743,9,344079
7679,0.001174,74.125.68.0-255,5738,112481,9,344079
7680,0.001177,172.31.36.0-255,66,112547,9,344079
7681,0.001202,74.125.68.0-255,2902,115449,9,344079
7682,0.001205,172.31.36.0-255,66,115515,9,344079
7683,0.001237,172.31.36.0-255,66,115581,9,344079
7684,0.001241,74.125.68.0-255,2184,117765,9,344079
7685,0.001244,172.31.36.0-255,66,117831,9,344079
7686,0.001807,74.125.68.0-255,1484,119315,9,344079
7687,0.001814,74.125.68.0-255,2902,122217,9,344079
7688,0.001818,172.31.36.0-255,66,122283,9,344079
7689,0.001823,74.125.68.0-255,2902,125185,9,344079
7690,0.001825,172.31.36.0-255,66,125251,9,344079
7691,0.00184,74.125.68.0-255,2902,128153,9,344079
7692,0.001843,172.31.36.0-255,66,128219,9,344079
7693,0.001861,74.125.68.0-255,2902,131121,9,344079
7694,0.001863,172.31.36.0-255,66,131187,9,344079
7695,0.001882,74.125.68.0-255,7156,138343,9,344079
7696,0.001884,172.31.36.0-255,66,138409,9,344079
7697,0.00189,74.125.68.0-255,5738,144147,9,344079
7698,0.001892,172.31.36.0-255,66,144213,9,344079
7699,0.001918,74.125.68.0-255,5738,149951,9,344079
7700,0.00192,172.31.36.0-255,66,150017,9,344079
7701,0.001925,74.125.68.0-255,2184,152201,9,344079
7702,0.001927,172.31.36.0-255,66,152267,9,344079
7703,0.001993,74.125.68.0-255,1484,153751,9,344079
7704,0.002012,74.125.68.0-255,1484,155235,9,344079
7705,0.002015,172.31.36.0-255,66,155301,9,344079
7706,0.002033,74.125.68.0-255,1484,156785,9,344079
7707,0.002038,74.125.68.0-255,4320,161105,9,344079
7708,0.002041,172.31.36.0-255,66,161171,9,344079
7709,0.002098,172.31.36.0-255,66,161237,9,344079
7710,0.002103,74.125.68.0-255,4320,165557,9,344079
7711,0.002105,172.31.36.0-255,66,165623,9,344079
7712,0.00211,74.125.68.0-255,5738,171361,9,344079
7713,0.002112,172.31.36.0-255,66,171427,9,344079
7714,0.002124,74.125.68.0-255,2902,174329,9,344079
7715,0.002126,172.31.36.0-255,66,174395,9,344079
7716,0.002139,74.125.68.0-255,3602,177997,9,344079
7717,0.002141,172.31.36.0-255,66,178063,9,344079
7718,0.002217,74.125.68.0-255,1484,179547,9,344079
7719,0.002231,74.125.68.0-255,2902,182449,9,344079
7720,0.002234,172.31.36.0-255,66,182515,9,344079
7721,0.002238,74.125.68.0-255,2902,185417,9,344079
7722,0.00224,172.31.36.0-255,66,185483,9,344079
7723,0.002251,74.125.68.0-255,2902,188385,9,344079
7724,0.002254,172.31.36.0-255,66,188451,9,344079
7725,0.002269,74.125.68.0-255,1484,189935,9,344079
7726,0.002287,74.125.68.0-255,5738,195673,9,344079
7727,0.00229,172.31.36.0-255,66,195739,9,344079
7728,0.002303,74.125.68.0-255,1484,197223,9,344079
7729,0.002309,74.125.68.0-255,5738,202961,9,344079
7730,0.002312,172.31.36.0-255,66,203027,9,344079
7731,0.002332,74.125.68.0-255,4320,207347,9,344079
7732,0.002334,172.31.36.0-255,66,207413,9,344079
7733,0.002339,74.125.68.0-255,5020,212433,9,344079
7734,0.002341,172.31.36.0-255,66,212499,9,344079
7735,0.004785,74.125.68.0-255,4320,216819,9,344079
7736,0.004789,172.31.36.0-255,66,216885,9,344079
7737,0.004806,74.125.68.0-255,1484,218369,9,344079
7738,0.007232,74.125.68.0-255,4320,222689,9,344079
7739,0.007238,172.31.36.0-255,66,222755,9,344079
7740,0.009908,74.125.68.0-255,5738,228493,9,344079
7741,0.009918,172.31.36.0-255,66,228559,9,344079
7742,0.012385,74.125.68.0-255,5738,234297,9,344079
7743,0.012397,172.31.36.0-255,66,234363,9,344079
7744,0.014863,74.125.68.0-255,5738,240101,9,344079
7745,0.014872,172.31.36.0-255,66,240167,9,344079
7746,0.017341,74.125.68.0-255,5738,245905,9,344079
7747,0.017347,172.31.36.0-255,66,245971,9,344079
7748,0.019808,74.125.68.0-255,4320,250291,9,344079
7749,0.019816,172.31.36.0-255,66,250357,9,344079
7750,0.019853,74.125.68.0-255,1484,251841,9,344079
7751,0.022297,74.125.68.0-255,4320,256161,9,344079
7752,0.022307,172.31.36.0-255,66,256227,9,344079
7753,0.024776,74.125.68.0-255,5738,261965,9,344079
7754,0.024784,172.31.36.0-255,66,262031,9,344079
7755,0.027295,74.125.68.0-255,4320,266351,9,344079
7756,0.027302,172.31.36.0-255,66,266417,9,344079
7757,0.027322,74.125.68.0-255,1484,267901,9,344079
7758,0.02977,74.125.68.0-255,4320,272221,9,344079
7759,0.029777,172.31.36.0-255,66,272287,9,344079
7760,0.032232,74.125.68.0-255,5738,278025,9,344079
7761,0.03224,172.31.36.0-255,66,278091,9,344079
7762,0.034703,74.125.68.0-255,5738,283829,9,344079
7763,0.034711,172.31.36.0-255,66,283895,9,344079
7764,0.037164,74.125.68.0-255,4320,288215,9,344079
7765,0.037172,172.31.36.0-255,66,288281,9,344079
7766,0.037202,74.125.68.0-255,1484,289765,9,344079
7767,0.039661,74.125.68.0-255,4320,294085,9,344079
7768,0.039669,172.31.36.0-255,66,294151,9,344079
7769,0.042132,74.125.68.0-255,5738,299889,9,344079
7770,0.042139,172.31.36.0-255,66,299955,9,344079
7771,0.044585,74.125.68.0-255,5738,305693,9,344079
7772,0.044593,172.31.36.0-255,66,305759,9,344079
7773,0.045772,172.31.36.0-255,172,305931,9,344079
7774,0.045823,172.31.36.0-255,1116,307047,9,344079
7775,0.0459,172.31.36.0-255,1514,308561,9,344079
7776,0.045902,172.31.36.0-255,1514,310075,9,344079
7777,0.045906,172.31.36.0-255,1514,311589,9,344079
7778,0.045907,172.31.36.0-255,106,311695,9,344079
7779,0.04704,74.125.68.0-255,5738,317433,9,344079
7780,0.047046,172.31.36.0-255,66,317499,9,344079
7781,0.047426,104.244.42.0-255,66,317565,9,344079
7782,0.047511,104.244.42.0-255,66,317631,9,344079
7783,0.047557,104.244.42.0-255,66,317697,9,344079
7784,0.047561,104.244.42.0-255,66,317763,9,344079
7785,0.049543,74.125.68.0-255,4320,322083,9,344079
7786,0.049548,172.31.36.0-255,66,322149,9,344079
7787,0.049578,74.125.68.0-255,1484,323633,9,344079
7788,0.052008,74.125.68.0-255,4320,327953,9,344079
7789,0.052013,172.31.36.0-255,66,328019,9,344079
7790,0.054558,74.125.68.0-255,5738,333757,9,344079
7791,0.054563,172.31.36.0-255,66,333823,9,344079
7792,0.057008,74.125.68.0-255,4320,338143,9,344079
7793,0.057013,172.31.36.0-255,66,338209,9,344079
7794,0.05708,74.125.68.0-255,1484,339693,9,344079
7795,0.059465,74.125.68.0-255,4320,344013,9,344079
7796,0.05947,172.31.36.0-255,66,344079,9,344079
7797,0.0,74.125.24.0-255,153,153,9,238651
7798,3e-05,172.31.36.0-255,66,219,9,238651
7799,3.6e-05,74.125.24.0-255,1484,1703,9,238651
7800,4.1e-05,172.31.36.0-255,66,1769,9,238651
7801,4.6e-05,74.125.24.0-255,2902,4671,9,238651
7802,4.9e-05,172.31.36.0-255,66,4737,9,238651
7803,6.4e-05,74.125.24.0-255,7156,11893,9,238651
7804,6.8e-05,172.31.36.0-255,66,11959,9,238651
7805,7.1e-05,74.125.24.0-255,2070,14029,9,238651
7806,7.4e-05,172.31.36.0-255,66,14095,9,238651
7807,0.000226,74.125.24.0-255,1484,15579,9,238651
7808,0.000231,172.31.36.0-255,66,15645,9,238651
7809,0.000236,74.125.24.0-255,2902,18547,9,238651
7810,0.000239,172.31.36.0-255,66,18613,9,238651
7811,0.000243,74.125.24.0-255,2902,21515,9,238651
7812,0.000246,172.31.36.0-255,66,21581,9,238651
7813,0.000286,74.125.24.0-255,2902,24483,9,238651
7814,0.000289,172.31.36.0-255,66,24549,9,238651
7815,0.000296,74.125.24.0-255,6797,31346,9,238651
7816,0.000299,172.31.36.0-255,66,31412,9,238651
7817,0.00049,74.125.24.0-255,1484,32896,9,238651
7818,0.000496,172.31.36.0-255,66,32962,9,238651
7819,0.000501,74.125.24.0-255,2902,35864,9,238651
7820,0.000503,172.31.36.0-255,66,35930,9,238651
7821,0.000538,74.125.24.0-255,5738,41668,9,238651
7822,0.000541,172.31.36.0-255,66,41734,9,238651
7823,0.000549,74.125.24.0-255,7156,48890,9,238651
7824,0.000554,172.31.36.0-255,66,48956,9,238651
7825,0.000575,74.125.24.0-255,3961,52917,9,238651
7826,0.000579,172.31.36.0-255,66,52983,9,238651
7827,0.000592,172.31.36.0-255,66,53049,9,238651
7828,0.000624,74.125.24.0-255,2543,55592,9,238651
7829,0.000627,172.31.36.0-255,66,55658,9,238651
7830,0.000799,74.125.24.0-255,645,56303,9,238651
7831,0.000807,172.31.36.0-255,66,56369,9,238651
7832,0.000953,74.125.24.0-255,1484,57853,9,238651
7833,0.000963,74.125.24.0-255,2902,60755,9,238651
7834,0.000967,172.31.36.0-255,66,60821,9,238651
7835,0.000974,74.125.24.0-255,5738,66559,9,238651
7836,0.000977,172.31.36.0-255,66,66625,9,238651
7837,0.001037,172.31.36.0-255,66,66691,9,238651
7838,0.001043,74.125.24.0-255,4320,71011,9,238651
7839,0.001045,172.31.36.0-255,66,71077,9,238651
7840,0.001077,74.125.24.0-255,6438,77515,9,238651
7841,0.001081,172.31.36.0-255,66,77581,9,238651
7842,0.001424,74.125.24.0-255,1484,79065,9,238651
7843,0.001431,74.125.24.0-255,2902,81967,9,238651
7844,0.001435,172.31.36.0-255,66,82033,9,238651
7845,0.001461,74.125.24.0-255,5738,87771,9,238651
7846,0.001463,172.31.36.0-255,66,87837,9,238651
7847,0.001498,74.125.24.0-255,4320,92157,9,238651
7848,0.001501,172.31.36.0-255,66,92223,9,238651
7849,0.001547,172.31.36.0-255,66,92289,9,238651
7850,0.001556,172.31.36.0-255,66,92355,9,238651
7851,0.00156,74.125.24.0-255,2184,94539,9,238651
7852,0.001563,172.31.36.0-255,66,94605,9,238651
7853,0.002104,74.125.24.0-255,1484,96089,9,238651
7854,0.002118,74.125.24.0-255,2902,98991,9,238651
7855,0.002121,172.31.36.0-255,66,99057,9,238651
7856,0.002134,74.125.24.0-255,4320,103377,9,238651
7857,0.002142,172.31.36.0-255,66,103443,9,238651
7858,0.002174,172.31.36.0-255,66,103509,9,238651
7859,0.00221,74.125.24.0-255,5738,109247,9,238651
7860,0.002212,172.31.36.0-255,66,109313,9,238651
7861,0.002254,172.31.36.0-255,66,109379,9,238651
7862,0.002436,74.125.24.0-255,1484,110863,9,238651
7863,0.00244,74.125.24.0-255,1484,112347,9,238651
7864,0.002442,172.31.36.0-255,66,112413,9,238651
7865,0.002467,74.125.24.0-255,1484,113897,9,238651
7866,0.002474,74.125.24.0-255,5738,119635,9,238651
7867,0.002477,172.31.36.0-255,66,119701,9,238651
7868,0.002482,74.125.24.0-255,5738,125439,9,238651
7869,0.002485,172.31.36.0-255,66,125505,9,238651
7870,0.002523,74.125.24.0-255,7156,132661,9,238651
7871,0.002526,172.31.36.0-255,66,132727,9,238651
7872,0.002542,172.31.36.0-255,66,132793,9,238651
7873,0.002583,172.31.36.0-255,66,132859,9,238651
7874,0.002612,74.125.24.0-255,7156,140015,9,238651
7875,0.002615,172.31.36.0-255,66,140081,9,238651
7876,0.002626,172.31.36.0-255,66,140147,9,238651
7877,0.002628,74.125.24.0-255,1484,141631,9,238651
7878,0.002649,74.125.24.0-255,2902,144533,9,238651
7879,0.002652,172.31.36.0-255,66,144599,9,238651
7880,0.002679,74.125.24.0-255,5738,150337,9,238651
7881,0.002682,172.31.36.0-255,66,150403,9,238651
7882,0.002703,172.31.36.0-255,66,150469,9,238651
7883,0.002728,74.125.24.0-255,1484,151953,9,238651
7884,0.002741,172.31.36.0-255,66,152019,9,238651
7885,0.002807,172.31.36.0-255,66,152085,9,238651
7886,0.002822,172.31.36.0-255,66,152151,9,238651
7887,0.002826,74.125.24.0-255,2902,155053,9,238651
7888,0.002828,172.31.36.0-255,66,155119,9,238651
7889,0.002831,74.125.24.0-255,1484,156603,9,238651
7890,0.002836,74.125.24.0-255,4320,160923,9,238651
7891,0.002838,172.31.36.0-255,66,160989,9,238651
7892,0.002867,74.125.24.0-255,6438,167427,9,238651
7893,0.00287,172.31.36.0-255,66,167493,9,238651
7894,0.002874,74.125.24.0-255,2902,170395,9,238651
7895,0.002876,172.31.36.0-255,66,170461,9,238651
7896,0.002879,74.125.24.0-255,1484,171945,9,238651
7897,0.002903,74.125.24.0-255,1484,173429,9,238651
7898,0.002905,172.31.36.0-255,66,173495,9,238651
7899,0.002937,172.31.36.0-255,66,173561,9,238651
7900,0.002968,172.31.36.0-255,66,173627,9,238651
7901,0.003,172.31.36.0-255,66,173693,9,238651
7902,0.003004,74.125.24.0-255,2902,176595,9,238651
7903,0.003006,172.31.36.0-255,66,176661,9,238651
7904,0.003024,74.125.24.0-255,7156,183817,9,238651
7905,0.003026,172.31.36.0-255,66,183883,9,238651
7906,0.003057,172.31.36.0-255,66,183949,9,238651
7907,0.00306,74.125.24.0-255,1484,185433,9,238651
7908,0.003083,74.125.24.0-255,3602,189035,9,238651
7909,0.003085,172.31.36.0-255,66,189101,9,238651
7910,0.003166,74.125.24.0-255,1484,190585,9,238651
7911,0.003199,74.125.24.0-255,1484,192069,9,238651
7912,0.003201,172.31.36.0-255,66,192135,9,238651
7913,0.003205,74.125.24.0-255,1484,193619,9,238651
7914,0.003223,74.125.24.0-255,1484,195103,9,238651
7915,0.003225,172.31.36.0-255,66,195169,9,238651
7916,0.003256,74.125.24.0-255,2902,198071,9,238651
7917,0.003259,172.31.36.0-255,66,198137,9,238651
7918,0.003286,74.125.24.0-255,4320,202457,9,238651
7919,0.003289,172.31.36.0-255,66,202523,9,238651
7920,0.003292,74.125.24.0-255,1484,204007,9,238651
7921,0.003312,74.125.24.0-255,2902,206909,9,238651
7922,0.003314,172.31.36.0-255,66,206975,9,238651
7923,0.003342,74.125.24.0-255,2902,209877,9,238651
7924,0.003344,172.31.36.0-255,66,209943,9,238651
7925,0.003348,74.125.24.0-255,2902,212845,9,238651
7926,0.00335,172.31.36.0-255,66,212911,9,238651
7927,0.003355,74.125.24.0-255,4320,217231,9,238651
7928,0.003361,172.31.36.0-255,66,217297,9,238651
7929,0.003372,74.125.24.0-255,2902,220199,9,238651
7930,0.003375,172.31.36.0-255,66,220265,9,238651
7931,0.003404,74.125.24.0-255,5020,225285,9,238651
7932,0.00341,172.31.36.0-255,66,225351,9,238651
7933,0.003416,74.125.24.0-255,5738,231089,9,238651
7934,0.003418,172.31.36.0-255,66,231155,9,238651
7935,0.003424,74.125.24.0-255,5710,236865,9,238651
7936,0.003426,172.31.36.0-255,66,236931,9,238651
7937,0.003429,74.125.24.0-255,105,237036,9,238651
7938,0.011867,172.31.36.0-255,66,237102,9,238651
7939,0.011898,172.31.36.0-255,105,237207,9,238651
7940,0.014445,74.125.24.0-255,66,237273,9,238651
7941,0.056103,172.31.36.0-255,176,237449,9,238651
7942,0.056135,172.31.36.0-255,1070,238519,9,238651
7943,0.057655,104.244.42.0-255,66,238585,9,238651
7944,0.057697,104.244.42.0-255,66,238651,9,238651
7945,0.0,104.244.42.0-255,66,66,9,66
7946,0.0,172.31.36.0-255,105,105,9,459
7947,0.000201,172.31.36.0-255,90,195,9,459
7948,0.000214,172.31.36.0-255,66,261,9,459
7949,0.002541,74.125.130.0-255,66,327,9,459
7950,0.002558,74.125.130.0-255,66,393,9,459
7951,0.002571,172.31.36.0-255,66,459,9,459
7952,0.0,172.217.194.0-255,150,150,9,202941
7953,2.8e-05,172.31.36.0-255,66,216,9,202941
7954,3.5e-05,172.217.194.0-255,1484,1700,9,202941
7955,3.9e-05,172.31.36.0-255,66,1766,9,202941
7956,4.4e-05,172.217.194.0-255,2902,4668,9,202941
7957,4.7e-05,172.31.36.0-255,66,4734,9,202941
7958,5.8e-05,172.217.194.0-255,1484,6218,9,202941
7959,6e-05,172.31.36.0-255,66,6284,9,202941
7960,9.4e-05,172.217.194.0-255,5738,12022,9,202941
7961,9.7e-05,172.31.36.0-255,66,12088,9,202941
7962,0.000101,172.217.194.0-255,2019,14107,9,202941
7963,0.000103,172.31.36.0-255,66,14173,9,202941
7964,0.000142,172.31.36.0-255,66,14239,9,202941
7965,0.000149,172.217.194.0-255,7156,21395,9,202941
7966,0.000152,172.31.36.0-255,66,21461,9,202941
7967,0.000207,172.217.194.0-255,5738,27199,9,202941
7968,0.000211,172.31.36.0-255,66,27265,9,202941
7969,0.000243,172.31.36.0-255,66,27331,9,202941
7970,0.001979,172.217.194.0-255,1484,28815,9,202941
7971,0.001985,172.31.36.0-255,66,28881,9,202941
7972,0.001996,172.217.194.0-255,2902,31783,9,202941
7973,0.002003,172.31.36.0-255,66,31849,9,202941
7974,0.00201,172.217.194.0-255,5738,37587,9,202941
7975,0.002012,172.31.36.0-255,66,37653,9,202941
7976,0.002036,172.217.194.0-255,4320,41973,9,202941
7977,0.002038,172.31.36.0-255,66,42039,9,202941
7978,0.002066,172.217.194.0-255,2834,44873,9,202941
7979,0.002068,172.31.36.0-255,66,44939,9,202941
7980,0.002075,172.217.194.0-255,7156,52095,9,202941
7981,0.002076,172.31.36.0-255,66,52161,9,202941
7982,0.002111,172.217.194.0-255,7156,59317,9,202941
7983,0.002114,172.31.36.0-255,66,59383,9,202941
7984,0.002188,172.31.36.0-255,66,59449,9,202941
7985,0.002216,172.217.194.0-255,5738,65187,9,202941
7986,0.002218,172.31.36.0-255,66,65253,9,202941
7987,0.002221,172.217.194.0-255,1484,66737,9,202941
7988,0.002225,172.217.194.0-255,2184,68921,9,202941
7989,0.002227,172.31.36.0-255,66,68987,9,202941
7990,0.004731,172.217.194.0-255,1484,70471,9,202941
7991,0.004748,172.217.194.0-255,4320,74791,9,202941
7992,0.004752,172.31.36.0-255,66,74857,9,202941
7993,0.007289,172.217.194.0-255,5738,80595,9,202941
7994,0.007295,172.31.36.0-255,66,80661,9,202941
7995,0.009824,172.217.194.0-255,5738,86399,9,202941
7996,0.009831,172.31.36.0-255,66,86465,9,202941
7997,0.012382,172.217.194.0-255,5738,92203,9,202941
7998,0.012391,172.31.36.0-255,66,92269,9,202941
7999,0.014942,172.217.194.0-255,5738,98007,9,202941
8000,0.014952,172.31.36.0-255,66,98073,9,202941
8001,0.017489,172.217.194.0-255,5738,103811,9,202941
8002,0.017497,172.31.36.0-255,66,103877,9,202941
8003,0.020022,172.217.194.0-255,5738,109615,9,202941
8004,0.020028,172.31.36.0-255,66,109681,9,202941
8005,0.022551,172.217.194.0-255,5738,115419,9,202941
8006,0.022558,172.31.36.0-255,66,115485,9,202941
8007,0.025079,172.217.194.0-255,5738,121223,9,202941
8008,0.025088,172.31.36.0-255,66,121289,9,202941
8009,0.027609,172.217.194.0-255,5738,127027,9,202941
8010,0.027615,172.31.36.0-255,66,127093,9,202941
8011,0.030149,172.217.194.0-255,5738,132831,9,202941
8012,0.030157,172.31.36.0-255,66,132897,9,202941
8013,0.032699,172.217.194.0-255,5738,138635,9,202941
8014,0.032708,172.31.36.0-255,66,138701,9,202941
8015,0.035311,172.217.194.0-255,5738,144439,9,202941
8016,0.035318,172.31.36.0-255,66,144505,9,202941
8017,0.037853,172.217.194.0-255,5738,150243,9,202941
8018,0.037861,172.31.36.0-255,66,150309,9,202941
8019,0.038243,172.31.36.0-255,172,150481,9,202941
8020,0.038289,172.31.36.0-255,1112,151593,9,202941
8021,0.038381,172.31.36.0-255,1514,153107,9,202941
8022,0.038383,172.31.36.0-255,1514,154621,9,202941
8023,0.038388,172.31.36.0-255,1514,156135,9,202941
8024,0.038389,172.31.36.0-255,110,156245,9,202941
8025,0.03979,104.244.42.0-255,66,156311,9,202941
8026,0.039939,104.244.42.0-255,66,156377,9,202941
8027,0.039944,104.244.42.0-255,66,156443,9,202941
8028,0.039948,104.244.42.0-255,66,156509,9,202941
8029,0.040359,172.217.194.0-255,5738,162247,9,202941
8030,0.040364,172.31.36.0-255,66,162313,9,202941
8031,0.042881,172.217.194.0-255,5738,168051,9,202941
8032,0.042904,172.31.36.0-255,66,168117,9,202941
8033,0.04542,172.217.194.0-255,5738,173855,9,202941
8034,0.045425,172.31.36.0-255,66,173921,9,202941
8035,0.047959,172.217.194.0-255,5738,179659,9,202941
8036,0.047964,172.31.36.0-255,66,179725,9,202941
8037,0.050482,172.217.194.0-255,5738,185463,9,202941
8038,0.050487,172.31.36.0-255,66,185529,9,202941
8039,0.053006,172.217.194.0-255,5738,191267,9,202941
8040,0.053011,172.31.36.0-255,66,191333,9,202941
8041,0.055543,172.217.194.0-255,5738,197071,9,202941
8042,0.055548,172.31.36.0-255,66,197137,9,202941
8043,0.058084,172.217.194.0-255,5738,202875,9,202941
8044,0.058089,172.31.36.0-255,66,202941,9,202941
8045,0.0,172.31.36.0-255,105,105,9,105
8046,0.0,172.217.194.0-255,153,153,9,217680
8047,3.6e-05,172.31.36.0-255,66,219,9,217680
8048,4.4e-05,172.217.194.0-255,1484,1703,9,217680
8049,4.8e-05,172.31.36.0-255,66,1769,9,217680
8050,5.3e-05,172.217.194.0-255,2902,4671,9,217680
8051,5.6e-05,172.31.36.0-255,66,4737,9,217680
8052,6.3e-05,172.217.194.0-255,7156,11893,9,217680
8053,6.6e-05,172.31.36.0-255,66,11959,9,217680
8054,7e-05,172.217.194.0-255,2902,14861,9,217680
8055,7.2e-05,172.31.36.0-255,66,14927,9,217680
8056,9.9e-05,172.217.194.0-255,4890,19817,9,217680
8057,0.000101,172.31.36.0-255,66,19883,9,217680
8058,0.000109,172.217.194.0-255,5738,25621,9,217680
8059,0.000112,172.31.36.0-255,66,25687,9,217680
8060,0.000126,172.217.194.0-255,5379,31066,9,217680
8061,0.000128,172.31.36.0-255,66,31132,9,217680
8062,0.00018,172.217.194.0-255,1484,32616,9,217680
8063,0.000183,172.31.36.0-255,66,32682,9,217680
8064,0.000188,172.217.194.0-255,1484,34166,9,217680
8065,0.00019,172.31.36.0-255,66,34232,9,217680
8066,0.000202,172.217.194.0-255,1484,35716,9,217680
8067,0.000204,172.31.36.0-255,66,35782,9,217680
8068,0.000212,172.217.194.0-255,5738,41520,9,217680
8069,0.000214,172.31.36.0-255,66,41586,9,217680
8070,0.000253,172.31.36.0-255,66,41652,9,217680
8071,0.000259,172.217.194.0-255,4320,45972,9,217680
8072,0.000261,172.31.36.0-255,66,46038,9,217680
8073,0.000287,172.217.194.0-255,5637,51675,9,217680
8074,0.00029,172.31.36.0-255,66,51741,9,217680
8075,0.000416,172.217.194.0-255,114,51855,9,217680
8076,0.00042,172.31.36.0-255,66,51921,9,217680
8077,0.000423,172.217.194.0-255,380,52301,9,217680
8078,0.000628,172.217.194.0-255,1484,53785,9,217680
8079,0.000632,172.31.36.0-255,66,53851,9,217680
8080,0.000637,172.217.194.0-255,2902,56753,9,217680
8081,0.000639,172.31.36.0-255,66,56819,9,217680
8082,0.000674,172.217.194.0-255,5738,62557,9,217680
8083,0.000677,172.31.36.0-255,66,62623,9,217680
8084,0.000682,172.217.194.0-255,4320,66943,9,217680
8085,0.000684,172.31.36.0-255,66,67009,9,217680
8086,0.000703,172.217.194.0-255,2543,69552,9,217680
8087,0.000705,172.31.36.0-255,66,69618,9,217680
8088,0.000743,172.217.194.0-255,1484,71102,9,217680
8089,0.000751,172.217.194.0-255,2902,74004,9,217680
8090,0.000758,172.31.36.0-255,66,74070,9,217680
8091,0.000765,172.217.194.0-255,5738,79808,9,217680
8092,0.000768,172.31.36.0-255,66,79874,9,217680
8093,0.000772,172.217.194.0-255,2902,82776,9,217680
8094,0.000775,172.31.36.0-255,66,82842,9,217680
8095,0.0008,172.217.194.0-255,3961,86803,9,217680
8096,0.000803,172.31.36.0-255,66,86869,9,217680
8097,0.000958,172.217.194.0-255,1484,88353,9,217680
8098,0.000962,172.217.194.0-255,1484,89837,9,217680
8099,0.000965,172.31.36.0-255,66,89903,9,217680
8100,0.000985,172.217.194.0-255,1484,91387,9,217680
8101,0.000991,172.217.194.0-255,5738,97125,9,217680
8102,0.000994,172.31.36.0-255,66,97191,9,217680
8103,0.001,172.217.194.0-255,7156,104347,9,217680
8104,0.001003,172.31.36.0-255,66,104413,9,217680
8105,0.001021,172.31.36.0-255,66,104479,9,217680
8106,0.001038,172.217.194.0-255,5738,110217,9,217680
8107,0.001041,172.31.36.0-255,66,110283,9,217680
8108,0.001046,172.217.194.0-255,2184,112467,9,217680
8109,0.001049,172.31.36.0-255,66,112533,9,217680
8110,0.00114,172.31.36.0-255,101,112634,9,217680
8111,0.001193,172.217.194.0-255,1484,114118,9,217680
8112,0.001199,172.217.194.0-255,2902,117020,9,217680
8113,0.001203,172.31.36.0-255,66,117086,9,217680
8114,0.001225,172.217.194.0-255,5738,122824,9,217680
8115,0.001228,172.31.36.0-255,66,122890,9,217680
8116,0.001232,172.217.194.0-255,1484,124374,9,217680
8117,0.001252,172.217.194.0-255,5738,130112,9,217680
8118,0.001255,172.31.36.0-255,66,130178,9,217680
8119,0.001279,172.217.194.0-255,5738,135916,9,217680
8120,0.001281,172.31.36.0-255,66,135982,9,217680
8121,0.001293,172.31.36.0-255,66,136048,9,217680
8122,0.001297,172.217.194.0-255,1484,137532,9,217680
8123,0.001326,172.217.194.0-255,6438,143970,9,217680
8124,0.001329,172.31.36.0-255,66,144036,9,217680
8125,0.001341,172.31.36.0-255,66,144102,9,217680
8126,0.001353,172.31.36.0-255,66,144168,9,217680
8127,0.001387,172.31.36.0-255,66,144234,9,217680
8128,0.001431,172.217.194.0-255,1484,145718,9,217680
8129,0.001447,172.217.194.0-255,2902,148620,9,217680
8130,0.00145,172.31.36.0-255,66,148686,9,217680
8131,0.001454,172.217.194.0-255,1484,150170,9,217680
8132,0.001476,172.217.194.0-255,2902,153072,9,217680
8133,0.001479,172.31.36.0-255,66,153138,9,217680
8134,0.001485,172.217.194.0-255,5738,158876,9,217680
8135,0.001487,172.31.36.0-255,66,158942,9,217680
8136,0.001507,172.217.194.0-255,2902,161844,9,217680
8137,0.001509,172.31.36.0-255,66,161910,9,217680
8138,0.001544,172.217.194.0-255,4320,166230,9,217680
8139,0.001548,172.31.36.0-255,66,166296,9,217680
8140,0.001581,172.31.36.0-255,66,166362,9,217680
8141,0.001626,172.217.194.0-255,4320,170682,9,217680
8142,0.001631,172.31.36.0-255,66,170748,9,217680
8143,0.001672,172.31.36.0-255,66,170814,9,217680
8144,0.0017,172.31.36.0-255,66,170880,9,217680
8145,0.001728,172.31.36.0-255,66,170946,9,217680
8146,0.001734,172.217.194.0-255,4320,175266,9,217680
8147,0.001738,172.31.36.0-255,66,175332,9,217680
8148,0.001768,172.217.194.0-255,5738,181070,9,217680
8149,0.001772,172.31.36.0-255,66,181136,9,217680
8150,0.001784,172.31.36.0-255,66,181202,9,217680
8151,0.001828,172.217.194.0-255,1484,182686,9,217680
8152,0.001857,172.31.36.0-255,66,182752,9,217680
8153,0.00186,172.217.194.0-255,1484,184236,9,217680
8154,0.001864,172.217.194.0-255,2902,187138,9,217680
8155,0.001867,172.31.36.0-255,66,187204,9,217680
8156,0.001871,172.217.194.0-255,2902,190106,9,217680
8157,0.001875,172.31.36.0-255,66,190172,9,217680
8158,0.001894,172.217.194.0-255,2902,193074,9,217680
8159,0.001897,172.31.36.0-255,66,193140,9,217680
8160,0.001908,172.31.36.0-255,66,193206,9,217680
8161,0.001922,172.217.194.0-255,1484,194690,9,217680
8162,0.00195,172.217.194.0-255,2902,197592,9,217680
8163,0.001954,172.31.36.0-255,66,197658,9,217680
8164,0.001989,172.31.36.0-255,66,197724,9,217680
8165,0.002003,172.31.36.0-255,66,197790,9,217680
8166,0.002044,172.217.194.0-255,1484,199274,9,217680
8167,0.002063,172.31.36.0-255,66,199340,9,217680
8168,0.002082,172.31.36.0-255,66,199406,9,217680
8169,0.002089,172.31.36.0-255,66,199472,9,217680
8170,0.002116,172.217.194.0-255,2902,202374,9,217680
8171,0.002121,172.31.36.0-255,66,202440,9,217680
8172,0.002127,172.217.194.0-255,5738,208178,9,217680
8173,0.00213,172.31.36.0-255,66,208244,9,217680
8174,0.002171,172.31.36.0-255,66,208310,9,217680
8175,0.002174,172.217.194.0-255,105,208415,9,217680
8176,0.003391,172.217.194.0-255,66,208481,9,217680
8177,0.003654,172.31.36.0-255,105,208586,9,217680
8178,0.005863,172.217.194.0-255,66,208652,9,217680
8179,0.034093,172.31.36.0-255,172,208824,9,217680
8180,0.034148,172.31.36.0-255,1112,209936,9,217680
8181,0.034186,172.31.36.0-255,1514,211450,9,217680
8182,0.034188,172.31.36.0-255,1514,212964,9,217680
8183,0.034193,172.31.36.0-255,1514,214478,9,217680
8184,0.034194,172.31.36.0-255,1514,215992,9,217680
8185,0.034215,172.31.36.0-255,1490,217482,9,217680
8186,0.035641,104.244.42.0-255,66,217548,9,217680
8187,0.035712,104.244.42.0-255,66,217614,9,217680
8188,0.035767,104.244.42.0-255,66,217680,9,217680
8189,0.0,74.125.130.0-255,155,155,9,303781
8190,2.6e-05,172.31.36.0-255,66,221,9,303781
8191,3.3e-05,74.125.130.0-255,1484,1705,9,303781
8192,3.7e-05,172.31.36.0-255,66,1771,9,303781
8193,5.3e-05,74.125.130.0-255,2902,4673,9,303781
8194,5.6e-05,172.31.36.0-255,66,4739,9,303781
8195,5.9e-05,74.125.130.0-255,1484,6223,9,303781
8196,6.2e-05,172.31.36.0-255,66,6289,9,303781
8197,8.8e-05,74.125.130.0-255,2902,9191,9,303781
8198,9.2e-05,172.31.36.0-255,66,9257,9,303781
8199,9.7e-05,74.125.130.0-255,4320,13577,9,303781
8200,9.9e-05,172.31.36.0-255,66,13643,9,303781
8201,0.000116,74.125.130.0-255,4917,18560,9,303781
8202,0.000119,172.31.36.0-255,66,18626,9,303781
8203,0.000125,74.125.130.0-255,4320,22946,9,303781
8204,0.000127,172.31.36.0-255,66,23012,9,303781
8205,0.000169,74.125.130.0-255,1484,24496,9,303781
8206,0.000172,172.31.36.0-255,66,24562,9,303781
8207,0.000197,74.125.130.0-255,6797,31359,9,303781
8208,0.0002,172.31.36.0-255,66,31425,9,303781
8209,0.000271,74.125.130.0-255,1484,32909,9,303781
8210,0.000275,172.31.36.0-255,66,32975,9,303781
8211,0.00028,74.125.130.0-255,2902,35877,9,303781
8212,0.000283,172.31.36.0-255,66,35943,9,303781
8213,0.000303,74.125.130.0-255,1484,37427,9,303781
8214,0.000306,172.31.36.0-255,66,37493,9,303781
8215,0.000334,74.125.130.0-255,4320,41813,9,303781
8216,0.000338,172.31.36.0-255,66,41879,9,303781
8217,0.000342,74.125.130.0-255,2902,44781,9,303781
8218,0.000344,172.31.36.0-255,66,44847,9,303781
8219,0.00035,74.125.130.0-255,3961,48808,9,303781
8220,0.000352,172.31.36.0-255,66,48874,9,303781
8221,0.000357,74.125.130.0-255,5738,54612,9,303781
8222,0.000361,172.31.36.0-255,66,54678,9,303781
8223,0.000382,74.125.130.0-255,2902,57580,9,303781
8224,0.000386,74.125.130.0-255,2902,60482,9,303781
8225,0.000387,172.31.36.0-255,66,60548,9,303781
8226,0.000391,172.31.36.0-255,66,60614,9,303781
8227,0.00043,74.125.130.0-255,5635,66249,9,303781
8228,0.000434,172.31.36.0-255,66,66315,9,303781
8229,0.000437,74.125.130.0-255,117,66432,9,303781
8230,0.000799,172.31.36.0-255,66,66498,9,303781
8231,0.001857,74.125.130.0-255,1484,67982,9,303781
8232,0.001867,74.125.130.0-255,2902,70884,9,303781
8233,0.001871,172.31.36.0-255,66,70950,9,303781
8234,0.001876,74.125.130.0-255,1484,72434,9,303781
8235,0.00188,74.125.130.0-255,2902,75336,9,303781
8236,0.001883,172.31.36.0-255,66,75402,9,303781
8237,0.001898,74.125.130.0-255,1484,76886,9,303781
8238,0.001912,74.125.130.0-255,4320,81206,9,303781
8239,0.001914,172.31.36.0-255,66,81272,9,303781
8240,0.001917,74.125.130.0-255,1484,82756,9,303781
8241,0.001932,74.125.130.0-255,2543,85299,9,303781
8242,0.001934,172.31.36.0-255,66,85365,9,303781
8243,0.001937,74.125.130.0-255,1484,86849,9,303781
8244,0.001955,74.125.130.0-255,2902,89751,9,303781
8245,0.001956,172.31.36.0-255,66,89817,9,303781
8246,0.001984,172.31.36.0-255,66,89883,9,303781
8247,0.001989,74.125.130.0-255,4320,94203,9,303781
8248,0.001991,172.31.36.0-255,66,94269,9,303781
8249,0.002042,74.125.130.0-255,4320,98589,9,303781
8250,0.002046,172.31.36.0-255,66,98655,9,303781
8251,0.002072,172.31.36.0-255,66,98721,9,303781
8252,0.002247,74.125.130.0-255,1484,100205,9,303781
8253,0.002261,74.125.130.0-255,1484,101689,9,303781
8254,0.002265,172.31.36.0-255,66,101755,9,303781
8255,0.00228,74.125.130.0-255,1484,103239,9,303781
8256,0.002285,74.125.130.0-255,2902,106141,9,303781
8257,0.002288,172.31.36.0-255,66,106207,9,303781
8258,0.002292,74.125.130.0-255,2902,109109,9,303781
8259,0.002294,172.31.36.0-255,66,109175,9,303781
8260,0.002316,74.125.130.0-255,1484,110659,9,303781
8261,0.002321,74.125.130.0-255,2902,113561,9,303781
8262,0.002323,172.31.36.0-255,66,113627,9,303781
8263,0.002349,74.125.130.0-255,5738,119365,9,303781
8264,0.002351,172.31.36.0-255,66,119431,9,303781
8265,0.002357,74.125.130.0-255,5738,125169,9,303781
8266,0.002359,172.31.36.0-255,66,125235,9,303781
8267,0.002365,74.125.130.0-255,7156,132391,9,303781
8268,0.002368,172.31.36.0-255,66,132457,9,303781
8269,0.002392,74.125.130.0-255,5020,137477,9,303781
8270,0.002395,172.31.36.0-255,66,137543,9,303781
8271,0.002402,74.125.130.0-255,5738,143281,9,303781
8272,0.002404,172.31.36.0-255,66,143347,9,303781
8273,0.002437,74.125.130.0-255,2902,146249,9,303781
8274,0.00244,172.31.36.0-255,66,146315,9,303781
8275,0.002467,172.31.36.0-255,66,146381,9,303781
8276,0.002496,74.125.130.0-255,4320,150701,9,303781
8277,0.002499,172.31.36.0-255,66,150767,9,303781
8278,0.002515,74.125.130.0-255,6438,157205,9,303781
8279,0.002517,172.31.36.0-255,66,157271,9,303781
8280,0.002636,74.125.130.0-255,1484,158755,9,303781
8281,0.002648,74.125.130.0-255,2902,161657,9,303781
8282,0.002651,172.31.36.0-255,66,161723,9,303781
8283,0.002671,74.125.130.0-255,5738,167461,9,303781
8284,0.002673,172.31.36.0-255,66,167527,9,303781
8285,0.002711,172.31.36.0-255,66,167593,9,303781
8286,0.002718,74.125.130.0-255,7156,174749,9,303781
8287,0.00272,172.31.36.0-255,66,174815,9,303781
8288,0.002744,74.125.130.0-255,2902,177717,9,303781
8289,0.002747,172.31.36.0-255,66,177783,9,303781
8290,0.005396,74.125.130.0-255,2902,180685,9,303781
8291,0.005402,172.31.36.0-255,66,180751,9,303781
8292,0.005445,74.125.130.0-255,2902,183653,9,303781
8293,0.005448,172.31.36.0-255,66,183719,9,303781
8294,0.008088,74.125.130.0-255,2902,186621,9,303781
8295,0.008095,172.31.36.0-255,66,186687,9,303781
8296,0.008128,74.125.130.0-255,2902,189589,9,303781
8297,0.008133,172.31.36.0-255,66,189655,9,303781
8298,0.010777,74.125.130.0-255,2902,192557,9,303781
8299,0.010785,172.31.36.0-255,66,192623,9,303781
8300,0.010811,74.125.130.0-255,2902,195525,9,303781
8301,0.010815,172.31.36.0-255,66,195591,9,303781
8302,0.013475,74.125.130.0-255,5738,201329,9,303781
8303,0.013485,172.31.36.0-255,66,201395,9,303781
8304,0.016183,74.125.130.0-255,5738,207133,9,303781
8305,0.016192,172.31.36.0-255,66,207199,9,303781
8306,0.01889,74.125.130.0-255,5738,212937,9,303781
8307,0.018897,172.31.36.0-255,66,213003,9,303781
8308,0.021606,74.125.130.0-255,5738,218741,9,303781
8309,0.021613,172.31.36.0-255,66,218807,9,303781
8310,0.024293,74.125.130.0-255,5738,224545,9,303781
8311,0.024299,172.31.36.0-255,66,224611,9,303781
8312,0.024701,172.31.36.0-255,167,224778,9,303781
8313,0.024731,172.31.36.0-255,1116,225894,9,303781
8314,0.024766,172.31.36.0-255,1514,227408,9,303781
8315,0.024768,172.31.36.0-255,1283,228691,9,303781
8316,0.026343,104.244.42.0-255,66,228757,9,303781
8317,0.026351,104.244.42.0-255,66,228823,9,303781
8318,0.02643,104.244.42.0-255,66,228889,9,303781
8319,0.026981,74.125.130.0-255,2902,231791,9,303781
8320,0.026985,172.31.36.0-255,66,231857,9,303781
8321,0.02702,74.125.130.0-255,2902,234759,9,303781
8322,0.027024,172.31.36.0-255,66,234825,9,303781
8323,0.02973,74.125.130.0-255,5738,240563,9,303781
8324,0.029735,172.31.36.0-255,66,240629,9,303781
8325,0.032414,74.125.130.0-255,5738,246367,9,303781
8326,0.032419,172.31.36.0-255,66,246433,9,303781
8327,0.035096,74.125.130.0-255,5738,252171,9,303781
8328,0.035102,172.31.36.0-255,66,252237,9,303781
8329,0.03778,74.125.130.0-255,2902,255139,9,303781
8330,0.037786,172.31.36.0-255,66,255205,9,303781
8331,0.037817,74.125.130.0-255,2902,258107,9,303781
8332,0.037821,172.31.36.0-255,66,258173,9,303781
8333,0.040478,74.125.130.0-255,2902,261075,9,303781
8334,0.040498,172.31.36.0-255,66,261141,9,303781
8335,0.040502,74.125.130.0-255,2902,264043,9,303781
8336,0.040505,172.31.36.0-255,66,264109,9,303781
8337,0.043202,74.125.130.0-255,5738,269847,9,303781
8338,0.043207,172.31.36.0-255,66,269913,9,303781
8339,0.045884,74.125.130.0-255,5738,275651,9,303781
8340,0.045889,172.31.36.0-255,66,275717,9,303781
8341,0.048573,74.125.130.0-255,4320,280037,9,303781
8342,0.048579,172.31.36.0-255,66,280103,9,303781
8343,0.048609,74.125.130.0-255,1484,281587,9,303781
8344,0.051265,74.125.130.0-255,4320,285907,9,303781
8345,0.05127,172.31.36.0-255,66,285973,9,303781
8346,0.053958,74.125.130.0-255,2902,288875,9,303781
8347,0.053963,172.31.36.0-255,66,288941,9,303781
8348,0.053997,74.125.130.0-255,2902,291843,9,303781
8349,0.054,172.31.36.0-255,66,291909,9,303781
8350,0.056654,74.125.130.0-255,2902,294811,9,303781
8351,0.056659,172.31.36.0-255,66,294877,9,303781
8352,0.056696,74.125.130.0-255,2902,297779,9,303781
8353,0.056699,172.31.36.0-255,66,297845,9,303781
8354,0.059344,74.125.130.0-255,2902,300747,9,303781
8355,0.059349,172.31.36.0-255,66,300813,9,303781
8356,0.059389,74.125.130.0-255,2902,303715,9,303781
8357,0.059393,172.31.36.0-255,66,303781,9,303781
8358,0.0,172.31.36.0-255,235,235,9,301
8359,0.006336,172.217.194.0-255,66,301,9,301
8360,0.0,74.125.24.0-255,122,122,9,629
8361,1.5e-05,74.125.24.0-255,66,188,9,629
8362,0.000161,172.31.36.0-255,105,293,9,629
8363,0.000259,172.31.36.0-255,90,383,9,629
8364,0.000269,172.31.36.0-255,66,449,9,629
8365,0.002548,74.125.24.0-255,60,509,9,629
8366,0.002559,74.125.24.0-255,60,569,9,629
8367,0.002778,74.125.24.0-255,60,629,9,629
8368,0.0,74.125.200.0-255,153,153,9,365988
8369,2.9e-05,172.31.36.0-255,66,219,9,365988
8370,3.7e-05,74.125.200.0-255,1484,1703,9,365988
8371,4.2e-05,172.31.36.0-255,66,1769,9,365988
8372,4.5e-05,74.125.200.0-255,1484,3253,9,365988
8373,4.8e-05,172.31.36.0-255,66,3319,9,365988
8374,6.9e-05,74.125.200.0-255,1484,4803,9,365988
8375,7.2e-05,172.31.36.0-255,66,4869,9,365988
8376,7.8e-05,74.125.200.0-255,4320,9189,9,365988
8377,8e-05,172.31.36.0-255,66,9255,9,365988
8378,0.000106,74.125.200.0-255,4872,14127,9,365988
8379,0.000109,172.31.36.0-255,66,14193,9,365988
8380,0.00013,74.125.200.0-255,5738,19931,9,365988
8381,0.000133,172.31.36.0-255,66,19997,9,365988
8382,0.000153,74.125.200.0-255,4320,24317,9,365988
8383,0.000155,172.31.36.0-255,66,24383,9,365988
8384,0.000176,74.125.200.0-255,2902,27285,9,365988
8385,0.000179,172.31.36.0-255,66,27351,9,365988
8386,0.000195,74.125.200.0-255,1484,28835,9,365988
8387,0.000197,172.31.36.0-255,66,28901,9,365988
8388,0.000215,74.125.200.0-255,2543,31444,9,365988
8389,0.000218,172.31.36.0-255,66,31510,9,365988
8390,0.000314,74.125.200.0-255,1484,32994,9,365988
8391,0.000318,172.31.36.0-255,66,33060,9,365988
8392,0.000335,74.125.200.0-255,2902,35962,9,365988
8393,0.000342,172.31.36.0-255,66,36028,9,365988
8394,0.000346,74.125.200.0-255,1484,37512,9,365988
8395,0.000349,172.31.36.0-255,66,37578,9,365988
8396,0.000363,74.125.200.0-255,2902,40480,9,365988
8397,0.000366,172.31.36.0-255,66,40546,9,365988
8398,0.000384,74.125.200.0-255,4320,44866,9,365988
8399,0.000387,172.31.36.0-255,66,44932,9,365988
8400,0.000411,74.125.200.0-255,1484,46416,9,365988
8401,0.000414,172.31.36.0-255,66,46482,9,365988
8402,0.000419,74.125.200.0-255,4320,50802,9,365988
8403,0.000423,74.125.200.0-255,1484,52286,9,365988
8404,0.000432,172.31.36.0-255,66,52352,9,365988
8405,0.000445,74.125.200.0-255,4320,56672,9,365988
8406,0.00046,172.31.36.0-255,66,56738,9,365988
8407,0.000461,74.125.200.0-255,1484,58222,9,365988
8408,0.00048,74.125.200.0-255,2902,61124,9,365988
8409,0.000483,172.31.36.0-255,66,61190,9,365988
8410,0.000501,74.125.200.0-255,1484,62674,9,365988
8411,0.000506,74.125.200.0-255,2902,65576,9,365988
8412,0.000512,172.31.36.0-255,66,65642,9,365988
8413,0.000529,74.125.200.0-255,766,66408,9,365988
8414,0.000568,74.125.200.0-255,400,66808,9,365988
8415,0.00061,74.125.200.0-255,110,66918,9,365988
8416,0.00068,74.125.200.0-255,1484,68402,9,365988
8417,0.000684,172.31.36.0-255,66,68468,9,365988
8418,0.000706,74.125.200.0-255,2902,71370,9,365988
8419,0.00071,74.125.200.0-255,1484,72854,9,365988
8420,0.000711,172.31.36.0-255,66,72920,9,365988
8421,0.000722,74.125.200.0-255,1484,74404,9,365988
8422,0.000727,172.31.36.0-255,66,74470,9,365988
8423,0.000736,74.125.200.0-255,4320,78790,9,365988
8424,0.00074,172.31.36.0-255,66,78856,9,365988
8425,0.000758,74.125.200.0-255,1484,80340,9,365988
8426,0.000774,74.125.200.0-255,5738,86078,9,365988
8427,0.000787,172.31.36.0-255,66,86144,9,365988
8428,0.000791,74.125.200.0-255,1484,87628,9,365988
8429,0.000809,74.125.200.0-255,5738,93366,9,365988
8430,0.000821,172.31.36.0-255,66,93432,9,365988
8431,0.000821,74.125.200.0-255,1484,94916,9,365988
8432,0.000829,74.125.200.0-255,4320,99236,9,365988
8433,0.000836,172.31.36.0-255,66,99302,9,365988
8434,0.000863,74.125.200.0-255,2448,101750,9,365988
8435,0.000867,172.31.36.0-255,66,101816,9,365988
8436,0.001024,74.125.200.0-255,1484,103300,9,365988
8437,0.00104,74.125.200.0-255,2902,106202,9,365988
8438,0.001051,172.31.36.0-255,66,106268,9,365988
8439,0.00106,74.125.200.0-255,2902,109170,9,365988
8440,0.001065,172.31.36.0-255,66,109236,9,365988
8441,0.001071,74.125.200.0-255,1484,110720,9,365988
8442,0.001074,74.125.200.0-255,1484,112204,9,365988
8443,0.001078,172.31.36.0-255,66,112270,9,365988
8444,0.001094,74.125.200.0-255,4320,116590,9,365988
8445,0.001103,172.31.36.0-255,66,116656,9,365988
8446,0.001108,74.125.200.0-255,1484,118140,9,365988
8447,0.001126,74.125.200.0-255,5738,123878,9,365988
8448,0.00113,172.31.36.0-255,66,123944,9,365988
8449,0.001145,74.125.200.0-255,1484,125428,9,365988
8450,0.001162,74.125.200.0-255,7156,132584,9,365988
8451,0.001167,74.125.200.0-255,3602,136186,9,365988
8452,0.001167,172.31.36.0-255,66,136252,9,365988
8453,0.001172,172.31.36.0-255,66,136318,9,365988
8454,0.001256,74.125.200.0-255,1484,137802,9,365988
8455,0.001271,74.125.200.0-255,1484,139286,9,365988
8456,0.001275,172.31.36.0-255,66,139352,9,365988
8457,0.001291,74.125.200.0-255,1484,140836,9,365988
8458,0.001295,74.125.200.0-255,1484,142320,9,365988
8459,0.0013,172.31.36.0-255,66,142386,9,365988
8460,0.00132,74.125.200.0-255,4320,146706,9,365988
8461,0.001323,74.125.200.0-255,1484,148190,9,365988
8462,0.001327,172.31.36.0-255,66,148256,9,365988
8463,0.001377,74.125.200.0-255,2902,151158,9,365988
8464,0.001387,172.31.36.0-255,66,151224,9,365988
8465,0.001396,74.125.200.0-255,4320,155544,9,365988
8466,0.0014,172.31.36.0-255,66,155610,9,365988
8467,0.00142,74.125.200.0-255,1484,157094,9,365988
8468,0.00144,74.125.200.0-255,5738,162832,9,365988
8469,0.001447,172.31.36.0-255,66,162898,9,365988
8470,0.001465,74.125.200.0-255,1484,164382,9,365988
8471,0.001479,74.125.200.0-255,4320,168702,9,365988
8472,0.001486,172.31.36.0-255,66,168768,9,365988
8473,0.001517,74.125.200.0-255,2184,170952,9,365988
8474,0.001528,172.31.36.0-255,66,171018,9,365988
8475,0.001609,74.125.200.0-255,1484,172502,9,365988
8476,0.001615,74.125.200.0-255,2902,175404,9,365988
8477,0.001627,172.31.36.0-255,66,175470,9,365988
8478,0.001643,74.125.200.0-255,5738,181208,9,365988
8479,0.00165,172.31.36.0-255,66,181274,9,365988
8480,0.001659,74.125.200.0-255,1484,182758,9,365988
8481,0.001679,74.125.200.0-255,5738,188496,9,365988
8482,0.001682,172.31.36.0-255,66,188562,9,365988
8483,0.001702,74.125.200.0-255,4320,192882,9,365988
8484,0.001713,172.31.36.0-255,66,192948,9,365988
8485,0.001723,74.125.200.0-255,4320,197268,9,365988
8486,0.001727,74.125.200.0-255,4320,201588,9,365988
8487,0.001728,172.31.36.0-255,66,201654,9,365988
8488,0.001744,172.31.36.0-255,66,201720,9,365988
8489,0.001773,74.125.200.0-255,2902,204622,9,365988
8490,0.001788,74.125.200.0-255,766,205388,9,365988
8491,0.001789,172.31.36.0-255,66,205454,9,365988
8492,0.002008,172.31.36.0-255,66,205520,9,365988
8493,0.002118,74.125.200.0-255,1484,207004,9,365988
8494,0.002123,172.31.36.0-255,66,207070,9,365988
8495,0.00213,74.125.200.0-255,1484,208554,9,365988
8496,0.002135,74.125.200.0-255,2902,211456,9,365988
8497,0.002164,74.125.200.0-255,1484,212940,9,365988
8498,0.002185,74.125.200.0-255,4320,217260,9,365988
8499,0.002189,74.125.200.0-255,1484,218744,9,365988
8500,0.002193,74.125.200.0-255,2902,221646,9,365988
8501,0.002196,74.125.200.0-255,1484,223130,9,365988
8502,0.002215,74.125.200.0-255,4320,227450,9,365988
8503,0.007577,172.31.36.0-255,66,227516,9,365988
8504,0.009785,74.125.200.0-255,5738,233254,9,365988
8505,0.009792,172.31.36.0-255,66,233320,9,365988
8506,0.011987,74.125.200.0-255,5738,239058,9,365988
8507,0.011994,172.31.36.0-255,66,239124,9,365988
8508,0.014204,74.125.200.0-255,5738,244862,9,365988
8509,0.014212,172.31.36.0-255,66,244928,9,365988
8510,0.016434,74.125.200.0-255,5738,250666,9,365988
8511,0.016441,172.31.36.0-255,66,250732,9,365988
8512,0.018633,74.125.200.0-255,5738,256470,9,365988
8513,0.01864,172.31.36.0-255,66,256536,9,365988
8514,0.02084,74.125.200.0-255,5738,262274,9,365988
8515,0.020847,172.31.36.0-255,66,262340,9,365988
8516,0.023041,74.125.200.0-255,5738,268078,9,365988
8517,0.023048,172.31.36.0-255,66,268144,9,365988
8518,0.025239,74.125.200.0-255,5738,273882,9,365988
8519,0.025248,172.31.36.0-255,66,273948,9,365988
8520,0.027436,74.125.200.0-255,5738,279686,9,365988
8521,0.027444,172.31.36.0-255,66,279752,9,365988
8522,0.029637,74.125.200.0-255,5738,285490,9,365988
8523,0.029645,172.31.36.0-255,66,285556,9,365988
8524,0.031833,74.125.200.0-255,5738,291294,9,365988
8525,0.031841,172.31.36.0-255,66,291360,9,365988
8526,0.034044,74.125.200.0-255,5738,297098,9,365988
8527,0.034052,172.31.36.0-255,66,297164,9,365988
8528,0.036255,74.125.200.0-255,5738,302902,9,365988
8529,0.036263,172.31.36.0-255,66,302968,9,365988
8530,0.038467,74.125.200.0-255,5738,308706,9,365988
8531,0.038475,172.31.36.0-255,66,308772,9,365988
8532,0.040726,74.125.200.0-255,5738,314510,9,365988
8533,0.040733,172.31.36.0-255,66,314576,9,365988
8534,0.042933,74.125.200.0-255,5738,320314,9,365988
8535,0.042947,172.31.36.0-255,66,320380,9,365988
8536,0.045164,74.125.200.0-255,5738,326118,9,365988
8537,0.045172,172.31.36.0-255,66,326184,9,365988
8538,0.047405,74.125.200.0-255,5738,331922,9,365988
8539,0.047413,172.31.36.0-255,66,331988,9,365988
8540,0.049414,172.31.36.0-255,172,332160,9,365988
8541,0.049446,172.31.36.0-255,1116,333276,9,365988
8542,0.049513,172.31.36.0-255,1514,334790,9,365988
8543,0.049515,172.31.36.0-255,1514,336304,9,365988
8544,0.049521,172.31.36.0-255,1514,337818,9,365988
8545,0.049522,172.31.36.0-255,106,337924,9,365988
8546,0.049616,74.125.200.0-255,5738,343662,9,365988
8547,0.049621,172.31.36.0-255,66,343728,9,365988
8548,0.051093,104.244.42.0-255,66,343794,9,365988
8549,0.051147,104.244.42.0-255,66,343860,9,365988
8550,0.051202,104.244.42.0-255,66,343926,9,365988
8551,0.051208,104.244.42.0-255,66,343992,9,365988
8552,0.051817,74.125.200.0-255,4320,348312,9,365988
8553,0.051822,172.31.36.0-255,66,348378,9,365988
8554,0.051858,74.125.200.0-255,1484,349862,9,365988
8555,0.053999,74.125.200.0-255,4320,354182,9,365988
8556,0.054006,172.31.36.0-255,66,354248,9,365988
8557,0.056225,74.125.200.0-255,5738,359986,9,365988
8558,0.056283,172.31.36.0-255,66,360052,9,365988
8559,0.058466,74.125.200.0-255,1484,361536,9,365988
8560,0.058471,172.31.36.0-255,66,361602,9,365988
8561,0.058499,74.125.200.0-255,4320,365922,9,365988
8562,0.058523,172.31.36.0-255,66,365988,9,365988
8563,0.0,172.31.36.0-255,105,105,9,105
8564,0.0,74.125.24.0-255,153,153,9,243149
8565,1.2e-05,172.31.36.0-255,66,219,9,243149
8566,1.7e-05,74.125.24.0-255,1484,1703,9,243149
8567,2.1e-05,172.31.36.0-255,66,1769,9,243149
8568,5e-05,74.125.24.0-255,2902,4671,9,243149
8569,5.3e-05,172.31.36.0-255,66,4737,9,243149
8570,8.8e-05,74.125.24.0-255,5738,10475,9,243149
8571,9.1e-05,172.31.36.0-255,66,10541,9,243149
8572,0.000107,172.31.36.0-255,66,10607,9,243149
8573,0.000127,74.125.24.0-255,593,11200,9,243149
8574,0.00013,172.31.36.0-255,66,11266,9,243149
8575,0.000135,74.125.24.0-255,2902,14168,9,243149
8576,0.000138,172.31.36.0-255,66,14234,9,243149
8577,0.000169,74.125.24.0-255,3961,18195,9,243149
8578,0.000172,172.31.36.0-255,66,18261,9,243149
8579,0.000256,74.125.24.0-255,1484,19745,9,243149
8580,0.00026,172.31.36.0-255,66,19811,9,243149
8581,0.000267,74.125.24.0-255,2902,22713,9,243149
8582,0.00027,172.31.36.0-255,66,22779,9,243149
8583,0.000281,74.125.24.0-255,4320,27099,9,243149
8584,0.000283,172.31.36.0-255,66,27165,9,243149
8585,0.000311,74.125.24.0-255,1484,28649,9,243149
8586,0.000314,172.31.36.0-255,66,28715,9,243149
8587,0.000317,74.125.24.0-255,1484,30199,9,243149
8588,0.000319,172.31.36.0-255,66,30265,9,243149
8589,0.000333,172.31.36.0-255,66,30331,9,243149
8590,0.000336,74.125.24.0-255,1484,31815,9,243149
8591,0.000338,172.31.36.0-255,66,31881,9,243149
8592,0.00039,172.31.36.0-255,66,31947,9,243149
8593,0.000393,74.125.24.0-255,114,32061,9,243149
8594,0.000544,74.125.24.0-255,331,32392,9,243149
8595,0.000771,74.125.24.0-255,1484,33876,9,243149
8596,0.000776,172.31.36.0-255,66,33942,9,243149
8597,0.000783,74.125.24.0-255,2902,36844,9,243149
8598,0.000786,172.31.36.0-255,66,36910,9,243149
8599,0.000798,74.125.24.0-255,5738,42648,9,243149
8600,0.0008,172.31.36.0-255,66,42714,9,243149
8601,0.000855,172.31.36.0-255,66,42780,9,243149
8602,0.000868,172.31.36.0-255,66,42846,9,243149
8603,0.00091,74.125.24.0-255,1484,44330,9,243149
8604,0.000916,74.125.24.0-255,2902,47232,9,243149
8605,0.000918,172.31.36.0-255,66,47298,9,243149
8606,0.000923,74.125.24.0-255,2902,50200,9,243149
8607,0.000925,172.31.36.0-255,66,50266,9,243149
8608,0.000968,74.125.24.0-255,2902,53168,9,243149
8609,0.000972,172.31.36.0-255,66,53234,9,243149
8610,0.000983,172.31.36.0-255,66,53300,9,243149
8611,0.000988,74.125.24.0-255,4320,57620,9,243149
8612,0.000991,172.31.36.0-255,66,57686,9,243149
8613,0.001028,74.125.24.0-255,7156,64842,9,243149
8614,0.001031,172.31.36.0-255,66,64908,9,243149
8615,0.001035,74.125.24.0-255,2184,67092,9,243149
8616,0.001037,172.31.36.0-255,66,67158,9,243149
8617,0.003025,74.125.24.0-255,5738,72896,9,243149
8618,0.003033,172.31.36.0-255,66,72962,9,243149
8619,0.005044,74.125.24.0-255,5738,78700,9,243149
8620,0.005048,172.31.36.0-255,66,78766,9,243149
8621,0.007069,74.125.24.0-255,5738,84504,9,243149
8622,0.007075,172.31.36.0-255,66,84570,9,243149
8623,0.009097,74.125.24.0-255,4320,88890,9,243149
8624,0.009104,172.31.36.0-255,66,88956,9,243149
8625,0.009129,74.125.24.0-255,1484,90440,9,243149
8626,0.011095,74.125.24.0-255,4320,94760,9,243149
8627,0.011102,172.31.36.0-255,66,94826,9,243149
8628,0.013314,74.125.24.0-255,5738,100564,9,243149
8629,0.013321,172.31.36.0-255,66,100630,9,243149
8630,0.015331,74.125.24.0-255,5738,106368,9,243149
8631,0.015339,172.31.36.0-255,66,106434,9,243149
8632,0.017342,74.125.24.0-255,5738,112172,9,243149
8633,0.01735,172.31.36.0-255,66,112238,9,243149
8634,0.019382,74.125.24.0-255,5738,117976,9,243149
8635,0.01939,172.31.36.0-255,66,118042,9,243149
8636,0.021391,74.125.24.0-255,5738,123780,9,243149
8637,0.0214,172.31.36.0-255,66,123846,9,243149
8638,0.023411,74.125.24.0-255,5738,129584,9,243149
8639,0.023418,172.31.36.0-255,66,129650,9,243149
8640,0.025442,74.125.24.0-255,5738,135388,9,243149
8641,0.025451,172.31.36.0-255,66,135454,9,243149
8642,0.027481,74.125.24.0-255,5738,141192,9,243149
8643,0.027488,172.31.36.0-255,66,141258,9,243149
8644,0.029501,74.125.24.0-255,5738,146996,9,243149
8645,0.029509,172.31.36.0-255,66,147062,9,243149
8646,0.031515,74.125.24.0-255,5738,152800,9,243149
8647,0.031522,172.31.36.0-255,66,152866,9,243149
8648,0.032095,172.31.36.0-255,172,153038,9,243149
8649,0.032126,172.31.36.0-255,1112,154150,9,243149
8650,0.032195,172.31.36.0-255,1514,155664,9,243149
8651,0.032197,172.31.36.0-255,1514,157178,9,243149
8652,0.032203,172.31.36.0-255,1514,158692,9,243149
8653,0.032204,172.31.36.0-255,1514,160206,9,243149
8654,0.032223,172.31.36.0-255,1489,161695,9,243149
8655,0.033539,74.125.24.0-255,5738,167433,9,243149
8656,0.033547,172.31.36.0-255,66,167499,9,243149
8657,0.033605,104.244.42.0-255,66,167565,9,243149
8658,0.033691,104.244.42.0-255,66,167631,9,243149
8659,0.033824,104.244.42.0-255,66,167697,9,243149
8660,0.035559,74.125.24.0-255,5738,173435,9,243149
8661,0.035566,172.31.36.0-255,66,173501,9,243149
8662,0.037614,74.125.24.0-255,5738,179239,9,243149
8663,0.03762,172.31.36.0-255,66,179305,9,243149
8664,0.039627,74.125.24.0-255,5738,185043,9,243149
8665,0.039634,172.31.36.0-255,66,185109,9,243149
8666,0.041661,74.125.24.0-255,5738,190847,9,243149
8667,0.041668,172.31.36.0-255,66,190913,9,243149
8668,0.043692,74.125.24.0-255,5738,196651,9,243149
8669,0.043698,172.31.36.0-255,66,196717,9,243149
8670,0.045756,74.125.24.0-255,5738,202455,9,243149
8671,0.045763,172.31.36.0-255,66,202521,9,243149
8672,0.047814,74.125.24.0-255,5738,208259,9,243149
8673,0.04782,172.31.36.0-255,66,208325,9,243149
8674,0.049836,74.125.24.0-255,5738,214063,9,243149
8675,0.049845,172.31.36.0-255,66,214129,9,243149
8676,0.051872,74.125.24.0-255,5738,219867,9,243149
8677,0.051878,172.31.36.0-255,66,219933,9,243149
8678,0.053878,74.125.24.0-255,5738,225671,9,243149
8679,0.053885,172.31.36.0-255,66,225737,9,243149
8680,0.055907,74.125.24.0-255,5738,231475,9,243149
8681,0.055913,172.31.36.0-255,66,231541,9,243149
8682,0.057957,74.125.24.0-255,5738,237279,9,243149
8683,0.057964,172.31.36.0-255,66,237345,9,243149
8684,0.059975,74.125.24.0-255,5738,243083,9,243149
8685,0.059982,172.31.36.0-255,66,243149,9,243149
8686,0.0,74.125.24.0-255,153,153,9,265232
8687,1.5e-05,74.125.24.0-255,1484,1637,9,265232
8688,2.3e-05,172.31.36.0-255,66,1703,9,265232
8689,3e-05,74.125.24.0-255,2902,4605,9,265232
8690,3.4e-05,172.31.36.0-255,66,4671,9,265232
8691,4.2e-05,74.125.24.0-255,7156,11827,9,265232
8692,4.5e-05,172.31.36.0-255,66,11893,9,265232
8693,4.9e-05,74.125.24.0-255,1993,13886,9,265232
8694,5.2e-05,172.31.36.0-255,66,13952,9,265232
8695,0.000345,74.125.24.0-255,1484,15436,9,265232
8696,0.000354,74.125.24.0-255,2902,18338,9,265232
8697,0.000358,172.31.36.0-255,66,18404,9,265232
8698,0.000364,74.125.24.0-255,2902,21306,9,265232
8699,0.000366,172.31.36.0-255,66,21372,9,265232
8700,0.000382,74.125.24.0-255,2902,24274,9,265232
8701,0.000384,172.31.36.0-255,66,24340,9,265232
8702,0.000409,74.125.24.0-255,6797,31137,9,265232
8703,0.000412,172.31.36.0-255,66,31203,9,265232
8704,0.000579,74.125.24.0-255,1484,32687,9,265232
8705,0.000583,74.125.24.0-255,1484,34171,9,265232
8706,0.000587,172.31.36.0-255,66,34237,9,265232
8707,0.000609,74.125.24.0-255,1484,35721,9,265232
8708,0.000616,74.125.24.0-255,5738,41459,9,265232
8709,0.000618,172.31.36.0-255,66,41525,9,265232
8710,0.000621,74.125.24.0-255,1484,43009,9,265232
8711,0.000662,74.125.24.0-255,5379,48388,9,265232
8712,0.000671,172.31.36.0-255,66,48454,9,265232
8713,0.000691,74.125.24.0-255,2902,51356,9,265232
8714,0.000693,172.31.36.0-255,66,51422,9,265232
8715,0.000716,74.125.24.0-255,2902,54324,9,265232
8716,0.000719,172.31.36.0-255,66,54390,9,265232
8717,0.000726,74.125.24.0-255,7156,61546,9,265232
8718,0.000729,172.31.36.0-255,66,61612,9,265232
8719,0.000763,74.125.24.0-255,1484,63096,9,265232
8720,0.000802,74.125.24.0-255,2543,65639,9,265232
8721,0.000805,172.31.36.0-255,66,65705,9,265232
8722,0.000922,74.125.24.0-255,646,66351,9,265232
8723,0.001326,74.125.24.0-255,1484,67835,9,265232
8724,0.001332,172.31.36.0-255,66,67901,9,265232
8725,0.001339,74.125.24.0-255,2902,70803,9,265232
8726,0.001341,172.31.36.0-255,66,70869,9,265232
8727,0.001349,74.125.24.0-255,5738,76607,9,265232
8728,0.001352,172.31.36.0-255,66,76673,9,265232
8729,0.001394,172.31.36.0-255,66,76739,9,265232
8730,0.001439,172.31.36.0-255,66,76805,9,265232
8731,0.001726,74.125.24.0-255,1484,78289,9,265232
8732,0.001734,74.125.24.0-255,2902,81191,9,265232
8733,0.001738,172.31.36.0-255,66,81257,9,265232
8734,0.001746,74.125.24.0-255,5738,86995,9,265232
8735,0.001748,172.31.36.0-255,66,87061,9,265232
8736,0.001769,74.125.24.0-255,4320,91381,9,265232
8737,0.001772,172.31.36.0-255,66,91447,9,265232
8738,0.0018,172.31.36.0-255,66,91513,9,265232
8739,0.001814,172.31.36.0-255,66,91579,9,265232
8740,0.001875,74.125.24.0-255,1484,93063,9,265232
8741,0.001879,74.125.24.0-255,1484,94547,9,265232
8742,0.001882,172.31.36.0-255,66,94613,9,265232
8743,0.001899,74.125.24.0-255,1484,96097,9,265232
8744,0.001906,74.125.24.0-255,5738,101835,9,265232
8745,0.001908,172.31.36.0-255,66,101901,9,265232
8746,0.001943,74.125.24.0-255,4320,106221,9,265232
8747,0.001946,172.31.36.0-255,66,106287,9,265232
8748,0.001971,172.31.36.0-255,66,106353,9,265232
8749,0.001988,74.125.24.0-255,1484,107837,9,265232
8750,0.002009,172.31.36.0-255,66,107903,9,265232
8751,0.002041,74.125.24.0-255,7156,115059,9,265232
8752,0.002044,172.31.36.0-255,66,115125,9,265232
8753,0.00205,74.125.24.0-255,5738,120863,9,265232
8754,0.002053,172.31.36.0-255,66,120929,9,265232
8755,0.002065,74.125.24.0-255,2902,123831,9,265232
8756,0.002068,172.31.36.0-255,66,123897,9,265232
8757,0.002104,172.31.36.0-255,66,123963,9,265232
8758,0.002121,74.125.24.0-255,2902,126865,9,265232
8759,0.002123,172.31.36.0-255,66,126931,9,265232
8760,0.002126,74.125.24.0-255,766,127697,9,265232
8761,0.002139,74.125.24.0-255,1484,129181,9,265232
8762,0.002141,172.31.36.0-255,66,129247,9,265232
8763,0.002163,74.125.24.0-255,2902,132149,9,265232
8764,0.002165,172.31.36.0-255,66,132215,9,265232
8765,0.002171,74.125.24.0-255,5738,137953,9,265232
8766,0.002174,172.31.36.0-255,66,138019,9,265232
8767,0.002189,74.125.24.0-255,5738,143757,9,265232
8768,0.002192,172.31.36.0-255,66,143823,9,265232
8769,0.002208,74.125.24.0-255,7156,150979,9,265232
8770,0.002211,172.31.36.0-255,66,151045,9,265232
8771,0.002226,74.125.24.0-255,1484,152529,9,265232
8772,0.002238,74.125.24.0-255,2902,155431,9,265232
8773,0.00224,172.31.36.0-255,66,155497,9,265232
8774,0.002257,74.125.24.0-255,6438,161935,9,265232
8775,0.00226,172.31.36.0-255,66,162001,9,265232
8776,0.002431,74.125.24.0-255,1484,163485,9,265232
8777,0.002457,74.125.24.0-255,2902,166387,9,265232
8778,0.00246,172.31.36.0-255,66,166453,9,265232
8779,0.002463,74.125.24.0-255,1484,167937,9,265232
8780,0.002475,74.125.24.0-255,1484,169421,9,265232
8781,0.002477,172.31.36.0-255,66,169487,9,265232
8782,0.00248,74.125.24.0-255,1484,170971,9,265232
8783,0.00255,172.31.36.0-255,66,171037,9,265232
8784,0.002556,74.125.24.0-255,4320,175357,9,265232
8785,0.002558,172.31.36.0-255,66,175423,9,265232
8786,0.002569,172.31.36.0-255,66,175489,9,265232
8787,0.002585,74.125.24.0-255,766,176255,9,265232
8788,0.003422,74.125.24.0-255,1484,177739,9,265232
8789,0.003425,172.31.36.0-255,66,177805,9,265232
8790,0.00343,74.125.24.0-255,2902,180707,9,265232
8791,0.003433,172.31.36.0-255,66,180773,9,265232
8792,0.003445,74.125.24.0-255,1484,182257,9,265232
8793,0.00346,74.125.24.0-255,4320,186577,9,265232
8794,0.003462,172.31.36.0-255,66,186643,9,265232
8795,0.003479,74.125.24.0-255,2902,189545,9,265232
8796,0.003481,172.31.36.0-255,66,189611,9,265232
8797,0.003496,74.125.24.0-255,2902,192513,9,265232
8798,0.003498,172.31.36.0-255,66,192579,9,265232
8799,0.003504,74.125.24.0-255,5738,198317,9,265232
8800,0.003506,172.31.36.0-255,66,198383,9,265232
8801,0.003538,74.125.24.0-255,7156,205539,9,265232
8802,0.003541,172.31.36.0-255,66,205605,9,265232
8803,0.003547,74.125.24.0-255,5020,210625,9,265232
8804,0.003549,172.31.36.0-255,66,210691,9,265232
8805,0.003716,74.125.24.0-255,1484,212175,9,265232
8806,0.003723,74.125.24.0-255,2902,215077,9,265232
8807,0.003726,172.31.36.0-255,66,215143,9,265232
8808,0.003732,74.125.24.0-255,2902,218045,9,265232
8809,0.003735,172.31.36.0-255,66,218111,9,265232
8810,0.00375,74.125.24.0-255,2902,221013,9,265232
8811,0.003752,172.31.36.0-255,66,221079,9,265232
8812,0.003755,74.125.24.0-255,1484,222563,9,265232
8813,0.003768,74.125.24.0-255,1484,224047,9,265232
8814,0.003771,172.31.36.0-255,66,224113,9,265232
8815,0.003795,172.31.36.0-255,66,224179,9,265232
8816,0.003816,74.125.24.0-255,1484,225663,9,265232
8817,0.003819,172.31.36.0-255,78,225741,9,265232
8818,0.003826,74.125.24.0-255,4320,230061,9,265232
8819,0.003829,172.31.36.0-255,78,230139,9,265232
8820,0.003853,172.31.36.0-255,66,230205,9,265232
8821,0.00386,74.125.24.0-255,7156,237361,9,265232
8822,0.003863,172.31.36.0-255,66,237427,9,265232
8823,0.0039,172.31.36.0-255,66,237493,9,265232
8824,0.003935,172.31.36.0-255,66,237559,9,265232
8825,0.003945,172.31.36.0-255,66,237625,9,265232
8826,0.003952,74.125.24.0-255,5738,243363,9,265232
8827,0.003954,172.31.36.0-255,66,243429,9,265232
8828,0.003975,74.125.24.0-255,4320,247749,9,265232
8829,0.003979,172.31.36.0-255,66,247815,9,265232
8830,0.004028,172.31.36.0-255,66,247881,9,265232
8831,0.004034,74.125.24.0-255,4320,252201,9,265232
8832,0.004036,172.31.36.0-255,66,252267,9,265232
8833,0.00406,74.125.24.0-255,5144,257411,9,265232
8834,0.004063,172.31.36.0-255,66,257477,9,265232
8835,0.004067,74.125.24.0-255,105,257582,9,265232
8836,0.007218,172.31.36.0-255,66,257648,9,265232
8837,0.007256,172.31.36.0-255,105,257753,9,265232
8838,0.009559,74.125.24.0-255,66,257819,9,265232
8839,0.02905,172.31.36.0-255,172,257991,9,265232
8840,0.029087,172.31.36.0-255,1115,259106,9,265232
8841,0.029148,172.31.36.0-255,1514,260620,9,265232
8842,0.02915,172.31.36.0-255,1514,262134,9,265232
8843,0.029155,172.31.36.0-255,1514,263648,9,265232
8844,0.029156,172.31.36.0-255,1320,264968,9,265232
8845,0.0306,104.244.42.0-255,66,265034,9,265232
8846,0.030637,104.244.42.0-255,66,265100,9,265232
8847,0.030724,104.244.42.0-255,66,265166,9,265232
8848,0.030743,104.244.42.0-255,66,265232,9,265232
8849,0.0,172.217.194.0-255,162,162,9,156074
8850,2.4e-05,172.217.194.0-255,1484,1646,9,156074
8851,3.1e-05,172.31.36.0-255,66,1712,9,156074
8852,3.9e-05,172.217.194.0-255,2902,4614,9,156074
8853,4.2e-05,172.31.36.0-255,66,4680,9,156074
8854,4.7e-05,172.217.194.0-255,4320,9000,9,156074
8855,5e-05,172.31.36.0-255,66,9066,9,156074
8856,8.3e-05,172.217.194.0-255,2902,11968,9,156074
8857,8.6e-05,172.31.36.0-255,66,12034,9,156074
8858,9.9e-05,172.31.36.0-255,66,12100,9,156074
8859,0.000133,172.217.194.0-255,6254,18354,9,156074
8860,0.000137,172.31.36.0-255,66,18420,9,156074
8861,0.000141,172.217.194.0-255,2543,20963,9,156074
8862,0.000143,172.31.36.0-255,66,21029,9,156074
8863,0.000426,172.217.194.0-255,1484,22513,9,156074
8864,0.000432,172.217.194.0-255,2902,25415,9,156074
8865,0.000435,172.31.36.0-255,66,25481,9,156074
8866,0.000466,172.217.194.0-255,5738,31219,9,156074
8867,0.00047,172.31.36.0-255,66,31285,9,156074
8868,0.000473,172.217.194.0-255,1484,32769,9,156074
8869,0.000518,172.31.36.0-255,66,32835,9,156074
8870,0.000537,172.31.36.0-255,66,32901,9,156074
8871,0.000541,172.217.194.0-255,363,33264,9,156074
8872,0.000634,172.217.194.0-255,1484,34748,9,156074
8873,0.000637,172.31.36.0-255,66,34814,9,156074
8874,0.000642,172.217.194.0-255,2902,37716,9,156074
8875,0.000645,172.31.36.0-255,66,37782,9,156074
8876,0.000657,172.217.194.0-255,5738,43520,9,156074
8877,0.000659,172.31.36.0-255,66,43586,9,156074
8878,0.000663,172.217.194.0-255,1484,45070,9,156074
8879,0.000701,172.31.36.0-255,66,45136,9,156074
8880,0.000708,172.217.194.0-255,4320,49456,9,156074
8881,0.00071,172.31.36.0-255,66,49522,9,156074
8882,0.00074,172.217.194.0-255,6438,55960,9,156074
8883,0.000743,172.31.36.0-255,66,56026,9,156074
8884,0.000784,172.217.194.0-255,1484,57510,9,156074
8885,0.000788,172.217.194.0-255,2902,60412,9,156074
8886,0.000791,172.31.36.0-255,66,60478,9,156074
8887,0.000825,172.217.194.0-255,5738,66216,9,156074
8888,0.000829,172.31.36.0-255,66,66282,9,156074
8889,0.00085,172.31.36.0-255,66,66348,9,156074
8890,0.000885,172.31.36.0-255,66,66414,9,156074
8891,0.000919,172.217.194.0-255,3053,69467,9,156074
8892,0.000922,172.31.36.0-255,66,69533,9,156074
8893,0.000942,172.31.36.0-255,66,69599,9,156074
8894,0.000959,172.31.36.0-255,66,69665,9,156074
8895,0.001007,172.217.194.0-255,1484,71149,9,156074
8896,0.001024,172.217.194.0-255,2902,74051,9,156074
8897,0.001027,172.31.36.0-255,66,74117,9,156074
8898,0.001034,172.217.194.0-255,5738,79855,9,156074
8899,0.001036,172.31.36.0-255,66,79921,9,156074
8900,0.001108,172.217.194.0-255,5738,85659,9,156074
8901,0.001112,172.31.36.0-255,66,85725,9,156074
8902,0.001142,172.217.194.0-255,7156,92881,9,156074
8903,0.001145,172.31.36.0-255,66,92947,9,156074
8904,0.001163,172.31.36.0-255,66,93013,9,156074
8905,0.001166,172.217.194.0-255,1484,94497,9,156074
8906,0.00117,172.217.194.0-255,2902,97399,9,156074
8907,0.001173,172.31.36.0-255,66,97465,9,156074
8908,0.001179,172.217.194.0-255,5738,103203,9,156074
8909,0.001182,172.31.36.0-255,66,103269,9,156074
8910,0.001209,172.31.36.0-255,66,103335,9,156074
8911,0.001216,172.217.194.0-255,5738,109073,9,156074
8912,0.001219,172.31.36.0-255,66,109139,9,156074
8913,0.001239,172.31.36.0-255,66,109205,9,156074
8914,0.001244,172.217.194.0-255,4320,113525,9,156074
8915,0.001246,172.31.36.0-255,66,113591,9,156074
8916,0.001296,172.31.36.0-255,66,113657,9,156074
8917,0.001301,172.217.194.0-255,3602,117259,9,156074
8918,0.001303,172.31.36.0-255,66,117325,9,156074
8919,0.001324,172.217.194.0-255,4320,121645,9,156074
8920,0.001327,172.31.36.0-255,66,121711,9,156074
8921,0.001339,172.217.194.0-255,5738,127449,9,156074
8922,0.001342,172.31.36.0-255,66,127515,9,156074
8923,0.001393,172.31.36.0-255,66,127581,9,156074
8924,0.001408,172.31.36.0-255,66,127647,9,156074
8925,0.001436,172.217.194.0-255,5738,133385,9,156074
8926,0.001439,172.31.36.0-255,66,133451,9,156074
8927,0.001477,172.217.194.0-255,4320,137771,9,156074
8928,0.001481,172.31.36.0-255,66,137837,9,156074
8929,0.001494,172.31.36.0-255,66,137903,9,156074
8930,0.001516,172.31.36.0-255,66,137969,9,156074
8931,0.001549,172.217.194.0-255,5020,142989,9,156074
8932,0.001558,172.31.36.0-255,66,143055,9,156074
8933,0.001578,172.31.36.0-255,66,143121,9,156074
8934,0.001591,172.31.36.0-255,66,143187,9,156074
8935,0.001669,172.31.36.0-255,66,143253,9,156074
8936,0.001674,172.217.194.0-255,3452,146705,9,156074
8937,0.001677,172.31.36.0-255,66,146771,9,156074
8938,0.00168,172.217.194.0-255,105,146876,9,156074
8939,0.008386,172.31.36.0-255,105,146981,9,156074
8940,0.010922,172.217.194.0-255,66,147047,9,156074
8941,0.033544,172.31.36.0-255,172,147219,9,156074
8942,0.033574,172.31.36.0-255,1115,148334,9,156074
8943,0.03362,172.31.36.0-255,1514,149848,9,156074
8944,0.033621,172.31.36.0-255,1514,151362,9,156074
8945,0.033628,172.31.36.0-255,1514,152876,9,156074
8946,0.033629,172.31.36.0-255,1514,154390,9,156074
8947,0.033655,172.31.36.0-255,1486,155876,9,156074
8948,0.035064,104.244.42.0-255,66,155942,9,156074
8949,0.035109,104.244.42.0-255,66,156008,9,156074
8950,0.035259,104.244.42.0-255,66,156074,9,156074
8951,0.0,74.125.24.0-255,153,153,9,298211
8952,3.3e-05,172.31.36.0-255,66,219,9,298211
8953,4.1e-05,74.125.24.0-255,1484,1703,9,298211
8954,4.6e-05,172.31.36.0-255,66,1769,9,298211
8955,6e-05,74.125.24.0-255,2902,4671,9,298211
8956,6.3e-05,172.31.36.0-255,66,4737,9,298211
8957,7e-05,74.125.24.0-255,7156,11893,9,298211
8958,7.3e-05,172.31.36.0-255,66,11959,9,298211
8959,0.000122,172.31.36.0-255,66,12025,9,298211
8960,0.000125,74.125.24.0-255,1484,13509,9,298211
8961,0.000127,172.31.36.0-255,66,13575,9,298211
8962,0.00013,74.125.24.0-255,1125,14700,9,298211
8963,0.000132,172.31.36.0-255,66,14766,9,298211
8964,0.000211,74.125.24.0-255,1484,16250,9,298211
8965,0.000215,172.31.36.0-255,66,16316,9,298211
8966,0.00022,74.125.24.0-255,2902,19218,9,298211
8967,0.000223,172.31.36.0-255,66,19284,9,298211
8968,0.000236,74.125.24.0-255,5738,25022,9,298211
8969,0.000238,172.31.36.0-255,66,25088,9,298211
8970,0.000278,172.31.36.0-255,66,25154,9,298211
8971,0.000282,74.125.24.0-255,2902,28056,9,298211
8972,0.000284,172.31.36.0-255,66,28122,9,298211
8973,0.000329,172.31.36.0-255,66,28188,9,298211
8974,0.00091,74.125.24.0-255,391,28579,9,298211
8975,0.000915,172.31.36.0-255,66,28645,9,298211
8976,0.001026,74.125.24.0-255,1484,30129,9,298211
8977,0.001031,172.31.36.0-255,66,30195,9,298211
8978,0.00104,74.125.24.0-255,2902,33097,9,298211
8979,0.001042,172.31.36.0-255,66,33163,9,298211
8980,0.001055,74.125.24.0-255,4320,37483,9,298211
8981,0.001108,74.125.24.0-255,4320,41803,9,298211
8982,0.001116,172.31.36.0-255,66,41869,9,298211
8983,0.001138,74.125.24.0-255,7156,49025,9,298211
8984,0.001142,74.125.24.0-255,1484,50509,9,298211
8985,0.001162,74.125.24.0-255,3602,54111,9,298211
8986,0.001218,74.125.24.0-255,1484,55595,9,298211
8987,0.001224,74.125.24.0-255,2902,58497,9,298211
8988,0.001226,74.125.24.0-255,1484,59981,9,298211
8989,0.001237,172.31.36.0-255,66,60047,9,298211
8990,0.001249,74.125.24.0-255,4320,64367,9,298211
8991,0.001255,74.125.24.0-255,5738,70105,9,298211
8992,0.001261,74.125.24.0-255,1484,71589,9,298211
8993,0.001269,172.31.36.0-255,66,71655,9,298211
8994,0.001306,74.125.24.0-255,1484,73139,9,298211
8995,0.001311,74.125.24.0-255,4726,77865,9,298211
8996,0.001337,172.31.36.0-255,66,77931,9,298211
8997,0.001364,74.125.24.0-255,5738,83669,9,298211
8998,0.001372,74.125.24.0-255,7156,90825,9,298211
8999,0.001416,74.125.24.0-255,7156,97981,9,298211
9000,0.001432,74.125.24.0-255,5020,103001,9,298211
9001,0.001456,172.31.36.0-255,66,103067,9,298211
9002,0.001474,74.125.24.0-255,1484,104551,9,298211
9003,0.00148,74.125.24.0-255,2902,107453,9,298211
9004,0.001487,74.125.24.0-255,5738,113191,9,298211
9005,0.001504,74.125.24.0-255,4320,117511,9,298211
9006,0.00152,74.125.24.0-255,5738,123249,9,298211
9007,0.001539,172.31.36.0-255,66,123315,9,298211
9008,0.00159,172.31.36.0-255,66,123381,9,298211
9009,0.002004,74.125.24.0-255,1484,124865,9,298211
9010,0.002009,74.125.24.0-255,1484,126349,9,298211
9011,0.002022,172.31.36.0-255,66,126415,9,298211
9012,0.00203,74.125.24.0-255,1484,127899,9,298211
9013,0.002035,74.125.24.0-255,5738,133637,9,298211
9014,0.002046,172.31.36.0-255,66,133703,9,298211
9015,0.002055,74.125.24.0-255,5738,139441,9,298211
9016,0.002076,74.125.24.0-255,7156,146597,9,298211
9017,0.002079,74.125.24.0-255,1484,148081,9,298211
9018,0.002104,74.125.24.0-255,5738,153819,9,298211
9019,0.00211,172.31.36.0-255,66,153885,9,298211
9020,0.002125,74.125.24.0-255,3602,157487,9,298211
9021,0.00213,172.31.36.0-255,66,157553,9,298211
9022,0.002156,74.125.24.0-255,4320,161873,9,298211
9023,0.00216,74.125.24.0-255,2902,164775,9,298211
9024,0.002174,74.125.24.0-255,2902,167677,9,298211
9025,0.002178,74.125.24.0-255,4320,171997,9,298211
9026,0.002181,172.31.36.0-255,66,172063,9,298211
9027,0.002186,172.31.36.0-255,66,172129,9,298211
9028,0.002217,74.125.24.0-255,7156,179285,9,298211
9029,0.002234,74.125.24.0-255,766,180051,9,298211
9030,0.002275,74.125.24.0-255,1484,181535,9,298211
9031,0.002279,74.125.24.0-255,1484,183019,9,298211
9032,0.002291,74.125.24.0-255,2902,185921,9,298211
9033,0.002302,74.125.24.0-255,1484,187405,9,298211
9034,0.00232,74.125.24.0-255,4320,191725,9,298211
9035,0.002326,74.125.24.0-255,7156,198881,9,298211
9036,0.002386,74.125.24.0-255,766,199647,9,298211
9037,0.002457,74.125.24.0-255,1484,201131,9,298211
9038,0.002462,74.125.24.0-255,2902,204033,9,298211
9039,0.002466,74.125.24.0-255,2902,206935,9,298211
9040,0.002483,74.125.24.0-255,2902,209837,9,298211
9041,0.002734,172.31.36.0-255,66,209903,9,298211
9042,0.005269,74.125.24.0-255,4320,214223,9,298211
9043,0.005275,172.31.36.0-255,66,214289,9,298211
9044,0.005307,74.125.24.0-255,1484,215773,9,298211
9045,0.007731,74.125.24.0-255,4320,220093,9,298211
9046,0.007738,172.31.36.0-255,66,220159,9,298211
9047,0.010235,74.125.24.0-255,5738,225897,9,298211
9048,0.010295,172.31.36.0-255,66,225963,9,298211
9049,0.012738,74.125.24.0-255,5738,231701,9,298211
9050,0.012748,172.31.36.0-255,66,231767,9,298211
9051,0.015216,74.125.24.0-255,5738,237505,9,298211
9052,0.015226,172.31.36.0-255,66,237571,9,298211
9053,0.017695,74.125.24.0-255,5738,243309,9,298211
9054,0.017704,172.31.36.0-255,66,243375,9,298211
9055,0.020225,74.125.24.0-255,5738,249113,9,298211
9056,0.020233,172.31.36.0-255,66,249179,9,298211
9057,0.022672,74.125.24.0-255,5738,254917,9,298211
9058,0.022679,172.31.36.0-255,66,254983,9,298211
9059,0.025146,74.125.24.0-255,5738,260721,9,298211
9060,0.025155,172.31.36.0-255,66,260787,9,298211
9061,0.027612,74.125.24.0-255,5738,266525,9,298211
9062,0.027621,172.31.36.0-255,66,266591,9,298211
9063,0.030089,74.125.24.0-255,4320,270911,9,298211
9064,0.030097,172.31.36.0-255,66,270977,9,298211
9065,0.030131,74.125.24.0-255,1484,272461,9,298211
9066,0.03257,74.125.24.0-255,4320,276781,9,298211
9067,0.032578,172.31.36.0-255,66,276847,9,298211
9068,0.035041,74.125.24.0-255,5738,282585,9,298211
9069,0.035097,172.31.36.0-255,66,282651,9,298211
9070,0.03754,74.125.24.0-255,5738,288389,9,298211
9071,0.037547,172.31.36.0-255,66,288455,9,298211
9072,0.039996,74.125.24.0-255,3319,291774,9,298211
9073,0.040005,172.31.36.0-255,66,291840,9,298211
9074,0.040246,172.31.36.0-255,105,291945,9,298211
9075,0.042683,74.125.24.0-255,66,292011,9,298211
9076,0.044352,172.31.36.0-255,172,292183,9,298211
9077,0.044396,172.31.36.0-255,1116,293299,9,298211
9078,0.044469,172.31.36.0-255,1514,294813,9,298211
9079,0.044472,172.31.36.0-255,1514,296327,9,298211
9080,0.044473,172.31.36.0-255,1514,297841,9,298211
9081,0.044474,172.31.36.0-255,106,297947,9,298211
9082,0.046021,104.244.42.0-255,66,298013,9,298211
9083,0.046038,104.244.42.0-255,66,298079,9,298211
9084,0.046155,104.244.42.0-255,66,298145,9,298211
9085,0.046158,104.244.42.0-255,66,298211,9,298211
9086,0.0,172.217.24.0-255,153,153,9,226388
9087,2.5e-05,172.217.24.0-255,1484,1637,9,226388
9088,3.1e-05,172.31.36.0-255,66,1703,9,226388
9089,3.7e-05,172.217.24.0-255,2902,4605,9,226388
9090,4e-05,172.31.36.0-255,66,4671,9,226388
9091,5.7e-05,172.217.24.0-255,4320,8991,9,226388
9092,5.9e-05,172.31.36.0-255,66,9057,9,226388
9093,7.1e-05,172.217.24.0-255,2902,11959,9,226388
9094,7.4e-05,172.31.36.0-255,66,12025,9,226388
9095,7.8e-05,172.217.24.0-255,1991,14016,9,226388
9096,8.1e-05,172.31.36.0-255,66,14082,9,226388
9097,0.000127,172.217.24.0-255,2902,16984,9,226388
9098,0.00013,172.31.36.0-255,66,17050,9,226388
9099,0.000138,172.217.24.0-255,4320,21370,9,226388
9100,0.000142,172.31.36.0-255,66,21436,9,226388
9101,0.000159,172.217.24.0-255,1484,22920,9,226388
9102,0.000167,172.217.24.0-255,7156,30076,9,226388
9103,0.000169,172.31.36.0-255,66,30142,9,226388
9104,0.000172,172.217.24.0-255,1125,31267,9,226388
9105,0.000254,172.217.24.0-255,1484,32751,9,226388
9106,0.000258,172.31.36.0-255,66,32817,9,226388
9107,0.000261,172.217.24.0-255,1484,34301,9,226388
9108,0.000279,172.217.24.0-255,1484,35785,9,226388
9109,0.000284,172.217.24.0-255,4320,40105,9,226388
9110,0.000285,172.31.36.0-255,66,40171,9,226388
9111,0.000286,172.217.24.0-255,1484,41655,9,226388
9112,0.000289,172.31.36.0-255,66,41721,9,226388
9113,0.0003,172.217.24.0-255,4320,46041,9,226388
9114,0.000303,172.31.36.0-255,66,46107,9,226388
9115,0.000347,172.31.36.0-255,66,46173,9,226388
9116,0.000354,172.217.24.0-255,7099,53272,9,226388
9117,0.000357,172.31.36.0-255,66,53338,9,226388
9118,0.001216,172.217.24.0-255,121,53459,9,226388
9119,0.001349,172.217.24.0-255,1484,54943,9,226388
9120,0.001354,172.31.36.0-255,66,55009,9,226388
9121,0.001363,172.217.24.0-255,2902,57911,9,226388
9122,0.001365,172.31.36.0-255,66,57977,9,226388
9123,0.001371,172.217.24.0-255,5738,63715,9,226388
9124,0.001374,172.31.36.0-255,66,63781,9,226388
9125,0.001381,172.217.24.0-255,6797,70578,9,226388
9126,0.001383,172.31.36.0-255,66,70644,9,226388
9127,0.001423,172.31.36.0-255,66,70710,9,226388
9128,0.001442,172.217.24.0-255,2543,73253,9,226388
9129,0.001444,172.31.36.0-255,66,73319,9,226388
9130,0.002111,172.217.24.0-255,1484,74803,9,226388
9131,0.002117,172.217.24.0-255,1484,76287,9,226388
9132,0.002121,172.31.36.0-255,66,76353,9,226388
9133,0.002137,172.217.24.0-255,1484,77837,9,226388
9134,0.002139,172.217.24.0-255,1484,79321,9,226388
9135,0.002141,172.31.36.0-255,66,79387,9,226388
9136,0.002146,172.217.24.0-255,2902,82289,9,226388
9137,0.002148,172.31.36.0-255,66,82355,9,226388
9138,0.002177,172.217.24.0-255,5738,88093,9,226388
9139,0.002179,172.31.36.0-255,66,88159,9,226388
9140,0.002185,172.217.24.0-255,5738,93897,9,226388
9141,0.002187,172.31.36.0-255,66,93963,9,226388
9142,0.002194,172.217.24.0-255,7156,101119,9,226388
9143,0.002196,172.31.36.0-255,66,101185,9,226388
9144,0.002201,172.217.24.0-255,4320,105505,9,226388
9145,0.002202,172.31.36.0-255,66,105571,9,226388
9146,0.002205,172.217.24.0-255,1484,107055,9,226388
9147,0.002208,172.217.24.0-255,766,107821,9,226388
9148,0.00221,172.31.36.0-255,66,107887,9,226388
9149,0.002474,172.217.24.0-255,1484,109371,9,226388
9150,0.002481,172.217.24.0-255,2902,112273,9,226388
9151,0.002485,172.31.36.0-255,66,112339,9,226388
9152,0.002506,172.217.24.0-255,5738,118077,9,226388
9153,0.002508,172.31.36.0-255,66,118143,9,226388
9154,0.002529,172.217.24.0-255,4320,122463,9,226388
9155,0.002531,172.31.36.0-255,66,122529,9,226388
9156,0.002548,172.217.24.0-255,1484,124013,9,226388
9157,0.002555,172.217.24.0-255,7156,131169,9,226388
9158,0.002557,172.31.36.0-255,66,131235,9,226388
9159,0.00256,172.217.24.0-255,1484,132719,9,226388
9160,0.002589,172.217.24.0-255,7156,139875,9,226388
9161,0.002592,172.31.36.0-255,66,139941,9,226388
9162,0.002599,172.31.36.0-255,66,140007,9,226388
9163,0.002604,172.217.24.0-255,4320,144327,9,226388
9164,0.002606,172.31.36.0-255,66,144393,9,226388
9165,0.002621,172.31.36.0-255,66,144459,9,226388
9166,0.002649,172.217.24.0-255,6438,150897,9,226388
9167,0.002652,172.31.36.0-255,66,150963,9,226388
9168,0.002655,172.217.24.0-255,1484,152447,9,226388
9169,0.002659,172.217.24.0-255,2902,155349,9,226388
9170,0.002661,172.31.36.0-255,66,155415,9,226388
9171,0.002684,172.217.24.0-255,5738,161153,9,226388
9172,0.002687,172.31.36.0-255,66,161219,9,226388
9173,0.002721,172.217.24.0-255,1484,162703,9,226388
9174,0.002742,172.31.36.0-255,66,162769,9,226388
9175,0.002753,172.31.36.0-255,66,162835,9,226388
9176,0.002783,172.217.24.0-255,1484,164319,9,226388
9177,0.0028,172.217.24.0-255,2902,167221,9,226388
9178,0.002803,172.31.36.0-255,66,167287,9,226388
9179,0.002809,172.217.24.0-255,5738,173025,9,226388
9180,0.002811,172.31.36.0-255,66,173091,9,226388
9181,0.002833,172.217.24.0-255,7156,180247,9,226388
9182,0.002836,172.31.36.0-255,66,180313,9,226388
9183,0.002866,172.217.24.0-255,5738,186051,9,226388
9184,0.002869,172.31.36.0-255,66,186117,9,226388
9185,0.002881,172.31.36.0-255,66,186183,9,226388
9186,0.002893,172.31.36.0-255,66,186249,9,226388
9187,0.002898,172.217.24.0-255,5738,191987,9,226388
9188,0.002901,172.31.36.0-255,66,192053,9,226388
9189,0.002939,172.31.36.0-255,66,192119,9,226388
9190,0.002945,172.217.24.0-255,5738,197857,9,226388
9191,0.002947,172.31.36.0-255,66,197923,9,226388
9192,0.00297,172.31.36.0-255,66,197989,9,226388
9193,0.002977,172.217.24.0-255,7156,205145,9,226388
9194,0.002979,172.31.36.0-255,66,205211,9,226388
9195,0.003002,172.217.24.0-255,2902,208113,9,226388
9196,0.003004,172.31.36.0-255,66,208179,9,226388
9197,0.003019,172.217.24.0-255,4320,212499,9,226388
9198,0.003022,172.31.36.0-255,66,212565,9,226388
9199,0.00306,172.31.36.0-255,66,212631,9,226388
9200,0.003066,172.217.24.0-255,5738,218369,9,226388
9201,0.003068,172.31.36.0-255,66,218435,9,226388
9202,0.003095,172.31.36.0-255,66,218501,9,226388
9203,0.003108,172.31.36.0-255,66,218567,9,226388
9204,0.003149,172.31.36.0-255,66,218633,9,226388
9205,0.003216,172.31.36.0-255,66,218699,9,226388
9206,0.003219,172.217.24.0-255,105,218804,9,226388
9207,0.005436,172.31.36.0-255,105,218909,9,226388
9208,0.007348,172.217.24.0-255,66,218975,9,226388
9209,0.026582,172.31.36.0-255,172,219147,9,226388
9210,0.026621,172.31.36.0-255,1115,220262,9,226388
9211,0.026685,172.31.36.0-255,1514,221776,9,226388
9212,0.026687,172.31.36.0-255,1514,223290,9,226388
9213,0.026689,172.31.36.0-255,1514,224804,9,226388
9214,0.02669,172.31.36.0-255,1320,226124,9,226388
9215,0.02814,104.244.42.0-255,66,226190,9,226388
9216,0.028184,104.244.42.0-255,66,226256,9,226388
9217,0.02828,104.244.42.0-255,66,226322,9,226388
9218,0.028283,104.244.42.0-255,66,226388,9,226388
9219,0.0,74.125.130.0-255,153,153,9,361574
9220,2.9e-05,172.31.36.0-255,66,219,9,361574
9221,3.7e-05,74.125.130.0-255,1484,1703,9,361574
9222,4.1e-05,172.31.36.0-255,66,1769,9,361574
9223,6.3e-05,74.125.130.0-255,2902,4671,9,361574
9224,6.5e-05,172.31.36.0-255,66,4737,9,361574
9225,7.1e-05,74.125.130.0-255,4320,9057,9,361574
9226,7.3e-05,172.31.36.0-255,66,9123,9,361574
9227,0.000105,74.125.130.0-255,4920,14043,9,361574
9228,0.00011,172.31.36.0-255,66,14109,9,361574
9229,0.000137,74.125.130.0-255,4320,18429,9,361574
9230,0.00014,172.31.36.0-255,66,18495,9,361574
9231,0.000155,74.125.130.0-255,1484,19979,9,361574
9232,0.000158,172.31.36.0-255,66,20045,9,361574
9233,0.000162,74.125.130.0-255,1484,21529,9,361574
9234,0.000164,172.31.36.0-255,66,21595,9,361574
9235,0.000168,74.125.130.0-255,2902,24497,9,361574
9236,0.00017,172.31.36.0-255,66,24563,9,361574
9237,0.000192,74.125.130.0-255,2902,27465,9,361574
9238,0.000194,172.31.36.0-255,66,27531,9,361574
9239,0.00021,74.125.130.0-255,2902,30433,9,361574
9240,0.000213,172.31.36.0-255,66,30499,9,361574
9241,0.000251,74.125.130.0-255,1125,31624,9,361574
9242,0.000254,172.31.36.0-255,66,31690,9,361574
9243,0.000405,74.125.130.0-255,1484,33174,9,361574
9244,0.00041,172.31.36.0-255,66,33240,9,361574
9245,0.000414,74.125.130.0-255,1484,34724,9,361574
9246,0.000416,172.31.36.0-255,66,34790,9,361574
9247,0.000438,74.125.130.0-255,1484,36274,9,361574
9248,0.000441,172.31.36.0-255,66,36340,9,361574
9249,0.000459,74.125.130.0-255,1484,37824,9,361574
9250,0.000463,172.31.36.0-255,66,37890,9,361574
9251,0.000484,74.125.130.0-255,4320,42210,9,361574
9252,0.000492,74.125.130.0-255,5738,47948,9,361574
9253,0.000491,172.31.36.0-255,66,48014,9,361574
9254,0.000497,172.31.36.0-255,66,48080,9,361574
9255,0.000518,74.125.130.0-255,5379,53459,9,361574
9256,0.000523,172.31.36.0-255,66,53525,9,361574
9257,0.000524,74.125.130.0-255,5738,59263,9,361574
9258,0.000528,172.31.36.0-255,66,59329,9,361574
9259,0.00057,74.125.130.0-255,6797,66126,9,361574
9260,0.000583,172.31.36.0-255,66,66192,9,361574
9261,0.000828,74.125.130.0-255,646,66838,9,361574
9262,0.000886,172.31.36.0-255,66,66904,9,361574
9263,0.001005,74.125.130.0-255,1484,68388,9,361574
9264,0.001025,74.125.130.0-255,2902,71290,9,361574
9265,0.001052,74.125.130.0-255,1484,72774,9,361574
9266,0.001071,74.125.130.0-255,4320,77094,9,361574
9267,0.001074,74.125.130.0-255,1484,78578,9,361574
9268,0.00109,74.125.130.0-255,2902,81480,9,361574
9269,0.001127,74.125.130.0-255,1484,82964,9,361574
9270,0.001146,74.125.130.0-255,2543,85507,9,361574
9271,0.001152,74.125.130.0-255,4320,89827,9,361574
9272,0.001179,74.125.130.0-255,4320,94147,9,361574
9273,0.001191,74.125.130.0-255,2902,97049,9,361574
9274,0.001223,74.125.130.0-255,3961,101010,9,361574
9275,0.001972,74.125.130.0-255,1484,102494,9,361574
9276,0.001991,74.125.130.0-255,2902,105396,9,361574
9277,0.002009,74.125.130.0-255,4320,109716,9,361574
9278,0.002022,74.125.130.0-255,1484,111200,9,361574
9279,0.002037,74.125.130.0-255,2902,114102,9,361574
9280,0.002051,74.125.130.0-255,2902,117004,9,361574
9281,0.002073,74.125.130.0-255,7156,124160,9,361574
9282,0.002095,74.125.130.0-255,7156,131316,9,361574
9283,0.002108,74.125.130.0-255,1484,132800,9,361574
9284,0.002136,74.125.130.0-255,2184,134984,9,361574
9285,0.002365,74.125.130.0-255,1484,136468,9,361574
9286,0.00238,74.125.130.0-255,2902,139370,9,361574
9287,0.002405,74.125.130.0-255,4320,143690,9,361574
9288,0.002421,74.125.130.0-255,1484,145174,9,361574
9289,0.002442,74.125.130.0-255,7156,152330,9,361574
9290,0.002459,74.125.130.0-255,2902,155232,9,361574
9291,0.002472,74.125.130.0-255,1484,156716,9,361574
9292,0.002475,74.125.130.0-255,1484,158200,9,361574
9293,0.002491,74.125.130.0-255,2902,161102,9,361574
9294,0.002511,74.125.130.0-255,4320,165422,9,361574
9295,0.002526,74.125.130.0-255,3602,169024,9,361574
9296,0.002663,74.125.130.0-255,1484,170508,9,361574
9297,0.002676,74.125.130.0-255,1484,171992,9,361574
9298,0.002687,74.125.130.0-255,2902,174894,9,361574
9299,0.002698,74.125.130.0-255,1484,176378,9,361574
9300,0.002716,74.125.130.0-255,4320,180698,9,361574
9301,0.002739,74.125.130.0-255,7156,187854,9,361574
9302,0.002755,74.125.130.0-255,2902,190756,9,361574
9303,0.002767,74.125.130.0-255,2902,193658,9,361574
9304,0.002785,74.125.130.0-255,4320,197978,9,361574
9305,0.002798,74.125.130.0-255,4320,202298,9,361574
9306,0.002801,74.125.130.0-255,766,203064,9,361574
9307,0.003025,74.125.130.0-255,1484,204548,9,361574
9308,0.003037,74.125.130.0-255,2902,207450,9,361574
9309,0.003041,74.125.130.0-255,2902,210352,9,361574
9310,0.003057,74.125.130.0-255,2902,213254,9,361574
9311,0.003084,74.125.130.0-255,2902,216156,9,361574
9312,0.003101,74.125.130.0-255,7156,223312,9,361574
9313,0.003117,74.125.130.0-255,2902,226214,9,361574
9314,0.003144,74.125.130.0-255,2902,229116,9,361574
9315,0.00336,74.125.130.0-255,1484,230600,9,361574
9316,0.003363,74.125.130.0-255,1484,232084,9,361574
9317,0.003384,74.125.130.0-255,1484,233568,9,361574
9318,0.003388,74.125.130.0-255,2902,236470,9,361574
9319,0.003427,74.125.130.0-255,2902,239372,9,361574
9320,0.003444,74.125.130.0-255,1484,240856,9,361574
9321,0.003463,74.125.130.0-255,5738,246594,9,361574
9322,0.003469,74.125.130.0-255,5738,252332,9,361574
9323,0.003493,74.125.130.0-255,1484,253816,9,361574
9324,0.003496,74.125.130.0-255,766,254582,9,361574
9325,0.00351,74.125.130.0-255,1484,256066,9,361574
9326,0.003533,74.125.130.0-255,4320,260386,9,361574
9327,0.00355,74.125.130.0-255,1484,261870,9,361574
9328,0.003571,74.125.130.0-255,5738,267608,9,361574
9329,0.003621,74.125.130.0-255,2184,269792,9,361574
9330,0.003671,74.125.130.0-255,2902,272694,9,361574
9331,0.003678,74.125.130.0-255,5738,278432,9,361574
9332,0.003725,74.125.130.0-255,4320,282752,9,361574
9333,0.003738,74.125.130.0-255,2184,284936,9,361574
9334,0.003752,74.125.130.0-255,1484,286420,9,361574
9335,0.003763,74.125.130.0-255,1484,287904,9,361574
9336,0.003779,172.31.36.0-255,66,287970,9,361574
9337,0.003793,74.125.130.0-255,1484,289454,9,361574
9338,0.003815,74.125.130.0-255,5738,295192,9,361574
9339,0.00382,74.125.130.0-255,2902,298094,9,361574
9340,0.003822,172.31.36.0-255,66,298160,9,361574
9341,0.003825,74.125.130.0-255,4320,302480,9,361574
9342,0.003829,172.31.36.0-255,66,302546,9,361574
9343,0.003843,74.125.130.0-255,1484,304030,9,361574
9344,0.003871,74.125.130.0-255,7156,311186,9,361574
9345,0.003876,172.31.36.0-255,66,311252,9,361574
9346,0.003879,74.125.130.0-255,7156,318408,9,361574
9347,0.003884,74.125.130.0-255,2902,321310,9,361574
9348,0.003892,172.31.36.0-255,66,321376,9,361574
9349,0.003905,74.125.130.0-255,5020,326396,9,361574
9350,0.003911,74.125.130.0-255,4320,330716,9,361574
9351,0.003913,172.31.36.0-255,66,330782,9,361574
9352,0.003917,74.125.130.0-255,5738,336520,9,361574
9353,0.003918,172.31.36.0-255,66,336586,9,361574
9354,0.003935,172.31.36.0-255,66,336652,9,361574
9355,0.003959,74.125.130.0-255,2902,339554,9,361574
9356,0.003966,172.31.36.0-255,66,339620,9,361574
9357,0.003973,74.125.130.0-255,1484,341104,9,361574
9358,0.004002,74.125.130.0-255,2184,343288,9,361574
9359,0.004007,172.31.36.0-255,66,343354,9,361574
9360,0.004019,74.125.130.0-255,2902,346256,9,361574
9361,0.004024,74.125.130.0-255,2902,349158,9,361574
9362,0.004027,172.31.36.0-255,66,349224,9,361574
9363,0.004033,172.31.36.0-255,66,349290,9,361574
9364,0.004049,74.125.130.0-255,4320,353610,9,361574
9365,0.004053,74.125.130.0-255,1272,354882,9,361574
9366,0.004054,172.31.36.0-255,66,354948,9,361574
9367,0.004103,74.125.130.0-255,105,355053,9,361574
9368,0.010794,172.31.36.0-255,66,355119,9,361574
9369,0.010825,172.31.36.0-255,105,355224,9,361574
9370,0.013212,74.125.130.0-255,66,355290,9,361574
9371,0.050572,172.31.36.0-255,176,355466,9,361574
9372,0.050607,172.31.36.0-255,1116,356582,9,361574
9373,0.050664,172.31.36.0-255,1514,358096,9,361574
9374,0.050666,172.31.36.0-255,1514,359610,9,361574
9375,0.050667,172.31.36.0-255,1514,361124,9,361574
9376,0.050668,172.31.36.0-255,186,361310,9,361574
9377,0.052287,104.244.42.0-255,66,361376,9,361574
9378,0.052304,104.244.42.0-255,66,361442,9,361574
9379,0.052367,104.244.42.0-255,66,361508,9,361574
9380,0.052371,104.244.42.0-255,66,361574,9,361574
9381,0.0,74.125.24.0-255,153,153,9,276338
9382,2.4e-05,172.31.36.0-255,66,219,9,276338
9383,3.1e-05,74.125.24.0-255,1484,1703,9,276338
9384,3.6e-05,172.31.36.0-255,66,1769,9,276338
9385,4.2e-05,74.125.24.0-255,2902,4671,9,276338
9386,4.5e-05,172.31.36.0-255,66,4737,9,276338
9387,5.9e-05,74.125.24.0-255,4320,9057,9,276338
9388,6.2e-05,172.31.36.0-255,66,9123,9,276338
9389,9.6e-05,74.125.24.0-255,2902,12025,9,276338
9390,9.9e-05,172.31.36.0-255,66,12091,9,276338
9391,0.000123,74.125.24.0-255,2084,14175,9,276338
9392,0.000126,172.31.36.0-255,66,14241,9,276338
9393,0.000179,74.125.24.0-255,1484,15725,9,276338
9394,0.000181,172.31.36.0-255,66,15791,9,276338
9395,0.000187,74.125.24.0-255,2902,18693,9,276338
9396,0.00019,172.31.36.0-255,66,18759,9,276338
9397,0.000219,74.125.24.0-255,5738,24497,9,276338
9398,0.000221,172.31.36.0-255,66,24563,9,276338
9399,0.000264,74.125.24.0-255,5738,30301,9,276338
9400,0.000268,172.31.36.0-255,66,30367,9,276338
9401,0.000282,74.125.24.0-255,3961,34328,9,276338
9402,0.000284,172.31.36.0-255,66,34394,9,276338
9403,0.000293,74.125.24.0-255,2902,37296,9,276338
9404,0.000295,172.31.36.0-255,66,37362,9,276338
9405,0.000326,74.125.24.0-255,7156,44518,9,276338
9406,0.000329,172.31.36.0-255,66,44584,9,276338
9407,0.000335,74.125.24.0-255,3961,48545,9,276338
9408,0.000337,172.31.36.0-255,66,48611,9,276338
9409,0.000361,74.125.24.0-255,1484,50095,9,276338
9410,0.000364,172.31.36.0-255,66,50161,9,276338
9411,0.000369,74.125.24.0-255,2902,53063,9,276338
9412,0.000371,172.31.36.0-255,66,53129,9,276338
9413,0.0004,74.125.24.0-255,5738,58867,9,276338
9414,0.000403,172.31.36.0-255,66,58933,9,276338
9415,0.000426,74.125.24.0-255,7069,66002,9,276338
9416,0.000429,172.31.36.0-255,66,66068,9,276338
9417,0.000454,74.125.24.0-255,127,66195,9,276338
9418,0.000577,74.125.24.0-255,1484,67679,9,276338
9419,0.000581,172.31.36.0-255,66,67745,9,276338
9420,0.000587,74.125.24.0-255,2902,70647,9,276338
9421,0.000589,172.31.36.0-255,66,70713,9,276338
9422,0.000617,74.125.24.0-255,5738,76451,9,276338
9423,0.000625,172.31.36.0-255,66,76517,9,276338
9424,0.000627,74.125.24.0-255,1484,78001,9,276338
9425,0.000666,74.125.24.0-255,7156,85157,9,276338
9426,0.000669,172.31.36.0-255,66,85223,9,276338
9427,0.000699,74.125.24.0-255,6797,92020,9,276338
9428,0.000702,172.31.36.0-255,66,92086,9,276338
9429,0.000732,172.31.36.0-255,66,92152,9,276338
9430,0.001395,74.125.24.0-255,1484,93636,9,276338
9431,0.001402,74.125.24.0-255,2902,96538,9,276338
9432,0.001406,172.31.36.0-255,66,96604,9,276338
9433,0.00143,74.125.24.0-255,1484,98088,9,276338
9434,0.001435,74.125.24.0-255,2902,100990,9,276338
9435,0.001437,172.31.36.0-255,66,101056,9,276338
9436,0.00144,74.125.24.0-255,1484,102540,9,276338
9437,0.001464,74.125.24.0-255,4320,106860,9,276338
9438,0.001466,172.31.36.0-255,66,106926,9,276338
9439,0.001469,74.125.24.0-255,1484,108410,9,276338
9440,0.001503,172.31.36.0-255,66,108476,9,276338
9441,0.001531,74.125.24.0-255,4320,112796,9,276338
9442,0.001533,172.31.36.0-255,66,112862,9,276338
9443,0.001554,74.125.24.0-255,3602,116464,9,276338
9444,0.001557,172.31.36.0-255,66,116530,9,276338
9445,0.003528,74.125.24.0-255,5738,122268,9,276338
9446,0.003535,172.31.36.0-255,66,122334,9,276338
9447,0.005524,74.125.24.0-255,5738,128072,9,276338
9448,0.005528,172.31.36.0-255,66,128138,9,276338
9449,0.007509,74.125.24.0-255,4320,132458,9,276338
9450,0.007516,172.31.36.0-255,66,132524,9,276338
9451,0.007544,74.125.24.0-255,1484,134008,9,276338
9452,0.009523,74.125.24.0-255,4320,138328,9,276338
9453,0.009532,172.31.36.0-255,66,138394,9,276338
9454,0.011587,74.125.24.0-255,5738,144132,9,276338
9455,0.011595,172.31.36.0-255,66,144198,9,276338
9456,0.013607,74.125.24.0-255,5738,149936,9,276338
9457,0.013615,172.31.36.0-255,66,150002,9,276338
9458,0.015618,74.125.24.0-255,5738,155740,9,276338
9459,0.015626,172.31.36.0-255,66,155806,9,276338
9460,0.017682,74.125.24.0-255,5738,161544,9,276338
9461,0.01769,172.31.36.0-255,66,161610,9,276338
9462,0.019696,74.125.24.0-255,5738,167348,9,276338
9463,0.019703,172.31.36.0-255,66,167414,9,276338
9464,0.021716,74.125.24.0-255,5738,173152,9,276338
9465,0.021723,172.31.36.0-255,66,173218,9,276338
9466,0.023748,74.125.24.0-255,5738,178956,9,276338
9467,0.023756,172.31.36.0-255,66,179022,9,276338
9468,0.025751,74.125.24.0-255,5738,184760,9,276338
9469,0.025758,172.31.36.0-255,66,184826,9,276338
9470,0.027816,74.125.24.0-255,5738,190564,9,276338
9471,0.027823,172.31.36.0-255,66,190630,9,276338
9472,0.029841,74.125.24.0-255,5738,196368,9,276338
9473,0.02985,172.31.36.0-255,66,196434,9,276338
9474,0.031878,74.125.24.0-255,5738,202172,9,276338
9475,0.031886,172.31.36.0-255,66,202238,9,276338
9476,0.033877,74.125.24.0-255,5738,207976,9,276338
9477,0.033884,172.31.36.0-255,66,208042,9,276338
9478,0.035935,74.125.24.0-255,5738,213780,9,276338
9479,0.03594,172.31.36.0-255,66,213846,9,276338
9480,0.037952,74.125.24.0-255,4320,218166,9,276338
9481,0.037961,172.31.36.0-255,66,218232,9,276338
9482,0.037987,74.125.24.0-255,1484,219716,9,276338
9483,0.039973,74.125.24.0-255,4320,224036,9,276338
9484,0.03998,172.31.36.0-255,66,224102,9,276338
9485,0.041973,74.125.24.0-255,5738,229840,9,276338
9486,0.041981,172.31.36.0-255,66,229906,9,276338
9487,0.04401,74.125.24.0-255,5738,235644,9,276338
9488,0.044018,172.31.36.0-255,66,235710,9,276338
9489,0.046013,74.125.24.0-255,5738,241448,9,276338
9490,0.046025,172.31.36.0-255,66,241514,9,276338
9491,0.048022,74.125.24.0-255,5738,247252,9,276338
9492,0.048034,172.31.36.0-255,66,247318,9,276338
9493,0.050035,74.125.24.0-255,5738,253056,9,276338
9494,0.050044,172.31.36.0-255,66,253122,9,276338
9495,0.052046,74.125.24.0-255,5738,258860,9,276338
9496,0.052054,172.31.36.0-255,66,258926,9,276338
9497,0.054036,74.125.24.0-255,5738,264664,9,276338
9498,0.054043,172.31.36.0-255,66,264730,9,276338
9499,0.056061,74.125.24.0-255,5738,270468,9,276338
9500,0.056068,172.31.36.0-255,66,270534,9,276338
9501,0.058079,74.125.24.0-255,5738,276272,9,276338
9502,0.058087,172.31.36.0-255,66,276338,9,276338
9503,0.0,74.125.130.0-255,297,297,9,329748
9504,4e-05,172.31.36.0-255,66,363,9,329748
9505,4.7e-05,74.125.130.0-255,1484,1847,9,329748
9506,5.3e-05,172.31.36.0-255,66,1913,9,329748
9507,5.8e-05,74.125.130.0-255,2902,4815,9,329748
9508,6.1e-05,172.31.36.0-255,66,4881,9,329748
9509,7.5e-05,74.125.130.0-255,5738,10619,9,329748
9510,7.8e-05,172.31.36.0-255,66,10685,9,329748
9511,8.3e-05,74.125.130.0-255,3294,13979,9,329748
9512,8.6e-05,172.31.36.0-255,66,14045,9,329748
9513,9.2e-05,74.125.130.0-255,4320,18365,9,329748
9514,9.4e-05,172.31.36.0-255,66,18431,9,329748
9515,0.000134,74.125.130.0-255,7156,25587,9,329748
9516,0.000137,172.31.36.0-255,66,25653,9,329748
9517,0.000161,74.125.130.0-255,1484,27137,9,329748
9518,0.000163,172.31.36.0-255,66,27203,9,329748
9519,0.000195,74.125.130.0-255,3961,31164,9,329748
9520,0.000198,172.31.36.0-255,66,31230,9,329748
9521,0.000311,74.125.130.0-255,1484,32714,9,329748
9522,0.000315,172.31.36.0-255,66,32780,9,329748
9523,0.000345,74.125.130.0-255,2902,35682,9,329748
9524,0.000349,172.31.36.0-255,66,35748,9,329748
9525,0.000356,74.125.130.0-255,5738,41486,9,329748
9526,0.000359,172.31.36.0-255,66,41552,9,329748
9527,0.000396,74.125.130.0-255,6797,48349,9,329748
9528,0.000399,172.31.36.0-255,66,48415,9,329748
9529,0.000406,74.125.130.0-255,7156,55571,9,329748
9530,0.000409,172.31.36.0-255,66,55637,9,329748
9531,0.000414,74.125.130.0-255,2902,58539,9,329748
9532,0.000417,172.31.36.0-255,66,58605,9,329748
9533,0.000448,74.125.130.0-255,4320,62925,9,329748
9534,0.000451,172.31.36.0-255,66,62991,9,329748
9535,0.000487,74.125.130.0-255,2794,65785,9,329748
9536,0.000502,172.31.36.0-255,66,65851,9,329748
9537,0.00075,74.125.130.0-255,121,65972,9,329748
9538,0.000789,74.125.130.0-255,1484,67456,9,329748
9539,0.000794,172.31.36.0-255,66,67522,9,329748
9540,0.000801,74.125.130.0-255,2902,70424,9,329748
9541,0.000813,172.31.36.0-255,66,70490,9,329748
9542,0.000826,74.125.130.0-255,5738,76228,9,329748
9543,0.000835,74.125.130.0-255,1484,77712,9,329748
9544,0.000836,172.31.36.0-255,66,77778,9,329748
9545,0.000861,74.125.130.0-255,5379,83157,9,329748
9546,0.000866,172.31.36.0-255,66,83223,9,329748
9547,0.000903,74.125.130.0-255,1484,84707,9,329748
9548,0.000908,74.125.130.0-255,2902,87609,9,329748
9549,0.000912,172.31.36.0-255,66,87675,9,329748
9550,0.000938,74.125.130.0-255,5738,93413,9,329748
9551,0.000944,74.125.130.0-255,4320,97733,9,329748
9552,0.000956,172.31.36.0-255,66,97799,9,329748
9553,0.000958,74.125.130.0-255,2543,100342,9,329748
9554,0.000971,172.31.36.0-255,66,100408,9,329748
9555,0.00148,74.125.130.0-255,1484,101892,9,329748
9556,0.001491,74.125.130.0-255,2902,104794,9,329748
9557,0.001495,172.31.36.0-255,66,104860,9,329748
9558,0.001501,74.125.130.0-255,2902,107762,9,329748
9559,0.001526,74.125.130.0-255,4320,112082,9,329748
9560,0.00154,74.125.130.0-255,1484,113566,9,329748
9561,0.001557,74.125.130.0-255,7156,120722,9,329748
9562,0.00156,74.125.130.0-255,1484,122206,9,329748
9563,0.001579,74.125.130.0-255,5738,127944,9,329748
9564,0.001603,74.125.130.0-255,6438,134382,9,329748
9565,0.001624,74.125.130.0-255,1484,135866,9,329748
9566,0.001637,74.125.130.0-255,1484,137350,9,329748
9567,0.001675,74.125.130.0-255,1484,138834,9,329748
9568,0.001682,74.125.130.0-255,5738,144572,9,329748
9569,0.001686,74.125.130.0-255,2902,147474,9,329748
9570,0.00169,74.125.130.0-255,4320,151794,9,329748
9571,0.001701,74.125.130.0-255,1484,153278,9,329748
9572,0.001727,74.125.130.0-255,6438,159716,9,329748
9573,0.001826,74.125.130.0-255,1484,161200,9,329748
9574,0.001832,74.125.130.0-255,2902,164102,9,329748
9575,0.001847,74.125.130.0-255,2902,167004,9,329748
9576,0.001868,74.125.130.0-255,2902,169906,9,329748
9577,0.001873,74.125.130.0-255,2902,172808,9,329748
9578,0.001875,74.125.130.0-255,1484,174292,9,329748
9579,0.001895,74.125.130.0-255,2902,177194,9,329748
9580,0.001899,74.125.130.0-255,1484,178678,9,329748
9581,0.001914,74.125.130.0-255,4320,182998,9,329748
9582,0.001935,74.125.130.0-255,2902,185900,9,329748
9583,0.002,74.125.130.0-255,1484,187384,9,329748
9584,0.002008,74.125.130.0-255,2902,190286,9,329748
9585,0.002027,74.125.130.0-255,1484,191770,9,329748
9586,0.002043,74.125.130.0-255,4320,196090,9,329748
9587,0.002049,74.125.130.0-255,4320,200410,9,329748
9588,0.002053,74.125.130.0-255,4320,204730,9,329748
9589,0.002072,74.125.130.0-255,1484,206214,9,329748
9590,0.002084,74.125.130.0-255,2184,208398,9,329748
9591,0.006486,172.31.36.0-255,66,208464,9,329748
9592,0.008567,74.125.130.0-255,5738,214202,9,329748
9593,0.008579,172.31.36.0-255,66,214268,9,329748
9594,0.010645,74.125.130.0-255,5738,220006,9,329748
9595,0.010658,172.31.36.0-255,66,220072,9,329748
9596,0.012735,74.125.130.0-255,5738,225810,9,329748
9597,0.012749,172.31.36.0-255,66,225876,9,329748
9598,0.014816,74.125.130.0-255,5738,231614,9,329748
9599,0.014837,172.31.36.0-255,66,231680,9,329748
9600,0.016902,74.125.130.0-255,5738,237418,9,329748
9601,0.017797,172.31.36.0-255,66,237484,9,329748
9602,0.019859,74.125.130.0-255,5738,243222,9,329748
9603,0.019879,172.31.36.0-255,66,243288,9,329748
9604,0.021934,74.125.130.0-255,5738,249026,9,329748
9605,0.022072,172.31.36.0-255,66,249092,9,329748
9606,0.024141,74.125.130.0-255,5738,254830,9,329748
9607,0.024156,172.31.36.0-255,66,254896,9,329748
9608,0.02622,74.125.130.0-255,5738,260634,9,329748
9609,0.032534,74.125.130.0-255,1484,262118,9,329748
9610,0.033774,172.31.36.0-255,66,262184,9,329748
9611,0.035825,74.125.130.0-255,5738,267922,9,329748
9612,0.035841,172.31.36.0-255,66,267988,9,329748
9613,0.037875,74.125.130.0-255,4320,272308,9,329748
9614,0.037884,172.31.36.0-255,66,272374,9,329748
9615,0.037909,74.125.130.0-255,1484,273858,9,329748
9616,0.037955,172.31.36.0-255,176,274034,9,329748
9617,0.037982,172.31.36.0-255,1070,275104,9,329748
9618,0.039484,104.244.42.0-255,66,275170,9,329748
9619,0.039541,104.244.42.0-255,66,275236,9,329748
9620,0.039915,74.125.130.0-255,4320,279556,9,329748
9621,0.039926,172.31.36.0-255,66,279622,9,329748
9622,0.041973,74.125.130.0-255,5738,285360,9,329748
9623,0.042051,172.31.36.0-255,66,285426,9,329748
9624,0.044092,74.125.130.0-255,5738,291164,9,329748
9625,0.0441,172.31.36.0-255,66,291230,9,329748
9626,0.046148,74.125.130.0-255,2902,294132,9,329748
9627,0.046155,172.31.36.0-255,66,294198,9,329748
9628,0.046189,74.125.130.0-255,2902,297100,9,329748
9629,0.046212,172.31.36.0-255,66,297166,9,329748
9630,0.048183,74.125.130.0-255,2902,300068,9,329748
9631,0.048189,172.31.36.0-255,66,300134,9,329748
9632,0.048239,74.125.130.0-255,2902,303036,9,329748
9633,0.048249,172.31.36.0-255,66,303102,9,329748
9634,0.050216,74.125.130.0-255,2902,306004,9,329748
9635,0.050221,172.31.36.0-255,66,306070,9,329748
9636,0.05027,74.125.130.0-255,2902,308972,9,329748
9637,0.0503,172.31.36.0-255,66,309038,9,329748
9638,0.052261,74.125.130.0-255,2902,311940,9,329748
9639,0.052267,172.31.36.0-255,66,312006,9,329748
9640,0.052319,74.125.130.0-255,2902,314908,9,329748
9641,0.052348,172.31.36.0-255,66,314974,9,329748
9642,0.05431,74.125.130.0-255,2902,317876,9,329748
9643,0.054316,172.31.36.0-255,66,317942,9,329748
9644,0.054394,74.125.130.0-255,2902,320844,9,329748
9645,0.054402,172.31.36.0-255,66,320910,9,329748
9646,0.056362,74.125.130.0-255,2902,323812,9,329748
9647,0.056373,172.31.36.0-255,66,323878,9,329748
9648,0.056447,74.125.130.0-255,2902,326780,9,329748
9649,0.058465,74.125.130.0-255,2902,329682,9,329748
9650,0.058641,172.31.36.0-255,66,329748,9,329748
9651,0.0,74.125.130.0-255,145,145,9,349102
9652,2.7e-05,172.31.36.0-255,66,211,9,349102
9653,3.5e-05,74.125.130.0-255,1484,1695,9,349102
9654,3.9e-05,172.31.36.0-255,66,1761,9,349102
9655,4.5e-05,74.125.130.0-255,2902,4663,9,349102
9656,4.8e-05,172.31.36.0-255,66,4729,9,349102
9657,5.3e-05,74.125.130.0-255,4320,9049,9,349102
9658,5.6e-05,172.31.36.0-255,66,9115,9,349102
9659,7.2e-05,74.125.130.0-255,1484,10599,9,349102
9660,7.4e-05,172.31.36.0-255,66,10665,9,349102
9661,0.000107,74.125.130.0-255,3489,14154,9,349102
9662,0.00011,172.31.36.0-255,66,14220,9,349102
9663,0.000178,74.125.130.0-255,1484,15704,9,349102
9664,0.000182,172.31.36.0-255,66,15770,9,349102
9665,0.000188,74.125.130.0-255,2902,18672,9,349102
9666,0.00019,172.31.36.0-255,66,18738,9,349102
9667,0.000214,74.125.130.0-255,4320,23058,9,349102
9668,0.000218,172.31.36.0-255,66,23124,9,349102
9669,0.000224,74.125.130.0-255,4320,27444,9,349102
9670,0.000227,172.31.36.0-255,66,27510,9,349102
9671,0.00024,74.125.130.0-255,1484,28994,9,349102
9672,0.000242,172.31.36.0-255,66,29060,9,349102
9673,0.000247,74.125.130.0-255,2543,31603,9,349102
9674,0.000249,172.31.36.0-255,66,31669,9,349102
9675,0.000272,74.125.130.0-255,2902,34571,9,349102
9676,0.000275,172.31.36.0-255,66,34637,9,349102
9677,0.000291,74.125.130.0-255,5738,40375,9,349102
9678,0.000295,172.31.36.0-255,66,40441,9,349102
9679,0.000309,74.125.130.0-255,1484,41925,9,349102
9680,0.000312,172.31.36.0-255,66,41991,9,349102
9681,0.000317,74.125.130.0-255,4320,46311,9,349102
9682,0.00032,172.31.36.0-255,66,46377,9,349102
9683,0.000355,74.125.130.0-255,2543,48920,9,349102
9684,0.000361,172.31.36.0-255,66,48986,9,349102
9685,0.000943,74.125.130.0-255,1484,50470,9,349102
9686,0.000954,74.125.130.0-255,2902,53372,9,349102
9687,0.000958,172.31.36.0-255,66,53438,9,349102
9688,0.000978,74.125.130.0-255,4320,57758,9,349102
9689,0.00098,172.31.36.0-255,66,57824,9,349102
9690,0.001004,74.125.130.0-255,5738,63562,9,349102
9691,0.001007,172.31.36.0-255,66,63628,9,349102
9692,0.001027,74.125.130.0-255,3961,67589,9,349102
9693,0.001029,172.31.36.0-255,66,67655,9,349102
9694,0.001034,74.125.130.0-255,2902,70557,9,349102
9695,0.001035,172.31.36.0-255,66,70623,9,349102
9696,0.001061,74.125.130.0-255,7156,77779,9,349102
9697,0.001063,172.31.36.0-255,66,77845,9,349102
9698,0.00107,74.125.130.0-255,5379,83224,9,349102
9699,0.001071,172.31.36.0-255,66,83290,9,349102
9700,0.001141,74.125.130.0-255,1484,84774,9,349102
9701,0.001157,74.125.130.0-255,1484,86258,9,349102
9702,0.00116,172.31.36.0-255,66,86324,9,349102
9703,0.001165,74.125.130.0-255,2902,89226,9,349102
9704,0.001167,172.31.36.0-255,66,89292,9,349102
9705,0.001196,74.125.130.0-255,5738,95030,9,349102
9706,0.001199,172.31.36.0-255,66,95096,9,349102
9707,0.00122,74.125.130.0-255,5379,100475,9,349102
9708,0.001247,74.125.130.0-255,646,101121,9,349102
9709,0.001484,74.125.130.0-255,1484,102605,9,349102
9710,0.001522,74.125.130.0-255,2902,105507,9,349102
9711,0.001539,74.125.130.0-255,4320,109827,9,349102
9712,0.001563,74.125.130.0-255,4320,114147,9,349102
9713,0.001577,74.125.130.0-255,4320,118467,9,349102
9714,0.001594,74.125.130.0-255,5738,124205,9,349102
9715,0.001608,74.125.130.0-255,4320,128525,9,349102
9716,0.001613,74.125.130.0-255,4320,132845,9,349102
9717,0.001627,74.125.130.0-255,2184,135029,9,349102
9718,0.001751,74.125.130.0-255,1484,136513,9,349102
9719,0.001767,74.125.130.0-255,2902,139415,9,349102
9720,0.00179,74.125.130.0-255,1484,140899,9,349102
9721,0.001809,74.125.130.0-255,4320,145219,9,349102
9722,0.001815,74.125.130.0-255,4320,149539,9,349102
9723,0.00183,74.125.130.0-255,2902,152441,9,349102
9724,0.001836,74.125.130.0-255,5738,158179,9,349102
9725,0.001852,74.125.130.0-255,2902,161081,9,349102
9726,0.001864,74.125.130.0-255,4320,165401,9,349102
9727,0.001881,74.125.130.0-255,3602,169003,9,349102
9728,0.002005,74.125.130.0-255,1484,170487,9,349102
9729,0.002059,74.125.130.0-255,1484,171971,9,349102
9730,0.002063,74.125.130.0-255,2902,174873,9,349102
9731,0.002069,74.125.130.0-255,5738,180611,9,349102
9732,0.002076,74.125.130.0-255,7156,187767,9,349102
9733,0.002095,74.125.130.0-255,5738,193505,9,349102
9734,0.002113,74.125.130.0-255,2902,196407,9,349102
9735,0.002117,74.125.130.0-255,2902,199309,9,349102
9736,0.002137,74.125.130.0-255,3602,202911,9,349102
9737,0.002692,172.31.36.0-255,66,202977,9,349102
9738,0.004974,74.125.130.0-255,5738,208715,9,349102
9739,0.00498,172.31.36.0-255,66,208781,9,349102
9740,0.007249,74.125.130.0-255,5738,214519,9,349102
9741,0.007255,172.31.36.0-255,66,214585,9,349102
9742,0.009525,74.125.130.0-255,5738,220323,9,349102
9743,0.009533,172.31.36.0-255,66,220389,9,349102
9744,0.011978,74.125.130.0-255,5738,226127,9,349102
9745,0.012042,172.31.36.0-255,66,226193,9,349102
9746,0.014335,74.125.130.0-255,5738,231931,9,349102
9747,0.014342,172.31.36.0-255,66,231997,9,349102
9748,0.016619,74.125.130.0-255,5738,237735,9,349102
9749,0.016629,172.31.36.0-255,66,237801,9,349102
9750,0.018908,74.125.130.0-255,5738,243539,9,349102
9751,0.018918,172.31.36.0-255,66,243605,9,349102
9752,0.021199,74.125.130.0-255,5738,249343,9,349102
9753,0.021208,172.31.36.0-255,66,249409,9,349102
9754,0.023509,74.125.130.0-255,5738,255147,9,349102
9755,0.023517,172.31.36.0-255,66,255213,9,349102
9756,0.025784,74.125.130.0-255,5738,260951,9,349102
9757,0.025793,172.31.36.0-255,66,261017,9,349102
9758,0.028065,74.125.130.0-255,5738,266755,9,349102
9759,0.028075,172.31.36.0-255,66,266821,9,349102
9760,0.030351,74.125.130.0-255,5738,272559,9,349102
9761,0.030361,172.31.36.0-255,66,272625,9,349102
9762,0.030535,172.31.36.0-255,101,272726,9,349102
9763,0.032639,74.125.130.0-255,5738,278464,9,349102
9764,0.032648,172.31.36.0-255,66,278530,9,349102
9765,0.032764,74.125.130.0-255,66,278596,9,349102
9766,0.034928,74.125.130.0-255,5738,284334,9,349102
9767,0.034936,172.31.36.0-255,66,284400,9,349102
9768,0.037225,74.125.130.0-255,5738,290138,9,349102
9769,0.037233,172.31.36.0-255,66,290204,9,349102
9770,0.039532,74.125.130.0-255,5738,295942,9,349102
9771,0.039557,172.31.36.0-255,66,296008,9,349102
9772,0.041841,74.125.130.0-255,5738,301746,9,349102
9773,0.04185,172.31.36.0-255,66,301812,9,349102
9774,0.044129,74.125.130.0-255,5738,307550,9,349102
9775,0.044137,172.31.36.0-255,66,307616,9,349102
9776,0.046407,74.125.130.0-255,5738,313354,9,349102
9777,0.046417,172.31.36.0-255,66,313420,9,349102
9778,0.04764,172.31.36.0-255,172,313592,9,349102
9779,0.047672,172.31.36.0-255,1117,314709,9,349102
9780,0.047726,172.31.36.0-255,1514,316223,9,349102
9781,0.047728,172.31.36.0-255,1514,317737,9,349102
9782,0.047729,172.31.36.0-255,1514,319251,9,349102
9783,0.04773,172.31.36.0-255,105,319356,9,349102
9784,0.048691,74.125.130.0-255,5738,325094,9,349102
9785,0.048698,172.31.36.0-255,66,325160,9,349102
9786,0.049302,104.244.42.0-255,66,325226,9,349102
9787,0.04931,104.244.42.0-255,66,325292,9,349102
9788,0.049339,104.244.42.0-255,66,325358,9,349102
9789,0.050955,74.125.130.0-255,2902,328260,9,349102
9790,0.050971,172.31.36.0-255,66,328326,9,349102
9791,0.051057,74.125.130.0-255,2902,331228,9,349102
9792,0.05106,172.31.36.0-255,66,331294,9,349102
9793,0.053241,74.125.130.0-255,2902,334196,9,349102
9794,0.053246,172.31.36.0-255,66,334262,9,349102
9795,0.053327,74.125.130.0-255,2902,337164,9,349102
9796,0.053332,172.31.36.0-255,66,337230,9,349102
9797,0.055527,74.125.130.0-255,2902,340132,9,349102
9798,0.055532,172.31.36.0-255,66,340198,9,349102
9799,0.055588,74.125.130.0-255,2902,343100,9,349102
9800,0.055592,172.31.36.0-255,66,343166,9,349102
9801,0.057828,74.125.130.0-255,2902,346068,9,349102
9802,0.057832,172.31.36.0-255,66,346134,9,349102
9803,0.057864,74.125.130.0-255,2902,349036,9,349102
9804,0.057867,172.31.36.0-255,66,349102,9,349102
9805,0.0,172.217.24.0-255,148,148,9,260568
9806,2.4e-05,172.31.36.0-255,66,214,9,260568
9807,3.1e-05,172.217.24.0-255,1484,1698,9,260568
9808,3.6e-05,172.31.36.0-255,66,1764,9,260568
9809,4.2e-05,172.217.24.0-255,2902,4666,9,260568
9810,4.4e-05,172.31.36.0-255,66,4732,9,260568
9811,6.2e-05,172.217.24.0-255,7156,11888,9,260568
9812,6.5e-05,172.31.36.0-255,66,11954,9,260568
9813,7e-05,172.217.24.0-255,2036,13990,9,260568
9814,7.3e-05,172.31.36.0-255,66,14056,9,260568
9815,9.3e-05,172.217.24.0-255,2902,16958,9,260568
9816,0.0001,172.31.36.0-255,66,17024,9,260568
9817,0.000105,172.217.24.0-255,2902,19926,9,260568
9818,0.000107,172.31.36.0-255,66,19992,9,260568
9819,0.00015,172.217.24.0-255,1484,21476,9,260568
9820,0.000153,172.31.36.0-255,66,21542,9,260568
9821,0.000164,172.31.36.0-255,66,21608,9,260568
9822,0.000168,172.217.24.0-255,1125,22733,9,260568
9823,0.00017,172.31.36.0-255,66,22799,9,260568
9824,0.000332,172.217.24.0-255,1484,24283,9,260568
9825,0.000337,172.31.36.0-255,66,24349,9,260568
9826,0.000343,172.217.24.0-255,2902,27251,9,260568
9827,0.000345,172.31.36.0-255,66,27317,9,260568
9828,0.000354,172.217.24.0-255,2902,30219,9,260568
9829,0.000357,172.31.36.0-255,66,30285,9,260568
9830,0.000362,172.217.24.0-255,4320,34605,9,260568
9831,0.000365,172.31.36.0-255,66,34671,9,260568
9832,0.000403,172.217.24.0-255,1484,36155,9,260568
9833,0.000405,172.31.36.0-255,66,36221,9,260568
9834,0.000443,172.217.24.0-255,3961,40182,9,260568
9835,0.000446,172.31.36.0-255,66,40248,9,260568
9836,0.00058,172.217.24.0-255,1484,41732,9,260568
9837,0.000588,172.217.24.0-255,2902,44634,9,260568
9838,0.000591,172.31.36.0-255,66,44700,9,260568
9839,0.000597,172.217.24.0-255,4320,49020,9,260568
9840,0.000599,172.31.36.0-255,66,49086,9,260568
9841,0.000625,172.217.24.0-255,1484,50570,9,260568
9842,0.000632,172.217.24.0-255,6797,57367,9,260568
9843,0.000635,172.31.36.0-255,66,57433,9,260568
9844,0.000638,172.217.24.0-255,399,57832,9,260568
9845,0.001181,172.31.36.0-255,66,57898,9,260568
9846,0.00156,172.217.24.0-255,116,58014,9,260568
9847,0.001678,172.217.24.0-255,1484,59498,9,260568
9848,0.001683,172.31.36.0-255,66,59564,9,260568
9849,0.00169,172.217.24.0-255,2902,62466,9,260568
9850,0.001692,172.31.36.0-255,66,62532,9,260568
9851,0.001703,172.217.24.0-255,5738,68270,9,260568
9852,0.001705,172.31.36.0-255,66,68336,9,260568
9853,0.001736,172.217.24.0-255,6797,75133,9,260568
9854,0.001738,172.31.36.0-255,66,75199,9,260568
9855,0.001746,172.217.24.0-255,7156,82355,9,260568
9856,0.001748,172.31.36.0-255,66,82421,9,260568
9857,0.001772,172.217.24.0-255,4320,86741,9,260568
9858,0.001774,172.31.36.0-255,66,86807,9,260568
9859,0.001799,172.217.24.0-255,5379,92186,9,260568
9860,0.001802,172.31.36.0-255,66,92252,9,260568
9861,0.003782,172.217.24.0-255,5738,97990,9,260568
9862,0.003791,172.31.36.0-255,66,98056,9,260568
9863,0.005769,172.217.24.0-255,5738,103794,9,260568
9864,0.005772,172.31.36.0-255,66,103860,9,260568
9865,0.007739,172.217.24.0-255,5738,109598,9,260568
9866,0.007747,172.31.36.0-255,66,109664,9,260568
9867,0.00973,172.217.24.0-255,5738,115402,9,260568
9868,0.009742,172.31.36.0-255,66,115468,9,260568
9869,0.01173,172.217.24.0-255,5738,121206,9,260568
9870,0.011741,172.31.36.0-255,66,121272,9,260568
9871,0.013726,172.217.24.0-255,5738,127010,9,260568
9872,0.013737,172.31.36.0-255,66,127076,9,260568
9873,0.015724,172.217.24.0-255,5738,132814,9,260568
9874,0.015733,172.31.36.0-255,66,132880,9,260568
9875,0.017749,172.217.24.0-255,5738,138618,9,260568
9876,0.017757,172.31.36.0-255,66,138684,9,260568
9877,0.019761,172.217.24.0-255,5738,144422,9,260568
9878,0.01977,172.31.36.0-255,66,144488,9,260568
9879,0.021748,172.217.24.0-255,5738,150226,9,260568
9880,0.021755,172.31.36.0-255,66,150292,9,260568
9881,0.02373,172.217.24.0-255,5738,156030,9,260568
9882,0.023737,172.31.36.0-255,66,156096,9,260568
9883,0.02571,172.217.24.0-255,5738,161834,9,260568
9884,0.025717,172.31.36.0-255,66,161900,9,260568
9885,0.027692,172.217.24.0-255,5738,167638,9,260568
9886,0.027702,172.31.36.0-255,66,167704,9,260568
9887,0.029693,172.217.24.0-255,5738,173442,9,260568
9888,0.029704,172.31.36.0-255,66,173508,9,260568
9889,0.031682,172.217.24.0-255,5738,179246,9,260568
9890,0.031692,172.31.36.0-255,66,179312,9,260568
9891,0.033696,172.217.24.0-255,5738,185050,9,260568
9892,0.033707,172.31.36.0-255,66,185116,9,260568
9893,0.035688,172.217.24.0-255,5738,190854,9,260568
9894,0.035697,172.31.36.0-255,66,190920,9,260568
9895,0.037677,172.217.24.0-255,5738,196658,9,260568
9896,0.037687,172.31.36.0-255,66,196724,9,260568
9897,0.039668,172.217.24.0-255,5738,202462,9,260568
9898,0.039686,172.31.36.0-255,66,202528,9,260568
9899,0.041671,172.217.24.0-255,5738,208266,9,260568
9900,0.041683,172.31.36.0-255,66,208332,9,260568
9901,0.043661,172.217.24.0-255,5738,214070,9,260568
9902,0.04367,172.31.36.0-255,66,214136,9,260568
9903,0.045644,172.217.24.0-255,5738,219874,9,260568
9904,0.045653,172.31.36.0-255,66,219940,9,260568
9905,0.047642,172.217.24.0-255,5738,225678,9,260568
9906,0.047651,172.31.36.0-255,66,225744,9,260568
9907,0.049669,172.217.24.0-255,5738,231482,9,260568
9908,0.049679,172.31.36.0-255,66,231548,9,260568
9909,0.051652,172.217.24.0-255,5738,237286,9,260568
9910,0.051661,172.31.36.0-255,66,237352,9,260568
9911,0.053638,172.217.24.0-255,5738,243090,9,260568
9912,0.053651,172.31.36.0-255,66,243156,9,260568
9913,0.055641,172.217.24.0-255,5738,248894,9,260568
9914,0.055654,172.31.36.0-255,66,248960,9,260568
9915,0.057652,172.217.24.0-255,5738,254698,9,260568
9916,0.057671,172.31.36.0-255,66,254764,9,260568
9917,0.05966,172.217.24.0-255,5738,260502,9,260568
9918,0.05968,172.31.36.0-255,66,260568,9,260568
9919,0.0,172.31.36.0-255,105,105,9,105
9920,0.0,74.125.68.0-255,220,220,9,314195
9921,1.9e-05,74.125.68.0-255,1484,1704,9,314195
9922,3e-05,172.31.36.0-255,66,1770,9,314195
9923,3.9e-05,74.125.68.0-255,2902,4672,9,314195
9924,4.3e-05,172.31.36.0-255,66,4738,9,314195
9925,4.9e-05,74.125.68.0-255,4320,9058,9,314195
9926,6.1e-05,172.31.36.0-255,66,9124,9,314195
9927,6.4e-05,74.125.68.0-255,1484,10608,9,314195
9928,9.7e-05,172.31.36.0-255,66,10674,9,314195
9929,0.0001,74.125.68.0-255,1484,12158,9,314195
9930,0.000134,172.31.36.0-255,66,12224,9,314195
9931,0.000159,74.125.68.0-255,2543,14767,9,314195
9932,0.000162,172.31.36.0-255,66,14833,9,314195
9933,0.000264,74.125.68.0-255,1484,16317,9,314195
9934,0.000269,74.125.68.0-255,1484,17801,9,314195
9935,0.000272,172.31.36.0-255,66,17867,9,314195
9936,0.000276,74.125.68.0-255,1484,19351,9,314195
9937,0.000314,74.125.68.0-255,1484,20835,9,314195
9938,0.000317,172.31.36.0-255,66,20901,9,314195
9939,0.000324,74.125.68.0-255,5738,26639,9,314195
9940,0.000327,172.31.36.0-255,66,26705,9,314195
9941,0.000338,74.125.68.0-255,5379,32084,9,314195
9942,0.000341,172.31.36.0-255,66,32150,9,314195
9943,0.000347,74.125.68.0-255,5738,37888,9,314195
9944,0.000349,172.31.36.0-255,66,37954,9,314195
9945,0.000386,74.125.68.0-255,5738,43692,9,314195
9946,0.000389,172.31.36.0-255,66,43758,9,314195
9947,0.000417,74.125.68.0-255,5379,49137,9,314195
9948,0.00042,172.31.36.0-255,66,49203,9,314195
9949,0.000904,74.125.68.0-255,645,49848,9,314195
9950,0.001061,74.125.68.0-255,1484,51332,9,314195
9951,0.001066,172.31.36.0-255,66,51398,9,314195
9952,0.001072,74.125.68.0-255,2902,54300,9,314195
9953,0.001074,172.31.36.0-255,66,54366,9,314195
9954,0.001103,74.125.68.0-255,2902,57268,9,314195
9955,0.001106,172.31.36.0-255,66,57334,9,314195
9956,0.001111,74.125.68.0-255,4320,61654,9,314195
9957,0.001114,172.31.36.0-255,66,61720,9,314195
9958,0.00112,74.125.68.0-255,4320,66040,9,314195
9959,0.001126,172.31.36.0-255,66,66106,9,314195
9960,0.001162,74.125.68.0-255,4320,70426,9,314195
9961,0.001165,172.31.36.0-255,66,70492,9,314195
9962,0.001168,74.125.68.0-255,1484,71976,9,314195
9963,0.001173,74.125.68.0-255,2902,74878,9,314195
9964,0.001175,172.31.36.0-255,66,74944,9,314195
9965,0.001187,74.125.68.0-255,5738,80682,9,314195
9966,0.001189,172.31.36.0-255,66,80748,9,314195
9967,0.001194,74.125.68.0-255,3602,84350,9,314195
9968,0.001197,172.31.36.0-255,66,84416,9,314195
9969,0.002785,74.125.68.0-255,1484,85900,9,314195
9970,0.002796,74.125.68.0-255,2902,88802,9,314195
9971,0.002802,172.31.36.0-255,66,88868,9,314195
9972,0.002807,74.125.68.0-255,1484,90352,9,314195
9973,0.00281,74.125.68.0-255,1484,91836,9,314195
9974,0.002812,172.31.36.0-255,66,91902,9,314195
9975,0.00283,74.125.68.0-255,1484,93386,9,314195
9976,0.002838,74.125.68.0-255,1484,94870,9,314195
9977,0.00284,172.31.36.0-255,66,94936,9,314195
9978,0.002844,74.125.68.0-255,1484,96420,9,314195
9979,0.002846,74.125.68.0-255,1484,97904,9,314195
9980,0.002848,172.31.36.0-255,66,97970,9,314195
9981,0.002852,74.125.68.0-255,1484,99454,9,314195
9982,0.002854,74.125.68.0-255,1484,100938,9,314195
9983,0.002856,172.31.36.0-255,66,101004,9,314195
9984,0.00286,74.125.68.0-255,1484,102488,9,314195
9985,0.002895,74.125.68.0-255,4320,106808,9,314195
9986,0.002897,172.31.36.0-255,66,106874,9,314195
9987,0.0029,74.125.68.0-255,1484,108358,9,314195
9988,0.002927,74.125.68.0-255,4320,112678,9,314195
9989,0.002929,172.31.36.0-255,66,112744,9,314195
9990,0.002932,74.125.68.0-255,1484,114228,9,314195
9991,0.002936,74.125.68.0-255,2902,117130,9,314195
9992,0.002938,172.31.36.0-255,66,117196,9,314195
9993,0.002967,74.125.68.0-255,2184,119380,9,314195
9994,0.00297,172.31.36.0-255,66,119446,9,314195
9995,0.003301,74.125.68.0-255,1484,120930,9,314195
9996,0.003305,74.125.68.0-255,1484,122414,9,314195
9997,0.003307,172.31.36.0-255,66,122480,9,314195
9998,0.003333,74.125.68.0-255,2902,125382,9,314195
9999,0.003335,172.31.36.0-255,66,125448,9,314195
10000,0.003361,74.125.68.0-255,4320,129768,9,314195
10001,0.003364,172.31.36.0-255,66,129834,9,314195
10002,0.003393,74.125.68.0-255,5738,135572,9,314195
10003,0.003395,172.31.36.0-255,66,135638,9,314195
10004,0.003422,74.125.68.0-255,7156,142794,9,314195
10005,0.003425,172.31.36.0-255,66,142860,9,314195
10006,0.003452,74.125.68.0-255,4320,147180,9,314195
10007,0.003454,172.31.36.0-255,66,147246,9,314195
10008,0.003461,74.125.68.0-255,6438,153684,9,314195
10009,0.003465,172.31.36.0-255,66,153750,9,314195
10010,0.003503,172.31.36.0-255,66,153816,9,314195
10011,0.003506,74.125.68.0-255,1484,155300,9,314195
10012,0.003544,172.31.36.0-255,66,155366,9,314195
10013,0.003551,74.125.68.0-255,5738,161104,9,314195
10014,0.003553,172.31.36.0-255,66,161170,9,314195
10015,0.00356,74.125.68.0-255,766,161936,9,314195
10016,0.003598,74.125.68.0-255,1484,163420,9,314195
10017,0.003601,172.31.36.0-255,66,163486,9,314195
10018,0.003631,74.125.68.0-255,4320,167806,9,314195
10019,0.003633,172.31.36.0-255,66,167872,9,314195
10020,0.003636,74.125.68.0-255,1484,169356,9,314195
10021,0.003639,74.125.68.0-255,1484,170840,9,314195
10022,0.003641,172.31.36.0-255,66,170906,9,314195
10023,0.003646,74.125.68.0-255,2902,173808,9,314195
10024,0.003653,172.31.36.0-255,66,173874,9,314195
10025,0.003656,74.125.68.0-255,1484,175358,9,314195
10026,0.00369,74.125.68.0-255,4320,179678,9,314195
10027,0.003692,172.31.36.0-255,66,179744,9,314195
10028,0.003696,74.125.68.0-255,2902,182646,9,314195
10029,0.003699,172.31.36.0-255,66,182712,9,314195
10030,0.003702,74.125.68.0-255,1484,184196,9,314195
10031,0.003736,74.125.68.0-255,5738,189934,9,314195
10032,0.003739,172.31.36.0-255,66,190000,9,314195
10033,0.003744,74.125.68.0-255,4320,194320,9,314195
10034,0.003746,172.31.36.0-255,66,194386,9,314195
10035,0.003778,74.125.68.0-255,2184,196570,9,314195
10036,0.00378,172.31.36.0-255,66,196636,9,314195
10037,0.003935,74.125.68.0-255,1484,198120,9,314195
10038,0.003958,74.125.68.0-255,2902,201022,9,314195
10039,0.00396,172.31.36.0-255,66,201088,9,314195
10040,0.003991,74.125.68.0-255,5738,206826,9,314195
10041,0.003993,172.31.36.0-255,66,206892,9,314195
10042,0.003996,74.125.68.0-255,1484,208376,9,314195
10043,0.004025,74.125.68.0-255,5738,214114,9,314195
10044,0.004028,172.31.36.0-255,66,214180,9,314195
10045,0.004033,74.125.68.0-255,2902,217082,9,314195
10046,0.004036,172.31.36.0-255,66,217148,9,314195
10047,0.004075,172.31.36.0-255,66,217214,9,314195
10048,0.004079,74.125.68.0-255,2902,220116,9,314195
10049,0.004081,172.31.36.0-255,66,220182,9,314195
10050,0.004101,74.125.68.0-255,5020,225202,9,314195
10051,0.004104,172.31.36.0-255,66,225268,9,314195
10052,0.00412,172.31.36.0-255,66,225334,9,314195
10053,0.004192,74.125.68.0-255,5738,231072,9,314195
10054,0.004195,172.31.36.0-255,66,231138,9,314195
10055,0.004202,74.125.68.0-255,7156,238294,9,314195
10056,0.004204,172.31.36.0-255,66,238360,9,314195
10057,0.004216,74.125.68.0-255,6438,244798,9,314195
10058,0.004219,172.31.36.0-255,66,244864,9,314195
10059,0.004308,74.125.68.0-255,1484,246348,9,314195
10060,0.004314,74.125.68.0-255,2902,249250,9,314195
10061,0.004317,172.31.36.0-255,66,249316,9,314195
10062,0.004325,74.125.68.0-255,5738,255054,9,314195
10063,0.004328,172.31.36.0-255,66,255120,9,314195
10064,0.004336,74.125.68.0-255,2902,258022,9,314195
10065,0.004338,172.31.36.0-255,66,258088,9,314195
10066,0.004361,74.125.68.0-255,2902,260990,9,314195
10067,0.004364,172.31.36.0-255,66,261056,9,314195
10068,0.004393,74.125.68.0-255,7156,268212,9,314195
10069,0.004396,172.31.36.0-255,66,268278,9,314195
10070,0.004413,172.31.36.0-255,66,268344,9,314195
10071,0.004438,74.125.68.0-255,1484,269828,9,314195
10072,0.004462,74.125.68.0-255,5020,274848,9,314195
10073,0.004465,172.31.36.0-255,66,274914,9,314195
10074,0.004472,74.125.68.0-255,7156,282070,9,314195
10075,0.004475,172.31.36.0-255,66,282136,9,314195
10076,0.004511,172.31.36.0-255,66,282202,9,314195
10077,0.004539,74.125.68.0-255,5738,287940,9,314195
10078,0.004542,172.31.36.0-255,66,288006,9,314195
10079,0.004575,74.125.68.0-255,6438,294444,9,314195
10080,0.004578,172.31.36.0-255,66,294510,9,314195
10081,0.004583,74.125.68.0-255,4320,298830,9,314195
10082,0.004586,172.31.36.0-255,66,298896,9,314195
10083,0.004639,172.31.36.0-255,66,298962,9,314195
10084,0.004676,172.31.36.0-255,66,299028,9,314195
10085,0.004699,74.125.68.0-255,766,299794,9,314195
10086,0.004706,74.125.68.0-255,4320,304114,9,314195
10087,0.004708,172.31.36.0-255,66,304180,9,314195
10088,0.004739,74.125.68.0-255,3299,307479,9,314195
10089,0.004742,172.31.36.0-255,66,307545,9,314195
10090,0.004746,74.125.68.0-255,105,307650,9,314195
10091,0.012096,172.31.36.0-255,105,307755,9,314195
10092,0.014601,74.125.68.0-255,66,307821,9,314195
10093,0.042055,172.31.36.0-255,172,307993,9,314195
10094,0.042088,172.31.36.0-255,1115,309108,9,314195
10095,0.042169,172.31.36.0-255,1514,310622,9,314195
10096,0.042171,172.31.36.0-255,1514,312136,9,314195
10097,0.042176,172.31.36.0-255,1514,313650,9,314195
10098,0.042177,172.31.36.0-255,107,313757,9,314195
10099,0.043595,104.244.42.0-255,66,313823,9,314195
10100,0.043634,104.244.42.0-255,66,313889,9,314195
10101,0.043734,104.244.42.0-255,66,313955,9,314195
10102,0.043741,104.244.42.0-255,66,314021,9,314195
10103,0.045461,104.244.42.0-255,108,314129,9,314195
10104,0.045473,172.31.36.0-255,66,314195,9,314195
10105,0.0,172.217.194.0-255,145,145,9,298492
10106,2.4e-05,172.31.36.0-255,66,211,9,298492
10107,3.2e-05,172.217.194.0-255,1484,1695,9,298492
10108,3.6e-05,172.31.36.0-255,66,1761,9,298492
10109,4.3e-05,172.217.194.0-255,2902,4663,9,298492
10110,4.7e-05,172.31.36.0-255,66,4729,9,298492
10111,5.3e-05,172.217.194.0-255,4320,9049,9,298492
10112,5.6e-05,172.31.36.0-255,66,9115,9,298492
10113,8.2e-05,172.217.194.0-255,4922,14037,9,298492
10114,8.5e-05,172.31.36.0-255,66,14103,9,298492
10115,9e-05,172.217.194.0-255,4320,18423,9,298492
10116,9.3e-05,172.31.36.0-255,66,18489,9,298492
10117,0.000108,172.217.194.0-255,1484,19973,9,298492
10118,0.00011,172.31.36.0-255,66,20039,9,298492
10119,0.000141,172.217.194.0-255,7156,27195,9,298492
10120,0.000143,172.31.36.0-255,66,27261,9,298492
10121,0.000167,172.217.194.0-255,2902,30163,9,298492
10122,0.000169,172.31.36.0-255,66,30229,9,298492
10123,0.000173,172.217.194.0-255,1125,31354,9,298492
10124,0.000175,172.31.36.0-255,66,31420,9,298492
10125,0.000179,172.217.194.0-255,1484,32904,9,298492
10126,0.00018,172.31.36.0-255,66,32970,9,298492
10127,0.000198,172.217.194.0-255,4320,37290,9,298492
10128,0.000201,172.31.36.0-255,66,37356,9,298492
10129,0.000228,172.31.36.0-255,66,37422,9,298492
10130,0.000252,172.217.194.0-255,1125,38547,9,298492
10131,0.000255,172.31.36.0-255,66,38613,9,298492
10132,0.000436,172.217.194.0-255,1484,40097,9,298492
10133,0.000441,172.31.36.0-255,66,40163,9,298492
10134,0.000448,172.217.194.0-255,2902,43065,9,298492
10135,0.00045,172.31.36.0-255,66,43131,9,298492
10136,0.000457,172.217.194.0-255,5738,48869,9,298492
10137,0.000459,172.31.36.0-255,66,48935,9,298492
10138,0.000462,172.217.194.0-255,1484,50419,9,298492
10139,0.000483,172.217.194.0-255,5379,55798,9,298492
10140,0.000488,172.31.36.0-255,66,55864,9,298492
10141,0.000523,172.217.194.0-255,5738,61602,9,298492
10142,0.000527,172.31.36.0-255,66,61668,9,298492
10143,0.000555,172.31.36.0-255,66,61734,9,298492
10144,0.000559,172.217.194.0-255,2543,64277,9,298492
10145,0.000561,172.31.36.0-255,66,64343,9,298492
10146,0.000729,172.217.194.0-255,1484,65827,9,298492
10147,0.000736,172.217.194.0-255,2902,68729,9,298492
10148,0.000739,172.31.36.0-255,66,68795,9,298492
10149,0.000746,172.217.194.0-255,5738,74533,9,298492
10150,0.000748,172.31.36.0-255,66,74599,9,298492
10151,0.000806,172.31.36.0-255,66,74665,9,298492
10152,0.000811,172.217.194.0-255,2902,77567,9,298492
10153,0.000813,172.31.36.0-255,66,77633,9,298492
10154,0.000828,172.217.194.0-255,5738,83371,9,298492
10155,0.000831,172.31.36.0-255,66,83437,9,298492
10156,0.000854,172.217.194.0-255,6683,90120,9,298492
10157,0.000858,172.31.36.0-255,66,90186,9,298492
10158,0.001215,172.217.194.0-255,211,90397,9,298492
10159,0.00148,172.217.194.0-255,1484,91881,9,298492
10160,0.001484,172.31.36.0-255,66,91947,9,298492
10161,0.001507,172.217.194.0-255,2902,94849,9,298492
10162,0.00151,172.31.36.0-255,66,94915,9,298492
10163,0.001516,172.217.194.0-255,5738,100653,9,298492
10164,0.001518,172.31.36.0-255,66,100719,9,298492
10165,0.00153,172.217.194.0-255,1484,102203,9,298492
10166,0.001557,172.31.36.0-255,66,102269,9,298492
10167,0.001569,172.31.36.0-255,66,102335,9,298492
10168,0.00159,172.217.194.0-255,766,103101,9,298492
10169,0.00192,172.31.36.0-255,66,103167,9,298492
10170,0.001942,172.217.194.0-255,1484,104651,9,298492
10171,0.001946,172.217.194.0-255,1484,106135,9,298492
10172,0.001949,172.31.36.0-255,66,106201,9,298492
10173,0.001967,172.217.194.0-255,1484,107685,9,298492
10174,0.001974,172.217.194.0-255,5738,113423,9,298492
10175,0.001976,172.31.36.0-255,66,113489,9,298492
10176,0.002006,172.217.194.0-255,1484,114973,9,298492
10177,0.002029,172.31.36.0-255,66,115039,9,298492
10178,0.002041,172.31.36.0-255,66,115105,9,298492
10179,0.002064,172.217.194.0-255,1484,116589,9,298492
10180,0.00208,172.217.194.0-255,4320,120909,9,298492
10181,0.002082,172.31.36.0-255,66,120975,9,298492
10182,0.00209,172.217.194.0-255,7156,128131,9,298492
10183,0.002092,172.31.36.0-255,66,128197,9,298492
10184,0.002129,172.31.36.0-255,66,128263,9,298492
10185,0.002136,172.217.194.0-255,6438,134701,9,298492
10186,0.002139,172.31.36.0-255,66,134767,9,298492
10187,0.002187,172.217.194.0-255,4320,139087,9,298492
10188,0.002192,172.31.36.0-255,66,139153,9,298492
10189,0.002222,172.217.194.0-255,2902,142055,9,298492
10190,0.002225,172.31.36.0-255,66,142121,9,298492
10191,0.002236,172.31.36.0-255,66,142187,9,298492
10192,0.002252,172.31.36.0-255,66,142253,9,298492
10193,0.002254,172.217.194.0-255,766,143019,9,298492
10194,0.002295,172.217.194.0-255,1484,144503,9,298492
10195,0.002299,172.31.36.0-255,66,144569,9,298492
10196,0.002304,172.217.194.0-255,2902,147471,9,298492
10197,0.002306,172.31.36.0-255,66,147537,9,298492
10198,0.002313,172.217.194.0-255,5738,153275,9,298492
10199,0.002315,172.31.36.0-255,66,153341,9,298492
10200,0.002353,172.31.36.0-255,66,153407,9,298492
10201,0.002359,172.217.194.0-255,5738,159145,9,298492
10202,0.002361,172.31.36.0-255,66,159211,9,298492
10203,0.004677,172.217.194.0-255,5738,164949,9,298492
10204,0.004696,172.31.36.0-255,66,165015,9,298492
10205,0.007006,172.217.194.0-255,5738,170753,9,298492
10206,0.007023,172.31.36.0-255,66,170819,9,298492
10207,0.009334,172.217.194.0-255,5738,176557,9,298492
10208,0.009346,172.31.36.0-255,66,176623,9,298492
10209,0.011637,172.217.194.0-255,5738,182361,9,298492
10210,0.011644,172.31.36.0-255,66,182427,9,298492
10211,0.013965,172.217.194.0-255,5738,188165,9,298492
10212,0.013973,172.31.36.0-255,66,188231,9,298492
10213,0.016282,172.217.194.0-255,5738,193969,9,298492
10214,0.016292,172.31.36.0-255,66,194035,9,298492
10215,0.018602,172.217.194.0-255,5738,199773,9,298492
10216,0.018609,172.31.36.0-255,66,199839,9,298492
10217,0.020944,172.217.194.0-255,5738,205577,9,298492
10218,0.020953,172.31.36.0-255,66,205643,9,298492
10219,0.02326,172.217.194.0-255,5738,211381,9,298492
10220,0.023267,172.31.36.0-255,66,211447,9,298492
10221,0.025582,172.217.194.0-255,5738,217185,9,298492
10222,0.02559,172.31.36.0-255,66,217251,9,298492
10223,0.027909,172.217.194.0-255,5738,222989,9,298492
10224,0.027917,172.31.36.0-255,66,223055,9,298492
10225,0.030276,172.217.194.0-255,5738,228793,9,298492
10226,0.030284,172.31.36.0-255,66,228859,9,298492
10227,0.032598,172.217.194.0-255,5738,234597,9,298492
10228,0.032606,172.31.36.0-255,66,234663,9,298492
10229,0.034869,172.31.36.0-255,176,234839,9,298492
10230,0.0349,172.217.194.0-255,5738,240577,9,298492
10231,0.034907,172.31.36.0-255,66,240643,9,298492
10232,0.034947,172.31.36.0-255,1070,241713,9,298492
10233,0.036402,104.244.42.0-255,66,241779,9,298492
10234,0.03649,104.244.42.0-255,66,241845,9,298492
10235,0.037219,172.217.194.0-255,5738,247583,9,298492
10236,0.037225,172.31.36.0-255,66,247649,9,298492
10237,0.03953,172.217.194.0-255,5738,253387,9,298492
10238,0.039536,172.31.36.0-255,66,253453,9,298492
10239,0.041852,172.217.194.0-255,5738,259191,9,298492
10240,0.041859,172.31.36.0-255,66,259257,9,298492
10241,0.044174,172.217.194.0-255,5738,264995,9,298492
10242,0.044184,172.31.36.0-255,66,265061,9,298492
10243,0.046509,172.217.194.0-255,5738,270799,9,298492
10244,0.046516,172.31.36.0-255,66,270865,9,298492
10245,0.048838,172.217.194.0-255,5738,276603,9,298492
10246,0.048844,172.31.36.0-255,66,276669,9,298492
10247,0.051155,172.217.194.0-255,5738,282407,9,298492
10248,0.051162,172.31.36.0-255,66,282473,9,298492
10249,0.053457,172.217.194.0-255,5738,288211,9,298492
10250,0.053476,172.31.36.0-255,66,288277,9,298492
10251,0.055797,172.217.194.0-255,5738,294015,9,298492
10252,0.055804,172.31.36.0-255,66,294081,9,298492
10253,0.05811,172.217.194.0-255,4240,298321,9,298492
10254,0.058117,172.31.36.0-255,66,298387,9,298492
10255,0.058306,172.31.36.0-255,105,298492,9,298492
10256,0.0,74.125.24.0-255,144,144,9,190538
10257,3.3e-05,74.125.24.0-255,1484,1628,9,190538
10258,4.6e-05,172.31.36.0-255,66,1694,9,190538
10259,5.3e-05,74.125.24.0-255,2902,4596,9,190538
10260,5.6e-05,74.125.24.0-255,1484,6080,9,190538
10261,7.5e-05,74.125.24.0-255,5738,11818,9,190538
10262,0.0001,172.31.36.0-255,66,11884,9,190538
10263,0.000107,172.31.36.0-255,66,11950,9,190538
10264,0.000141,74.125.24.0-255,1484,13434,9,190538
10265,0.000156,74.125.24.0-255,1125,14559,9,190538
10266,0.000205,74.125.24.0-255,1484,16043,9,190538
10267,0.00021,74.125.24.0-255,1484,17527,9,190538
10268,0.000241,74.125.24.0-255,4320,21847,9,190538
10269,0.000269,74.125.24.0-255,2902,24749,9,190538
10270,0.000292,74.125.24.0-255,6797,31546,9,190538
10271,0.000312,172.31.36.0-255,66,31612,9,190538
10272,0.000589,74.125.24.0-255,1484,33096,9,190538
10273,0.000594,74.125.24.0-255,1484,34580,9,190538
10274,0.000598,172.31.36.0-255,66,34646,9,190538
10275,0.000618,74.125.24.0-255,1484,36130,9,190538
10276,0.000625,74.125.24.0-255,5738,41868,9,190538
10277,0.00063,172.31.36.0-255,66,41934,9,190538
10278,0.000654,74.125.24.0-255,7156,49090,9,190538
10279,0.000664,172.31.36.0-255,66,49156,9,190538
10280,0.000672,74.125.24.0-255,5379,54535,9,190538
10281,0.000679,172.31.36.0-255,66,54601,9,190538
10282,0.000729,172.31.36.0-255,66,54667,9,190538
10283,0.000805,74.125.24.0-255,1484,56151,9,190538
10284,0.000823,74.125.24.0-255,2902,59053,9,190538
10285,0.000827,172.31.36.0-255,66,59119,9,190538
10286,0.000835,74.125.24.0-255,2902,62021,9,190538
10287,0.000841,172.31.36.0-255,66,62087,9,190538
10288,0.000857,74.125.24.0-255,2902,64989,9,190538
10289,0.000859,172.31.36.0-255,66,65055,9,190538
10290,0.000865,74.125.24.0-255,4320,69375,9,190538
10291,0.00087,172.31.36.0-255,66,69441,9,190538
10292,0.000883,74.125.24.0-255,1484,70925,9,190538
10293,0.000908,74.125.24.0-255,7156,78081,9,190538
10294,0.000912,172.31.36.0-255,66,78147,9,190538
10295,0.000924,74.125.24.0-255,2902,81049,9,190538
10296,0.000937,172.31.36.0-255,66,81115,9,190538
10297,0.001061,74.125.24.0-255,1484,82599,9,190538
10298,0.001081,74.125.24.0-255,2902,85501,9,190538
10299,0.001085,172.31.36.0-255,66,85567,9,190538
10300,0.001088,74.125.24.0-255,1484,87051,9,190538
10301,0.001103,74.125.24.0-255,4320,91371,9,190538
10302,0.001108,172.31.36.0-255,66,91437,9,190538
10303,0.001109,74.125.24.0-255,5738,97175,9,190538
10304,0.001112,172.31.36.0-255,66,97241,9,190538
10305,0.001135,74.125.24.0-255,1484,98725,9,190538
10306,0.00117,74.125.24.0-255,5738,104463,9,190538
10307,0.001178,172.31.36.0-255,66,104529,9,190538
10308,0.001197,74.125.24.0-255,5738,110267,9,190538
10309,0.001212,172.31.36.0-255,66,110333,9,190538
10310,0.001213,74.125.24.0-255,4320,114653,9,190538
10311,0.001216,172.31.36.0-255,66,114719,9,190538
10312,0.001234,74.125.24.0-255,5020,119739,9,190538
10313,0.001239,172.31.36.0-255,66,119805,9,190538
10314,0.001289,74.125.24.0-255,1484,121289,9,190538
10315,0.00131,74.125.24.0-255,2902,124191,9,190538
10316,0.001314,172.31.36.0-255,66,124257,9,190538
10317,0.001331,74.125.24.0-255,5738,129995,9,190538
10318,0.00134,172.31.36.0-255,66,130061,9,190538
10319,0.001375,172.31.36.0-255,66,130127,9,190538
10320,0.001381,74.125.24.0-255,4320,134447,9,190538
10321,0.001393,172.31.36.0-255,66,134513,9,190538
10322,0.001398,172.31.36.0-255,66,134579,9,190538
10323,0.001416,74.125.24.0-255,2184,136763,9,190538
10324,0.001421,172.31.36.0-255,66,136829,9,190538
10325,0.001562,74.125.24.0-255,1484,138313,9,190538
10326,0.001566,74.125.24.0-255,1484,139797,9,190538
10327,0.001569,172.31.36.0-255,66,139863,9,190538
10328,0.001588,74.125.24.0-255,1484,141347,9,190538
10329,0.001595,74.125.24.0-255,5738,147085,9,190538
10330,0.001598,74.125.24.0-255,1484,148569,9,190538
10331,0.001606,172.31.36.0-255,66,148635,9,190538
10332,0.001627,172.31.36.0-255,66,148701,9,190538
10333,0.001633,172.31.36.0-255,66,148767,9,190538
10334,0.001701,172.31.36.0-255,66,148833,9,190538
10335,0.001731,172.31.36.0-255,66,148899,9,190538
10336,0.001737,172.31.36.0-255,66,148965,9,190538
10337,0.001741,74.125.24.0-255,7156,156121,9,190538
10338,0.001749,172.31.36.0-255,66,156187,9,190538
10339,0.001777,74.125.24.0-255,4320,160507,9,190538
10340,0.001789,172.31.36.0-255,66,160573,9,190538
10341,0.001795,172.31.36.0-255,66,160639,9,190538
10342,0.001817,172.31.36.0-255,66,160705,9,190538
10343,0.001844,74.125.24.0-255,5738,166443,9,190538
10344,0.001844,172.31.36.0-255,66,166509,9,190538
10345,0.001848,172.31.36.0-255,66,166575,9,190538
10346,0.001866,74.125.24.0-255,1484,168059,9,190538
10347,0.00188,74.125.24.0-255,1484,169543,9,190538
10348,0.001892,172.31.36.0-255,66,169609,9,190538
10349,0.001931,172.31.36.0-255,66,169675,9,190538
10350,0.001936,172.31.36.0-255,66,169741,9,190538
10351,0.001956,74.125.24.0-255,2902,172643,9,190538
10352,0.001968,172.31.36.0-255,66,172709,9,190538
10353,0.001973,172.31.36.0-255,66,172775,9,190538
10354,0.001994,172.31.36.0-255,66,172841,9,190538
10355,0.001997,74.125.24.0-255,5738,178579,9,190538
10356,0.002007,172.31.36.0-255,66,178645,9,190538
10357,0.002044,172.31.36.0-255,66,178711,9,190538
10358,0.002049,172.31.36.0-255,66,178777,9,190538
10359,0.002073,74.125.24.0-255,1484,180261,9,190538
10360,0.002092,172.31.36.0-255,66,180327,9,190538
10361,0.002108,74.125.24.0-255,2456,182783,9,190538
10362,0.002112,74.125.24.0-255,105,182888,9,190538
10363,0.002118,172.31.36.0-255,66,182954,9,190538
10364,0.003803,172.31.36.0-255,105,183059,9,190538
10365,0.00634,74.125.24.0-255,66,183125,9,190538
10366,0.031018,172.31.36.0-255,172,183297,9,190538
10367,0.031049,172.31.36.0-255,1115,184412,9,190538
10368,0.03109,172.31.36.0-255,1514,185926,9,190538
10369,0.031092,172.31.36.0-255,1514,187440,9,190538
10370,0.031097,172.31.36.0-255,1514,188954,9,190538
10371,0.031098,172.31.36.0-255,1320,190274,9,190538
10372,0.03257,104.244.42.0-255,66,190340,9,190538
10373,0.032587,104.244.42.0-255,66,190406,9,190538
10374,0.032645,104.244.42.0-255,66,190472,9,190538
10375,0.032648,104.244.42.0-255,66,190538,9,190538
10376,0.0,74.125.200.0-255,152,152,9,192061
10377,3.4e-05,172.31.36.0-255,66,218,9,192061
10378,4.1e-05,74.125.200.0-255,1484,1702,9,192061
10379,4.5e-05,172.31.36.0-255,66,1768,9,192061
10380,5e-05,74.125.200.0-255,2902,4670,9,192061
10381,5.3e-05,172.31.36.0-255,66,4736,9,192061
10382,0.000119,74.125.200.0-255,5738,10474,9,192061
10383,0.000124,172.31.36.0-255,66,10540,9,192061
10384,0.000253,74.125.200.0-255,2902,13442,9,192061
10385,0.000257,172.31.36.0-255,66,13508,9,192061
10386,0.000309,74.125.200.0-255,603,14111,9,192061
10387,0.000314,172.31.36.0-255,66,14177,9,192061
10388,0.000341,74.125.200.0-255,1484,15661,9,192061
10389,0.000345,172.31.36.0-255,66,15727,9,192061
10390,0.000381,74.125.200.0-255,4320,20047,9,192061
10391,0.000385,172.31.36.0-255,66,20113,9,192061
10392,0.000495,74.125.200.0-255,5738,25851,9,192061
10393,0.0005,172.31.36.0-255,66,25917,9,192061
10394,0.000525,74.125.200.0-255,4320,30237,9,192061
10395,0.000529,172.31.36.0-255,66,30303,9,192061
10396,0.000737,74.125.200.0-255,1125,31428,9,192061
10397,0.000741,172.31.36.0-255,66,31494,9,192061
10398,0.000777,74.125.200.0-255,7156,38650,9,192061
10399,0.000781,172.31.36.0-255,66,38716,9,192061
10400,0.000976,172.31.36.0-255,66,38782,9,192061
10401,0.001288,74.125.200.0-255,7156,45938,9,192061
10402,0.001294,172.31.36.0-255,66,46004,9,192061
10403,0.001332,172.31.36.0-255,66,46070,9,192061
10404,0.001668,172.31.36.0-255,66,46136,9,192061
10405,0.001727,172.31.36.0-255,66,46202,9,192061
10406,0.0024,172.31.36.0-255,66,46268,9,192061
10407,0.003258,74.125.200.0-255,5738,52006,9,192061
10408,0.004942,172.31.36.0-255,66,52072,9,192061
10409,0.007219,74.125.200.0-255,5738,57810,9,192061
10410,0.00723,172.31.36.0-255,66,57876,9,192061
10411,0.009502,74.125.200.0-255,5738,63614,9,192061
10412,0.009509,172.31.36.0-255,66,63680,9,192061
10413,0.011788,74.125.200.0-255,5738,69418,9,192061
10414,0.011803,172.31.36.0-255,66,69484,9,192061
10415,0.014069,74.125.200.0-255,5738,75222,9,192061
10416,0.015761,172.31.36.0-255,66,75288,9,192061
10417,0.018022,74.125.200.0-255,5738,81026,9,192061
10418,0.018034,172.31.36.0-255,66,81092,9,192061
10419,0.020302,74.125.200.0-255,5738,86830,9,192061
10420,0.020309,172.31.36.0-255,66,86896,9,192061
10421,0.02259,74.125.200.0-255,5738,92634,9,192061
10422,0.022597,172.31.36.0-255,66,92700,9,192061
10423,0.024855,74.125.200.0-255,5738,98438,9,192061
10424,0.024861,172.31.36.0-255,66,98504,9,192061
10425,0.027122,74.125.200.0-255,5738,104242,9,192061
10426,0.027132,172.31.36.0-255,66,104308,9,192061
10427,0.029405,74.125.200.0-255,5738,110046,9,192061
10428,0.030221,172.31.36.0-255,66,110112,9,192061
10429,0.032501,74.125.200.0-255,5738,115850,9,192061
10430,0.032514,172.31.36.0-255,66,115916,9,192061
10431,0.033608,172.31.36.0-255,172,116088,9,192061
10432,0.033639,172.31.36.0-255,1112,117200,9,192061
10433,0.033749,172.31.36.0-255,1514,118714,9,192061
10434,0.033751,172.31.36.0-255,1514,120228,9,192061
10435,0.033753,172.31.36.0-255,1514,121742,9,192061
10436,0.033753,172.31.36.0-255,1514,123256,9,192061
10437,0.033784,172.31.36.0-255,1489,124745,9,192061
10438,0.03478,74.125.200.0-255,5738,130483,9,192061
10439,0.034787,172.31.36.0-255,66,130549,9,192061
10440,0.035168,104.244.42.0-255,66,130615,9,192061
10441,0.035218,104.244.42.0-255,66,130681,9,192061
10442,0.035365,104.244.42.0-255,66,130747,9,192061
10443,0.03596,104.244.42.0-255,108,130855,9,192061
10444,0.035983,172.31.36.0-255,66,130921,9,192061
10445,0.037082,74.125.200.0-255,4320,135241,9,192061
10446,0.037086,172.31.36.0-255,66,135307,9,192061
10447,0.037117,74.125.200.0-255,1484,136791,9,192061
10448,0.039356,74.125.200.0-255,4320,141111,9,192061
10449,0.039362,172.31.36.0-255,66,141177,9,192061
10450,0.041615,74.125.200.0-255,4320,145497,9,192061
10451,0.041621,172.31.36.0-255,66,145563,9,192061
10452,0.04167,74.125.200.0-255,1484,147047,9,192061
10453,0.043904,74.125.200.0-255,4320,151367,9,192061
10454,0.04391,172.31.36.0-255,66,151433,9,192061
10455,0.046178,74.125.200.0-255,5738,157171,9,192061
10456,0.04623,172.31.36.0-255,66,157237,9,192061
10457,0.048501,74.125.200.0-255,5738,162975,9,192061
10458,0.048511,172.31.36.0-255,66,163041,9,192061
10459,0.050782,74.125.200.0-255,5738,168779,9,192061
10460,0.050787,172.31.36.0-255,66,168845,9,192061
10461,0.053037,74.125.200.0-255,5738,174583,9,192061
10462,0.053043,172.31.36.0-255,66,174649,9,192061
10463,0.055299,74.125.200.0-255,5738,180387,9,192061
10464,0.055305,172.31.36.0-255,66,180453,9,192061
10465,0.057562,74.125.200.0-255,5738,186191,9,192061
10466,0.057567,172.31.36.0-255,66,186257,9,192061
10467,0.059828,74.125.200.0-255,5738,191995,9,192061
10468,0.059834,172.31.36.0-255,66,192061,9,192061
10469,0.0,74.125.24.0-255,66,66,9,66
10470,0.0,172.217.194.0-255,153,153,9,296854
10471,2.2e-05,172.31.36.0-255,66,219,9,296854
10472,2.9e-05,172.217.194.0-255,1484,1703,9,296854
10473,3.4e-05,172.31.36.0-255,66,1769,9,296854
10474,4e-05,172.217.194.0-255,2902,4671,9,296854
10475,5.1e-05,172.31.36.0-255,66,4737,9,296854
10476,6e-05,172.217.194.0-255,7156,11893,9,296854
10477,6.3e-05,172.31.36.0-255,66,11959,9,296854
10478,6.8e-05,172.217.194.0-255,2037,13996,9,296854
10479,7.1e-05,172.31.36.0-255,66,14062,9,296854
10480,0.000111,172.31.36.0-255,66,14128,9,296854
10481,0.000145,172.217.194.0-255,2902,17030,9,296854
10482,0.000147,172.31.36.0-255,66,17096,9,296854
10483,0.000154,172.217.194.0-255,5379,22475,9,296854
10484,0.000157,172.31.36.0-255,66,22541,9,296854
10485,0.000184,172.217.194.0-255,1484,24025,9,296854
10486,0.000186,172.31.36.0-255,66,24091,9,296854
10487,0.000191,172.217.194.0-255,2902,26993,9,296854
10488,0.000194,172.31.36.0-255,66,27059,9,296854
10489,0.0002,172.217.194.0-255,5738,32797,9,296854
10490,0.000208,172.31.36.0-255,66,32863,9,296854
10491,0.000246,172.31.36.0-255,66,32929,9,296854
10492,0.000279,172.217.194.0-255,2543,35472,9,296854
10493,0.000282,172.31.36.0-255,66,35538,9,296854
10494,0.000298,172.31.36.0-255,66,35604,9,296854
10495,0.000322,172.217.194.0-255,1447,37051,9,296854
10496,0.000324,172.31.36.0-255,66,37117,9,296854
10497,0.00038,172.217.194.0-255,1484,38601,9,296854
10498,0.000383,172.31.36.0-255,66,38667,9,296854
10499,0.000389,172.217.194.0-255,2902,41569,9,296854
10500,0.000392,172.31.36.0-255,66,41635,9,296854
10501,0.000404,172.217.194.0-255,5738,47373,9,296854
10502,0.000407,172.31.36.0-255,66,47439,9,296854
10503,0.000448,172.217.194.0-255,4320,51759,9,296854
10504,0.000452,172.31.36.0-255,66,51825,9,296854
10505,0.000475,172.217.194.0-255,2543,54368,9,296854
10506,0.000478,172.31.36.0-255,66,54434,9,296854
10507,0.000481,172.217.194.0-255,1484,55918,9,296854
10508,0.000504,172.217.194.0-255,5738,61656,9,296854
10509,0.000506,172.31.36.0-255,66,61722,9,296854
10510,0.000512,172.217.194.0-255,4320,66042,9,296854
10511,0.000514,172.31.36.0-255,66,66108,9,296854
10512,0.000526,172.217.194.0-255,1484,67592,9,296854
10513,0.000544,172.217.194.0-255,4258,71850,9,296854
10514,0.000547,172.31.36.0-255,66,71916,9,296854
10515,0.00059,172.217.194.0-255,2902,74818,9,296854
10516,0.000592,172.31.36.0-255,66,74884,9,296854
10517,0.000625,172.217.194.0-255,4320,79204,9,296854
10518,0.000628,172.31.36.0-255,66,79270,9,296854
10519,0.000662,172.31.36.0-255,66,79336,9,296854
10520,0.00073,172.31.36.0-255,66,79402,9,296854
10521,0.000737,172.217.194.0-255,5738,85140,9,296854
10522,0.000739,172.31.36.0-255,66,85206,9,296854
10523,0.000769,172.217.194.0-255,2184,87390,9,296854
10524,0.000771,172.31.36.0-255,66,87456,9,296854
10525,0.000808,172.217.194.0-255,1484,88940,9,296854
10526,0.000821,172.217.194.0-255,2902,91842,9,296854
10527,0.000823,172.31.36.0-255,66,91908,9,296854
10528,0.000848,172.217.194.0-255,5738,97646,9,296854
10529,0.000851,172.31.36.0-255,66,97712,9,296854
10530,0.000856,172.217.194.0-255,4320,102032,9,296854
10531,0.000858,172.31.36.0-255,66,102098,9,296854
10532,0.000899,172.217.194.0-255,1484,103582,9,296854
10533,0.000923,172.217.194.0-255,6438,110020,9,296854
10534,0.000977,172.217.194.0-255,1484,111504,9,296854
10535,0.000992,172.217.194.0-255,1484,112988,9,296854
10536,0.001005,172.217.194.0-255,1484,114472,9,296854
10537,0.001008,172.217.194.0-255,1484,115956,9,296854
10538,0.001028,172.217.194.0-255,4320,120276,9,296854
10539,0.001036,172.217.194.0-255,7156,127432,9,296854
10540,0.001052,172.217.194.0-255,5738,133170,9,296854
10541,0.00112,172.31.36.0-255,66,133236,9,296854
10542,0.002054,172.217.194.0-255,1484,134720,9,296854
10543,0.00206,172.217.194.0-255,2902,137622,9,296854
10544,0.002064,172.31.36.0-255,66,137688,9,296854
10545,0.002079,172.217.194.0-255,4320,142008,9,296854
10546,0.002092,172.31.36.0-255,66,142074,9,296854
10547,0.002123,172.217.194.0-255,1484,143558,9,296854
10548,0.002138,172.31.36.0-255,66,143624,9,296854
10549,0.002156,172.31.36.0-255,66,143690,9,296854
10550,0.00224,172.217.194.0-255,1484,145174,9,296854
10551,0.002258,172.217.194.0-255,2902,148076,9,296854
10552,0.002261,172.31.36.0-255,66,148142,9,296854
10553,0.002269,172.217.194.0-255,5738,153880,9,296854
10554,0.002271,172.31.36.0-255,66,153946,9,296854
10555,0.002282,172.217.194.0-255,5738,159684,9,296854
10556,0.002284,172.31.36.0-255,66,159750,9,296854
10557,0.002294,172.217.194.0-255,2902,162652,9,296854
10558,0.002296,172.31.36.0-255,66,162718,9,296854
10559,0.002337,172.31.36.0-255,66,162784,9,296854
10560,0.002345,172.217.194.0-255,7156,169940,9,296854
10561,0.002347,172.31.36.0-255,66,170006,9,296854
10562,0.00238,172.217.194.0-255,5020,175026,9,296854
10563,0.002383,172.31.36.0-255,66,175092,9,296854
10564,0.002452,172.217.194.0-255,1484,176576,9,296854
10565,0.002456,172.217.194.0-255,2902,179478,9,296854
10566,0.002469,172.31.36.0-255,66,179544,9,296854
10567,0.004911,172.217.194.0-255,5738,185282,9,296854
10568,0.004919,172.31.36.0-255,66,185348,9,296854
10569,0.007338,172.217.194.0-255,5738,191086,9,296854
10570,0.007342,172.31.36.0-255,66,191152,9,296854
10571,0.009787,172.217.194.0-255,5738,196890,9,296854
10572,0.009793,172.31.36.0-255,66,196956,9,296854
10573,0.012226,172.217.194.0-255,5738,202694,9,296854
10574,0.012243,172.31.36.0-255,66,202760,9,296854
10575,0.014735,172.217.194.0-255,5738,208498,9,296854
10576,0.014745,172.31.36.0-255,66,208564,9,296854
10577,0.017211,172.217.194.0-255,5738,214302,9,296854
10578,0.017222,172.31.36.0-255,66,214368,9,296854
10579,0.019677,172.217.194.0-255,5738,220106,9,296854
10580,0.019691,172.31.36.0-255,66,220172,9,296854
10581,0.022151,172.217.194.0-255,5738,225910,9,296854
10582,0.022162,172.31.36.0-255,66,225976,9,296854
10583,0.024617,172.217.194.0-255,5738,231714,9,296854
10584,0.024629,172.31.36.0-255,66,231780,9,296854
10585,0.027097,172.217.194.0-255,5738,237518,9,296854
10586,0.027104,172.31.36.0-255,66,237584,9,296854
10587,0.029608,172.217.194.0-255,5738,243322,9,296854
10588,0.029617,172.31.36.0-255,66,243388,9,296854
10589,0.032065,172.217.194.0-255,5738,249126,9,296854
10590,0.032074,172.31.36.0-255,66,249192,9,296854
10591,0.034545,172.217.194.0-255,5738,254930,9,296854
10592,0.034554,172.31.36.0-255,66,254996,9,296854
10593,0.037022,172.217.194.0-255,5738,260734,9,296854
10594,0.037032,172.31.36.0-255,66,260800,9,296854
10595,0.039477,172.217.194.0-255,5738,266538,9,296854
10596,0.039487,172.31.36.0-255,66,266604,9,296854
10597,0.042001,172.217.194.0-255,5738,272342,9,296854
10598,0.042011,172.31.36.0-255,66,272408,9,296854
10599,0.044486,172.217.194.0-255,5738,278146,9,296854
10600,0.044498,172.31.36.0-255,66,278212,9,296854
10601,0.046988,172.217.194.0-255,5738,283950,9,296854
10602,0.046999,172.31.36.0-255,66,284016,9,296854
10603,0.049426,172.217.194.0-255,4320,288336,9,296854
10604,0.049433,172.31.36.0-255,66,288402,9,296854
10605,0.04946,172.217.194.0-255,1484,289886,9,296854
10606,0.05185,172.217.194.0-255,531,290417,9,296854
10607,0.05186,172.31.36.0-255,66,290483,9,296854
10608,0.052075,172.31.36.0-255,105,290588,9,296854
10609,0.054479,172.217.194.0-255,66,290654,9,296854
10610,0.054785,172.31.36.0-255,172,290826,9,296854
10611,0.054814,172.31.36.0-255,1116,291942,9,296854
10612,0.054881,172.31.36.0-255,1514,293456,9,296854
10613,0.054883,172.31.36.0-255,1514,294970,9,296854
10614,0.054884,172.31.36.0-255,1514,296484,9,296854
10615,0.054886,172.31.36.0-255,106,296590,9,296854
10616,0.05647,104.244.42.0-255,66,296656,9,296854
10617,0.056506,104.244.42.0-255,66,296722,9,296854
10618,0.056555,104.244.42.0-255,66,296788,9,296854
10619,0.056575,104.244.42.0-255,66,296854,9,296854
10620,0.0,74.125.24.0-255,152,152,9,238948
10621,1.6e-05,172.31.36.0-255,66,218,9,238948
10622,4.9e-05,74.125.24.0-255,1484,1702,9,238948
10623,5.4e-05,172.31.36.0-255,66,1768,9,238948
10624,5.8e-05,74.125.24.0-255,1484,3252,9,238948
10625,6.1e-05,172.31.36.0-255,66,3318,9,238948
10626,8.2e-05,74.125.24.0-255,1484,4802,9,238948
10627,8.5e-05,172.31.36.0-255,66,4868,9,238948
10628,9.7e-05,74.125.24.0-255,7156,12024,9,238948
10629,0.0001,172.31.36.0-255,66,12090,9,238948
10630,0.000105,74.125.24.0-255,2020,14110,9,238948
10631,0.000107,172.31.36.0-255,66,14176,9,238948
10632,0.000163,74.125.24.0-255,1484,15660,9,238948
10633,0.000168,172.31.36.0-255,66,15726,9,238948
10634,0.000174,74.125.24.0-255,2902,18628,9,238948
10635,0.000176,172.31.36.0-255,66,18694,9,238948
10636,0.00018,74.125.24.0-255,1484,20178,9,238948
10637,0.000182,172.31.36.0-255,66,20244,9,238948
10638,0.000215,74.125.24.0-255,4320,24564,9,238948
10639,0.000224,172.31.36.0-255,66,24630,9,238948
10640,0.00023,74.125.24.0-255,5738,30368,9,238948
10641,0.000233,172.31.36.0-255,66,30434,9,238948
10642,0.000272,74.125.24.0-255,3961,34395,9,238948
10643,0.000276,172.31.36.0-255,66,34461,9,238948
10644,0.000282,74.125.24.0-255,4320,38781,9,238948
10645,0.000285,172.31.36.0-255,66,38847,9,238948
10646,0.000302,172.31.36.0-255,66,38913,9,238948
10647,0.001255,74.125.24.0-255,1484,40397,9,238948
10648,0.001261,172.31.36.0-255,66,40463,9,238948
10649,0.001268,74.125.24.0-255,1484,41947,9,238948
10650,0.001271,172.31.36.0-255,66,42013,9,238948
10651,0.001276,74.125.24.0-255,2902,44915,9,238948
10652,0.001283,172.31.36.0-255,66,44981,9,238948
10653,0.001288,74.125.24.0-255,2902,47883,9,238948
10654,0.00129,172.31.36.0-255,66,47949,9,238948
10655,0.001319,74.125.24.0-255,2902,50851,9,238948
10656,0.001326,172.31.36.0-255,66,50917,9,238948
10657,0.001333,74.125.24.0-255,5379,56296,9,238948
10658,0.001334,172.31.36.0-255,66,56362,9,238948
10659,0.001371,172.31.36.0-255,66,56428,9,238948
10660,0.001376,74.125.24.0-255,3961,60389,9,238948
10661,0.001377,172.31.36.0-255,66,60455,9,238948
10662,0.003347,74.125.24.0-255,5738,66193,9,238948
10663,0.003352,172.31.36.0-255,66,66259,9,238948
10664,0.005309,74.125.24.0-255,5738,71997,9,238948
10665,0.005313,172.31.36.0-255,66,72063,9,238948
10666,0.007259,74.125.24.0-255,5738,77801,9,238948
10667,0.007265,172.31.36.0-255,66,77867,9,238948
10668,0.009236,74.125.24.0-255,5738,83605,9,238948
10669,0.009243,172.31.36.0-255,66,83671,9,238948
10670,0.011215,74.125.24.0-255,5738,89409,9,238948
10671,0.011224,172.31.36.0-255,66,89475,9,238948
10672,0.013191,74.125.24.0-255,5738,95213,9,238948
10673,0.013198,172.31.36.0-255,66,95279,9,238948
10674,0.015165,74.125.24.0-255,5738,101017,9,238948
10675,0.015175,172.31.36.0-255,66,101083,9,238948
10676,0.017136,74.125.24.0-255,5738,106821,9,238948
10677,0.017147,172.31.36.0-255,66,106887,9,238948
10678,0.019115,74.125.24.0-255,5738,112625,9,238948
10679,0.019125,172.31.36.0-255,66,112691,9,238948
10680,0.021081,74.125.24.0-255,5738,118429,9,238948
10681,0.021088,172.31.36.0-255,66,118495,9,238948
10682,0.023058,74.125.24.0-255,5738,124233,9,238948
10683,0.023066,172.31.36.0-255,66,124299,9,238948
10684,0.025039,74.125.24.0-255,5738,130037,9,238948
10685,0.025048,172.31.36.0-255,66,130103,9,238948
10686,0.027008,74.125.24.0-255,5738,135841,9,238948
10687,0.027017,172.31.36.0-255,66,135907,9,238948
10688,0.028966,74.125.24.0-255,5738,141645,9,238948
10689,0.028973,172.31.36.0-255,66,141711,9,238948
10690,0.03095,74.125.24.0-255,5738,147449,9,238948
10691,0.030958,172.31.36.0-255,66,147515,9,238948
10692,0.032922,74.125.24.0-255,5738,153253,9,238948
10693,0.03293,172.31.36.0-255,66,153319,9,238948
10694,0.03488,74.125.24.0-255,5738,159057,9,238948
10695,0.034888,172.31.36.0-255,66,159123,9,238948
10696,0.036887,74.125.24.0-255,5738,164861,9,238948
10697,0.036896,172.31.36.0-255,66,164927,9,238948
10698,0.038861,74.125.24.0-255,5738,170665,9,238948
10699,0.038868,172.31.36.0-255,66,170731,9,238948
10700,0.038997,172.31.36.0-255,172,170903,9,238948
10701,0.039088,172.31.36.0-255,1112,172015,9,238948
10702,0.039783,172.31.36.0-255,1514,173529,9,238948
10703,0.039787,172.31.36.0-255,1514,175043,9,238948
10704,0.039793,172.31.36.0-255,1514,176557,9,238948
10705,0.039794,172.31.36.0-255,1514,178071,9,238948
10706,0.039817,172.31.36.0-255,1385,179456,9,238948
10707,0.04052,104.244.42.0-255,66,179522,9,238948
10708,0.040662,104.244.42.0-255,66,179588,9,238948
10709,0.040836,74.125.24.0-255,5738,185326,9,238948
10710,0.040843,172.31.36.0-255,66,185392,9,238948
10711,0.041381,104.244.42.0-255,66,185458,9,238948
10712,0.041429,104.244.42.0-255,66,185524,9,238948
10713,0.042782,74.125.24.0-255,2902,188426,9,238948
10714,0.042788,172.31.36.0-255,66,188492,9,238948
10715,0.042824,74.125.24.0-255,2902,191394,9,238948
10716,0.042828,172.31.36.0-255,66,191460,9,238948
10717,0.044738,74.125.24.0-255,2902,194362,9,238948
10718,0.044744,172.31.36.0-255,66,194428,9,238948
10719,0.04478,74.125.24.0-255,2902,197330,9,238948
10720,0.044783,172.31.36.0-255,66,197396,9,238948
10721,0.04668,74.125.24.0-255,2902,200298,9,238948
10722,0.046686,172.31.36.0-255,66,200364,9,238948
10723,0.046736,74.125.24.0-255,2902,203266,9,238948
10724,0.046741,172.31.36.0-255,66,203332,9,238948
10725,0.048646,74.125.24.0-255,2902,206234,9,238948
10726,0.048651,172.31.36.0-255,66,206300,9,238948
10727,0.048713,74.125.24.0-255,2902,209202,9,238948
10728,0.048717,172.31.36.0-255,66,209268,9,238948
10729,0.050604,74.125.24.0-255,2902,212170,9,238948
10730,0.050612,172.31.36.0-255,66,212236,9,238948
10731,0.050666,74.125.24.0-255,2902,215138,9,238948
10732,0.050669,172.31.36.0-255,66,215204,9,238948
10733,0.052578,74.125.24.0-255,2902,218106,9,238948
10734,0.052585,172.31.36.0-255,66,218172,9,238948
10735,0.052619,74.125.24.0-255,2902,221074,9,238948
10736,0.052622,172.31.36.0-255,66,221140,9,238948
10737,0.054536,74.125.24.0-255,2902,224042,9,238948
10738,0.054541,172.31.36.0-255,66,224108,9,238948
10739,0.054576,74.125.24.0-255,2902,227010,9,238948
10740,0.05458,172.31.36.0-255,66,227076,9,238948
10741,0.056512,74.125.24.0-255,2902,229978,9,238948
10742,0.056519,172.31.36.0-255,66,230044,9,238948
10743,0.056547,74.125.24.0-255,2902,232946,9,238948
10744,0.05655,172.31.36.0-255,66,233012,9,238948
10745,0.058472,74.125.24.0-255,2902,235914,9,238948
10746,0.058478,172.31.36.0-255,66,235980,9,238948
10747,0.058516,74.125.24.0-255,2902,238882,9,238948
10748,0.058519,172.31.36.0-255,66,238948,9,238948
10749,0.0,172.31.36.0-255,105,105,9,105
10750,0.0,172.31.36.0-255,105,105,9,105
10751,0.0,74.125.200.0-255,153,153,9,285883
10752,2.4e-05,172.31.36.0-255,66,219,9,285883
10753,3.1e-05,74.125.200.0-255,1484,1703,9,285883
10754,3.7e-05,172.31.36.0-255,66,1769,9,285883
10755,5e-05,74.125.200.0-255,2902,4671,9,285883
10756,5.4e-05,172.31.36.0-255,66,4737,9,285883
10757,6.2e-05,74.125.200.0-255,5738,10475,9,285883
10758,6.5e-05,172.31.36.0-255,66,10541,9,285883
10759,6.9e-05,74.125.200.0-255,1484,12025,9,285883
10760,7.2e-05,172.31.36.0-255,66,12091,9,285883
10761,0.000117,172.31.36.0-255,66,12157,9,285883
10762,0.000169,172.31.36.0-255,66,12223,9,285883
10763,0.000196,74.125.200.0-255,1484,13707,9,285883
10764,0.000198,172.31.36.0-255,66,13773,9,285883
10765,0.000203,74.125.200.0-255,2902,16675,9,285883
10766,0.000205,172.31.36.0-255,66,16741,9,285883
10767,0.000235,74.125.200.0-255,5738,22479,9,285883
10768,0.000238,172.31.36.0-255,66,22545,9,285883
10769,0.000245,74.125.200.0-255,5738,28283,9,285883
10770,0.000247,172.31.36.0-255,66,28349,9,285883
10771,0.000275,74.125.200.0-255,1125,29474,9,285883
10772,0.000277,172.31.36.0-255,66,29540,9,285883
10773,0.00031,172.31.36.0-255,66,29606,9,285883
10774,0.000363,172.31.36.0-255,66,29672,9,285883
10775,0.000387,74.125.200.0-255,110,29782,9,285883
10776,0.000389,172.31.36.0-255,66,29848,9,285883
10777,0.000452,74.125.200.0-255,330,30178,9,285883
10778,0.000455,172.31.36.0-255,66,30244,9,285883
10779,0.000488,74.125.200.0-255,1484,31728,9,285883
10780,0.00049,172.31.36.0-255,66,31794,9,285883
10781,0.000517,74.125.200.0-255,2902,34696,9,285883
10782,0.000521,172.31.36.0-255,66,34762,9,285883
10783,0.000524,74.125.200.0-255,1484,36246,9,285883
10784,0.000526,172.31.36.0-255,66,36312,9,285883
10785,0.000531,74.125.200.0-255,2902,39214,9,285883
10786,0.000533,172.31.36.0-255,66,39280,9,285883
10787,0.00056,74.125.200.0-255,2902,42182,9,285883
10788,0.000562,172.31.36.0-255,66,42248,9,285883
10789,0.000573,74.125.200.0-255,4830,47078,9,285883
10790,0.000575,172.31.36.0-255,66,47144,9,285883
10791,0.001167,74.125.200.0-255,1484,48628,9,285883
10792,0.001172,172.31.36.0-255,66,48694,9,285883
10793,0.001179,74.125.200.0-255,2902,51596,9,285883
10794,0.001181,172.31.36.0-255,66,51662,9,285883
10795,0.001254,74.125.200.0-255,1484,53146,9,285883
10796,0.001258,172.31.36.0-255,66,53212,9,285883
10797,0.001288,74.125.200.0-255,4320,57532,9,285883
10798,0.001291,172.31.36.0-255,66,57598,9,285883
10799,0.001296,74.125.200.0-255,2902,60500,9,285883
10800,0.001298,172.31.36.0-255,66,60566,9,285883
10801,0.001308,74.125.200.0-255,4320,64886,9,285883
10802,0.00131,172.31.36.0-255,66,64952,9,285883
10803,0.001321,172.31.36.0-255,66,65018,9,285883
10804,0.001327,74.125.200.0-255,5738,70756,9,285883
10805,0.00133,172.31.36.0-255,66,70822,9,285883
10806,0.001333,74.125.200.0-255,2184,73006,9,285883
10807,0.001335,172.31.36.0-255,66,73072,9,285883
10808,0.001705,74.125.200.0-255,1484,74556,9,285883
10809,0.00171,172.31.36.0-255,66,74622,9,285883
10810,0.001717,74.125.200.0-255,2902,77524,9,285883
10811,0.001718,172.31.36.0-255,66,77590,9,285883
10812,0.001736,74.125.200.0-255,1484,79074,9,285883
10813,0.001738,172.31.36.0-255,66,79140,9,285883
10814,0.001772,74.125.200.0-255,2902,82042,9,285883
10815,0.001775,172.31.36.0-255,66,82108,9,285883
10816,0.001779,74.125.200.0-255,1484,83592,9,285883
10817,0.001781,172.31.36.0-255,66,83658,9,285883
10818,0.001808,74.125.200.0-255,2902,86560,9,285883
10819,0.00181,172.31.36.0-255,66,86626,9,285883
10820,0.001824,74.125.200.0-255,5738,92364,9,285883
10821,0.001826,172.31.36.0-255,66,92430,9,285883
10822,0.001889,74.125.200.0-255,4320,96750,9,285883
10823,0.001893,172.31.36.0-255,66,96816,9,285883
10824,0.0019,74.125.200.0-255,5738,102554,9,285883
10825,0.001902,172.31.36.0-255,66,102620,9,285883
10826,0.001942,74.125.200.0-255,5020,107640,9,285883
10827,0.001945,172.31.36.0-255,66,107706,9,285883
10828,0.00392,74.125.200.0-255,5738,113444,9,285883
10829,0.003927,172.31.36.0-255,66,113510,9,285883
10830,0.005894,74.125.200.0-255,5738,119248,9,285883
10831,0.005898,172.31.36.0-255,66,119314,9,285883
10832,0.007861,74.125.200.0-255,5738,125052,9,285883
10833,0.007868,172.31.36.0-255,66,125118,9,285883
10834,0.009838,74.125.200.0-255,5738,130856,9,285883
10835,0.009846,172.31.36.0-255,66,130922,9,285883
10836,0.011823,74.125.200.0-255,5738,136660,9,285883
10837,0.011831,172.31.36.0-255,66,136726,9,285883
10838,0.013802,74.125.200.0-255,5738,142464,9,285883
10839,0.013811,172.31.36.0-255,66,142530,9,285883
10840,0.015781,74.125.200.0-255,5738,148268,9,285883
10841,0.01579,172.31.36.0-255,66,148334,9,285883
10842,0.017772,74.125.200.0-255,5738,154072,9,285883
10843,0.017784,172.31.36.0-255,66,154138,9,285883
10844,0.019754,74.125.200.0-255,5738,159876,9,285883
10845,0.019763,172.31.36.0-255,66,159942,9,285883
10846,0.02177,74.125.200.0-255,5738,165680,9,285883
10847,0.021778,172.31.36.0-255,66,165746,9,285883
10848,0.023752,74.125.200.0-255,5738,171484,9,285883
10849,0.02376,172.31.36.0-255,66,171550,9,285883
10850,0.02574,74.125.200.0-255,5738,177288,9,285883
10851,0.025748,172.31.36.0-255,66,177354,9,285883
10852,0.027724,74.125.200.0-255,5738,183092,9,285883
10853,0.027732,172.31.36.0-255,66,183158,9,285883
10854,0.029741,74.125.200.0-255,5738,188896,9,285883
10855,0.029749,172.31.36.0-255,66,188962,9,285883
10856,0.031725,74.125.200.0-255,5738,194700,9,285883
10857,0.031733,172.31.36.0-255,66,194766,9,285883
10858,0.033711,74.125.200.0-255,2902,197668,9,285883
10859,0.033719,172.31.36.0-255,66,197734,9,285883
10860,0.033754,74.125.200.0-255,2902,200636,9,285883
10861,0.033758,172.31.36.0-255,66,200702,9,285883
10862,0.034485,172.31.36.0-255,172,200874,9,285883
10863,0.034537,172.31.36.0-255,1112,201986,9,285883
10864,0.034612,172.31.36.0-255,1514,203500,9,285883
10865,0.034615,172.31.36.0-255,1514,205014,9,285883
10866,0.034616,172.31.36.0-255,1514,206528,9,285883
10867,0.034624,172.31.36.0-255,1514,208042,9,285883
10868,0.034626,172.31.36.0-255,1489,209531,9,285883
10869,0.035686,74.125.200.0-255,2902,212433,9,285883
10870,0.035693,172.31.36.0-255,66,212499,9,285883
10871,0.03572,74.125.200.0-255,2902,215401,9,285883
10872,0.035722,172.31.36.0-255,66,215467,9,285883
10873,0.036036,104.244.42.0-255,66,215533,9,285883
10874,0.036103,104.244.42.0-255,66,215599,9,285883
10875,0.036204,104.244.42.0-255,66,215665,9,285883
10876,0.036715,104.244.42.0-255,108,215773,9,285883
10877,0.036724,172.31.36.0-255,66,215839,9,285883
10878,0.037663,74.125.200.0-255,2902,218741,9,285883
10879,0.037668,172.31.36.0-255,66,218807,9,285883
10880,0.037697,74.125.200.0-255,2902,221709,9,285883
10881,0.0377,172.31.36.0-255,66,221775,9,285883
10882,0.039652,74.125.200.0-255,2902,224677,9,285883
10883,0.039659,172.31.36.0-255,66,224743,9,285883
10884,0.039688,74.125.200.0-255,2902,227645,9,285883
10885,0.039691,172.31.36.0-255,66,227711,9,285883
10886,0.041625,74.125.200.0-255,2902,230613,9,285883
10887,0.041632,172.31.36.0-255,66,230679,9,285883
10888,0.041665,74.125.200.0-255,2902,233581,9,285883
10889,0.041667,172.31.36.0-255,66,233647,9,285883
10890,0.043629,74.125.200.0-255,5738,239385,9,285883
10891,0.043636,172.31.36.0-255,66,239451,9,285883
10892,0.045619,74.125.200.0-255,5738,245189,9,285883
10893,0.045626,172.31.36.0-255,66,245255,9,285883
10894,0.047649,74.125.200.0-255,5738,250993,9,285883
10895,0.047655,172.31.36.0-255,66,251059,9,285883
10896,0.049634,74.125.200.0-255,5738,256797,9,285883
10897,0.049641,172.31.36.0-255,66,256863,9,285883
10898,0.051643,74.125.200.0-255,5738,262601,9,285883
10899,0.05165,172.31.36.0-255,66,262667,9,285883
10900,0.053621,74.125.200.0-255,5738,268405,9,285883
10901,0.053628,172.31.36.0-255,66,268471,9,285883
10902,0.0556,74.125.200.0-255,5738,274209,9,285883
10903,0.05562,172.31.36.0-255,66,274275,9,285883
10904,0.057598,74.125.200.0-255,5738,280013,9,285883
10905,0.057605,172.31.36.0-255,66,280079,9,285883
10906,0.059609,74.125.200.0-255,5738,285817,9,285883
10907,0.05962,172.31.36.0-255,66,285883,9,285883
10908,0.0,172.217.194.0-255,153,153,9,278161
10909,3.1e-05,172.217.194.0-255,1484,1637,9,278161
10910,4.1e-05,172.31.36.0-255,66,1703,9,278161
10911,4.8e-05,172.217.194.0-255,2902,4605,9,278161
10912,5.2e-05,172.31.36.0-255,66,4671,9,278161
10913,6.8e-05,172.217.194.0-255,7156,11827,9,278161
10914,7.2e-05,172.31.36.0-255,66,11893,9,278161
10915,7.5e-05,172.217.194.0-255,2039,13932,9,278161
10916,7.8e-05,172.31.36.0-255,66,13998,9,278161
10917,9.4e-05,172.217.194.0-255,2902,16900,9,278161
10918,9.7e-05,172.31.36.0-255,66,16966,9,278161
10919,0.000152,172.31.36.0-255,66,17032,9,278161
10920,0.00016,172.217.194.0-255,5379,22411,9,278161
10921,0.000162,172.31.36.0-255,66,22477,9,278161
10922,0.000188,172.217.194.0-255,1484,23961,9,278161
10923,0.000214,172.217.194.0-255,2902,26863,9,278161
10924,0.000219,172.31.36.0-255,66,26929,9,278161
10925,0.000252,172.217.194.0-255,5738,32667,9,278161
10926,0.000256,172.31.36.0-255,66,32733,9,278161
10927,0.000262,172.217.194.0-255,4320,37053,9,278161
10928,0.000265,172.31.36.0-255,66,37119,9,278161
10929,0.000296,172.217.194.0-255,5379,42498,9,278161
10930,0.0003,172.31.36.0-255,66,42564,9,278161
10931,0.000306,172.217.194.0-255,2902,45466,9,278161
10932,0.000308,172.31.36.0-255,66,45532,9,278161
10933,0.000333,172.217.194.0-255,4320,49852,9,278161
10934,0.000337,172.31.36.0-255,66,49918,9,278161
10935,0.000344,172.217.194.0-255,6797,56715,9,278161
10936,0.000347,172.31.36.0-255,66,56781,9,278161
10937,0.000403,172.217.194.0-255,677,57458,9,278161
10938,0.000408,172.217.194.0-255,1484,58942,9,278161
10939,0.000411,172.31.36.0-255,66,59008,9,278161
10940,0.00044,172.217.194.0-255,4320,63328,9,278161
10941,0.000444,172.31.36.0-255,66,63394,9,278161
10942,0.000449,172.217.194.0-255,2902,66296,9,278161
10943,0.000451,172.31.36.0-255,66,66362,9,278161
10944,0.000488,172.217.194.0-255,5738,72100,9,278161
10945,0.000492,172.31.36.0-255,66,72166,9,278161
10946,0.000497,172.217.194.0-255,2543,74709,9,278161
10947,0.000499,172.31.36.0-255,66,74775,9,278161
10948,0.000503,172.217.194.0-255,2902,77677,9,278161
10949,0.000507,172.31.36.0-255,66,77743,9,278161
10950,0.000514,172.217.194.0-255,7156,84899,9,278161
10951,0.000518,172.31.36.0-255,66,84965,9,278161
10952,0.000555,172.217.194.0-255,6797,91762,9,278161
10953,0.00056,172.31.36.0-255,66,91828,9,278161
10954,0.001278,172.217.194.0-255,1484,93312,9,278161
10955,0.001289,172.217.194.0-255,2902,96214,9,278161
10956,0.001294,172.31.36.0-255,66,96280,9,278161
10957,0.001303,172.217.194.0-255,5738,102018,9,278161
10958,0.001306,172.31.36.0-255,66,102084,9,278161
10959,0.001325,172.31.36.0-255,66,102150,9,278161
10960,0.00139,172.217.194.0-255,7156,109306,9,278161
10961,0.001394,172.31.36.0-255,66,109372,9,278161
10962,0.001433,172.31.36.0-255,66,109438,9,278161
10963,0.00187,172.217.194.0-255,1484,110922,9,278161
10964,0.001877,172.217.194.0-255,2902,113824,9,278161
10965,0.001881,172.31.36.0-255,66,113890,9,278161
10966,0.001888,172.217.194.0-255,5738,119628,9,278161
10967,0.001891,172.31.36.0-255,66,119694,9,278161
10968,0.001936,172.31.36.0-255,66,119760,9,278161
10969,0.001954,172.217.194.0-255,2902,122662,9,278161
10970,0.001956,172.31.36.0-255,66,122728,9,278161
10971,0.00196,172.217.194.0-255,2902,125630,9,278161
10972,0.001962,172.31.36.0-255,66,125696,9,278161
10973,0.001997,172.31.36.0-255,66,125762,9,278161
10974,0.002031,172.217.194.0-255,1484,127246,9,278161
10975,0.002036,172.217.194.0-255,2902,130148,9,278161
10976,0.002038,172.31.36.0-255,66,130214,9,278161
10977,0.002065,172.217.194.0-255,5738,135952,9,278161
10978,0.002068,172.31.36.0-255,66,136018,9,278161
10979,0.00209,172.217.194.0-255,5738,141756,9,278161
10980,0.002092,172.31.36.0-255,66,141822,9,278161
10981,0.002104,172.31.36.0-255,66,141888,9,278161
10982,0.002139,172.217.194.0-255,2902,144790,9,278161
10983,0.002141,172.31.36.0-255,66,144856,9,278161
10984,0.002147,172.217.194.0-255,5020,149876,9,278161
10985,0.002151,172.31.36.0-255,66,149942,9,278161
10986,0.002281,172.217.194.0-255,1484,151426,9,278161
10987,0.002292,172.217.194.0-255,2902,154328,9,278161
10988,0.002295,172.31.36.0-255,66,154394,9,278161
10989,0.002297,172.217.194.0-255,1484,155878,9,278161
10990,0.002321,172.217.194.0-255,4320,160198,9,278161
10991,0.002324,172.31.36.0-255,66,160264,9,278161
10992,0.002335,172.31.36.0-255,66,160330,9,278161
10993,0.00238,172.31.36.0-255,66,160396,9,278161
10994,0.002407,172.217.194.0-255,5020,165416,9,278161
10995,0.002409,172.31.36.0-255,66,165482,9,278161
10996,0.002438,172.217.194.0-255,1484,166966,9,278161
10997,0.002442,172.217.194.0-255,2902,169868,9,278161
10998,0.002444,172.31.36.0-255,66,169934,9,278161
10999,0.002469,172.217.194.0-255,5738,175672,9,278161
11000,0.002472,172.31.36.0-255,66,175738,9,278161
11001,0.002518,172.217.194.0-255,2902,178640,9,278161
11002,0.00252,172.31.36.0-255,66,178706,9,278161
11003,0.002569,172.217.194.0-255,2902,181608,9,278161
11004,0.002573,172.31.36.0-255,66,181674,9,278161
11005,0.002576,172.217.194.0-255,1484,183158,9,278161
11006,0.00258,172.217.194.0-255,1484,184642,9,278161
11007,0.002581,172.31.36.0-255,66,184708,9,278161
11008,0.002586,172.217.194.0-255,2902,187610,9,278161
11009,0.002588,172.31.36.0-255,66,187676,9,278161
11010,0.002592,172.217.194.0-255,4320,191996,9,278161
11011,0.002624,172.31.36.0-255,66,192062,9,278161
11012,0.002626,172.31.36.0-255,66,192128,9,278161
11013,0.002662,172.217.194.0-255,1484,193612,9,278161
11014,0.002667,172.217.194.0-255,2902,196514,9,278161
11015,0.002671,172.31.36.0-255,66,196580,9,278161
11016,0.0027,172.217.194.0-255,5738,202318,9,278161
11017,0.002703,172.31.36.0-255,66,202384,9,278161
11018,0.002709,172.217.194.0-255,5738,208122,9,278161
11019,0.002711,172.31.36.0-255,66,208188,9,278161
11020,0.002714,172.217.194.0-255,1484,209672,9,278161
11021,0.002716,172.217.194.0-255,1484,211156,9,278161
11022,0.002718,172.31.36.0-255,66,211222,9,278161
11023,0.002773,172.31.36.0-255,66,211288,9,278161
11024,0.002776,172.217.194.0-255,1484,212772,9,278161
11025,0.002805,172.217.194.0-255,2184,214956,9,278161
11026,0.002807,172.31.36.0-255,66,215022,9,278161
11027,0.002846,172.217.194.0-255,1484,216506,9,278161
11028,0.002863,172.217.194.0-255,2902,219408,9,278161
11029,0.002866,172.31.36.0-255,66,219474,9,278161
11030,0.002891,172.217.194.0-255,5738,225212,9,278161
11031,0.002893,172.31.36.0-255,66,225278,9,278161
11032,0.002899,172.217.194.0-255,7156,232434,9,278161
11033,0.002901,172.31.36.0-255,66,232500,9,278161
11034,0.002906,172.217.194.0-255,4320,236820,9,278161
11035,0.002909,172.31.36.0-255,66,236886,9,278161
11036,0.002957,172.31.36.0-255,66,236952,9,278161
11037,0.00296,172.217.194.0-255,2184,239136,9,278161
11038,0.002962,172.31.36.0-255,66,239202,9,278161
11039,0.002965,172.217.194.0-255,1484,240686,9,278161
11040,0.002971,172.217.194.0-255,7156,247842,9,278161
11041,0.002974,172.31.36.0-255,66,247908,9,278161
11042,0.002985,172.31.36.0-255,66,247974,9,278161
11043,0.00302,172.217.194.0-255,4320,252294,9,278161
11044,0.003022,172.31.36.0-255,66,252360,9,278161
11045,0.003034,172.31.36.0-255,66,252426,9,278161
11046,0.003039,172.217.194.0-255,4320,256746,9,278161
11047,0.003041,172.31.36.0-255,66,256812,9,278161
11048,0.003052,172.31.36.0-255,66,256878,9,278161
11049,0.003082,172.217.194.0-255,7156,264034,9,278161
11050,0.003084,172.31.36.0-255,66,264100,9,278161
11051,0.003097,172.31.36.0-255,66,264166,9,278161
11052,0.003102,172.217.194.0-255,4320,268486,9,278161
11053,0.003104,172.31.36.0-255,66,268552,9,278161
11054,0.003114,172.31.36.0-255,66,268618,9,278161
11055,0.003117,172.217.194.0-255,105,268723,9,278161
11056,0.009012,172.31.36.0-255,105,268828,9,278161
11057,0.011364,172.217.194.0-255,66,268894,9,278161
11058,0.03584,172.31.36.0-255,172,269066,9,278161
11059,0.035873,172.31.36.0-255,1115,270181,9,278161
11060,0.035945,172.31.36.0-255,1514,271695,9,278161
11061,0.035975,172.31.36.0-255,1514,273209,9,278161
11062,0.035977,172.31.36.0-255,1514,274723,9,278161
11063,0.035997,172.31.36.0-255,1514,276237,9,278161
11064,0.036001,172.31.36.0-255,1486,277723,9,278161
11065,0.037416,104.244.42.0-255,66,277789,9,278161
11066,0.037447,104.244.42.0-255,66,277855,9,278161
11067,0.037511,104.244.42.0-255,66,277921,9,278161
11068,0.037565,104.244.42.0-255,66,277987,9,278161
11069,0.04101,104.244.42.0-255,108,278095,9,278161
11070,0.041021,172.31.36.0-255,66,278161,9,278161
11071,0.0,74.125.24.0-255,297,297,9,274444
11072,1.1e-05,172.31.36.0-255,66,363,9,274444
11073,3.2e-05,74.125.24.0-255,1484,1847,9,274444
11074,3.6e-05,172.31.36.0-255,66,1913,9,274444
11075,4.4e-05,74.125.24.0-255,4320,6233,9,274444
11076,4.8e-05,172.31.36.0-255,66,6299,9,274444
11077,9.6e-05,172.31.36.0-255,66,6365,9,274444
11078,0.000135,74.125.24.0-255,7156,13521,9,274444
11079,0.000138,172.31.36.0-255,66,13587,9,274444
11080,0.000163,74.125.24.0-255,2902,16489,9,274444
11081,0.000166,172.31.36.0-255,66,16555,9,274444
11082,0.000212,74.125.24.0-255,1484,18039,9,274444
11083,0.000215,172.31.36.0-255,66,18105,9,274444
11084,0.000243,74.125.24.0-255,3961,22066,9,274444
11085,0.000247,172.31.36.0-255,66,22132,9,274444
11086,0.000276,74.125.24.0-255,5738,27870,9,274444
11087,0.000279,172.31.36.0-255,66,27936,9,274444
11088,0.000329,172.31.36.0-255,66,28002,9,274444
11089,0.00036,74.125.24.0-255,3961,31963,9,274444
11090,0.000362,172.31.36.0-255,66,32029,9,274444
11091,0.000417,74.125.24.0-255,5738,37767,9,274444
11092,0.000421,172.31.36.0-255,66,37833,9,274444
11093,0.000437,74.125.24.0-255,1484,39317,9,274444
11094,0.00044,172.31.36.0-255,66,39383,9,274444
11095,0.000489,172.31.36.0-255,66,39449,9,274444
11096,0.000526,74.125.24.0-255,414,39863,9,274444
11097,0.000529,172.31.36.0-255,66,39929,9,274444
11098,0.000579,74.125.24.0-255,1484,41413,9,274444
11099,0.000582,172.31.36.0-255,66,41479,9,274444
11100,0.000587,74.125.24.0-255,2902,44381,9,274444
11101,0.000604,172.31.36.0-255,66,44447,9,274444
11102,0.000611,74.125.24.0-255,5738,50185,9,274444
11103,0.000621,172.31.36.0-255,66,50251,9,274444
11104,0.000649,74.125.24.0-255,2902,53153,9,274444
11105,0.000663,172.31.36.0-255,66,53219,9,274444
11106,0.000688,172.31.36.0-255,66,53285,9,274444
11107,0.000778,74.125.24.0-255,2184,55469,9,274444
11108,0.000783,172.31.36.0-255,66,55535,9,274444
11109,0.000789,172.31.36.0-255,66,55601,9,274444
11110,0.001742,74.125.24.0-255,1484,57085,9,274444
11111,0.001753,74.125.24.0-255,2902,59987,9,274444
11112,0.001758,172.31.36.0-255,66,60053,9,274444
11113,0.001766,74.125.24.0-255,5738,65791,9,274444
11114,0.001812,74.125.24.0-255,7156,72947,9,274444
11115,0.001828,74.125.24.0-255,5738,78685,9,274444
11116,0.002037,74.125.24.0-255,1484,80169,9,274444
11117,0.002045,74.125.24.0-255,2902,83071,9,274444
11118,0.002057,74.125.24.0-255,1484,84555,9,274444
11119,0.002073,74.125.24.0-255,4320,88875,9,274444
11120,0.002129,74.125.24.0-255,5738,94613,9,274444
11121,0.002159,74.125.24.0-255,7156,101769,9,274444
11122,0.00222,74.125.24.0-255,7156,108925,9,274444
11123,0.002239,74.125.24.0-255,3602,112527,9,274444
11124,0.002396,74.125.24.0-255,1484,114011,9,274444
11125,0.002416,74.125.24.0-255,7156,121167,9,274444
11126,0.002436,74.125.24.0-255,7156,128323,9,274444
11127,0.002533,74.125.24.0-255,7156,135479,9,274444
11128,0.002547,74.125.24.0-255,2184,137663,9,274444
11129,0.007596,172.31.36.0-255,66,137729,9,274444
11130,0.009961,74.125.24.0-255,5738,143467,9,274444
11131,0.009969,172.31.36.0-255,66,143533,9,274444
11132,0.012337,74.125.24.0-255,5738,149271,9,274444
11133,0.012346,172.31.36.0-255,66,149337,9,274444
11134,0.01469,74.125.24.0-255,5738,155075,9,274444
11135,0.014729,172.31.36.0-255,66,155141,9,274444
11136,0.017056,74.125.24.0-255,5738,160879,9,274444
11137,0.017066,172.31.36.0-255,66,160945,9,274444
11138,0.019418,74.125.24.0-255,5738,166683,9,274444
11139,0.019427,172.31.36.0-255,66,166749,9,274444
11140,0.021778,74.125.24.0-255,5738,172487,9,274444
11141,0.021786,172.31.36.0-255,66,172553,9,274444
11142,0.024123,74.125.24.0-255,5738,178291,9,274444
11143,0.02413,172.31.36.0-255,66,178357,9,274444
11144,0.02653,74.125.24.0-255,5738,184095,9,274444
11145,0.026538,172.31.36.0-255,66,184161,9,274444
11146,0.028888,74.125.24.0-255,5738,189899,9,274444
11147,0.028895,172.31.36.0-255,66,189965,9,274444
11148,0.031241,74.125.24.0-255,5738,195703,9,274444
11149,0.031249,172.31.36.0-255,66,195769,9,274444
11150,0.033592,74.125.24.0-255,5738,201507,9,274444
11151,0.033599,172.31.36.0-255,66,201573,9,274444
11152,0.035914,172.31.36.0-255,172,201745,9,274444
11153,0.035949,74.125.24.0-255,5738,207483,9,274444
11154,0.035955,172.31.36.0-255,66,207549,9,274444
11155,0.035966,172.31.36.0-255,1112,208661,9,274444
11156,0.036101,172.31.36.0-255,1514,210175,9,274444
11157,0.036103,172.31.36.0-255,1514,211689,9,274444
11158,0.036105,172.31.36.0-255,1514,213203,9,274444
11159,0.036106,172.31.36.0-255,1514,214717,9,274444
11160,0.036134,172.31.36.0-255,1489,216206,9,274444
11161,0.037411,104.244.42.0-255,66,216272,9,274444
11162,0.037462,104.244.42.0-255,66,216338,9,274444
11163,0.037641,104.244.42.0-255,66,216404,9,274444
11164,0.038278,74.125.24.0-255,5738,222142,9,274444
11165,0.038284,172.31.36.0-255,66,222208,9,274444
11166,0.040648,74.125.24.0-255,5738,227946,9,274444
11167,0.040654,172.31.36.0-255,66,228012,9,274444
11168,0.042994,74.125.24.0-255,5738,233750,9,274444
11169,0.042998,172.31.36.0-255,66,233816,9,274444
11170,0.045339,74.125.24.0-255,5738,239554,9,274444
11171,0.045347,172.31.36.0-255,66,239620,9,274444
11172,0.04766,74.125.24.0-255,5738,245358,9,274444
11173,0.047667,172.31.36.0-255,66,245424,9,274444
11174,0.050009,74.125.24.0-255,5738,251162,9,274444
11175,0.050016,172.31.36.0-255,66,251228,9,274444
11176,0.052367,74.125.24.0-255,5738,256966,9,274444
11177,0.052376,172.31.36.0-255,66,257032,9,274444
11178,0.054705,74.125.24.0-255,5738,262770,9,274444
11179,0.054711,172.31.36.0-255,66,262836,9,274444
11180,0.057034,74.125.24.0-255,5738,268574,9,274444
11181,0.057042,172.31.36.0-255,66,268640,9,274444
11182,0.059372,74.125.24.0-255,5738,274378,9,274444
11183,0.059378,172.31.36.0-255,66,274444,9,274444
11184,0.0,172.217.194.0-255,153,153,9,205644
11185,1.6e-05,172.217.194.0-255,1484,1637,9,205644
11186,2.4e-05,172.31.36.0-255,66,1703,9,205644
11187,3.3e-05,172.217.194.0-255,2902,4605,9,205644
11188,3.7e-05,172.31.36.0-255,66,4671,9,205644
11189,4.5e-05,172.217.194.0-255,7156,11827,9,205644
11190,4.9e-05,172.31.36.0-255,66,11893,9,205644
11191,5.3e-05,172.217.194.0-255,2041,13934,9,205644
11192,5.6e-05,172.31.36.0-255,66,14000,9,205644
11193,0.00012,172.217.194.0-255,5738,19738,9,205644
11194,0.000124,172.31.36.0-255,66,19804,9,205644
11195,0.000132,172.217.194.0-255,7156,26960,9,205644
11196,0.000134,172.31.36.0-255,66,27026,9,205644
11197,0.000154,172.217.194.0-255,2902,29928,9,205644
11198,0.000156,172.31.36.0-255,66,29994,9,205644
11199,0.000178,172.217.194.0-255,1125,31119,9,205644
11200,0.000194,172.217.194.0-255,4320,35439,9,205644
11201,0.000203,172.31.36.0-255,66,35505,9,205644
11202,0.000207,172.217.194.0-255,1484,36989,9,205644
11203,0.000228,172.217.194.0-255,4320,41309,9,205644
11204,0.000231,172.31.36.0-255,66,41375,9,205644
11205,0.000242,172.31.36.0-255,66,41441,9,205644
11206,0.000259,172.217.194.0-255,3961,45402,9,205644
11207,0.000262,172.31.36.0-255,66,45468,9,205644
11208,0.000265,172.217.194.0-255,1484,46952,9,205644
11209,0.000299,172.31.36.0-255,66,47018,9,205644
11210,0.000324,172.217.194.0-255,117,47135,9,205644
11211,0.000352,172.217.194.0-255,382,47517,9,205644
11212,0.000539,172.217.194.0-255,1484,49001,9,205644
11213,0.000545,172.31.36.0-255,66,49067,9,205644
11214,0.000551,172.217.194.0-255,2902,51969,9,205644
11215,0.000554,172.31.36.0-255,66,52035,9,205644
11216,0.000561,172.217.194.0-255,5738,57773,9,205644
11217,0.000564,172.31.36.0-255,66,57839,9,205644
11218,0.000567,172.217.194.0-255,1484,59323,9,205644
11219,0.000591,172.217.194.0-255,4320,63643,9,205644
11220,0.000594,172.31.36.0-255,66,63709,9,205644
11221,0.000616,172.217.194.0-255,7156,70865,9,205644
11222,0.00062,172.31.36.0-255,66,70931,9,205644
11223,0.000641,172.31.36.0-255,66,70997,9,205644
11224,0.000643,172.217.194.0-255,766,71763,9,205644
11225,0.000707,172.217.194.0-255,1484,73247,9,205644
11226,0.000711,172.31.36.0-255,66,73313,9,205644
11227,0.000716,172.217.194.0-255,2902,76215,9,205644
11228,0.000719,172.31.36.0-255,66,76281,9,205644
11229,0.000725,172.217.194.0-255,5738,82019,9,205644
11230,0.000729,172.31.36.0-255,66,82085,9,205644
11231,0.000735,172.217.194.0-255,5738,87823,9,205644
11232,0.000737,172.31.36.0-255,66,87889,9,205644
11233,0.00074,172.217.194.0-255,1484,89373,9,205644
11234,0.000771,172.31.36.0-255,66,89439,9,205644
11235,0.000777,172.217.194.0-255,5020,94459,9,205644
11236,0.000779,172.31.36.0-255,66,94525,9,205644
11237,0.000786,172.217.194.0-255,5738,100263,9,205644
11238,0.000788,172.31.36.0-255,66,100329,9,205644
11239,0.000819,172.31.36.0-255,66,100395,9,205644
11240,0.000841,172.217.194.0-255,1484,101879,9,205644
11241,0.000855,172.31.36.0-255,66,101945,9,205644
11242,0.000876,172.217.194.0-255,3602,105547,9,205644
11243,0.000878,172.31.36.0-255,66,105613,9,205644
11244,0.001231,172.217.194.0-255,1484,107097,9,205644
11245,0.001237,172.217.194.0-255,2902,109999,9,205644
11246,0.001241,172.31.36.0-255,66,110065,9,205644
11247,0.001245,172.217.194.0-255,1484,111549,9,205644
11248,0.001264,172.217.194.0-255,4320,115869,9,205644
11249,0.001268,172.217.194.0-255,2902,118771,9,205644
11250,0.001272,172.31.36.0-255,66,118837,9,205644
11251,0.001275,172.31.36.0-255,66,118903,9,205644
11252,0.001303,172.31.36.0-255,66,118969,9,205644
11253,0.001314,172.31.36.0-255,66,119035,9,205644
11254,0.001317,172.217.194.0-255,766,119801,9,205644
11255,0.001378,172.217.194.0-255,1484,121285,9,205644
11256,0.001382,172.31.36.0-255,66,121351,9,205644
11257,0.001386,172.217.194.0-255,1484,122835,9,205644
11258,0.001401,172.217.194.0-255,1484,124319,9,205644
11259,0.001404,172.31.36.0-255,66,124385,9,205644
11260,0.001424,172.217.194.0-255,1484,125869,9,205644
11261,0.00144,172.217.194.0-255,4320,130189,9,205644
11262,0.001443,172.31.36.0-255,66,130255,9,205644
11263,0.001464,172.217.194.0-255,5738,135993,9,205644
11264,0.001467,172.31.36.0-255,66,136059,9,205644
11265,0.001502,172.217.194.0-255,7156,143215,9,205644
11266,0.001505,172.31.36.0-255,66,143281,9,205644
11267,0.001518,172.31.36.0-255,66,143347,9,205644
11268,0.001521,172.217.194.0-255,1484,144831,9,205644
11269,0.001543,172.217.194.0-255,2902,147733,9,205644
11270,0.001546,172.31.36.0-255,66,147799,9,205644
11271,0.001553,172.217.194.0-255,5738,153537,9,205644
11272,0.001555,172.31.36.0-255,66,153603,9,205644
11273,0.001591,172.31.36.0-255,66,153669,9,205644
11274,0.001613,172.217.194.0-255,4320,157989,9,205644
11275,0.001616,172.31.36.0-255,66,158055,9,205644
11276,0.001621,172.217.194.0-255,4320,162375,9,205644
11277,0.001623,172.31.36.0-255,66,162441,9,205644
11278,0.001641,172.217.194.0-255,6438,168879,9,205644
11279,0.001644,172.31.36.0-255,66,168945,9,205644
11280,0.001647,172.217.194.0-255,1484,170429,9,205644
11281,0.00165,172.217.194.0-255,1484,171913,9,205644
11282,0.001652,172.31.36.0-255,66,171979,9,205644
11283,0.001666,172.217.194.0-255,1484,173463,9,205644
11284,0.00169,172.217.194.0-255,2902,176365,9,205644
11285,0.001693,172.31.36.0-255,66,176431,9,205644
11286,0.001711,172.217.194.0-255,2902,179333,9,205644
11287,0.001714,172.31.36.0-255,66,179399,9,205644
11288,0.001736,172.217.194.0-255,4320,183719,9,205644
11289,0.001739,172.31.36.0-255,66,183785,9,205644
11290,0.001785,172.31.36.0-255,66,183851,9,205644
11291,0.001797,172.31.36.0-255,66,183917,9,205644
11292,0.001799,172.217.194.0-255,766,184683,9,205644
11293,0.001803,172.217.194.0-255,1484,186167,9,205644
11294,0.001805,172.31.36.0-255,66,186233,9,205644
11295,0.001811,172.217.194.0-255,4320,190553,9,205644
11296,0.001814,172.31.36.0-255,66,190619,9,205644
11297,0.001826,172.31.36.0-255,66,190685,9,205644
11298,0.001839,172.31.36.0-255,66,190751,9,205644
11299,0.001855,172.31.36.0-255,66,190817,9,205644
11300,0.001876,172.217.194.0-255,5020,195837,9,205644
11301,0.001878,172.31.36.0-255,66,195903,9,205644
11302,0.001923,172.31.36.0-255,66,195969,9,205644
11303,0.001964,172.31.36.0-255,66,196035,9,205644
11304,0.001981,172.31.36.0-255,66,196101,9,205644
11305,0.002005,172.31.36.0-255,66,196167,9,205644
11306,0.002008,172.217.194.0-255,105,196272,9,205644
11307,0.010884,172.31.36.0-255,105,196377,9,205644
11308,0.013195,172.217.194.0-255,66,196443,9,205644
11309,0.036452,172.31.36.0-255,172,196615,9,205644
11310,0.036488,172.31.36.0-255,1115,197730,9,205644
11311,0.036555,172.31.36.0-255,1514,199244,9,205644
11312,0.036557,172.31.36.0-255,1514,200758,9,205644
11313,0.036564,172.31.36.0-255,1514,202272,9,205644
11314,0.036565,172.31.36.0-255,1514,203786,9,205644
11315,0.036594,172.31.36.0-255,1486,205272,9,205644
11316,0.038003,104.244.42.0-255,66,205338,9,205644
11317,0.038043,104.244.42.0-255,66,205404,9,205644
11318,0.038156,104.244.42.0-255,66,205470,9,205644
11319,0.038991,104.244.42.0-255,108,205578,9,205644
11320,0.039001,172.31.36.0-255,66,205644,9,205644
11321,0.0,172.217.194.0-255,152,152,9,251982
11322,3.4e-05,172.31.36.0-255,66,218,9,251982
11323,4.1e-05,172.217.194.0-255,1484,1702,9,251982
11324,4.5e-05,172.31.36.0-255,66,1768,9,251982
11325,5e-05,172.217.194.0-255,2902,4670,9,251982
11326,6.2e-05,172.31.36.0-255,66,4736,9,251982
11327,6.8e-05,172.217.194.0-255,5738,10474,9,251982
11328,7e-05,172.31.36.0-255,66,10540,9,251982
11329,8.3e-05,172.217.194.0-255,1484,12024,9,251982
11330,8.5e-05,172.31.36.0-255,66,12090,9,251982
11331,0.000158,172.217.194.0-255,2048,14138,9,251982
11332,0.000163,172.31.36.0-255,66,14204,9,251982
11333,0.000193,172.217.194.0-255,2902,17106,9,251982
11334,0.000196,172.31.36.0-255,66,17172,9,251982
11335,0.000234,172.217.194.0-255,2902,20074,9,251982
11336,0.000237,172.31.36.0-255,66,20140,9,251982
11337,0.000263,172.217.194.0-255,4320,24460,9,251982
11338,0.000267,172.31.36.0-255,66,24526,9,251982
11339,0.000371,172.217.194.0-255,2902,27428,9,251982
11340,0.000375,172.31.36.0-255,66,27494,9,251982
11341,0.000396,172.217.194.0-255,3961,31455,9,251982
11342,0.000401,172.31.36.0-255,66,31521,9,251982
11343,0.000482,172.217.194.0-255,7156,38677,9,251982
11344,0.000486,172.31.36.0-255,66,38743,9,251982
11345,0.000549,172.217.194.0-255,4320,43063,9,251982
11346,0.000553,172.31.36.0-255,66,43129,9,251982
11347,0.000583,172.217.194.0-255,5379,48508,9,251982
11348,0.000587,172.31.36.0-255,66,48574,9,251982
11349,0.001123,172.217.194.0-255,1484,50058,9,251982
11350,0.001129,172.31.36.0-255,66,50124,9,251982
11351,0.001139,172.217.194.0-255,2902,53026,9,251982
11352,0.001141,172.31.36.0-255,66,53092,9,251982
11353,0.001152,172.217.194.0-255,1484,54576,9,251982
11354,0.00118,172.217.194.0-255,4320,58896,9,251982
11355,0.001265,172.217.194.0-255,3961,62857,9,251982
11356,0.001426,172.217.194.0-255,2902,65759,9,251982
11357,0.001436,172.217.194.0-255,2902,68661,9,251982
11358,0.001638,172.217.194.0-255,4320,72981,9,251982
11359,0.001655,172.217.194.0-255,4320,77301,9,251982
11360,0.001766,172.217.194.0-255,1484,78785,9,251982
11361,0.001787,172.217.194.0-255,2543,81328,9,251982
11362,0.001828,172.217.194.0-255,5738,87066,9,251982
11363,0.001886,172.217.194.0-255,2902,89968,9,251982
11364,0.002039,172.217.194.0-255,2902,92870,9,251982
11365,0.002443,172.217.194.0-255,766,93636,9,251982
11366,0.002456,172.31.36.0-255,66,93702,9,251982
11367,0.002762,172.31.36.0-255,66,93768,9,251982
11368,0.002817,172.31.36.0-255,66,93834,9,251982
11369,0.004854,172.217.194.0-255,5738,99572,9,251982
11370,0.004866,172.31.36.0-255,66,99638,9,251982
11371,0.006893,172.217.194.0-255,5738,105376,9,251982
11372,0.007847,172.31.36.0-255,66,105442,9,251982
11373,0.009876,172.217.194.0-255,5738,111180,9,251982
11374,0.009889,172.31.36.0-255,66,111246,9,251982
11375,0.011955,172.217.194.0-255,5738,116984,9,251982
11376,0.011961,172.31.36.0-255,66,117050,9,251982
11377,0.014004,172.217.194.0-255,5738,122788,9,251982
11378,0.014012,172.31.36.0-255,66,122854,9,251982
11379,0.016047,172.217.194.0-255,5738,128592,9,251982
11380,0.016054,172.31.36.0-255,66,128658,9,251982
11381,0.018102,172.217.194.0-255,5738,134396,9,251982
11382,0.018109,172.31.36.0-255,66,134462,9,251982
11383,0.02009,172.217.194.0-255,5738,140200,9,251982
11384,0.020098,172.31.36.0-255,66,140266,9,251982
11385,0.022117,172.217.194.0-255,5738,146004,9,251982
11386,0.022124,172.31.36.0-255,66,146070,9,251982
11387,0.024124,172.217.194.0-255,5738,151808,9,251982
11388,0.024131,172.31.36.0-255,66,151874,9,251982
11389,0.026177,172.217.194.0-255,5738,157612,9,251982
11390,0.026196,172.31.36.0-255,66,157678,9,251982
11391,0.028214,172.217.194.0-255,5738,163416,9,251982
11392,0.028233,172.31.36.0-255,66,163482,9,251982
11393,0.030259,172.217.194.0-255,5738,169220,9,251982
11394,0.030279,172.31.36.0-255,66,169286,9,251982
11395,0.032377,172.217.194.0-255,5738,175024,9,251982
11396,0.032387,172.31.36.0-255,66,175090,9,251982
11397,0.034453,172.217.194.0-255,5738,180828,9,251982
11398,0.034467,172.31.36.0-255,66,180894,9,251982
11399,0.036512,172.217.194.0-255,5738,186632,9,251982
11400,0.03652,172.31.36.0-255,66,186698,9,251982
11401,0.03852,172.217.194.0-255,5738,192436,9,251982
11402,0.038529,172.31.36.0-255,66,192502,9,251982
11403,0.040566,172.217.194.0-255,5738,198240,9,251982
11404,0.040573,172.31.36.0-255,66,198306,9,251982
11405,0.042553,172.217.194.0-255,5738,204044,9,251982
11406,0.042562,172.31.36.0-255,66,204110,9,251982
11407,0.04432,172.31.36.0-255,172,204282,9,251982
11408,0.04435,172.31.36.0-255,1070,205352,9,251982
11409,0.044599,172.217.194.0-255,5738,211090,9,251982
11410,0.044605,172.31.36.0-255,66,211156,9,251982
11411,0.045879,104.244.42.0-255,66,211222,9,251982
11412,0.045898,104.244.42.0-255,66,211288,9,251982
11413,0.046587,172.217.194.0-255,5738,217026,9,251982
11414,0.046596,172.31.36.0-255,66,217092,9,251982
11415,0.048594,172.217.194.0-255,5738,222830,9,251982
11416,0.0486,172.31.36.0-255,66,222896,9,251982
11417,0.050589,172.217.194.0-255,1484,224380,9,251982
11418,0.050619,172.217.194.0-255,4320,228700,9,251982
11419,0.050624,172.31.36.0-255,66,228766,9,251982
11420,0.052668,172.217.194.0-255,5738,234504,9,251982
11421,0.052674,172.31.36.0-255,66,234570,9,251982
11422,0.054684,172.217.194.0-255,5738,240308,9,251982
11423,0.054689,172.31.36.0-255,66,240374,9,251982
11424,0.056672,172.217.194.0-255,5738,246112,9,251982
11425,0.056677,172.31.36.0-255,66,246178,9,251982
11426,0.058692,172.217.194.0-255,5738,251916,9,251982
11427,0.058698,172.31.36.0-255,66,251982,9,251982
11428,0.0,74.125.68.0-255,150,150,9,382748
11429,1.7e-05,172.31.36.0-255,66,216,9,382748
11430,2.4e-05,74.125.68.0-255,1484,1700,9,382748
11431,2.8e-05,172.31.36.0-255,66,1766,9,382748
11432,3.2e-05,74.125.68.0-255,1484,3250,9,382748
11433,4.5e-05,172.31.36.0-255,66,3316,9,382748
11434,5.2e-05,74.125.68.0-255,2902,6218,9,382748
11435,5.5e-05,172.31.36.0-255,66,6284,9,382748
11436,6.1e-05,74.125.68.0-255,5738,12022,9,382748
11437,6.4e-05,172.31.36.0-255,66,12088,9,382748
11438,0.000107,74.125.68.0-255,2051,14139,9,382748
11439,0.00011,172.31.36.0-255,66,14205,9,382748
11440,0.000158,74.125.68.0-255,1484,15689,9,382748
11441,0.000162,172.31.36.0-255,66,15755,9,382748
11442,0.000167,74.125.68.0-255,2902,18657,9,382748
11443,0.00017,172.31.36.0-255,66,18723,9,382748
11444,0.000204,74.125.68.0-255,5738,24461,9,382748
11445,0.000206,172.31.36.0-255,66,24527,9,382748
11446,0.000239,74.125.68.0-255,6797,31324,9,382748
11447,0.000242,172.31.36.0-255,66,31390,9,382748
11448,0.000267,74.125.68.0-255,4320,35710,9,382748
11449,0.000269,172.31.36.0-255,66,35776,9,382748
11450,0.000296,74.125.68.0-255,2902,38678,9,382748
11451,0.000299,172.31.36.0-255,66,38744,9,382748
11452,0.000303,74.125.68.0-255,2902,41646,9,382748
11453,0.000305,172.31.36.0-255,66,41712,9,382748
11454,0.000314,74.125.68.0-255,4320,46032,9,382748
11455,0.000317,172.31.36.0-255,66,46098,9,382748
11456,0.000321,74.125.68.0-255,2543,48641,9,382748
11457,0.000324,172.31.36.0-255,66,48707,9,382748
11458,0.000378,74.125.68.0-255,1484,50191,9,382748
11459,0.000381,172.31.36.0-255,66,50257,9,382748
11460,0.000387,74.125.68.0-255,2902,53159,9,382748
11461,0.000389,172.31.36.0-255,66,53225,9,382748
11462,0.000419,74.125.68.0-255,5738,58963,9,382748
11463,0.000422,172.31.36.0-255,66,59029,9,382748
11464,0.000454,74.125.68.0-255,5738,64767,9,382748
11465,0.000457,172.31.36.0-255,66,64833,9,382748
11466,0.00048,74.125.68.0-255,1459,66292,9,382748
11467,0.000506,74.125.68.0-255,353,66645,9,382748
11468,0.000509,172.31.36.0-255,66,66711,9,382748
11469,0.000596,74.125.68.0-255,1484,68195,9,382748
11470,0.0006,74.125.68.0-255,1484,69679,9,382748
11471,0.000603,172.31.36.0-255,66,69745,9,382748
11472,0.00063,74.125.68.0-255,1484,71229,9,382748
11473,0.000637,74.125.68.0-255,5738,76967,9,382748
11474,0.00064,172.31.36.0-255,66,77033,9,382748
11475,0.000648,74.125.68.0-255,6797,83830,9,382748
11476,0.000651,172.31.36.0-255,66,83896,9,382748
11477,0.00072,74.125.68.0-255,4320,88216,9,382748
11478,0.000723,172.31.36.0-255,66,88282,9,382748
11479,0.00075,74.125.68.0-255,5738,94020,9,382748
11480,0.000752,172.31.36.0-255,66,94086,9,382748
11481,0.00076,74.125.68.0-255,6797,100883,9,382748
11482,0.000762,172.31.36.0-255,66,100949,9,382748
11483,0.000944,74.125.68.0-255,1484,102433,9,382748
11484,0.000963,74.125.68.0-255,2902,105335,9,382748
11485,0.000968,172.31.36.0-255,66,105401,9,382748
11486,0.000998,74.125.68.0-255,4320,109721,9,382748
11487,0.001001,172.31.36.0-255,66,109787,9,382748
11488,0.001008,74.125.68.0-255,5738,115525,9,382748
11489,0.00101,172.31.36.0-255,66,115591,9,382748
11490,0.001056,172.31.36.0-255,66,115657,9,382748
11491,0.001062,74.125.68.0-255,4320,119977,9,382748
11492,0.001065,172.31.36.0-255,66,120043,9,382748
11493,0.001103,74.125.68.0-255,3602,123645,9,382748
11494,0.001106,172.31.36.0-255,66,123711,9,382748
11495,0.00111,74.125.68.0-255,1484,125195,9,382748
11496,0.001126,74.125.68.0-255,2902,128097,9,382748
11497,0.001129,172.31.36.0-255,66,128163,9,382748
11498,0.001132,74.125.68.0-255,1484,129647,9,382748
11499,0.001151,74.125.68.0-255,4320,133967,9,382748
11500,0.001153,172.31.36.0-255,66,134033,9,382748
11501,0.001159,74.125.68.0-255,4320,138353,9,382748
11502,0.001161,172.31.36.0-255,66,138419,9,382748
11503,0.001185,74.125.68.0-255,2902,141321,9,382748
11504,0.001187,172.31.36.0-255,66,141387,9,382748
11505,0.001199,74.125.68.0-255,5738,147125,9,382748
11506,0.001202,172.31.36.0-255,66,147191,9,382748
11507,0.001232,74.125.68.0-255,7156,154347,9,382748
11508,0.001235,74.125.68.0-255,1484,155831,9,382748
11509,0.001241,172.31.36.0-255,66,155897,9,382748
11510,0.001267,74.125.68.0-255,2184,158081,9,382748
11511,0.00127,172.31.36.0-255,66,158147,9,382748
11512,0.001276,74.125.68.0-255,4320,162467,9,382748
11513,0.001278,172.31.36.0-255,66,162533,9,382748
11514,0.001308,74.125.68.0-255,7156,169689,9,382748
11515,0.001311,172.31.36.0-255,66,169755,9,382748
11516,0.001318,74.125.68.0-255,7156,176911,9,382748
11517,0.001321,172.31.36.0-255,66,176977,9,382748
11518,0.00135,74.125.68.0-255,1484,178461,9,382748
11519,0.001364,74.125.68.0-255,766,179227,9,382748
11520,0.001369,172.31.36.0-255,66,179293,9,382748
11521,0.001404,74.125.68.0-255,1484,180777,9,382748
11522,0.001406,172.31.36.0-255,66,180843,9,382748
11523,0.001426,74.125.68.0-255,4320,185163,9,382748
11524,0.001429,172.31.36.0-255,66,185229,9,382748
11525,0.001465,74.125.68.0-255,7156,192385,9,382748
11526,0.001469,172.31.36.0-255,66,192451,9,382748
11527,0.001473,74.125.68.0-255,1484,193935,9,382748
11528,0.001506,74.125.68.0-255,7156,201091,9,382748
11529,0.00151,172.31.36.0-255,66,201157,9,382748
11530,0.001528,172.31.36.0-255,66,201223,9,382748
11531,0.001688,74.125.68.0-255,1484,202707,9,382748
11532,0.001693,74.125.68.0-255,1484,204191,9,382748
11533,0.001696,172.31.36.0-255,66,204257,9,382748
11534,0.001723,74.125.68.0-255,1484,205741,9,382748
11535,0.001729,74.125.68.0-255,5738,211479,9,382748
11536,0.001733,172.31.36.0-255,66,211545,9,382748
11537,0.001761,74.125.68.0-255,2902,214447,9,382748
11538,0.001764,172.31.36.0-255,66,214513,9,382748
11539,0.001775,74.125.68.0-255,4320,218833,9,382748
11540,0.001795,74.125.68.0-255,2902,221735,9,382748
11541,0.001815,74.125.68.0-255,5738,227473,9,382748
11542,0.001833,74.125.68.0-255,2902,230375,9,382748
11543,0.001839,74.125.68.0-255,4320,234695,9,382748
11544,0.001841,74.125.68.0-255,766,235461,9,382748
11545,0.001977,74.125.68.0-255,1484,236945,9,382748
11546,0.001982,74.125.68.0-255,1484,238429,9,382748
11547,0.001992,74.125.68.0-255,1484,239913,9,382748
11548,0.001996,74.125.68.0-255,2902,242815,9,382748
11549,0.002014,74.125.68.0-255,4320,247135,9,382748
11550,0.002027,74.125.68.0-255,1484,248619,9,382748
11551,0.002052,74.125.68.0-255,7156,255775,9,382748
11552,0.002058,74.125.68.0-255,2902,258677,9,382748
11553,0.002072,74.125.68.0-255,2902,261579,9,382748
11554,0.002084,74.125.68.0-255,1484,263063,9,382748
11555,0.0021,74.125.68.0-255,5738,268801,9,382748
11556,0.002103,74.125.68.0-255,766,269567,9,382748
11557,0.002141,74.125.68.0-255,1484,271051,9,382748
11558,0.002144,74.125.68.0-255,1484,272535,9,382748
11559,0.002162,74.125.68.0-255,1484,274019,9,382748
11560,0.002176,74.125.68.0-255,1484,275503,9,382748
11561,0.00218,74.125.68.0-255,1484,276987,9,382748
11562,0.002202,74.125.68.0-255,4320,281307,9,382748
11563,0.002225,74.125.68.0-255,5738,287045,9,382748
11564,0.002242,74.125.68.0-255,4320,291365,9,382748
11565,0.002282,74.125.68.0-255,3602,294967,9,382748
11566,0.002287,74.125.68.0-255,4320,299287,9,382748
11567,0.002295,74.125.68.0-255,7156,306443,9,382748
11568,0.002308,74.125.68.0-255,2902,309345,9,382748
11569,0.002313,74.125.68.0-255,4320,313665,9,382748
11570,0.002317,74.125.68.0-255,2902,316567,9,382748
11571,0.002338,74.125.68.0-255,2902,319469,9,382748
11572,0.002357,74.125.68.0-255,4320,323789,9,382748
11573,0.002379,74.125.68.0-255,3602,327391,9,382748
11574,0.002386,74.125.68.0-255,5738,333129,9,382748
11575,0.002399,74.125.68.0-255,2902,336031,9,382748
11576,0.002405,74.125.68.0-255,5738,341769,9,382748
11577,0.002407,74.125.68.0-255,1484,343253,9,382748
11578,0.006331,172.31.36.0-255,66,343319,9,382748
11579,0.008727,74.125.68.0-255,5738,349057,9,382748
11580,0.008735,172.31.36.0-255,66,349123,9,382748
11581,0.011109,74.125.68.0-255,4320,353443,9,382748
11582,0.011117,172.31.36.0-255,66,353509,9,382748
11583,0.011149,74.125.68.0-255,1484,354993,9,382748
11584,0.013493,74.125.68.0-255,4320,359313,9,382748
11585,0.013501,172.31.36.0-255,66,359379,9,382748
11586,0.015881,74.125.68.0-255,5738,365117,9,382748
11587,0.015895,172.31.36.0-255,66,365183,9,382748
11588,0.018275,74.125.68.0-255,5738,370921,9,382748
11589,0.018289,172.31.36.0-255,66,370987,9,382748
11590,0.02068,74.125.68.0-255,2496,373483,9,382748
11591,0.020709,172.31.36.0-255,66,373549,9,382748
11592,0.020998,172.31.36.0-255,105,373654,9,382748
11593,0.023337,74.125.68.0-255,66,373720,9,382748
11594,0.040129,172.31.36.0-255,172,373892,9,382748
11595,0.040163,172.31.36.0-255,1112,375004,9,382748
11596,0.040231,172.31.36.0-255,1514,376518,9,382748
11597,0.040233,172.31.36.0-255,1514,378032,9,382748
11598,0.040234,172.31.36.0-255,1514,379546,9,382748
11599,0.040235,172.31.36.0-255,1514,381060,9,382748
11600,0.040262,172.31.36.0-255,1490,382550,9,382748
11601,0.041658,104.244.42.0-255,66,382616,9,382748
11602,0.041698,104.244.42.0-255,66,382682,9,382748
11603,0.041858,104.244.42.0-255,66,382748,9,382748
11604,0.0,74.125.68.0-255,146,146,9,305918
11605,2.5e-05,74.125.68.0-255,1484,1630,9,305918
11606,3.3e-05,172.31.36.0-255,66,1696,9,305918
11607,3.7e-05,74.125.68.0-255,1484,3180,9,305918
11608,5.1e-05,74.125.68.0-255,1484,4664,9,305918
11609,5.4e-05,172.31.36.0-255,66,4730,9,305918
11610,6e-05,74.125.68.0-255,4320,9050,9,305918
11611,6.4e-05,172.31.36.0-255,66,9116,9,305918
11612,8.9e-05,74.125.68.0-255,4876,13992,9,305918
11613,9.2e-05,172.31.36.0-255,66,14058,9,305918
11614,0.000114,74.125.68.0-255,2902,16960,9,305918
11615,0.000117,172.31.36.0-255,66,17026,9,305918
11616,0.000122,74.125.68.0-255,4320,21346,9,305918
11617,0.000125,172.31.36.0-255,66,21412,9,305918
11618,0.000149,74.125.68.0-255,2902,24314,9,305918
11619,0.000153,172.31.36.0-255,66,24380,9,305918
11620,0.000169,74.125.68.0-255,5738,30118,9,305918
11621,0.000171,172.31.36.0-255,66,30184,9,305918
11622,0.000174,74.125.68.0-255,1125,31309,9,305918
11623,0.000286,74.125.68.0-255,1484,32793,9,305918
11624,0.000292,172.31.36.0-255,66,32859,9,305918
11625,0.000297,74.125.68.0-255,2902,35761,9,305918
11626,0.0003,172.31.36.0-255,66,35827,9,305918
11627,0.000313,74.125.68.0-255,1484,37311,9,305918
11628,0.00033,74.125.68.0-255,4320,41631,9,305918
11629,0.000333,172.31.36.0-255,66,41697,9,305918
11630,0.00034,74.125.68.0-255,6797,48494,9,305918
11631,0.000343,172.31.36.0-255,66,48560,9,305918
11632,0.000363,74.125.68.0-255,5738,54298,9,305918
11633,0.000366,172.31.36.0-255,66,54364,9,305918
11634,0.000386,74.125.68.0-255,4320,58684,9,305918
11635,0.000389,172.31.36.0-255,66,58750,9,305918
11636,0.000409,74.125.68.0-255,2902,61652,9,305918
11637,0.000412,172.31.36.0-255,66,61718,9,305918
11638,0.000415,74.125.68.0-255,1484,63202,9,305918
11639,0.00043,74.125.68.0-255,2814,66016,9,305918
11640,0.000433,172.31.36.0-255,66,66082,9,305918
11641,0.000452,74.125.68.0-255,138,66220,9,305918
11642,0.000557,74.125.68.0-255,1484,67704,9,305918
11643,0.000561,172.31.36.0-255,66,67770,9,305918
11644,0.000576,74.125.68.0-255,1484,69254,9,305918
11645,0.000589,74.125.68.0-255,1484,70738,9,305918
11646,0.000592,172.31.36.0-255,66,70804,9,305918
11647,0.000614,74.125.68.0-255,5738,76542,9,305918
11648,0.000617,172.31.36.0-255,66,76608,9,305918
11649,0.000621,74.125.68.0-255,1484,78092,9,305918
11650,0.000653,172.31.36.0-255,66,78158,9,305918
11651,0.000681,74.125.68.0-255,7156,85314,9,305918
11652,0.000684,172.31.36.0-255,66,85380,9,305918
11653,0.000714,74.125.68.0-255,2902,88282,9,305918
11654,0.000717,172.31.36.0-255,66,88348,9,305918
11655,0.000737,74.125.68.0-255,3602,91950,9,305918
11656,0.00074,172.31.36.0-255,66,92016,9,305918
11657,0.000779,74.125.68.0-255,345,92361,9,305918
11658,0.000816,74.125.68.0-255,1484,93845,9,305918
11659,0.00082,172.31.36.0-255,66,93911,9,305918
11660,0.000824,74.125.68.0-255,2902,96813,9,305918
11661,0.000828,172.31.36.0-255,66,96879,9,305918
11662,0.000838,74.125.68.0-255,1484,98363,9,305918
11663,0.000854,74.125.68.0-255,4320,102683,9,305918
11664,0.000857,172.31.36.0-255,66,102749,9,305918
11665,0.000891,172.31.36.0-255,66,102815,9,305918
11666,0.000939,172.31.36.0-255,66,102881,9,305918
11667,0.000976,74.125.68.0-255,4320,107201,9,305918
11668,0.000981,172.31.36.0-255,66,107267,9,305918
11669,0.000998,74.125.68.0-255,4320,111587,9,305918
11670,0.001001,172.31.36.0-255,66,111653,9,305918
11671,0.001031,172.31.36.0-255,66,111719,9,305918
11672,0.00106,74.125.68.0-255,4320,116039,9,305918
11673,0.001063,172.31.36.0-255,66,116105,9,305918
11674,0.001093,74.125.68.0-255,7156,123261,9,305918
11675,0.001096,172.31.36.0-255,66,123327,9,305918
11676,0.001115,74.125.68.0-255,3602,126929,9,305918
11677,0.001119,172.31.36.0-255,66,126995,9,305918
11678,0.001137,74.125.68.0-255,2902,129897,9,305918
11679,0.001141,172.31.36.0-255,66,129963,9,305918
11680,0.001158,74.125.68.0-255,1484,131447,9,305918
11681,0.001169,74.125.68.0-255,1484,132931,9,305918
11682,0.001171,172.31.36.0-255,66,132997,9,305918
11683,0.001192,172.31.36.0-255,66,133063,9,305918
11684,0.001207,74.125.68.0-255,4320,137383,9,305918
11685,0.001211,172.31.36.0-255,66,137449,9,305918
11686,0.001255,172.31.36.0-255,66,137515,9,305918
11687,0.001353,74.125.68.0-255,1484,138999,9,305918
11688,0.001367,74.125.68.0-255,2902,141901,9,305918
11689,0.00137,172.31.36.0-255,66,141967,9,305918
11690,0.001374,74.125.68.0-255,1484,143451,9,305918
11691,0.001391,74.125.68.0-255,2902,146353,9,305918
11692,0.001394,172.31.36.0-255,66,146419,9,305918
11693,0.001398,74.125.68.0-255,2902,149321,9,305918
11694,0.001401,172.31.36.0-255,66,149387,9,305918
11695,0.001419,74.125.68.0-255,2902,152289,9,305918
11696,0.001422,172.31.36.0-255,66,152355,9,305918
11697,0.00144,74.125.68.0-255,7156,159511,9,305918
11698,0.001443,172.31.36.0-255,66,159577,9,305918
11699,0.001455,74.125.68.0-255,1484,161061,9,305918
11700,0.001467,172.31.36.0-255,66,161127,9,305918
11701,0.001483,74.125.68.0-255,1484,162611,9,305918
11702,0.001487,74.125.68.0-255,766,163377,9,305918
11703,0.001489,172.31.36.0-255,66,163443,9,305918
11704,0.001744,74.125.68.0-255,1484,164927,9,305918
11705,0.001759,74.125.68.0-255,2902,167829,9,305918
11706,0.001764,172.31.36.0-255,66,167895,9,305918
11707,0.001767,74.125.68.0-255,1484,169379,9,305918
11708,0.001789,74.125.68.0-255,4320,173699,9,305918
11709,0.001792,74.125.68.0-255,1484,175183,9,305918
11710,0.001793,172.31.36.0-255,66,175249,9,305918
11711,0.001801,74.125.68.0-255,2902,178151,9,305918
11712,0.001804,172.31.36.0-255,66,178217,9,305918
11713,0.001808,74.125.68.0-255,1484,179701,9,305918
11714,0.001828,74.125.68.0-255,4320,184021,9,305918
11715,0.001831,172.31.36.0-255,66,184087,9,305918
11716,0.001834,74.125.68.0-255,1484,185571,9,305918
11717,0.001867,172.31.36.0-255,66,185637,9,305918
11718,0.001883,74.125.68.0-255,1484,187121,9,305918
11719,0.001919,172.31.36.0-255,66,187187,9,305918
11720,0.001936,74.125.68.0-255,2902,190089,9,305918
11721,0.001939,172.31.36.0-255,66,190155,9,305918
11722,0.001969,172.31.36.0-255,66,190221,9,305918
11723,0.002044,172.31.36.0-255,66,190287,9,305918
11724,0.002068,74.125.68.0-255,5738,196025,9,305918
11725,0.002071,172.31.36.0-255,66,196091,9,305918
11726,0.002084,74.125.68.0-255,2902,198993,9,305918
11727,0.002087,172.31.36.0-255,66,199059,9,305918
11728,0.002107,74.125.68.0-255,2902,201961,9,305918
11729,0.00211,172.31.36.0-255,66,202027,9,305918
11730,0.002129,74.125.68.0-255,7156,209183,9,305918
11731,0.002133,172.31.36.0-255,66,209249,9,305918
11732,0.002173,74.125.68.0-255,2902,212151,9,305918
11733,0.002178,172.31.36.0-255,66,212217,9,305918
11734,0.002194,172.31.36.0-255,66,212283,9,305918
11735,0.002237,74.125.68.0-255,1484,213767,9,305918
11736,0.002243,74.125.68.0-255,2902,216669,9,305918
11737,0.002246,172.31.36.0-255,66,216735,9,305918
11738,0.002273,74.125.68.0-255,5738,222473,9,305918
11739,0.002277,172.31.36.0-255,66,222539,9,305918
11740,0.002302,74.125.68.0-255,7156,229695,9,305918
11741,0.002305,172.31.36.0-255,66,229761,9,305918
11742,0.00233,74.125.68.0-255,2902,232663,9,305918
11743,0.002335,172.31.36.0-255,66,232729,9,305918
11744,0.00235,74.125.68.0-255,4320,237049,9,305918
11745,0.002353,172.31.36.0-255,66,237115,9,305918
11746,0.002358,74.125.68.0-255,2902,240017,9,305918
11747,0.002361,74.125.68.0-255,1484,241501,9,305918
11748,0.002361,172.31.36.0-255,66,241567,9,305918
11749,0.002373,74.125.68.0-255,1484,243051,9,305918
11750,0.002376,172.31.36.0-255,66,243117,9,305918
11751,0.002402,74.125.68.0-255,3602,246719,9,305918
11752,0.002406,172.31.36.0-255,66,246785,9,305918
11753,0.002409,74.125.68.0-255,1484,248269,9,305918
11754,0.002443,74.125.68.0-255,7156,255425,9,305918
11755,0.002448,172.31.36.0-255,66,255491,9,305918
11756,0.00248,74.125.68.0-255,4320,259811,9,305918
11757,0.002483,172.31.36.0-255,66,259877,9,305918
11758,0.002502,74.125.68.0-255,4320,264197,9,305918
11759,0.002505,172.31.36.0-255,66,264263,9,305918
11760,0.002511,74.125.68.0-255,4320,268583,9,305918
11761,0.002513,172.31.36.0-255,66,268649,9,305918
11762,0.002541,74.125.68.0-255,2902,271551,9,305918
11763,0.002545,172.31.36.0-255,66,271617,9,305918
11764,0.002552,74.125.68.0-255,5738,277355,9,305918
11765,0.002555,172.31.36.0-255,66,277421,9,305918
11766,0.002559,74.125.68.0-255,2902,280323,9,305918
11767,0.002562,172.31.36.0-255,66,280389,9,305918
11768,0.002564,74.125.68.0-255,766,281155,9,305918
11769,0.002735,74.125.68.0-255,1484,282639,9,305918
11770,0.00274,172.31.36.0-255,66,282705,9,305918
11771,0.002762,74.125.68.0-255,2902,285607,9,305918
11772,0.002765,172.31.36.0-255,66,285673,9,305918
11773,0.002792,74.125.68.0-255,4320,289993,9,305918
11774,0.002794,74.125.68.0-255,1484,291477,9,305918
11775,0.002796,172.31.36.0-255,66,291543,9,305918
11776,0.002816,74.125.68.0-255,1484,293027,9,305918
11777,0.002819,172.31.36.0-255,66,293093,9,305918
11778,0.002838,74.125.68.0-255,2902,295995,9,305918
11779,0.002841,172.31.36.0-255,66,296061,9,305918
11780,0.002844,74.125.68.0-255,420,296481,9,305918
11781,0.002925,74.125.68.0-255,105,296586,9,305918
11782,0.00705,172.31.36.0-255,66,296652,9,305918
11783,0.007077,172.31.36.0-255,105,296757,9,305918
11784,0.009278,74.125.68.0-255,66,296823,9,305918
11785,0.033834,172.31.36.0-255,172,296995,9,305918
11786,0.033875,172.31.36.0-255,1115,298110,9,305918
11787,0.033927,172.31.36.0-255,1514,299624,9,305918
11788,0.03393,172.31.36.0-255,1514,301138,9,305918
11789,0.033931,172.31.36.0-255,1514,302652,9,305918
11790,0.033932,172.31.36.0-255,1514,304166,9,305918
11791,0.033959,172.31.36.0-255,1488,305654,9,305918
11792,0.035366,104.244.42.0-255,66,305720,9,305918
11793,0.035502,104.244.42.0-255,66,305786,9,305918
11794,0.035508,104.244.42.0-255,66,305852,9,305918
11795,0.035587,104.244.42.0-255,66,305918,9,305918
11796,0.0,172.217.194.0-255,220,220,9,172661
11797,1.4e-05,172.217.194.0-255,1484,1704,9,172661
11798,2.2e-05,172.31.36.0-255,66,1770,9,172661
11799,3e-05,172.217.194.0-255,4320,6090,9,172661
11800,3.4e-05,172.31.36.0-255,66,6156,9,172661
11801,4.6e-05,172.217.194.0-255,2902,9058,9,172661
11802,5e-05,172.31.36.0-255,66,9124,9,172661
11803,7.7e-05,172.217.194.0-255,4320,13444,9,172661
11804,8e-05,172.31.36.0-255,66,13510,9,172661
11805,0.000113,172.31.36.0-255,66,13576,9,172661
11806,0.000125,172.31.36.0-255,66,13642,9,172661
11807,0.000128,172.217.194.0-255,1125,14767,9,172661
11808,0.000249,172.217.194.0-255,1484,16251,9,172661
11809,0.000252,172.31.36.0-255,66,16317,9,172661
11810,0.000258,172.217.194.0-255,2902,19219,9,172661
11811,0.00026,172.31.36.0-255,66,19285,9,172661
11812,0.000282,172.217.194.0-255,5738,25023,9,172661
11813,0.000285,172.31.36.0-255,66,25089,9,172661
11814,0.000321,172.217.194.0-255,6797,31886,9,172661
11815,0.000325,172.31.36.0-255,66,31952,9,172661
11816,0.000354,172.217.194.0-255,7156,39108,9,172661
11817,0.000357,172.31.36.0-255,66,39174,9,172661
11818,0.00036,172.217.194.0-255,1484,40658,9,172661
11819,0.000405,172.217.194.0-255,5738,46396,9,172661
11820,0.000408,172.31.36.0-255,66,46462,9,172661
11821,0.000425,172.217.194.0-255,2543,49005,9,172661
11822,0.000428,172.31.36.0-255,66,49071,9,172661
11823,0.000837,172.217.194.0-255,648,49719,9,172661
11824,0.000923,172.217.194.0-255,1484,51203,9,172661
11825,0.000928,172.31.36.0-255,66,51269,9,172661
11826,0.000933,172.217.194.0-255,2902,54171,9,172661
11827,0.000936,172.31.36.0-255,66,54237,9,172661
11828,0.000967,172.217.194.0-255,5738,59975,9,172661
11829,0.00097,172.31.36.0-255,66,60041,9,172661
11830,0.000976,172.217.194.0-255,5738,65779,9,172661
11831,0.000978,172.31.36.0-255,66,65845,9,172661
11832,0.00099,172.217.194.0-255,5738,71583,9,172661
11833,0.000993,172.31.36.0-255,66,71649,9,172661
11834,0.00102,172.217.194.0-255,7156,78805,9,172661
11835,0.001023,172.31.36.0-255,66,78871,9,172661
11836,0.00103,172.217.194.0-255,5020,83891,9,172661
11837,0.001032,172.31.36.0-255,66,83957,9,172661
11838,0.001499,172.217.194.0-255,1484,85441,9,172661
11839,0.001508,172.217.194.0-255,2902,88343,9,172661
11840,0.001513,172.31.36.0-255,66,88409,9,172661
11841,0.001521,172.217.194.0-255,5738,94147,9,172661
11842,0.001523,172.31.36.0-255,66,94213,9,172661
11843,0.001556,172.31.36.0-255,66,94279,9,172661
11844,0.001592,172.31.36.0-255,66,94345,9,172661
11845,0.00164,172.217.194.0-255,5020,99365,9,172661
11846,0.001644,172.31.36.0-255,66,99431,9,172661
11847,0.001712,172.217.194.0-255,1484,100915,9,172661
11848,0.001717,172.217.194.0-255,1484,102399,9,172661
11849,0.00172,172.31.36.0-255,66,102465,9,172661
11850,0.001751,172.217.194.0-255,1484,103949,9,172661
11851,0.001759,172.217.194.0-255,5738,109687,9,172661
11852,0.001762,172.31.36.0-255,66,109753,9,172661
11853,0.001769,172.217.194.0-255,7156,116909,9,172661
11854,0.001772,172.31.36.0-255,66,116975,9,172661
11855,0.001809,172.217.194.0-255,5738,122713,9,172661
11856,0.001812,172.31.36.0-255,66,122779,9,172661
11857,0.001823,172.31.36.0-255,66,122845,9,172661
11858,0.001868,172.31.36.0-255,66,122911,9,172661
11859,0.00189,172.217.194.0-255,7156,130067,9,172661
11860,0.001893,172.31.36.0-255,66,130133,9,172661
11861,0.001925,172.217.194.0-255,6438,136571,9,172661
11862,0.001928,172.31.36.0-255,66,136637,9,172661
11863,0.001932,172.217.194.0-255,1484,138121,9,172661
11864,0.001936,172.217.194.0-255,2902,141023,9,172661
11865,0.001939,172.31.36.0-255,66,141089,9,172661
11866,0.001944,172.217.194.0-255,4320,145409,9,172661
11867,0.001948,172.31.36.0-255,66,145475,9,172661
11868,0.001991,172.217.194.0-255,1484,146959,9,172661
11869,0.002008,172.31.36.0-255,66,147025,9,172661
11870,0.002021,172.31.36.0-255,66,147091,9,172661
11871,0.002064,172.217.194.0-255,1484,148575,9,172661
11872,0.002084,172.217.194.0-255,1484,150059,9,172661
11873,0.002087,172.31.36.0-255,66,150125,9,172661
11874,0.002093,172.217.194.0-255,4320,154445,9,172661
11875,0.002095,172.31.36.0-255,66,154511,9,172661
11876,0.002106,172.31.36.0-255,66,154577,9,172661
11877,0.002127,172.31.36.0-255,66,154643,9,172661
11878,0.00214,172.31.36.0-255,66,154709,9,172661
11879,0.002172,172.31.36.0-255,66,154775,9,172661
11880,0.002184,172.31.36.0-255,66,154841,9,172661
11881,0.002221,172.217.194.0-255,3602,158443,9,172661
11882,0.002225,172.31.36.0-255,66,158509,9,172661
11883,0.002255,172.31.36.0-255,66,158575,9,172661
11884,0.002269,172.31.36.0-255,66,158641,9,172661
11885,0.002305,172.31.36.0-255,66,158707,9,172661
11886,0.002311,172.217.194.0-255,4320,163027,9,172661
11887,0.002313,172.31.36.0-255,66,163093,9,172661
11888,0.002364,172.31.36.0-255,66,163159,9,172661
11889,0.002378,172.31.36.0-255,66,163225,9,172661
11890,0.002392,172.31.36.0-255,66,163291,9,172661
11891,0.002395,172.217.194.0-255,105,163396,9,172661
11892,0.006012,172.31.36.0-255,105,163501,9,172661
11893,0.008254,172.217.194.0-255,66,163567,9,172661
11894,0.043491,172.31.36.0-255,172,163739,9,172661
11895,0.043527,172.31.36.0-255,1115,164854,9,172661
11896,0.043592,172.31.36.0-255,1514,166368,9,172661
11897,0.043594,172.31.36.0-255,1514,167882,9,172661
11898,0.043595,172.31.36.0-255,1514,169396,9,172661
11899,0.043596,172.31.36.0-255,1514,170910,9,172661
11900,0.043625,172.31.36.0-255,1487,172397,9,172661
11901,0.045044,104.244.42.0-255,66,172463,9,172661
11902,0.045077,104.244.42.0-255,66,172529,9,172661
11903,0.045136,104.244.42.0-255,66,172595,9,172661
11904,0.045182,104.244.42.0-255,66,172661,9,172661
11905,0.0,172.217.194.0-255,143,143,9,156259
11906,2.2e-05,172.31.36.0-255,66,209,9,156259
11907,2.9e-05,172.217.194.0-255,1484,1693,9,156259
11908,3.3e-05,172.31.36.0-255,66,1759,9,156259
11909,4.7e-05,172.217.194.0-255,2902,4661,9,156259
11910,5e-05,172.31.36.0-255,66,4727,9,156259
11911,5.5e-05,172.217.194.0-255,2902,7629,9,156259
11912,5.9e-05,172.31.36.0-255,66,7695,9,156259
11913,6.5e-05,172.217.194.0-255,4320,12015,9,156259
11914,6.8e-05,172.31.36.0-255,66,12081,9,156259
11915,8e-05,172.31.36.0-255,66,12147,9,156259
11916,9.3e-05,172.31.36.0-255,66,12213,9,156259
11917,0.000158,172.217.194.0-255,1484,13697,9,156259
11918,0.000161,172.31.36.0-255,66,13763,9,156259
11919,0.000166,172.217.194.0-255,2902,16665,9,156259
11920,0.000168,172.31.36.0-255,66,16731,9,156259
11921,0.000172,172.217.194.0-255,1484,18215,9,156259
11922,0.00018,172.31.36.0-255,66,18281,9,156259
11923,0.000208,172.217.194.0-255,4320,22601,9,156259
11924,0.000214,172.31.36.0-255,66,22667,9,156259
11925,0.000226,172.31.36.0-255,66,22733,9,156259
11926,0.000265,172.217.194.0-255,5379,28112,9,156259
11927,0.000268,172.31.36.0-255,66,28178,9,156259
11928,0.000285,172.31.36.0-255,66,28244,9,156259
11929,0.000288,172.217.194.0-255,365,28609,9,156259
11930,0.00029,172.31.36.0-255,66,28675,9,156259
11931,0.000355,172.217.194.0-255,1484,30159,9,156259
11932,0.000358,172.31.36.0-255,66,30225,9,156259
11933,0.000363,172.217.194.0-255,2902,33127,9,156259
11934,0.000365,172.31.36.0-255,66,33193,9,156259
11935,0.000368,172.217.194.0-255,1484,34677,9,156259
11936,0.000403,172.217.194.0-255,4320,38997,9,156259
11937,0.000406,172.31.36.0-255,66,39063,9,156259
11938,0.000412,172.217.194.0-255,5738,44801,9,156259
11939,0.000415,172.31.36.0-255,66,44867,9,156259
11940,0.000436,172.31.36.0-255,66,44933,9,156259
11941,0.000439,172.217.194.0-255,766,45699,9,156259
11942,0.000497,172.217.194.0-255,1484,47183,9,156259
11943,0.0005,172.31.36.0-255,66,47249,9,156259
11944,0.000506,172.217.194.0-255,2902,50151,9,156259
11945,0.000508,172.31.36.0-255,66,50217,9,156259
11946,0.000511,172.217.194.0-255,1484,51701,9,156259
11947,0.000542,172.217.194.0-255,4320,56021,9,156259
11948,0.000545,172.31.36.0-255,66,56087,9,156259
11949,0.000563,172.31.36.0-255,66,56153,9,156259
11950,0.000591,172.217.194.0-255,7156,63309,9,156259
11951,0.000594,172.31.36.0-255,66,63375,9,156259
11952,0.000623,172.217.194.0-255,3053,66428,9,156259
11953,0.000626,172.31.36.0-255,66,66494,9,156259
11954,0.000629,172.217.194.0-255,1484,67978,9,156259
11955,0.000653,172.217.194.0-255,2902,70880,9,156259
11956,0.000656,172.31.36.0-255,66,70946,9,156259
11957,0.000662,172.217.194.0-255,5738,76684,9,156259
11958,0.000665,172.31.36.0-255,66,76750,9,156259
11959,0.000694,172.31.36.0-255,66,76816,9,156259
11960,0.000706,172.31.36.0-255,66,76882,9,156259
11961,0.000734,172.217.194.0-255,2184,79066,9,156259
11962,0.000737,172.31.36.0-255,66,79132,9,156259
11963,0.00077,172.217.194.0-255,2902,82034,9,156259
11964,0.000772,172.31.36.0-255,66,82100,9,156259
11965,0.000804,172.217.194.0-255,7156,89256,9,156259
11966,0.000807,172.31.36.0-255,66,89322,9,156259
11967,0.000811,172.217.194.0-255,2902,92224,9,156259
11968,0.000813,172.31.36.0-255,66,92290,9,156259
11969,0.000845,172.31.36.0-255,66,92356,9,156259
11970,0.000858,172.31.36.0-255,66,92422,9,156259
11971,0.000885,172.217.194.0-255,3602,96024,9,156259
11972,0.000887,172.31.36.0-255,66,96090,9,156259
11973,0.00094,172.31.36.0-255,66,96156,9,156259
11974,0.000981,172.217.194.0-255,2902,99058,9,156259
11975,0.000984,172.31.36.0-255,66,99124,9,156259
11976,0.00099,172.217.194.0-255,5738,104862,9,156259
11977,0.000993,172.31.36.0-255,66,104928,9,156259
11978,0.00101,172.31.36.0-255,66,104994,9,156259
11979,0.001013,172.217.194.0-255,1484,106478,9,156259
11980,0.001017,172.217.194.0-255,2902,109380,9,156259
11981,0.001019,172.31.36.0-255,66,109446,9,156259
11982,0.001022,172.217.194.0-255,1484,110930,9,156259
11983,0.00105,172.217.194.0-255,4320,115250,9,156259
11984,0.001053,172.31.36.0-255,66,115316,9,156259
11985,0.001068,172.31.36.0-255,66,115382,9,156259
11986,0.00112,172.31.36.0-255,66,115448,9,156259
11987,0.001146,172.217.194.0-255,2902,118350,9,156259
11988,0.001149,172.31.36.0-255,66,118416,9,156259
11989,0.001187,172.31.36.0-255,66,118482,9,156259
11990,0.001208,172.31.36.0-255,66,118548,9,156259
11991,0.001222,172.31.36.0-255,66,118614,9,156259
11992,0.001264,172.217.194.0-255,5738,124352,9,156259
11993,0.001268,172.31.36.0-255,66,124418,9,156259
11994,0.0013,172.31.36.0-255,66,124484,9,156259
11995,0.001306,172.217.194.0-255,4320,128804,9,156259
11996,0.001309,172.31.36.0-255,66,128870,9,156259
11997,0.001314,172.217.194.0-255,2902,131772,9,156259
11998,0.001316,172.31.36.0-255,66,131838,9,156259
11999,0.001341,172.217.194.0-255,2902,134740,9,156259
12000,0.001343,172.31.36.0-255,66,134806,9,156259
12001,0.001361,172.31.36.0-255,66,134872,9,156259
12002,0.001371,172.31.36.0-255,66,134938,9,156259
12003,0.001408,172.217.194.0-255,3602,138540,9,156259
12004,0.001411,172.31.36.0-255,66,138606,9,156259
12005,0.001415,172.217.194.0-255,2902,141508,9,156259
12006,0.001417,172.31.36.0-255,66,141574,9,156259
12007,0.001437,172.217.194.0-255,1484,143058,9,156259
12008,0.001455,172.31.36.0-255,66,143124,9,156259
12009,0.001465,172.31.36.0-255,66,143190,9,156259
12010,0.001527,172.31.36.0-255,66,143256,9,156259
12011,0.001533,172.217.194.0-255,3500,146756,9,156259
12012,0.001535,172.31.36.0-255,66,146822,9,156259
12013,0.001538,172.217.194.0-255,105,146927,9,156259
12014,0.005102,172.31.36.0-255,66,146993,9,156259
12015,0.005143,172.31.36.0-255,105,147098,9,156259
12016,0.007404,172.217.194.0-255,66,147164,9,156259
12017,0.036213,172.31.36.0-255,172,147336,9,156259
12018,0.036245,172.31.36.0-255,1112,148448,9,156259
12019,0.036313,172.31.36.0-255,1514,149962,9,156259
12020,0.036314,172.31.36.0-255,1514,151476,9,156259
12021,0.036321,172.31.36.0-255,1514,152990,9,156259
12022,0.036322,172.31.36.0-255,1514,154504,9,156259
12023,0.036341,172.31.36.0-255,1491,155995,9,156259
12024,0.037729,104.244.42.0-255,66,156061,9,156259
12025,0.037754,104.244.42.0-255,66,156127,9,156259
12026,0.037869,104.244.42.0-255,66,156193,9,156259
12027,0.037875,104.244.42.0-255,66,156259,9,156259
12028,0.0,172.31.36.0-255,105,105,9,459
12029,0.000372,172.31.36.0-255,90,195,9,459
12030,0.000383,172.31.36.0-255,66,261,9,459
12031,0.003038,74.125.24.0-255,66,327,9,459
12032,0.003068,74.125.24.0-255,66,393,9,459
12033,0.00309,172.31.36.0-255,66,459,9,459
12034,0.0,172.31.36.0-255,105,105,9,525
12035,0.000219,172.31.36.0-255,90,195,9,525
12036,0.000231,172.31.36.0-255,66,261,9,525
12037,0.002493,74.125.24.0-255,66,327,9,525
12038,0.002506,74.125.24.0-255,66,393,9,525
12039,0.002512,172.31.36.0-255,66,459,9,525
12040,0.002516,74.125.24.0-255,66,525,9,525
12041,0.0,74.125.24.0-255,189,189,9,334843
12042,1.1e-05,172.31.36.0-255,66,255,9,334843
12043,1.7e-05,74.125.24.0-255,1484,1739,9,334843
12044,2.1e-05,172.31.36.0-255,66,1805,9,334843
12045,2.6e-05,74.125.24.0-255,2902,4707,9,334843
12046,3.4e-05,172.31.36.0-255,66,4773,9,334843
12047,5.5e-05,74.125.24.0-255,4320,9093,9,334843
12048,5.9e-05,172.31.36.0-255,66,9159,9,334843
12049,0.000101,74.125.24.0-255,2902,12061,9,334843
12050,0.000104,172.31.36.0-255,66,12127,9,334843
12051,0.000108,74.125.24.0-255,1484,13611,9,334843
12052,0.00011,172.31.36.0-255,66,13677,9,334843
12053,0.000124,172.31.36.0-255,66,13743,9,334843
12054,0.000131,74.125.24.0-255,6797,20540,9,334843
12055,0.000134,172.31.36.0-255,66,20606,9,334843
12056,0.000207,74.125.24.0-255,1484,22090,9,334843
12057,0.00021,172.31.36.0-255,66,22156,9,334843
12058,0.000214,74.125.24.0-255,1484,23640,9,334843
12059,0.000216,172.31.36.0-255,66,23706,9,334843
12060,0.000238,74.125.24.0-255,1484,25190,9,334843
12061,0.000244,172.31.36.0-255,66,25256,9,334843
12062,0.000251,74.125.24.0-255,5738,30994,9,334843
12063,0.000253,172.31.36.0-255,66,31060,9,334843
12064,0.000261,74.125.24.0-255,6797,37857,9,334843
12065,0.000263,172.31.36.0-255,66,37923,9,334843
12066,0.000296,74.125.24.0-255,7156,45079,9,334843
12067,0.000299,172.31.36.0-255,66,45145,9,334843
12068,0.000333,74.125.24.0-255,7156,52301,9,334843
12069,0.000336,172.31.36.0-255,66,52367,9,334843
12070,0.00034,74.125.24.0-255,2850,55217,9,334843
12071,0.000342,172.31.36.0-255,66,55283,9,334843
12072,0.000399,74.125.24.0-255,347,55630,9,334843
12073,0.000585,74.125.24.0-255,1484,57114,9,334843
12074,0.00059,172.31.36.0-255,66,57180,9,334843
12075,0.000596,74.125.24.0-255,2902,60082,9,334843
12076,0.000599,172.31.36.0-255,66,60148,9,334843
12077,0.000629,74.125.24.0-255,5738,65886,9,334843
12078,0.000633,172.31.36.0-255,66,65952,9,334843
12079,0.000683,172.31.36.0-255,66,66018,9,334843
12080,0.000691,74.125.24.0-255,7156,73174,9,334843
12081,0.000694,172.31.36.0-255,66,73240,9,334843
12082,0.000729,74.125.24.0-255,5379,78619,9,334843
12083,0.000732,172.31.36.0-255,66,78685,9,334843
12084,0.001241,74.125.24.0-255,1484,80169,9,334843
12085,0.001248,74.125.24.0-255,2902,83071,9,334843
12086,0.001251,172.31.36.0-255,66,83137,9,334843
12087,0.001288,74.125.24.0-255,5738,88875,9,334843
12088,0.001291,172.31.36.0-255,66,88941,9,334843
12089,0.001298,74.125.24.0-255,7156,96097,9,334843
12090,0.001301,172.31.36.0-255,66,96163,9,334843
12091,0.001308,74.125.24.0-255,7156,103319,9,334843
12092,0.001315,172.31.36.0-255,66,103385,9,334843
12093,0.001349,74.125.24.0-255,7156,110541,9,334843
12094,0.001356,172.31.36.0-255,66,110607,9,334843
12095,0.001384,74.125.24.0-255,2184,112791,9,334843
12096,0.001391,172.31.36.0-255,66,112857,9,334843
12097,0.001558,74.125.24.0-255,1484,114341,9,334843
12098,0.001562,74.125.24.0-255,1484,115825,9,334843
12099,0.001565,172.31.36.0-255,66,115891,9,334843
12100,0.001576,74.125.24.0-255,1484,117375,9,334843
12101,0.001603,74.125.24.0-255,5738,123113,9,334843
12102,0.001605,172.31.36.0-255,66,123179,9,334843
12103,0.001627,172.31.36.0-255,66,123245,9,334843
12104,0.001636,74.125.24.0-255,7156,130401,9,334843
12105,0.001638,172.31.36.0-255,66,130467,9,334843
12106,0.001672,74.125.24.0-255,4320,134787,9,334843
12107,0.001675,172.31.36.0-255,66,134853,9,334843
12108,0.001679,74.125.24.0-255,2184,137037,9,334843
12109,0.001681,172.31.36.0-255,66,137103,9,334843
12110,0.001687,74.125.24.0-255,2902,140005,9,334843
12111,0.001694,172.31.36.0-255,66,140071,9,334843
12112,0.001697,74.125.24.0-255,1484,141555,9,334843
12113,0.001721,74.125.24.0-255,1484,143039,9,334843
12114,0.001723,172.31.36.0-255,66,143105,9,334843
12115,0.001735,74.125.24.0-255,7156,150261,9,334843
12116,0.001738,172.31.36.0-255,66,150327,9,334843
12117,0.001741,74.125.24.0-255,1484,151811,9,334843
12118,0.001791,172.31.36.0-255,66,151877,9,334843
12119,0.001798,74.125.24.0-255,5020,156897,9,334843
12120,0.0018,172.31.36.0-255,66,156963,9,334843
12121,0.002048,74.125.24.0-255,1484,158447,9,334843
12122,0.002068,74.125.24.0-255,2902,161349,9,334843
12123,0.002072,172.31.36.0-255,66,161415,9,334843
12124,0.002079,74.125.24.0-255,5738,167153,9,334843
12125,0.002081,172.31.36.0-255,66,167219,9,334843
12126,0.002085,74.125.24.0-255,2902,170121,9,334843
12127,0.002087,172.31.36.0-255,66,170187,9,334843
12128,0.002123,74.125.24.0-255,5738,175925,9,334843
12129,0.002127,172.31.36.0-255,66,175991,9,334843
12130,0.004207,74.125.24.0-255,5738,181729,9,334843
12131,0.004214,172.31.36.0-255,66,181795,9,334843
12132,0.006267,74.125.24.0-255,5738,187533,9,334843
12133,0.006271,172.31.36.0-255,66,187599,9,334843
12134,0.008332,74.125.24.0-255,5738,193337,9,334843
12135,0.008336,172.31.36.0-255,66,193403,9,334843
12136,0.010435,74.125.24.0-255,4320,197723,9,334843
12137,0.010442,172.31.36.0-255,66,197789,9,334843
12138,0.010473,74.125.24.0-255,1484,199273,9,334843
12139,0.012522,74.125.24.0-255,4320,203593,9,334843
12140,0.01253,172.31.36.0-255,66,203659,9,334843
12141,0.01461,74.125.24.0-255,5738,209397,9,334843
12142,0.014618,172.31.36.0-255,66,209463,9,334843
12143,0.016721,74.125.24.0-255,4320,213783,9,334843
12144,0.016729,172.31.36.0-255,66,213849,9,334843
12145,0.016758,74.125.24.0-255,1484,215333,9,334843
12146,0.018809,74.125.24.0-255,4320,219653,9,334843
12147,0.018818,172.31.36.0-255,66,219719,9,334843
12148,0.020898,74.125.24.0-255,5738,225457,9,334843
12149,0.020905,172.31.36.0-255,66,225523,9,334843
12150,0.022996,74.125.24.0-255,5738,231261,9,334843
12151,0.023003,172.31.36.0-255,66,231327,9,334843
12152,0.025086,74.125.24.0-255,5738,237065,9,334843
12153,0.025098,172.31.36.0-255,66,237131,9,334843
12154,0.027162,74.125.24.0-255,5738,242869,9,334843
12155,0.027171,172.31.36.0-255,66,242935,9,334843
12156,0.029256,74.125.24.0-255,4320,247255,9,334843
12157,0.029264,172.31.36.0-255,66,247321,9,334843
12158,0.029291,74.125.24.0-255,1484,248805,9,334843
12159,0.031326,74.125.24.0-255,4320,253125,9,334843
12160,0.031333,172.31.36.0-255,66,253191,9,334843
12161,0.033406,74.125.24.0-255,5738,258929,9,334843
12162,0.033414,172.31.36.0-255,66,258995,9,334843
12163,0.035496,74.125.24.0-255,5738,264733,9,334843
12164,0.035504,172.31.36.0-255,66,264799,9,334843
12165,0.037588,74.125.24.0-255,5738,270537,9,334843
12166,0.037596,172.31.36.0-255,66,270603,9,334843
12167,0.0397,74.125.24.0-255,5738,276341,9,334843
12168,0.039709,172.31.36.0-255,66,276407,9,334843
12169,0.041779,74.125.24.0-255,5738,282145,9,334843
12170,0.041787,172.31.36.0-255,66,282211,9,334843
12171,0.043841,74.125.24.0-255,5738,287949,9,334843
12172,0.043848,172.31.36.0-255,66,288015,9,334843
12173,0.045953,74.125.24.0-255,5738,293753,9,334843
12174,0.045961,172.31.36.0-255,66,293819,9,334843
12175,0.048042,74.125.24.0-255,5738,299557,9,334843
12176,0.048049,172.31.36.0-255,66,299623,9,334843
12177,0.050147,74.125.24.0-255,5738,305361,9,334843
12178,0.050155,172.31.36.0-255,66,305427,9,334843
12179,0.052223,74.125.24.0-255,5738,311165,9,334843
12180,0.05223,172.31.36.0-255,66,311231,9,334843
12181,0.054306,74.125.24.0-255,5738,316969,9,334843
12182,0.054314,172.31.36.0-255,66,317035,9,334843
12183,0.056398,74.125.24.0-255,5738,322773,9,334843
12184,0.056404,172.31.36.0-255,66,322839,9,334843
12185,0.056643,172.31.36.0-255,172,323011,9,334843
12186,0.056673,172.31.36.0-255,1117,324128,9,334843
12187,0.056744,172.31.36.0-255,1514,325642,9,334843
12188,0.056745,172.31.36.0-255,1514,327156,9,334843
12189,0.05675,172.31.36.0-255,1514,328670,9,334843
12190,0.056751,172.31.36.0-255,105,328775,9,334843
12191,0.058208,104.244.42.0-255,66,328841,9,334843
12192,0.058257,104.244.42.0-255,66,328907,9,334843
12193,0.058305,104.244.42.0-255,66,328973,9,334843
12194,0.05831,104.244.42.0-255,66,329039,9,334843
12195,0.058503,74.125.24.0-255,5738,334777,9,334843
12196,0.058509,172.31.36.0-255,66,334843,9,334843
12197,0.0,172.31.36.0-255,66,66,9,66
