,TIME,SRC,PACKET_SIZE,CUMULATIVE_PACKET_SIZE,PAGE_NUMBER,TOTAL_PACKET_SIZE
0,0.0,74.125.200.0-255,153,153,13,396132
1,1.6e-05,172.31.36.0-255,66,219,13,396132
2,2.4e-05,74.125.200.0-255,1484,1703,13,396132
3,2.9e-05,172.31.36.0-255,66,1769,13,396132
4,3.5e-05,74.125.200.0-255,2902,4671,13,396132
5,3.8e-05,172.31.36.0-255,66,4737,13,396132
6,4.6e-05,74.125.200.0-255,7156,11893,13,396132
7,4.9e-05,172.31.36.0-255,66,11959,13,396132
8,5.3e-05,74.125.200.0-255,2039,13998,13,396132
9,5.5e-05,172.31.36.0-255,66,14064,13,396132
10,0.000121,74.125.200.0-255,1484,15548,13,396132
11,0.000123,172.31.36.0-255,66,15614,13,396132
12,0.000129,74.125.200.0-255,2902,18516,13,396132
13,0.000131,172.31.36.0-255,66,18582,13,396132
14,0.000134,74.125.200.0-255,1484,20066,13,396132
15,0.000136,172.31.36.0-255,66,20132,13,396132
16,0.000156,74.125.200.0-255,2902,23034,13,396132
17,0.000158,172.31.36.0-255,66,23100,13,396132
18,0.000181,74.125.200.0-255,1484,24584,13,396132
19,0.000183,172.31.36.0-255,66,24650,13,396132
20,0.000199,74.125.200.0-255,6797,31447,13,396132
21,0.000201,172.31.36.0-255,66,31513,13,396132
22,0.000329,74.125.200.0-255,1484,32997,13,396132
23,0.000334,172.31.36.0-255,66,33063,13,396132
24,0.000339,74.125.200.0-255,2902,35965,13,396132
25,0.000342,172.31.36.0-255,66,36031,13,396132
26,0.000345,74.125.200.0-255,1484,37515,13,396132
27,0.000347,172.31.36.0-255,66,37581,13,396132
28,0.000373,74.125.200.0-255,4320,41901,13,396132
29,0.000376,172.31.36.0-255,66,41967,13,396132
30,0.000382,74.125.200.0-255,4320,46287,13,396132
31,0.000384,172.31.36.0-255,66,46353,13,396132
32,0.000396,74.125.200.0-255,2543,48896,13,396132
33,0.000399,172.31.36.0-255,66,48962,13,396132
34,0.000406,74.125.200.0-255,5738,54700,13,396132
35,0.000408,172.31.36.0-255,66,54766,13,396132
36,0.00043,74.125.200.0-255,1484,56250,13,396132
37,0.000436,74.125.200.0-255,4320,60570,13,396132
38,0.000438,172.31.36.0-255,66,60636,13,396132
39,0.000458,74.125.200.0-255,1484,62120,13,396132
40,0.000483,74.125.200.0-255,2902,65022,13,396132
41,0.000486,172.31.36.0-255,66,65088,13,396132
42,0.0005,74.125.200.0-255,1470,66558,13,396132
43,0.000503,74.125.200.0-255,333,66891,13,396132
44,0.000506,172.31.36.0-255,66,66957,13,396132
45,0.000688,74.125.200.0-255,1484,68441,13,396132
46,0.000692,74.125.200.0-255,1484,69925,13,396132
47,0.000696,172.31.36.0-255,66,69991,13,396132
48,0.000713,74.125.200.0-255,1484,71475,13,396132
49,0.000742,74.125.200.0-255,4320,75795,13,396132
50,0.000744,172.31.36.0-255,66,75861,13,396132
51,0.000764,74.125.200.0-255,1484,77345,13,396132
52,0.000772,74.125.200.0-255,8574,85919,13,396132
53,0.000775,172.31.36.0-255,66,85985,13,396132
54,0.000784,74.125.200.0-255,9992,95977,13,396132
55,0.000787,172.31.36.0-255,66,96043,13,396132
56,0.000793,74.125.200.0-255,5020,101063,13,396132
57,0.000795,172.31.36.0-255,66,101129,13,396132
58,0.000949,74.125.200.0-255,1484,102613,13,396132
59,0.000971,74.125.200.0-255,2902,105515,13,396132
60,0.000975,172.31.36.0-255,66,105581,13,396132
61,0.001001,74.125.200.0-255,1484,107065,13,396132
62,0.001021,74.125.200.0-255,2902,109967,13,396132
63,0.001026,172.31.36.0-255,66,110033,13,396132
64,0.001048,74.125.200.0-255,5738,115771,13,396132
65,0.001051,172.31.36.0-255,66,115837,13,396132
66,0.001055,74.125.200.0-255,2902,118739,13,396132
67,0.001057,172.31.36.0-255,66,118805,13,396132
68,0.001063,74.125.200.0-255,4320,123125,13,396132
69,0.001065,172.31.36.0-255,66,123191,13,396132
70,0.001099,74.125.200.0-255,8574,131765,13,396132
71,0.001101,172.31.36.0-255,66,131831,13,396132
72,0.001105,74.125.200.0-255,1484,133315,13,396132
73,0.001129,74.125.200.0-255,2184,135499,13,396132
74,0.001131,172.31.36.0-255,66,135565,13,396132
75,0.001195,74.125.200.0-255,1484,137049,13,396132
76,0.001217,74.125.200.0-255,2902,139951,13,396132
77,0.00122,172.31.36.0-255,66,140017,13,396132
78,0.001241,74.125.200.0-255,5738,145755,13,396132
79,0.001244,172.31.36.0-255,66,145821,13,396132
80,0.001247,74.125.200.0-255,1484,147305,13,396132
81,0.001262,74.125.200.0-255,1484,148789,13,396132
82,0.001265,172.31.36.0-255,66,148855,13,396132
83,0.00127,74.125.200.0-255,4320,153175,13,396132
84,0.001272,172.31.36.0-255,66,153241,13,396132
85,0.001297,74.125.200.0-255,1484,154725,13,396132
86,0.00131,74.125.200.0-255,2902,157627,13,396132
87,0.001313,172.31.36.0-255,66,157693,13,396132
88,0.001338,74.125.200.0-255,5738,163431,13,396132
89,0.00134,172.31.36.0-255,66,163497,13,396132
90,0.001371,74.125.200.0-255,5738,169235,13,396132
91,0.001374,172.31.36.0-255,66,169301,13,396132
92,0.001392,74.125.200.0-255,766,170067,13,396132
93,0.001467,74.125.200.0-255,1484,171551,13,396132
94,0.001471,172.31.36.0-255,66,171617,13,396132
95,0.001475,74.125.200.0-255,1484,173101,13,396132
96,0.00149,74.125.200.0-255,1484,174585,13,396132
97,0.001492,172.31.36.0-255,66,174651,13,396132
98,0.001526,74.125.200.0-255,1484,176135,13,396132
99,0.001531,74.125.200.0-255,2902,179037,13,396132
100,0.001535,172.31.36.0-255,66,179103,13,396132
101,0.001557,74.125.200.0-255,5738,184841,13,396132
102,0.00156,172.31.36.0-255,66,184907,13,396132
103,0.00158,74.125.200.0-255,4320,189227,13,396132
104,0.001583,172.31.36.0-255,66,189293,13,396132
105,0.001586,74.125.200.0-255,1484,190777,13,396132
106,0.001627,74.125.200.0-255,4320,195097,13,396132
107,0.00163,172.31.36.0-255,66,195163,13,396132
108,0.001635,74.125.200.0-255,2902,198065,13,396132
109,0.001637,172.31.36.0-255,66,198131,13,396132
110,0.001643,74.125.200.0-255,4320,202451,13,396132
111,0.001645,172.31.36.0-255,66,202517,13,396132
112,0.00168,74.125.200.0-255,2184,204701,13,396132
113,0.001683,172.31.36.0-255,66,204767,13,396132
114,0.001822,74.125.200.0-255,1484,206251,13,396132
115,0.001829,74.125.200.0-255,2902,209153,13,396132
116,0.001832,172.31.36.0-255,66,209219,13,396132
117,0.001839,74.125.200.0-255,4320,213539,13,396132
118,0.001842,172.31.36.0-255,66,213605,13,396132
119,0.001859,74.125.200.0-255,1484,215089,13,396132
120,0.001891,74.125.200.0-255,9992,225081,13,396132
121,0.001895,172.31.36.0-255,66,225147,13,396132
122,0.001904,74.125.200.0-255,8574,233721,13,396132
123,0.001906,172.31.36.0-255,66,233787,13,396132
124,0.001924,74.125.200.0-255,2902,236689,13,396132
125,0.001926,172.31.36.0-255,66,236755,13,396132
126,0.00193,74.125.200.0-255,2184,238939,13,396132
127,0.001932,172.31.36.0-255,66,239005,13,396132
128,0.001936,74.125.200.0-255,2902,241907,13,396132
129,0.001938,172.31.36.0-255,66,241973,13,396132
130,0.001969,74.125.200.0-255,7156,249129,13,396132
131,0.001972,172.31.36.0-255,66,249195,13,396132
132,0.001982,74.125.200.0-255,2902,252097,13,396132
133,0.001984,172.31.36.0-255,66,252163,13,396132
134,0.00199,74.125.200.0-255,4320,256483,13,396132
135,0.001992,172.31.36.0-255,66,256549,13,396132
136,0.002025,74.125.200.0-255,8574,265123,13,396132
137,0.002028,172.31.36.0-255,66,265189,13,396132
138,0.002037,74.125.200.0-255,7856,273045,13,396132
139,0.002039,172.31.36.0-255,66,273111,13,396132
140,0.002105,74.125.200.0-255,8574,281685,13,396132
141,0.002108,172.31.36.0-255,66,281751,13,396132
142,0.002113,74.125.200.0-255,4320,286071,13,396132
143,0.002115,172.31.36.0-255,66,286137,13,396132
144,0.002122,74.125.200.0-255,5738,291875,13,396132
145,0.002124,172.31.36.0-255,66,291941,13,396132
146,0.002131,74.125.200.0-255,8574,300515,13,396132
147,0.002133,172.31.36.0-255,66,300581,13,396132
148,0.002162,74.125.200.0-255,6438,307019,13,396132
149,0.002166,172.31.36.0-255,66,307085,13,396132
150,0.004286,74.125.200.0-255,5738,312823,13,396132
151,0.004293,172.31.36.0-255,66,312889,13,396132
152,0.006417,74.125.200.0-255,5738,318627,13,396132
153,0.006422,172.31.36.0-255,66,318693,13,396132
154,0.008552,74.125.200.0-255,5738,324431,13,396132
155,0.008557,172.31.36.0-255,66,324497,13,396132
156,0.010675,74.125.200.0-255,5738,330235,13,396132
157,0.010679,172.31.36.0-255,66,330301,13,396132
158,0.012821,74.125.200.0-255,5738,336039,13,396132
159,0.012829,172.31.36.0-255,66,336105,13,396132
160,0.014955,74.125.200.0-255,5738,341843,13,396132
161,0.014963,172.31.36.0-255,66,341909,13,396132
162,0.017092,74.125.200.0-255,5738,347647,13,396132
163,0.017101,172.31.36.0-255,66,347713,13,396132
164,0.019234,74.125.200.0-255,5738,353451,13,396132
165,0.019246,172.31.36.0-255,66,353517,13,396132
166,0.021387,74.125.200.0-255,5738,359255,13,396132
167,0.021397,172.31.36.0-255,66,359321,13,396132
168,0.023518,74.125.200.0-255,5738,365059,13,396132
169,0.023528,172.31.36.0-255,66,365125,13,396132
170,0.025652,74.125.200.0-255,5738,370863,13,396132
171,0.025659,172.31.36.0-255,66,370929,13,396132
172,0.027795,74.125.200.0-255,5738,376667,13,396132
173,0.027802,172.31.36.0-255,66,376733,13,396132
174,0.029927,74.125.200.0-255,5738,382471,13,396132
175,0.029935,172.31.36.0-255,66,382537,13,396132
176,0.032057,74.125.200.0-255,4098,386635,13,396132
177,0.032066,172.31.36.0-255,66,386701,13,396132
178,0.032248,172.31.36.0-255,105,386806,13,396132
179,0.034328,74.125.200.0-255,66,386872,13,396132
180,0.038759,172.31.36.0-255,172,387044,13,396132
181,0.038788,172.31.36.0-255,1110,388154,13,396132
182,0.038851,172.31.36.0-255,1514,389668,13,396132
183,0.038853,172.31.36.0-255,1514,391182,13,396132
184,0.038855,172.31.36.0-255,1514,392696,13,396132
185,0.038861,172.31.36.0-255,1514,394210,13,396132
186,0.038862,172.31.36.0-255,1514,395724,13,396132
187,0.038863,172.31.36.0-255,144,395868,13,396132
188,0.04042,104.244.42.0-255,66,395934,13,396132
189,0.040449,104.244.42.0-255,66,396000,13,396132
190,0.040546,104.244.42.0-255,66,396066,13,396132
191,0.040559,104.244.42.0-255,66,396132,13,396132
192,0.0,74.125.24.0-255,153,153,13,322306
193,3.1e-05,74.125.24.0-255,1484,1637,13,322306
194,4.2e-05,172.31.36.0-255,66,1703,13,322306
195,4.9e-05,74.125.24.0-255,2902,4605,13,322306
196,5.1e-05,172.31.36.0-255,66,4671,13,322306
197,6e-05,74.125.24.0-255,7156,11827,13,322306
198,6.3e-05,172.31.36.0-255,66,11893,13,322306
199,6.7e-05,74.125.24.0-255,1991,13884,13,322306
200,6.9e-05,172.31.36.0-255,66,13950,13,322306
201,0.000171,74.125.24.0-255,1484,15434,13,322306
202,0.000177,74.125.24.0-255,2902,18336,13,322306
203,0.000181,172.31.36.0-255,66,18402,13,322306
204,0.000198,74.125.24.0-255,5738,24140,13,322306
205,0.0002,172.31.36.0-255,66,24206,13,322306
206,0.000225,74.125.24.0-255,5738,29944,13,322306
207,0.000229,172.31.36.0-255,66,30010,13,322306
208,0.000272,74.125.24.0-255,7156,37166,13,322306
209,0.000276,172.31.36.0-255,66,37232,13,322306
210,0.000292,74.125.24.0-255,3961,41193,13,322306
211,0.000295,172.31.36.0-255,66,41259,13,322306
212,0.000311,74.125.24.0-255,1484,42743,13,322306
213,0.000325,74.125.24.0-255,5379,48122,13,322306
214,0.000329,172.31.36.0-255,66,48188,13,322306
215,0.000384,74.125.24.0-255,1484,49672,13,322306
216,0.000397,74.125.24.0-255,2902,52574,13,322306
217,0.000401,172.31.36.0-255,66,52640,13,322306
218,0.000408,74.125.24.0-255,5738,58378,13,322306
219,0.000411,172.31.36.0-255,66,58444,13,322306
220,0.000416,74.125.24.0-255,5738,64182,13,322306
221,0.000419,172.31.36.0-255,66,64248,13,322306
222,0.000462,74.125.24.0-255,1471,65719,13,322306
223,0.000876,74.125.24.0-255,330,66049,13,322306
224,0.000881,172.31.36.0-255,66,66115,13,322306
225,0.001326,74.125.24.0-255,1484,67599,13,322306
226,0.001334,74.125.24.0-255,2902,70501,13,322306
227,0.001338,172.31.36.0-255,66,70567,13,322306
228,0.001343,74.125.24.0-255,1484,72051,13,322306
229,0.001364,74.125.24.0-255,4320,76371,13,322306
230,0.001367,172.31.36.0-255,66,76437,13,322306
231,0.001373,74.125.24.0-255,5738,82175,13,322306
232,0.001375,172.31.36.0-255,66,82241,13,322306
233,0.001394,74.125.24.0-255,7156,89397,13,322306
234,0.001397,172.31.36.0-255,66,89463,13,322306
235,0.0014,74.125.24.0-255,1484,90947,13,322306
236,0.00142,74.125.24.0-255,2902,93849,13,322306
237,0.001423,172.31.36.0-255,66,93915,13,322306
238,0.001446,74.125.24.0-255,6438,100353,13,322306
239,0.001448,172.31.36.0-255,66,100419,13,322306
240,0.001574,74.125.24.0-255,1484,101903,13,322306
241,0.001593,74.125.24.0-255,2902,104805,13,322306
242,0.001595,172.31.36.0-255,66,104871,13,322306
243,0.001601,74.125.24.0-255,5738,110609,13,322306
244,0.001603,172.31.36.0-255,66,110675,13,322306
245,0.001632,74.125.24.0-255,4320,114995,13,322306
246,0.001634,172.31.36.0-255,66,115061,13,322306
247,0.001654,74.125.24.0-255,2902,117963,13,322306
248,0.001656,172.31.36.0-255,66,118029,13,322306
249,0.001664,74.125.24.0-255,8574,126603,13,322306
250,0.001665,172.31.36.0-255,66,126669,13,322306
251,0.00167,74.125.24.0-255,2902,129571,13,322306
252,0.001672,172.31.36.0-255,66,129637,13,322306
253,0.001697,74.125.24.0-255,5020,134657,13,322306
254,0.0017,172.31.36.0-255,66,134723,13,322306
255,0.001718,74.125.24.0-255,2902,137625,13,322306
256,0.001719,172.31.36.0-255,66,137691,13,322306
257,0.001736,74.125.24.0-255,2902,140593,13,322306
258,0.001738,172.31.36.0-255,66,140659,13,322306
259,0.001744,74.125.24.0-255,7156,147815,13,322306
260,0.001746,172.31.36.0-255,66,147881,13,322306
261,0.001763,74.125.24.0-255,1484,149365,13,322306
262,0.001784,172.31.36.0-255,66,149431,13,322306
263,0.001799,74.125.24.0-255,1484,150915,13,322306
264,0.001812,74.125.24.0-255,2902,153817,13,322306
265,0.001814,172.31.36.0-255,66,153883,13,322306
266,0.001828,74.125.24.0-255,3602,157485,13,322306
267,0.00183,172.31.36.0-255,66,157551,13,322306
268,0.001856,74.125.24.0-255,4320,161871,13,322306
269,0.001859,172.31.36.0-255,66,161937,13,322306
270,0.001873,74.125.24.0-255,2902,164839,13,322306
271,0.001875,172.31.36.0-255,66,164905,13,322306
272,0.00189,74.125.24.0-255,8574,173479,13,322306
273,0.001893,172.31.36.0-255,66,173545,13,322306
274,0.001918,74.125.24.0-255,7156,180701,13,322306
275,0.001921,172.31.36.0-255,66,180767,13,322306
276,0.001924,74.125.24.0-255,1484,182251,13,322306
277,0.00197,74.125.24.0-255,4320,186571,13,322306
278,0.001972,172.31.36.0-255,66,186637,13,322306
279,0.001989,74.125.24.0-255,5020,191657,13,322306
280,0.001992,172.31.36.0-255,66,191723,13,322306
281,0.002005,74.125.24.0-255,1484,193207,13,322306
282,0.002023,74.125.24.0-255,1484,194691,13,322306
283,0.002025,172.31.36.0-255,66,194757,13,322306
284,0.002043,74.125.24.0-255,1484,196241,13,322306
285,0.002047,74.125.24.0-255,2902,199143,13,322306
286,0.002049,172.31.36.0-255,66,199209,13,322306
287,0.002066,74.125.24.0-255,2902,202111,13,322306
288,0.002069,172.31.36.0-255,66,202177,13,322306
289,0.0021,172.31.36.0-255,66,202243,13,322306
290,0.002104,74.125.24.0-255,2902,205145,13,322306
291,0.002105,172.31.36.0-255,66,205211,13,322306
292,0.002119,74.125.24.0-255,2902,208113,13,322306
293,0.002121,172.31.36.0-255,66,208179,13,322306
294,0.002149,74.125.24.0-255,1484,209663,13,322306
295,0.002161,74.125.24.0-255,3602,213265,13,322306
296,0.002282,74.125.24.0-255,1484,214749,13,322306
297,0.002299,74.125.24.0-255,1484,216233,13,322306
298,0.002309,74.125.24.0-255,1484,217717,13,322306
299,0.002313,74.125.24.0-255,2902,220619,13,322306
300,0.002329,74.125.24.0-255,2902,223521,13,322306
301,0.002392,74.125.24.0-255,4320,227841,13,322306
302,0.002414,74.125.24.0-255,7156,234997,13,322306
303,0.002422,74.125.24.0-255,8574,243571,13,322306
304,0.002427,74.125.24.0-255,3602,247173,13,322306
305,0.002512,74.125.24.0-255,1484,248657,13,322306
306,0.002529,74.125.24.0-255,1484,250141,13,322306
307,0.002542,74.125.24.0-255,1484,251625,13,322306
308,0.002546,74.125.24.0-255,2902,254527,13,322306
309,0.002565,74.125.24.0-255,2902,257429,13,322306
310,0.002567,74.125.24.0-255,1484,258913,13,322306
311,0.002591,74.125.24.0-255,8574,267487,13,322306
312,0.002607,74.125.24.0-255,1484,268971,13,322306
313,0.002622,74.125.24.0-255,7156,276127,13,322306
314,0.002636,74.125.24.0-255,5020,281147,13,322306
315,0.002658,74.125.24.0-255,9992,291139,13,322306
316,0.00267,74.125.24.0-255,4320,295459,13,322306
317,0.002695,74.125.24.0-255,2902,298361,13,322306
318,0.002713,74.125.24.0-255,7156,305517,13,322306
319,0.002738,74.125.24.0-255,4320,309837,13,322306
320,0.002787,74.125.24.0-255,6438,316275,13,322306
321,0.002841,74.125.24.0-255,1484,317759,13,322306
322,0.002913,74.125.24.0-255,136,317895,13,322306
323,0.004131,172.31.36.0-255,66,317961,13,322306
324,0.006551,172.31.36.0-255,105,318066,13,322306
325,0.008518,74.125.24.0-255,66,318132,13,322306
326,0.027564,172.31.36.0-255,172,318304,13,322306
327,0.027599,172.31.36.0-255,1109,319413,13,322306
328,0.027632,172.31.36.0-255,1514,320927,13,322306
329,0.027633,172.31.36.0-255,1181,322108,13,322306
330,0.029093,104.244.42.0-255,66,322174,13,322306
331,0.029156,104.244.42.0-255,66,322240,13,322306
332,0.029202,104.244.42.0-255,66,322306,13,322306
333,0.0,74.125.24.0-255,153,153,13,334300
334,2.6e-05,74.125.24.0-255,1484,1637,13,334300
335,3.6e-05,172.31.36.0-255,66,1703,13,334300
336,4.3e-05,74.125.24.0-255,2902,4605,13,334300
337,4.7e-05,74.125.24.0-255,4320,8925,13,334300
338,7.1e-05,74.125.24.0-255,2902,11827,13,334300
339,7.5e-05,74.125.24.0-255,2030,13857,13,334300
340,7.9e-05,172.31.36.0-255,66,13923,13,334300
341,8.5e-05,172.31.36.0-255,66,13989,13,334300
342,0.00016,74.125.24.0-255,1484,15473,13,334300
343,0.000165,74.125.24.0-255,2902,18375,13,334300
344,0.000184,74.125.24.0-255,5738,24113,13,334300
345,0.00023,74.125.24.0-255,4320,28433,13,334300
346,0.000245,74.125.24.0-255,2543,30976,13,334300
347,0.000263,172.31.36.0-255,66,31042,13,334300
348,0.000273,74.125.24.0-255,4320,35362,13,334300
349,0.000285,172.31.36.0-255,66,35428,13,334300
350,0.000293,74.125.24.0-255,2902,38330,13,334300
351,0.000299,172.31.36.0-255,66,38396,13,334300
352,0.000305,74.125.24.0-255,8574,46970,13,334300
353,0.000315,172.31.36.0-255,66,47036,13,334300
354,0.000325,74.125.24.0-255,1125,48161,13,334300
355,0.000385,74.125.24.0-255,1484,49645,13,334300
356,0.000389,172.31.36.0-255,66,49711,13,334300
357,0.000398,74.125.24.0-255,2902,52613,13,334300
358,0.000402,74.125.24.0-255,2902,55515,13,334300
359,0.000404,172.31.36.0-255,66,55581,13,334300
360,0.000408,172.31.36.0-255,66,55647,13,334300
361,0.000421,74.125.24.0-255,2902,58549,13,334300
362,0.000432,172.31.36.0-255,66,58615,13,334300
363,0.000452,74.125.24.0-255,6797,65412,13,334300
364,0.000463,172.31.36.0-255,66,65478,13,334300
365,0.000509,74.125.24.0-255,396,65874,13,334300
366,0.000609,74.125.24.0-255,347,66221,13,334300
367,0.000753,172.31.36.0-255,66,66287,13,334300
368,0.000787,74.125.24.0-255,1484,67771,13,334300
369,0.000801,74.125.24.0-255,2902,70673,13,334300
370,0.000814,172.31.36.0-255,66,70739,13,334300
371,0.000815,74.125.24.0-255,5738,76477,13,334300
372,0.000818,172.31.36.0-255,66,76543,13,334300
373,0.000843,74.125.24.0-255,2902,79445,13,334300
374,0.000853,172.31.36.0-255,66,79511,13,334300
375,0.000863,74.125.24.0-255,3961,83472,13,334300
376,0.000872,172.31.36.0-255,66,83538,13,334300
377,0.000918,74.125.24.0-255,1484,85022,13,334300
378,0.000935,74.125.24.0-255,2902,87924,13,334300
379,0.000937,172.31.36.0-255,66,87990,13,334300
380,0.000953,74.125.24.0-255,4320,92310,13,334300
381,0.000961,172.31.36.0-255,66,92376,13,334300
382,0.000972,74.125.24.0-255,1484,93860,13,334300
383,0.000992,74.125.24.0-255,4320,98180,13,334300
384,0.000996,172.31.36.0-255,66,98246,13,334300
385,0.001006,74.125.24.0-255,1994,100240,13,334300
386,0.00101,172.31.36.0-255,66,100306,13,334300
387,0.001498,74.125.24.0-255,1484,101790,13,334300
388,0.001508,74.125.24.0-255,2902,104692,13,334300
389,0.001512,172.31.36.0-255,66,104758,13,334300
390,0.001521,74.125.24.0-255,5738,110496,13,334300
391,0.001569,74.125.24.0-255,5738,116234,13,334300
392,0.001588,74.125.24.0-255,5020,121254,13,334300
393,0.001844,74.125.24.0-255,1484,122738,13,334300
394,0.001849,74.125.24.0-255,2902,125640,13,334300
395,0.00186,74.125.24.0-255,1484,127124,13,334300
396,0.001875,74.125.24.0-255,4320,131444,13,334300
397,0.001878,74.125.24.0-255,1484,132928,13,334300
398,0.001935,74.125.24.0-255,2902,135830,13,334300
399,0.001967,74.125.24.0-255,7856,143686,13,334300
400,0.001998,74.125.24.0-255,1484,145170,13,334300
401,0.002001,74.125.24.0-255,1484,146654,13,334300
402,0.002013,74.125.24.0-255,1484,148138,13,334300
403,0.002017,74.125.24.0-255,2902,151040,13,334300
404,0.002044,74.125.24.0-255,2902,153942,13,334300
405,0.00207,74.125.24.0-255,2902,156844,13,334300
406,0.002094,74.125.24.0-255,7856,164700,13,334300
407,0.002163,74.125.24.0-255,1484,166184,13,334300
408,0.002168,74.125.24.0-255,2902,169086,13,334300
409,0.002171,74.125.24.0-255,1484,170570,13,334300
410,0.002183,74.125.24.0-255,4320,174890,13,334300
411,0.002252,74.125.24.0-255,4320,179210,13,334300
412,0.002273,74.125.24.0-255,8574,187784,13,334300
413,0.002281,74.125.24.0-255,10692,198476,13,334300
414,0.002286,74.125.24.0-255,4320,202796,13,334300
415,0.002312,74.125.24.0-255,7156,209952,13,334300
416,0.002335,74.125.24.0-255,5738,215690,13,334300
417,0.002356,74.125.24.0-255,3602,219292,13,334300
418,0.002375,74.125.24.0-255,9992,229284,13,334300
419,0.002398,74.125.24.0-255,8574,237858,13,334300
420,0.002414,74.125.24.0-255,2902,240760,13,334300
421,0.002437,74.125.24.0-255,8574,249334,13,334300
422,0.002454,74.125.24.0-255,3602,252936,13,334300
423,0.002495,74.125.24.0-255,1484,254420,13,334300
424,0.002498,74.125.24.0-255,1484,255904,13,334300
425,0.002515,74.125.24.0-255,1484,257388,13,334300
426,0.002521,74.125.24.0-255,5738,263126,13,334300
427,0.002543,74.125.24.0-255,2902,266028,13,334300
428,0.002572,74.125.24.0-255,9992,276020,13,334300
429,0.002575,74.125.24.0-255,1484,277504,13,334300
430,0.002602,74.125.24.0-255,5738,283242,13,334300
431,0.002615,74.125.24.0-255,3602,286844,13,334300
432,0.002691,74.125.24.0-255,1484,288328,13,334300
433,0.002704,74.125.24.0-255,2902,291230,13,334300
434,0.00272,74.125.24.0-255,5738,296968,13,334300
435,0.002763,74.125.24.0-255,5738,302706,13,334300
436,0.002788,74.125.24.0-255,7156,309862,13,334300
437,0.002806,74.125.24.0-255,9992,319854,13,334300
438,0.002821,74.125.24.0-255,2184,322038,13,334300
439,0.002855,74.125.24.0-255,4320,326358,13,334300
440,0.002873,74.125.24.0-255,4279,330637,13,334300
441,0.002883,74.125.24.0-255,105,330742,13,334300
442,0.006605,172.31.36.0-255,66,330808,13,334300
443,0.00876,172.31.36.0-255,105,330913,13,334300
444,0.011091,74.125.24.0-255,66,330979,13,334300
445,0.028697,172.31.36.0-255,167,331146,13,334300
446,0.028729,172.31.36.0-255,1109,332255,13,334300
447,0.028764,172.31.36.0-255,1514,333769,13,334300
448,0.028766,172.31.36.0-255,333,334102,13,334300
449,0.030292,104.244.42.0-255,66,334168,13,334300
450,0.030316,104.244.42.0-255,66,334234,13,334300
451,0.030371,104.244.42.0-255,66,334300,13,334300
452,0.0,74.125.24.0-255,153,153,13,361291
453,2.2e-05,172.31.36.0-255,66,219,13,361291
454,3e-05,74.125.24.0-255,1484,1703,13,361291
455,3.4e-05,172.31.36.0-255,66,1769,13,361291
456,4e-05,74.125.24.0-255,2902,4671,13,361291
457,4.2e-05,172.31.36.0-255,66,4737,13,361291
458,8.3e-05,74.125.24.0-255,7156,11893,13,361291
459,8.8e-05,172.31.36.0-255,66,11959,13,361291
460,9.2e-05,74.125.24.0-255,2038,13997,13,361291
461,9.5e-05,172.31.36.0-255,66,14063,13,361291
462,0.000254,74.125.24.0-255,1484,15547,13,361291
463,0.00026,172.31.36.0-255,66,15613,13,361291
464,0.000264,74.125.24.0-255,1484,17097,13,361291
465,0.000267,172.31.36.0-255,66,17163,13,361291
466,0.000286,74.125.24.0-255,1484,18647,13,361291
467,0.000289,172.31.36.0-255,66,18713,13,361291
468,0.000296,74.125.24.0-255,1484,20197,13,361291
469,0.000299,172.31.36.0-255,66,20263,13,361291
470,0.000305,74.125.24.0-255,5738,26001,13,361291
471,0.000307,172.31.36.0-255,66,26067,13,361291
472,0.000344,74.125.24.0-255,5379,31446,13,361291
473,0.000347,172.31.36.0-255,66,31512,13,361291
474,0.000351,74.125.24.0-255,2902,34414,13,361291
475,0.000353,172.31.36.0-255,66,34480,13,361291
476,0.000381,74.125.24.0-255,2902,37382,13,361291
477,0.000384,172.31.36.0-255,66,37448,13,361291
478,0.000396,74.125.24.0-255,7156,44604,13,361291
479,0.000398,172.31.36.0-255,66,44670,13,361291
480,0.000429,74.125.24.0-255,5738,50408,13,361291
481,0.000432,172.31.36.0-255,66,50474,13,361291
482,0.000457,74.125.24.0-255,8574,59048,13,361291
483,0.00046,172.31.36.0-255,66,59114,13,361291
484,0.000468,74.125.24.0-255,6438,65552,13,361291
485,0.00047,172.31.36.0-255,66,65618,13,361291
486,0.000473,74.125.24.0-255,443,66061,13,361291
487,0.000497,74.125.24.0-255,330,66391,13,361291
488,0.000728,74.125.24.0-255,1484,67875,13,361291
489,0.000733,172.31.36.0-255,66,67941,13,361291
490,0.000739,74.125.24.0-255,2902,70843,13,361291
491,0.000741,172.31.36.0-255,66,70909,13,361291
492,0.000774,74.125.24.0-255,5738,76647,13,361291
493,0.000777,172.31.36.0-255,66,76713,13,361291
494,0.000781,74.125.24.0-255,1484,78197,13,361291
495,0.000804,74.125.24.0-255,2902,81099,13,361291
496,0.000807,172.31.36.0-255,66,81165,13,361291
497,0.000812,74.125.24.0-255,2902,84067,13,361291
498,0.000814,172.31.36.0-255,66,84133,13,361291
499,0.000838,74.125.24.0-255,2902,87035,13,361291
500,0.00084,172.31.36.0-255,66,87101,13,361291
501,0.000849,74.125.24.0-255,2902,90003,13,361291
502,0.000851,172.31.36.0-255,66,90069,13,361291
503,0.000866,74.125.24.0-255,2902,92971,13,361291
504,0.000868,172.31.36.0-255,66,93037,13,361291
505,0.000903,74.125.24.0-255,7156,100193,13,361291
506,0.000905,172.31.36.0-255,66,100259,13,361291
507,0.000909,74.125.24.0-255,218,100477,13,361291
508,0.001084,74.125.24.0-255,1484,101961,13,361291
509,0.001088,172.31.36.0-255,66,102027,13,361291
510,0.001138,74.125.24.0-255,2902,104929,13,361291
511,0.001141,172.31.36.0-255,66,104995,13,361291
512,0.001147,74.125.24.0-255,5738,110733,13,361291
513,0.00115,172.31.36.0-255,66,110799,13,361291
514,0.001162,74.125.24.0-255,8574,119373,13,361291
515,0.001165,172.31.36.0-255,66,119439,13,361291
516,0.001217,74.125.24.0-255,8574,128013,13,361291
517,0.001221,172.31.36.0-255,66,128079,13,361291
518,0.001254,74.125.24.0-255,6438,134517,13,361291
519,0.001257,172.31.36.0-255,66,134583,13,361291
520,0.00146,74.125.24.0-255,1484,136067,13,361291
521,0.001477,74.125.24.0-255,2902,138969,13,361291
522,0.001481,172.31.36.0-255,66,139035,13,361291
523,0.001487,74.125.24.0-255,4320,143355,13,361291
524,0.001489,172.31.36.0-255,66,143421,13,361291
525,0.001519,74.125.24.0-255,1484,144905,13,361291
526,0.001534,74.125.24.0-255,4320,149225,13,361291
527,0.001536,172.31.36.0-255,66,149291,13,361291
528,0.001558,74.125.24.0-255,8574,157865,13,361291
529,0.001561,172.31.36.0-255,66,157931,13,361291
530,0.001568,74.125.24.0-255,7156,165087,13,361291
531,0.00157,172.31.36.0-255,66,165153,13,361291
532,0.001605,74.125.24.0-255,3602,168755,13,361291
533,0.001608,172.31.36.0-255,66,168821,13,361291
534,0.002151,74.125.24.0-255,1484,170305,13,361291
535,0.002157,74.125.24.0-255,2902,173207,13,361291
536,0.00216,172.31.36.0-255,66,173273,13,361291
537,0.002164,74.125.24.0-255,1484,174757,13,361291
538,0.002193,74.125.24.0-255,4320,179077,13,361291
539,0.002195,172.31.36.0-255,66,179143,13,361291
540,0.002199,74.125.24.0-255,1484,180627,13,361291
541,0.002234,172.31.36.0-255,66,180693,13,361291
542,0.002241,74.125.24.0-255,7156,187849,13,361291
543,0.002243,172.31.36.0-255,66,187915,13,361291
544,0.002271,74.125.24.0-255,3602,191517,13,361291
545,0.002273,172.31.36.0-255,66,191583,13,361291
546,0.002457,74.125.24.0-255,1484,193067,13,361291
547,0.002462,74.125.24.0-255,1484,194551,13,361291
548,0.002464,172.31.36.0-255,66,194617,13,361291
549,0.002491,74.125.24.0-255,1484,196101,13,361291
550,0.002497,74.125.24.0-255,5738,201839,13,361291
551,0.0025,172.31.36.0-255,66,201905,13,361291
552,0.002534,74.125.24.0-255,9992,211897,13,361291
553,0.002537,172.31.36.0-255,66,211963,13,361291
554,0.002542,74.125.24.0-255,4320,216283,13,361291
555,0.002544,172.31.36.0-255,66,216349,13,361291
556,0.002565,74.125.24.0-255,7156,223505,13,361291
557,0.002567,172.31.36.0-255,66,223571,13,361291
558,0.002576,74.125.24.0-255,2184,225755,13,361291
559,0.002578,172.31.36.0-255,66,225821,13,361291
560,0.002614,74.125.24.0-255,2902,228723,13,361291
561,0.002617,172.31.36.0-255,66,228789,13,361291
562,0.002649,74.125.24.0-255,8574,237363,13,361291
563,0.002652,172.31.36.0-255,66,237429,13,361291
564,0.002675,172.31.36.0-255,66,237495,13,361291
565,0.002681,74.125.24.0-255,5738,243233,13,361291
566,0.002684,172.31.36.0-255,66,243299,13,361291
567,0.005284,74.125.24.0-255,5738,249037,13,361291
568,0.005307,172.31.36.0-255,66,249103,13,361291
569,0.007921,74.125.24.0-255,5738,254841,13,361291
570,0.007942,172.31.36.0-255,66,254907,13,361291
571,0.010522,74.125.24.0-255,5738,260645,13,361291
572,0.010531,172.31.36.0-255,66,260711,13,361291
573,0.013164,74.125.24.0-255,5738,266449,13,361291
574,0.01318,172.31.36.0-255,66,266515,13,361291
575,0.015796,74.125.24.0-255,5738,272253,13,361291
576,0.015812,172.31.36.0-255,66,272319,13,361291
577,0.018431,74.125.24.0-255,5738,278057,13,361291
578,0.018441,172.31.36.0-255,66,278123,13,361291
579,0.021027,74.125.24.0-255,5738,283861,13,361291
580,0.021036,172.31.36.0-255,66,283927,13,361291
581,0.023669,74.125.24.0-255,5738,289665,13,361291
582,0.023678,172.31.36.0-255,66,289731,13,361291
583,0.026284,74.125.24.0-255,5738,295469,13,361291
584,0.026292,172.31.36.0-255,66,295535,13,361291
585,0.028894,74.125.24.0-255,5738,301273,13,361291
586,0.028905,172.31.36.0-255,66,301339,13,361291
587,0.03151,74.125.24.0-255,5738,307077,13,361291
588,0.031519,172.31.36.0-255,66,307143,13,361291
589,0.034097,74.125.24.0-255,5738,312881,13,361291
590,0.034104,172.31.36.0-255,66,312947,13,361291
591,0.035313,172.31.36.0-255,172,313119,13,361291
592,0.035357,172.31.36.0-255,1110,314229,13,361291
593,0.035519,172.31.36.0-255,1514,315743,13,361291
594,0.035521,172.31.36.0-255,1295,317038,13,361291
595,0.036736,74.125.24.0-255,5738,322776,13,361291
596,0.036745,172.31.36.0-255,66,322842,13,361291
597,0.036832,104.244.42.0-255,66,322908,13,361291
598,0.036904,104.244.42.0-255,66,322974,13,361291
599,0.037061,104.244.42.0-255,66,323040,13,361291
600,0.039375,74.125.24.0-255,5738,328778,13,361291
601,0.039384,172.31.36.0-255,66,328844,13,361291
602,0.041985,74.125.24.0-255,5738,334582,13,361291
603,0.041993,172.31.36.0-255,66,334648,13,361291
604,0.044632,74.125.24.0-255,5738,340386,13,361291
605,0.044639,172.31.36.0-255,66,340452,13,361291
606,0.047247,74.125.24.0-255,5738,346190,13,361291
607,0.047255,172.31.36.0-255,66,346256,13,361291
608,0.049892,74.125.24.0-255,5738,351994,13,361291
609,0.049898,172.31.36.0-255,66,352060,13,361291
610,0.052491,74.125.24.0-255,5738,357798,13,361291
611,0.052496,172.31.36.0-255,66,357864,13,361291
612,0.0551,74.125.24.0-255,3190,361054,13,361291
613,0.055106,172.31.36.0-255,66,361120,13,361291
614,0.055259,172.31.36.0-255,105,361225,13,361291
615,0.05784,74.125.24.0-255,66,361291,13,361291
616,0.0,172.217.27.0-255,298,298,13,388929
617,1.7e-05,172.31.36.0-255,66,364,13,388929
618,2.3e-05,172.217.27.0-255,1484,1848,13,388929
619,2.7e-05,172.31.36.0-255,66,1914,13,388929
620,3.4e-05,172.217.27.0-255,4320,6234,13,388929
621,3.7e-05,172.31.36.0-255,66,6300,13,388929
622,4.2e-05,172.217.27.0-255,2902,9202,13,388929
623,4.4e-05,172.31.36.0-255,66,9268,13,388929
624,6.8e-05,172.217.27.0-255,2902,12170,13,388929
625,7e-05,172.31.36.0-255,66,12236,13,388929
626,7.8e-05,172.217.27.0-255,6139,18375,13,388929
627,8e-05,172.31.36.0-255,66,18441,13,388929
628,8.7e-05,172.217.27.0-255,7156,25597,13,388929
629,9e-05,172.31.36.0-255,66,25663,13,388929
630,0.00011,172.217.27.0-255,5379,31042,13,388929
631,0.000113,172.31.36.0-255,66,31108,13,388929
632,0.000174,172.217.27.0-255,1484,32592,13,388929
633,0.000177,172.31.36.0-255,66,32658,13,388929
634,0.000181,172.217.27.0-255,2902,35560,13,388929
635,0.000183,172.31.36.0-255,66,35626,13,388929
636,0.000214,172.217.27.0-255,5738,41364,13,388929
637,0.000217,172.31.36.0-255,66,41430,13,388929
638,0.000255,172.217.27.0-255,7156,48586,13,388929
639,0.000257,172.31.36.0-255,66,48652,13,388929
640,0.000277,172.217.27.0-255,5738,54390,13,388929
641,0.00028,172.31.36.0-255,66,54456,13,388929
642,0.000288,172.217.27.0-255,8574,63030,13,388929
643,0.000291,172.31.36.0-255,66,63096,13,388929
644,0.000295,172.217.27.0-255,2471,65567,13,388929
645,0.000297,172.31.36.0-255,66,65633,13,388929
646,0.000526,172.217.27.0-255,140,65773,13,388929
647,0.000531,172.31.36.0-255,66,65839,13,388929
648,0.000782,172.217.27.0-255,1484,67323,13,388929
649,0.00079,172.217.27.0-255,2902,70225,13,388929
650,0.000793,172.31.36.0-255,66,70291,13,388929
651,0.000797,172.217.27.0-255,2902,73193,13,388929
652,0.000799,172.31.36.0-255,66,73259,13,388929
653,0.000815,172.217.27.0-255,2902,76161,13,388929
654,0.000817,172.31.36.0-255,66,76227,13,388929
655,0.000832,172.217.27.0-255,2902,79129,13,388929
656,0.000834,172.31.36.0-255,66,79195,13,388929
657,0.000859,172.217.27.0-255,9992,89187,13,388929
658,0.000862,172.31.36.0-255,66,89253,13,388929
659,0.000865,172.217.27.0-255,1484,90737,13,388929
660,0.000895,172.217.27.0-255,9274,100011,13,388929
661,0.000898,172.31.36.0-255,66,100077,13,388929
662,0.00098,172.217.27.0-255,1484,101561,13,388929
663,0.000985,172.217.27.0-255,2902,104463,13,388929
664,0.000988,172.31.36.0-255,66,104529,13,388929
665,0.000993,172.217.27.0-255,2902,107431,13,388929
666,0.000995,172.31.36.0-255,66,107497,13,388929
667,0.00101,172.217.27.0-255,2902,110399,13,388929
668,0.001015,172.217.27.0-255,4320,114719,13,388929
669,0.001019,172.31.36.0-255,66,114785,13,388929
670,0.001022,172.31.36.0-255,66,114851,13,388929
671,0.001048,172.217.27.0-255,8574,123425,13,388929
672,0.001051,172.31.36.0-255,66,123491,13,388929
673,0.001061,172.217.27.0-255,10692,134183,13,388929
674,0.001064,172.31.36.0-255,66,134249,13,388929
675,0.001073,172.217.27.0-255,8574,142823,13,388929
676,0.001075,172.31.36.0-255,66,142889,13,388929
677,0.001094,172.217.27.0-255,2902,145791,13,388929
678,0.001096,172.31.36.0-255,66,145857,13,388929
679,0.001102,172.217.27.0-255,4320,150177,13,388929
680,0.001104,172.31.36.0-255,66,150243,13,388929
681,0.001124,172.217.27.0-255,7156,157399,13,388929
682,0.001127,172.31.36.0-255,66,157465,13,388929
683,0.00115,172.217.27.0-255,2902,160367,13,388929
684,0.001152,172.31.36.0-255,66,160433,13,388929
685,0.001177,172.217.27.0-255,7856,168289,13,388929
686,0.00118,172.31.36.0-255,66,168355,13,388929
687,0.001208,172.217.27.0-255,4320,172675,13,388929
688,0.001211,172.31.36.0-255,66,172741,13,388929
689,0.001235,172.217.27.0-255,7156,179897,13,388929
690,0.00124,172.217.27.0-255,4320,184217,13,388929
691,0.001244,172.31.36.0-255,66,184283,13,388929
692,0.001247,172.31.36.0-255,66,184349,13,388929
693,0.001263,172.217.27.0-255,2902,187251,13,388929
694,0.001265,172.31.36.0-255,66,187317,13,388929
695,0.001274,172.217.27.0-255,8574,195891,13,388929
696,0.001276,172.31.36.0-255,66,195957,13,388929
697,0.001282,172.217.27.0-255,6139,202096,13,388929
698,0.001284,172.31.36.0-255,66,202162,13,388929
699,0.001355,172.217.27.0-255,1484,203646,13,388929
700,0.001358,172.217.27.0-255,1484,205130,13,388929
701,0.001361,172.31.36.0-255,66,205196,13,388929
702,0.001379,172.217.27.0-255,1484,206680,13,388929
703,0.001386,172.217.27.0-255,5738,212418,13,388929
704,0.001388,172.31.36.0-255,66,212484,13,388929
705,0.001405,172.217.27.0-255,4320,216804,13,388929
706,0.001409,172.31.36.0-255,66,216870,13,388929
707,0.001422,172.217.27.0-255,4320,221190,13,388929
708,0.001425,172.31.36.0-255,66,221256,13,388929
709,0.001433,172.217.27.0-255,7156,228412,13,388929
710,0.001435,172.31.36.0-255,66,228478,13,388929
711,0.001458,172.217.27.0-255,2902,231380,13,388929
712,0.001464,172.217.27.0-255,5020,236400,13,388929
713,0.001503,172.31.36.0-255,66,236466,13,388929
714,0.001506,172.31.36.0-255,66,236532,13,388929
715,0.003265,172.217.27.0-255,5738,242270,13,388929
716,0.003272,172.31.36.0-255,66,242336,13,388929
717,0.00504,172.217.27.0-255,5738,248074,13,388929
718,0.005044,172.31.36.0-255,66,248140,13,388929
719,0.006803,172.217.27.0-255,5738,253878,13,388929
720,0.00681,172.31.36.0-255,66,253944,13,388929
721,0.00858,172.217.27.0-255,5738,259682,13,388929
722,0.008586,172.31.36.0-255,66,259748,13,388929
723,0.010346,172.217.27.0-255,4320,264068,13,388929
724,0.010351,172.31.36.0-255,66,264134,13,388929
725,0.010366,172.217.27.0-255,1484,265618,13,388929
726,0.012112,172.217.27.0-255,4320,269938,13,388929
727,0.012119,172.31.36.0-255,66,270004,13,388929
728,0.01389,172.217.27.0-255,5738,275742,13,388929
729,0.013898,172.31.36.0-255,66,275808,13,388929
730,0.015655,172.217.27.0-255,2902,278710,13,388929
731,0.015662,172.31.36.0-255,66,278776,13,388929
732,0.015683,172.217.27.0-255,2902,281678,13,388929
733,0.015686,172.31.36.0-255,66,281744,13,388929
734,0.017425,172.217.27.0-255,2902,284646,13,388929
735,0.017432,172.31.36.0-255,66,284712,13,388929
736,0.017456,172.217.27.0-255,2902,287614,13,388929
737,0.017459,172.31.36.0-255,66,287680,13,388929
738,0.019198,172.217.27.0-255,2902,290582,13,388929
739,0.019207,172.31.36.0-255,66,290648,13,388929
740,0.019228,172.217.27.0-255,2902,293550,13,388929
741,0.019231,172.31.36.0-255,66,293616,13,388929
742,0.020981,172.217.27.0-255,5738,299354,13,388929
743,0.02099,172.31.36.0-255,66,299420,13,388929
744,0.022765,172.217.27.0-255,2902,302322,13,388929
745,0.022771,172.31.36.0-255,66,302388,13,388929
746,0.022791,172.217.27.0-255,2902,305290,13,388929
747,0.022793,172.31.36.0-255,66,305356,13,388929
748,0.024524,172.217.27.0-255,2902,308258,13,388929
749,0.02453,172.31.36.0-255,66,308324,13,388929
750,0.024551,172.217.27.0-255,2902,311226,13,388929
751,0.024553,172.31.36.0-255,66,311292,13,388929
752,0.026442,172.217.27.0-255,5738,317030,13,388929
753,0.02645,172.31.36.0-255,66,317096,13,388929
754,0.028238,172.217.27.0-255,5738,322834,13,388929
755,0.028245,172.31.36.0-255,66,322900,13,388929
756,0.03005,172.217.27.0-255,5738,328638,13,388929
757,0.030058,172.31.36.0-255,66,328704,13,388929
758,0.031817,172.217.27.0-255,4320,333024,13,388929
759,0.031824,172.31.36.0-255,66,333090,13,388929
760,0.031844,172.217.27.0-255,1484,334574,13,388929
761,0.03359,172.217.27.0-255,4320,338894,13,388929
762,0.033597,172.31.36.0-255,66,338960,13,388929
763,0.035366,172.217.27.0-255,5738,344698,13,388929
764,0.035374,172.31.36.0-255,66,344764,13,388929
765,0.037166,172.217.27.0-255,5738,350502,13,388929
766,0.037173,172.31.36.0-255,66,350568,13,388929
767,0.038921,172.217.27.0-255,2902,353470,13,388929
768,0.038926,172.31.36.0-255,66,353536,13,388929
769,0.038945,172.217.27.0-255,2902,356438,13,388929
770,0.038947,172.31.36.0-255,66,356504,13,388929
771,0.039839,172.31.36.0-255,172,356676,13,388929
772,0.039868,172.31.36.0-255,1110,357786,13,388929
773,0.039925,172.31.36.0-255,1514,359300,13,388929
774,0.039927,172.31.36.0-255,1295,360595,13,388929
775,0.040725,172.217.27.0-255,2902,363497,13,388929
776,0.040733,172.31.36.0-255,66,363563,13,388929
777,0.040751,172.217.27.0-255,1484,365047,13,388929
778,0.040766,172.217.27.0-255,1484,366531,13,388929
779,0.040769,172.31.36.0-255,66,366597,13,388929
780,0.041547,104.244.42.0-255,66,366663,13,388929
781,0.041584,104.244.42.0-255,66,366729,13,388929
782,0.041611,104.244.42.0-255,66,366795,13,388929
783,0.042507,172.217.27.0-255,5738,372533,13,388929
784,0.042512,172.31.36.0-255,66,372599,13,388929
785,0.044323,172.217.27.0-255,5738,378337,13,388929
786,0.04433,172.31.36.0-255,66,378403,13,388929
787,0.046107,172.217.27.0-255,5738,384141,13,388929
788,0.046114,172.31.36.0-255,66,384207,13,388929
789,0.047882,172.217.27.0-255,4485,388692,13,388929
790,0.047889,172.31.36.0-255,66,388758,13,388929
791,0.048079,172.31.36.0-255,105,388863,13,388929
792,0.04982,172.217.27.0-255,66,388929,13,388929
793,0.0,74.125.24.0-255,153,153,13,348851
794,3.2e-05,172.31.36.0-255,66,219,13,348851
795,4e-05,74.125.24.0-255,1484,1703,13,348851
796,4.5e-05,172.31.36.0-255,66,1769,13,348851
797,5.7e-05,74.125.24.0-255,2902,4671,13,348851
798,6e-05,172.31.36.0-255,66,4737,13,348851
799,6.8e-05,74.125.24.0-255,7156,11893,13,348851
800,7.1e-05,172.31.36.0-255,66,11959,13,348851
801,7.5e-05,74.125.24.0-255,2013,13972,13,348851
802,7.7e-05,172.31.36.0-255,66,14038,13,348851
803,0.000128,74.125.24.0-255,1484,15522,13,348851
804,0.000131,172.31.36.0-255,66,15588,13,348851
805,0.000137,74.125.24.0-255,2902,18490,13,348851
806,0.000139,172.31.36.0-255,66,18556,13,348851
807,0.000142,74.125.24.0-255,1484,20040,13,348851
808,0.00015,172.31.36.0-255,66,20106,13,348851
809,0.000185,74.125.24.0-255,4320,24426,13,348851
810,0.000189,172.31.36.0-255,66,24492,13,348851
811,0.000197,74.125.24.0-255,6797,31289,13,348851
812,0.0002,172.31.36.0-255,66,31355,13,348851
813,0.000237,74.125.24.0-255,2902,34257,13,348851
814,0.00024,172.31.36.0-255,66,34323,13,348851
815,0.000271,74.125.24.0-255,4320,38643,13,348851
816,0.000274,172.31.36.0-255,66,38709,13,348851
817,0.000283,74.125.24.0-255,8574,47283,13,348851
818,0.000291,172.31.36.0-255,66,47349,13,348851
819,0.000294,74.125.24.0-255,1125,48474,13,348851
820,0.000297,172.31.36.0-255,66,48540,13,348851
821,0.000343,74.125.24.0-255,4320,52860,13,348851
822,0.000348,172.31.36.0-255,66,52926,13,348851
823,0.000378,74.125.24.0-255,7156,60082,13,348851
824,0.000381,172.31.36.0-255,66,60148,13,348851
825,0.00041,74.125.24.0-255,4320,64468,13,348851
826,0.000418,172.31.36.0-255,66,64534,13,348851
827,0.00043,74.125.24.0-255,1766,66300,13,348851
828,0.000446,172.31.36.0-255,66,66366,13,348851
829,0.000651,74.125.24.0-255,1484,67850,13,348851
830,0.000657,74.125.24.0-255,2902,70752,13,348851
831,0.000659,74.125.24.0-255,1484,72236,13,348851
832,0.000663,172.31.36.0-255,66,72302,13,348851
833,0.000692,74.125.24.0-255,4320,76622,13,348851
834,0.000701,74.125.24.0-255,8574,85196,13,348851
835,0.0007,172.31.36.0-255,66,85262,13,348851
836,0.000706,172.31.36.0-255,66,85328,13,348851
837,0.000722,74.125.24.0-255,4320,89648,13,348851
838,0.000733,74.125.24.0-255,10692,100340,13,348851
839,0.000732,172.31.36.0-255,66,100406,13,348851
840,0.000736,172.31.36.0-255,66,100472,13,348851
841,0.000929,74.125.24.0-255,1484,101956,13,348851
842,0.000951,74.125.24.0-255,2902,104858,13,348851
843,0.000954,172.31.36.0-255,66,104924,13,348851
844,0.000961,74.125.24.0-255,5738,110662,13,348851
845,0.000977,172.31.36.0-255,66,110728,13,348851
846,0.001011,172.31.36.0-255,66,110794,13,348851
847,0.001065,74.125.24.0-255,10692,121486,13,348851
848,0.001075,172.31.36.0-255,66,121552,13,348851
849,0.001179,74.125.24.0-255,1484,123036,13,348851
850,0.001184,74.125.24.0-255,2902,125938,13,348851
851,0.001188,172.31.36.0-255,66,126004,13,348851
852,0.001214,74.125.24.0-255,4320,130324,13,348851
853,0.001218,74.125.24.0-255,1484,131808,13,348851
854,0.001224,172.31.36.0-255,66,131874,13,348851
855,0.001251,74.125.24.0-255,4320,136194,13,348851
856,0.001264,172.31.36.0-255,66,136260,13,348851
857,0.001268,74.125.24.0-255,7156,143416,13,348851
858,0.001278,172.31.36.0-255,66,143482,13,348851
859,0.001291,74.125.24.0-255,4320,147802,13,348851
860,0.001303,74.125.24.0-255,7856,155658,13,348851
861,0.001302,172.31.36.0-255,66,155724,13,348851
862,0.001306,172.31.36.0-255,66,155790,13,348851
863,0.001477,74.125.24.0-255,1484,157274,13,348851
864,0.001483,74.125.24.0-255,2902,160176,13,348851
865,0.001486,172.31.36.0-255,66,160242,13,348851
866,0.0015,74.125.24.0-255,5738,165980,13,348851
867,0.001509,172.31.36.0-255,66,166046,13,348851
868,0.001513,74.125.24.0-255,7156,173202,13,348851
869,0.001524,172.31.36.0-255,66,173268,13,348851
870,0.001541,74.125.24.0-255,2902,176170,13,348851
871,0.001548,172.31.36.0-255,66,176236,13,348851
872,0.001576,74.125.24.0-255,2184,178420,13,348851
873,0.001579,74.125.24.0-255,2902,181322,13,348851
874,0.001581,172.31.36.0-255,66,181388,13,348851
875,0.001585,74.125.24.0-255,5738,187126,13,348851
876,0.001586,172.31.36.0-255,66,187192,13,348851
877,0.001599,172.31.36.0-255,66,187258,13,348851
878,0.001608,74.125.24.0-255,1484,188742,13,348851
879,0.001634,172.31.36.0-255,66,188808,13,348851
880,0.001659,74.125.24.0-255,1484,190292,13,348851
881,0.001673,74.125.24.0-255,7856,198148,13,348851
882,0.001679,172.31.36.0-255,66,198214,13,348851
883,0.002129,74.125.24.0-255,1484,199698,13,348851
884,0.002135,74.125.24.0-255,2902,202600,13,348851
885,0.002138,172.31.36.0-255,66,202666,13,348851
886,0.002141,74.125.24.0-255,1484,204150,13,348851
887,0.002165,74.125.24.0-255,4320,208470,13,348851
888,0.002171,74.125.24.0-255,4320,212790,13,348851
889,0.002182,172.31.36.0-255,66,212856,13,348851
890,0.00221,74.125.24.0-255,4320,217176,13,348851
891,0.00222,74.125.24.0-255,9992,227168,13,348851
892,0.002226,74.125.24.0-255,5020,232188,13,348851
893,0.002299,74.125.24.0-255,1484,233672,13,348851
894,0.002316,74.125.24.0-255,2902,236574,13,348851
895,0.00233,74.125.24.0-255,2902,239476,13,348851
896,0.002342,74.125.24.0-255,2902,242378,13,348851
897,0.002364,74.125.24.0-255,5738,248116,13,348851
898,0.008029,172.31.36.0-255,66,248182,13,348851
899,0.010359,74.125.24.0-255,5738,253920,13,348851
900,0.010367,172.31.36.0-255,66,253986,13,348851
901,0.0127,74.125.24.0-255,5738,259724,13,348851
902,0.012708,172.31.36.0-255,66,259790,13,348851
903,0.015037,74.125.24.0-255,5738,265528,13,348851
904,0.015044,172.31.36.0-255,66,265594,13,348851
905,0.017402,74.125.24.0-255,5738,271332,13,348851
906,0.017408,172.31.36.0-255,66,271398,13,348851
907,0.0197,74.125.24.0-255,5738,277136,13,348851
908,0.019707,172.31.36.0-255,66,277202,13,348851
909,0.022027,74.125.24.0-255,5738,282940,13,348851
910,0.022034,172.31.36.0-255,66,283006,13,348851
911,0.024374,74.125.24.0-255,4320,287326,13,348851
912,0.024384,172.31.36.0-255,66,287392,13,348851
913,0.024426,74.125.24.0-255,1484,288876,13,348851
914,0.026696,74.125.24.0-255,4320,293196,13,348851
915,0.026704,172.31.36.0-255,66,293262,13,348851
916,0.029027,74.125.24.0-255,4320,297582,13,348851
917,0.029032,172.31.36.0-255,66,297648,13,348851
918,0.029061,74.125.24.0-255,1484,299132,13,348851
919,0.031357,74.125.24.0-255,4320,303452,13,348851
920,0.031364,172.31.36.0-255,66,303518,13,348851
921,0.032272,172.31.36.0-255,172,303690,13,348851
922,0.032304,172.31.36.0-255,1106,304796,13,348851
923,0.032338,172.31.36.0-255,1514,306310,13,348851
924,0.032341,172.31.36.0-255,1299,307609,13,348851
925,0.03366,74.125.24.0-255,5738,313347,13,348851
926,0.033713,172.31.36.0-255,66,313413,13,348851
927,0.033819,104.244.42.0-255,66,313479,13,348851
928,0.033858,104.244.42.0-255,66,313545,13,348851
929,0.034002,104.244.42.0-255,66,313611,13,348851
930,0.036034,74.125.24.0-255,5738,319349,13,348851
931,0.03604,172.31.36.0-255,66,319415,13,348851
932,0.038368,74.125.24.0-255,5738,325153,13,348851
933,0.038374,172.31.36.0-255,66,325219,13,348851
934,0.040704,74.125.24.0-255,5738,330957,13,348851
935,0.040709,172.31.36.0-255,66,331023,13,348851
936,0.043014,74.125.24.0-255,5738,336761,13,348851
937,0.04302,172.31.36.0-255,66,336827,13,348851
938,0.045338,74.125.24.0-255,5738,342565,13,348851
939,0.045343,172.31.36.0-255,66,342631,13,348851
940,0.047646,74.125.24.0-255,5738,348369,13,348851
941,0.047651,172.31.36.0-255,66,348435,13,348851
942,0.049935,74.125.24.0-255,179,348614,13,348851
943,0.050071,172.31.36.0-255,66,348680,13,348851
944,0.050095,172.31.36.0-255,105,348785,13,348851
945,0.052363,74.125.24.0-255,66,348851,13,348851
946,0.0,172.31.36.0-255,105,105,13,459
947,0.000241,172.31.36.0-255,90,195,13,459
948,0.000252,172.31.36.0-255,66,261,13,459
949,0.002678,172.217.194.0-255,66,327,13,459
950,0.002712,172.217.194.0-255,66,393,13,459
951,0.002737,172.31.36.0-255,66,459,13,459
952,0.0,74.125.24.0-255,157,157,13,363759
953,3.2e-05,172.31.36.0-255,66,223,13,363759
954,3.9e-05,74.125.24.0-255,1484,1707,13,363759
955,4.4e-05,172.31.36.0-255,66,1773,13,363759
956,5.7e-05,74.125.24.0-255,2902,4675,13,363759
957,6e-05,172.31.36.0-255,66,4741,13,363759
958,6.7e-05,74.125.24.0-255,7156,11897,13,363759
959,7e-05,172.31.36.0-255,66,11963,13,363759
960,7.4e-05,74.125.24.0-255,2029,13992,13,363759
961,7.6e-05,172.31.36.0-255,66,14058,13,363759
962,0.000541,74.125.24.0-255,1484,15542,13,363759
963,0.000547,172.31.36.0-255,66,15608,13,363759
964,0.000557,74.125.24.0-255,2902,18510,13,363759
965,0.00056,172.31.36.0-255,66,18576,13,363759
966,0.000574,74.125.24.0-255,5738,24314,13,363759
967,0.000577,172.31.36.0-255,66,24380,13,363759
968,0.000609,74.125.24.0-255,6797,31177,13,363759
969,0.000613,172.31.36.0-255,66,31243,13,363759
970,0.00072,74.125.24.0-255,1484,32727,13,363759
971,0.000725,172.31.36.0-255,66,32793,13,363759
972,0.000731,74.125.24.0-255,2902,35695,13,363759
973,0.000733,172.31.36.0-255,66,35761,13,363759
974,0.000738,74.125.24.0-255,2902,38663,13,363759
975,0.000745,172.31.36.0-255,66,38729,13,363759
976,0.000758,74.125.24.0-255,2902,41631,13,363759
977,0.000761,172.31.36.0-255,66,41697,13,363759
978,0.000769,74.125.24.0-255,1484,43181,13,363759
979,0.000771,172.31.36.0-255,66,43247,13,363759
980,0.000776,74.125.24.0-255,4320,47567,13,363759
981,0.000778,172.31.36.0-255,66,47633,13,363759
982,0.000815,74.125.24.0-255,5379,53012,13,363759
983,0.000819,172.31.36.0-255,66,53078,13,363759
984,0.000824,74.125.24.0-255,2902,55980,13,363759
985,0.000825,172.31.36.0-255,66,56046,13,363759
986,0.000865,74.125.24.0-255,9633,65679,13,363759
987,0.000869,172.31.36.0-255,66,65745,13,363759
988,0.000872,74.125.24.0-255,398,66143,13,363759
989,0.000892,74.125.24.0-255,344,66487,13,363759
990,0.001179,74.125.24.0-255,1484,67971,13,363759
991,0.001184,172.31.36.0-255,66,68037,13,363759
992,0.001214,74.125.24.0-255,2902,70939,13,363759
993,0.001217,172.31.36.0-255,66,71005,13,363759
994,0.001223,74.125.24.0-255,5738,76743,13,363759
995,0.001225,172.31.36.0-255,66,76809,13,363759
996,0.001248,74.125.24.0-255,1484,78293,13,363759
997,0.001273,74.125.24.0-255,7156,85449,13,363759
998,0.001276,172.31.36.0-255,66,85515,13,363759
999,0.001308,74.125.24.0-255,4320,89835,13,363759
1000,0.001312,172.31.36.0-255,66,89901,13,363759
1001,0.001322,74.125.24.0-255,10692,100593,13,363759
1002,0.001331,172.31.36.0-255,66,100659,13,363759
1003,0.001413,74.125.24.0-255,1484,102143,13,363759
1004,0.001419,74.125.24.0-255,2902,105045,13,363759
1005,0.001422,172.31.36.0-255,66,105111,13,363759
1006,0.00145,74.125.24.0-255,5738,110849,13,363759
1007,0.001453,172.31.36.0-255,66,110915,13,363759
1008,0.001458,74.125.24.0-255,2902,113817,13,363759
1009,0.00146,172.31.36.0-255,66,113883,13,363759
1010,0.001488,74.125.24.0-255,9992,123875,13,363759
1011,0.001496,172.31.36.0-255,66,123941,13,363759
1012,0.001506,74.125.24.0-255,9992,133933,13,363759
1013,0.001509,172.31.36.0-255,66,133999,13,363759
1014,0.001535,74.125.24.0-255,766,134765,13,363759
1015,0.001777,172.31.36.0-255,66,134831,13,363759
1016,0.001777,74.125.24.0-255,1484,136315,13,363759
1017,0.001809,74.125.24.0-255,2902,139217,13,363759
1018,0.001812,172.31.36.0-255,66,139283,13,363759
1019,0.001819,74.125.24.0-255,5738,145021,13,363759
1020,0.001821,172.31.36.0-255,66,145087,13,363759
1021,0.001874,172.31.36.0-255,66,145153,13,363759
1022,0.001881,74.125.24.0-255,7156,152309,13,363759
1023,0.001883,172.31.36.0-255,66,152375,13,363759
1024,0.001923,74.125.24.0-255,3602,155977,13,363759
1025,0.001927,172.31.36.0-255,66,156043,13,363759
1026,0.001975,74.125.24.0-255,1484,157527,13,363759
1027,0.00198,74.125.24.0-255,2902,160429,13,363759
1028,0.001983,172.31.36.0-255,66,160495,13,363759
1029,0.00201,74.125.24.0-255,5738,166233,13,363759
1030,0.002013,172.31.36.0-255,66,166299,13,363759
1031,0.002044,74.125.24.0-255,5738,172037,13,363759
1032,0.002047,172.31.36.0-255,66,172103,13,363759
1033,0.002076,74.125.24.0-255,7156,179259,13,363759
1034,0.002079,172.31.36.0-255,66,179325,13,363759
1035,0.002084,74.125.24.0-255,2902,182227,13,363759
1036,0.002085,172.31.36.0-255,66,182293,13,363759
1037,0.002124,74.125.24.0-255,7156,189449,13,363759
1038,0.002128,172.31.36.0-255,66,189515,13,363759
1039,0.002131,74.125.24.0-255,766,190281,13,363759
1040,0.002197,74.125.24.0-255,1484,191765,13,363759
1041,0.0022,172.31.36.0-255,66,191831,13,363759
1042,0.002205,74.125.24.0-255,4320,196151,13,363759
1043,0.002207,172.31.36.0-255,66,196217,13,363759
1044,0.002219,74.125.24.0-255,5738,201955,13,363759
1045,0.002221,172.31.36.0-255,66,202021,13,363759
1046,0.002233,172.31.36.0-255,66,202087,13,363759
1047,0.002243,74.125.24.0-255,10692,212779,13,363759
1048,0.002245,172.31.36.0-255,66,212845,13,363759
1049,0.004435,74.125.24.0-255,5738,218583,13,363759
1050,0.004442,172.31.36.0-255,66,218649,13,363759
1051,0.00661,74.125.24.0-255,4320,222969,13,363759
1052,0.006613,172.31.36.0-255,66,223035,13,363759
1053,0.006637,74.125.24.0-255,1484,224519,13,363759
1054,0.008805,74.125.24.0-255,2902,227421,13,363759
1055,0.008812,172.31.36.0-255,66,227487,13,363759
1056,0.008852,74.125.24.0-255,1484,228971,13,363759
1057,0.010979,74.125.24.0-255,4320,233291,13,363759
1058,0.010987,172.31.36.0-255,66,233357,13,363759
1059,0.013161,74.125.24.0-255,5738,239095,13,363759
1060,0.013169,172.31.36.0-255,66,239161,13,363759
1061,0.015348,74.125.24.0-255,5738,244899,13,363759
1062,0.015356,172.31.36.0-255,66,244965,13,363759
1063,0.017556,74.125.24.0-255,5738,250703,13,363759
1064,0.017569,172.31.36.0-255,66,250769,13,363759
1065,0.019741,74.125.24.0-255,5738,256507,13,363759
1066,0.019751,172.31.36.0-255,66,256573,13,363759
1067,0.021932,74.125.24.0-255,5738,262311,13,363759
1068,0.02194,172.31.36.0-255,66,262377,13,363759
1069,0.02411,74.125.24.0-255,5738,268115,13,363759
1070,0.024119,172.31.36.0-255,66,268181,13,363759
1071,0.026288,74.125.24.0-255,5738,273919,13,363759
1072,0.026296,172.31.36.0-255,66,273985,13,363759
1073,0.02784,172.31.36.0-255,172,274157,13,363759
1074,0.027869,172.31.36.0-255,1110,275267,13,363759
1075,0.027908,172.31.36.0-255,1514,276781,13,363759
1076,0.02791,172.31.36.0-255,1295,278076,13,363759
1077,0.028473,74.125.24.0-255,5738,283814,13,363759
1078,0.028479,172.31.36.0-255,66,283880,13,363759
1079,0.029487,104.244.42.0-255,66,283946,13,363759
1080,0.029667,104.244.42.0-255,66,284012,13,363759
1081,0.02967,104.244.42.0-255,66,284078,13,363759
1082,0.030633,74.125.24.0-255,4320,288398,13,363759
1083,0.030638,172.31.36.0-255,66,288464,13,363759
1084,0.030667,74.125.24.0-255,1484,289948,13,363759
1085,0.03282,74.125.24.0-255,4320,294268,13,363759
1086,0.032825,172.31.36.0-255,66,294334,13,363759
1087,0.035,74.125.24.0-255,4320,298654,13,363759
1088,0.035006,172.31.36.0-255,66,298720,13,363759
1089,0.035041,74.125.24.0-255,1484,300204,13,363759
1090,0.037189,74.125.24.0-255,4320,304524,13,363759
1091,0.037194,172.31.36.0-255,66,304590,13,363759
1092,0.039372,74.125.24.0-255,5738,310328,13,363759
1093,0.039378,172.31.36.0-255,66,310394,13,363759
1094,0.041562,74.125.24.0-255,5738,316132,13,363759
1095,0.041567,172.31.36.0-255,66,316198,13,363759
1096,0.043747,74.125.24.0-255,4320,320518,13,363759
1097,0.043752,172.31.36.0-255,66,320584,13,363759
1098,0.043785,74.125.24.0-255,1484,322068,13,363759
1099,0.045916,74.125.24.0-255,4320,326388,13,363759
1100,0.045921,172.31.36.0-255,66,326454,13,363759
1101,0.04809,74.125.24.0-255,5738,332192,13,363759
1102,0.048095,172.31.36.0-255,66,332258,13,363759
1103,0.050277,74.125.24.0-255,5738,337996,13,363759
1104,0.050282,172.31.36.0-255,66,338062,13,363759
1105,0.052461,74.125.24.0-255,5738,343800,13,363759
1106,0.052466,172.31.36.0-255,66,343866,13,363759
1107,0.054615,74.125.24.0-255,5738,349604,13,363759
1108,0.05462,172.31.36.0-255,66,349670,13,363759
1109,0.056814,74.125.24.0-255,1484,351154,13,363759
1110,0.056848,74.125.24.0-255,4320,355474,13,363759
1111,0.056853,172.31.36.0-255,66,355540,13,363759
1112,0.059005,74.125.24.0-255,5738,361278,13,363759
1113,0.05901,172.31.36.0-255,66,361344,13,363759
1114,0.061184,74.125.24.0-255,2178,363522,13,363759
1115,0.061189,172.31.36.0-255,66,363588,13,363759
1116,0.061356,172.31.36.0-255,105,363693,13,363759
1117,0.0635,74.125.24.0-255,66,363759,13,363759
1118,0.0,74.125.24.0-255,630,630,13,1022
1119,0.001245,74.125.24.0-255,97,727,13,1022
1120,0.001256,172.31.36.0-255,66,793,13,1022
1121,0.005467,172.31.36.0-255,97,890,13,1022
1122,0.006086,74.125.24.0-255,66,956,13,1022
1123,0.00767,74.125.24.0-255,66,1022,13,1022
1124,0.0,172.31.36.0-255,105,105,13,276
1125,0.001606,157.240.13.0-255,105,210,13,276
1126,0.001621,172.31.36.0-255,66,276,13,276
1127,0.0,74.125.200.0-255,153,153,13,364419
1128,3.5e-05,172.31.36.0-255,66,219,13,364419
1129,4.3e-05,74.125.200.0-255,1484,1703,13,364419
1130,4.8e-05,172.31.36.0-255,66,1769,13,364419
1131,5.1e-05,74.125.200.0-255,1484,3253,13,364419
1132,6e-05,172.31.36.0-255,66,3319,13,364419
1133,9.4e-05,74.125.200.0-255,1484,4803,13,364419
1134,9.7e-05,172.31.36.0-255,66,4869,13,364419
1135,0.000107,74.125.200.0-255,5738,10607,13,364419
1136,0.000115,172.31.36.0-255,66,10673,13,364419
1137,0.00012,74.125.200.0-255,3494,14167,13,364419
1138,0.000123,172.31.36.0-255,66,14233,13,364419
1139,0.000128,74.125.200.0-255,4320,18553,13,364419
1140,0.00013,172.31.36.0-255,66,18619,13,364419
1141,0.000141,74.125.200.0-255,9992,28611,13,364419
1142,0.000143,172.31.36.0-255,66,28677,13,364419
1143,0.000148,74.125.200.0-255,2543,31220,13,364419
1144,0.000151,172.31.36.0-255,66,31286,13,364419
1145,0.000299,74.125.200.0-255,1484,32770,13,364419
1146,0.000303,172.31.36.0-255,66,32836,13,364419
1147,0.000309,74.125.200.0-255,2902,35738,13,364419
1148,0.000311,172.31.36.0-255,66,35804,13,364419
1149,0.000335,74.125.200.0-255,4320,40124,13,364419
1150,0.000339,172.31.36.0-255,66,40190,13,364419
1151,0.000347,74.125.200.0-255,1484,41674,13,364419
1152,0.00035,172.31.36.0-255,66,41740,13,364419
1153,0.000364,74.125.200.0-255,4320,46060,13,364419
1154,0.000367,172.31.36.0-255,66,46126,13,364419
1155,0.000396,74.125.200.0-255,3961,50087,13,364419
1156,0.000399,172.31.36.0-255,66,50153,13,364419
1157,0.000405,74.125.200.0-255,4320,54473,13,364419
1158,0.000408,172.31.36.0-255,66,54539,13,364419
1159,0.000411,74.125.200.0-255,1484,56023,13,364419
1160,0.000452,74.125.200.0-255,8574,64597,13,364419
1161,0.000455,172.31.36.0-255,66,64663,13,364419
1162,0.000459,74.125.200.0-255,1393,66056,13,364419
1163,0.000462,74.125.200.0-255,417,66473,13,364419
1164,0.000464,172.31.36.0-255,66,66539,13,364419
1165,0.000645,74.125.200.0-255,1484,68023,13,364419
1166,0.000678,74.125.200.0-255,2902,70925,13,364419
1167,0.000682,172.31.36.0-255,66,70991,13,364419
1168,0.000709,74.125.200.0-255,4320,75311,13,364419
1169,0.000712,172.31.36.0-255,66,75377,13,364419
1170,0.000718,74.125.200.0-255,5738,81115,13,364419
1171,0.00072,172.31.36.0-255,66,81181,13,364419
1172,0.000758,172.31.36.0-255,66,81247,13,364419
1173,0.000763,74.125.200.0-255,4320,85567,13,364419
1174,0.000766,172.31.36.0-255,66,85633,13,364419
1175,0.000799,74.125.200.0-255,3602,89235,13,364419
1176,0.000803,172.31.36.0-255,66,89301,13,364419
1177,0.000948,74.125.200.0-255,1484,90785,13,364419
1178,0.000955,74.125.200.0-255,2902,93687,13,364419
1179,0.000958,172.31.36.0-255,66,93753,13,364419
1180,0.000987,74.125.200.0-255,5738,99491,13,364419
1181,0.000991,172.31.36.0-255,66,99557,13,364419
1182,0.001013,74.125.200.0-255,7156,106713,13,364419
1183,0.001016,172.31.36.0-255,66,106779,13,364419
1184,0.001023,74.125.200.0-255,7156,113935,13,364419
1185,0.001025,172.31.36.0-255,66,114001,13,364419
1186,0.001059,74.125.200.0-255,1484,115485,13,364419
1187,0.001067,74.125.200.0-255,7856,123341,13,364419
1188,0.00107,172.31.36.0-255,66,123407,13,364419
1189,0.001487,74.125.200.0-255,1484,124891,13,364419
1190,0.001535,74.125.200.0-255,2902,127793,13,364419
1191,0.00154,172.31.36.0-255,66,127859,13,364419
1192,0.001544,74.125.200.0-255,1484,129343,13,364419
1193,0.001605,74.125.200.0-255,2902,132245,13,364419
1194,0.001608,172.31.36.0-255,66,132311,13,364419
1195,0.001612,74.125.200.0-255,1484,133795,13,364419
1196,0.001615,74.125.200.0-255,1484,135279,13,364419
1197,0.001617,172.31.36.0-255,66,135345,13,364419
1198,0.001649,74.125.200.0-255,1484,136829,13,364419
1199,0.001656,74.125.200.0-255,5738,142567,13,364419
1200,0.001659,172.31.36.0-255,66,142633,13,364419
1201,0.001665,74.125.200.0-255,4320,146953,13,364419
1202,0.001667,172.31.36.0-255,66,147019,13,364419
1203,0.001679,74.125.200.0-255,4320,151339,13,364419
1204,0.001682,172.31.36.0-255,66,151405,13,364419
1205,0.001709,74.125.200.0-255,1484,152889,13,364419
1206,0.001721,74.125.200.0-255,5020,157909,13,364419
1207,0.001724,172.31.36.0-255,66,157975,13,364419
1208,0.001926,74.125.200.0-255,1484,159459,13,364419
1209,0.001943,74.125.200.0-255,2902,162361,13,364419
1210,0.001948,172.31.36.0-255,66,162427,13,364419
1211,0.00198,74.125.200.0-255,5738,168165,13,364419
1212,0.001983,172.31.36.0-255,66,168231,13,364419
1213,0.001991,74.125.200.0-255,7156,175387,13,364419
1214,0.001993,172.31.36.0-255,66,175453,13,364419
1215,0.002046,74.125.200.0-255,1484,176937,13,364419
1216,0.002051,172.31.36.0-255,66,177003,13,364419
1217,0.002083,74.125.200.0-255,3602,180605,13,364419
1218,0.002087,172.31.36.0-255,66,180671,13,364419
1219,0.004315,74.125.200.0-255,5738,186409,13,364419
1220,0.004323,172.31.36.0-255,66,186475,13,364419
1221,0.006548,74.125.200.0-255,5738,192213,13,364419
1222,0.006555,172.31.36.0-255,66,192279,13,364419
1223,0.008783,74.125.200.0-255,5738,198017,13,364419
1224,0.008789,172.31.36.0-255,66,198083,13,364419
1225,0.011027,74.125.200.0-255,5738,203821,13,364419
1226,0.011036,172.31.36.0-255,66,203887,13,364419
1227,0.013269,74.125.200.0-255,4320,208207,13,364419
1228,0.013277,172.31.36.0-255,66,208273,13,364419
1229,0.013312,74.125.200.0-255,1484,209757,13,364419
1230,0.015517,74.125.200.0-255,4320,214077,13,364419
1231,0.015526,172.31.36.0-255,66,214143,13,364419
1232,0.017762,74.125.200.0-255,5738,219881,13,364419
1233,0.017773,172.31.36.0-255,66,219947,13,364419
1234,0.020007,74.125.200.0-255,5738,225685,13,364419
1235,0.020015,172.31.36.0-255,66,225751,13,364419
1236,0.022261,74.125.200.0-255,5738,231489,13,364419
1237,0.022269,172.31.36.0-255,66,231555,13,364419
1238,0.024531,74.125.200.0-255,5738,237293,13,364419
1239,0.024552,172.31.36.0-255,66,237359,13,364419
1240,0.026811,74.125.200.0-255,5738,243097,13,364419
1241,0.026828,172.31.36.0-255,66,243163,13,364419
1242,0.029074,74.125.200.0-255,5738,248901,13,364419
1243,0.029092,172.31.36.0-255,66,248967,13,364419
1244,0.031322,74.125.200.0-255,5738,254705,13,364419
1245,0.03133,172.31.36.0-255,66,254771,13,364419
1246,0.033558,74.125.200.0-255,5738,260509,13,364419
1247,0.033565,172.31.36.0-255,66,260575,13,364419
1248,0.03358,172.31.36.0-255,172,260747,13,364419
1249,0.033613,172.31.36.0-255,1110,261857,13,364419
1250,0.03371,172.31.36.0-255,1514,263371,13,364419
1251,0.033713,172.31.36.0-255,1295,264666,13,364419
1252,0.035135,104.244.42.0-255,66,264732,13,364419
1253,0.035167,104.244.42.0-255,66,264798,13,364419
1254,0.035254,104.244.42.0-255,66,264864,13,364419
1255,0.035785,74.125.200.0-255,5738,270602,13,364419
1256,0.035791,172.31.36.0-255,66,270668,13,364419
1257,0.038012,74.125.200.0-255,1484,272152,13,364419
1258,0.038047,74.125.200.0-255,4320,276472,13,364419
1259,0.038053,172.31.36.0-255,66,276538,13,364419
1260,0.040284,74.125.200.0-255,5738,282276,13,364419
1261,0.040289,172.31.36.0-255,66,282342,13,364419
1262,0.042518,74.125.200.0-255,5738,288080,13,364419
1263,0.042524,172.31.36.0-255,66,288146,13,364419
1264,0.044748,74.125.200.0-255,5738,293884,13,364419
1265,0.044753,172.31.36.0-255,66,293950,13,364419
1266,0.046986,74.125.200.0-255,4320,298270,13,364419
1267,0.04699,172.31.36.0-255,66,298336,13,364419
1268,0.047019,74.125.200.0-255,1484,299820,13,364419
1269,0.049254,74.125.200.0-255,4320,304140,13,364419
1270,0.04926,172.31.36.0-255,66,304206,13,364419
1271,0.051477,74.125.200.0-255,2902,307108,13,364419
1272,0.051483,172.31.36.0-255,66,307174,13,364419
1273,0.051515,74.125.200.0-255,2902,310076,13,364419
1274,0.051518,172.31.36.0-255,66,310142,13,364419
1275,0.053711,74.125.200.0-255,2902,313044,13,364419
1276,0.053717,172.31.36.0-255,66,313110,13,364419
1277,0.053751,74.125.200.0-255,2902,316012,13,364419
1278,0.053755,172.31.36.0-255,66,316078,13,364419
1279,0.055949,74.125.200.0-255,2902,318980,13,364419
1280,0.055955,172.31.36.0-255,66,319046,13,364419
1281,0.05599,74.125.200.0-255,2902,321948,13,364419
1282,0.055993,172.31.36.0-255,66,322014,13,364419
1283,0.058177,74.125.200.0-255,2902,324916,13,364419
1284,0.058182,172.31.36.0-255,66,324982,13,364419
1285,0.058223,74.125.200.0-255,2902,327884,13,364419
1286,0.058227,172.31.36.0-255,66,327950,13,364419
1287,0.060404,74.125.200.0-255,2902,330852,13,364419
1288,0.060409,172.31.36.0-255,66,330918,13,364419
1289,0.060446,74.125.200.0-255,2902,333820,13,364419
1290,0.060449,172.31.36.0-255,66,333886,13,364419
1291,0.062626,74.125.200.0-255,2902,336788,13,364419
1292,0.062632,172.31.36.0-255,66,336854,13,364419
1293,0.062666,74.125.200.0-255,2902,339756,13,364419
1294,0.062669,172.31.36.0-255,66,339822,13,364419
1295,0.064855,74.125.200.0-255,2902,342724,13,364419
1296,0.064861,172.31.36.0-255,66,342790,13,364419
1297,0.064897,74.125.200.0-255,2902,345692,13,364419
1298,0.064901,172.31.36.0-255,66,345758,13,364419
1299,0.067094,74.125.200.0-255,2902,348660,13,364419
1300,0.0671,172.31.36.0-255,66,348726,13,364419
1301,0.067137,74.125.200.0-255,1484,350210,13,364419
1302,0.067155,74.125.200.0-255,1484,351694,13,364419
1303,0.067158,172.31.36.0-255,66,351760,13,364419
1304,0.069321,74.125.200.0-255,2902,354662,13,364419
1305,0.069327,172.31.36.0-255,66,354728,13,364419
1306,0.069372,74.125.200.0-255,2902,357630,13,364419
1307,0.069376,172.31.36.0-255,66,357696,13,364419
1308,0.071552,74.125.200.0-255,2902,360598,13,364419
1309,0.071557,172.31.36.0-255,66,360664,13,364419
1310,0.071598,74.125.200.0-255,2902,363566,13,364419
1311,0.071602,172.31.36.0-255,66,363632,13,364419
1312,0.073759,74.125.200.0-255,550,364182,13,364419
1313,0.073927,172.31.36.0-255,66,364248,13,364419
1314,0.073957,172.31.36.0-255,105,364353,13,364419
1315,0.076144,74.125.200.0-255,66,364419,13,364419
1316,0.0,74.125.24.0-255,146,146,13,307290
1317,2.3e-05,172.31.36.0-255,66,212,13,307290
1318,4.7e-05,74.125.24.0-255,1484,1696,13,307290
1319,5.1e-05,172.31.36.0-255,66,1762,13,307290
1320,7.3e-05,74.125.24.0-255,2902,4664,13,307290
1321,7.5e-05,172.31.36.0-255,66,4730,13,307290
1322,9.7e-05,74.125.24.0-255,5738,10468,13,307290
1323,9.9e-05,172.31.36.0-255,66,10534,13,307290
1324,0.000132,74.125.24.0-255,4320,14854,13,307290
1325,0.000135,172.31.36.0-255,66,14920,13,307290
1326,0.00016,74.125.24.0-255,6339,21259,13,307290
1327,0.000163,172.31.36.0-255,66,21325,13,307290
1328,0.000168,74.125.24.0-255,4320,25645,13,307290
1329,0.00017,172.31.36.0-255,66,25711,13,307290
1330,0.000189,74.125.24.0-255,5379,31090,13,307290
1331,0.000192,172.31.36.0-255,66,31156,13,307290
1332,0.000483,74.125.24.0-255,1484,32640,13,307290
1333,0.000487,172.31.36.0-255,66,32706,13,307290
1334,0.000504,74.125.24.0-255,1484,34190,13,307290
1335,0.000506,172.31.36.0-255,66,34256,13,307290
1336,0.000529,74.125.24.0-255,1484,35740,13,307290
1337,0.000531,172.31.36.0-255,66,35806,13,307290
1338,0.000537,74.125.24.0-255,5738,41544,13,307290
1339,0.000539,172.31.36.0-255,66,41610,13,307290
1340,0.000543,74.125.24.0-255,2902,44512,13,307290
1341,0.000547,172.31.36.0-255,66,44578,13,307290
1342,0.000574,74.125.24.0-255,7156,51734,13,307290
1343,0.000577,172.31.36.0-255,66,51800,13,307290
1344,0.000585,74.125.24.0-255,8574,60374,13,307290
1345,0.000587,172.31.36.0-255,66,60440,13,307290
1346,0.000606,74.125.24.0-255,2902,63342,13,307290
1347,0.000609,172.31.36.0-255,66,63408,13,307290
1348,0.000613,74.125.24.0-255,2184,65592,13,307290
1349,0.000615,172.31.36.0-255,66,65658,13,307290
1350,0.000627,74.125.24.0-255,361,66019,13,307290
1351,0.00063,172.31.36.0-255,66,66085,13,307290
1352,0.000914,74.125.24.0-255,130,66215,13,307290
1353,0.000917,172.31.36.0-255,66,66281,13,307290
1354,0.000963,74.125.24.0-255,1484,67765,13,307290
1355,0.000966,172.31.36.0-255,66,67831,13,307290
1356,0.000968,74.125.24.0-255,1484,69315,13,307290
1357,0.000971,172.31.36.0-255,66,69381,13,307290
1358,0.000982,74.125.24.0-255,1484,70865,13,307290
1359,0.000985,172.31.36.0-255,66,70931,13,307290
1360,0.000988,74.125.24.0-255,1484,72415,13,307290
1361,0.00099,172.31.36.0-255,66,72481,13,307290
1362,0.001022,74.125.24.0-255,4320,76801,13,307290
1363,0.001025,172.31.36.0-255,66,76867,13,307290
1364,0.001032,74.125.24.0-255,7156,84023,13,307290
1365,0.001034,172.31.36.0-255,66,84089,13,307290
1366,0.001084,172.31.36.0-255,66,84155,13,307290
1367,0.001109,74.125.24.0-255,2184,86339,13,307290
1368,0.001111,172.31.36.0-255,66,86405,13,307290
1369,0.003415,74.125.24.0-255,2902,89307,13,307290
1370,0.003422,172.31.36.0-255,66,89373,13,307290
1371,0.003445,74.125.24.0-255,2902,92275,13,307290
1372,0.003448,172.31.36.0-255,66,92341,13,307290
1373,0.00574,74.125.24.0-255,2902,95243,13,307290
1374,0.005746,172.31.36.0-255,66,95309,13,307290
1375,0.00576,74.125.24.0-255,2902,98211,13,307290
1376,0.005762,172.31.36.0-255,66,98277,13,307290
1377,0.00808,74.125.24.0-255,5738,104015,13,307290
1378,0.008086,172.31.36.0-255,66,104081,13,307290
1379,0.010412,74.125.24.0-255,5738,109819,13,307290
1380,0.010421,172.31.36.0-255,66,109885,13,307290
1381,0.012743,74.125.24.0-255,5738,115623,13,307290
1382,0.012754,172.31.36.0-255,66,115689,13,307290
1383,0.015098,74.125.24.0-255,5738,121427,13,307290
1384,0.015107,172.31.36.0-255,66,121493,13,307290
1385,0.017419,74.125.24.0-255,5738,127231,13,307290
1386,0.017427,172.31.36.0-255,66,127297,13,307290
1387,0.019839,74.125.24.0-255,5738,133035,13,307290
1388,0.019858,172.31.36.0-255,66,133101,13,307290
1389,0.022188,74.125.24.0-255,5738,138839,13,307290
1390,0.022203,172.31.36.0-255,66,138905,13,307290
1391,0.024553,74.125.24.0-255,5738,144643,13,307290
1392,0.024568,172.31.36.0-255,66,144709,13,307290
1393,0.026906,74.125.24.0-255,4320,149029,13,307290
1394,0.026915,172.31.36.0-255,66,149095,13,307290
1395,0.026935,74.125.24.0-255,1484,150579,13,307290
1396,0.026939,172.31.36.0-255,66,150645,13,307290
1397,0.02735,172.31.36.0-255,172,150817,13,307290
1398,0.027391,172.31.36.0-255,1110,151927,13,307290
1399,0.027465,172.31.36.0-255,1514,153441,13,307290
1400,0.027467,172.31.36.0-255,1295,154736,13,307290
1401,0.028928,104.244.42.0-255,66,154802,13,307290
1402,0.028957,104.244.42.0-255,66,154868,13,307290
1403,0.029049,104.244.42.0-255,66,154934,13,307290
1404,0.029228,74.125.24.0-255,2902,157836,13,307290
1405,0.029234,172.31.36.0-255,66,157902,13,307290
1406,0.029268,74.125.24.0-255,2902,160804,13,307290
1407,0.029271,172.31.36.0-255,66,160870,13,307290
1408,0.031584,74.125.24.0-255,2902,163772,13,307290
1409,0.031592,172.31.36.0-255,66,163838,13,307290
1410,0.031623,74.125.24.0-255,2902,166740,13,307290
1411,0.031627,172.31.36.0-255,66,166806,13,307290
1412,0.033928,74.125.24.0-255,2902,169708,13,307290
1413,0.033937,172.31.36.0-255,66,169774,13,307290
1414,0.033963,74.125.24.0-255,2902,172676,13,307290
1415,0.033966,172.31.36.0-255,66,172742,13,307290
1416,0.036285,74.125.24.0-255,5738,178480,13,307290
1417,0.036292,172.31.36.0-255,66,178546,13,307290
1418,0.038639,74.125.24.0-255,5738,184284,13,307290
1419,0.038648,172.31.36.0-255,66,184350,13,307290
1420,0.040995,74.125.24.0-255,5738,190088,13,307290
1421,0.041005,172.31.36.0-255,66,190154,13,307290
1422,0.043344,74.125.24.0-255,5738,195892,13,307290
1423,0.043352,172.31.36.0-255,66,195958,13,307290
1424,0.045685,74.125.24.0-255,5738,201696,13,307290
1425,0.045694,172.31.36.0-255,66,201762,13,307290
1426,0.04803,74.125.24.0-255,5738,207500,13,307290
1427,0.048045,172.31.36.0-255,66,207566,13,307290
1428,0.050388,74.125.24.0-255,5738,213304,13,307290
1429,0.050397,172.31.36.0-255,66,213370,13,307290
1430,0.052732,74.125.24.0-255,5738,219108,13,307290
1431,0.052741,172.31.36.0-255,66,219174,13,307290
1432,0.055077,74.125.24.0-255,5738,224912,13,307290
1433,0.055085,172.31.36.0-255,66,224978,13,307290
1434,0.057443,74.125.24.0-255,5738,230716,13,307290
1435,0.057452,172.31.36.0-255,66,230782,13,307290
1436,0.059821,74.125.24.0-255,5738,236520,13,307290
1437,0.059829,172.31.36.0-255,66,236586,13,307290
1438,0.062176,74.125.24.0-255,5738,242324,13,307290
1439,0.062184,172.31.36.0-255,66,242390,13,307290
1440,0.06458,74.125.24.0-255,5738,248128,13,307290
1441,0.0646,172.31.36.0-255,66,248194,13,307290
1442,0.066972,74.125.24.0-255,5738,253932,13,307290
1443,0.066981,172.31.36.0-255,66,253998,13,307290
1444,0.069302,74.125.24.0-255,5738,259736,13,307290
1445,0.069308,172.31.36.0-255,66,259802,13,307290
1446,0.071638,74.125.24.0-255,2902,262704,13,307290
1447,0.071644,172.31.36.0-255,66,262770,13,307290
1448,0.071675,74.125.24.0-255,2902,265672,13,307290
1449,0.071702,172.31.36.0-255,66,265738,13,307290
1450,0.073977,74.125.24.0-255,2902,268640,13,307290
1451,0.073983,172.31.36.0-255,66,268706,13,307290
1452,0.074016,74.125.24.0-255,2902,271608,13,307290
1453,0.074043,172.31.36.0-255,66,271674,13,307290
1454,0.076326,74.125.24.0-255,2902,274576,13,307290
1455,0.076331,172.31.36.0-255,66,274642,13,307290
1456,0.076364,74.125.24.0-255,2902,277544,13,307290
1457,0.076389,172.31.36.0-255,66,277610,13,307290
1458,0.078664,74.125.24.0-255,2902,280512,13,307290
1459,0.07867,172.31.36.0-255,66,280578,13,307290
1460,0.078725,74.125.24.0-255,2902,283480,13,307290
1461,0.078751,172.31.36.0-255,66,283546,13,307290
1462,0.080986,74.125.24.0-255,2902,286448,13,307290
1463,0.080991,172.31.36.0-255,66,286514,13,307290
1464,0.081065,74.125.24.0-255,2902,289416,13,307290
1465,0.081073,172.31.36.0-255,66,289482,13,307290
1466,0.083311,74.125.24.0-255,2902,292384,13,307290
1467,0.08332,172.31.36.0-255,66,292450,13,307290
1468,0.083381,74.125.24.0-255,2902,295352,13,307290
1469,0.083405,172.31.36.0-255,66,295418,13,307290
1470,0.085675,74.125.24.0-255,2902,298320,13,307290
1471,0.08568,172.31.36.0-255,66,298386,13,307290
1472,0.085719,74.125.24.0-255,2902,301288,13,307290
1473,0.085738,172.31.36.0-255,66,301354,13,307290
1474,0.087996,74.125.24.0-255,2902,304256,13,307290
1475,0.088001,172.31.36.0-255,66,304322,13,307290
1476,0.088058,74.125.24.0-255,2902,307224,13,307290
1477,0.08808,172.31.36.0-255,66,307290,13,307290
1478,0.0,74.125.200.0-255,153,153,13,321670
1479,1.9e-05,172.31.36.0-255,66,219,13,321670
1480,2.5e-05,74.125.200.0-255,1484,1703,13,321670
1481,3e-05,172.31.36.0-255,66,1769,13,321670
1482,3.6e-05,74.125.200.0-255,2902,4671,13,321670
1483,3.9e-05,172.31.36.0-255,66,4737,13,321670
1484,6.2e-05,74.125.200.0-255,7156,11893,13,321670
1485,6.6e-05,172.31.36.0-255,66,11959,13,321670
1486,7e-05,74.125.200.0-255,2037,13996,13,321670
1487,7.3e-05,172.31.36.0-255,66,14062,13,321670
1488,0.00017,74.125.200.0-255,1484,15546,13,321670
1489,0.000173,172.31.36.0-255,66,15612,13,321670
1490,0.00019,74.125.200.0-255,2902,18514,13,321670
1491,0.000193,172.31.36.0-255,66,18580,13,321670
1492,0.0002,74.125.200.0-255,5738,24318,13,321670
1493,0.000203,172.31.36.0-255,66,24384,13,321670
1494,0.000215,74.125.200.0-255,1484,25868,13,321670
1495,0.000218,172.31.36.0-255,66,25934,13,321670
1496,0.000238,74.125.200.0-255,5379,31313,13,321670
1497,0.000241,172.31.36.0-255,66,31379,13,321670
1498,0.000275,74.125.200.0-255,7156,38535,13,321670
1499,0.000278,172.31.36.0-255,66,38601,13,321670
1500,0.000281,74.125.200.0-255,1484,40085,13,321670
1501,0.000283,172.31.36.0-255,66,40151,13,321670
1502,0.000305,74.125.200.0-255,7156,47307,13,321670
1503,0.000308,172.31.36.0-255,66,47373,13,321670
1504,0.000311,74.125.200.0-255,1125,48498,13,321670
1505,0.000314,172.31.36.0-255,66,48564,13,321670
1506,0.001504,74.125.200.0-255,1484,50048,13,321670
1507,0.001511,172.31.36.0-255,66,50114,13,321670
1508,0.001521,74.125.200.0-255,2902,53016,13,321670
1509,0.001524,172.31.36.0-255,66,53082,13,321670
1510,0.001532,74.125.200.0-255,5738,58820,13,321670
1511,0.001534,172.31.36.0-255,66,58886,13,321670
1512,0.001538,74.125.200.0-255,2902,61788,13,321670
1513,0.001541,172.31.36.0-255,66,61854,13,321670
1514,0.001547,74.125.200.0-255,3961,65815,13,321670
1515,0.001549,172.31.36.0-255,66,65881,13,321670
1516,0.00159,74.125.200.0-255,8574,74455,13,321670
1517,0.001592,172.31.36.0-255,66,74521,13,321670
1518,0.001597,74.125.200.0-255,2902,77423,13,321670
1519,0.001598,172.31.36.0-255,66,77489,13,321670
1520,0.001629,74.125.200.0-255,7156,84645,13,321670
1521,0.001631,172.31.36.0-255,66,84711,13,321670
1522,0.001661,74.125.200.0-255,5738,90449,13,321670
1523,0.001663,172.31.36.0-255,66,90515,13,321670
1524,0.001673,74.125.200.0-255,9274,99789,13,321670
1525,0.001674,172.31.36.0-255,66,99855,13,321670
1526,0.001677,74.125.200.0-255,645,100500,13,321670
1527,0.004002,74.125.200.0-255,4320,104820,13,321670
1528,0.004007,172.31.36.0-255,66,104886,13,321670
1529,0.006329,74.125.200.0-255,5738,110624,13,321670
1530,0.006335,172.31.36.0-255,66,110690,13,321670
1531,0.008662,74.125.200.0-255,5738,116428,13,321670
1532,0.008669,172.31.36.0-255,66,116494,13,321670
1533,0.010996,74.125.200.0-255,5738,122232,13,321670
1534,0.011004,172.31.36.0-255,66,122298,13,321670
1535,0.013325,74.125.200.0-255,5738,128036,13,321670
1536,0.013335,172.31.36.0-255,66,128102,13,321670
1537,0.015656,74.125.200.0-255,5738,133840,13,321670
1538,0.015665,172.31.36.0-255,66,133906,13,321670
1539,0.017998,74.125.200.0-255,5738,139644,13,321670
1540,0.018007,172.31.36.0-255,66,139710,13,321670
1541,0.020337,74.125.200.0-255,5738,145448,13,321670
1542,0.020348,172.31.36.0-255,66,145514,13,321670
1543,0.022689,74.125.200.0-255,5738,151252,13,321670
1544,0.022698,172.31.36.0-255,66,151318,13,321670
1545,0.025024,74.125.200.0-255,5738,157056,13,321670
1546,0.025032,172.31.36.0-255,66,157122,13,321670
1547,0.027371,74.125.200.0-255,5738,162860,13,321670
1548,0.027378,172.31.36.0-255,66,162926,13,321670
1549,0.029696,74.125.200.0-255,5738,168664,13,321670
1550,0.029705,172.31.36.0-255,66,168730,13,321670
1551,0.03204,74.125.200.0-255,5738,174468,13,321670
1552,0.032054,172.31.36.0-255,66,174534,13,321670
1553,0.034379,74.125.200.0-255,5738,180272,13,321670
1554,0.034388,172.31.36.0-255,66,180338,13,321670
1555,0.036707,74.125.200.0-255,5738,186076,13,321670
1556,0.036716,172.31.36.0-255,66,186142,13,321670
1557,0.039041,74.125.200.0-255,5738,191880,13,321670
1558,0.039054,172.31.36.0-255,66,191946,13,321670
1559,0.041377,74.125.200.0-255,5738,197684,13,321670
1560,0.041384,172.31.36.0-255,66,197750,13,321670
1561,0.04159,172.31.36.0-255,176,197926,13,321670
1562,0.041622,172.31.36.0-255,1111,199037,13,321670
1563,0.041757,172.31.36.0-255,1514,200551,13,321670
1564,0.04176,172.31.36.0-255,1514,202065,13,321670
1565,0.041761,172.31.36.0-255,1514,203579,13,321670
1566,0.041762,172.31.36.0-255,1514,205093,13,321670
1567,0.041763,172.31.36.0-255,1514,206607,13,321670
1568,0.041793,172.31.36.0-255,71,206678,13,321670
1569,0.043114,104.244.42.0-255,66,206744,13,321670
1570,0.043157,104.244.42.0-255,66,206810,13,321670
1571,0.04332,104.244.42.0-255,66,206876,13,321670
1572,0.043325,104.244.42.0-255,66,206942,13,321670
1573,0.043698,74.125.200.0-255,5738,212680,13,321670
1574,0.043704,172.31.36.0-255,66,212746,13,321670
1575,0.046034,74.125.200.0-255,5738,218484,13,321670
1576,0.046041,172.31.36.0-255,66,218550,13,321670
1577,0.048364,74.125.200.0-255,5738,224288,13,321670
1578,0.048373,172.31.36.0-255,66,224354,13,321670
1579,0.050721,74.125.200.0-255,5738,230092,13,321670
1580,0.05073,172.31.36.0-255,66,230158,13,321670
1581,0.053063,74.125.200.0-255,5738,235896,13,321670
1582,0.05307,172.31.36.0-255,66,235962,13,321670
1583,0.055388,74.125.200.0-255,5738,241700,13,321670
1584,0.055394,172.31.36.0-255,66,241766,13,321670
1585,0.057721,74.125.200.0-255,5738,247504,13,321670
1586,0.057728,172.31.36.0-255,66,247570,13,321670
1587,0.060048,74.125.200.0-255,5738,253308,13,321670
1588,0.060055,172.31.36.0-255,66,253374,13,321670
1589,0.062389,74.125.200.0-255,5738,259112,13,321670
1590,0.062397,172.31.36.0-255,66,259178,13,321670
1591,0.064756,74.125.200.0-255,5738,264916,13,321670
1592,0.064762,172.31.36.0-255,66,264982,13,321670
1593,0.067102,74.125.200.0-255,5738,270720,13,321670
1594,0.067113,172.31.36.0-255,66,270786,13,321670
1595,0.06945,74.125.200.0-255,5738,276524,13,321670
1596,0.069456,172.31.36.0-255,66,276590,13,321670
1597,0.07178,74.125.200.0-255,5738,282328,13,321670
1598,0.071786,172.31.36.0-255,66,282394,13,321670
1599,0.074121,74.125.200.0-255,5738,288132,13,321670
1600,0.074127,172.31.36.0-255,66,288198,13,321670
1601,0.076457,74.125.200.0-255,5738,293936,13,321670
1602,0.076464,172.31.36.0-255,66,294002,13,321670
1603,0.078787,74.125.200.0-255,5738,299740,13,321670
1604,0.078795,172.31.36.0-255,66,299806,13,321670
1605,0.081112,74.125.200.0-255,4320,304126,13,321670
1606,0.08112,172.31.36.0-255,66,304192,13,321670
1607,0.08114,74.125.200.0-255,1484,305676,13,321670
1608,0.083466,74.125.200.0-255,4320,309996,13,321670
1609,0.083481,172.31.36.0-255,66,310062,13,321670
1610,0.085827,74.125.200.0-255,5738,315800,13,321670
1611,0.085835,172.31.36.0-255,66,315866,13,321670
1612,0.088166,74.125.200.0-255,5738,321604,13,321670
1613,0.088173,172.31.36.0-255,66,321670,13,321670
1614,0.0,172.217.194.0-255,153,153,13,194663
1615,2.8e-05,172.31.36.0-255,66,219,13,194663
1616,3.5e-05,172.217.194.0-255,1484,1703,13,194663
1617,3.9e-05,172.31.36.0-255,66,1769,13,194663
1618,4.4e-05,172.217.194.0-255,2902,4671,13,194663
1619,4.6e-05,172.31.36.0-255,66,4737,13,194663
1620,7.6e-05,172.217.194.0-255,1484,6221,13,194663
1621,8e-05,172.31.36.0-255,66,6287,13,194663
1622,0.00011,172.217.194.0-255,5738,12025,13,194663
1623,0.000113,172.31.36.0-255,66,12091,13,194663
1624,0.000226,172.217.194.0-255,5738,17829,13,194663
1625,0.000231,172.31.36.0-255,66,17895,13,194663
1626,0.000245,172.217.194.0-255,3468,21363,13,194663
1627,0.000248,172.31.36.0-255,66,21429,13,194663
1628,0.000368,172.217.194.0-255,7156,28585,13,194663
1629,0.000373,172.31.36.0-255,66,28651,13,194663
1630,0.000391,172.217.194.0-255,9992,38643,13,194663
1631,0.000395,172.31.36.0-255,66,38709,13,194663
1632,0.000658,172.217.194.0-255,9274,47983,13,194663
1633,0.000663,172.31.36.0-255,66,48049,13,194663
1634,0.000804,172.217.194.0-255,4320,52369,13,194663
1635,0.000808,172.31.36.0-255,66,52435,13,194663
1636,0.000837,172.31.36.0-255,66,52501,13,194663
1637,0.001095,172.217.194.0-255,9992,62493,13,194663
1638,0.001102,172.31.36.0-255,66,62559,13,194663
1639,0.00114,172.31.36.0-255,66,62625,13,194663
1640,0.001563,172.217.194.0-255,5738,68363,13,194663
1641,0.001566,172.31.36.0-255,66,68429,13,194663
1642,0.001608,172.31.36.0-255,66,68495,13,194663
1643,0.001627,172.217.194.0-255,1592,70087,13,194663
1644,0.002216,172.217.194.0-255,4320,74407,13,194663
1645,0.003196,172.217.194.0-255,5738,80145,13,194663
1646,0.003815,172.31.36.0-255,66,80211,13,194663
1647,0.004187,172.217.194.0-255,8574,88785,13,194663
1648,0.004198,172.31.36.0-255,66,88851,13,194663
1649,0.004239,172.31.36.0-255,66,88917,13,194663
1650,0.006481,172.217.194.0-255,4320,93237,13,194663
1651,0.006487,172.31.36.0-255,66,93303,13,194663
1652,0.006502,172.217.194.0-255,1484,94787,13,194663
1653,0.008769,172.217.194.0-255,4320,99107,13,194663
1654,0.008776,172.31.36.0-255,66,99173,13,194663
1655,0.01107,172.217.194.0-255,5738,104911,13,194663
1656,0.012279,172.31.36.0-255,66,104977,13,194663
1657,0.014563,172.217.194.0-255,5738,110715,13,194663
1658,0.014572,172.31.36.0-255,66,110781,13,194663
1659,0.016855,172.217.194.0-255,5738,116519,13,194663
1660,0.016863,172.31.36.0-255,66,116585,13,194663
1661,0.019139,172.217.194.0-255,5738,122323,13,194663
1662,0.01915,172.31.36.0-255,66,122389,13,194663
1663,0.021431,172.217.194.0-255,5738,128127,13,194663
1664,0.021438,172.31.36.0-255,66,128193,13,194663
1665,0.023692,172.217.194.0-255,5738,133931,13,194663
1666,0.0237,172.31.36.0-255,66,133997,13,194663
1667,0.025981,172.217.194.0-255,5738,139735,13,194663
1668,0.025988,172.31.36.0-255,66,139801,13,194663
1669,0.028235,172.217.194.0-255,5738,145539,13,194663
1670,0.028243,172.31.36.0-255,66,145605,13,194663
1671,0.030531,172.217.194.0-255,5738,151343,13,194663
1672,0.030538,172.31.36.0-255,66,151409,13,194663
1673,0.032805,172.217.194.0-255,4320,155729,13,194663
1674,0.032812,172.31.36.0-255,66,155795,13,194663
1675,0.032839,172.217.194.0-255,1484,157279,13,194663
1676,0.033896,172.31.36.0-255,200,157479,13,194663
1677,0.033923,172.31.36.0-255,1106,158585,13,194663
1678,0.033964,172.31.36.0-255,1514,160099,13,194663
1679,0.033966,172.31.36.0-255,1299,161398,13,194663
1680,0.035081,172.217.194.0-255,4320,165718,13,194663
1681,0.035088,172.31.36.0-255,66,165784,13,194663
1682,0.035443,104.244.42.0-255,66,165850,13,194663
1683,0.03545,104.244.42.0-255,66,165916,13,194663
1684,0.035501,104.244.42.0-255,66,165982,13,194663
1685,0.037357,172.217.194.0-255,5738,171720,13,194663
1686,0.0374,172.31.36.0-255,66,171786,13,194663
1687,0.039675,172.217.194.0-255,5738,177524,13,194663
1688,0.039681,172.31.36.0-255,66,177590,13,194663
1689,0.041936,172.217.194.0-255,5738,183328,13,194663
1690,0.041942,172.31.36.0-255,66,183394,13,194663
1691,0.044202,172.217.194.0-255,4320,187714,13,194663
1692,0.044207,172.31.36.0-255,66,187780,13,194663
1693,0.044238,172.217.194.0-255,1484,189264,13,194663
1694,0.046458,172.217.194.0-255,4320,193584,13,194663
1695,0.046463,172.31.36.0-255,66,193650,13,194663
1696,0.048722,172.217.194.0-255,776,194426,13,194663
1697,0.04886,172.31.36.0-255,66,194492,13,194663
1698,0.048886,172.31.36.0-255,105,194597,13,194663
1699,0.051102,172.217.194.0-255,66,194663,13,194663
1700,0.0,74.125.24.0-255,296,296,13,353576
1701,2.4e-05,172.31.36.0-255,66,362,13,353576
1702,3.1e-05,74.125.24.0-255,1484,1846,13,353576
1703,3.5e-05,172.31.36.0-255,66,1912,13,353576
1704,4.2e-05,74.125.24.0-255,4320,6232,13,353576
1705,4.6e-05,172.31.36.0-255,66,6298,13,353576
1706,5e-05,74.125.24.0-255,2902,9200,13,353576
1707,5.4e-05,172.31.36.0-255,66,9266,13,353576
1708,7.6e-05,74.125.24.0-255,4320,13586,13,353576
1709,7.9e-05,172.31.36.0-255,66,13652,13,353576
1710,0.000133,172.31.36.0-255,66,13718,13,353576
1711,0.000173,74.125.24.0-255,3961,17679,13,353576
1712,0.000177,172.31.36.0-255,66,17745,13,353576
1713,0.000196,74.125.24.0-255,2902,20647,13,353576
1714,0.000199,172.31.36.0-255,66,20713,13,353576
1715,0.000215,74.125.24.0-255,1484,22197,13,353576
1716,0.000219,172.31.36.0-255,66,22263,13,353576
1717,0.000232,74.125.24.0-255,5738,28001,13,353576
1718,0.000234,172.31.36.0-255,66,28067,13,353576
1719,0.000257,74.125.24.0-255,2902,30969,13,353576
1720,0.000259,172.31.36.0-255,66,31035,13,353576
1721,0.000302,74.125.24.0-255,9992,41027,13,353576
1722,0.000305,172.31.36.0-255,66,41093,13,353576
1723,0.000326,74.125.24.0-255,4320,45413,13,353576
1724,0.000328,172.31.36.0-255,66,45479,13,353576
1725,0.000365,74.125.24.0-255,5738,51217,13,353576
1726,0.000368,172.31.36.0-255,66,51283,13,353576
1727,0.000379,74.125.24.0-255,1056,52339,13,353576
1728,0.000383,172.31.36.0-255,66,52405,13,353576
1729,0.000386,74.125.24.0-255,386,52791,13,353576
1730,0.000388,172.31.36.0-255,66,52857,13,353576
1731,0.000441,74.125.24.0-255,1484,54341,13,353576
1732,0.000446,74.125.24.0-255,1484,55825,13,353576
1733,0.000448,172.31.36.0-255,66,55891,13,353576
1734,0.000452,74.125.24.0-255,1484,57375,13,353576
1735,0.000469,74.125.24.0-255,2902,60277,13,353576
1736,0.000472,172.31.36.0-255,66,60343,13,353576
1737,0.000478,74.125.24.0-255,5738,66081,13,353576
1738,0.000481,172.31.36.0-255,66,66147,13,353576
1739,0.000497,74.125.24.0-255,4320,70467,13,353576
1740,0.0005,172.31.36.0-255,66,70533,13,353576
1741,0.00054,74.125.24.0-255,7156,77689,13,353576
1742,0.000544,172.31.36.0-255,66,77755,13,353576
1743,0.000569,74.125.24.0-255,8726,86481,13,353576
1744,0.000572,172.31.36.0-255,66,86547,13,353576
1745,0.000637,74.125.24.0-255,5738,92285,13,353576
1746,0.00064,172.31.36.0-255,66,92351,13,353576
1747,0.000658,74.125.24.0-255,8574,100925,13,353576
1748,0.000662,172.31.36.0-255,66,100991,13,353576
1749,0.00068,74.125.24.0-255,1484,102475,13,353576
1750,0.000737,74.125.24.0-255,7156,109631,13,353576
1751,0.000741,172.31.36.0-255,66,109697,13,353576
1752,0.000768,74.125.24.0-255,9992,119689,13,353576
1753,0.000771,172.31.36.0-255,66,119755,13,353576
1754,0.000828,74.125.24.0-255,766,120521,13,353576
1755,0.000833,74.125.24.0-255,1484,122005,13,353576
1756,0.000836,172.31.36.0-255,66,122071,13,353576
1757,0.00086,74.125.24.0-255,7156,129227,13,353576
1758,0.000869,172.31.36.0-255,66,129293,13,353576
1759,0.000915,172.31.36.0-255,66,129359,13,353576
1760,0.000968,74.125.24.0-255,4320,133679,13,353576
1761,0.000972,172.31.36.0-255,66,133745,13,353576
1762,0.001,74.125.24.0-255,9274,143019,13,353576
1763,0.001005,172.31.36.0-255,66,143085,13,353576
1764,0.001054,74.125.24.0-255,1484,144569,13,353576
1765,0.00106,74.125.24.0-255,2902,147471,13,353576
1766,0.00108,74.125.24.0-255,5738,153209,13,353576
1767,0.001085,172.31.36.0-255,66,153275,13,353576
1768,0.001096,172.31.36.0-255,66,153341,13,353576
1769,0.001104,74.125.24.0-255,1484,154825,13,353576
1770,0.001122,74.125.24.0-255,9992,164817,13,353576
1771,0.001139,74.125.24.0-255,1484,166301,13,353576
1772,0.001142,172.31.36.0-255,66,166367,13,353576
1773,0.001244,74.125.24.0-255,4320,170687,13,353576
1774,0.001271,74.125.24.0-255,6438,177125,13,353576
1775,0.001279,74.125.24.0-255,7156,184281,13,353576
1776,0.001292,74.125.24.0-255,1484,185765,13,353576
1777,0.001299,172.31.36.0-255,66,185831,13,353576
1778,0.00131,74.125.24.0-255,2902,188733,13,353576
1779,0.001316,172.31.36.0-255,66,188799,13,353576
1780,0.001328,74.125.24.0-255,7156,195955,13,353576
1781,0.001357,172.31.36.0-255,66,196021,13,353576
1782,0.001372,74.125.24.0-255,4320,200341,13,353576
1783,0.001386,172.31.36.0-255,66,200407,13,353576
1784,0.001406,74.125.24.0-255,10692,211099,13,353576
1785,0.001423,172.31.36.0-255,66,211165,13,353576
1786,0.00147,74.125.24.0-255,2902,214067,13,353576
1787,0.001476,172.31.36.0-255,66,214133,13,353576
1788,0.001495,74.125.24.0-255,5738,219871,13,353576
1789,0.001503,172.31.36.0-255,66,219937,13,353576
1790,0.001558,172.31.36.0-255,66,220003,13,353576
1791,0.001627,74.125.24.0-255,5738,225741,13,353576
1792,0.001646,74.125.24.0-255,5020,230761,13,353576
1793,0.001661,172.31.36.0-255,66,230827,13,353576
1794,0.002105,74.125.24.0-255,1484,232311,13,353576
1795,0.002111,74.125.24.0-255,1484,233795,13,353576
1796,0.002114,172.31.36.0-255,66,233861,13,353576
1797,0.002134,74.125.24.0-255,1484,235345,13,353576
1798,0.002141,74.125.24.0-255,5738,241083,13,353576
1799,0.002154,172.31.36.0-255,66,241149,13,353576
1800,0.002164,74.125.24.0-255,4320,245469,13,353576
1801,0.002169,172.31.36.0-255,66,245535,13,353576
1802,0.002179,74.125.24.0-255,2902,248437,13,353576
1803,0.002195,74.125.24.0-255,2902,251339,13,353576
1804,0.002201,172.31.36.0-255,66,251405,13,353576
1805,0.004354,74.125.24.0-255,5738,257143,13,353576
1806,0.004361,172.31.36.0-255,66,257209,13,353576
1807,0.006511,74.125.24.0-255,5738,262947,13,353576
1808,0.006518,172.31.36.0-255,66,263013,13,353576
1809,0.008636,74.125.24.0-255,2902,265915,13,353576
1810,0.008639,172.31.36.0-255,66,265981,13,353576
1811,0.008652,74.125.24.0-255,2902,268883,13,353576
1812,0.008654,172.31.36.0-255,66,268949,13,353576
1813,0.010764,74.125.24.0-255,2902,271851,13,353576
1814,0.010768,172.31.36.0-255,66,271917,13,353576
1815,0.010787,74.125.24.0-255,2902,274819,13,353576
1816,0.010789,172.31.36.0-255,66,274885,13,353576
1817,0.01293,74.125.24.0-255,5738,280623,13,353576
1818,0.012937,172.31.36.0-255,66,280689,13,353576
1819,0.01507,74.125.24.0-255,5738,286427,13,353576
1820,0.01508,172.31.36.0-255,66,286493,13,353576
1821,0.017232,74.125.24.0-255,5738,292231,13,353576
1822,0.01724,172.31.36.0-255,66,292297,13,353576
1823,0.019373,74.125.24.0-255,5738,298035,13,353576
1824,0.019382,172.31.36.0-255,66,298101,13,353576
1825,0.021492,74.125.24.0-255,5738,303839,13,353576
1826,0.0215,172.31.36.0-255,66,303905,13,353576
1827,0.023875,74.125.24.0-255,4320,308225,13,353576
1828,0.023882,172.31.36.0-255,66,308291,13,353576
1829,0.023903,74.125.24.0-255,1484,309775,13,353576
1830,0.026133,74.125.24.0-255,4320,314095,13,353576
1831,0.026146,172.31.36.0-255,66,314161,13,353576
1832,0.028267,74.125.24.0-255,5738,319899,13,353576
1833,0.028275,172.31.36.0-255,66,319965,13,353576
1834,0.030387,74.125.24.0-255,5738,325703,13,353576
1835,0.030396,172.31.36.0-255,66,325769,13,353576
1836,0.032528,74.125.24.0-255,5738,331507,13,353576
1837,0.032536,172.31.36.0-255,66,331573,13,353576
1838,0.034661,74.125.24.0-255,5738,337311,13,353576
1839,0.034668,172.31.36.0-255,66,337377,13,353576
1840,0.036829,74.125.24.0-255,5738,343115,13,353576
1841,0.036838,172.31.36.0-255,66,343181,13,353576
1842,0.038937,74.125.24.0-255,899,344080,13,353576
1843,0.03908,172.31.36.0-255,66,344146,13,353576
1844,0.039116,172.31.36.0-255,105,344251,13,353576
1845,0.040512,172.31.36.0-255,172,344423,13,353576
1846,0.040542,172.31.36.0-255,1110,345533,13,353576
1847,0.040602,172.31.36.0-255,1514,347047,13,353576
1848,0.040604,172.31.36.0-255,1514,348561,13,353576
1849,0.040605,172.31.36.0-255,1514,350075,13,353576
1850,0.04061,172.31.36.0-255,1514,351589,13,353576
1851,0.040611,172.31.36.0-255,1514,353103,13,353576
1852,0.040612,172.31.36.0-255,143,353246,13,353576
1853,0.04124,74.125.24.0-255,66,353312,13,353576
1854,0.042159,104.244.42.0-255,66,353378,13,353576
1855,0.042211,104.244.42.0-255,66,353444,13,353576
1856,0.042321,104.244.42.0-255,66,353510,13,353576
1857,0.042328,104.244.42.0-255,66,353576,13,353576
1858,0.0,74.125.68.0-255,153,153,13,365031
1859,2.2e-05,172.31.36.0-255,66,219,13,365031
1860,3e-05,74.125.68.0-255,1484,1703,13,365031
1861,3.4e-05,172.31.36.0-255,66,1769,13,365031
1862,4.9e-05,74.125.68.0-255,2902,4671,13,365031
1863,5.3e-05,172.31.36.0-255,66,4737,13,365031
1864,5.9e-05,74.125.68.0-255,4320,9057,13,365031
1865,6.2e-05,172.31.36.0-255,66,9123,13,365031
1866,9.9e-05,74.125.68.0-255,4882,14005,13,365031
1867,0.000102,172.31.36.0-255,66,14071,13,365031
1868,0.000132,74.125.68.0-255,5738,19809,13,365031
1869,0.000134,172.31.36.0-255,66,19875,13,365031
1870,0.00014,74.125.68.0-255,4320,24195,13,365031
1871,0.000143,172.31.36.0-255,66,24261,13,365031
1872,0.000172,74.125.68.0-255,2902,27163,13,365031
1873,0.000175,172.31.36.0-255,66,27229,13,365031
1874,0.000184,74.125.68.0-255,8574,35803,13,365031
1875,0.000186,172.31.36.0-255,66,35869,13,365031
1876,0.000205,172.31.36.0-255,66,35935,13,365031
1877,0.000229,74.125.68.0-255,766,36701,13,365031
1878,0.000235,172.31.36.0-255,66,36767,13,365031
1879,0.000551,74.125.68.0-255,1484,38251,13,365031
1880,0.000557,172.31.36.0-255,66,38317,13,365031
1881,0.000564,74.125.68.0-255,2902,41219,13,365031
1882,0.000566,172.31.36.0-255,66,41285,13,365031
1883,0.000601,74.125.68.0-255,5738,47023,13,365031
1884,0.000604,172.31.36.0-255,66,47089,13,365031
1885,0.000609,74.125.68.0-255,2902,49991,13,365031
1886,0.000611,172.31.36.0-255,66,50057,13,365031
1887,0.000621,74.125.68.0-255,4285,54342,13,365031
1888,0.000624,172.31.36.0-255,66,54408,13,365031
1889,0.000698,74.125.68.0-255,1484,55892,13,365031
1890,0.000705,74.125.68.0-255,2902,58794,13,365031
1891,0.000708,172.31.36.0-255,66,58860,13,365031
1892,0.000735,74.125.68.0-255,5738,64598,13,365031
1893,0.000738,172.31.36.0-255,66,64664,13,365031
1894,0.000743,74.125.68.0-255,2902,67566,13,365031
1895,0.000745,172.31.36.0-255,66,67632,13,365031
1896,0.000763,74.125.68.0-255,1484,69116,13,365031
1897,0.000775,74.125.68.0-255,5738,74854,13,365031
1898,0.000778,172.31.36.0-255,66,74920,13,365031
1899,0.000812,172.31.36.0-255,66,74986,13,365031
1900,0.000817,74.125.68.0-255,2184,77170,13,365031
1901,0.000819,172.31.36.0-255,66,77236,13,365031
1902,0.000859,74.125.68.0-255,4320,81556,13,365031
1903,0.000863,172.31.36.0-255,66,81622,13,365031
1904,0.000896,74.125.68.0-255,9992,91614,13,365031
1905,0.0009,74.125.68.0-255,2228,93842,13,365031
1906,0.000904,172.31.36.0-255,66,93908,13,365031
1907,0.000911,172.31.36.0-255,66,93974,13,365031
1908,0.000949,74.125.68.0-255,2902,96876,13,365031
1909,0.000953,172.31.36.0-255,66,96942,13,365031
1910,0.000985,74.125.68.0-255,4320,101262,13,365031
1911,0.000988,172.31.36.0-255,66,101328,13,365031
1912,0.000997,74.125.68.0-255,8574,109902,13,365031
1913,0.001,172.31.36.0-255,66,109968,13,365031
1914,0.001008,74.125.68.0-255,1484,111452,13,365031
1915,0.00103,74.125.68.0-255,4320,115772,13,365031
1916,0.001033,172.31.36.0-255,66,115838,13,365031
1917,0.001038,74.125.68.0-255,4320,120158,13,365031
1918,0.00104,172.31.36.0-255,66,120224,13,365031
1919,0.001068,74.125.68.0-255,2902,123126,13,365031
1920,0.001071,172.31.36.0-255,66,123192,13,365031
1921,0.001078,74.125.68.0-255,5020,128212,13,365031
1922,0.00108,172.31.36.0-255,66,128278,13,365031
1923,0.001475,74.125.68.0-255,1484,129762,13,365031
1924,0.00148,74.125.68.0-255,1484,131246,13,365031
1925,0.001484,172.31.36.0-255,66,131312,13,365031
1926,0.001511,74.125.68.0-255,1484,132796,13,365031
1927,0.001517,74.125.68.0-255,5738,138534,13,365031
1928,0.00152,172.31.36.0-255,66,138600,13,365031
1929,0.001549,74.125.68.0-255,7156,145756,13,365031
1930,0.001552,172.31.36.0-255,66,145822,13,365031
1931,0.001555,74.125.68.0-255,1484,147306,13,365031
1932,0.001583,74.125.68.0-255,5738,153044,13,365031
1933,0.001586,172.31.36.0-255,66,153110,13,365031
1934,0.001591,74.125.68.0-255,4320,157430,13,365031
1935,0.001593,172.31.36.0-255,66,157496,13,365031
1936,0.001614,74.125.68.0-255,4320,161816,13,365031
1937,0.001617,172.31.36.0-255,66,161882,13,365031
1938,0.001623,74.125.68.0-255,766,162648,13,365031
1939,0.001836,74.125.68.0-255,1484,164132,13,365031
1940,0.00184,172.31.36.0-255,66,164198,13,365031
1941,0.001844,74.125.68.0-255,1484,165682,13,365031
1942,0.001871,74.125.68.0-255,1484,167166,13,365031
1943,0.001873,172.31.36.0-255,66,167232,13,365031
1944,0.001876,74.125.68.0-255,1484,168716,13,365031
1945,0.00188,74.125.68.0-255,2902,171618,13,365031
1946,0.001882,172.31.36.0-255,66,171684,13,365031
1947,0.001894,74.125.68.0-255,5738,177422,13,365031
1948,0.001896,172.31.36.0-255,66,177488,13,365031
1949,0.001932,74.125.68.0-255,9992,187480,13,365031
1950,0.001935,172.31.36.0-255,66,187546,13,365031
1951,0.001958,74.125.68.0-255,2902,190448,13,365031
1952,0.001961,172.31.36.0-255,66,190514,13,365031
1953,0.001985,74.125.68.0-255,7856,198370,13,365031
1954,0.001988,172.31.36.0-255,66,198436,13,365031
1955,0.001997,74.125.68.0-255,9992,208428,13,365031
1956,0.002011,172.31.36.0-255,66,208494,13,365031
1957,0.002027,74.125.68.0-255,1484,209978,13,365031
1958,0.002039,74.125.68.0-255,8574,218552,13,365031
1959,0.002048,74.125.68.0-255,9992,228544,13,365031
1960,0.00206,172.31.36.0-255,66,228610,13,365031
1961,0.00207,74.125.68.0-255,2184,230794,13,365031
1962,0.002094,74.125.68.0-255,2902,233696,13,365031
1963,0.002103,172.31.36.0-255,66,233762,13,365031
1964,0.002112,74.125.68.0-255,1484,235246,13,365031
1965,0.002136,74.125.68.0-255,2902,238148,13,365031
1966,0.002138,172.31.36.0-255,66,238214,13,365031
1967,0.002142,74.125.68.0-255,1484,239698,13,365031
1968,0.004242,74.125.68.0-255,4320,244018,13,365031
1969,0.004249,172.31.36.0-255,66,244084,13,365031
1970,0.006359,74.125.68.0-255,5738,249822,13,365031
1971,0.006363,172.31.36.0-255,66,249888,13,365031
1972,0.008467,74.125.68.0-255,5738,255626,13,365031
1973,0.00847,172.31.36.0-255,66,255692,13,365031
1974,0.010591,74.125.68.0-255,5738,261430,13,365031
1975,0.010598,172.31.36.0-255,66,261496,13,365031
1976,0.012718,74.125.68.0-255,5738,267234,13,365031
1977,0.012726,172.31.36.0-255,66,267300,13,365031
1978,0.01486,74.125.68.0-255,5738,273038,13,365031
1979,0.014868,172.31.36.0-255,66,273104,13,365031
1980,0.016985,74.125.68.0-255,5738,278842,13,365031
1981,0.016996,172.31.36.0-255,66,278908,13,365031
1982,0.01911,74.125.68.0-255,5738,284646,13,365031
1983,0.019118,172.31.36.0-255,66,284712,13,365031
1984,0.021235,74.125.68.0-255,5738,290450,13,365031
1985,0.021243,172.31.36.0-255,66,290516,13,365031
1986,0.023358,74.125.68.0-255,5738,296254,13,365031
1987,0.023365,172.31.36.0-255,66,296320,13,365031
1988,0.025477,74.125.68.0-255,4320,300640,13,365031
1989,0.025485,172.31.36.0-255,66,300706,13,365031
1990,0.025515,74.125.68.0-255,1484,302190,13,365031
1991,0.027603,74.125.68.0-255,4320,306510,13,365031
1992,0.02761,172.31.36.0-255,66,306576,13,365031
1993,0.029738,74.125.68.0-255,5738,312314,13,365031
1994,0.029745,172.31.36.0-255,66,312380,13,365031
1995,0.031902,74.125.68.0-255,5738,318118,13,365031
1996,0.03191,172.31.36.0-255,66,318184,13,365031
1997,0.034019,74.125.68.0-255,5738,323922,13,365031
1998,0.034026,172.31.36.0-255,66,323988,13,365031
1999,0.034241,172.31.36.0-255,172,324160,13,365031
2000,0.034271,172.31.36.0-255,1110,325270,13,365031
2001,0.034326,172.31.36.0-255,1514,326784,13,365031
2002,0.034328,172.31.36.0-255,1297,328081,13,365031
2003,0.035852,104.244.42.0-255,66,328147,13,365031
2004,0.035882,104.244.42.0-255,66,328213,13,365031
2005,0.035941,104.244.42.0-255,66,328279,13,365031
2006,0.036138,74.125.68.0-255,5738,334017,13,365031
2007,0.036143,172.31.36.0-255,66,334083,13,365031
2008,0.038261,74.125.68.0-255,5738,339821,13,365031
2009,0.038267,172.31.36.0-255,66,339887,13,365031
2010,0.040376,74.125.68.0-255,5738,345625,13,365031
2011,0.040383,172.31.36.0-255,66,345691,13,365031
2012,0.042504,74.125.68.0-255,5738,351429,13,365031
2013,0.042511,172.31.36.0-255,66,351495,13,365031
2014,0.044611,74.125.68.0-255,5738,357233,13,365031
2015,0.044619,172.31.36.0-255,66,357299,13,365031
2016,0.046725,74.125.68.0-255,5738,363037,13,365031
2017,0.046732,172.31.36.0-255,66,363103,13,365031
2018,0.048838,74.125.68.0-255,1691,364794,13,365031
2019,0.048845,172.31.36.0-255,66,364860,13,365031
2020,0.049009,172.31.36.0-255,105,364965,13,365031
2021,0.051073,74.125.68.0-255,66,365031,13,365031
2022,0.0,74.125.24.0-255,153,153,13,336933
2023,3.5e-05,172.31.36.0-255,66,219,13,336933
2024,4.3e-05,74.125.24.0-255,1484,1703,13,336933
2025,4.8e-05,172.31.36.0-255,66,1769,13,336933
2026,5.2e-05,74.125.24.0-255,2902,4671,13,336933
2027,5.5e-05,172.31.36.0-255,66,4737,13,336933
2028,8.3e-05,74.125.24.0-255,7156,11893,13,336933
2029,8.6e-05,172.31.36.0-255,66,11959,13,336933
2030,9.2e-05,74.125.24.0-255,4906,16865,13,336933
2031,9.5e-05,172.31.36.0-255,66,16931,13,336933
2032,0.000103,74.125.24.0-255,5738,22669,13,336933
2033,0.000105,172.31.36.0-255,66,22735,13,336933
2034,0.000162,74.125.24.0-255,8215,30950,13,336933
2035,0.000167,172.31.36.0-255,66,31016,13,336933
2036,0.000542,74.125.24.0-255,1484,32500,13,336933
2037,0.000547,172.31.36.0-255,66,32566,13,336933
2038,0.000553,74.125.24.0-255,2902,35468,13,336933
2039,0.000555,172.31.36.0-255,66,35534,13,336933
2040,0.000559,74.125.24.0-255,2902,38436,13,336933
2041,0.000567,172.31.36.0-255,66,38502,13,336933
2042,0.000601,74.125.24.0-255,2902,41404,13,336933
2043,0.000605,172.31.36.0-255,66,41470,13,336933
2044,0.000623,172.31.36.0-255,66,41536,13,336933
2045,0.000628,74.125.24.0-255,2902,44438,13,336933
2046,0.00063,172.31.36.0-255,66,44504,13,336933
2047,0.000662,74.125.24.0-255,9574,54078,13,336933
2048,0.000664,74.125.24.0-255,131,54209,13,336933
2049,0.000666,172.31.36.0-255,66,54275,13,336933
2050,0.000671,172.31.36.0-255,66,54341,13,336933
2051,0.000962,74.125.24.0-255,1484,55825,13,336933
2052,0.000967,172.31.36.0-255,66,55891,13,336933
2053,0.000975,74.125.24.0-255,2902,58793,13,336933
2054,0.000977,172.31.36.0-255,66,58859,13,336933
2055,0.000989,74.125.24.0-255,5738,64597,13,336933
2056,0.000992,172.31.36.0-255,66,64663,13,336933
2057,0.000995,74.125.24.0-255,1484,66147,13,336933
2058,0.000999,74.125.24.0-255,1484,67631,13,336933
2059,0.001001,172.31.36.0-255,66,67697,13,336933
2060,0.00104,74.125.24.0-255,7156,74853,13,336933
2061,0.001044,172.31.36.0-255,66,74919,13,336933
2062,0.001065,172.31.36.0-255,66,74985,13,336933
2063,0.001093,74.125.24.0-255,4320,79305,13,336933
2064,0.001096,172.31.36.0-255,66,79371,13,336933
2065,0.001128,74.125.24.0-255,7156,86527,13,336933
2066,0.001132,172.31.36.0-255,66,86593,13,336933
2067,0.001163,74.125.24.0-255,5076,91669,13,336933
2068,0.001167,172.31.36.0-255,66,91735,13,336933
2069,0.001868,74.125.24.0-255,1484,93219,13,336933
2070,0.001876,74.125.24.0-255,2902,96121,13,336933
2071,0.00188,172.31.36.0-255,66,96187,13,336933
2072,0.001887,74.125.24.0-255,5738,101925,13,336933
2073,0.00189,172.31.36.0-255,66,101991,13,336933
2074,0.0019,74.125.24.0-255,4320,106311,13,336933
2075,0.001902,172.31.36.0-255,66,106377,13,336933
2076,0.001938,172.31.36.0-255,66,106443,13,336933
2077,0.001943,74.125.24.0-255,4320,110763,13,336933
2078,0.001945,172.31.36.0-255,66,110829,13,336933
2079,0.001978,74.125.24.0-255,3602,114431,13,336933
2080,0.00198,172.31.36.0-255,66,114497,13,336933
2081,0.001987,74.125.24.0-255,8574,123071,13,336933
2082,0.001989,172.31.36.0-255,66,123137,13,336933
2083,0.002,74.125.24.0-255,5738,128875,13,336933
2084,0.002003,172.31.36.0-255,66,128941,13,336933
2085,0.002015,74.125.24.0-255,5738,134679,13,336933
2086,0.002017,172.31.36.0-255,66,134745,13,336933
2087,0.00202,74.125.24.0-255,1484,136229,13,336933
2088,0.002054,172.31.36.0-255,66,136295,13,336933
2089,0.002057,74.125.24.0-255,766,137061,13,336933
2090,0.004382,74.125.24.0-255,4320,141381,13,336933
2091,0.004388,172.31.36.0-255,66,141447,13,336933
2092,0.006731,74.125.24.0-255,5738,147185,13,336933
2093,0.006736,172.31.36.0-255,66,147251,13,336933
2094,0.009114,74.125.24.0-255,5738,152989,13,336933
2095,0.00912,172.31.36.0-255,66,153055,13,336933
2096,0.011508,74.125.24.0-255,5738,158793,13,336933
2097,0.011519,172.31.36.0-255,66,158859,13,336933
2098,0.013856,74.125.24.0-255,5738,164597,13,336933
2099,0.013866,172.31.36.0-255,66,164663,13,336933
2100,0.016212,74.125.24.0-255,5738,170401,13,336933
2101,0.016224,172.31.36.0-255,66,170467,13,336933
2102,0.018553,74.125.24.0-255,5738,176205,13,336933
2103,0.018564,172.31.36.0-255,66,176271,13,336933
2104,0.020899,74.125.24.0-255,5738,182009,13,336933
2105,0.020909,172.31.36.0-255,66,182075,13,336933
2106,0.023282,74.125.24.0-255,5738,187813,13,336933
2107,0.023289,172.31.36.0-255,66,187879,13,336933
2108,0.025626,74.125.24.0-255,5738,193617,13,336933
2109,0.025632,172.31.36.0-255,66,193683,13,336933
2110,0.026321,172.31.36.0-255,172,193855,13,336933
2111,0.026351,172.31.36.0-255,1110,194965,13,336933
2112,0.026413,172.31.36.0-255,1514,196479,13,336933
2113,0.026415,172.31.36.0-255,1295,197774,13,336933
2114,0.027865,104.244.42.0-255,66,197840,13,336933
2115,0.027911,104.244.42.0-255,66,197906,13,336933
2116,0.027943,74.125.24.0-255,5738,203644,13,336933
2117,0.027948,172.31.36.0-255,66,203710,13,336933
2118,0.027973,104.244.42.0-255,66,203776,13,336933
2119,0.030333,74.125.24.0-255,5738,209514,13,336933
2120,0.030346,172.31.36.0-255,66,209580,13,336933
2121,0.032691,74.125.24.0-255,5738,215318,13,336933
2122,0.032713,172.31.36.0-255,66,215384,13,336933
2123,0.03508,74.125.24.0-255,5738,221122,13,336933
2124,0.035098,172.31.36.0-255,66,221188,13,336933
2125,0.037457,74.125.24.0-255,5738,226926,13,336933
2126,0.037476,172.31.36.0-255,66,226992,13,336933
2127,0.039799,74.125.24.0-255,5738,232730,13,336933
2128,0.039811,172.31.36.0-255,66,232796,13,336933
2129,0.042152,74.125.24.0-255,5738,238534,13,336933
2130,0.042183,172.31.36.0-255,66,238600,13,336933
2131,0.044525,74.125.24.0-255,5738,244338,13,336933
2132,0.04454,172.31.36.0-255,66,244404,13,336933
2133,0.046915,74.125.24.0-255,5738,250142,13,336933
2134,0.04693,172.31.36.0-255,66,250208,13,336933
2135,0.049315,74.125.24.0-255,5738,255946,13,336933
2136,0.049331,172.31.36.0-255,66,256012,13,336933
2137,0.05168,74.125.24.0-255,5738,261750,13,336933
2138,0.05169,172.31.36.0-255,66,261816,13,336933
2139,0.054028,74.125.24.0-255,5738,267554,13,336933
2140,0.054036,172.31.36.0-255,66,267620,13,336933
2141,0.056363,74.125.24.0-255,4320,271940,13,336933
2142,0.056369,172.31.36.0-255,66,272006,13,336933
2143,0.056399,74.125.24.0-255,1484,273490,13,336933
2144,0.058687,74.125.24.0-255,4320,277810,13,336933
2145,0.058693,172.31.36.0-255,66,277876,13,336933
2146,0.060996,74.125.24.0-255,5738,283614,13,336933
2147,0.061001,172.31.36.0-255,66,283680,13,336933
2148,0.063323,74.125.24.0-255,5738,289418,13,336933
2149,0.063329,172.31.36.0-255,66,289484,13,336933
2150,0.065666,74.125.24.0-255,5738,295222,13,336933
2151,0.065671,172.31.36.0-255,66,295288,13,336933
2152,0.067998,74.125.24.0-255,4320,299608,13,336933
2153,0.068003,172.31.36.0-255,66,299674,13,336933
2154,0.068036,74.125.24.0-255,1484,301158,13,336933
2155,0.070348,74.125.24.0-255,4320,305478,13,336933
2156,0.070353,172.31.36.0-255,66,305544,13,336933
2157,0.072676,74.125.24.0-255,5738,311282,13,336933
2158,0.072682,172.31.36.0-255,66,311348,13,336933
2159,0.075003,74.125.24.0-255,5738,317086,13,336933
2160,0.075008,172.31.36.0-255,66,317152,13,336933
2161,0.077317,74.125.24.0-255,5738,322890,13,336933
2162,0.077322,172.31.36.0-255,66,322956,13,336933
2163,0.079662,74.125.24.0-255,1484,324440,13,336933
2164,0.079695,74.125.24.0-255,4320,328760,13,336933
2165,0.079699,172.31.36.0-255,66,328826,13,336933
2166,0.082026,74.125.24.0-255,5738,334564,13,336933
2167,0.082032,172.31.36.0-255,66,334630,13,336933
2168,0.084347,74.125.24.0-255,2066,336696,13,336933
2169,0.084353,172.31.36.0-255,66,336762,13,336933
2170,0.084532,172.31.36.0-255,105,336867,13,336933
2171,0.086837,74.125.24.0-255,66,336933,13,336933
2172,0.0,74.125.24.0-255,298,298,13,333991
2173,3.4e-05,172.31.36.0-255,66,364,13,333991
2174,4.2e-05,74.125.24.0-255,1484,1848,13,333991
2175,4.6e-05,172.31.36.0-255,66,1914,13,333991
2176,5.2e-05,74.125.24.0-255,4320,6234,13,333991
2177,5.4e-05,172.31.36.0-255,66,6300,13,333991
2178,5.7e-05,74.125.24.0-255,1484,7784,13,333991
2179,5.9e-05,172.31.36.0-255,66,7850,13,333991
2180,6.5e-05,74.125.24.0-255,4320,12170,13,333991
2181,6.7e-05,172.31.36.0-255,66,12236,13,333991
2182,8.7e-05,74.125.24.0-255,6084,18320,13,333991
2183,9.2e-05,74.125.24.0-255,4320,22640,13,333991
2184,9.3e-05,172.31.36.0-255,66,22706,13,333991
2185,9.7e-05,172.31.36.0-255,66,22772,13,333991
2186,0.000117,74.125.24.0-255,8215,30987,13,333991
2187,0.00012,172.31.36.0-255,66,31053,13,333991
2188,0.000206,74.125.24.0-255,1484,32537,13,333991
2189,0.000209,172.31.36.0-255,66,32603,13,333991
2190,0.000213,74.125.24.0-255,1484,34087,13,333991
2191,0.000215,172.31.36.0-255,66,34153,13,333991
2192,0.000232,74.125.24.0-255,1484,35637,13,333991
2193,0.000235,172.31.36.0-255,66,35703,13,333991
2194,0.000241,74.125.24.0-255,5738,41441,13,333991
2195,0.000243,172.31.36.0-255,66,41507,13,333991
2196,0.00025,74.125.24.0-255,6797,48304,13,333991
2197,0.000253,172.31.36.0-255,66,48370,13,333991
2198,0.000275,74.125.24.0-255,7156,55526,13,333991
2199,0.000279,172.31.36.0-255,66,55592,13,333991
2200,0.000309,74.125.24.0-255,7156,62748,13,333991
2201,0.000313,172.31.36.0-255,66,62814,13,333991
2202,0.000317,74.125.24.0-255,2543,65357,13,333991
2203,0.000319,172.31.36.0-255,66,65423,13,333991
2204,0.000321,74.125.24.0-255,399,65822,13,333991
2205,0.000537,74.125.24.0-255,343,66165,13,333991
2206,0.000585,74.125.24.0-255,1484,67649,13,333991
2207,0.00059,172.31.36.0-255,66,67715,13,333991
2208,0.000598,74.125.24.0-255,1484,69199,13,333991
2209,0.000613,74.125.24.0-255,2902,72101,13,333991
2210,0.000616,172.31.36.0-255,66,72167,13,333991
2211,0.000622,74.125.24.0-255,5738,77905,13,333991
2212,0.000625,172.31.36.0-255,66,77971,13,333991
2213,0.00064,74.125.24.0-255,4320,82291,13,333991
2214,0.000642,74.125.24.0-255,1125,83416,13,333991
2215,0.000643,172.31.36.0-255,66,83482,13,333991
2216,0.000853,172.31.36.0-255,101,83583,13,333991
2217,0.001187,74.125.24.0-255,1484,85067,13,333991
2218,0.0012,74.125.24.0-255,2902,87969,13,333991
2219,0.001204,172.31.36.0-255,66,88035,13,333991
2220,0.001211,74.125.24.0-255,4320,92355,13,333991
2221,0.001213,172.31.36.0-255,66,92421,13,333991
2222,0.001226,74.125.24.0-255,1484,93905,13,333991
2223,0.00124,74.125.24.0-255,1484,95389,13,333991
2224,0.001243,172.31.36.0-255,66,95455,13,333991
2225,0.001267,74.125.24.0-255,8574,104029,13,333991
2226,0.00127,172.31.36.0-255,66,104095,13,333991
2227,0.001277,74.125.24.0-255,7156,111251,13,333991
2228,0.001279,172.31.36.0-255,66,111317,13,333991
2229,0.001302,74.125.24.0-255,4320,115637,13,333991
2230,0.001306,172.31.36.0-255,66,115703,13,333991
2231,0.001314,74.125.24.0-255,5890,121593,13,333991
2232,0.001316,172.31.36.0-255,66,121659,13,333991
2233,0.00132,74.125.24.0-255,1484,123143,13,333991
2234,0.001346,172.31.36.0-255,66,123209,13,333991
2235,0.001377,74.125.24.0-255,5738,128947,13,333991
2236,0.00138,172.31.36.0-255,66,129013,13,333991
2237,0.001389,74.125.24.0-255,9274,138287,13,333991
2238,0.001391,172.31.36.0-255,66,138353,13,333991
2239,0.001511,74.125.24.0-255,1484,139837,13,333991
2240,0.001529,74.125.24.0-255,2902,142739,13,333991
2241,0.001536,172.31.36.0-255,66,142805,13,333991
2242,0.001543,74.125.24.0-255,5738,148543,13,333991
2243,0.001546,172.31.36.0-255,66,148609,13,333991
2244,0.001551,74.125.24.0-255,4320,152929,13,333991
2245,0.001553,172.31.36.0-255,66,152995,13,333991
2246,0.001574,74.125.24.0-255,7156,160151,13,333991
2247,0.001578,172.31.36.0-255,66,160217,13,333991
2248,0.0016,74.125.24.0-255,4320,164537,13,333991
2249,0.001603,172.31.36.0-255,66,164603,13,333991
2250,0.001607,74.125.24.0-255,2902,167505,13,333991
2251,0.00161,172.31.36.0-255,66,167571,13,333991
2252,0.001626,74.125.24.0-255,5020,172591,13,333991
2253,0.001629,172.31.36.0-255,66,172657,13,333991
2254,0.001976,74.125.24.0-255,1484,174141,13,333991
2255,0.001982,74.125.24.0-255,1484,175625,13,333991
2256,0.001986,172.31.36.0-255,66,175691,13,333991
2257,0.002,74.125.24.0-255,1484,177175,13,333991
2258,0.002006,74.125.24.0-255,4320,181495,13,333991
2259,0.002008,172.31.36.0-255,66,181561,13,333991
2260,0.002032,74.125.24.0-255,8574,190135,13,333991
2261,0.002034,172.31.36.0-255,66,190201,13,333991
2262,0.002072,74.125.24.0-255,5738,195939,13,333991
2263,0.002075,172.31.36.0-255,66,196005,13,333991
2264,0.002104,172.31.36.0-255,66,196071,13,333991
2265,0.002154,74.125.24.0-255,9992,206063,13,333991
2266,0.002159,172.31.36.0-255,66,206129,13,333991
2267,0.002184,74.125.24.0-255,9992,216121,13,333991
2268,0.002187,172.31.36.0-255,66,216187,13,333991
2269,0.002194,74.125.24.0-255,7156,223343,13,333991
2270,0.002197,172.31.36.0-255,66,223409,13,333991
2271,0.002208,74.125.24.0-255,3602,227011,13,333991
2272,0.00221,172.31.36.0-255,66,227077,13,333991
2273,0.002216,74.125.24.0-255,4320,231397,13,333991
2274,0.00222,172.31.36.0-255,66,231463,13,333991
2275,0.002224,74.125.24.0-255,9992,241455,13,333991
2276,0.002228,172.31.36.0-255,66,241521,13,333991
2277,0.00223,74.125.24.0-255,1484,243005,13,333991
2278,0.002235,74.125.24.0-255,2902,245907,13,333991
2279,0.002237,172.31.36.0-255,66,245973,13,333991
2280,0.002269,74.125.24.0-255,9992,255965,13,333991
2281,0.002273,172.31.36.0-255,66,256031,13,333991
2282,0.002279,74.125.24.0-255,5020,261051,13,333991
2283,0.002282,172.31.36.0-255,66,261117,13,333991
2284,0.002353,74.125.24.0-255,1484,262601,13,333991
2285,0.002375,74.125.24.0-255,2902,265503,13,333991
2286,0.002378,172.31.36.0-255,66,265569,13,333991
2287,0.002382,74.125.24.0-255,1484,267053,13,333991
2288,0.0024,74.125.24.0-255,4320,271373,13,333991
2289,0.002402,172.31.36.0-255,66,271439,13,333991
2290,0.002406,74.125.24.0-255,2902,274341,13,333991
2291,0.002409,172.31.36.0-255,66,274407,13,333991
2292,0.002429,74.125.24.0-255,9992,284399,13,333991
2293,0.002432,172.31.36.0-255,66,284465,13,333991
2294,0.002461,74.125.24.0-255,2902,287367,13,333991
2295,0.002464,172.31.36.0-255,66,287433,13,333991
2296,0.002503,172.31.36.0-255,66,287499,13,333991
2297,0.002514,172.31.36.0-255,66,287565,13,333991
2298,0.002543,74.125.24.0-255,5738,293303,13,333991
2299,0.002546,172.31.36.0-255,66,293369,13,333991
2300,0.002553,74.125.24.0-255,6438,299807,13,333991
2301,0.002557,172.31.36.0-255,66,299873,13,333991
2302,0.002653,74.125.24.0-255,1484,301357,13,333991
2303,0.002658,74.125.24.0-255,2902,304259,13,333991
2304,0.002661,172.31.36.0-255,66,304325,13,333991
2305,0.002666,74.125.24.0-255,2902,307227,13,333991
2306,0.002668,172.31.36.0-255,66,307293,13,333991
2307,0.002683,74.125.24.0-255,2902,310195,13,333991
2308,0.002685,172.31.36.0-255,66,310261,13,333991
2309,0.002713,74.125.24.0-255,9992,320253,13,333991
2310,0.002716,172.31.36.0-255,66,320319,13,333991
2311,0.002732,74.125.24.0-255,2902,323221,13,333991
2312,0.002734,172.31.36.0-255,66,323287,13,333991
2313,0.002741,74.125.24.0-255,6007,329294,13,333991
2314,0.002744,172.31.36.0-255,66,329360,13,333991
2315,0.003558,74.125.24.0-255,66,329426,13,333991
2316,0.00541,74.125.24.0-255,105,329531,13,333991
2317,0.006454,172.31.36.0-255,105,329636,13,333991
2318,0.014333,74.125.24.0-255,66,329702,13,333991
2319,0.030945,172.31.36.0-255,172,329874,13,333991
2320,0.030974,172.31.36.0-255,1110,330984,13,333991
2321,0.031016,172.31.36.0-255,1514,332498,13,333991
2322,0.031018,172.31.36.0-255,1295,333793,13,333991
2323,0.032608,104.244.42.0-255,66,333859,13,333991
2324,0.032638,104.244.42.0-255,66,333925,13,333991
2325,0.032699,104.244.42.0-255,66,333991,13,333991
2326,0.0,74.125.24.0-255,153,153,13,302241
2327,1.5e-05,172.31.36.0-255,66,219,13,302241
2328,2.1e-05,74.125.24.0-255,1484,1703,13,302241
2329,2.5e-05,172.31.36.0-255,66,1769,13,302241
2330,5.5e-05,74.125.24.0-255,1484,3253,13,302241
2331,5.8e-05,172.31.36.0-255,66,3319,13,302241
2332,6.4e-05,74.125.24.0-255,2902,6221,13,302241
2333,6.7e-05,172.31.36.0-255,66,6287,13,302241
2334,8.9e-05,74.125.24.0-255,5738,12025,13,302241
2335,9.3e-05,172.31.36.0-255,66,12091,13,302241
2336,9.6e-05,74.125.24.0-255,2068,14159,13,302241
2337,9.8e-05,172.31.36.0-255,66,14225,13,302241
2338,0.00017,74.125.24.0-255,1484,15709,13,302241
2339,0.000173,172.31.36.0-255,66,15775,13,302241
2340,0.000178,74.125.24.0-255,2902,18677,13,302241
2341,0.000181,172.31.36.0-255,66,18743,13,302241
2342,0.000184,74.125.24.0-255,1484,20227,13,302241
2343,0.000186,172.31.36.0-255,66,20293,13,302241
2344,0.000203,74.125.24.0-255,4320,24613,13,302241
2345,0.000205,172.31.36.0-255,66,24679,13,302241
2346,0.000209,74.125.24.0-255,2902,27581,13,302241
2347,0.000211,172.31.36.0-255,66,27647,13,302241
2348,0.000259,74.125.24.0-255,3961,31608,13,302241
2349,0.000262,172.31.36.0-255,66,31674,13,302241
2350,0.000363,74.125.24.0-255,1484,33158,13,302241
2351,0.000367,172.31.36.0-255,66,33224,13,302241
2352,0.000388,74.125.24.0-255,2902,36126,13,302241
2353,0.000391,172.31.36.0-255,66,36192,13,302241
2354,0.000396,74.125.24.0-255,2902,39094,13,302241
2355,0.000398,172.31.36.0-255,66,39160,13,302241
2356,0.000412,74.125.24.0-255,2902,42062,13,302241
2357,0.000414,172.31.36.0-255,66,42128,13,302241
2358,0.000419,74.125.24.0-255,2902,45030,13,302241
2359,0.000436,74.125.24.0-255,1484,46514,13,302241
2360,0.000456,74.125.24.0-255,4320,50834,13,302241
2361,0.000478,74.125.24.0-255,5738,56572,13,302241
2362,0.000491,74.125.24.0-255,2543,59115,13,302241
2363,0.000496,74.125.24.0-255,2902,62017,13,302241
2364,0.000508,74.125.24.0-255,2902,64919,13,302241
2365,0.000515,172.31.36.0-255,66,64985,13,302241
2366,0.000523,74.125.24.0-255,1125,66110,13,302241
2367,0.001009,172.31.36.0-255,66,66176,13,302241
2368,0.002135,74.125.24.0-255,645,66821,13,302241
2369,0.002168,74.125.24.0-255,1484,68305,13,302241
2370,0.002173,172.31.36.0-255,66,68371,13,302241
2371,0.002179,74.125.24.0-255,2902,71273,13,302241
2372,0.002181,172.31.36.0-255,66,71339,13,302241
2373,0.002186,74.125.24.0-255,2902,74241,13,302241
2374,0.002188,172.31.36.0-255,66,74307,13,302241
2375,0.002206,74.125.24.0-255,2902,77209,13,302241
2376,0.002208,172.31.36.0-255,66,77275,13,302241
2377,0.002213,74.125.24.0-255,2902,80177,13,302241
2378,0.002233,74.125.24.0-255,4320,84497,13,302241
2379,0.006582,172.31.36.0-255,66,84563,13,302241
2380,0.008763,74.125.24.0-255,5738,90301,13,302241
2381,0.008769,172.31.36.0-255,66,90367,13,302241
2382,0.010945,74.125.24.0-255,5738,96105,13,302241
2383,0.010952,172.31.36.0-255,66,96171,13,302241
2384,0.013203,74.125.24.0-255,5738,101909,13,302241
2385,0.013211,172.31.36.0-255,66,101975,13,302241
2386,0.015387,74.125.24.0-255,5738,107713,13,302241
2387,0.015395,172.31.36.0-255,66,107779,13,302241
2388,0.017633,74.125.24.0-255,5738,113517,13,302241
2389,0.017641,172.31.36.0-255,66,113583,13,302241
2390,0.019876,74.125.24.0-255,5738,119321,13,302241
2391,0.019886,172.31.36.0-255,66,119387,13,302241
2392,0.022091,74.125.24.0-255,5738,125125,13,302241
2393,0.0221,172.31.36.0-255,66,125191,13,302241
2394,0.024319,74.125.24.0-255,5738,130929,13,302241
2395,0.024327,172.31.36.0-255,66,130995,13,302241
2396,0.026533,74.125.24.0-255,5738,136733,13,302241
2397,0.026542,172.31.36.0-255,66,136799,13,302241
2398,0.028752,74.125.24.0-255,5738,142537,13,302241
2399,0.028761,172.31.36.0-255,66,142603,13,302241
2400,0.030979,74.125.24.0-255,4320,146923,13,302241
2401,0.030988,172.31.36.0-255,66,146989,13,302241
2402,0.031009,74.125.24.0-255,1484,148473,13,302241
2403,0.033214,74.125.24.0-255,2902,151375,13,302241
2404,0.033221,172.31.36.0-255,66,151441,13,302241
2405,0.033532,172.31.36.0-255,172,151613,13,302241
2406,0.033566,172.31.36.0-255,1110,152723,13,302241
2407,0.033639,172.31.36.0-255,1514,154237,13,302241
2408,0.033641,172.31.36.0-255,1514,155751,13,302241
2409,0.033642,172.31.36.0-255,1514,157265,13,302241
2410,0.033649,172.31.36.0-255,1514,158779,13,302241
2411,0.03365,172.31.36.0-255,1514,160293,13,302241
2412,0.033651,172.31.36.0-255,144,160437,13,302241
2413,0.035243,104.244.42.0-255,66,160503,13,302241
2414,0.035253,104.244.42.0-255,66,160569,13,302241
2415,0.035308,104.244.42.0-255,66,160635,13,302241
2416,0.035313,104.244.42.0-255,66,160701,13,302241
2417,0.035396,74.125.24.0-255,4320,165021,13,302241
2418,0.035401,172.31.36.0-255,66,165087,13,302241
2419,0.035417,74.125.24.0-255,1484,166571,13,302241
2420,0.037648,74.125.24.0-255,4320,170891,13,302241
2421,0.037655,172.31.36.0-255,66,170957,13,302241
2422,0.039836,74.125.24.0-255,5738,176695,13,302241
2423,0.039841,172.31.36.0-255,66,176761,13,302241
2424,0.042053,74.125.24.0-255,4320,181081,13,302241
2425,0.042058,172.31.36.0-255,66,181147,13,302241
2426,0.042083,74.125.24.0-255,1484,182631,13,302241
2427,0.044255,74.125.24.0-255,4320,186951,13,302241
2428,0.04426,172.31.36.0-255,66,187017,13,302241
2429,0.046471,74.125.24.0-255,5738,192755,13,302241
2430,0.046476,172.31.36.0-255,66,192821,13,302241
2431,0.04876,74.125.24.0-255,5738,198559,13,302241
2432,0.048765,172.31.36.0-255,66,198625,13,302241
2433,0.05096,74.125.24.0-255,2902,201527,13,302241
2434,0.050966,172.31.36.0-255,66,201593,13,302241
2435,0.050992,74.125.24.0-255,2902,204495,13,302241
2436,0.050995,172.31.36.0-255,66,204561,13,302241
2437,0.053206,74.125.24.0-255,2902,207463,13,302241
2438,0.053211,172.31.36.0-255,66,207529,13,302241
2439,0.053245,74.125.24.0-255,2902,210431,13,302241
2440,0.053248,172.31.36.0-255,66,210497,13,302241
2441,0.055401,74.125.24.0-255,2902,213399,13,302241
2442,0.055406,172.31.36.0-255,66,213465,13,302241
2443,0.055498,74.125.24.0-255,2902,216367,13,302241
2444,0.055503,172.31.36.0-255,66,216433,13,302241
2445,0.057642,74.125.24.0-255,2902,219335,13,302241
2446,0.057648,172.31.36.0-255,66,219401,13,302241
2447,0.057733,74.125.24.0-255,2902,222303,13,302241
2448,0.057738,172.31.36.0-255,66,222369,13,302241
2449,0.059815,74.125.24.0-255,2902,225271,13,302241
2450,0.05982,172.31.36.0-255,66,225337,13,302241
2451,0.059947,74.125.24.0-255,2902,228239,13,302241
2452,0.059953,172.31.36.0-255,66,228305,13,302241
2453,0.061999,74.125.24.0-255,2902,231207,13,302241
2454,0.062004,172.31.36.0-255,66,231273,13,302241
2455,0.062148,74.125.24.0-255,2902,234175,13,302241
2456,0.062153,172.31.36.0-255,66,234241,13,302241
2457,0.064211,74.125.24.0-255,2902,237143,13,302241
2458,0.064216,172.31.36.0-255,66,237209,13,302241
2459,0.064348,74.125.24.0-255,2902,240111,13,302241
2460,0.064353,172.31.36.0-255,66,240177,13,302241
2461,0.066423,74.125.24.0-255,2902,243079,13,302241
2462,0.066428,172.31.36.0-255,66,243145,13,302241
2463,0.066546,74.125.24.0-255,2902,246047,13,302241
2464,0.066551,172.31.36.0-255,66,246113,13,302241
2465,0.068604,74.125.24.0-255,2902,249015,13,302241
2466,0.068609,172.31.36.0-255,66,249081,13,302241
2467,0.068751,74.125.24.0-255,2902,251983,13,302241
2468,0.068756,172.31.36.0-255,66,252049,13,302241
2469,0.070769,74.125.24.0-255,2902,254951,13,302241
2470,0.070776,172.31.36.0-255,66,255017,13,302241
2471,0.070938,74.125.24.0-255,2902,257919,13,302241
2472,0.070944,172.31.36.0-255,66,257985,13,302241
2473,0.072999,74.125.24.0-255,1484,259469,13,302241
2474,0.073025,74.125.24.0-255,1484,260953,13,302241
2475,0.07303,172.31.36.0-255,66,261019,13,302241
2476,0.073133,74.125.24.0-255,2902,263921,13,302241
2477,0.073138,172.31.36.0-255,66,263987,13,302241
2478,0.075281,74.125.24.0-255,2902,266889,13,302241
2479,0.075285,172.31.36.0-255,66,266955,13,302241
2480,0.075378,74.125.24.0-255,2902,269857,13,302241
2481,0.075382,172.31.36.0-255,66,269923,13,302241
2482,0.07751,74.125.24.0-255,2902,272825,13,302241
2483,0.077515,172.31.36.0-255,66,272891,13,302241
2484,0.077566,74.125.24.0-255,2902,275793,13,302241
2485,0.07757,172.31.36.0-255,66,275859,13,302241
2486,0.079903,74.125.24.0-255,4320,280179,13,302241
2487,0.079909,172.31.36.0-255,66,280245,13,302241
2488,0.079928,74.125.24.0-255,1484,281729,13,302241
2489,0.082112,74.125.24.0-255,4320,286049,13,302241
2490,0.082117,172.31.36.0-255,66,286115,13,302241
2491,0.084311,74.125.24.0-255,1484,287599,13,302241
2492,0.084347,74.125.24.0-255,4320,291919,13,302241
2493,0.084352,172.31.36.0-255,66,291985,13,302241
2494,0.086549,74.125.24.0-255,4320,296305,13,302241
2495,0.086554,172.31.36.0-255,66,296371,13,302241
2496,0.086624,74.125.24.0-255,1484,297855,13,302241
2497,0.088749,74.125.24.0-255,4320,302175,13,302241
2498,0.088753,172.31.36.0-255,66,302241,13,302241
2499,0.0,74.125.24.0-255,153,153,13,365495
2500,3.2e-05,172.31.36.0-255,66,219,13,365495
2501,3.9e-05,74.125.24.0-255,1484,1703,13,365495
2502,4.4e-05,172.31.36.0-255,66,1769,13,365495
2503,4.7e-05,74.125.24.0-255,1484,3253,13,365495
2504,5.7e-05,172.31.36.0-255,66,3319,13,365495
2505,6.5e-05,74.125.24.0-255,4320,7639,13,365495
2506,6.7e-05,172.31.36.0-255,66,7705,13,365495
2507,7.5e-05,74.125.24.0-255,8574,16279,13,365495
2508,7.7e-05,172.31.36.0-255,66,16345,13,365495
2509,0.000114,74.125.24.0-255,2066,18411,13,365495
2510,0.000116,172.31.36.0-255,66,18477,13,365495
2511,0.000122,74.125.24.0-255,5738,24215,13,365495
2512,0.000124,172.31.36.0-255,66,24281,13,365495
2513,0.000129,74.125.24.0-255,4320,28601,13,365495
2514,0.000132,172.31.36.0-255,66,28667,13,365495
2515,0.000156,74.125.24.0-255,2543,31210,13,365495
2516,0.000158,172.31.36.0-255,66,31276,13,365495
2517,0.000284,74.125.24.0-255,1484,32760,13,365495
2518,0.00029,172.31.36.0-255,66,32826,13,365495
2519,0.000319,74.125.24.0-255,2902,35728,13,365495
2520,0.000322,172.31.36.0-255,66,35794,13,365495
2521,0.000329,74.125.24.0-255,5738,41532,13,365495
2522,0.000331,172.31.36.0-255,66,41598,13,365495
2523,0.000337,74.125.24.0-255,5738,47336,13,365495
2524,0.000341,172.31.36.0-255,66,47402,13,365495
2525,0.000386,74.125.24.0-255,5738,53140,13,365495
2526,0.000389,172.31.36.0-255,66,53206,13,365495
2527,0.000408,74.125.24.0-255,7156,60362,13,365495
2528,0.000412,172.31.36.0-255,66,60428,13,365495
2529,0.000415,74.125.24.0-255,1484,61912,13,365495
2530,0.000417,172.31.36.0-255,66,61978,13,365495
2531,0.000463,74.125.24.0-255,3602,65580,13,365495
2532,0.00047,172.31.36.0-255,66,65646,13,365495
2533,0.000931,74.125.24.0-255,358,66004,13,365495
2534,0.000941,74.125.24.0-255,384,66388,13,365495
2535,0.001093,74.125.24.0-255,1484,67872,13,365495
2536,0.001099,172.31.36.0-255,66,67938,13,365495
2537,0.001106,74.125.24.0-255,2902,70840,13,365495
2538,0.001109,74.125.24.0-255,1484,72324,13,365495
2539,0.001127,74.125.24.0-255,4320,76644,13,365495
2540,0.001153,74.125.24.0-255,4320,80964,13,365495
2541,0.001176,74.125.24.0-255,7156,88120,13,365495
2542,0.001183,74.125.24.0-255,8574,96694,13,365495
2543,0.001199,74.125.24.0-255,3602,100296,13,365495
2544,0.001202,74.125.24.0-255,1484,101780,13,365495
2545,0.001206,74.125.24.0-255,2902,104682,13,365495
2546,0.001208,74.125.24.0-255,1484,106166,13,365495
2547,0.00123,74.125.24.0-255,4320,110486,13,365495
2548,0.001266,74.125.24.0-255,8574,119060,13,365495
2549,0.001284,74.125.24.0-255,4320,123380,13,365495
2550,0.001292,74.125.24.0-255,8574,131954,13,365495
2551,0.001326,74.125.24.0-255,2184,134138,13,365495
2552,0.001432,74.125.24.0-255,1484,135622,13,365495
2553,0.001448,74.125.24.0-255,1484,137106,13,365495
2554,0.00147,74.125.24.0-255,2902,140008,13,365495
2555,0.001497,74.125.24.0-255,5738,145746,13,365495
2556,0.001519,74.125.24.0-255,1484,147230,13,365495
2557,0.001537,74.125.24.0-255,5738,152968,13,365495
2558,0.001548,74.125.24.0-255,2902,155870,13,365495
2559,0.001566,74.125.24.0-255,5738,161608,13,365495
2560,0.001578,74.125.24.0-255,1484,163092,13,365495
2561,0.00159,74.125.24.0-255,2902,165994,13,365495
2562,0.001599,74.125.24.0-255,1484,167478,13,365495
2563,0.00161,74.125.24.0-255,766,168244,13,365495
2564,0.001972,74.125.24.0-255,1484,169728,13,365495
2565,0.002002,74.125.24.0-255,1484,171212,13,365495
2566,0.00202,74.125.24.0-255,1484,172696,13,365495
2567,0.002025,74.125.24.0-255,4320,177016,13,365495
2568,0.002037,74.125.24.0-255,1484,178500,13,365495
2569,0.00206,74.125.24.0-255,7156,185656,13,365495
2570,0.002064,74.125.24.0-255,2902,188558,13,365495
2571,0.002088,74.125.24.0-255,9992,198550,13,365495
2572,0.002114,74.125.24.0-255,2902,201452,13,365495
2573,0.002135,74.125.24.0-255,8574,210026,13,365495
2574,0.002148,74.125.24.0-255,2184,212210,13,365495
2575,0.002151,74.125.24.0-255,2902,215112,13,365495
2576,0.002174,74.125.24.0-255,9992,225104,13,365495
2577,0.002183,74.125.24.0-255,1484,226588,13,365495
2578,0.002191,74.125.24.0-255,9274,235862,13,365495
2579,0.002247,74.125.24.0-255,1484,237346,13,365495
2580,0.002264,74.125.24.0-255,2902,240248,13,365495
2581,0.002281,74.125.24.0-255,4320,244568,13,365495
2582,0.002292,74.125.24.0-255,1484,246052,13,365495
2583,0.002306,74.125.24.0-255,9992,256044,13,365495
2584,0.002318,74.125.24.0-255,2902,258946,13,365495
2585,0.002327,74.125.24.0-255,8574,267520,13,365495
2586,0.002341,74.125.24.0-255,2184,269704,13,365495
2587,0.002404,74.125.24.0-255,1484,271188,13,365495
2588,0.002408,74.125.24.0-255,2902,274090,13,365495
2589,0.002413,74.125.24.0-255,4320,278410,13,365495
2590,0.002429,74.125.24.0-255,1484,279894,13,365495
2591,0.002436,74.125.24.0-255,7156,287050,13,365495
2592,0.002438,74.125.24.0-255,1484,288534,13,365495
2593,0.002464,74.125.24.0-255,9992,298526,13,365495
2594,0.002475,74.125.24.0-255,2902,301428,13,365495
2595,0.002479,74.125.24.0-255,3602,305030,13,365495
2596,0.002537,74.125.24.0-255,4320,309350,13,365495
2597,0.002553,74.125.24.0-255,4320,313670,13,365495
2598,0.004362,172.31.36.0-255,66,313736,13,365495
2599,0.006821,74.125.24.0-255,5738,319474,13,365495
2600,0.006828,172.31.36.0-255,66,319540,13,365495
2601,0.009279,74.125.24.0-255,5738,325278,13,365495
2602,0.009286,172.31.36.0-255,66,325344,13,365495
2603,0.011749,74.125.24.0-255,5738,331082,13,365495
2604,0.011756,172.31.36.0-255,66,331148,13,365495
2605,0.01423,74.125.24.0-255,5738,336886,13,365495
2606,0.015415,172.31.36.0-255,66,336952,13,365495
2607,0.01791,74.125.24.0-255,5738,342690,13,365495
2608,0.017924,172.31.36.0-255,66,342756,13,365495
2609,0.020374,74.125.24.0-255,5738,348494,13,365495
2610,0.020383,172.31.36.0-255,66,348560,13,365495
2611,0.022833,74.125.24.0-255,5738,354298,13,365495
2612,0.02284,172.31.36.0-255,66,354364,13,365495
2613,0.025303,74.125.24.0-255,5738,360102,13,365495
2614,0.02531,172.31.36.0-255,66,360168,13,365495
2615,0.027774,74.125.24.0-255,801,360969,13,365495
2616,0.027914,172.31.36.0-255,66,361035,13,365495
2617,0.027942,172.31.36.0-255,105,361140,13,365495
2618,0.030363,74.125.24.0-255,66,361206,13,365495
2619,0.032996,172.31.36.0-255,172,361378,13,365495
2620,0.033025,172.31.36.0-255,1110,362488,13,365495
2621,0.033066,172.31.36.0-255,1514,364002,13,365495
2622,0.033068,172.31.36.0-255,1295,365297,13,365495
2623,0.034679,104.244.42.0-255,66,365363,13,365495
2624,0.034687,104.244.42.0-255,66,365429,13,365495
2625,0.034768,104.244.42.0-255,66,365495,13,365495
2626,0.0,74.125.24.0-255,153,153,13,322637
2627,3.3e-05,172.31.36.0-255,66,219,13,322637
2628,4.1e-05,74.125.24.0-255,1484,1703,13,322637
2629,4.5e-05,172.31.36.0-255,66,1769,13,322637
2630,5e-05,74.125.24.0-255,2902,4671,13,322637
2631,6e-05,172.31.36.0-255,66,4737,13,322637
2632,6.3e-05,74.125.24.0-255,1484,6221,13,322637
2633,6.6e-05,172.31.36.0-255,66,6287,13,322637
2634,7.1e-05,74.125.24.0-255,2902,9189,13,322637
2635,7.3e-05,172.31.36.0-255,66,9255,13,322637
2636,0.000101,74.125.24.0-255,2902,12157,13,322637
2637,0.000103,172.31.36.0-255,66,12223,13,322637
2638,0.000108,74.125.24.0-255,2049,14272,13,322637
2639,0.00011,172.31.36.0-255,66,14338,13,322637
2640,0.000115,74.125.24.0-255,2902,17240,13,322637
2641,0.000118,172.31.36.0-255,66,17306,13,322637
2642,0.000124,74.125.24.0-255,7156,24462,13,322637
2643,0.000127,172.31.36.0-255,66,24528,13,322637
2644,0.000172,172.31.36.0-255,66,24594,13,322637
2645,0.000181,74.125.24.0-255,9992,34586,13,322637
2646,0.000183,172.31.36.0-255,66,34652,13,322637
2647,0.000213,74.125.24.0-255,2184,36836,13,322637
2648,0.000215,172.31.36.0-255,66,36902,13,322637
2649,0.000333,74.125.24.0-255,1484,38386,13,322637
2650,0.000337,172.31.36.0-255,66,38452,13,322637
2651,0.000342,74.125.24.0-255,2902,41354,13,322637
2652,0.000344,172.31.36.0-255,66,41420,13,322637
2653,0.000377,74.125.24.0-255,5738,47158,13,322637
2654,0.000382,172.31.36.0-255,66,47224,13,322637
2655,0.000426,74.125.24.0-255,7142,54366,13,322637
2656,0.00043,172.31.36.0-255,66,54432,13,322637
2657,0.000662,74.125.24.0-255,1484,55916,13,322637
2658,0.000669,74.125.24.0-255,2902,58818,13,322637
2659,0.000672,172.31.36.0-255,66,58884,13,322637
2660,0.000678,74.125.24.0-255,2902,61786,13,322637
2661,0.000685,172.31.36.0-255,66,61852,13,322637
2662,0.000702,74.125.24.0-255,2902,64754,13,322637
2663,0.000705,172.31.36.0-255,66,64820,13,322637
2664,0.000718,172.31.36.0-255,66,64886,13,322637
2665,0.000763,74.125.24.0-255,10692,75578,13,322637
2666,0.000766,172.31.36.0-255,66,75644,13,322637
2667,0.00088,74.125.24.0-255,332,75976,13,322637
2668,0.00091,74.125.24.0-255,1484,77460,13,322637
2669,0.000915,172.31.36.0-255,66,77526,13,322637
2670,0.000924,74.125.24.0-255,4320,81846,13,322637
2671,0.000932,172.31.36.0-255,66,81912,13,322637
2672,0.000963,74.125.24.0-255,7156,89068,13,322637
2673,0.000966,172.31.36.0-255,66,89134,13,322637
2674,0.000973,74.125.24.0-255,5738,94872,13,322637
2675,0.000976,172.31.36.0-255,66,94938,13,322637
2676,0.001006,74.125.24.0-255,2902,97840,13,322637
2677,0.001009,172.31.36.0-255,66,97906,13,322637
2678,0.001031,172.31.36.0-255,66,97972,13,322637
2679,0.001093,74.125.24.0-255,1484,99456,13,322637
2680,0.001106,74.125.24.0-255,2902,102358,13,322637
2681,0.00111,172.31.36.0-255,66,102424,13,322637
2682,0.001135,74.125.24.0-255,2902,105326,13,322637
2683,0.001139,172.31.36.0-255,66,105392,13,322637
2684,0.001166,74.125.24.0-255,2902,108294,13,322637
2685,0.001171,172.31.36.0-255,66,108360,13,322637
2686,0.001172,74.125.24.0-255,5738,114098,13,322637
2687,0.001175,172.31.36.0-255,66,114164,13,322637
2688,0.001178,74.125.24.0-255,5738,119902,13,322637
2689,0.001181,172.31.36.0-255,66,119968,13,322637
2690,0.001208,74.125.24.0-255,7156,127124,13,322637
2691,0.001211,172.31.36.0-255,66,127190,13,322637
2692,0.001219,74.125.24.0-255,5020,132210,13,322637
2693,0.001222,172.31.36.0-255,66,132276,13,322637
2694,0.00134,74.125.24.0-255,1484,133760,13,322637
2695,0.001345,74.125.24.0-255,1484,135244,13,322637
2696,0.001348,172.31.36.0-255,66,135310,13,322637
2697,0.001372,74.125.24.0-255,1484,136794,13,322637
2698,0.001381,74.125.24.0-255,5738,142532,13,322637
2699,0.001384,172.31.36.0-255,66,142598,13,322637
2700,0.00139,74.125.24.0-255,4320,146918,13,322637
2701,0.001392,172.31.36.0-255,66,146984,13,322637
2702,0.001431,74.125.24.0-255,8574,155558,13,322637
2703,0.001435,172.31.36.0-255,66,155624,13,322637
2704,0.001444,74.125.24.0-255,10692,166316,13,322637
2705,0.001447,172.31.36.0-255,66,166382,13,322637
2706,0.001525,74.125.24.0-255,1484,167866,13,322637
2707,0.001531,74.125.24.0-255,2902,170768,13,322637
2708,0.001533,172.31.36.0-255,66,170834,13,322637
2709,0.001566,74.125.24.0-255,5738,176572,13,322637
2710,0.001569,172.31.36.0-255,66,176638,13,322637
2711,0.001577,74.125.24.0-255,8574,185212,13,322637
2712,0.00158,172.31.36.0-255,66,185278,13,322637
2713,0.001615,74.125.24.0-255,4320,189598,13,322637
2714,0.001618,172.31.36.0-255,66,189664,13,322637
2715,0.001643,74.125.24.0-255,10692,200356,13,322637
2716,0.001646,172.31.36.0-255,66,200422,13,322637
2717,0.001974,74.125.24.0-255,1484,201906,13,322637
2718,0.00198,74.125.24.0-255,2902,204808,13,322637
2719,0.001983,172.31.36.0-255,66,204874,13,322637
2720,0.002044,74.125.24.0-255,5738,210612,13,322637
2721,0.002048,172.31.36.0-255,66,210678,13,322637
2722,0.002078,74.125.24.0-255,8574,219252,13,322637
2723,0.002082,172.31.36.0-255,66,219318,13,322637
2724,0.002089,74.125.24.0-255,5738,225056,13,322637
2725,0.002091,172.31.36.0-255,66,225122,13,322637
2726,0.002093,74.125.24.0-255,1484,226606,13,322637
2727,0.002125,74.125.24.0-255,2902,229508,13,322637
2728,0.002129,172.31.36.0-255,66,229574,13,322637
2729,0.002158,74.125.24.0-255,5020,234594,13,322637
2730,0.002161,172.31.36.0-255,66,234660,13,322637
2731,0.002361,74.125.24.0-255,1484,236144,13,322637
2732,0.002367,74.125.24.0-255,2902,239046,13,322637
2733,0.00237,172.31.36.0-255,66,239112,13,322637
2734,0.002396,74.125.24.0-255,4320,243432,13,322637
2735,0.0024,172.31.36.0-255,66,243498,13,322637
2736,0.002404,74.125.24.0-255,1484,244982,13,322637
2737,0.002428,74.125.24.0-255,7156,252138,13,322637
2738,0.002446,172.31.36.0-255,66,252204,13,322637
2739,0.00245,74.125.24.0-255,1484,253688,13,322637
2740,0.002456,74.125.24.0-255,4320,258008,13,322637
2741,0.002459,172.31.36.0-255,66,258074,13,322637
2742,0.002498,74.125.24.0-255,7156,265230,13,322637
2743,0.002502,172.31.36.0-255,66,265296,13,322637
2744,0.002508,74.125.24.0-255,3602,268898,13,322637
2745,0.00251,172.31.36.0-255,66,268964,13,322637
2746,0.00256,74.125.24.0-255,1484,270448,13,322637
2747,0.002566,74.125.24.0-255,2902,273350,13,322637
2748,0.002568,172.31.36.0-255,66,273416,13,322637
2749,0.002605,74.125.24.0-255,5738,279154,13,322637
2750,0.00261,172.31.36.0-255,66,279220,13,322637
2751,0.00263,172.31.36.0-255,66,279286,13,322637
2752,0.002639,74.125.24.0-255,9992,289278,13,322637
2753,0.002642,172.31.36.0-255,66,289344,13,322637
2754,0.002673,74.125.24.0-255,3602,292946,13,322637
2755,0.002677,172.31.36.0-255,66,293012,13,322637
2756,0.002691,172.31.36.0-255,66,293078,13,322637
2757,0.002723,74.125.24.0-255,7156,300234,13,322637
2758,0.002728,172.31.36.0-255,66,300300,13,322637
2759,0.002731,74.125.24.0-255,1484,301784,13,322637
2760,0.002737,74.125.24.0-255,4320,306104,13,322637
2761,0.002761,74.125.24.0-255,6438,312542,13,322637
2762,0.002783,74.125.24.0-255,6433,318975,13,322637
2763,0.00281,74.125.24.0-255,105,319080,13,322637
2764,0.008855,172.31.36.0-255,66,319146,13,322637
2765,0.010253,172.31.36.0-255,105,319251,13,322637
2766,0.012278,74.125.24.0-255,66,319317,13,322637
2767,0.027263,172.31.36.0-255,167,319484,13,322637
2768,0.02729,172.31.36.0-255,1108,320592,13,322637
2769,0.027323,172.31.36.0-255,1514,322106,13,322637
2770,0.027325,172.31.36.0-255,333,322439,13,322637
2771,0.028773,104.244.42.0-255,66,322505,13,322637
2772,0.028792,104.244.42.0-255,66,322571,13,322637
2773,0.028859,104.244.42.0-255,66,322637,13,322637
2774,0.0,74.125.24.0-255,153,153,13,327044
2775,2.4e-05,172.31.36.0-255,66,219,13,327044
2776,3.1e-05,74.125.24.0-255,1484,1703,13,327044
2777,3.6e-05,172.31.36.0-255,66,1769,13,327044
2778,4.1e-05,74.125.24.0-255,2902,4671,13,327044
2779,4.4e-05,172.31.36.0-255,66,4737,13,327044
2780,5.3e-05,74.125.24.0-255,7156,11893,13,327044
2781,5.7e-05,172.31.36.0-255,66,11959,13,327044
2782,6.2e-05,74.125.24.0-255,2086,14045,13,327044
2783,6.5e-05,172.31.36.0-255,66,14111,13,327044
2784,7.5e-05,74.125.24.0-255,8574,22685,13,327044
2785,7.8e-05,172.31.36.0-255,66,22751,13,327044
2786,9.9e-05,74.125.24.0-255,2902,25653,13,327044
2787,0.000101,172.31.36.0-255,66,25719,13,327044
2788,0.000107,74.125.24.0-255,5379,31098,13,327044
2789,0.00011,172.31.36.0-255,66,31164,13,327044
2790,0.000176,74.125.24.0-255,1484,32648,13,327044
2791,0.000179,172.31.36.0-255,66,32714,13,327044
2792,0.000184,74.125.24.0-255,2902,35616,13,327044
2793,0.000186,172.31.36.0-255,66,35682,13,327044
2794,0.000192,74.125.24.0-255,2902,38584,13,327044
2795,0.000195,172.31.36.0-255,66,38650,13,327044
2796,0.000227,74.125.24.0-255,7156,45806,13,327044
2797,0.00023,172.31.36.0-255,66,45872,13,327044
2798,0.000243,74.125.24.0-255,2902,48774,13,327044
2799,0.000245,172.31.36.0-255,66,48840,13,327044
2800,0.000273,172.31.36.0-255,66,48906,13,327044
2801,0.000293,74.125.24.0-255,2543,51449,13,327044
2802,0.000296,172.31.36.0-255,66,51515,13,327044
2803,0.0003,74.125.24.0-255,2818,54333,13,327044
2804,0.000302,172.31.36.0-255,66,54399,13,327044
2805,0.000304,74.125.24.0-255,412,54811,13,327044
2806,0.00059,74.125.24.0-255,1484,56295,13,327044
2807,0.000596,172.31.36.0-255,66,56361,13,327044
2808,0.000601,74.125.24.0-255,2902,59263,13,327044
2809,0.000604,172.31.36.0-255,66,59329,13,327044
2810,0.000609,74.125.24.0-255,2902,62231,13,327044
2811,0.000612,172.31.36.0-255,66,62297,13,327044
2812,0.000638,74.125.24.0-255,1484,63781,13,327044
2813,0.000646,74.125.24.0-255,5738,69519,13,327044
2814,0.000648,172.31.36.0-255,66,69585,13,327044
2815,0.000662,172.31.36.0-255,66,69651,13,327044
2816,0.000666,74.125.24.0-255,2902,72553,13,327044
2817,0.000668,172.31.36.0-255,66,72619,13,327044
2818,0.000684,74.125.24.0-255,5020,77639,13,327044
2819,0.000688,172.31.36.0-255,66,77705,13,327044
2820,0.001356,74.125.24.0-255,1484,79189,13,327044
2821,0.001362,74.125.24.0-255,2902,82091,13,327044
2822,0.001366,172.31.36.0-255,66,82157,13,327044
2823,0.00139,74.125.24.0-255,5738,87895,13,327044
2824,0.001394,172.31.36.0-255,66,87961,13,327044
2825,0.0014,74.125.24.0-255,4320,92281,13,327044
2826,0.001402,172.31.36.0-255,66,92347,13,327044
2827,0.001433,74.125.24.0-255,8574,100921,13,327044
2828,0.001443,74.125.24.0-255,10692,111613,13,327044
2829,0.001448,172.31.36.0-255,66,111679,13,327044
2830,0.001456,172.31.36.0-255,66,111745,13,327044
2831,0.001493,74.125.24.0-255,1484,113229,13,327044
2832,0.001499,74.125.24.0-255,2902,116131,13,327044
2833,0.001502,172.31.36.0-255,66,116197,13,327044
2834,0.001524,74.125.24.0-255,5738,121935,13,327044
2835,0.001526,172.31.36.0-255,66,122001,13,327044
2836,0.001531,74.125.24.0-255,2902,124903,13,327044
2837,0.001533,172.31.36.0-255,66,124969,13,327044
2838,0.00154,74.125.24.0-255,7156,132125,13,327044
2839,0.001542,172.31.36.0-255,66,132191,13,327044
2840,0.001565,74.125.24.0-255,2902,135093,13,327044
2841,0.001568,172.31.36.0-255,66,135159,13,327044
2842,0.001583,74.125.24.0-255,5738,140897,13,327044
2843,0.001586,172.31.36.0-255,66,140963,13,327044
2844,0.001602,74.125.24.0-255,5020,145983,13,327044
2845,0.001606,172.31.36.0-255,66,146049,13,327044
2846,0.001644,74.125.24.0-255,1484,147533,13,327044
2847,0.001649,74.125.24.0-255,2902,150435,13,327044
2848,0.001652,172.31.36.0-255,66,150501,13,327044
2849,0.001673,74.125.24.0-255,5738,156239,13,327044
2850,0.001676,172.31.36.0-255,66,156305,13,327044
2851,0.001682,74.125.24.0-255,5738,162043,13,327044
2852,0.001684,172.31.36.0-255,66,162109,13,327044
2853,0.00171,74.125.24.0-255,7156,169265,13,327044
2854,0.001713,172.31.36.0-255,66,169331,13,327044
2855,0.001735,74.125.24.0-255,5738,175069,13,327044
2856,0.001741,74.125.24.0-255,5020,180089,13,327044
2857,0.001745,172.31.36.0-255,66,180155,13,327044
2858,0.001752,172.31.36.0-255,66,180221,13,327044
2859,0.001759,74.125.24.0-255,5738,185959,13,327044
2860,0.001762,172.31.36.0-255,66,186025,13,327044
2861,0.001801,172.31.36.0-255,66,186091,13,327044
2862,0.001804,74.125.24.0-255,1484,187575,13,327044
2863,0.001844,74.125.24.0-255,8574,196149,13,327044
2864,0.001847,172.31.36.0-255,66,196215,13,327044
2865,0.001866,74.125.24.0-255,5020,201235,13,327044
2866,0.001871,172.31.36.0-255,66,201301,13,327044
2867,0.001936,74.125.24.0-255,1484,202785,13,327044
2868,0.00195,74.125.24.0-255,2902,205687,13,327044
2869,0.001953,172.31.36.0-255,66,205753,13,327044
2870,0.001958,74.125.24.0-255,2902,208655,13,327044
2871,0.00196,172.31.36.0-255,66,208721,13,327044
2872,0.001975,74.125.24.0-255,2902,211623,13,327044
2873,0.001977,172.31.36.0-255,66,211689,13,327044
2874,0.001982,74.125.24.0-255,2902,214591,13,327044
2875,0.001983,172.31.36.0-255,66,214657,13,327044
2876,0.00202,74.125.24.0-255,8574,223231,13,327044
2877,0.002023,172.31.36.0-255,66,223297,13,327044
2878,0.002035,172.31.36.0-255,66,223363,13,327044
2879,0.002205,74.125.24.0-255,1484,224847,13,327044
2880,0.00221,74.125.24.0-255,1484,226331,13,327044
2881,0.002214,172.31.36.0-255,66,226397,13,327044
2882,0.00224,74.125.24.0-255,1484,227881,13,327044
2883,0.002247,74.125.24.0-255,5738,233619,13,327044
2884,0.00225,172.31.36.0-255,66,233685,13,327044
2885,0.002256,74.125.24.0-255,5738,239423,13,327044
2886,0.002258,172.31.36.0-255,66,239489,13,327044
2887,0.002317,172.31.36.0-255,66,239555,13,327044
2888,0.002324,74.125.24.0-255,5020,244575,13,327044
2889,0.002327,172.31.36.0-255,66,244641,13,327044
2890,0.002401,74.125.24.0-255,1484,246125,13,327044
2891,0.002409,74.125.24.0-255,2902,249027,13,327044
2892,0.002412,172.31.36.0-255,66,249093,13,327044
2893,0.00242,74.125.24.0-255,5738,254831,13,327044
2894,0.002423,172.31.36.0-255,66,254897,13,327044
2895,0.002427,74.125.24.0-255,2902,257799,13,327044
2896,0.00243,172.31.36.0-255,66,257865,13,327044
2897,0.00247,74.125.24.0-255,9992,267857,13,327044
2898,0.002474,172.31.36.0-255,66,267923,13,327044
2899,0.002477,74.125.24.0-255,1484,269407,13,327044
2900,0.004868,74.125.24.0-255,4320,273727,13,327044
2901,0.004875,172.31.36.0-255,66,273793,13,327044
2902,0.007292,74.125.24.0-255,5738,279531,13,327044
2903,0.007299,172.31.36.0-255,66,279597,13,327044
2904,0.009674,74.125.24.0-255,5738,285335,13,327044
2905,0.009678,172.31.36.0-255,66,285401,13,327044
2906,0.01206,74.125.24.0-255,5738,291139,13,327044
2907,0.012068,172.31.36.0-255,66,291205,13,327044
2908,0.01446,74.125.24.0-255,4320,295525,13,327044
2909,0.014469,172.31.36.0-255,66,295591,13,327044
2910,0.014487,74.125.24.0-255,1484,297075,13,327044
2911,0.016869,74.125.24.0-255,4320,301395,13,327044
2912,0.016882,172.31.36.0-255,66,301461,13,327044
2913,0.01929,74.125.24.0-255,5738,307199,13,327044
2914,0.019298,172.31.36.0-255,66,307265,13,327044
2915,0.021718,74.125.24.0-255,5738,313003,13,327044
2916,0.021728,172.31.36.0-255,66,313069,13,327044
2917,0.024169,74.125.24.0-255,5738,318807,13,327044
2918,0.024181,172.31.36.0-255,66,318873,13,327044
2919,0.026578,74.125.24.0-255,3644,322517,13,327044
2920,0.026585,172.31.36.0-255,66,322583,13,327044
2921,0.02681,172.31.36.0-255,105,322688,13,327044
2922,0.029179,74.125.24.0-255,66,322754,13,327044
2923,0.032465,172.31.36.0-255,171,322925,13,327044
2924,0.032495,172.31.36.0-255,1134,324059,13,327044
2925,0.032559,172.31.36.0-255,1514,325573,13,327044
2926,0.032561,172.31.36.0-255,1273,326846,13,327044
2927,0.03414,104.244.42.0-255,66,326912,13,327044
2928,0.034167,104.244.42.0-255,66,326978,13,327044
2929,0.034239,104.244.42.0-255,66,327044,13,327044
2930,0.0,74.125.130.0-255,152,152,13,363263
2931,3.7e-05,172.31.36.0-255,66,218,13,363263
2932,4.4e-05,74.125.130.0-255,1484,1702,13,363263
2933,4.8e-05,172.31.36.0-255,66,1768,13,363263
2934,5.3e-05,74.125.130.0-255,2902,4670,13,363263
2935,5.6e-05,172.31.36.0-255,66,4736,13,363263
2936,6e-05,74.125.130.0-255,2902,7638,13,363263
2937,6.3e-05,172.31.36.0-255,66,7704,13,363263
2938,8.9e-05,74.125.130.0-255,1484,9188,13,363263
2939,9.2e-05,172.31.36.0-255,66,9254,13,363263
2940,9.8e-05,74.125.130.0-255,4907,14161,13,363263
2941,0.0001,172.31.36.0-255,66,14227,13,363263
2942,0.000238,74.125.130.0-255,1484,15711,13,363263
2943,0.000243,172.31.36.0-255,66,15777,13,363263
2944,0.000249,74.125.130.0-255,2902,18679,13,363263
2945,0.000253,172.31.36.0-255,66,18745,13,363263
2946,0.000278,74.125.130.0-255,2902,21647,13,363263
2947,0.000281,172.31.36.0-255,66,21713,13,363263
2948,0.000286,74.125.130.0-255,4320,26033,13,363263
2949,0.000289,172.31.36.0-255,66,26099,13,363263
2950,0.000309,74.125.130.0-255,1484,27583,13,363263
2951,0.000312,172.31.36.0-255,66,27649,13,363263
2952,0.000334,74.125.130.0-255,3961,31610,13,363263
2953,0.000338,172.31.36.0-255,66,31676,13,363263
2954,0.000345,74.125.130.0-255,5738,37414,13,363263
2955,0.000349,172.31.36.0-255,66,37480,13,363263
2956,0.000357,74.125.130.0-255,2902,40382,13,363263
2957,0.00036,172.31.36.0-255,66,40448,13,363263
2958,0.000376,74.125.130.0-255,2902,43350,13,363263
2959,0.000379,172.31.36.0-255,66,43416,13,363263
2960,0.000417,74.125.130.0-255,5379,48795,13,363263
2961,0.000421,172.31.36.0-255,66,48861,13,363263
2962,0.000536,74.125.130.0-255,1484,50345,13,363263
2963,0.000542,74.125.130.0-255,2902,53247,13,363263
2964,0.000546,172.31.36.0-255,66,53313,13,363263
2965,0.000565,74.125.130.0-255,2902,56215,13,363263
2966,0.000569,172.31.36.0-255,66,56281,13,363263
2967,0.000588,74.125.130.0-255,4320,60601,13,363263
2968,0.000591,172.31.36.0-255,66,60667,13,363263
2969,0.000614,74.125.130.0-255,2902,63569,13,363263
2970,0.000617,172.31.36.0-255,66,63635,13,363263
2971,0.000635,74.125.130.0-255,2839,66474,13,363263
2972,0.000638,172.31.36.0-255,66,66540,13,363263
2973,0.00064,74.125.130.0-255,380,66920,13,363263
2974,0.000802,172.31.36.0-255,66,66986,13,363263
2975,0.000965,74.125.130.0-255,1484,68470,13,363263
2976,0.000974,74.125.130.0-255,1484,69954,13,363263
2977,0.000978,172.31.36.0-255,66,70020,13,363263
2978,0.000997,74.125.130.0-255,1484,71504,13,363263
2979,0.001002,74.125.130.0-255,1484,72988,13,363263
2980,0.001005,172.31.36.0-255,66,73054,13,363263
2981,0.001021,74.125.130.0-255,4320,77374,13,363263
2982,0.001025,172.31.36.0-255,66,77440,13,363263
2983,0.001036,74.125.130.0-255,1484,78924,13,363263
2984,0.00106,74.125.130.0-255,7156,86080,13,363263
2985,0.001063,172.31.36.0-255,66,86146,13,363263
2986,0.001072,74.125.130.0-255,9992,96138,13,363263
2987,0.001075,172.31.36.0-255,66,96204,13,363263
2988,0.001081,74.125.130.0-255,5020,101224,13,363263
2989,0.001085,172.31.36.0-255,66,101290,13,363263
2990,0.001574,74.125.130.0-255,1484,102774,13,363263
2991,0.001583,74.125.130.0-255,2902,105676,13,363263
2992,0.001587,172.31.36.0-255,66,105742,13,363263
2993,0.001611,74.125.130.0-255,5738,111480,13,363263
2994,0.001614,172.31.36.0-255,66,111546,13,363263
2995,0.001667,74.125.130.0-255,9992,121538,13,363263
2996,0.001671,172.31.36.0-255,66,121604,13,363263
2997,0.001683,172.31.36.0-255,66,121670,13,363263
2998,0.001687,74.125.130.0-255,2184,123854,13,363263
2999,0.001689,172.31.36.0-255,66,123920,13,363263
3000,0.003819,74.125.130.0-255,2902,126822,13,363263
3001,0.003823,172.31.36.0-255,66,126888,13,363263
3002,0.003839,74.125.130.0-255,2902,129790,13,363263
3003,0.003841,172.31.36.0-255,66,129856,13,363263
3004,0.0061,74.125.130.0-255,5738,135594,13,363263
3005,0.006107,172.31.36.0-255,66,135660,13,363263
3006,0.008257,74.125.130.0-255,5738,141398,13,363263
3007,0.008262,172.31.36.0-255,66,141464,13,363263
3008,0.010577,74.125.130.0-255,5738,147202,13,363263
3009,0.010583,172.31.36.0-255,66,147268,13,363263
3010,0.012757,74.125.130.0-255,5738,153006,13,363263
3011,0.012764,172.31.36.0-255,66,153072,13,363263
3012,0.014928,74.125.130.0-255,5738,158810,13,363263
3013,0.014935,172.31.36.0-255,66,158876,13,363263
3014,0.017099,74.125.130.0-255,5738,164614,13,363263
3015,0.017108,172.31.36.0-255,66,164680,13,363263
3016,0.019265,74.125.130.0-255,5738,170418,13,363263
3017,0.019274,172.31.36.0-255,66,170484,13,363263
3018,0.021439,74.125.130.0-255,5738,176222,13,363263
3019,0.021445,172.31.36.0-255,66,176288,13,363263
3020,0.023817,74.125.130.0-255,5738,182026,13,363263
3021,0.023824,172.31.36.0-255,66,182092,13,363263
3022,0.025983,74.125.130.0-255,5738,187830,13,363263
3023,0.025991,172.31.36.0-255,66,187896,13,363263
3024,0.028143,74.125.130.0-255,5738,193634,13,363263
3025,0.028151,172.31.36.0-255,66,193700,13,363263
3026,0.030301,74.125.130.0-255,5738,199438,13,363263
3027,0.030307,172.31.36.0-255,66,199504,13,363263
3028,0.032468,74.125.130.0-255,5738,205242,13,363263
3029,0.032474,172.31.36.0-255,66,205308,13,363263
3030,0.034639,74.125.130.0-255,5738,211046,13,363263
3031,0.034646,172.31.36.0-255,66,211112,13,363263
3032,0.036589,172.31.36.0-255,172,211284,13,363263
3033,0.03662,172.31.36.0-255,1110,212394,13,363263
3034,0.036658,172.31.36.0-255,1514,213908,13,363263
3035,0.036659,172.31.36.0-255,1514,215422,13,363263
3036,0.036663,172.31.36.0-255,1514,216936,13,363263
3037,0.036664,172.31.36.0-255,1514,218450,13,363263
3038,0.036687,172.31.36.0-255,1514,219964,13,363263
3039,0.036688,172.31.36.0-255,143,220107,13,363263
3040,0.036801,74.125.130.0-255,5738,225845,13,363263
3041,0.036823,172.31.36.0-255,66,225911,13,363263
3042,0.038253,104.244.42.0-255,66,225977,13,363263
3043,0.038288,104.244.42.0-255,66,226043,13,363263
3044,0.038355,104.244.42.0-255,66,226109,13,363263
3045,0.038389,104.244.42.0-255,66,226175,13,363263
3046,0.038973,74.125.130.0-255,4320,230495,13,363263
3047,0.038979,172.31.36.0-255,66,230561,13,363263
3048,0.039014,74.125.130.0-255,1484,232045,13,363263
3049,0.041121,74.125.130.0-255,4320,236365,13,363263
3050,0.041127,172.31.36.0-255,66,236431,13,363263
3051,0.043307,74.125.130.0-255,4320,240751,13,363263
3052,0.043313,172.31.36.0-255,66,240817,13,363263
3053,0.043329,74.125.130.0-255,1484,242301,13,363263
3054,0.045455,74.125.130.0-255,4320,246621,13,363263
3055,0.04546,172.31.36.0-255,66,246687,13,363263
3056,0.047607,74.125.130.0-255,5738,252425,13,363263
3057,0.047613,172.31.36.0-255,66,252491,13,363263
3058,0.049759,74.125.130.0-255,2902,255393,13,363263
3059,0.049764,172.31.36.0-255,66,255459,13,363263
3060,0.049791,74.125.130.0-255,2902,258361,13,363263
3061,0.049794,172.31.36.0-255,66,258427,13,363263
3062,0.051913,74.125.130.0-255,2902,261329,13,363263
3063,0.051919,172.31.36.0-255,66,261395,13,363263
3064,0.051953,74.125.130.0-255,2902,264297,13,363263
3065,0.051956,172.31.36.0-255,66,264363,13,363263
3066,0.054065,74.125.130.0-255,2902,267265,13,363263
3067,0.05407,172.31.36.0-255,66,267331,13,363263
3068,0.054096,74.125.130.0-255,2902,270233,13,363263
3069,0.054099,172.31.36.0-255,66,270299,13,363263
3070,0.05622,74.125.130.0-255,2902,273201,13,363263
3071,0.056225,172.31.36.0-255,66,273267,13,363263
3072,0.056257,74.125.130.0-255,2902,276169,13,363263
3073,0.05626,172.31.36.0-255,66,276235,13,363263
3074,0.058371,74.125.130.0-255,2902,279137,13,363263
3075,0.058376,172.31.36.0-255,66,279203,13,363263
3076,0.058409,74.125.130.0-255,2902,282105,13,363263
3077,0.058412,172.31.36.0-255,66,282171,13,363263
3078,0.060515,74.125.130.0-255,2902,285073,13,363263
3079,0.06052,172.31.36.0-255,66,285139,13,363263
3080,0.060551,74.125.130.0-255,2902,288041,13,363263
3081,0.060554,172.31.36.0-255,66,288107,13,363263
3082,0.062694,74.125.130.0-255,2902,291009,13,363263
3083,0.0627,172.31.36.0-255,66,291075,13,363263
3084,0.062734,74.125.130.0-255,2902,293977,13,363263
3085,0.062737,172.31.36.0-255,66,294043,13,363263
3086,0.064841,74.125.130.0-255,2902,296945,13,363263
3087,0.064846,172.31.36.0-255,66,297011,13,363263
3088,0.064876,74.125.130.0-255,2902,299913,13,363263
3089,0.064879,172.31.36.0-255,66,299979,13,363263
3090,0.066985,74.125.130.0-255,2902,302881,13,363263
3091,0.066991,172.31.36.0-255,66,302947,13,363263
3092,0.067026,74.125.130.0-255,2902,305849,13,363263
3093,0.067029,172.31.36.0-255,66,305915,13,363263
3094,0.069139,74.125.130.0-255,2902,308817,13,363263
3095,0.069144,172.31.36.0-255,66,308883,13,363263
3096,0.069179,74.125.130.0-255,2902,311785,13,363263
3097,0.069182,172.31.36.0-255,66,311851,13,363263
3098,0.071302,74.125.130.0-255,2902,314753,13,363263
3099,0.071307,172.31.36.0-255,66,314819,13,363263
3100,0.071335,74.125.130.0-255,2902,317721,13,363263
3101,0.071338,172.31.36.0-255,66,317787,13,363263
3102,0.07347,74.125.130.0-255,5738,323525,13,363263
3103,0.073477,172.31.36.0-255,66,323591,13,363263
3104,0.075656,74.125.130.0-255,5738,329329,13,363263
3105,0.075662,172.31.36.0-255,66,329395,13,363263
3106,0.07781,74.125.130.0-255,4320,333715,13,363263
3107,0.077815,172.31.36.0-255,66,333781,13,363263
3108,0.077847,74.125.130.0-255,1484,335265,13,363263
3109,0.079968,74.125.130.0-255,4320,339585,13,363263
3110,0.079973,172.31.36.0-255,66,339651,13,363263
3111,0.082118,74.125.130.0-255,5738,345389,13,363263
3112,0.082123,172.31.36.0-255,66,345455,13,363263
3113,0.084267,74.125.130.0-255,2902,348357,13,363263
3114,0.084272,172.31.36.0-255,66,348423,13,363263
3115,0.084301,74.125.130.0-255,2902,351325,13,363263
3116,0.084304,172.31.36.0-255,66,351391,13,363263
3117,0.086421,74.125.130.0-255,2902,354293,13,363263
3118,0.086427,172.31.36.0-255,66,354359,13,363263
3119,0.086457,74.125.130.0-255,2902,357261,13,363263
3120,0.08646,172.31.36.0-255,66,357327,13,363263
3121,0.088571,74.125.130.0-255,2902,360229,13,363263
3122,0.088577,172.31.36.0-255,66,360295,13,363263
3123,0.088607,74.125.130.0-255,2902,363197,13,363263
3124,0.08861,172.31.36.0-255,66,363263,13,363263
3125,0.0,74.125.68.0-255,153,153,13,357250
3126,1.9e-05,172.31.36.0-255,66,219,13,357250
3127,2.6e-05,74.125.68.0-255,1484,1703,13,357250
3128,3.1e-05,172.31.36.0-255,66,1769,13,357250
3129,3.7e-05,74.125.68.0-255,2902,4671,13,357250
3130,4e-05,172.31.36.0-255,66,4737,13,357250
3131,4.4e-05,74.125.68.0-255,1484,6221,13,357250
3132,4.6e-05,172.31.36.0-255,66,6287,13,357250
3133,5e-05,74.125.68.0-255,1484,7771,13,357250
3134,5.2e-05,172.31.36.0-255,66,7837,13,357250
3135,7.7e-05,74.125.68.0-255,1484,9321,13,357250
3136,8e-05,172.31.36.0-255,66,9387,13,357250
3137,9.9e-05,74.125.68.0-255,4887,14274,13,357250
3138,0.000101,172.31.36.0-255,66,14340,13,357250
3139,0.000184,74.125.68.0-255,1484,15824,13,357250
3140,0.000187,172.31.36.0-255,66,15890,13,357250
3141,0.000193,74.125.68.0-255,2902,18792,13,357250
3142,0.000196,172.31.36.0-255,66,18858,13,357250
3143,0.000215,74.125.68.0-255,4320,23178,13,357250
3144,0.000218,172.31.36.0-255,66,23244,13,357250
3145,0.000267,74.125.68.0-255,8215,31459,13,357250
3146,0.00027,172.31.36.0-255,66,31525,13,357250
3147,0.000287,74.125.68.0-255,1484,33009,13,357250
3148,0.00029,172.31.36.0-255,66,33075,13,357250
3149,0.000314,74.125.68.0-255,7156,40231,13,357250
3150,0.000317,172.31.36.0-255,66,40297,13,357250
3151,0.000325,74.125.68.0-255,7156,47453,13,357250
3152,0.000328,172.31.36.0-255,66,47519,13,357250
3153,0.000357,74.125.68.0-255,2902,50421,13,357250
3154,0.00036,172.31.36.0-255,66,50487,13,357250
3155,0.000364,74.125.68.0-255,2902,53389,13,357250
3156,0.000366,172.31.36.0-255,66,53455,13,357250
3157,0.000371,74.125.68.0-255,2902,56357,13,357250
3158,0.000374,172.31.36.0-255,66,56423,13,357250
3159,0.000391,74.125.68.0-255,1484,57907,13,357250
3160,0.000394,74.125.68.0-255,1484,59391,13,357250
3161,0.000397,172.31.36.0-255,66,59457,13,357250
3162,0.000402,74.125.68.0-255,2902,62359,13,357250
3163,0.000404,172.31.36.0-255,66,62425,13,357250
3164,0.000452,74.125.68.0-255,3602,66027,13,357250
3165,0.000456,172.31.36.0-255,66,66093,13,357250
3166,0.000486,74.125.68.0-255,677,66770,13,357250
3167,0.000526,74.125.68.0-255,1484,68254,13,357250
3168,0.000528,172.31.36.0-255,66,68320,13,357250
3169,0.000545,74.125.68.0-255,4320,72640,13,357250
3170,0.000547,172.31.36.0-255,66,72706,13,357250
3171,0.000569,74.125.68.0-255,5738,78444,13,357250
3172,0.000571,172.31.36.0-255,66,78510,13,357250
3173,0.00061,74.125.68.0-255,4320,82830,13,357250
3174,0.000613,172.31.36.0-255,66,82896,13,357250
3175,0.000638,74.125.68.0-255,7156,90052,13,357250
3176,0.000641,172.31.36.0-255,66,90118,13,357250
3177,0.000659,74.125.68.0-255,7156,97274,13,357250
3178,0.000663,172.31.36.0-255,66,97340,13,357250
3179,0.000687,74.125.68.0-255,3602,100942,13,357250
3180,0.00069,172.31.36.0-255,66,101008,13,357250
3181,0.000788,74.125.68.0-255,1484,102492,13,357250
3182,0.000803,74.125.68.0-255,2902,105394,13,357250
3183,0.000806,172.31.36.0-255,66,105460,13,357250
3184,0.000826,74.125.68.0-255,4320,109780,13,357250
3185,0.000831,172.31.36.0-255,66,109846,13,357250
3186,0.000873,74.125.68.0-255,8574,118420,13,357250
3187,0.000876,172.31.36.0-255,66,118486,13,357250
3188,0.000912,74.125.68.0-255,5738,124224,13,357250
3189,0.000916,172.31.36.0-255,66,124290,13,357250
3190,0.000941,74.125.68.0-255,7156,131446,13,357250
3191,0.000945,172.31.36.0-255,66,131512,13,357250
3192,0.000968,74.125.68.0-255,3602,135114,13,357250
3193,0.000972,172.31.36.0-255,66,135180,13,357250
3194,0.001064,74.125.68.0-255,1484,136664,13,357250
3195,0.001069,74.125.68.0-255,2902,139566,13,357250
3196,0.001075,172.31.36.0-255,66,139632,13,357250
3197,0.001085,74.125.68.0-255,2902,142534,13,357250
3198,0.001088,172.31.36.0-255,66,142600,13,357250
3199,0.001119,74.125.68.0-255,2902,145502,13,357250
3200,0.001122,172.31.36.0-255,66,145568,13,357250
3201,0.001129,74.125.68.0-255,5738,151306,13,357250
3202,0.001131,172.31.36.0-255,66,151372,13,357250
3203,0.001138,74.125.68.0-255,7156,158528,13,357250
3204,0.00114,172.31.36.0-255,66,158594,13,357250
3205,0.001165,74.125.68.0-255,4320,162914,13,357250
3206,0.001169,172.31.36.0-255,66,162980,13,357250
3207,0.001186,74.125.68.0-255,2902,165882,13,357250
3208,0.001189,172.31.36.0-255,66,165948,13,357250
3209,0.001204,74.125.68.0-255,1484,167432,13,357250
3210,0.001217,74.125.68.0-255,2184,169616,13,357250
3211,0.00122,172.31.36.0-255,66,169682,13,357250
3212,0.001505,74.125.68.0-255,1484,171166,13,357250
3213,0.001523,74.125.68.0-255,2902,174068,13,357250
3214,0.001527,172.31.36.0-255,66,174134,13,357250
3215,0.001532,74.125.68.0-255,2902,177036,13,357250
3216,0.001534,172.31.36.0-255,66,177102,13,357250
3217,0.00155,74.125.68.0-255,2902,180004,13,357250
3218,0.001552,172.31.36.0-255,66,180070,13,357250
3219,0.001575,74.125.68.0-255,7156,187226,13,357250
3220,0.001577,172.31.36.0-255,66,187292,13,357250
3221,0.001594,74.125.68.0-255,2902,190194,13,357250
3222,0.001596,172.31.36.0-255,66,190260,13,357250
3223,0.001605,74.125.68.0-255,8574,198834,13,357250
3224,0.001607,172.31.36.0-255,66,198900,13,357250
3225,0.001632,74.125.68.0-255,2902,201802,13,357250
3226,0.001635,172.31.36.0-255,66,201868,13,357250
3227,0.001638,74.125.68.0-255,2184,204052,13,357250
3228,0.00164,172.31.36.0-255,66,204118,13,357250
3229,0.001711,74.125.68.0-255,1484,205602,13,357250
3230,0.001761,74.125.68.0-255,1484,207086,13,357250
3231,0.001764,172.31.36.0-255,66,207152,13,357250
3232,0.001779,74.125.68.0-255,1484,208636,13,357250
3233,0.001785,74.125.68.0-255,5738,214374,13,357250
3234,0.001787,172.31.36.0-255,66,214440,13,357250
3235,0.001795,74.125.68.0-255,8574,223014,13,357250
3236,0.001799,172.31.36.0-255,66,223080,13,357250
3237,0.001808,74.125.68.0-255,9992,233072,13,357250
3238,0.00181,172.31.36.0-255,66,233138,13,357250
3239,0.001813,74.125.68.0-255,1484,234622,13,357250
3240,0.001836,74.125.68.0-255,3602,238224,13,357250
3241,0.001839,172.31.36.0-255,66,238290,13,357250
3242,0.001845,74.125.68.0-255,5738,244028,13,357250
3243,0.001848,172.31.36.0-255,66,244094,13,357250
3244,0.001875,74.125.68.0-255,4320,248414,13,357250
3245,0.001877,172.31.36.0-255,66,248480,13,357250
3246,0.001907,74.125.68.0-255,7156,255636,13,357250
3247,0.00191,172.31.36.0-255,66,255702,13,357250
3248,0.001925,172.31.36.0-255,66,255768,13,357250
3249,0.00193,74.125.68.0-255,3602,259370,13,357250
3250,0.001933,172.31.36.0-255,66,259436,13,357250
3251,0.001954,74.125.68.0-255,4320,263756,13,357250
3252,0.001958,172.31.36.0-255,66,263822,13,357250
3253,0.001983,74.125.68.0-255,7156,270978,13,357250
3254,0.001986,172.31.36.0-255,66,271044,13,357250
3255,0.002014,74.125.68.0-255,8574,279618,13,357250
3256,0.002017,172.31.36.0-255,66,279684,13,357250
3257,0.002023,74.125.68.0-255,4320,284004,13,357250
3258,0.002026,172.31.36.0-255,66,284070,13,357250
3259,0.002055,74.125.68.0-255,5738,289808,13,357250
3260,0.002058,172.31.36.0-255,66,289874,13,357250
3261,0.002062,74.125.68.0-255,1484,291358,13,357250
3262,0.002079,74.125.68.0-255,2184,293542,13,357250
3263,0.002081,172.31.36.0-255,66,293608,13,357250
3264,0.002087,74.125.68.0-255,4320,297928,13,357250
3265,0.002089,172.31.36.0-255,66,297994,13,357250
3266,0.002118,74.125.68.0-255,8574,306568,13,357250
3267,0.002121,172.31.36.0-255,66,306634,13,357250
3268,0.002137,74.125.68.0-255,1484,308118,13,357250
3269,0.002142,74.125.68.0-255,2902,311020,13,357250
3270,0.002144,172.31.36.0-255,66,311086,13,357250
3271,0.002164,74.125.68.0-255,5738,316824,13,357250
3272,0.002166,172.31.36.0-255,66,316890,13,357250
3273,0.002181,74.125.68.0-255,7156,324046,13,357250
3274,0.002183,172.31.36.0-255,66,324112,13,357250
3275,0.002196,74.125.68.0-255,1484,325596,13,357250
3276,0.0022,74.125.68.0-255,2184,327780,13,357250
3277,0.002202,172.31.36.0-255,66,327846,13,357250
3278,0.002253,172.31.36.0-255,66,327912,13,357250
3279,0.002285,74.125.68.0-255,5738,333650,13,357250
3280,0.002288,172.31.36.0-255,66,333716,13,357250
3281,0.002307,74.125.68.0-255,9274,342990,13,357250
3282,0.002311,172.31.36.0-255,66,343056,13,357250
3283,0.002328,74.125.68.0-255,2902,345958,13,357250
3284,0.00233,172.31.36.0-255,66,346024,13,357250
3285,0.002357,74.125.68.0-255,6529,352553,13,357250
3286,0.00236,172.31.36.0-255,66,352619,13,357250
3287,0.004631,74.125.68.0-255,105,352724,13,357250
3288,0.008884,172.31.36.0-255,66,352790,13,357250
3289,0.008921,172.31.36.0-255,105,352895,13,357250
3290,0.011203,74.125.68.0-255,66,352961,13,357250
3291,0.032348,172.31.36.0-255,172,353133,13,357250
3292,0.032385,172.31.36.0-255,1106,354239,13,357250
3293,0.032448,172.31.36.0-255,1514,355753,13,357250
3294,0.03245,172.31.36.0-255,1299,357052,13,357250
3295,0.033896,104.244.42.0-255,66,357118,13,357250
3296,0.033931,104.244.42.0-255,66,357184,13,357250
3297,0.034011,104.244.42.0-255,66,357250,13,357250
3298,0.0,74.125.24.0-255,146,146,13,299923
3299,2.7e-05,74.125.24.0-255,1484,1630,13,299923
3300,3.5e-05,172.31.36.0-255,66,1696,13,299923
3301,4.2e-05,74.125.24.0-255,2902,4598,13,299923
3302,4.5e-05,172.31.36.0-255,66,4664,13,299923
3303,8e-05,74.125.24.0-255,5738,10402,13,299923
3304,8.2e-05,172.31.36.0-255,66,10468,13,299923
3305,0.000113,74.125.24.0-255,3458,13926,13,299923
3306,0.000115,172.31.36.0-255,66,13992,13,299923
3307,0.000175,74.125.24.0-255,1484,15476,13,299923
3308,0.00019,74.125.24.0-255,2902,18378,13,299923
3309,0.000194,172.31.36.0-255,66,18444,13,299923
3310,0.0002,74.125.24.0-255,5738,24182,13,299923
3311,0.000203,172.31.36.0-255,66,24248,13,299923
3312,0.000248,74.125.24.0-255,4320,28568,13,299923
3313,0.000252,172.31.36.0-255,66,28634,13,299923
3314,0.000272,74.125.24.0-255,2543,31177,13,299923
3315,0.000275,172.31.36.0-255,66,31243,13,299923
3316,0.000881,74.125.24.0-255,1484,32727,13,299923
3317,0.000893,74.125.24.0-255,2902,35629,13,299923
3318,0.000897,172.31.36.0-255,66,35695,13,299923
3319,0.000903,74.125.24.0-255,2902,38597,13,299923
3320,0.000905,172.31.36.0-255,66,38663,13,299923
3321,0.000928,74.125.24.0-255,2902,41565,13,299923
3322,0.00093,172.31.36.0-255,66,41631,13,299923
3323,0.000938,74.125.24.0-255,6797,48428,13,299923
3324,0.00094,172.31.36.0-255,66,48494,13,299923
3325,0.000976,74.125.24.0-255,5738,54232,13,299923
3326,0.000981,172.31.36.0-255,66,54298,13,299923
3327,0.001003,74.125.24.0-255,1484,55782,13,299923
3328,0.001011,74.125.24.0-255,8574,64356,13,299923
3329,0.001014,172.31.36.0-255,66,64422,13,299923
3330,0.001017,74.125.24.0-255,1399,65821,13,299923
3331,0.001127,74.125.24.0-255,381,66202,13,299923
3332,0.001132,172.31.36.0-255,66,66268,13,299923
3333,0.001368,74.125.24.0-255,1484,67752,13,299923
3334,0.001376,74.125.24.0-255,2902,70654,13,299923
3335,0.001379,172.31.36.0-255,66,70720,13,299923
3336,0.0014,74.125.24.0-255,5738,76458,13,299923
3337,0.001402,172.31.36.0-255,66,76524,13,299923
3338,0.00142,74.125.24.0-255,2902,79426,13,299923
3339,0.001422,172.31.36.0-255,66,79492,13,299923
3340,0.001455,74.125.24.0-255,8215,87707,13,299923
3341,0.001457,172.31.36.0-255,66,87773,13,299923
3342,0.001465,74.125.24.0-255,8574,96347,13,299923
3343,0.001467,172.31.36.0-255,66,96413,13,299923
3344,0.001488,74.125.24.0-255,9992,106405,13,299923
3345,0.001491,172.31.36.0-255,66,106471,13,299923
3346,0.001499,74.125.24.0-255,10692,117163,13,299923
3347,0.001502,172.31.36.0-255,66,117229,13,299923
3348,0.001573,74.125.24.0-255,1484,118713,13,299923
3349,0.001576,74.125.24.0-255,1484,120197,13,299923
3350,0.001579,172.31.36.0-255,66,120263,13,299923
3351,0.001595,74.125.24.0-255,1484,121747,13,299923
3352,0.001608,74.125.24.0-255,5738,127485,13,299923
3353,0.001611,172.31.36.0-255,66,127551,13,299923
3354,0.001623,74.125.24.0-255,1484,129035,13,299923
3355,0.001642,74.125.24.0-255,4830,133865,13,299923
3356,0.001645,172.31.36.0-255,66,133931,13,299923
3357,0.001648,74.125.24.0-255,1484,135415,13,299923
3358,0.001678,172.31.36.0-255,66,135481,13,299923
3359,0.001714,172.31.36.0-255,66,135547,13,299923
3360,0.001731,74.125.24.0-255,2184,137731,13,299923
3361,0.001733,172.31.36.0-255,66,137797,13,299923
3362,0.00207,74.125.24.0-255,1484,139281,13,299923
3363,0.002084,74.125.24.0-255,2902,142183,13,299923
3364,0.002088,172.31.36.0-255,66,142249,13,299923
3365,0.002105,74.125.24.0-255,5738,147987,13,299923
3366,0.002108,172.31.36.0-255,66,148053,13,299923
3367,0.00211,74.125.24.0-255,1484,149537,13,299923
3368,0.002126,74.125.24.0-255,4320,153857,13,299923
3369,0.002128,172.31.36.0-255,66,153923,13,299923
3370,0.002151,74.125.24.0-255,8574,162497,13,299923
3371,0.002153,172.31.36.0-255,66,162563,13,299923
3372,0.002161,74.125.24.0-255,8574,171137,13,299923
3373,0.002163,172.31.36.0-255,66,171203,13,299923
3374,0.002176,74.125.24.0-255,766,171969,13,299923
3375,0.002223,74.125.24.0-255,1484,173453,13,299923
3376,0.002225,172.31.36.0-255,66,173519,13,299923
3377,0.002241,74.125.24.0-255,2902,176421,13,299923
3378,0.002243,172.31.36.0-255,66,176487,13,299923
3379,0.002285,74.125.24.0-255,5738,182225,13,299923
3380,0.002288,172.31.36.0-255,66,182291,13,299923
3381,0.002295,74.125.24.0-255,7156,189447,13,299923
3382,0.002297,172.31.36.0-255,66,189513,13,299923
3383,0.002302,74.125.24.0-255,4320,193833,13,299923
3384,0.002305,172.31.36.0-255,66,193899,13,299923
3385,0.002337,74.125.24.0-255,9992,203891,13,299923
3386,0.002341,172.31.36.0-255,66,203957,13,299923
3387,0.002345,74.125.24.0-255,2184,206141,13,299923
3388,0.002347,172.31.36.0-255,66,206207,13,299923
3389,0.002458,74.125.24.0-255,1484,207691,13,299923
3390,0.002462,74.125.24.0-255,1484,209175,13,299923
3391,0.002466,172.31.36.0-255,66,209241,13,299923
3392,0.002487,74.125.24.0-255,1484,210725,13,299923
3393,0.002493,74.125.24.0-255,4320,215045,13,299923
3394,0.002496,172.31.36.0-255,66,215111,13,299923
3395,0.002511,74.125.24.0-255,1484,216595,13,299923
3396,0.002545,74.125.24.0-255,8574,225169,13,299923
3397,0.002548,172.31.36.0-255,66,225235,13,299923
3398,0.002574,74.125.24.0-255,1484,226719,13,299923
3399,0.002587,172.31.36.0-255,66,226785,13,299923
3400,0.00259,74.125.24.0-255,2184,228969,13,299923
3401,0.002592,172.31.36.0-255,66,229035,13,299923
3402,0.002664,74.125.24.0-255,1484,230519,13,299923
3403,0.00267,74.125.24.0-255,2902,233421,13,299923
3404,0.002674,172.31.36.0-255,66,233487,13,299923
3405,0.002677,74.125.24.0-255,1484,234971,13,299923
3406,0.002704,74.125.24.0-255,4320,239291,13,299923
3407,0.002707,172.31.36.0-255,66,239357,13,299923
3408,0.002715,74.125.24.0-255,8574,247931,13,299923
3409,0.002717,172.31.36.0-255,66,247997,13,299923
3410,0.00274,74.125.24.0-255,4320,252317,13,299923
3411,0.002743,172.31.36.0-255,66,252383,13,299923
3412,0.002753,74.125.24.0-255,10692,263075,13,299923
3413,0.002756,172.31.36.0-255,66,263141,13,299923
3414,0.002798,74.125.24.0-255,7156,270297,13,299923
3415,0.002802,172.31.36.0-255,66,270363,13,299923
3416,0.002824,74.125.24.0-255,4320,274683,13,299923
3417,0.002828,172.31.36.0-255,66,274749,13,299923
3418,0.002844,172.31.36.0-255,66,274815,13,299923
3419,0.002858,172.31.36.0-255,66,274881,13,299923
3420,0.002871,172.31.36.0-255,66,274947,13,299923
3421,0.002896,74.125.24.0-255,2902,277849,13,299923
3422,0.0029,172.31.36.0-255,66,277915,13,299923
3423,0.002907,74.125.24.0-255,8574,286489,13,299923
3424,0.00291,172.31.36.0-255,66,286555,13,299923
3425,0.002942,74.125.24.0-255,3602,290157,13,299923
3426,0.002944,172.31.36.0-255,66,290223,13,299923
3427,0.002957,172.31.36.0-255,66,290289,13,299923
3428,0.00296,74.125.24.0-255,97,290386,13,299923
3429,0.002976,74.125.24.0-255,105,290491,13,299923
3430,0.004507,172.31.36.0-255,66,290557,13,299923
3431,0.00454,172.31.36.0-255,105,290662,13,299923
3432,0.00685,74.125.24.0-255,66,290728,13,299923
3433,0.030876,172.31.36.0-255,172,290900,13,299923
3434,0.030931,172.31.36.0-255,1109,292009,13,299923
3435,0.031013,172.31.36.0-255,1514,293523,13,299923
3436,0.031015,172.31.36.0-255,1514,295037,13,299923
3437,0.031016,172.31.36.0-255,1514,296551,13,299923
3438,0.031022,172.31.36.0-255,1514,298065,13,299923
3439,0.031023,172.31.36.0-255,1514,299579,13,299923
3440,0.031024,172.31.36.0-255,80,299659,13,299923
3441,0.032381,104.244.42.0-255,66,299725,13,299923
3442,0.032476,104.244.42.0-255,66,299791,13,299923
3443,0.032589,104.244.42.0-255,66,299857,13,299923
3444,0.032594,104.244.42.0-255,66,299923,13,299923
3445,0.0,172.217.160.0-255,153,153,13,375410
3446,3.3e-05,172.31.36.0-255,66,219,13,375410
3447,3.9e-05,172.217.160.0-255,1484,1703,13,375410
3448,4.3e-05,172.31.36.0-255,66,1769,13,375410
3449,4.8e-05,172.217.160.0-255,2902,4671,13,375410
3450,6e-05,172.31.36.0-255,66,4737,13,375410
3451,6.7e-05,172.217.160.0-255,7156,11893,13,375410
3452,7e-05,172.31.36.0-255,66,11959,13,375410
3453,7.4e-05,172.217.160.0-255,2020,13979,13,375410
3454,7.7e-05,172.217.160.0-255,2902,16881,13,375410
3455,7.8e-05,172.31.36.0-255,66,16947,13,375410
3456,8.3e-05,172.31.36.0-255,66,17013,13,375410
3457,0.000127,172.217.160.0-255,7156,24169,13,375410
3458,0.000131,172.31.36.0-255,66,24235,13,375410
3459,0.000135,172.217.160.0-255,1484,25719,13,375410
3460,0.000138,172.31.36.0-255,66,25785,13,375410
3461,0.000168,172.217.160.0-255,5379,31164,13,375410
3462,0.000172,172.31.36.0-255,66,31230,13,375410
3463,0.000361,172.217.160.0-255,1484,32714,13,375410
3464,0.000366,172.31.36.0-255,66,32780,13,375410
3465,0.000385,172.217.160.0-255,2902,35682,13,375410
3466,0.000389,172.31.36.0-255,66,35748,13,375410
3467,0.000396,172.217.160.0-255,5738,41486,13,375410
3468,0.000399,172.31.36.0-255,66,41552,13,375410
3469,0.000425,172.217.160.0-255,4320,45872,13,375410
3470,0.000431,172.31.36.0-255,66,45938,13,375410
3471,0.000448,172.217.160.0-255,2543,48481,13,375410
3472,0.000454,172.217.160.0-255,5738,54219,13,375410
3473,0.000455,172.31.36.0-255,66,54285,13,375410
3474,0.000458,172.31.36.0-255,66,54351,13,375410
3475,0.000488,172.217.160.0-255,1484,55835,13,375410
3476,0.000491,172.31.36.0-255,66,55901,13,375410
3477,0.000502,172.217.160.0-255,9633,65534,13,375410
3478,0.000506,172.31.36.0-255,66,65600,13,375410
3479,0.000517,172.217.160.0-255,373,65973,13,375410
3480,0.000787,172.31.36.0-255,66,66039,13,375410
3481,0.001105,172.217.160.0-255,370,66409,13,375410
3482,0.001213,172.217.160.0-255,1484,67893,13,375410
3483,0.001219,172.217.160.0-255,2902,70795,13,375410
3484,0.001225,172.217.160.0-255,4320,75115,13,375410
3485,0.001237,172.217.160.0-255,1484,76599,13,375410
3486,0.00126,172.217.160.0-255,6797,83396,13,375410
3487,0.001307,172.217.160.0-255,2902,86298,13,375410
3488,0.001313,172.217.160.0-255,4320,90618,13,375410
3489,0.00132,172.217.160.0-255,7156,97774,13,375410
3490,0.001335,172.217.160.0-255,1484,99258,13,375410
3491,0.001337,172.217.160.0-255,1125,100383,13,375410
3492,0.001467,172.217.160.0-255,1484,101867,13,375410
3493,0.001474,172.217.160.0-255,2902,104769,13,375410
3494,0.001478,172.217.160.0-255,4320,109089,13,375410
3495,0.001493,172.217.160.0-255,1484,110573,13,375410
3496,0.001501,172.217.160.0-255,7156,117729,13,375410
3497,0.001527,172.217.160.0-255,8574,126303,13,375410
3498,0.001541,172.217.160.0-255,5738,132041,13,375410
3499,0.00156,172.217.160.0-255,2184,134225,13,375410
3500,0.001592,172.217.160.0-255,1484,135709,13,375410
3501,0.001618,172.217.160.0-255,2902,138611,13,375410
3502,0.001624,172.217.160.0-255,5738,144349,13,375410
3503,0.00165,172.217.160.0-255,9992,154341,13,375410
3504,0.001672,172.217.160.0-255,2902,157243,13,375410
3505,0.001679,172.217.160.0-255,8574,165817,13,375410
3506,0.001705,172.217.160.0-255,2184,168001,13,375410
3507,0.001811,172.217.160.0-255,1484,169485,13,375410
3508,0.001825,172.217.160.0-255,1484,170969,13,375410
3509,0.001835,172.217.160.0-255,1484,172453,13,375410
3510,0.001841,172.217.160.0-255,5738,178191,13,375410
3511,0.001843,172.217.160.0-255,1484,179675,13,375410
3512,0.001881,172.217.160.0-255,4320,183995,13,375410
3513,0.001896,172.217.160.0-255,4320,188315,13,375410
3514,0.001948,172.217.160.0-255,1635,189950,13,375410
3515,0.005917,172.31.36.0-255,66,190016,13,375410
3516,0.007836,172.217.160.0-255,5738,195754,13,375410
3517,0.007847,172.31.36.0-255,66,195820,13,375410
3518,0.009757,172.217.160.0-255,5738,201558,13,375410
3519,0.009767,172.31.36.0-255,66,201624,13,375410
3520,0.011665,172.217.160.0-255,5738,207362,13,375410
3521,0.011677,172.31.36.0-255,66,207428,13,375410
3522,0.01358,172.217.160.0-255,5738,213166,13,375410
3523,0.013587,172.31.36.0-255,66,213232,13,375410
3524,0.015491,172.217.160.0-255,5738,218970,13,375410
3525,0.015498,172.31.36.0-255,66,219036,13,375410
3526,0.017411,172.217.160.0-255,5738,224774,13,375410
3527,0.017423,172.31.36.0-255,66,224840,13,375410
3528,0.019341,172.217.160.0-255,5738,230578,13,375410
3529,0.019349,172.31.36.0-255,66,230644,13,375410
3530,0.021251,172.217.160.0-255,5738,236382,13,375410
3531,0.02126,172.31.36.0-255,66,236448,13,375410
3532,0.023179,172.217.160.0-255,5738,242186,13,375410
3533,0.023186,172.31.36.0-255,66,242252,13,375410
3534,0.025114,172.217.160.0-255,5738,247990,13,375410
3535,0.025123,172.31.36.0-255,66,248056,13,375410
3536,0.027023,172.217.160.0-255,5738,253794,13,375410
3537,0.02703,172.31.36.0-255,66,253860,13,375410
3538,0.028928,172.217.160.0-255,5738,259598,13,375410
3539,0.028936,172.31.36.0-255,66,259664,13,375410
3540,0.030845,172.217.160.0-255,5738,265402,13,375410
3541,0.030852,172.31.36.0-255,66,265468,13,375410
3542,0.031384,172.31.36.0-255,176,265644,13,375410
3543,0.031412,172.31.36.0-255,1106,266750,13,375410
3544,0.031449,172.31.36.0-255,1514,268264,13,375410
3545,0.031451,172.31.36.0-255,1299,269563,13,375410
3546,0.032763,172.217.160.0-255,5738,275301,13,375410
3547,0.032769,172.31.36.0-255,66,275367,13,375410
3548,0.032908,104.244.42.0-255,66,275433,13,375410
3549,0.032944,104.244.42.0-255,66,275499,13,375410
3550,0.033017,104.244.42.0-255,66,275565,13,375410
3551,0.03467,172.217.160.0-255,5738,281303,13,375410
3552,0.034676,172.31.36.0-255,66,281369,13,375410
3553,0.036579,172.217.160.0-255,4320,285689,13,375410
3554,0.036584,172.31.36.0-255,66,285755,13,375410
3555,0.036621,172.217.160.0-255,1484,287239,13,375410
3556,0.038489,172.217.160.0-255,4320,291559,13,375410
3557,0.038494,172.31.36.0-255,66,291625,13,375410
3558,0.040386,172.217.160.0-255,5738,297363,13,375410
3559,0.040442,172.31.36.0-255,66,297429,13,375410
3560,0.042334,172.217.160.0-255,5738,303167,13,375410
3561,0.04234,172.31.36.0-255,66,303233,13,375410
3562,0.044233,172.217.160.0-255,5738,308971,13,375410
3563,0.044238,172.31.36.0-255,66,309037,13,375410
3564,0.046135,172.217.160.0-255,5738,314775,13,375410
3565,0.046141,172.31.36.0-255,66,314841,13,375410
3566,0.048033,172.217.160.0-255,5738,320579,13,375410
3567,0.048039,172.31.36.0-255,66,320645,13,375410
3568,0.049942,172.217.160.0-255,5738,326383,13,375410
3569,0.049948,172.31.36.0-255,66,326449,13,375410
3570,0.05186,172.217.160.0-255,5738,332187,13,375410
3571,0.051866,172.31.36.0-255,66,332253,13,375410
3572,0.053766,172.217.160.0-255,5738,337991,13,375410
3573,0.053771,172.31.36.0-255,66,338057,13,375410
3574,0.055665,172.217.160.0-255,5738,343795,13,375410
3575,0.05567,172.31.36.0-255,66,343861,13,375410
3576,0.057555,172.217.160.0-255,5738,349599,13,375410
3577,0.05756,172.31.36.0-255,66,349665,13,375410
3578,0.059454,172.217.160.0-255,5738,355403,13,375410
3579,0.059459,172.31.36.0-255,66,355469,13,375410
3580,0.061353,172.217.160.0-255,5738,361207,13,375410
3581,0.061358,172.31.36.0-255,66,361273,13,375410
3582,0.063262,172.217.160.0-255,5738,367011,13,375410
3583,0.063267,172.31.36.0-255,66,367077,13,375410
3584,0.06516,172.217.160.0-255,5738,372815,13,375410
3585,0.065166,172.31.36.0-255,66,372881,13,375410
3586,0.067055,172.217.160.0-255,2292,375173,13,375410
3587,0.067062,172.31.36.0-255,66,375239,13,375410
3588,0.067434,172.31.36.0-255,105,375344,13,375410
3589,0.069301,172.217.160.0-255,66,375410,13,375410
3590,0.0,74.125.24.0-255,155,155,13,351189
3591,3.6e-05,172.31.36.0-255,66,221,13,351189
3592,4.3e-05,74.125.24.0-255,1484,1705,13,351189
3593,4.7e-05,172.31.36.0-255,66,1771,13,351189
3594,5.2e-05,74.125.24.0-255,2902,4673,13,351189
3595,5.5e-05,172.31.36.0-255,66,4739,13,351189
3596,6.1e-05,74.125.24.0-255,5738,10477,13,351189
3597,6.4e-05,172.31.36.0-255,66,10543,13,351189
3598,7.7e-05,74.125.24.0-255,1484,12027,13,351189
3599,7.9e-05,172.31.36.0-255,66,12093,13,351189
3600,9.5e-05,74.125.24.0-255,7156,19249,13,351189
3601,9.7e-05,172.31.36.0-255,66,19315,13,351189
3602,0.000116,74.125.24.0-255,4886,24201,13,351189
3603,0.000118,172.31.36.0-255,66,24267,13,351189
3604,0.000121,74.125.24.0-255,1484,25751,13,351189
3605,0.000123,172.31.36.0-255,66,25817,13,351189
3606,0.00015,74.125.24.0-255,5379,31196,13,351189
3607,0.000152,172.31.36.0-255,66,31262,13,351189
3608,0.000784,74.125.24.0-255,1484,32746,13,351189
3609,0.00079,172.31.36.0-255,66,32812,13,351189
3610,0.000801,74.125.24.0-255,2902,35714,13,351189
3611,0.000804,172.31.36.0-255,66,35780,13,351189
3612,0.00081,74.125.24.0-255,5738,41518,13,351189
3613,0.000812,172.31.36.0-255,66,41584,13,351189
3614,0.000834,74.125.24.0-255,1484,43068,13,351189
3615,0.000837,172.31.36.0-255,66,43134,13,351189
3616,0.000892,172.31.36.0-255,66,43200,13,351189
3617,0.000899,74.125.24.0-255,7156,50356,13,351189
3618,0.000902,172.31.36.0-255,66,50422,13,351189
3619,0.000916,74.125.24.0-255,2883,53305,13,351189
3620,0.00092,172.31.36.0-255,66,53371,13,351189
3621,0.000952,74.125.24.0-255,1484,54855,13,351189
3622,0.000958,74.125.24.0-255,2902,57757,13,351189
3623,0.000962,172.31.36.0-255,66,57823,13,351189
3624,0.000965,74.125.24.0-255,1484,59307,13,351189
3625,0.000981,74.125.24.0-255,4320,63627,13,351189
3626,0.000985,172.31.36.0-255,66,63693,13,351189
3627,0.000991,74.125.24.0-255,5738,69431,13,351189
3628,0.000993,172.31.36.0-255,66,69497,13,351189
3629,0.001018,74.125.24.0-255,4320,73817,13,351189
3630,0.001021,172.31.36.0-255,66,73883,13,351189
3631,0.001055,74.125.24.0-255,9633,83516,13,351189
3632,0.001058,172.31.36.0-255,66,83582,13,351189
3633,0.001063,74.125.24.0-255,3961,87543,13,351189
3634,0.001066,172.31.36.0-255,66,87609,13,351189
3635,0.001142,74.125.24.0-255,1484,89093,13,351189
3636,0.001149,74.125.24.0-255,2902,91995,13,351189
3637,0.001153,172.31.36.0-255,66,92061,13,351189
3638,0.001158,74.125.24.0-255,2902,94963,13,351189
3639,0.00116,172.31.36.0-255,66,95029,13,351189
3640,0.00118,74.125.24.0-255,2902,97931,13,351189
3641,0.001182,172.31.36.0-255,66,97997,13,351189
3642,0.001189,74.125.24.0-255,5738,103735,13,351189
3643,0.001191,172.31.36.0-255,66,103801,13,351189
3644,0.001231,74.125.24.0-255,7156,110957,13,351189
3645,0.001236,172.31.36.0-255,66,111023,13,351189
3646,0.001243,74.125.24.0-255,8574,119597,13,351189
3647,0.001245,172.31.36.0-255,66,119663,13,351189
3648,0.001249,74.125.24.0-255,2184,121847,13,351189
3649,0.001251,172.31.36.0-255,66,121913,13,351189
3650,0.001324,74.125.24.0-255,1484,123397,13,351189
3651,0.001339,74.125.24.0-255,2902,126299,13,351189
3652,0.001343,172.31.36.0-255,66,126365,13,351189
3653,0.001358,74.125.24.0-255,5738,132103,13,351189
3654,0.001361,172.31.36.0-255,66,132169,13,351189
3655,0.001365,74.125.24.0-255,2902,135071,13,351189
3656,0.001366,172.31.36.0-255,66,135137,13,351189
3657,0.00139,74.125.24.0-255,9992,145129,13,351189
3658,0.001392,172.31.36.0-255,66,145195,13,351189
3659,0.001395,74.125.24.0-255,1484,146679,13,351189
3660,0.001423,74.125.24.0-255,9274,155953,13,351189
3661,0.001426,172.31.36.0-255,66,156019,13,351189
3662,0.001501,74.125.24.0-255,8574,164593,13,351189
3663,0.001504,172.31.36.0-255,66,164659,13,351189
3664,0.001527,172.31.36.0-255,66,164725,13,351189
3665,0.00154,172.31.36.0-255,66,164791,13,351189
3666,0.001554,74.125.24.0-255,1484,166275,13,351189
3667,0.001556,74.125.24.0-255,1484,167759,13,351189
3668,0.00156,172.31.36.0-255,66,167825,13,351189
3669,0.001567,74.125.24.0-255,1484,169309,13,351189
3670,0.001586,74.125.24.0-255,5738,175047,13,351189
3671,0.001588,172.31.36.0-255,66,175113,13,351189
3672,0.001611,74.125.24.0-255,5738,180851,13,351189
3673,0.001614,172.31.36.0-255,66,180917,13,351189
3674,0.001632,74.125.24.0-255,1484,182401,13,351189
3675,0.001638,74.125.24.0-255,4320,186721,13,351189
3676,0.001643,172.31.36.0-255,66,186787,13,351189
3677,0.001671,74.125.24.0-255,9992,196779,13,351189
3678,0.001673,172.31.36.0-255,66,196845,13,351189
3679,0.001678,74.125.24.0-255,2184,199029,13,351189
3680,0.001679,172.31.36.0-255,66,199095,13,351189
3681,0.001911,74.125.24.0-255,1484,200579,13,351189
3682,0.001929,74.125.24.0-255,2902,203481,13,351189
3683,0.001934,172.31.36.0-255,66,203547,13,351189
3684,0.001956,74.125.24.0-255,5738,209285,13,351189
3685,0.001958,172.31.36.0-255,66,209351,13,351189
3686,0.001962,74.125.24.0-255,2902,212253,13,351189
3687,0.001964,172.31.36.0-255,66,212319,13,351189
3688,0.001992,74.125.24.0-255,2615,214934,13,351189
3689,0.001995,172.31.36.0-255,66,215000,13,351189
3690,0.002006,74.125.24.0-255,5738,220738,13,351189
3691,0.002008,172.31.36.0-255,66,220804,13,351189
3692,0.002015,74.125.24.0-255,7156,227960,13,351189
3693,0.002017,172.31.36.0-255,66,228026,13,351189
3694,0.002042,74.125.24.0-255,1484,229510,13,351189
3695,0.002051,74.125.24.0-255,9992,239502,13,351189
3696,0.002054,172.31.36.0-255,66,239568,13,351189
3697,0.00208,74.125.24.0-255,9274,248842,13,351189
3698,0.002082,172.31.36.0-255,66,248908,13,351189
3699,0.003571,172.31.36.0-255,101,249009,13,351189
3700,0.004633,74.125.24.0-255,5738,254747,13,351189
3701,0.004637,172.31.36.0-255,66,254813,13,351189
3702,0.006081,74.125.24.0-255,66,254879,13,351189
3703,0.007171,74.125.24.0-255,5738,260617,13,351189
3704,0.007178,172.31.36.0-255,66,260683,13,351189
3705,0.009715,74.125.24.0-255,5738,266421,13,351189
3706,0.009724,172.31.36.0-255,66,266487,13,351189
3707,0.012243,74.125.24.0-255,5738,272225,13,351189
3708,0.012251,172.31.36.0-255,66,272291,13,351189
3709,0.014814,74.125.24.0-255,5738,278029,13,351189
3710,0.014822,172.31.36.0-255,66,278095,13,351189
3711,0.017388,74.125.24.0-255,5738,283833,13,351189
3712,0.017394,172.31.36.0-255,66,283899,13,351189
3713,0.019926,74.125.24.0-255,5738,289637,13,351189
3714,0.019938,172.31.36.0-255,66,289703,13,351189
3715,0.022468,74.125.24.0-255,5738,295441,13,351189
3716,0.022478,172.31.36.0-255,66,295507,13,351189
3717,0.025001,74.125.24.0-255,5738,301245,13,351189
3718,0.02501,172.31.36.0-255,66,301311,13,351189
3719,0.027564,74.125.24.0-255,5738,307049,13,351189
3720,0.027569,172.31.36.0-255,66,307115,13,351189
3721,0.029261,172.31.36.0-255,172,307287,13,351189
3722,0.029304,172.31.36.0-255,1106,308393,13,351189
3723,0.029378,172.31.36.0-255,1514,309907,13,351189
3724,0.02938,172.31.36.0-255,1299,311206,13,351189
3725,0.030173,74.125.24.0-255,5738,316944,13,351189
3726,0.03018,172.31.36.0-255,66,317010,13,351189
3727,0.030783,104.244.42.0-255,66,317076,13,351189
3728,0.03083,104.244.42.0-255,66,317142,13,351189
3729,0.03094,104.244.42.0-255,66,317208,13,351189
3730,0.032728,74.125.24.0-255,2902,320110,13,351189
3731,0.032732,172.31.36.0-255,66,320176,13,351189
3732,0.032797,74.125.24.0-255,2902,323078,13,351189
3733,0.032802,172.31.36.0-255,66,323144,13,351189
3734,0.03528,74.125.24.0-255,2902,326046,13,351189
3735,0.035285,172.31.36.0-255,66,326112,13,351189
3736,0.035378,74.125.24.0-255,2902,329014,13,351189
3737,0.035383,172.31.36.0-255,66,329080,13,351189
3738,0.037799,74.125.24.0-255,2902,331982,13,351189
3739,0.037805,172.31.36.0-255,66,332048,13,351189
3740,0.037924,74.125.24.0-255,1484,333532,13,351189
3741,0.037939,74.125.24.0-255,1484,335016,13,351189
3742,0.037944,172.31.36.0-255,66,335082,13,351189
3743,0.040357,74.125.24.0-255,2902,337984,13,351189
3744,0.040363,172.31.36.0-255,66,338050,13,351189
3745,0.040486,74.125.24.0-255,2902,340952,13,351189
3746,0.040492,172.31.36.0-255,66,341018,13,351189
3747,0.042893,74.125.24.0-255,2902,343920,13,351189
3748,0.042899,172.31.36.0-255,66,343986,13,351189
3749,0.043029,74.125.24.0-255,2902,346888,13,351189
3750,0.043035,172.31.36.0-255,66,346954,13,351189
3751,0.04543,74.125.24.0-255,2902,349856,13,351189
3752,0.045436,172.31.36.0-255,66,349922,13,351189
3753,0.045567,74.125.24.0-255,703,350625,13,351189
3754,0.045927,172.31.36.0-255,105,350730,13,351189
3755,0.045952,172.31.36.0-255,105,350835,13,351189
3756,0.046198,172.31.36.0-255,90,350925,13,351189
3757,0.046209,172.31.36.0-255,66,350991,13,351189
3758,0.048464,74.125.24.0-255,66,351057,13,351189
3759,0.048777,74.125.24.0-255,66,351123,13,351189
3760,0.048782,172.31.36.0-255,66,351189,13,351189
3761,0.0,172.31.36.0-255,105,105,13,459
3762,0.000236,172.31.36.0-255,90,195,13,459
3763,0.000247,172.31.36.0-255,66,261,13,459
3764,0.002302,74.125.68.0-255,66,327,13,459
3765,0.002332,74.125.68.0-255,66,393,13,459
3766,0.002355,172.31.36.0-255,66,459,13,459
3767,0.0,172.217.27.0-255,150,150,13,377168
3768,3.4e-05,172.31.36.0-255,66,216,13,377168
3769,4.2e-05,172.217.27.0-255,1484,1700,13,377168
3770,4.6e-05,172.31.36.0-255,66,1766,13,377168
3771,5.2e-05,172.217.27.0-255,2902,4668,13,377168
3772,6.2e-05,172.31.36.0-255,66,4734,13,377168
3773,6.8e-05,172.217.27.0-255,5738,10472,13,377168
3774,7e-05,172.31.36.0-255,66,10538,13,377168
3775,8.8e-05,172.217.27.0-255,7156,17694,13,377168
3776,9.1e-05,172.31.36.0-255,66,17760,13,377168
3777,0.00012,172.217.27.0-255,3465,21225,13,377168
3778,0.000123,172.31.36.0-255,66,21291,13,377168
3779,0.000153,172.217.27.0-255,9633,30924,13,377168
3780,0.000156,172.31.36.0-255,66,30990,13,377168
3781,0.000194,172.217.27.0-255,1484,32474,13,377168
3782,0.000197,172.31.36.0-255,66,32540,13,377168
3783,0.000223,172.217.27.0-255,2902,35442,13,377168
3784,0.000226,172.31.36.0-255,66,35508,13,377168
3785,0.000233,172.217.27.0-255,5738,41246,13,377168
3786,0.000235,172.31.36.0-255,66,41312,13,377168
3787,0.000239,172.217.27.0-255,2902,44214,13,377168
3788,0.000242,172.31.36.0-255,66,44280,13,377168
3789,0.000273,172.217.27.0-255,7156,51436,13,377168
3790,0.000277,172.31.36.0-255,66,51502,13,377168
3791,0.000313,172.31.36.0-255,66,51568,13,377168
3792,0.000317,172.217.27.0-255,2471,54039,13,377168
3793,0.00032,172.31.36.0-255,66,54105,13,377168
3794,0.000876,172.217.27.0-255,140,54245,13,377168
3795,0.000882,172.31.36.0-255,66,54311,13,377168
3796,0.00112,172.217.27.0-255,1484,55795,13,377168
3797,0.001126,172.31.36.0-255,66,55861,13,377168
3798,0.001135,172.217.27.0-255,2902,58763,13,377168
3799,0.001144,172.31.36.0-255,66,58829,13,377168
3800,0.001148,172.217.27.0-255,1484,60313,13,377168
3801,0.001178,172.217.27.0-255,4320,64633,13,377168
3802,0.001182,172.31.36.0-255,66,64699,13,377168
3803,0.001188,172.217.27.0-255,5738,70437,13,377168
3804,0.001191,172.31.36.0-255,66,70503,13,377168
3805,0.001197,172.217.27.0-255,7156,77659,13,377168
3806,0.001199,172.31.36.0-255,66,77725,13,377168
3807,0.001208,172.217.27.0-255,10692,88417,13,377168
3808,0.001211,172.31.36.0-255,66,88483,13,377168
3809,0.002871,172.217.27.0-255,5738,94221,13,377168
3810,0.002877,172.31.36.0-255,66,94287,13,377168
3811,0.004543,172.217.27.0-255,5738,100025,13,377168
3812,0.004549,172.31.36.0-255,66,100091,13,377168
3813,0.006212,172.217.27.0-255,2902,102993,13,377168
3814,0.006217,172.31.36.0-255,66,103059,13,377168
3815,0.006243,172.217.27.0-255,2902,105961,13,377168
3816,0.006246,172.31.36.0-255,66,106027,13,377168
3817,0.007887,172.217.27.0-255,2902,108929,13,377168
3818,0.007894,172.31.36.0-255,66,108995,13,377168
3819,0.007925,172.217.27.0-255,2902,111897,13,377168
3820,0.007928,172.31.36.0-255,66,111963,13,377168
3821,0.009556,172.217.27.0-255,2902,114865,13,377168
3822,0.009564,172.31.36.0-255,66,114931,13,377168
3823,0.009599,172.217.27.0-255,2902,117833,13,377168
3824,0.009603,172.31.36.0-255,66,117899,13,377168
3825,0.011243,172.217.27.0-255,2902,120801,13,377168
3826,0.01125,172.31.36.0-255,66,120867,13,377168
3827,0.011284,172.217.27.0-255,2902,123769,13,377168
3828,0.011289,172.31.36.0-255,66,123835,13,377168
3829,0.012933,172.217.27.0-255,2902,126737,13,377168
3830,0.01294,172.31.36.0-255,66,126803,13,377168
3831,0.012971,172.217.27.0-255,2902,129705,13,377168
3832,0.012976,172.31.36.0-255,66,129771,13,377168
3833,0.014598,172.217.27.0-255,2902,132673,13,377168
3834,0.014604,172.31.36.0-255,66,132739,13,377168
3835,0.014627,172.217.27.0-255,1484,134223,13,377168
3836,0.014645,172.217.27.0-255,1484,135707,13,377168
3837,0.014647,172.31.36.0-255,66,135773,13,377168
3838,0.016268,172.217.27.0-255,2902,138675,13,377168
3839,0.016274,172.31.36.0-255,66,138741,13,377168
3840,0.016335,172.217.27.0-255,2902,141643,13,377168
3841,0.016337,172.31.36.0-255,66,141709,13,377168
3842,0.01794,172.217.27.0-255,2902,144611,13,377168
3843,0.017948,172.31.36.0-255,66,144677,13,377168
3844,0.017992,172.217.27.0-255,2902,147579,13,377168
3845,0.017997,172.31.36.0-255,66,147645,13,377168
3846,0.019615,172.217.27.0-255,2902,150547,13,377168
3847,0.019623,172.31.36.0-255,66,150613,13,377168
3848,0.019651,172.217.27.0-255,2902,153515,13,377168
3849,0.019653,172.31.36.0-255,66,153581,13,377168
3850,0.021289,172.217.27.0-255,2902,156483,13,377168
3851,0.021297,172.31.36.0-255,66,156549,13,377168
3852,0.021329,172.217.27.0-255,2902,159451,13,377168
3853,0.021333,172.31.36.0-255,66,159517,13,377168
3854,0.022968,172.217.27.0-255,2902,162419,13,377168
3855,0.022978,172.31.36.0-255,66,162485,13,377168
3856,0.023012,172.217.27.0-255,2902,165387,13,377168
3857,0.023016,172.31.36.0-255,66,165453,13,377168
3858,0.024676,172.217.27.0-255,5738,171191,13,377168
3859,0.024683,172.31.36.0-255,66,171257,13,377168
3860,0.025657,172.31.36.0-255,172,171429,13,377168
3861,0.025691,172.31.36.0-255,1106,172535,13,377168
3862,0.025746,172.31.36.0-255,1514,174049,13,377168
3863,0.025748,172.31.36.0-255,1299,175348,13,377168
3864,0.026359,172.217.27.0-255,5738,181086,13,377168
3865,0.026365,172.31.36.0-255,66,181152,13,377168
3866,0.027223,104.244.42.0-255,66,181218,13,377168
3867,0.027252,104.244.42.0-255,66,181284,13,377168
3868,0.027307,104.244.42.0-255,66,181350,13,377168
3869,0.028042,172.217.27.0-255,4320,185670,13,377168
3870,0.028047,172.31.36.0-255,66,185736,13,377168
3871,0.028074,172.217.27.0-255,1484,187220,13,377168
3872,0.029724,172.217.27.0-255,4320,191540,13,377168
3873,0.029731,172.31.36.0-255,66,191606,13,377168
3874,0.031406,172.217.27.0-255,5738,197344,13,377168
3875,0.031412,172.31.36.0-255,66,197410,13,377168
3876,0.033095,172.217.27.0-255,5738,203148,13,377168
3877,0.033102,172.31.36.0-255,66,203214,13,377168
3878,0.034793,172.217.27.0-255,5738,208952,13,377168
3879,0.0348,172.31.36.0-255,66,209018,13,377168
3880,0.036482,172.217.27.0-255,5738,214756,13,377168
3881,0.036488,172.31.36.0-255,66,214822,13,377168
3882,0.038175,172.217.27.0-255,5738,220560,13,377168
3883,0.038181,172.31.36.0-255,66,220626,13,377168
3884,0.039886,172.217.27.0-255,5738,226364,13,377168
3885,0.039893,172.31.36.0-255,66,226430,13,377168
3886,0.041599,172.217.27.0-255,5738,232168,13,377168
3887,0.041605,172.31.36.0-255,66,232234,13,377168
3888,0.043299,172.217.27.0-255,5738,237972,13,377168
3889,0.043305,172.31.36.0-255,66,238038,13,377168
3890,0.045016,172.217.27.0-255,5738,243776,13,377168
3891,0.045022,172.31.36.0-255,66,243842,13,377168
3892,0.046694,172.217.27.0-255,5738,249580,13,377168
3893,0.046701,172.31.36.0-255,66,249646,13,377168
3894,0.048371,172.217.27.0-255,5738,255384,13,377168
3895,0.048378,172.31.36.0-255,66,255450,13,377168
3896,0.050075,172.217.27.0-255,5738,261188,13,377168
3897,0.050082,172.31.36.0-255,66,261254,13,377168
3898,0.051764,172.217.27.0-255,5738,266992,13,377168
3899,0.051771,172.31.36.0-255,66,267058,13,377168
3900,0.05345,172.217.27.0-255,5738,272796,13,377168
3901,0.053456,172.31.36.0-255,66,272862,13,377168
3902,0.05517,172.217.27.0-255,5738,278600,13,377168
3903,0.055177,172.31.36.0-255,66,278666,13,377168
3904,0.056852,172.217.27.0-255,5738,284404,13,377168
3905,0.056858,172.31.36.0-255,66,284470,13,377168
3906,0.058538,172.217.27.0-255,5738,290208,13,377168
3907,0.058545,172.31.36.0-255,66,290274,13,377168
3908,0.060238,172.217.27.0-255,5738,296012,13,377168
3909,0.060245,172.31.36.0-255,66,296078,13,377168
3910,0.061944,172.217.27.0-255,5738,301816,13,377168
3911,0.061951,172.31.36.0-255,66,301882,13,377168
3912,0.063636,172.217.27.0-255,5738,307620,13,377168
3913,0.063642,172.31.36.0-255,66,307686,13,377168
3914,0.065313,172.217.27.0-255,5738,313424,13,377168
3915,0.065324,172.31.36.0-255,66,313490,13,377168
3916,0.067004,172.217.27.0-255,5738,319228,13,377168
3917,0.06701,172.31.36.0-255,66,319294,13,377168
3918,0.068687,172.217.27.0-255,5738,325032,13,377168
3919,0.068694,172.31.36.0-255,66,325098,13,377168
3920,0.070405,172.217.27.0-255,5738,330836,13,377168
3921,0.070411,172.31.36.0-255,66,330902,13,377168
3922,0.072091,172.217.27.0-255,5738,336640,13,377168
3923,0.072097,172.31.36.0-255,66,336706,13,377168
3924,0.073775,172.217.27.0-255,5738,342444,13,377168
3925,0.073782,172.31.36.0-255,66,342510,13,377168
3926,0.075456,172.217.27.0-255,5738,348248,13,377168
3927,0.075463,172.31.36.0-255,66,348314,13,377168
3928,0.077136,172.217.27.0-255,5738,354052,13,377168
3929,0.077144,172.31.36.0-255,66,354118,13,377168
3930,0.078835,172.217.27.0-255,5738,359856,13,377168
3931,0.078842,172.31.36.0-255,66,359922,13,377168
3932,0.080517,172.217.27.0-255,5738,365660,13,377168
3933,0.080524,172.31.36.0-255,66,365726,13,377168
3934,0.082202,172.217.27.0-255,5738,371464,13,377168
3935,0.082208,172.31.36.0-255,66,371530,13,377168
3936,0.083896,172.217.27.0-255,5401,376931,13,377168
3937,0.083903,172.31.36.0-255,66,376997,13,377168
3938,0.084087,172.31.36.0-255,105,377102,13,377168
3939,0.085721,172.217.27.0-255,66,377168,13,377168
3940,0.0,74.125.130.0-255,150,150,13,381972
3941,2.2e-05,172.31.36.0-255,66,216,13,381972
3942,2.9e-05,74.125.130.0-255,1484,1700,13,381972
3943,3.2e-05,172.31.36.0-255,66,1766,13,381972
3944,5.9e-05,74.125.130.0-255,1484,3250,13,381972
3945,6.1e-05,172.31.36.0-255,66,3316,13,381972
3946,8.4e-05,74.125.130.0-255,2902,6218,13,381972
3947,8.7e-05,172.31.36.0-255,66,6284,13,381972
3948,0.000102,74.125.130.0-255,2902,9186,13,381972
3949,0.000104,172.31.36.0-255,66,9252,13,381972
3950,0.00013,74.125.130.0-255,4320,13572,13,381972
3951,0.000132,172.31.36.0-255,66,13638,13,381972
3952,0.000135,74.125.130.0-255,664,14302,13,381972
3953,0.000137,172.31.36.0-255,66,14368,13,381972
3954,0.000314,74.125.130.0-255,1484,15852,13,381972
3955,0.000318,172.31.36.0-255,66,15918,13,381972
3956,0.000324,74.125.130.0-255,2902,18820,13,381972
3957,0.000326,172.31.36.0-255,66,18886,13,381972
3958,0.000329,74.125.130.0-255,1484,20370,13,381972
3959,0.000332,172.31.36.0-255,66,20436,13,381972
3960,0.000358,74.125.130.0-255,2902,23338,13,381972
3961,0.000361,172.31.36.0-255,66,23404,13,381972
3962,0.000365,74.125.130.0-255,2902,26306,13,381972
3963,0.000367,172.31.36.0-255,66,26372,13,381972
3964,0.000381,74.125.130.0-255,2902,29274,13,381972
3965,0.000384,172.31.36.0-255,66,29340,13,381972
3966,0.000398,74.125.130.0-255,1484,30824,13,381972
3967,0.0004,172.31.36.0-255,66,30890,13,381972
3968,0.000413,74.125.130.0-255,2543,33433,13,381972
3969,0.000415,172.31.36.0-255,66,33499,13,381972
3970,0.00042,74.125.130.0-255,4320,37819,13,381972
3971,0.000423,172.31.36.0-255,66,37885,13,381972
3972,0.00044,74.125.130.0-255,1484,39369,13,381972
3973,0.000454,74.125.130.0-255,4320,43689,13,381972
3974,0.000457,172.31.36.0-255,66,43755,13,381972
3975,0.000506,74.125.130.0-255,7156,50911,13,381972
3976,0.000509,172.31.36.0-255,66,50977,13,381972
3977,0.000514,74.125.130.0-255,4320,55297,13,381972
3978,0.000516,172.31.36.0-255,66,55363,13,381972
3979,0.000522,74.125.130.0-255,5738,61101,13,381972
3980,0.000524,172.31.36.0-255,66,61167,13,381972
3981,0.000564,74.125.130.0-255,2902,64069,13,381972
3982,0.000567,172.31.36.0-255,66,64135,13,381972
3983,0.000609,74.125.130.0-255,2458,66593,13,381972
3984,0.000612,74.125.130.0-255,114,66707,13,381972
3985,0.000616,172.31.36.0-255,66,66773,13,381972
3986,0.000914,74.125.130.0-255,1484,68257,13,381972
3987,0.000918,172.31.36.0-255,66,68323,13,381972
3988,0.000931,74.125.130.0-255,2902,71225,13,381972
3989,0.000933,172.31.36.0-255,66,71291,13,381972
3990,0.00096,74.125.130.0-255,5738,77029,13,381972
3991,0.000963,172.31.36.0-255,66,77095,13,381972
3992,0.000989,74.125.130.0-255,7156,84251,13,381972
3993,0.000991,172.31.36.0-255,66,84317,13,381972
3994,0.001015,74.125.130.0-255,4320,88637,13,381972
3995,0.001019,172.31.36.0-255,66,88703,13,381972
3996,0.001047,74.125.130.0-255,9992,98695,13,381972
3997,0.001049,172.31.36.0-255,66,98761,13,381972
3998,0.001053,74.125.130.0-255,2184,100945,13,381972
3999,0.001055,172.31.36.0-255,66,101011,13,381972
4000,0.001823,74.125.130.0-255,1484,102495,13,381972
4001,0.001832,74.125.130.0-255,2902,105397,13,381972
4002,0.001837,172.31.36.0-255,66,105463,13,381972
4003,0.001872,74.125.130.0-255,5738,111201,13,381972
4004,0.001876,172.31.36.0-255,66,111267,13,381972
4005,0.001883,74.125.130.0-255,5738,117005,13,381972
4006,0.001885,172.31.36.0-255,66,117071,13,381972
4007,0.001895,74.125.130.0-255,7156,124227,13,381972
4008,0.001898,172.31.36.0-255,66,124293,13,381972
4009,0.001917,74.125.130.0-255,5738,130031,13,381972
4010,0.00192,172.31.36.0-255,66,130097,13,381972
4011,0.00195,74.125.130.0-255,5020,135117,13,381972
4012,0.001954,172.31.36.0-255,66,135183,13,381972
4013,0.002026,74.125.130.0-255,1484,136667,13,381972
4014,0.002049,74.125.130.0-255,2902,139569,13,381972
4015,0.002052,172.31.36.0-255,66,139635,13,381972
4016,0.002057,74.125.130.0-255,1484,141119,13,381972
4017,0.00207,74.125.130.0-255,1484,142603,13,381972
4018,0.002071,172.31.36.0-255,66,142669,13,381972
4019,0.002077,74.125.130.0-255,4320,146989,13,381972
4020,0.002079,172.31.36.0-255,66,147055,13,381972
4021,0.002094,74.125.130.0-255,1484,148539,13,381972
4022,0.002114,74.125.130.0-255,7156,155695,13,381972
4023,0.002117,172.31.36.0-255,66,155761,13,381972
4024,0.002122,74.125.130.0-255,4320,160081,13,381972
4025,0.002124,172.31.36.0-255,66,160147,13,381972
4026,0.002139,74.125.130.0-255,1484,161631,13,381972
4027,0.002146,74.125.130.0-255,7156,168787,13,381972
4028,0.002149,172.31.36.0-255,66,168853,13,381972
4029,0.002152,74.125.130.0-255,766,169619,13,381972
4030,0.004554,74.125.130.0-255,4320,173939,13,381972
4031,0.004568,172.31.36.0-255,66,174005,13,381972
4032,0.006979,74.125.130.0-255,2902,176907,13,381972
4033,0.006986,172.31.36.0-255,66,176973,13,381972
4034,0.00701,74.125.130.0-255,2902,179875,13,381972
4035,0.007012,172.31.36.0-255,66,179941,13,381972
4036,0.009399,74.125.130.0-255,2902,182843,13,381972
4037,0.009407,172.31.36.0-255,66,182909,13,381972
4038,0.009428,74.125.130.0-255,2902,185811,13,381972
4039,0.009431,172.31.36.0-255,66,185877,13,381972
4040,0.011825,74.125.130.0-255,5738,191615,13,381972
4041,0.011833,172.31.36.0-255,66,191681,13,381972
4042,0.014383,74.125.130.0-255,5738,197419,13,381972
4043,0.014394,172.31.36.0-255,66,197485,13,381972
4044,0.016794,74.125.130.0-255,5738,203223,13,381972
4045,0.016802,172.31.36.0-255,66,203289,13,381972
4046,0.0192,74.125.130.0-255,5738,209027,13,381972
4047,0.019208,172.31.36.0-255,66,209093,13,381972
4048,0.021615,74.125.130.0-255,5738,214831,13,381972
4049,0.021625,172.31.36.0-255,66,214897,13,381972
4050,0.024038,74.125.130.0-255,5738,220635,13,381972
4051,0.024047,172.31.36.0-255,66,220701,13,381972
4052,0.026178,172.31.36.0-255,176,220877,13,381972
4053,0.026211,172.31.36.0-255,1110,221987,13,381972
4054,0.026275,172.31.36.0-255,1514,223501,13,381972
4055,0.026277,172.31.36.0-255,1514,225015,13,381972
4056,0.026279,172.31.36.0-255,1514,226529,13,381972
4057,0.02628,172.31.36.0-255,1075,227604,13,381972
4058,0.026452,74.125.130.0-255,5738,233342,13,381972
4059,0.026458,172.31.36.0-255,66,233408,13,381972
4060,0.027874,104.244.42.0-255,66,233474,13,381972
4061,0.027909,104.244.42.0-255,66,233540,13,381972
4062,0.027978,104.244.42.0-255,66,233606,13,381972
4063,0.027981,104.244.42.0-255,66,233672,13,381972
4064,0.028853,74.125.130.0-255,5738,239410,13,381972
4065,0.028861,172.31.36.0-255,66,239476,13,381972
4066,0.031255,74.125.130.0-255,4320,243796,13,381972
4067,0.031262,172.31.36.0-255,66,243862,13,381972
4068,0.031278,74.125.130.0-255,1484,245346,13,381972
4069,0.033676,74.125.130.0-255,4320,249666,13,381972
4070,0.033685,172.31.36.0-255,66,249732,13,381972
4071,0.036115,74.125.130.0-255,5738,255470,13,381972
4072,0.036122,172.31.36.0-255,66,255536,13,381972
4073,0.03853,74.125.130.0-255,5738,261274,13,381972
4074,0.038538,172.31.36.0-255,66,261340,13,381972
4075,0.040932,74.125.130.0-255,5738,267078,13,381972
4076,0.040939,172.31.36.0-255,66,267144,13,381972
4077,0.043345,74.125.130.0-255,5738,272882,13,381972
4078,0.043352,172.31.36.0-255,66,272948,13,381972
4079,0.045753,74.125.130.0-255,5738,278686,13,381972
4080,0.04576,172.31.36.0-255,66,278752,13,381972
4081,0.048176,74.125.130.0-255,4320,283072,13,381972
4082,0.048183,172.31.36.0-255,66,283138,13,381972
4083,0.048204,74.125.130.0-255,1484,284622,13,381972
4084,0.050612,74.125.130.0-255,4320,288942,13,381972
4085,0.050625,172.31.36.0-255,66,289008,13,381972
4086,0.053035,74.125.130.0-255,5738,294746,13,381972
4087,0.053042,172.31.36.0-255,66,294812,13,381972
4088,0.055446,74.125.130.0-255,2902,297714,13,381972
4089,0.055453,172.31.36.0-255,66,297780,13,381972
4090,0.055475,74.125.130.0-255,2902,300682,13,381972
4091,0.055478,172.31.36.0-255,66,300748,13,381972
4092,0.057856,74.125.130.0-255,2902,303650,13,381972
4093,0.057861,172.31.36.0-255,66,303716,13,381972
4094,0.057894,74.125.130.0-255,2902,306618,13,381972
4095,0.057898,172.31.36.0-255,66,306684,13,381972
4096,0.060242,74.125.130.0-255,2902,309586,13,381972
4097,0.060248,172.31.36.0-255,66,309652,13,381972
4098,0.060279,74.125.130.0-255,2902,312554,13,381972
4099,0.060283,172.31.36.0-255,66,312620,13,381972
4100,0.062647,74.125.130.0-255,2902,315522,13,381972
4101,0.062653,172.31.36.0-255,66,315588,13,381972
4102,0.062682,74.125.130.0-255,2902,318490,13,381972
4103,0.062685,172.31.36.0-255,66,318556,13,381972
4104,0.065063,74.125.130.0-255,2902,321458,13,381972
4105,0.065072,172.31.36.0-255,66,321524,13,381972
4106,0.065102,74.125.130.0-255,2902,324426,13,381972
4107,0.065105,172.31.36.0-255,66,324492,13,381972
4108,0.067478,74.125.130.0-255,2902,327394,13,381972
4109,0.067485,172.31.36.0-255,66,327460,13,381972
4110,0.067516,74.125.130.0-255,2902,330362,13,381972
4111,0.067519,172.31.36.0-255,66,330428,13,381972
4112,0.069886,74.125.130.0-255,2902,333330,13,381972
4113,0.069892,172.31.36.0-255,66,333396,13,381972
4114,0.069926,74.125.130.0-255,2902,336298,13,381972
4115,0.069929,172.31.36.0-255,66,336364,13,381972
4116,0.072289,74.125.130.0-255,2902,339266,13,381972
4117,0.072294,172.31.36.0-255,66,339332,13,381972
4118,0.072321,74.125.130.0-255,2902,342234,13,381972
4119,0.072324,172.31.36.0-255,66,342300,13,381972
4120,0.074714,74.125.130.0-255,2902,345202,13,381972
4121,0.074721,172.31.36.0-255,66,345268,13,381972
4122,0.074749,74.125.130.0-255,2902,348170,13,381972
4123,0.074752,172.31.36.0-255,66,348236,13,381972
4124,0.077121,74.125.130.0-255,2902,351138,13,381972
4125,0.077127,172.31.36.0-255,66,351204,13,381972
4126,0.077159,74.125.130.0-255,2902,354106,13,381972
4127,0.077162,172.31.36.0-255,66,354172,13,381972
4128,0.079534,74.125.130.0-255,2902,357074,13,381972
4129,0.079539,172.31.36.0-255,66,357140,13,381972
4130,0.079567,74.125.130.0-255,2902,360042,13,381972
4131,0.079569,172.31.36.0-255,66,360108,13,381972
4132,0.081947,74.125.130.0-255,5738,365846,13,381972
4133,0.081959,172.31.36.0-255,66,365912,13,381972
4134,0.084362,74.125.130.0-255,4320,370232,13,381972
4135,0.084368,172.31.36.0-255,66,370298,13,381972
4136,0.084394,74.125.130.0-255,1484,371782,13,381972
4137,0.086785,74.125.130.0-255,4320,376102,13,381972
4138,0.086792,172.31.36.0-255,66,376168,13,381972
4139,0.089199,74.125.130.0-255,5738,381906,13,381972
4140,0.089205,172.31.36.0-255,66,381972,13,381972
4141,0.0,192.229.237.0-255,128,128,13,611
4142,2.1e-05,192.229.237.0-255,90,218,13,611
4143,2.4e-05,192.229.237.0-255,66,284,13,611
4144,0.00015,172.31.36.0-255,105,389,13,611
4145,0.000306,172.31.36.0-255,90,479,13,611
4146,0.000318,172.31.36.0-255,66,545,13,611
4147,0.086634,192.229.237.0-255,66,611,13,611
4148,0.0,172.217.194.0-255,150,150,13,295659
4149,2e-05,172.31.36.0-255,66,216,13,295659
4150,2.7e-05,172.217.194.0-255,1484,1700,13,295659
4151,3.2e-05,172.31.36.0-255,66,1766,13,295659
4152,3.8e-05,172.217.194.0-255,2902,4668,13,295659
4153,4.9e-05,172.31.36.0-255,66,4734,13,295659
4154,5.6e-05,172.217.194.0-255,7156,11890,13,295659
4155,6e-05,172.31.36.0-255,66,11956,13,295659
4156,6.7e-05,172.217.194.0-255,6339,18295,13,295659
4157,7e-05,172.31.36.0-255,66,18361,13,295659
4158,0.000104,172.217.194.0-255,7156,25517,13,295659
4159,0.000107,172.31.36.0-255,66,25583,13,295659
4160,0.000135,172.217.194.0-255,5379,30962,13,295659
4161,0.000139,172.31.36.0-255,66,31028,13,295659
4162,0.000142,172.217.194.0-255,1484,32512,13,295659
4163,0.000144,172.31.36.0-255,66,32578,13,295659
4164,0.000147,172.217.194.0-255,1484,34062,13,295659
4165,0.00015,172.31.36.0-255,66,34128,13,295659
4166,0.000184,172.217.194.0-255,1484,35612,13,295659
4167,0.000187,172.31.36.0-255,66,35678,13,295659
4168,0.000194,172.217.194.0-255,5738,41416,13,295659
4169,0.000196,172.31.36.0-255,66,41482,13,295659
4170,0.00021,172.31.36.0-255,66,41548,13,295659
4171,0.000261,172.217.194.0-255,4320,45868,13,295659
4172,0.000264,172.31.36.0-255,66,45934,13,295659
4173,0.000296,172.217.194.0-255,5999,51933,13,295659
4174,0.000299,172.31.36.0-255,66,51999,13,295659
4175,0.000474,172.217.194.0-255,1484,53483,13,295659
4176,0.000479,172.31.36.0-255,66,53549,13,295659
4177,0.000485,172.217.194.0-255,2902,56451,13,295659
4178,0.000487,172.31.36.0-255,66,56517,13,295659
4179,0.000492,172.217.194.0-255,2902,59419,13,295659
4180,0.000499,172.31.36.0-255,66,59485,13,295659
4181,0.000535,172.217.194.0-255,2902,62387,13,295659
4182,0.000538,172.31.36.0-255,66,62453,13,295659
4183,0.000544,172.217.194.0-255,5738,68191,13,295659
4184,0.000546,172.31.36.0-255,66,68257,13,295659
4185,0.000553,172.217.194.0-255,7156,75413,13,295659
4186,0.000555,172.31.36.0-255,66,75479,13,295659
4187,0.000588,172.217.194.0-255,5738,81217,13,295659
4188,0.00059,172.31.36.0-255,66,81283,13,295659
4189,0.000597,172.217.194.0-255,4471,85754,13,295659
4190,0.000599,172.31.36.0-255,66,85820,13,295659
4191,0.000605,172.217.194.0-255,4320,90140,13,295659
4192,0.000607,172.31.36.0-255,66,90206,13,295659
4193,0.000635,172.217.194.0-255,1484,91690,13,295659
4194,0.000639,172.217.194.0-255,1484,93174,13,295659
4195,0.000641,172.31.36.0-255,66,93240,13,295659
4196,0.000667,172.217.194.0-255,5738,98978,13,295659
4197,0.000669,172.31.36.0-255,66,99044,13,295659
4198,0.000697,172.217.194.0-255,3961,103005,13,295659
4199,0.0007,172.31.36.0-255,66,103071,13,295659
4200,0.000734,172.217.194.0-255,1484,104555,13,295659
4201,0.000738,172.217.194.0-255,1484,106039,13,295659
4202,0.00074,172.31.36.0-255,66,106105,13,295659
4203,0.000763,172.217.194.0-255,1484,107589,13,295659
4204,0.000769,172.217.194.0-255,5738,113327,13,295659
4205,0.000772,172.31.36.0-255,66,113393,13,295659
4206,0.000829,172.217.194.0-255,7156,120549,13,295659
4207,0.000832,172.31.36.0-255,66,120615,13,295659
4208,0.000861,172.217.194.0-255,5738,126353,13,295659
4209,0.000864,172.31.36.0-255,66,126419,13,295659
4210,0.000873,172.217.194.0-255,9992,136411,13,295659
4211,0.000876,172.31.36.0-255,66,136477,13,295659
4212,0.000879,172.217.194.0-255,766,137243,13,295659
4213,0.00115,172.217.194.0-255,1484,138727,13,295659
4214,0.001155,172.31.36.0-255,66,138793,13,295659
4215,0.001161,172.217.194.0-255,2902,141695,13,295659
4216,0.001163,172.31.36.0-255,66,141761,13,295659
4217,0.001166,172.217.194.0-255,1484,143245,13,295659
4218,0.001184,172.217.194.0-255,4320,147565,13,295659
4219,0.00119,172.31.36.0-255,66,147631,13,295659
4220,0.001194,172.217.194.0-255,2902,150533,13,295659
4221,0.001196,172.31.36.0-255,66,150599,13,295659
4222,0.001241,172.217.194.0-255,9992,160591,13,295659
4223,0.001251,172.217.194.0-255,10692,171283,13,295659
4224,0.001261,172.31.36.0-255,66,171349,13,295659
4225,0.001265,172.31.36.0-255,66,171415,13,295659
4226,0.001532,172.217.194.0-255,1484,172899,13,295659
4227,0.001537,172.217.194.0-255,2902,175801,13,295659
4228,0.001541,172.31.36.0-255,66,175867,13,295659
4229,0.001572,172.217.194.0-255,5738,181605,13,295659
4230,0.001575,172.31.36.0-255,66,181671,13,295659
4231,0.001591,172.31.36.0-255,66,181737,13,295659
4232,0.001635,172.217.194.0-255,8574,190311,13,295659
4233,0.001638,172.31.36.0-255,66,190377,13,295659
4234,0.001664,172.217.194.0-255,3602,193979,13,295659
4235,0.001666,172.31.36.0-255,66,194045,13,295659
4236,0.001683,172.217.194.0-255,1484,195529,13,295659
4237,0.001687,172.217.194.0-255,2902,198431,13,295659
4238,0.001689,172.31.36.0-255,66,198497,13,295659
4239,0.001708,172.217.194.0-255,4320,202817,13,295659
4240,0.001713,172.31.36.0-255,66,202883,13,295659
4241,0.001738,172.217.194.0-255,1484,204367,13,295659
4242,0.001746,172.217.194.0-255,8574,212941,13,295659
4243,0.001749,172.31.36.0-255,66,213007,13,295659
4244,0.001772,172.217.194.0-255,1484,214491,13,295659
4245,0.001791,172.217.194.0-255,7156,221647,13,295659
4246,0.001794,172.31.36.0-255,66,221713,13,295659
4247,0.001832,172.217.194.0-255,6438,228151,13,295659
4248,0.001835,172.31.36.0-255,66,228217,13,295659
4249,0.001861,172.217.194.0-255,1484,229701,13,295659
4250,0.001866,172.217.194.0-255,2902,232603,13,295659
4251,0.001868,172.31.36.0-255,66,232669,13,295659
4252,0.001873,172.217.194.0-255,4320,236989,13,295659
4253,0.001876,172.31.36.0-255,66,237055,13,295659
4254,0.001894,172.217.194.0-255,1484,238539,13,295659
4255,0.001903,172.217.194.0-255,9992,248531,13,295659
4256,0.001905,172.31.36.0-255,66,248597,13,295659
4257,0.001937,172.217.194.0-255,8574,257171,13,295659
4258,0.00194,172.31.36.0-255,66,257237,13,295659
4259,0.001966,172.217.194.0-255,5020,262257,13,295659
4260,0.001969,172.31.36.0-255,66,262323,13,295659
4261,0.001977,172.217.194.0-255,8574,270897,13,295659
4262,0.00198,172.31.36.0-255,66,270963,13,295659
4263,0.002018,172.217.194.0-255,5738,276701,13,295659
4264,0.002038,172.31.36.0-255,66,276767,13,295659
4265,0.002042,172.31.36.0-255,66,276833,13,295659
4266,0.002098,172.31.36.0-255,66,276899,13,295659
4267,0.002127,172.217.194.0-255,2184,279083,13,295659
4268,0.00213,172.31.36.0-255,66,279149,13,295659
4269,0.002144,172.31.36.0-255,66,279215,13,295659
4270,0.002152,172.217.194.0-255,8574,287789,13,295659
4271,0.002155,172.31.36.0-255,66,287855,13,295659
4272,0.002167,172.31.36.0-255,66,287921,13,295659
4273,0.002207,172.217.194.0-255,2980,290901,13,295659
4274,0.002209,172.217.194.0-255,105,291006,13,295659
4275,0.002215,172.31.36.0-255,66,291072,13,295659
4276,0.002229,172.31.36.0-255,66,291138,13,295659
4277,0.011295,172.31.36.0-255,66,291204,13,295659
4278,0.011338,172.31.36.0-255,105,291309,13,295659
4279,0.013696,172.217.194.0-255,66,291375,13,295659
4280,0.032186,172.31.36.0-255,167,291542,13,295659
4281,0.032216,172.31.36.0-255,1110,292652,13,295659
4282,0.032275,172.31.36.0-255,1514,294166,13,295659
4283,0.032277,172.31.36.0-255,1295,295461,13,295659
4284,0.033843,104.244.42.0-255,66,295527,13,295659
4285,0.033875,104.244.42.0-255,66,295593,13,295659
4286,0.033913,104.244.42.0-255,66,295659,13,295659
4287,0.0,172.217.194.0-255,176,176,13,225411
4288,2.3e-05,172.31.36.0-255,66,242,13,225411
4289,3.1e-05,172.217.194.0-255,1484,1726,13,225411
4290,3.6e-05,172.31.36.0-255,66,1792,13,225411
4291,4.3e-05,172.217.194.0-255,2902,4694,13,225411
4292,5.4e-05,172.31.36.0-255,66,4760,13,225411
4293,6.3e-05,172.217.194.0-255,7156,11916,13,225411
4294,6.6e-05,172.31.36.0-255,66,11982,13,225411
4295,9.5e-05,172.217.194.0-255,2012,13994,13,225411
4296,9.8e-05,172.31.36.0-255,66,14060,13,225411
4297,0.000157,172.217.194.0-255,1484,15544,13,225411
4298,0.000161,172.31.36.0-255,66,15610,13,225411
4299,0.000167,172.217.194.0-255,2902,18512,13,225411
4300,0.00017,172.31.36.0-255,66,18578,13,225411
4301,0.000181,172.217.194.0-255,5738,24316,13,225411
4302,0.000184,172.31.36.0-255,66,24382,13,225411
4303,0.000187,172.217.194.0-255,1484,25866,13,225411
4304,0.000189,172.31.36.0-255,66,25932,13,225411
4305,0.000223,172.217.194.0-255,4320,30252,13,225411
4306,0.000226,172.31.36.0-255,66,30318,13,225411
4307,0.000274,172.31.36.0-255,66,30384,13,225411
4308,0.000283,172.217.194.0-255,8574,38958,13,225411
4309,0.00029,172.31.36.0-255,66,39024,13,225411
4310,0.000354,172.31.36.0-255,66,39090,13,225411
4311,0.000404,172.217.194.0-255,1484,40574,13,225411
4312,0.000407,172.31.36.0-255,66,40640,13,225411
4313,0.000412,172.217.194.0-255,2902,43542,13,225411
4314,0.000414,172.31.36.0-255,66,43608,13,225411
4315,0.000418,172.217.194.0-255,1484,45092,13,225411
4316,0.000424,172.31.36.0-255,66,45158,13,225411
4317,0.000454,172.217.194.0-255,4320,49478,13,225411
4318,0.000457,172.31.36.0-255,66,49544,13,225411
4319,0.000475,172.31.36.0-255,66,49610,13,225411
4320,0.000485,172.217.194.0-255,8574,58184,13,225411
4321,0.000487,172.31.36.0-255,66,58250,13,225411
4322,0.000529,172.217.194.0-255,2184,60434,13,225411
4323,0.000531,172.31.36.0-255,66,60500,13,225411
4324,0.000537,172.217.194.0-255,2902,63402,13,225411
4325,0.000539,172.31.36.0-255,66,63468,13,225411
4326,0.000577,172.217.194.0-255,7156,70624,13,225411
4327,0.00058,172.31.36.0-255,66,70690,13,225411
4328,0.000589,172.217.194.0-255,8574,79264,13,225411
4329,0.000595,172.31.36.0-255,66,79330,13,225411
4330,0.000626,172.217.194.0-255,7156,86486,13,225411
4331,0.000629,172.31.36.0-255,66,86552,13,225411
4332,0.000661,172.217.194.0-255,7856,94408,13,225411
4333,0.000664,172.31.36.0-255,66,94474,13,225411
4334,0.000669,172.217.194.0-255,2902,97376,13,225411
4335,0.000671,172.31.36.0-255,66,97442,13,225411
4336,0.000737,172.31.36.0-255,66,97508,13,225411
4337,0.00076,172.31.36.0-255,66,97574,13,225411
4338,0.000762,172.217.194.0-255,766,98340,13,225411
4339,0.000791,172.217.194.0-255,1484,99824,13,225411
4340,0.000794,172.31.36.0-255,66,99890,13,225411
4341,0.000798,172.217.194.0-255,1484,101374,13,225411
4342,0.000819,172.217.194.0-255,1484,102858,13,225411
4343,0.000821,172.31.36.0-255,66,102924,13,225411
4344,0.000828,172.217.194.0-255,5738,108662,13,225411
4345,0.000831,172.31.36.0-255,66,108728,13,225411
4346,0.000842,172.217.194.0-255,5738,114466,13,225411
4347,0.000845,172.31.36.0-255,66,114532,13,225411
4348,0.000858,172.217.194.0-255,4320,118852,13,225411
4349,0.00086,172.31.36.0-255,66,118918,13,225411
4350,0.0009,172.31.36.0-255,66,118984,13,225411
4351,0.000908,172.217.194.0-255,7156,126140,13,225411
4352,0.00091,172.31.36.0-255,66,126206,13,225411
4353,0.00094,172.217.194.0-255,9992,136198,13,225411
4354,0.000943,172.31.36.0-255,66,136264,13,225411
4355,0.000954,172.217.194.0-255,9992,146256,13,225411
4356,0.000956,172.31.36.0-255,66,146322,13,225411
4357,0.000991,172.217.194.0-255,3602,149924,13,225411
4358,0.000993,172.31.36.0-255,66,149990,13,225411
4359,0.001058,172.217.194.0-255,1484,151474,13,225411
4360,0.001063,172.217.194.0-255,2902,154376,13,225411
4361,0.001065,172.31.36.0-255,66,154442,13,225411
4362,0.001072,172.217.194.0-255,5738,160180,13,225411
4363,0.001075,172.31.36.0-255,66,160246,13,225411
4364,0.001097,172.31.36.0-255,66,160312,13,225411
4365,0.001105,172.217.194.0-255,7156,167468,13,225411
4366,0.001107,172.31.36.0-255,66,167534,13,225411
4367,0.001132,172.217.194.0-255,3602,171136,13,225411
4368,0.001134,172.31.36.0-255,66,171202,13,225411
4369,0.001164,172.217.194.0-255,4320,175522,13,225411
4370,0.001167,172.31.36.0-255,66,175588,13,225411
4371,0.00117,172.217.194.0-255,1484,177072,13,225411
4372,0.001199,172.217.194.0-255,5738,182810,13,225411
4373,0.001202,172.31.36.0-255,66,182876,13,225411
4374,0.001223,172.31.36.0-255,66,182942,13,225411
4375,0.001258,172.217.194.0-255,9274,192216,13,225411
4376,0.001261,172.31.36.0-255,66,192282,13,225411
4377,0.001271,172.217.194.0-255,9992,202274,13,225411
4378,0.001277,172.31.36.0-255,66,202340,13,225411
4379,0.001308,172.31.36.0-255,66,202406,13,225411
4380,0.001336,172.217.194.0-255,4320,206726,13,225411
4381,0.001338,172.31.36.0-255,66,206792,13,225411
4382,0.001365,172.31.36.0-255,66,206858,13,225411
4383,0.001399,172.217.194.0-255,10692,217550,13,225411
4384,0.001402,172.31.36.0-255,66,217616,13,225411
4385,0.001407,172.217.194.0-255,2902,220518,13,225411
4386,0.001409,172.31.36.0-255,66,220584,13,225411
4387,0.001435,172.31.36.0-255,66,220650,13,225411
4388,0.001438,172.217.194.0-255,105,220755,13,225411
4389,0.004038,172.31.36.0-255,101,220856,13,225411
4390,0.004958,172.31.36.0-255,105,220961,13,225411
4391,0.006567,172.217.194.0-255,66,221027,13,225411
4392,0.007496,172.217.194.0-255,66,221093,13,225411
4393,0.038784,172.31.36.0-255,199,221292,13,225411
4394,0.038826,172.31.36.0-255,1106,222398,13,225411
4395,0.038889,172.31.36.0-255,1514,223912,13,225411
4396,0.038892,172.31.36.0-255,1301,225213,13,225411
4397,0.040285,104.244.42.0-255,66,225279,13,225411
4398,0.040387,104.244.42.0-255,66,225345,13,225411
4399,0.040408,104.244.42.0-255,66,225411,13,225411
4400,0.0,172.217.194.0-255,298,298,13,233259
4401,3.6e-05,172.31.36.0-255,66,364,13,233259
4402,4.3e-05,172.217.194.0-255,1484,1848,13,233259
4403,4.8e-05,172.31.36.0-255,66,1914,13,233259
4404,6.3e-05,172.217.194.0-255,4320,6234,13,233259
4405,6.5e-05,172.31.36.0-255,66,6300,13,233259
4406,7.4e-05,172.217.194.0-255,8939,15239,13,233259
4407,7.6e-05,172.31.36.0-255,66,15305,13,233259
4408,8e-05,172.217.194.0-255,1484,16789,13,233259
4409,8.2e-05,172.31.36.0-255,66,16855,13,233259
4410,0.000122,172.31.36.0-255,66,16921,13,233259
4411,0.000125,172.217.194.0-255,1125,18046,13,233259
4412,0.000126,172.31.36.0-255,66,18112,13,233259
4413,0.000202,172.217.194.0-255,1484,19596,13,233259
4414,0.000205,172.31.36.0-255,66,19662,13,233259
4415,0.000232,172.217.194.0-255,2902,22564,13,233259
4416,0.000236,172.31.36.0-255,66,22630,13,233259
4417,0.000242,172.217.194.0-255,5738,28368,13,233259
4418,0.000244,172.31.36.0-255,66,28434,13,233259
4419,0.000283,172.31.36.0-255,66,28500,13,233259
4420,0.000288,172.217.194.0-255,2902,31402,13,233259
4421,0.000291,172.31.36.0-255,66,31468,13,233259
4422,0.000332,172.217.194.0-255,9921,41389,13,233259
4423,0.000336,172.31.36.0-255,66,41455,13,233259
4424,0.00034,172.217.194.0-255,98,41553,13,233259
4425,0.000342,172.31.36.0-255,66,41619,13,233259
4426,0.000365,172.217.194.0-255,1484,43103,13,233259
4427,0.000368,172.31.36.0-255,66,43169,13,233259
4428,0.000372,172.217.194.0-255,1484,44653,13,233259
4429,0.000374,172.31.36.0-255,66,44719,13,233259
4430,0.000397,172.217.194.0-255,1484,46203,13,233259
4431,0.000412,172.217.194.0-255,5738,51941,13,233259
4432,0.000415,172.31.36.0-255,66,52007,13,233259
4433,0.000455,172.31.36.0-255,66,52073,13,233259
4434,0.000484,172.217.194.0-255,1484,53557,13,233259
4435,0.000513,172.217.194.0-255,8514,62071,13,233259
4436,0.000516,172.31.36.0-255,66,62137,13,233259
4437,0.001848,172.217.194.0-255,1484,63621,13,233259
4438,0.001857,172.217.194.0-255,2902,66523,13,233259
4439,0.001862,172.31.36.0-255,66,66589,13,233259
4440,0.00187,172.217.194.0-255,5738,72327,13,233259
4441,0.001872,172.31.36.0-255,66,72393,13,233259
4442,0.001917,172.31.36.0-255,66,72459,13,233259
4443,0.001926,172.217.194.0-255,5738,78197,13,233259
4444,0.001928,172.31.36.0-255,66,78263,13,233259
4445,0.001961,172.217.194.0-255,5020,83283,13,233259
4446,0.001964,172.31.36.0-255,66,83349,13,233259
4447,0.001997,172.217.194.0-255,1484,84833,13,233259
4448,0.002003,172.217.194.0-255,2902,87735,13,233259
4449,0.002006,172.31.36.0-255,66,87801,13,233259
4450,0.002012,172.217.194.0-255,5738,93539,13,233259
4451,0.002014,172.31.36.0-255,66,93605,13,233259
4452,0.00202,172.217.194.0-255,5738,99343,13,233259
4453,0.002022,172.31.36.0-255,66,99409,13,233259
4454,0.002062,172.217.194.0-255,7156,106565,13,233259
4455,0.002066,172.31.36.0-255,66,106631,13,233259
4456,0.002074,172.217.194.0-255,8574,115205,13,233259
4457,0.002077,172.31.36.0-255,66,115271,13,233259
4458,0.002088,172.217.194.0-255,9992,125263,13,233259
4459,0.002093,172.31.36.0-255,66,125329,13,233259
4460,0.002143,172.31.36.0-255,66,125395,13,233259
4461,0.002159,172.31.36.0-255,66,125461,13,233259
4462,0.00217,172.217.194.0-255,9992,135453,13,233259
4463,0.002173,172.31.36.0-255,66,135519,13,233259
4464,0.002185,172.31.36.0-255,66,135585,13,233259
4465,0.002275,172.31.36.0-255,66,135651,13,233259
4466,0.002288,172.31.36.0-255,66,135717,13,233259
4467,0.002299,172.217.194.0-255,8574,144291,13,233259
4468,0.002301,172.31.36.0-255,66,144357,13,233259
4469,0.002304,172.217.194.0-255,1484,145841,13,233259
4470,0.002347,172.31.36.0-255,66,145907,13,233259
4471,0.002354,172.217.194.0-255,7156,153063,13,233259
4472,0.002356,172.31.36.0-255,66,153129,13,233259
4473,0.002396,172.31.36.0-255,66,153195,13,233259
4474,0.002404,172.217.194.0-255,8574,161769,13,233259
4475,0.002406,172.31.36.0-255,66,161835,13,233259
4476,0.004769,172.217.194.0-255,5738,167573,13,233259
4477,0.004774,172.31.36.0-255,66,167639,13,233259
4478,0.007116,172.217.194.0-255,5738,173377,13,233259
4479,0.007134,172.31.36.0-255,66,173443,13,233259
4480,0.00951,172.217.194.0-255,5738,179181,13,233259
4481,0.009523,172.31.36.0-255,66,179247,13,233259
4482,0.011867,172.217.194.0-255,5738,184985,13,233259
4483,0.011894,172.31.36.0-255,66,185051,13,233259
4484,0.014248,172.217.194.0-255,5738,190789,13,233259
4485,0.014253,172.31.36.0-255,66,190855,13,233259
4486,0.016593,172.217.194.0-255,5738,196593,13,233259
4487,0.0166,172.31.36.0-255,66,196659,13,233259
4488,0.018925,172.217.194.0-255,4320,200979,13,233259
4489,0.018931,172.31.36.0-255,66,201045,13,233259
4490,0.018954,172.217.194.0-255,1484,202529,13,233259
4491,0.021305,172.217.194.0-255,4320,206849,13,233259
4492,0.021314,172.31.36.0-255,66,206915,13,233259
4493,0.023671,172.217.194.0-255,5738,212653,13,233259
4494,0.023679,172.31.36.0-255,66,212719,13,233259
4495,0.026014,172.217.194.0-255,5738,218457,13,233259
4496,0.026022,172.31.36.0-255,66,218523,13,233259
4497,0.028374,172.217.194.0-255,5738,224261,13,233259
4498,0.028381,172.31.36.0-255,66,224327,13,233259
4499,0.03074,172.217.194.0-255,4406,228733,13,233259
4500,0.030748,172.31.36.0-255,66,228799,13,233259
4501,0.030939,172.31.36.0-255,105,228904,13,233259
4502,0.03322,172.217.194.0-255,66,228970,13,233259
4503,0.03507,172.31.36.0-255,172,229142,13,233259
4504,0.035101,172.31.36.0-255,1110,230252,13,233259
4505,0.035133,172.31.36.0-255,1514,231766,13,233259
4506,0.035134,172.31.36.0-255,1295,233061,13,233259
4507,0.036608,104.244.42.0-255,66,233127,13,233259
4508,0.036664,104.244.42.0-255,66,233193,13,233259
4509,0.036724,104.244.42.0-255,66,233259,13,233259
4510,0.0,74.125.68.0-255,153,153,13,302133
4511,2.8e-05,172.31.36.0-255,66,219,13,302133
4512,3.5e-05,74.125.68.0-255,1484,1703,13,302133
4513,4e-05,172.31.36.0-255,66,1769,13,302133
4514,7.3e-05,74.125.68.0-255,2902,4671,13,302133
4515,7.6e-05,172.31.36.0-255,66,4737,13,302133
4516,8.3e-05,74.125.68.0-255,5738,10475,13,302133
4517,8.5e-05,172.31.36.0-255,66,10541,13,302133
4518,9.4e-05,74.125.68.0-255,1484,12025,13,302133
4519,9.7e-05,172.31.36.0-255,66,12091,13,302133
4520,0.00012,74.125.68.0-255,1484,13575,13,302133
4521,0.000123,172.31.36.0-255,66,13641,13,302133
4522,0.000134,74.125.68.0-255,3465,17106,13,302133
4523,0.000137,172.31.36.0-255,66,17172,13,302133
4524,0.00015,74.125.68.0-255,1484,18656,13,302133
4525,0.000153,172.31.36.0-255,66,18722,13,302133
4526,0.000189,74.125.68.0-255,7156,25878,13,302133
4527,0.000193,172.31.36.0-255,66,25944,13,302133
4528,0.000197,74.125.68.0-255,2902,28846,13,302133
4529,0.000199,172.31.36.0-255,66,28912,13,302133
4530,0.000203,74.125.68.0-255,2543,31455,13,302133
4531,0.000205,172.31.36.0-255,66,31521,13,302133
4532,0.000246,74.125.68.0-255,1484,33005,13,302133
4533,0.000249,172.31.36.0-255,66,33071,13,302133
4534,0.000275,74.125.68.0-255,2902,35973,13,302133
4535,0.000279,172.31.36.0-255,66,36039,13,302133
4536,0.000286,74.125.68.0-255,5738,41777,13,302133
4537,0.000288,172.31.36.0-255,66,41843,13,302133
4538,0.000317,74.125.68.0-255,7156,48999,13,302133
4539,0.000321,172.31.36.0-255,66,49065,13,302133
4540,0.000328,74.125.68.0-255,5738,54803,13,302133
4541,0.000333,172.31.36.0-255,66,54869,13,302133
4542,0.000349,74.125.68.0-255,2902,57771,13,302133
4543,0.000362,172.31.36.0-255,66,57837,13,302133
4544,0.000363,74.125.68.0-255,7856,65693,13,302133
4545,0.000367,172.31.36.0-255,66,65759,13,302133
4546,0.000391,74.125.68.0-255,396,66155,13,302133
4547,0.000805,172.31.36.0-255,66,66221,13,302133
4548,0.001309,74.125.68.0-255,111,66332,13,302133
4549,0.001319,74.125.68.0-255,332,66664,13,302133
4550,0.001932,74.125.68.0-255,1484,68148,13,302133
4551,0.001941,74.125.68.0-255,2902,71050,13,302133
4552,0.00196,74.125.68.0-255,1484,72534,13,302133
4553,0.001971,74.125.68.0-255,4320,76854,13,302133
4554,0.001982,74.125.68.0-255,2902,79756,13,302133
4555,0.002011,74.125.68.0-255,4320,84076,13,302133
4556,0.002044,74.125.68.0-255,2902,86978,13,302133
4557,0.002058,74.125.68.0-255,4320,91298,13,302133
4558,0.002068,74.125.68.0-255,1484,92782,13,302133
4559,0.002097,74.125.68.0-255,1484,94266,13,302133
4560,0.002119,74.125.68.0-255,6438,100704,13,302133
4561,0.003856,172.31.36.0-255,66,100770,13,302133
4562,0.006323,74.125.68.0-255,1484,102254,13,302133
4563,0.006353,74.125.68.0-255,4320,106574,13,302133
4564,0.006357,172.31.36.0-255,66,106640,13,302133
4565,0.008849,74.125.68.0-255,5738,112378,13,302133
4566,0.008857,172.31.36.0-255,66,112444,13,302133
4567,0.011348,74.125.68.0-255,5738,118182,13,302133
4568,0.01136,172.31.36.0-255,66,118248,13,302133
4569,0.013859,74.125.68.0-255,5738,123986,13,302133
4570,0.013872,172.31.36.0-255,66,124052,13,302133
4571,0.016357,74.125.68.0-255,5738,129790,13,302133
4572,0.016366,172.31.36.0-255,66,129856,13,302133
4573,0.018864,74.125.68.0-255,5738,135594,13,302133
4574,0.018873,172.31.36.0-255,66,135660,13,302133
4575,0.021401,74.125.68.0-255,4320,139980,13,302133
4576,0.02141,172.31.36.0-255,66,140046,13,302133
4577,0.02144,74.125.68.0-255,1484,141530,13,302133
4578,0.023879,74.125.68.0-255,4320,145850,13,302133
4579,0.023886,172.31.36.0-255,66,145916,13,302133
4580,0.026359,74.125.68.0-255,5738,151654,13,302133
4581,0.026416,172.31.36.0-255,66,151720,13,302133
4582,0.028917,74.125.68.0-255,5738,157458,13,302133
4583,0.028924,172.31.36.0-255,66,157524,13,302133
4584,0.030874,172.31.36.0-255,172,157696,13,302133
4585,0.030907,172.31.36.0-255,1110,158806,13,302133
4586,0.030941,172.31.36.0-255,1514,160320,13,302133
4587,0.030943,172.31.36.0-255,1295,161615,13,302133
4588,0.031386,74.125.68.0-255,5738,167353,13,302133
4589,0.031393,172.31.36.0-255,66,167419,13,302133
4590,0.032494,104.244.42.0-255,66,167485,13,302133
4591,0.032525,104.244.42.0-255,66,167551,13,302133
4592,0.032553,104.244.42.0-255,66,167617,13,302133
4593,0.033858,74.125.68.0-255,2902,170519,13,302133
4594,0.033862,172.31.36.0-255,66,170585,13,302133
4595,0.0339,74.125.68.0-255,2902,173487,13,302133
4596,0.033921,172.31.36.0-255,66,173553,13,302133
4597,0.036318,74.125.68.0-255,2902,176455,13,302133
4598,0.036323,172.31.36.0-255,66,176521,13,302133
4599,0.036404,74.125.68.0-255,2902,179423,13,302133
4600,0.036415,172.31.36.0-255,66,179489,13,302133
4601,0.038809,74.125.68.0-255,2902,182391,13,302133
4602,0.038815,172.31.36.0-255,66,182457,13,302133
4603,0.038868,74.125.68.0-255,1484,183941,13,302133
4604,0.038884,74.125.68.0-255,1484,185425,13,302133
4605,0.039128,172.31.36.0-255,66,185491,13,302133
4606,0.041273,74.125.68.0-255,2902,188393,13,302133
4607,0.04128,172.31.36.0-255,66,188459,13,302133
4608,0.041599,74.125.68.0-255,2902,191361,13,302133
4609,0.041604,172.31.36.0-255,66,191427,13,302133
4610,0.043798,74.125.68.0-255,2902,194329,13,302133
4611,0.043803,172.31.36.0-255,66,194395,13,302133
4612,0.044066,74.125.68.0-255,2902,197297,13,302133
4613,0.044072,172.31.36.0-255,66,197363,13,302133
4614,0.046308,74.125.68.0-255,2902,200265,13,302133
4615,0.046313,172.31.36.0-255,66,200331,13,302133
4616,0.04653,74.125.68.0-255,2902,203233,13,302133
4617,0.046536,172.31.36.0-255,66,203299,13,302133
4618,0.048777,74.125.68.0-255,2902,206201,13,302133
4619,0.048782,172.31.36.0-255,66,206267,13,302133
4620,0.049011,74.125.68.0-255,2902,209169,13,302133
4621,0.049016,172.31.36.0-255,66,209235,13,302133
4622,0.051259,74.125.68.0-255,2902,212137,13,302133
4623,0.051264,172.31.36.0-255,66,212203,13,302133
4624,0.051479,74.125.68.0-255,2902,215105,13,302133
4625,0.051486,172.31.36.0-255,66,215171,13,302133
4626,0.053732,74.125.68.0-255,2902,218073,13,302133
4627,0.053737,172.31.36.0-255,66,218139,13,302133
4628,0.053943,74.125.68.0-255,2902,221041,13,302133
4629,0.053949,172.31.36.0-255,66,221107,13,302133
4630,0.056187,74.125.68.0-255,2902,224009,13,302133
4631,0.056194,172.31.36.0-255,66,224075,13,302133
4632,0.056409,74.125.68.0-255,2902,226977,13,302133
4633,0.056415,172.31.36.0-255,66,227043,13,302133
4634,0.058647,74.125.68.0-255,2902,229945,13,302133
4635,0.058653,172.31.36.0-255,66,230011,13,302133
4636,0.058879,74.125.68.0-255,2902,232913,13,302133
4637,0.058884,172.31.36.0-255,66,232979,13,302133
4638,0.06111,74.125.68.0-255,1484,234463,13,302133
4639,0.061362,74.125.68.0-255,4320,238783,13,302133
4640,0.061394,172.31.36.0-255,66,238849,13,302133
4641,0.063863,74.125.68.0-255,4320,243169,13,302133
4642,0.063868,172.31.36.0-255,66,243235,13,302133
4643,0.063903,74.125.68.0-255,1484,244719,13,302133
4644,0.066334,74.125.68.0-255,4320,249039,13,302133
4645,0.066339,172.31.36.0-255,66,249105,13,302133
4646,0.068837,74.125.68.0-255,5738,254843,13,302133
4647,0.069227,172.31.36.0-255,66,254909,13,302133
4648,0.071696,74.125.68.0-255,1484,256393,13,302133
4649,0.071724,74.125.68.0-255,4320,260713,13,302133
4650,0.071729,172.31.36.0-255,66,260779,13,302133
4651,0.074226,74.125.68.0-255,5738,266517,13,302133
4652,0.074231,172.31.36.0-255,66,266583,13,302133
4653,0.076726,74.125.68.0-255,5738,272321,13,302133
4654,0.076732,172.31.36.0-255,66,272387,13,302133
4655,0.079221,74.125.68.0-255,2902,275289,13,302133
4656,0.079227,172.31.36.0-255,66,275355,13,302133
4657,0.07926,74.125.68.0-255,2902,278257,13,302133
4658,0.079276,172.31.36.0-255,66,278323,13,302133
4659,0.0817,74.125.68.0-255,2902,281225,13,302133
4660,0.081705,172.31.36.0-255,66,281291,13,302133
4661,0.081738,74.125.68.0-255,2902,284193,13,302133
4662,0.081747,172.31.36.0-255,66,284259,13,302133
4663,0.084165,74.125.68.0-255,2902,287161,13,302133
4664,0.08417,172.31.36.0-255,66,287227,13,302133
4665,0.0842,74.125.68.0-255,2902,290129,13,302133
4666,0.084211,172.31.36.0-255,66,290195,13,302133
4667,0.086645,74.125.68.0-255,2902,293097,13,302133
4668,0.08665,172.31.36.0-255,66,293163,13,302133
4669,0.086688,74.125.68.0-255,2902,296065,13,302133
4670,0.086703,172.31.36.0-255,66,296131,13,302133
4671,0.089116,74.125.68.0-255,2902,299033,13,302133
4672,0.089121,172.31.36.0-255,66,299099,13,302133
4673,0.08918,74.125.68.0-255,1484,300583,13,302133
4674,0.089199,74.125.68.0-255,1484,302067,13,302133
4675,0.089217,172.31.36.0-255,66,302133,13,302133
4676,0.0,172.217.194.0-255,153,153,13,261480
4677,1.4e-05,172.217.194.0-255,1484,1637,13,261480
4678,2.1e-05,172.31.36.0-255,66,1703,13,261480
4679,3e-05,172.217.194.0-255,2902,4605,13,261480
4680,3.4e-05,172.31.36.0-255,66,4671,13,261480
4681,4.1e-05,172.217.194.0-255,7156,11827,13,261480
4682,4.5e-05,172.31.36.0-255,66,11893,13,261480
4683,4.8e-05,172.217.194.0-255,1484,13377,13,261480
4684,8.3e-05,172.31.36.0-255,66,13443,13,261480
4685,0.000102,172.217.194.0-255,3961,17404,13,261480
4686,0.000104,172.31.36.0-255,66,17470,13,261480
4687,0.000124,172.217.194.0-255,4320,21790,13,261480
4688,0.000126,172.31.36.0-255,66,21856,13,261480
4689,0.000153,172.217.194.0-255,9992,31848,13,261480
4690,0.000156,172.31.36.0-255,66,31914,13,261480
4691,0.000163,172.217.194.0-255,7156,39070,13,261480
4692,0.000166,172.31.36.0-255,66,39136,13,261480
4693,0.000207,172.217.194.0-255,4320,43456,13,261480
4694,0.00021,172.31.36.0-255,66,43522,13,261480
4695,0.000228,172.217.194.0-255,7856,51378,13,261480
4696,0.000231,172.31.36.0-255,66,51444,13,261480
4697,0.000234,172.217.194.0-255,413,51857,13,261480
4698,0.000263,172.217.194.0-255,1484,53341,13,261480
4699,0.000266,172.31.36.0-255,66,53407,13,261480
4700,0.000317,172.217.194.0-255,4320,57727,13,261480
4701,0.00032,172.31.36.0-255,66,57793,13,261480
4702,0.000329,172.217.194.0-255,9992,67785,13,261480
4703,0.000331,172.31.36.0-255,66,67851,13,261480
4704,0.000338,172.217.194.0-255,7156,75007,13,261480
4705,0.000341,172.31.36.0-255,66,75073,13,261480
4706,0.000375,172.217.194.0-255,10407,85480,13,261480
4707,0.000378,172.31.36.0-255,66,85546,13,261480
4708,0.0004,172.217.194.0-255,7156,92702,13,261480
4709,0.000403,172.31.36.0-255,66,92768,13,261480
4710,0.000416,172.217.194.0-255,4320,97088,13,261480
4711,0.000419,172.31.36.0-255,66,97154,13,261480
4712,0.000426,172.217.194.0-255,7156,104310,13,261480
4713,0.000429,172.31.36.0-255,66,104376,13,261480
4714,0.000479,172.217.194.0-255,7156,111532,13,261480
4715,0.000482,172.31.36.0-255,66,111598,13,261480
4716,0.000507,172.217.194.0-255,7856,119454,13,261480
4717,0.00051,172.31.36.0-255,66,119520,13,261480
4718,0.000514,172.217.194.0-255,2902,122422,13,261480
4719,0.000516,172.31.36.0-255,66,122488,13,261480
4720,0.00054,172.31.36.0-255,66,122554,13,261480
4721,0.000554,172.31.36.0-255,66,122620,13,261480
4722,0.000585,172.217.194.0-255,6438,129058,13,261480
4723,0.000588,172.31.36.0-255,66,129124,13,261480
4724,0.000633,172.217.194.0-255,1484,130608,13,261480
4725,0.000637,172.217.194.0-255,1484,132092,13,261480
4726,0.000639,172.31.36.0-255,66,132158,13,261480
4727,0.000656,172.217.194.0-255,1484,133642,13,261480
4728,0.000663,172.217.194.0-255,5738,139380,13,261480
4729,0.000666,172.31.36.0-255,66,139446,13,261480
4730,0.000696,172.217.194.0-255,8574,148020,13,261480
4731,0.000699,172.31.36.0-255,66,148086,13,261480
4732,0.000727,172.217.194.0-255,4320,152406,13,261480
4733,0.00073,172.31.36.0-255,66,152472,13,261480
4734,0.000753,172.217.194.0-255,10692,163164,13,261480
4735,0.000758,172.31.36.0-255,66,163230,13,261480
4736,0.000798,172.217.194.0-255,1484,164714,13,261480
4737,0.000814,172.217.194.0-255,2902,167616,13,261480
4738,0.000817,172.31.36.0-255,66,167682,13,261480
4739,0.000824,172.217.194.0-255,4320,172002,13,261480
4740,0.000826,172.31.36.0-255,66,172068,13,261480
4741,0.00084,172.217.194.0-255,1484,173552,13,261480
4742,0.000849,172.217.194.0-255,8574,182126,13,261480
4743,0.000851,172.31.36.0-255,66,182192,13,261480
4744,0.000867,172.217.194.0-255,1484,183676,13,261480
4745,0.00087,172.217.194.0-255,1484,185160,13,261480
4746,0.000873,172.31.36.0-255,66,185226,13,261480
4747,0.00091,172.31.36.0-255,66,185292,13,261480
4748,0.000925,172.31.36.0-255,66,185358,13,261480
4749,0.000966,172.217.194.0-255,1484,186842,13,261480
4750,0.000996,172.31.36.0-255,66,186908,13,261480
4751,0.001,172.217.194.0-255,2184,189092,13,261480
4752,0.001002,172.31.36.0-255,66,189158,13,261480
4753,0.001111,172.217.194.0-255,1484,190642,13,261480
4754,0.001124,172.217.194.0-255,1484,192126,13,261480
4755,0.001127,172.31.36.0-255,66,192192,13,261480
4756,0.001131,172.217.194.0-255,1484,193676,13,261480
4757,0.001147,172.217.194.0-255,1484,195160,13,261480
4758,0.001149,172.31.36.0-255,66,195226,13,261480
4759,0.001156,172.217.194.0-255,5738,200964,13,261480
4760,0.001158,172.31.36.0-255,66,201030,13,261480
4761,0.001161,172.217.194.0-255,1484,202514,13,261480
4762,0.001198,172.31.36.0-255,66,202580,13,261480
4763,0.001206,172.217.194.0-255,8574,211154,13,261480
4764,0.001208,172.31.36.0-255,66,211220,13,261480
4765,0.001211,172.217.194.0-255,766,211986,13,261480
4766,0.001239,172.217.194.0-255,1484,213470,13,261480
4767,0.001241,172.31.36.0-255,66,213536,13,261480
4768,0.001263,172.217.194.0-255,4320,217856,13,261480
4769,0.001266,172.31.36.0-255,66,217922,13,261480
4770,0.001285,172.217.194.0-255,9992,227914,13,261480
4771,0.001288,172.31.36.0-255,66,227980,13,261480
4772,0.001293,172.217.194.0-255,4320,232300,13,261480
4773,0.001295,172.31.36.0-255,66,232366,13,261480
4774,0.001332,172.217.194.0-255,5738,238104,13,261480
4775,0.001336,172.31.36.0-255,66,238170,13,261480
4776,0.001364,172.217.194.0-255,10692,248862,13,261480
4777,0.001367,172.31.36.0-255,66,248928,13,261480
4778,0.001381,172.31.36.0-255,66,248994,13,261480
4779,0.001397,172.217.194.0-255,1484,250478,13,261480
4780,0.001414,172.217.194.0-255,7156,257634,13,261480
4781,0.001422,172.31.36.0-255,66,257700,13,261480
4782,0.001468,172.217.194.0-255,1386,259086,13,261480
4783,0.001528,172.217.194.0-255,105,259191,13,261480
4784,0.004547,172.31.36.0-255,66,259257,13,261480
4785,0.007338,172.31.36.0-255,105,259362,13,261480
4786,0.009635,172.217.194.0-255,66,259428,13,261480
4787,0.029448,172.31.36.0-255,171,259599,13,261480
4788,0.029879,172.31.36.0-255,1133,260732,13,261480
4789,0.029969,172.31.36.0-255,550,261282,13,261480
4790,0.03099,104.244.42.0-255,66,261348,13,261480
4791,0.031418,104.244.42.0-255,66,261414,13,261480
4792,0.03152,104.244.42.0-255,66,261480,13,261480
4793,0.0,74.125.130.0-255,148,148,13,373480
4794,2.4e-05,172.31.36.0-255,66,214,13,373480
4795,3.2e-05,74.125.130.0-255,1484,1698,13,373480
4796,3.7e-05,172.31.36.0-255,66,1764,13,373480
4797,4.2e-05,74.125.130.0-255,2902,4666,13,373480
4798,4.5e-05,172.31.36.0-255,66,4732,13,373480
4799,5.2e-05,74.125.130.0-255,5738,10470,13,373480
4800,5.6e-05,172.31.36.0-255,66,10536,13,373480
4801,6.2e-05,74.125.130.0-255,3466,14002,13,373480
4802,6.4e-05,172.31.36.0-255,66,14068,13,373480
4803,7e-05,74.125.130.0-255,2902,16970,13,373480
4804,7.2e-05,172.31.36.0-255,66,17036,13,373480
4805,9.3e-05,74.125.130.0-255,1484,18520,13,373480
4806,9.5e-05,172.31.36.0-255,66,18586,13,373480
4807,0.000106,74.125.130.0-255,9992,28578,13,373480
4808,0.000108,172.31.36.0-255,66,28644,13,373480
4809,0.000113,74.125.130.0-255,2543,31187,13,373480
4810,0.000116,172.31.36.0-255,66,31253,13,373480
4811,0.00026,74.125.130.0-255,1484,32737,13,373480
4812,0.000264,172.31.36.0-255,66,32803,13,373480
4813,0.000271,74.125.130.0-255,2902,35705,13,373480
4814,0.000274,172.31.36.0-255,66,35771,13,373480
4815,0.000303,74.125.130.0-255,5738,41509,13,373480
4816,0.000306,172.31.36.0-255,66,41575,13,373480
4817,0.000313,74.125.130.0-255,5738,47313,13,373480
4818,0.000315,172.31.36.0-255,66,47379,13,373480
4819,0.000342,74.125.130.0-255,6797,54176,13,373480
4820,0.000346,172.31.36.0-255,66,54242,13,373480
4821,0.000376,74.125.130.0-255,8574,62816,13,373480
4822,0.000379,172.31.36.0-255,66,62882,13,373480
4823,0.0004,74.125.130.0-255,1484,64366,13,373480
4824,0.000402,172.31.36.0-255,66,64432,13,373480
4825,0.00042,74.125.130.0-255,1713,66145,13,373480
4826,0.000454,172.31.36.0-255,66,66211,13,373480
4827,0.000548,74.125.130.0-255,1484,67695,13,373480
4828,0.000566,74.125.130.0-255,2902,70597,13,373480
4829,0.000574,74.125.130.0-255,5738,76335,13,373480
4830,0.000596,172.31.36.0-255,66,76401,13,373480
4831,0.000607,74.125.130.0-255,1484,77885,13,373480
4832,0.000627,74.125.130.0-255,9633,87518,13,373480
4833,0.000656,74.125.130.0-255,2902,90420,13,373480
4834,0.000672,74.125.130.0-255,8574,98994,13,373480
4835,0.000675,74.125.130.0-255,1125,100119,13,373480
4836,0.000684,172.31.36.0-255,66,100185,13,373480
4837,0.000836,74.125.130.0-255,1484,101669,13,373480
4838,0.000842,74.125.130.0-255,2902,104571,13,373480
4839,0.000848,74.125.130.0-255,5738,110309,13,373480
4840,0.000851,74.125.130.0-255,1484,111793,13,373480
4841,0.000858,74.125.130.0-255,5738,117531,13,373480
4842,0.000875,172.31.36.0-255,66,117597,13,373480
4843,0.000881,74.125.130.0-255,2902,120499,13,373480
4844,0.000886,74.125.130.0-255,4320,124819,13,373480
4845,0.000891,74.125.130.0-255,5738,130557,13,373480
4846,0.000898,172.31.36.0-255,66,130623,13,373480
4847,0.000915,74.125.130.0-255,1484,132107,13,373480
4848,0.000931,74.125.130.0-255,2184,134291,13,373480
4849,0.000939,172.31.36.0-255,66,134357,13,373480
4850,0.001041,74.125.130.0-255,1484,135841,13,373480
4851,0.001059,74.125.130.0-255,2902,138743,13,373480
4852,0.001063,74.125.130.0-255,2902,141645,13,373480
4853,0.001069,172.31.36.0-255,66,141711,13,373480
4854,0.001077,74.125.130.0-255,1484,143195,13,373480
4855,0.00108,74.125.130.0-255,1484,144679,13,373480
4856,0.001086,172.31.36.0-255,66,144745,13,373480
4857,0.001097,74.125.130.0-255,4320,149065,13,373480
4858,0.001119,74.125.130.0-255,8574,157639,13,373480
4859,0.001127,172.31.36.0-255,66,157705,13,373480
4860,0.001147,74.125.130.0-255,2902,160607,13,373480
4861,0.001152,74.125.130.0-255,4320,164927,13,373480
4862,0.001159,172.31.36.0-255,66,164993,13,373480
4863,0.001179,74.125.130.0-255,3602,168595,13,373480
4864,0.001214,172.31.36.0-255,66,168661,13,373480
4865,0.001348,74.125.130.0-255,1484,170145,13,373480
4866,0.001351,74.125.130.0-255,1484,171629,13,373480
4867,0.001359,172.31.36.0-255,66,171695,13,373480
4868,0.001367,74.125.130.0-255,1484,173179,13,373480
4869,0.001387,74.125.130.0-255,4320,177499,13,373480
4870,0.001393,74.125.130.0-255,5738,183237,13,373480
4871,0.001408,172.31.36.0-255,66,183303,13,373480
4872,0.00142,74.125.130.0-255,4320,187623,13,373480
4873,0.001439,172.31.36.0-255,66,187689,13,373480
4874,0.001456,74.125.130.0-255,7156,194845,13,373480
4875,0.001462,74.125.130.0-255,4320,199165,13,373480
4876,0.001477,74.125.130.0-255,3602,202767,13,373480
4877,0.001495,172.31.36.0-255,66,202833,13,373480
4878,0.001681,74.125.130.0-255,1484,204317,13,373480
4879,0.001702,74.125.130.0-255,2902,207219,13,373480
4880,0.001705,172.31.36.0-255,66,207285,13,373480
4881,0.001712,74.125.130.0-255,5738,213023,13,373480
4882,0.001735,74.125.130.0-255,2902,215925,13,373480
4883,0.001742,172.31.36.0-255,66,215991,13,373480
4884,0.001754,74.125.130.0-255,7156,223147,13,373480
4885,0.001759,172.31.36.0-255,66,223213,13,373480
4886,0.00178,74.125.130.0-255,5738,228951,13,373480
4887,0.001788,172.31.36.0-255,66,229017,13,373480
4888,0.001804,74.125.130.0-255,5738,234755,13,373480
4889,0.001808,74.125.130.0-255,2184,236939,13,373480
4890,0.00183,74.125.130.0-255,2902,239841,13,373480
4891,0.001836,74.125.130.0-255,5738,245579,13,373480
4892,0.00184,172.31.36.0-255,66,245645,13,373480
4893,0.001846,172.31.36.0-255,66,245711,13,373480
4894,0.001857,74.125.130.0-255,1484,247195,13,373480
4895,0.001863,74.125.130.0-255,4320,251515,13,373480
4896,0.001881,74.125.130.0-255,4320,255835,13,373480
4897,0.0019,172.31.36.0-255,66,255901,13,373480
4898,0.001904,74.125.130.0-255,1484,257385,13,373480
4899,0.001912,74.125.130.0-255,9992,267377,13,373480
4900,0.001923,172.31.36.0-255,66,267443,13,373480
4901,0.001937,74.125.130.0-255,2902,270345,13,373480
4902,0.001948,172.31.36.0-255,66,270411,13,373480
4903,0.001963,74.125.130.0-255,7856,278267,13,373480
4904,0.002025,74.125.130.0-255,7156,285423,13,373480
4905,0.002034,74.125.130.0-255,7856,293279,13,373480
4906,0.002036,74.125.130.0-255,1484,294763,13,373480
4907,0.002046,172.31.36.0-255,66,294829,13,373480
4908,0.002058,74.125.130.0-255,2902,297731,13,373480
4909,0.002075,74.125.130.0-255,5738,303469,13,373480
4910,0.002091,74.125.130.0-255,5738,309207,13,373480
4911,0.002102,172.31.36.0-255,66,309273,13,373480
4912,0.002115,74.125.130.0-255,7156,316429,13,373480
4913,0.002142,172.31.36.0-255,66,316495,13,373480
4914,0.002153,74.125.130.0-255,10692,327187,13,373480
4915,0.002158,172.31.36.0-255,66,327253,13,373480
4916,0.002167,74.125.130.0-255,1484,328737,13,373480
4917,0.002188,74.125.130.0-255,8574,337311,13,373480
4918,0.0022,172.31.36.0-255,66,337377,13,373480
4919,0.002211,74.125.130.0-255,1484,338861,13,373480
4920,0.002217,74.125.130.0-255,4320,343181,13,373480
4921,0.002221,172.31.36.0-255,66,343247,13,373480
4922,0.00223,74.125.130.0-255,1484,344731,13,373480
4923,0.002235,74.125.130.0-255,2902,347633,13,373480
4924,0.002256,74.125.130.0-255,4320,351953,13,373480
4925,0.002259,74.125.130.0-255,1484,353437,13,373480
4926,0.00227,172.31.36.0-255,66,353503,13,373480
4927,0.002284,74.125.130.0-255,7856,361359,13,373480
4928,0.002289,172.31.36.0-255,66,361425,13,373480
4929,0.002297,74.125.130.0-255,1484,362909,13,373480
4930,0.002322,74.125.130.0-255,6843,369752,13,373480
4931,0.002341,172.31.36.0-255,66,369818,13,373480
4932,0.004577,74.125.130.0-255,105,369923,13,373480
4933,0.008499,172.31.36.0-255,66,369989,13,373480
4934,0.008541,172.31.36.0-255,105,370094,13,373480
4935,0.010795,74.125.130.0-255,66,370160,13,373480
4936,0.030231,172.31.36.0-255,167,370327,13,373480
4937,0.030267,172.31.36.0-255,1108,371435,13,373480
4938,0.030325,172.31.36.0-255,1514,372949,13,373480
4939,0.030327,172.31.36.0-255,333,373282,13,373480
4940,0.031774,104.244.42.0-255,66,373348,13,373480
4941,0.031835,104.244.42.0-255,66,373414,13,373480
4942,0.031894,104.244.42.0-255,66,373480,13,373480
4943,0.0,74.125.24.0-255,153,153,13,365991
4944,2.3e-05,172.31.36.0-255,66,219,13,365991
4945,3e-05,74.125.24.0-255,1484,1703,13,365991
4946,3.4e-05,172.31.36.0-255,66,1769,13,365991
4947,4e-05,74.125.24.0-255,2902,4671,13,365991
4948,4.4e-05,172.31.36.0-255,66,4737,13,365991
4949,5.1e-05,74.125.24.0-255,7156,11893,13,365991
4950,5.5e-05,172.31.36.0-255,66,11959,13,365991
4951,6.2e-05,74.125.24.0-255,4905,16864,13,365991
4952,6.5e-05,172.31.36.0-255,66,16930,13,365991
4953,7.1e-05,74.125.24.0-255,4320,21250,13,365991
4954,7.4e-05,172.31.36.0-255,66,21316,13,365991
4955,0.000104,74.125.24.0-255,9633,30949,13,365991
4956,0.000108,172.31.36.0-255,66,31015,13,365991
4957,0.000152,74.125.24.0-255,1484,32499,13,365991
4958,0.000156,172.31.36.0-255,66,32565,13,365991
4959,0.000162,74.125.24.0-255,2902,35467,13,365991
4960,0.000164,172.31.36.0-255,66,35533,13,365991
4961,0.000169,74.125.24.0-255,2902,38435,13,365991
4962,0.000171,172.31.36.0-255,66,38501,13,365991
4963,0.000204,74.125.24.0-255,2902,41403,13,365991
4964,0.000207,172.31.36.0-255,66,41469,13,365991
4965,0.000214,74.125.24.0-255,6797,48266,13,365991
4966,0.000217,172.31.36.0-255,66,48332,13,365991
4967,0.000524,74.125.24.0-255,1484,49816,13,365991
4968,0.00053,172.31.36.0-255,66,49882,13,365991
4969,0.000537,74.125.24.0-255,2902,52784,13,365991
4970,0.00054,172.31.36.0-255,66,52850,13,365991
4971,0.000546,74.125.24.0-255,4320,57170,13,365991
4972,0.000549,172.31.36.0-255,66,57236,13,365991
4973,0.000576,74.125.24.0-255,1484,58720,13,365991
4974,0.000578,172.31.36.0-255,66,58786,13,365991
4975,0.000585,74.125.24.0-255,5738,64524,13,365991
4976,0.000588,172.31.36.0-255,66,64590,13,365991
4977,0.000607,74.125.24.0-255,1704,66294,13,365991
4978,0.000609,172.31.36.0-255,66,66360,13,365991
4979,0.000639,74.125.24.0-255,2902,69262,13,365991
4980,0.000643,172.31.36.0-255,66,69328,13,365991
4981,0.000646,74.125.24.0-255,1484,70812,13,365991
4982,0.000661,74.125.24.0-255,2902,73714,13,365991
4983,0.000663,172.31.36.0-255,66,73780,13,365991
4984,0.00069,74.125.24.0-255,2902,76682,13,365991
4985,0.000693,172.31.36.0-255,66,76748,13,365991
4986,0.000716,74.125.24.0-255,5738,82486,13,365991
4987,0.000719,172.31.36.0-255,66,82552,13,365991
4988,0.000736,172.31.36.0-255,66,82618,13,365991
4989,0.000749,74.125.24.0-255,1636,84254,13,365991
4990,0.000751,172.31.36.0-255,66,84320,13,365991
4991,0.000941,74.125.24.0-255,1484,85804,13,365991
4992,0.000947,74.125.24.0-255,1484,87288,13,365991
4993,0.000951,172.31.36.0-255,66,87354,13,365991
4994,0.000969,74.125.24.0-255,1484,88838,13,365991
4995,0.000976,74.125.24.0-255,5738,94576,13,365991
4996,0.000979,172.31.36.0-255,66,94642,13,365991
4997,0.000984,74.125.24.0-255,2902,97544,13,365991
4998,0.000987,172.31.36.0-255,66,97610,13,365991
4999,0.00102,74.125.24.0-255,9992,107602,13,365991
5000,0.001023,172.31.36.0-255,66,107668,13,365991
5001,0.001032,74.125.24.0-255,9992,117660,13,365991
5002,0.001034,172.31.36.0-255,66,117726,13,365991
5003,0.001037,74.125.24.0-255,766,118492,13,365991
5004,0.001371,74.125.24.0-255,1484,119976,13,365991
5005,0.001378,172.31.36.0-255,66,120042,13,365991
5006,0.001385,74.125.24.0-255,2902,122944,13,365991
5007,0.001388,172.31.36.0-255,66,123010,13,365991
5008,0.001394,74.125.24.0-255,5738,128748,13,365991
5009,0.001397,172.31.36.0-255,66,128814,13,365991
5010,0.0014,74.125.24.0-255,1484,130298,13,365991
5011,0.001438,172.31.36.0-255,66,130364,13,365991
5012,0.001444,74.125.24.0-255,5738,136102,13,365991
5013,0.001447,172.31.36.0-255,66,136168,13,365991
5014,0.001471,74.125.24.0-255,2902,139070,13,365991
5015,0.001473,172.31.36.0-255,66,139136,13,365991
5016,0.001492,74.125.24.0-255,2184,141320,13,365991
5017,0.001495,172.31.36.0-255,66,141386,13,365991
5018,0.001938,74.125.24.0-255,1484,142870,13,365991
5019,0.001945,74.125.24.0-255,2902,145772,13,365991
5020,0.001948,172.31.36.0-255,66,145838,13,365991
5021,0.001973,74.125.24.0-255,5738,151576,13,365991
5022,0.001976,172.31.36.0-255,66,151642,13,365991
5023,0.001991,74.125.24.0-255,4320,155962,13,365991
5024,0.001993,172.31.36.0-255,66,156028,13,365991
5025,0.002028,74.125.24.0-255,5738,161766,13,365991
5026,0.002031,172.31.36.0-255,66,161832,13,365991
5027,0.00204,74.125.24.0-255,8574,170406,13,365991
5028,0.002043,172.31.36.0-255,66,170472,13,365991
5029,0.004044,74.125.24.0-255,5738,176210,13,365991
5030,0.004052,172.31.36.0-255,66,176276,13,365991
5031,0.006076,74.125.24.0-255,5738,182014,13,365991
5032,0.00608,172.31.36.0-255,66,182080,13,365991
5033,0.008058,74.125.24.0-255,2902,184982,13,365991
5034,0.008062,172.31.36.0-255,66,185048,13,365991
5035,0.008078,74.125.24.0-255,2902,187950,13,365991
5036,0.00808,172.31.36.0-255,66,188016,13,365991
5037,0.010087,74.125.24.0-255,5738,193754,13,365991
5038,0.010095,172.31.36.0-255,66,193820,13,365991
5039,0.012136,74.125.24.0-255,5738,199558,13,365991
5040,0.012146,172.31.36.0-255,66,199624,13,365991
5041,0.01417,74.125.24.0-255,5738,205362,13,365991
5042,0.014177,172.31.36.0-255,66,205428,13,365991
5043,0.016156,74.125.24.0-255,5738,211166,13,365991
5044,0.016163,172.31.36.0-255,66,211232,13,365991
5045,0.018198,74.125.24.0-255,5738,216970,13,365991
5046,0.018205,172.31.36.0-255,66,217036,13,365991
5047,0.020191,74.125.24.0-255,4320,221356,13,365991
5048,0.020196,172.31.36.0-255,66,221422,13,365991
5049,0.020226,74.125.24.0-255,1484,222906,13,365991
5050,0.022212,74.125.24.0-255,4320,227226,13,365991
5051,0.022217,172.31.36.0-255,66,227292,13,365991
5052,0.024218,74.125.24.0-255,5738,233030,13,365991
5053,0.024226,172.31.36.0-255,66,233096,13,365991
5054,0.026283,74.125.24.0-255,4320,237416,13,365991
5055,0.02629,172.31.36.0-255,66,237482,13,365991
5056,0.026309,74.125.24.0-255,1484,238966,13,365991
5057,0.028285,74.125.24.0-255,4320,243286,13,365991
5058,0.028295,172.31.36.0-255,66,243352,13,365991
5059,0.030308,74.125.24.0-255,5738,249090,13,365991
5060,0.030317,172.31.36.0-255,66,249156,13,365991
5061,0.032361,74.125.24.0-255,5738,254894,13,365991
5062,0.032369,172.31.36.0-255,66,254960,13,365991
5063,0.034389,74.125.24.0-255,5738,260698,13,365991
5064,0.034398,172.31.36.0-255,66,260764,13,365991
5065,0.036401,74.125.24.0-255,5738,266502,13,365991
5066,0.03641,172.31.36.0-255,66,266568,13,365991
5067,0.038441,74.125.24.0-255,5738,272306,13,365991
5068,0.03845,172.31.36.0-255,66,272372,13,365991
5069,0.040472,74.125.24.0-255,5738,278110,13,365991
5070,0.040481,172.31.36.0-255,66,278176,13,365991
5071,0.042501,74.125.24.0-255,5738,283914,13,365991
5072,0.042511,172.31.36.0-255,66,283980,13,365991
5073,0.044487,74.125.24.0-255,5738,289718,13,365991
5074,0.044499,172.31.36.0-255,66,289784,13,365991
5075,0.046484,74.125.24.0-255,5738,295522,13,365991
5076,0.046497,172.31.36.0-255,66,295588,13,365991
5077,0.048487,74.125.24.0-255,2902,298490,13,365991
5078,0.048497,172.31.36.0-255,66,298556,13,365991
5079,0.048515,74.125.24.0-255,2902,301458,13,365991
5080,0.048519,172.31.36.0-255,66,301524,13,365991
5081,0.048945,172.31.36.0-255,176,301700,13,365991
5082,0.048978,172.31.36.0-255,1111,302811,13,365991
5083,0.049055,172.31.36.0-255,1514,304325,13,365991
5084,0.049057,172.31.36.0-255,1514,305839,13,365991
5085,0.049058,172.31.36.0-255,1514,307353,13,365991
5086,0.049059,172.31.36.0-255,1514,308867,13,365991
5087,0.04906,172.31.36.0-255,1514,310381,13,365991
5088,0.049088,172.31.36.0-255,71,310452,13,365991
5089,0.050472,104.244.42.0-255,66,310518,13,365991
5090,0.050504,74.125.24.0-255,2902,313420,13,365991
5091,0.050509,172.31.36.0-255,66,313486,13,365991
5092,0.05053,104.244.42.0-255,66,313552,13,365991
5093,0.050534,74.125.24.0-255,2902,316454,13,365991
5094,0.050537,172.31.36.0-255,66,316520,13,365991
5095,0.050624,104.244.42.0-255,66,316586,13,365991
5096,0.05063,104.244.42.0-255,66,316652,13,365991
5097,0.052555,74.125.24.0-255,5738,322390,13,365991
5098,0.052564,172.31.36.0-255,66,322456,13,365991
5099,0.054615,74.125.24.0-255,5738,328194,13,365991
5100,0.054623,172.31.36.0-255,66,328260,13,365991
5101,0.056631,74.125.24.0-255,5738,333998,13,365991
5102,0.056637,172.31.36.0-255,66,334064,13,365991
5103,0.058641,74.125.24.0-255,5738,339802,13,365991
5104,0.058649,172.31.36.0-255,66,339868,13,365991
5105,0.060655,74.125.24.0-255,5738,345606,13,365991
5106,0.060662,172.31.36.0-255,66,345672,13,365991
5107,0.062679,74.125.24.0-255,5738,351410,13,365991
5108,0.062686,172.31.36.0-255,66,351476,13,365991
5109,0.06472,74.125.24.0-255,5738,357214,13,365991
5110,0.06473,172.31.36.0-255,66,357280,13,365991
5111,0.066705,74.125.24.0-255,5738,363018,13,365991
5112,0.066712,172.31.36.0-255,66,363084,13,365991
5113,0.068716,74.125.24.0-255,2670,365754,13,365991
5114,0.068723,172.31.36.0-255,66,365820,13,365991
5115,0.06889,172.31.36.0-255,105,365925,13,365991
5116,0.070862,74.125.24.0-255,66,365991,13,365991
5117,0.0,172.217.24.0-255,150,150,13,353223
5118,1.5e-05,172.217.24.0-255,1484,1634,13,353223
5119,2.3e-05,172.31.36.0-255,66,1700,13,353223
5120,3.1e-05,172.217.24.0-255,2902,4602,13,353223
5121,3.5e-05,172.31.36.0-255,66,4668,13,353223
5122,4.5e-05,172.217.24.0-255,1484,6152,13,353223
5123,7.9e-05,172.217.24.0-255,5738,11890,13,353223
5124,8.3e-05,172.31.36.0-255,66,11956,13,353223
5125,8.8e-05,172.217.24.0-255,2031,13987,13,353223
5126,8.9e-05,172.31.36.0-255,66,14053,13,353223
5127,0.000607,172.217.24.0-255,1484,15537,13,353223
5128,0.000617,172.217.24.0-255,2902,18439,13,353223
5129,0.000621,172.31.36.0-255,66,18505,13,353223
5130,0.00063,172.217.24.0-255,5738,24243,13,353223
5131,0.000633,172.31.36.0-255,66,24309,13,353223
5132,0.000672,172.217.24.0-255,6797,31106,13,353223
5133,0.000675,172.31.36.0-255,66,31172,13,353223
5134,0.000915,172.217.24.0-255,1484,32656,13,353223
5135,0.000944,172.217.24.0-255,2902,35558,13,353223
5136,0.000949,172.31.36.0-255,66,35624,13,353223
5137,0.000961,172.217.24.0-255,4320,39944,13,353223
5138,0.000963,172.31.36.0-255,66,40010,13,353223
5139,0.000974,172.217.24.0-255,5738,45748,13,353223
5140,0.000977,172.31.36.0-255,66,45814,13,353223
5141,0.001019,172.217.24.0-255,2543,48357,13,353223
5142,0.001023,172.31.36.0-255,66,48423,13,353223
5143,0.001272,172.217.24.0-255,1484,49907,13,353223
5144,0.001283,172.217.24.0-255,2902,52809,13,353223
5145,0.001287,172.31.36.0-255,66,52875,13,353223
5146,0.001296,172.217.24.0-255,5738,58613,13,353223
5147,0.001298,172.31.36.0-255,66,58679,13,353223
5148,0.001335,172.217.24.0-255,7086,65765,13,353223
5149,0.001337,172.31.36.0-255,66,65831,13,353223
5150,0.001638,172.217.24.0-255,388,66219,13,353223
5151,0.001808,172.217.24.0-255,1484,67703,13,353223
5152,0.001814,172.31.36.0-255,66,67769,13,353223
5153,0.001823,172.217.24.0-255,2902,70671,13,353223
5154,0.001826,172.31.36.0-255,66,70737,13,353223
5155,0.001838,172.217.24.0-255,5738,76475,13,353223
5156,0.001842,172.31.36.0-255,66,76541,13,353223
5157,0.00185,172.217.24.0-255,6797,83338,13,353223
5158,0.001853,172.31.36.0-255,66,83404,13,353223
5159,0.00189,172.217.24.0-255,9992,93396,13,353223
5160,0.001894,172.31.36.0-255,66,93462,13,353223
5161,0.001921,172.217.24.0-255,4320,97782,13,353223
5162,0.001924,172.31.36.0-255,66,97848,13,353223
5163,0.001929,172.217.24.0-255,2543,100391,13,353223
5164,0.001931,172.31.36.0-255,66,100457,13,353223
5165,0.002056,172.217.24.0-255,1484,101941,13,353223
5166,0.002065,172.217.24.0-255,2902,104843,13,353223
5167,0.002069,172.31.36.0-255,66,104909,13,353223
5168,0.002077,172.217.24.0-255,5738,110647,13,353223
5169,0.002079,172.31.36.0-255,66,110713,13,353223
5170,0.002088,172.217.24.0-255,1484,112197,13,353223
5171,0.002113,172.217.24.0-255,4712,116909,13,353223
5172,0.002116,172.31.36.0-255,66,116975,13,353223
5173,0.002271,172.217.24.0-255,1484,118459,13,353223
5174,0.002278,172.217.24.0-255,2902,121361,13,353223
5175,0.002281,172.31.36.0-255,66,121427,13,353223
5176,0.002316,172.217.24.0-255,5738,127165,13,353223
5177,0.002319,172.31.36.0-255,66,127231,13,353223
5178,0.002327,172.217.24.0-255,7156,134387,13,353223
5179,0.00233,172.31.36.0-255,66,134453,13,353223
5180,0.00238,172.217.24.0-255,405,134858,13,353223
5181,0.002517,172.217.24.0-255,1484,136342,13,353223
5182,0.002521,172.31.36.0-255,66,136408,13,353223
5183,0.002528,172.217.24.0-255,2902,139310,13,353223
5184,0.00253,172.31.36.0-255,66,139376,13,353223
5185,0.002542,172.217.24.0-255,5738,145114,13,353223
5186,0.002545,172.31.36.0-255,66,145180,13,353223
5187,0.002547,172.217.24.0-255,1484,146664,13,353223
5188,0.00258,172.217.24.0-255,9992,156656,13,353223
5189,0.002582,172.31.36.0-255,66,156722,13,353223
5190,0.002597,172.31.36.0-255,66,156788,13,353223
5191,0.002831,172.217.24.0-255,1484,158272,13,353223
5192,0.002838,172.217.24.0-255,2902,161174,13,353223
5193,0.002841,172.31.36.0-255,66,161240,13,353223
5194,0.002845,172.217.24.0-255,1484,162724,13,353223
5195,0.002876,172.217.24.0-255,4320,167044,13,353223
5196,0.002878,172.31.36.0-255,66,167110,13,353223
5197,0.002884,172.217.24.0-255,4320,171430,13,353223
5198,0.002886,172.31.36.0-255,66,171496,13,353223
5199,0.002893,172.217.24.0-255,5738,177234,13,353223
5200,0.002896,172.31.36.0-255,66,177300,13,353223
5201,0.002911,172.31.36.0-255,66,177366,13,353223
5202,0.002916,172.217.24.0-255,2184,179550,13,353223
5203,0.002918,172.31.36.0-255,66,179616,13,353223
5204,0.002921,172.217.24.0-255,1484,181100,13,353223
5205,0.002952,172.217.24.0-255,1484,182584,13,353223
5206,0.002956,172.31.36.0-255,66,182650,13,353223
5207,0.002964,172.217.24.0-255,7156,189806,13,353223
5208,0.002966,172.31.36.0-255,66,189872,13,353223
5209,0.002974,172.217.24.0-255,7156,197028,13,353223
5210,0.002977,172.31.36.0-255,66,197094,13,353223
5211,0.00302,172.217.24.0-255,4320,201414,13,353223
5212,0.003023,172.31.36.0-255,66,201480,13,353223
5213,0.003031,172.217.24.0-255,5738,207218,13,353223
5214,0.003034,172.31.36.0-255,66,207284,13,353223
5215,0.003041,172.217.24.0-255,6438,213722,13,353223
5216,0.003043,172.31.36.0-255,66,213788,13,353223
5217,0.003113,172.217.24.0-255,1484,215272,13,353223
5218,0.003131,172.217.24.0-255,2902,218174,13,353223
5219,0.003134,172.31.36.0-255,66,218240,13,353223
5220,0.00314,172.217.24.0-255,2902,221142,13,353223
5221,0.003142,172.31.36.0-255,66,221208,13,353223
5222,0.003167,172.217.24.0-255,1484,222692,13,353223
5223,0.003202,172.217.24.0-255,2902,225594,13,353223
5224,0.003206,172.31.36.0-255,66,225660,13,353223
5225,0.003238,172.217.24.0-255,5738,231398,13,353223
5226,0.003247,172.217.24.0-255,9992,241390,13,353223
5227,0.003255,172.217.24.0-255,6438,247828,13,353223
5228,0.003265,172.31.36.0-255,66,247894,13,353223
5229,0.003302,172.217.24.0-255,1484,249378,13,353223
5230,0.003316,172.217.24.0-255,1484,250862,13,353223
5231,0.003338,172.217.24.0-255,2902,253764,13,353223
5232,0.003353,172.217.24.0-255,5738,259502,13,353223
5233,0.003357,172.217.24.0-255,2902,262404,13,353223
5234,0.003372,172.217.24.0-255,4320,266724,13,353223
5235,0.003395,172.217.24.0-255,5738,272462,13,353223
5236,0.003435,172.217.24.0-255,8574,281036,13,353223
5237,0.003446,172.217.24.0-255,766,281802,13,353223
5238,0.00365,172.217.24.0-255,1484,283286,13,353223
5239,0.003667,172.217.24.0-255,2902,286188,13,353223
5240,0.0037,172.217.24.0-255,1484,287672,13,353223
5241,0.003713,172.217.24.0-255,2902,290574,13,353223
5242,0.003786,172.217.24.0-255,4320,294894,13,353223
5243,0.003797,172.217.24.0-255,1484,296378,13,353223
5244,0.003802,172.217.24.0-255,4320,300698,13,353223
5245,0.003807,172.217.24.0-255,5738,306436,13,353223
5246,0.003818,172.217.24.0-255,9274,315710,13,353223
5247,0.003832,172.217.24.0-255,1484,317194,13,353223
5248,0.003848,172.217.24.0-255,1484,318678,13,353223
5249,0.00387,172.217.24.0-255,1484,320162,13,353223
5250,0.003872,172.217.24.0-255,1484,321646,13,353223
5251,0.003878,172.217.24.0-255,4320,325966,13,353223
5252,0.00388,172.217.24.0-255,1484,327450,13,353223
5253,0.003898,172.217.24.0-255,5738,333188,13,353223
5254,0.003911,172.217.24.0-255,1484,334672,13,353223
5255,0.003932,172.217.24.0-255,2902,337574,13,353223
5256,0.00397,172.217.24.0-255,766,338340,13,353223
5257,0.003977,172.217.24.0-255,5738,344078,13,353223
5258,0.003987,172.217.24.0-255,1484,345562,13,353223
5259,0.003998,172.217.24.0-255,2315,347877,13,353223
5260,0.004009,172.217.24.0-255,97,347974,13,353223
5261,0.004043,172.217.24.0-255,105,348079,13,353223
5262,0.004134,172.31.36.0-255,66,348145,13,353223
5263,0.00414,172.31.36.0-255,66,348211,13,353223
5264,0.004145,172.31.36.0-255,66,348277,13,353223
5265,0.004155,172.31.36.0-255,66,348343,13,353223
5266,0.004159,172.31.36.0-255,66,348409,13,353223
5267,0.004163,172.31.36.0-255,66,348475,13,353223
5268,0.004167,172.31.36.0-255,66,348541,13,353223
5269,0.004171,172.31.36.0-255,66,348607,13,353223
5270,0.004173,172.31.36.0-255,66,348673,13,353223
5271,0.004177,172.31.36.0-255,66,348739,13,353223
5272,0.004181,172.31.36.0-255,66,348805,13,353223
5273,0.004185,172.31.36.0-255,66,348871,13,353223
5274,0.004188,172.31.36.0-255,66,348937,13,353223
5275,0.004191,172.31.36.0-255,66,349003,13,353223
5276,0.004195,172.31.36.0-255,66,349069,13,353223
5277,0.004198,172.31.36.0-255,66,349135,13,353223
5278,0.004202,172.31.36.0-255,66,349201,13,353223
5279,0.004205,172.31.36.0-255,66,349267,13,353223
5280,0.004208,172.31.36.0-255,66,349333,13,353223
5281,0.004212,172.31.36.0-255,66,349399,13,353223
5282,0.004216,172.31.36.0-255,66,349465,13,353223
5283,0.004219,172.31.36.0-255,66,349531,13,353223
5284,0.004222,172.31.36.0-255,66,349597,13,353223
5285,0.004225,172.31.36.0-255,66,349663,13,353223
5286,0.008716,172.31.36.0-255,66,349729,13,353223
5287,0.008772,172.31.36.0-255,105,349834,13,353223
5288,0.010765,172.217.24.0-255,66,349900,13,353223
5289,0.030886,172.31.36.0-255,172,350072,13,353223
5290,0.030919,172.31.36.0-255,1109,351181,13,353223
5291,0.030979,172.31.36.0-255,1514,352695,13,353223
5292,0.030981,172.31.36.0-255,330,353025,13,353223
5293,0.032647,104.244.42.0-255,66,353091,13,353223
5294,0.03268,104.244.42.0-255,66,353157,13,353223
5295,0.032721,104.244.42.0-255,66,353223,13,353223
5296,0.0,172.217.194.0-255,298,298,13,367013
5297,2.8e-05,172.31.36.0-255,66,364,13,367013
5298,3.3e-05,172.217.194.0-255,1484,1848,13,367013
5299,3.7e-05,172.31.36.0-255,66,1914,13,367013
5300,4.1e-05,172.217.194.0-255,1484,3398,13,367013
5301,4.3e-05,172.31.36.0-255,66,3464,13,367013
5302,5.9e-05,172.217.194.0-255,2902,6366,13,367013
5303,6.2e-05,172.31.36.0-255,66,6432,13,367013
5304,7.8e-05,172.217.194.0-255,1484,7916,13,367013
5305,8e-05,172.31.36.0-255,66,7982,13,367013
5306,0.000107,172.217.194.0-255,6192,14174,13,367013
5307,0.00011,172.31.36.0-255,66,14240,13,367013
5308,0.000129,172.217.194.0-255,1484,15724,13,367013
5309,0.000131,172.31.36.0-255,66,15790,13,367013
5310,0.000136,172.217.194.0-255,2902,18692,13,367013
5311,0.000138,172.31.36.0-255,66,18758,13,367013
5312,0.000142,172.217.194.0-255,2902,21660,13,367013
5313,0.000144,172.31.36.0-255,66,21726,13,367013
5314,0.000163,172.217.194.0-255,2902,24628,13,367013
5315,0.000165,172.31.36.0-255,66,24694,13,367013
5316,0.000217,172.217.194.0-255,5738,30432,13,367013
5317,0.000221,172.31.36.0-255,66,30498,13,367013
5318,0.000239,172.217.194.0-255,1125,31623,13,367013
5319,0.000241,172.31.36.0-255,66,31689,13,367013
5320,0.000466,172.217.194.0-255,1484,33173,13,367013
5321,0.000471,172.31.36.0-255,66,33239,13,367013
5322,0.000476,172.217.194.0-255,2902,36141,13,367013
5323,0.000479,172.31.36.0-255,66,36207,13,367013
5324,0.000519,172.217.194.0-255,5738,41945,13,367013
5325,0.000524,172.31.36.0-255,66,42011,13,367013
5326,0.000541,172.217.194.0-255,6797,48808,13,367013
5327,0.000545,172.31.36.0-255,66,48874,13,367013
5328,0.000946,172.217.194.0-255,1484,50358,13,367013
5329,0.000958,172.217.194.0-255,2902,53260,13,367013
5330,0.000962,172.31.36.0-255,66,53326,13,367013
5331,0.00097,172.217.194.0-255,5738,59064,13,367013
5332,0.001003,172.217.194.0-255,6797,65861,13,367013
5333,0.001032,172.31.36.0-255,66,65927,13,367013
5334,0.001042,172.217.194.0-255,7156,73083,13,367013
5335,0.001048,172.31.36.0-255,66,73149,13,367013
5336,0.001062,172.217.194.0-255,7156,80305,13,367013
5337,0.001084,172.217.194.0-255,4320,84625,13,367013
5338,0.001116,172.217.194.0-255,3125,87750,13,367013
5339,0.001144,172.31.36.0-255,66,87816,13,367013
5340,0.001847,172.217.194.0-255,1484,89300,13,367013
5341,0.001855,172.217.194.0-255,2902,92202,13,367013
5342,0.00186,172.31.36.0-255,66,92268,13,367013
5343,0.001865,172.217.194.0-255,2902,95170,13,367013
5344,0.001883,172.217.194.0-255,2902,98072,13,367013
5345,0.001889,172.217.194.0-255,4320,102392,13,367013
5346,0.001914,172.217.194.0-255,8574,110966,13,367013
5347,0.001919,172.217.194.0-255,2902,113868,13,367013
5348,0.001925,172.31.36.0-255,66,113934,13,367013
5349,0.001939,172.217.194.0-255,7856,121790,13,367013
5350,0.001944,172.31.36.0-255,66,121856,13,367013
5351,0.004003,172.217.194.0-255,5738,127594,13,367013
5352,0.004009,172.31.36.0-255,66,127660,13,367013
5353,0.006071,172.217.194.0-255,5738,133398,13,367013
5354,0.006077,172.31.36.0-255,66,133464,13,367013
5355,0.008135,172.217.194.0-255,5738,139202,13,367013
5356,0.008142,172.31.36.0-255,66,139268,13,367013
5357,0.010214,172.217.194.0-255,5738,145006,13,367013
5358,0.010222,172.31.36.0-255,66,145072,13,367013
5359,0.01229,172.217.194.0-255,5738,150810,13,367013
5360,0.012297,172.31.36.0-255,66,150876,13,367013
5361,0.014387,172.217.194.0-255,5738,156614,13,367013
5362,0.014394,172.31.36.0-255,66,156680,13,367013
5363,0.016451,172.217.194.0-255,5738,162418,13,367013
5364,0.016458,172.31.36.0-255,66,162484,13,367013
5365,0.018515,172.217.194.0-255,5738,168222,13,367013
5366,0.018522,172.31.36.0-255,66,168288,13,367013
5367,0.020582,172.217.194.0-255,5738,174026,13,367013
5368,0.02059,172.31.36.0-255,66,174092,13,367013
5369,0.022666,172.217.194.0-255,5738,179830,13,367013
5370,0.022677,172.31.36.0-255,66,179896,13,367013
5371,0.024735,172.217.194.0-255,5738,185634,13,367013
5372,0.024743,172.31.36.0-255,66,185700,13,367013
5373,0.026808,172.217.194.0-255,5738,191438,13,367013
5374,0.026964,172.31.36.0-255,66,191504,13,367013
5375,0.027377,172.31.36.0-255,172,191676,13,367013
5376,0.027405,172.31.36.0-255,1110,192786,13,367013
5377,0.027448,172.31.36.0-255,1514,194300,13,367013
5378,0.02745,172.31.36.0-255,1514,195814,13,367013
5379,0.027451,172.31.36.0-255,1514,197328,13,367013
5380,0.027452,172.31.36.0-255,1514,198842,13,367013
5381,0.027453,172.31.36.0-255,547,199389,13,367013
5382,0.028922,104.244.42.0-255,66,199455,13,367013
5383,0.028956,104.244.42.0-255,66,199521,13,367013
5384,0.029016,172.217.194.0-255,4320,203841,13,367013
5385,0.02902,172.31.36.0-255,66,203907,13,367013
5386,0.029048,172.217.194.0-255,1484,205391,13,367013
5387,0.029077,104.244.42.0-255,66,205457,13,367013
5388,0.029082,104.244.42.0-255,66,205523,13,367013
5389,0.031058,172.217.194.0-255,4320,209843,13,367013
5390,0.031064,172.31.36.0-255,66,209909,13,367013
5391,0.033137,172.217.194.0-255,5738,215647,13,367013
5392,0.033188,172.31.36.0-255,66,215713,13,367013
5393,0.035286,172.217.194.0-255,5738,221451,13,367013
5394,0.035291,172.31.36.0-255,66,221517,13,367013
5395,0.037336,172.217.194.0-255,5738,227255,13,367013
5396,0.037342,172.31.36.0-255,66,227321,13,367013
5397,0.039404,172.217.194.0-255,5738,233059,13,367013
5398,0.039409,172.31.36.0-255,66,233125,13,367013
5399,0.041474,172.217.194.0-255,5738,238863,13,367013
5400,0.04149,172.31.36.0-255,66,238929,13,367013
5401,0.043558,172.217.194.0-255,5738,244667,13,367013
5402,0.043565,172.31.36.0-255,66,244733,13,367013
5403,0.045633,172.217.194.0-255,5738,250471,13,367013
5404,0.045639,172.31.36.0-255,66,250537,13,367013
5405,0.047674,172.217.194.0-255,5738,256275,13,367013
5406,0.04768,172.31.36.0-255,66,256341,13,367013
5407,0.049744,172.217.194.0-255,4320,260661,13,367013
5408,0.049749,172.31.36.0-255,66,260727,13,367013
5409,0.049779,172.217.194.0-255,1484,262211,13,367013
5410,0.051806,172.217.194.0-255,4320,266531,13,367013
5411,0.051811,172.31.36.0-255,66,266597,13,367013
5412,0.053867,172.217.194.0-255,5738,272335,13,367013
5413,0.05392,172.31.36.0-255,66,272401,13,367013
5414,0.055973,172.217.194.0-255,5738,278139,13,367013
5415,0.055978,172.31.36.0-255,66,278205,13,367013
5416,0.058008,172.217.194.0-255,5738,283943,13,367013
5417,0.058013,172.31.36.0-255,66,284009,13,367013
5418,0.060062,172.217.194.0-255,4320,288329,13,367013
5419,0.060067,172.31.36.0-255,66,288395,13,367013
5420,0.060098,172.217.194.0-255,1484,289879,13,367013
5421,0.062109,172.217.194.0-255,4320,294199,13,367013
5422,0.062115,172.31.36.0-255,66,294265,13,367013
5423,0.064169,172.217.194.0-255,5738,300003,13,367013
5424,0.064232,172.31.36.0-255,66,300069,13,367013
5425,0.066286,172.217.194.0-255,5738,305807,13,367013
5426,0.066291,172.31.36.0-255,66,305873,13,367013
5427,0.06833,172.217.194.0-255,5738,311611,13,367013
5428,0.068335,172.31.36.0-255,66,311677,13,367013
5429,0.070395,172.217.194.0-255,5738,317415,13,367013
5430,0.0704,172.31.36.0-255,66,317481,13,367013
5431,0.07243,172.217.194.0-255,5738,323219,13,367013
5432,0.072435,172.31.36.0-255,66,323285,13,367013
5433,0.074491,172.217.194.0-255,4320,327605,13,367013
5434,0.074496,172.31.36.0-255,66,327671,13,367013
5435,0.074524,172.217.194.0-255,1484,329155,13,367013
5436,0.076572,172.217.194.0-255,4320,333475,13,367013
5437,0.076578,172.31.36.0-255,66,333541,13,367013
5438,0.078635,172.217.194.0-255,5738,339279,13,367013
5439,0.078684,172.31.36.0-255,66,339345,13,367013
5440,0.080731,172.217.194.0-255,5738,345083,13,367013
5441,0.080737,172.31.36.0-255,66,345149,13,367013
5442,0.082759,172.217.194.0-255,4320,349469,13,367013
5443,0.082764,172.31.36.0-255,66,349535,13,367013
5444,0.082793,172.217.194.0-255,1484,351019,13,367013
5445,0.084815,172.217.194.0-255,4320,355339,13,367013
5446,0.084821,172.31.36.0-255,66,355405,13,367013
5447,0.08688,172.217.194.0-255,5738,361143,13,367013
5448,0.086935,172.31.36.0-255,66,361209,13,367013
5449,0.088997,172.217.194.0-255,5738,366947,13,367013
5450,0.089002,172.31.36.0-255,66,367013,13,367013
5451,0.0,172.217.194.0-255,153,153,13,325648
5452,2.4e-05,172.31.36.0-255,66,219,13,325648
5453,3.1e-05,172.217.194.0-255,1484,1703,13,325648
5454,3.6e-05,172.31.36.0-255,66,1769,13,325648
5455,4.2e-05,172.217.194.0-255,2902,4671,13,325648
5456,4.5e-05,172.31.36.0-255,66,4737,13,325648
5457,5.3e-05,172.217.194.0-255,7156,11893,13,325648
5458,5.5e-05,172.31.36.0-255,66,11959,13,325648
5459,6e-05,172.217.194.0-255,2075,14034,13,325648
5460,6.2e-05,172.31.36.0-255,66,14100,13,325648
5461,0.000384,172.217.194.0-255,1484,15584,13,325648
5462,0.00039,172.31.36.0-255,66,15650,13,325648
5463,0.000397,172.217.194.0-255,2902,18552,13,325648
5464,0.000399,172.31.36.0-255,66,18618,13,325648
5465,0.000406,172.217.194.0-255,5738,24356,13,325648
5466,0.000409,172.31.36.0-255,66,24422,13,325648
5467,0.000414,172.217.194.0-255,2902,27324,13,325648
5468,0.000416,172.31.36.0-255,66,27390,13,325648
5469,0.000434,172.217.194.0-255,2902,30292,13,325648
5470,0.000437,172.31.36.0-255,66,30358,13,325648
5471,0.00046,172.217.194.0-255,1484,31842,13,325648
5472,0.000463,172.31.36.0-255,66,31908,13,325648
5473,0.000486,172.31.36.0-255,66,31974,13,325648
5474,0.000501,172.31.36.0-255,66,32040,13,325648
5475,0.000524,172.217.194.0-255,7018,39058,13,325648
5476,0.000527,172.31.36.0-255,66,39124,13,325648
5477,0.000551,172.217.194.0-255,2902,42026,13,325648
5478,0.000553,172.31.36.0-255,66,42092,13,325648
5479,0.000566,172.217.194.0-255,4320,46412,13,325648
5480,0.000569,172.31.36.0-255,66,46478,13,325648
5481,0.000574,172.217.194.0-255,2902,49380,13,325648
5482,0.000576,172.31.36.0-255,66,49446,13,325648
5483,0.000603,172.217.194.0-255,5738,55184,13,325648
5484,0.000606,172.31.36.0-255,66,55250,13,325648
5485,0.000615,172.217.194.0-255,8574,63824,13,325648
5486,0.000617,172.31.36.0-255,66,63890,13,325648
5487,0.000636,172.217.194.0-255,8574,72464,13,325648
5488,0.000638,172.31.36.0-255,66,72530,13,325648
5489,0.000641,172.217.194.0-255,766,73296,13,325648
5490,0.001203,172.31.36.0-255,101,73397,13,325648
5491,0.001604,172.217.194.0-255,1484,74881,13,325648
5492,0.001614,172.217.194.0-255,2902,77783,13,325648
5493,0.001617,172.31.36.0-255,66,77849,13,325648
5494,0.001638,172.217.194.0-255,2902,80751,13,325648
5495,0.001641,172.31.36.0-255,66,80817,13,325648
5496,0.001663,172.217.194.0-255,2902,83719,13,325648
5497,0.001666,172.31.36.0-255,66,83785,13,325648
5498,0.00167,172.217.194.0-255,2902,86687,13,325648
5499,0.001672,172.31.36.0-255,66,86753,13,325648
5500,0.001703,172.217.194.0-255,7156,93909,13,325648
5501,0.001706,172.31.36.0-255,66,93975,13,325648
5502,0.001719,172.31.36.0-255,66,94041,13,325648
5503,0.001735,172.217.194.0-255,2184,96225,13,325648
5504,0.001738,172.31.36.0-255,66,96291,13,325648
5505,0.002466,172.217.194.0-255,1484,97775,13,325648
5506,0.002475,172.217.194.0-255,2902,100677,13,325648
5507,0.002479,172.31.36.0-255,66,100743,13,325648
5508,0.002484,172.217.194.0-255,1484,102227,13,325648
5509,0.002502,172.217.194.0-255,4320,106547,13,325648
5510,0.002504,172.31.36.0-255,66,106613,13,325648
5511,0.002511,172.217.194.0-255,4320,110933,13,325648
5512,0.002513,172.31.36.0-255,66,110999,13,325648
5513,0.002528,172.217.194.0-255,1484,112483,13,325648
5514,0.002544,172.217.194.0-255,7156,119639,13,325648
5515,0.002547,172.31.36.0-255,66,119705,13,325648
5516,0.00257,172.217.194.0-255,2902,122607,13,325648
5517,0.002573,172.31.36.0-255,66,122673,13,325648
5518,0.002581,172.217.194.0-255,7856,130529,13,325648
5519,0.002583,172.31.36.0-255,66,130595,13,325648
5520,0.003824,172.217.194.0-255,66,130661,13,325648
5521,0.00526,172.217.194.0-255,5738,136399,13,325648
5522,0.005266,172.31.36.0-255,66,136465,13,325648
5523,0.007974,172.217.194.0-255,5738,142203,13,325648
5524,0.00798,172.31.36.0-255,66,142269,13,325648
5525,0.010667,172.217.194.0-255,5738,148007,13,325648
5526,0.010674,172.31.36.0-255,66,148073,13,325648
5527,0.013355,172.217.194.0-255,5738,153811,13,325648
5528,0.013366,172.31.36.0-255,66,153877,13,325648
5529,0.016056,172.217.194.0-255,5738,159615,13,325648
5530,0.016069,172.31.36.0-255,66,159681,13,325648
5531,0.018773,172.217.194.0-255,5738,165419,13,325648
5532,0.018788,172.31.36.0-255,66,165485,13,325648
5533,0.021492,172.217.194.0-255,5738,171223,13,325648
5534,0.021502,172.31.36.0-255,66,171289,13,325648
5535,0.024213,172.217.194.0-255,5738,177027,13,325648
5536,0.024225,172.31.36.0-255,66,177093,13,325648
5537,0.026915,172.217.194.0-255,5738,182831,13,325648
5538,0.026923,172.31.36.0-255,66,182897,13,325648
5539,0.029591,172.217.194.0-255,5738,188635,13,325648
5540,0.029604,172.31.36.0-255,66,188701,13,325648
5541,0.032261,172.217.194.0-255,5738,194439,13,325648
5542,0.032268,172.31.36.0-255,66,194505,13,325648
5543,0.034951,172.217.194.0-255,5738,200243,13,325648
5544,0.034959,172.31.36.0-255,66,200309,13,325648
5545,0.037643,172.217.194.0-255,5738,206047,13,325648
5546,0.037652,172.31.36.0-255,66,206113,13,325648
5547,0.038572,172.31.36.0-255,172,206285,13,325648
5548,0.038607,172.31.36.0-255,1110,207395,13,325648
5549,0.038675,172.31.36.0-255,1514,208909,13,325648
5550,0.038677,172.31.36.0-255,1514,210423,13,325648
5551,0.038682,172.31.36.0-255,1514,211937,13,325648
5552,0.038683,172.31.36.0-255,1514,213451,13,325648
5553,0.038712,172.31.36.0-255,1514,214965,13,325648
5554,0.038713,172.31.36.0-255,143,215108,13,325648
5555,0.040272,104.244.42.0-255,66,215174,13,325648
5556,0.040317,104.244.42.0-255,66,215240,13,325648
5557,0.040345,172.217.194.0-255,5738,220978,13,325648
5558,0.040352,172.31.36.0-255,66,221044,13,325648
5559,0.040387,104.244.42.0-255,66,221110,13,325648
5560,0.040416,104.244.42.0-255,66,221176,13,325648
5561,0.043042,172.217.194.0-255,5738,226914,13,325648
5562,0.043049,172.31.36.0-255,66,226980,13,325648
5563,0.045724,172.217.194.0-255,5738,232718,13,325648
5564,0.045731,172.31.36.0-255,66,232784,13,325648
5565,0.048423,172.217.194.0-255,5738,238522,13,325648
5566,0.048438,172.31.36.0-255,66,238588,13,325648
5567,0.051129,172.217.194.0-255,5738,244326,13,325648
5568,0.051139,172.31.36.0-255,66,244392,13,325648
5569,0.053844,172.217.194.0-255,5738,250130,13,325648
5570,0.053851,172.31.36.0-255,66,250196,13,325648
5571,0.05659,172.217.194.0-255,5738,255934,13,325648
5572,0.056597,172.31.36.0-255,66,256000,13,325648
5573,0.059292,172.217.194.0-255,5738,261738,13,325648
5574,0.059298,172.31.36.0-255,66,261804,13,325648
5575,0.061994,172.217.194.0-255,5738,267542,13,325648
5576,0.062002,172.31.36.0-255,66,267608,13,325648
5577,0.064692,172.217.194.0-255,5738,273346,13,325648
5578,0.064699,172.31.36.0-255,66,273412,13,325648
5579,0.067386,172.217.194.0-255,5738,279150,13,325648
5580,0.067392,172.31.36.0-255,66,279216,13,325648
5581,0.07011,172.217.194.0-255,5738,284954,13,325648
5582,0.070116,172.31.36.0-255,66,285020,13,325648
5583,0.072819,172.217.194.0-255,5738,290758,13,325648
5584,0.072826,172.31.36.0-255,66,290824,13,325648
5585,0.075526,172.217.194.0-255,5738,296562,13,325648
5586,0.075533,172.31.36.0-255,66,296628,13,325648
5587,0.078312,172.217.194.0-255,5738,302366,13,325648
5588,0.078319,172.31.36.0-255,66,302432,13,325648
5589,0.081006,172.217.194.0-255,5738,308170,13,325648
5590,0.081018,172.31.36.0-255,66,308236,13,325648
5591,0.083738,172.217.194.0-255,5738,313974,13,325648
5592,0.083745,172.31.36.0-255,66,314040,13,325648
5593,0.086471,172.217.194.0-255,5738,319778,13,325648
5594,0.086478,172.31.36.0-255,66,319844,13,325648
5595,0.089169,172.217.194.0-255,5738,325582,13,325648
5596,0.089176,172.31.36.0-255,66,325648,13,325648
5597,0.0,172.217.194.0-255,150,150,13,282580
5598,3.5e-05,172.31.36.0-255,66,216,13,282580
5599,4.2e-05,172.217.194.0-255,1484,1700,13,282580
5600,4.6e-05,172.31.36.0-255,66,1766,13,282580
5601,5.1e-05,172.217.194.0-255,2902,4668,13,282580
5602,5.3e-05,172.31.36.0-255,66,4734,13,282580
5603,6.1e-05,172.217.194.0-255,5738,10472,13,282580
5604,6.3e-05,172.31.36.0-255,66,10538,13,282580
5605,7.1e-05,172.217.194.0-255,8574,19112,13,282580
5606,7.3e-05,172.31.36.0-255,66,19178,13,282580
5607,0.000103,172.217.194.0-255,2048,21226,13,282580
5608,0.000106,172.31.36.0-255,66,21292,13,282580
5609,0.000117,172.217.194.0-255,9633,30925,13,282580
5610,0.000121,172.31.36.0-255,66,30991,13,282580
5611,0.000135,172.217.194.0-255,1484,32475,13,282580
5612,0.000137,172.31.36.0-255,66,32541,13,282580
5613,0.000161,172.217.194.0-255,4320,36861,13,282580
5614,0.000164,172.31.36.0-255,66,36927,13,282580
5615,0.000172,172.217.194.0-255,7156,44083,13,282580
5616,0.000174,172.31.36.0-255,66,44149,13,282580
5617,0.000179,172.217.194.0-255,3961,48110,13,282580
5618,0.000181,172.31.36.0-255,66,48176,13,282580
5619,0.000223,172.217.194.0-255,4320,52496,13,282580
5620,0.000226,172.31.36.0-255,66,52562,13,282580
5621,0.000229,172.217.194.0-255,1484,54046,13,282580
5622,0.000231,172.31.36.0-255,66,54112,13,282580
5623,0.000252,172.217.194.0-255,2902,57014,13,282580
5624,0.000255,172.31.36.0-255,66,57080,13,282580
5625,0.000288,172.217.194.0-255,1484,58564,13,282580
5626,0.00029,172.31.36.0-255,66,58630,13,282580
5627,0.000316,172.217.194.0-255,7108,65738,13,282580
5628,0.000318,172.31.36.0-255,66,65804,13,282580
5629,0.000638,172.217.194.0-255,366,66170,13,282580
5630,0.000818,172.217.194.0-255,1484,67654,13,282580
5631,0.000823,172.31.36.0-255,66,67720,13,282580
5632,0.000828,172.217.194.0-255,2902,70622,13,282580
5633,0.00083,172.31.36.0-255,66,70688,13,282580
5634,0.000844,172.217.194.0-255,2902,73590,13,282580
5635,0.000846,172.31.36.0-255,66,73656,13,282580
5636,0.000871,172.217.194.0-255,2902,76558,13,282580
5637,0.000879,172.31.36.0-255,66,76624,13,282580
5638,0.000907,172.31.36.0-255,66,76690,13,282580
5639,0.000916,172.217.194.0-255,9992,86682,13,282580
5640,0.000919,172.31.36.0-255,66,86748,13,282580
5641,0.000948,172.217.194.0-255,2902,89650,13,282580
5642,0.000951,172.31.36.0-255,66,89716,13,282580
5643,0.000975,172.31.36.0-255,66,89782,13,282580
5644,0.001219,172.217.194.0-255,1484,91266,13,282580
5645,0.001224,172.217.194.0-255,2902,94168,13,282580
5646,0.001227,172.31.36.0-255,66,94234,13,282580
5647,0.001232,172.217.194.0-255,2902,97136,13,282580
5648,0.001234,172.31.36.0-255,66,97202,13,282580
5649,0.00125,172.217.194.0-255,2902,100104,13,282580
5650,0.001253,172.31.36.0-255,66,100170,13,282580
5651,0.00126,172.217.194.0-255,6248,106418,13,282580
5652,0.001262,172.31.36.0-255,66,106484,13,282580
5653,0.001357,172.217.194.0-255,1484,107968,13,282580
5654,0.00136,172.217.194.0-255,1484,109452,13,282580
5655,0.001363,172.31.36.0-255,66,109518,13,282580
5656,0.001384,172.217.194.0-255,1484,111002,13,282580
5657,0.00139,172.217.194.0-255,5738,116740,13,282580
5658,0.001392,172.31.36.0-255,66,116806,13,282580
5659,0.001396,172.217.194.0-255,2902,119708,13,282580
5660,0.001398,172.31.36.0-255,66,119774,13,282580
5661,0.001422,172.217.194.0-255,9992,129766,13,282580
5662,0.001425,172.31.36.0-255,66,129832,13,282580
5663,0.001433,172.217.194.0-255,9992,139824,13,282580
5664,0.001435,172.31.36.0-255,66,139890,13,282580
5665,0.001457,172.217.194.0-255,766,140656,13,282580
5666,0.001519,172.217.194.0-255,1484,142140,13,282580
5667,0.001522,172.31.36.0-255,66,142206,13,282580
5668,0.001528,172.217.194.0-255,2902,145108,13,282580
5669,0.00153,172.31.36.0-255,66,145174,13,282580
5670,0.001545,172.217.194.0-255,5738,150912,13,282580
5671,0.001548,172.31.36.0-255,66,150978,13,282580
5672,0.001611,172.31.36.0-255,66,151044,13,282580
5673,0.00162,172.217.194.0-255,10692,161736,13,282580
5674,0.001622,172.31.36.0-255,66,161802,13,282580
5675,0.001691,172.217.194.0-255,1484,163286,13,282580
5676,0.001696,172.217.194.0-255,2902,166188,13,282580
5677,0.001699,172.31.36.0-255,66,166254,13,282580
5678,0.001725,172.217.194.0-255,5738,171992,13,282580
5679,0.001727,172.31.36.0-255,66,172058,13,282580
5680,0.001734,172.217.194.0-255,7156,179214,13,282580
5681,0.001736,172.31.36.0-255,66,179280,13,282580
5682,0.001749,172.217.194.0-255,2902,182182,13,282580
5683,0.001752,172.31.36.0-255,66,182248,13,282580
5684,0.001788,172.217.194.0-255,7156,189404,13,282580
5685,0.001791,172.31.36.0-255,66,189470,13,282580
5686,0.001813,172.217.194.0-255,6438,195908,13,282580
5687,0.001817,172.31.36.0-255,66,195974,13,282580
5688,0.001835,172.217.194.0-255,1484,197458,13,282580
5689,0.00184,172.217.194.0-255,2902,200360,13,282580
5690,0.001842,172.31.36.0-255,66,200426,13,282580
5691,0.001846,172.217.194.0-255,1484,201910,13,282580
5692,0.001865,172.217.194.0-255,4320,206230,13,282580
5693,0.001868,172.31.36.0-255,66,206296,13,282580
5694,0.001921,172.31.36.0-255,66,206362,13,282580
5695,0.001932,172.217.194.0-255,10692,217054,13,282580
5696,0.001935,172.31.36.0-255,66,217120,13,282580
5697,0.001998,172.217.194.0-255,1484,218604,13,282580
5698,0.002004,172.217.194.0-255,2902,221506,13,282580
5699,0.002007,172.31.36.0-255,66,221572,13,282580
5700,0.002028,172.217.194.0-255,5738,227310,13,282580
5701,0.002031,172.31.36.0-255,66,227376,13,282580
5702,0.002035,172.217.194.0-255,2902,230278,13,282580
5703,0.002037,172.31.36.0-255,66,230344,13,282580
5704,0.002056,172.217.194.0-255,4320,234664,13,282580
5705,0.002059,172.31.36.0-255,66,234730,13,282580
5706,0.002078,172.217.194.0-255,8574,243304,13,282580
5707,0.002081,172.31.36.0-255,66,243370,13,282580
5708,0.002103,172.217.194.0-255,5738,249108,13,282580
5709,0.002105,172.31.36.0-255,66,249174,13,282580
5710,0.002112,172.217.194.0-255,6438,255612,13,282580
5711,0.002114,172.31.36.0-255,66,255678,13,282580
5712,0.00215,172.31.36.0-255,66,255744,13,282580
5713,0.002177,172.217.194.0-255,7156,262900,13,282580
5714,0.002179,172.31.36.0-255,66,262966,13,282580
5715,0.002186,172.217.194.0-255,6438,269404,13,282580
5716,0.002188,172.31.36.0-255,66,269470,13,282580
5717,0.002214,172.217.194.0-255,1484,270954,13,282580
5718,0.002247,172.31.36.0-255,66,271020,13,282580
5719,0.002291,172.31.36.0-255,66,271086,13,282580
5720,0.002346,172.217.194.0-255,1484,272570,13,282580
5721,0.002352,172.217.194.0-255,2902,275472,13,282580
5722,0.002356,172.31.36.0-255,66,275538,13,282580
5723,0.002361,172.217.194.0-255,3038,278576,13,282580
5724,0.002364,172.31.36.0-255,66,278642,13,282580
5725,0.004641,172.217.194.0-255,105,278747,13,282580
5726,0.011378,172.31.36.0-255,105,278852,13,282580
5727,0.011483,172.31.36.0-255,66,278918,13,282580
5728,0.011508,172.31.36.0-255,105,279023,13,282580
5729,0.013403,157.240.13.0-255,105,279128,13,282580
5730,0.013419,172.31.36.0-255,66,279194,13,282580
5731,0.013802,172.217.194.0-255,66,279260,13,282580
5732,0.030712,172.31.36.0-255,167,279427,13,282580
5733,0.030748,172.31.36.0-255,1108,280535,13,282580
5734,0.030787,172.31.36.0-255,1514,282049,13,282580
5735,0.030788,172.31.36.0-255,333,282382,13,282580
5736,0.032255,104.244.42.0-255,66,282448,13,282580
5737,0.032295,104.244.42.0-255,66,282514,13,282580
5738,0.032318,104.244.42.0-255,66,282580,13,282580
5739,0.0,74.125.24.0-255,66,66,13,66
5740,0.0,74.125.24.0-255,153,153,13,330724
5741,2.4e-05,172.31.36.0-255,66,219,13,330724
5742,3.3e-05,74.125.24.0-255,1484,1703,13,330724
5743,3.7e-05,172.31.36.0-255,66,1769,13,330724
5744,5.1e-05,74.125.24.0-255,2902,4671,13,330724
5745,5.4e-05,172.31.36.0-255,66,4737,13,330724
5746,6e-05,74.125.24.0-255,4320,9057,13,330724
5747,6.3e-05,172.31.36.0-255,66,9123,13,330724
5748,9.8e-05,74.125.24.0-255,4847,13970,13,330724
5749,0.0001,172.31.36.0-255,66,14036,13,330724
5750,0.000215,74.125.24.0-255,1484,15520,13,330724
5751,0.000219,172.31.36.0-255,66,15586,13,330724
5752,0.000224,74.125.24.0-255,2902,18488,13,330724
5753,0.000226,172.31.36.0-255,66,18554,13,330724
5754,0.000261,74.125.24.0-255,5738,24292,13,330724
5755,0.000264,172.31.36.0-255,66,24358,13,330724
5756,0.000269,74.125.24.0-255,2902,27260,13,330724
5757,0.000271,172.31.36.0-255,66,27326,13,330724
5758,0.000293,74.125.24.0-255,3961,31287,13,330724
5759,0.000296,172.31.36.0-255,66,31353,13,330724
5760,0.000309,74.125.24.0-255,9992,41345,13,330724
5761,0.000312,172.31.36.0-255,66,41411,13,330724
5762,0.000337,74.125.24.0-255,4320,45731,13,330724
5763,0.000342,172.31.36.0-255,66,45797,13,330724
5764,0.000361,74.125.24.0-255,7156,52953,13,330724
5765,0.000363,172.31.36.0-255,66,53019,13,330724
5766,0.000377,172.31.36.0-255,66,53085,13,330724
5767,0.00038,74.125.24.0-255,400,53485,13,330724
5768,0.000382,172.31.36.0-255,66,53551,13,330724
5769,0.000403,74.125.24.0-255,109,53660,13,330724
5770,0.000405,172.31.36.0-255,66,53726,13,330724
5771,0.000672,74.125.24.0-255,1484,55210,13,330724
5772,0.00068,74.125.24.0-255,2902,58112,13,330724
5773,0.000683,172.31.36.0-255,66,58178,13,330724
5774,0.000691,74.125.24.0-255,5738,63916,13,330724
5775,0.000693,172.31.36.0-255,66,63982,13,330724
5776,0.000723,74.125.24.0-255,7156,71138,13,330724
5777,0.000726,172.31.36.0-255,66,71204,13,330724
5778,0.000733,74.125.24.0-255,5738,76942,13,330724
5779,0.000735,172.31.36.0-255,66,77008,13,330724
5780,0.00077,74.125.24.0-255,8574,85582,13,330724
5781,0.000773,172.31.36.0-255,66,85648,13,330724
5782,0.000777,74.125.24.0-255,2184,87832,13,330724
5783,0.00078,172.31.36.0-255,66,87898,13,330724
5784,0.000857,74.125.24.0-255,1484,89382,13,330724
5785,0.000875,74.125.24.0-255,2902,92284,13,330724
5786,0.000879,172.31.36.0-255,66,92350,13,330724
5787,0.000886,74.125.24.0-255,5738,98088,13,330724
5788,0.000889,172.31.36.0-255,66,98154,13,330724
5789,0.000902,74.125.24.0-255,5738,103892,13,330724
5790,0.000904,172.31.36.0-255,66,103958,13,330724
5791,0.00091,74.125.24.0-255,4320,108278,13,330724
5792,0.000912,172.31.36.0-255,66,108344,13,330724
5793,0.000942,74.125.24.0-255,2902,111246,13,330724
5794,0.000946,172.31.36.0-255,66,111312,13,330724
5795,0.000953,74.125.24.0-255,5738,117050,13,330724
5796,0.000956,172.31.36.0-255,66,117116,13,330724
5797,0.000993,74.125.24.0-255,5020,122136,13,330724
5798,0.001009,74.125.24.0-255,4320,126456,13,330724
5799,0.001014,172.31.36.0-255,66,126522,13,330724
5800,0.001017,172.31.36.0-255,66,126588,13,330724
5801,0.00102,172.31.36.0-255,66,126654,13,330724
5802,0.001056,172.31.36.0-255,66,126720,13,330724
5803,0.001061,74.125.24.0-255,3602,130322,13,330724
5804,0.001063,172.31.36.0-255,66,130388,13,330724
5805,0.001101,74.125.24.0-255,1749,132137,13,330724
5806,0.001104,172.31.36.0-255,66,132203,13,330724
5807,0.001109,74.125.24.0-255,2902,135105,13,330724
5808,0.001111,172.31.36.0-255,66,135171,13,330724
5809,0.001136,74.125.24.0-255,7156,142327,13,330724
5810,0.001138,172.31.36.0-255,66,142393,13,330724
5811,0.001145,74.125.24.0-255,5738,148131,13,330724
5812,0.001148,172.31.36.0-255,66,148197,13,330724
5813,0.001182,74.125.24.0-255,8574,156771,13,330724
5814,0.001185,172.31.36.0-255,66,156837,13,330724
5815,0.001195,74.125.24.0-255,7856,164693,13,330724
5816,0.001197,172.31.36.0-255,66,164759,13,330724
5817,0.001241,74.125.24.0-255,1484,166243,13,330724
5818,0.001245,74.125.24.0-255,1484,167727,13,330724
5819,0.001248,172.31.36.0-255,66,167793,13,330724
5820,0.001266,74.125.24.0-255,1484,169277,13,330724
5821,0.001268,74.125.24.0-255,1484,170761,13,330724
5822,0.001273,172.31.36.0-255,66,170827,13,330724
5823,0.001291,74.125.24.0-255,4320,175147,13,330724
5824,0.001294,172.31.36.0-255,66,175213,13,330724
5825,0.001319,74.125.24.0-255,4320,179533,13,330724
5826,0.001323,172.31.36.0-255,66,179599,13,330724
5827,0.001353,74.125.24.0-255,8574,188173,13,330724
5828,0.001356,172.31.36.0-255,66,188239,13,330724
5829,0.0014,74.125.24.0-255,5738,193977,13,330724
5830,0.001402,172.31.36.0-255,66,194043,13,330724
5831,0.001437,74.125.24.0-255,5020,199063,13,330724
5832,0.00144,172.31.36.0-255,66,199129,13,330724
5833,0.001468,172.31.36.0-255,66,199195,13,330724
5834,0.001477,74.125.24.0-255,9274,208469,13,330724
5835,0.001479,172.31.36.0-255,66,208535,13,330724
5836,0.001766,74.125.24.0-255,1484,210019,13,330724
5837,0.001772,74.125.24.0-255,2902,212921,13,330724
5838,0.001776,172.31.36.0-255,66,212987,13,330724
5839,0.001803,74.125.24.0-255,5738,218725,13,330724
5840,0.001807,74.125.24.0-255,2902,221627,13,330724
5841,0.001811,172.31.36.0-255,66,221693,13,330724
5842,0.001814,172.31.36.0-255,66,221759,13,330724
5843,0.001837,74.125.24.0-255,2902,224661,13,330724
5844,0.00184,172.31.36.0-255,66,224727,13,330724
5845,0.001864,74.125.24.0-255,7156,231883,13,330724
5846,0.001867,172.31.36.0-255,66,231949,13,330724
5847,0.001894,74.125.24.0-255,5738,237687,13,330724
5848,0.001898,172.31.36.0-255,66,237753,13,330724
5849,0.001904,74.125.24.0-255,4320,242073,13,330724
5850,0.001906,172.31.36.0-255,66,242139,13,330724
5851,0.001936,74.125.24.0-255,766,242905,13,330724
5852,0.001984,74.125.24.0-255,1484,244389,13,330724
5853,0.001988,172.31.36.0-255,66,244455,13,330724
5854,0.001993,74.125.24.0-255,2902,247357,13,330724
5855,0.001995,172.31.36.0-255,66,247423,13,330724
5856,0.002005,74.125.24.0-255,2902,250325,13,330724
5857,0.002008,172.31.36.0-255,66,250391,13,330724
5858,0.002031,74.125.24.0-255,2902,253293,13,330724
5859,0.002033,172.31.36.0-255,66,253359,13,330724
5860,0.002041,74.125.24.0-255,7156,260515,13,330724
5861,0.002043,172.31.36.0-255,66,260581,13,330724
5862,0.002078,74.125.24.0-255,5738,266319,13,330724
5863,0.002081,172.31.36.0-255,66,266385,13,330724
5864,0.002091,74.125.24.0-255,10692,277077,13,330724
5865,0.002094,172.31.36.0-255,66,277143,13,330724
5866,0.002686,74.125.24.0-255,1484,278627,13,330724
5867,0.002706,74.125.24.0-255,2902,281529,13,330724
5868,0.002709,172.31.36.0-255,66,281595,13,330724
5869,0.002715,74.125.24.0-255,2902,284497,13,330724
5870,0.002717,172.31.36.0-255,66,284563,13,330724
5871,0.002736,74.125.24.0-255,2902,287465,13,330724
5872,0.002738,172.31.36.0-255,66,287531,13,330724
5873,0.002767,74.125.24.0-255,4320,291851,13,330724
5874,0.00277,172.31.36.0-255,66,291917,13,330724
5875,0.002799,74.125.24.0-255,7156,299073,13,330724
5876,0.002801,172.31.36.0-255,66,299139,13,330724
5877,0.002811,74.125.24.0-255,8574,307713,13,330724
5878,0.002813,172.31.36.0-255,66,307779,13,330724
5879,0.002842,74.125.24.0-255,3602,311381,13,330724
5880,0.002845,172.31.36.0-255,66,311447,13,330724
5881,0.003022,74.125.24.0-255,1484,312931,13,330724
5882,0.003037,74.125.24.0-255,2902,315833,13,330724
5883,0.00304,172.31.36.0-255,66,315899,13,330724
5884,0.003077,74.125.24.0-255,5155,321054,13,330724
5885,0.00308,172.31.36.0-255,66,321120,13,330724
5886,0.003136,74.125.24.0-255,105,321225,13,330724
5887,0.0047,172.31.36.0-255,66,321291,13,330724
5888,0.004739,172.31.36.0-255,105,321396,13,330724
5889,0.007351,74.125.24.0-255,66,321462,13,330724
5890,0.039006,172.31.36.0-255,172,321634,13,330724
5891,0.039041,172.31.36.0-255,1106,322740,13,330724
5892,0.039124,172.31.36.0-255,1514,324254,13,330724
5893,0.039146,172.31.36.0-255,1514,325768,13,330724
5894,0.039149,172.31.36.0-255,1514,327282,13,330724
5895,0.039165,172.31.36.0-255,1514,328796,13,330724
5896,0.03917,172.31.36.0-255,1514,330310,13,330724
5897,0.039171,172.31.36.0-255,84,330394,13,330724
5898,0.040568,104.244.42.0-255,66,330460,13,330724
5899,0.040616,104.244.42.0-255,66,330526,13,330724
5900,0.040659,104.244.42.0-255,66,330592,13,330724
5901,0.040709,104.244.42.0-255,66,330658,13,330724
5902,0.040712,104.244.42.0-255,66,330724,13,330724
5903,0.0,172.217.194.0-255,153,153,13,278237
5904,2.9e-05,172.31.36.0-255,66,219,13,278237
5905,3.6e-05,172.217.194.0-255,1484,1703,13,278237
5906,4e-05,172.31.36.0-255,66,1769,13,278237
5907,4.4e-05,172.217.194.0-255,2902,4671,13,278237
5908,4.7e-05,172.31.36.0-255,66,4737,13,278237
5909,8e-05,172.217.194.0-255,7156,11893,13,278237
5910,8.3e-05,172.31.36.0-255,66,11959,13,278237
5911,8.8e-05,172.217.194.0-255,2028,13987,13,278237
5912,9e-05,172.31.36.0-255,66,14053,13,278237
5913,0.000125,172.217.194.0-255,1484,15537,13,278237
5914,0.000128,172.31.36.0-255,66,15603,13,278237
5915,0.000153,172.217.194.0-255,9992,25595,13,278237
5916,0.000156,172.31.36.0-255,66,25661,13,278237
5917,0.000161,172.217.194.0-255,4320,29981,13,278237
5918,0.000163,172.31.36.0-255,66,30047,13,278237
5919,0.000189,172.217.194.0-255,7156,37203,13,278237
5920,0.000192,172.31.36.0-255,66,37269,13,278237
5921,0.000207,172.217.194.0-255,9992,47261,13,278237
5922,0.00021,172.31.36.0-255,66,47327,13,278237
5923,0.000212,172.217.194.0-255,766,48093,13,278237
5924,0.000214,172.31.36.0-255,66,48159,13,278237
5925,0.004435,172.217.194.0-255,1484,49643,13,278237
5926,0.004442,172.31.36.0-255,66,49709,13,278237
5927,0.004461,172.217.194.0-255,2902,52611,13,278237
5928,0.004464,172.31.36.0-255,66,52677,13,278237
5929,0.004468,172.217.194.0-255,1484,54161,13,278237
5930,0.00447,172.31.36.0-255,66,54227,13,278237
5931,0.006533,172.217.194.0-255,1484,55711,13,278237
5932,0.00654,172.31.36.0-255,66,55777,13,278237
5933,0.006565,172.217.194.0-255,2902,58679,13,278237
5934,0.006569,172.31.36.0-255,66,58745,13,278237
5935,0.006602,172.217.194.0-255,1484,60229,13,278237
5936,0.008621,172.217.194.0-255,1484,61713,13,278237
5937,0.008628,172.31.36.0-255,66,61779,13,278237
5938,0.008652,172.217.194.0-255,2902,64681,13,278237
5939,0.008656,172.31.36.0-255,66,64747,13,278237
5940,0.01074,172.217.194.0-255,2902,67649,13,278237
5941,0.010747,172.31.36.0-255,66,67715,13,278237
5942,0.010817,172.217.194.0-255,2902,70617,13,278237
5943,0.010822,172.31.36.0-255,66,70683,13,278237
5944,0.012851,172.217.194.0-255,2902,73585,13,278237
5945,0.012858,172.31.36.0-255,66,73651,13,278237
5946,0.012934,172.217.194.0-255,2902,76553,13,278237
5947,0.012938,172.31.36.0-255,66,76619,13,278237
5948,0.014985,172.217.194.0-255,2902,79521,13,278237
5949,0.014993,172.31.36.0-255,66,79587,13,278237
5950,0.015019,172.217.194.0-255,2902,82489,13,278237
5951,0.015022,172.31.36.0-255,66,82555,13,278237
5952,0.017108,172.217.194.0-255,4320,86875,13,278237
5953,0.017117,172.31.36.0-255,66,86941,13,278237
5954,0.017139,172.217.194.0-255,1484,88425,13,278237
5955,0.019234,172.217.194.0-255,4320,92745,13,278237
5956,0.019241,172.31.36.0-255,66,92811,13,278237
5957,0.021398,172.217.194.0-255,5738,98549,13,278237
5958,0.021404,172.31.36.0-255,66,98615,13,278237
5959,0.023545,172.217.194.0-255,5738,104353,13,278237
5960,0.023553,172.31.36.0-255,66,104419,13,278237
5961,0.025742,172.217.194.0-255,5738,110157,13,278237
5962,0.025749,172.31.36.0-255,66,110223,13,278237
5963,0.026961,172.31.36.0-255,197,110420,13,278237
5964,0.027002,172.31.36.0-255,1110,111530,13,278237
5965,0.02708,172.31.36.0-255,1514,113044,13,278237
5966,0.027082,172.31.36.0-255,1295,114339,13,278237
5967,0.027857,172.217.194.0-255,5738,120077,13,278237
5968,0.027863,172.31.36.0-255,66,120143,13,278237
5969,0.028651,104.244.42.0-255,66,120209,13,278237
5970,0.028685,104.244.42.0-255,66,120275,13,278237
5971,0.028791,104.244.42.0-255,66,120341,13,278237
5972,0.029977,172.217.194.0-255,5738,126079,13,278237
5973,0.029982,172.31.36.0-255,66,126145,13,278237
5974,0.032089,172.217.194.0-255,5738,131883,13,278237
5975,0.032094,172.31.36.0-255,66,131949,13,278237
5976,0.034257,172.217.194.0-255,4320,136269,13,278237
5977,0.034262,172.31.36.0-255,66,136335,13,278237
5978,0.03429,172.217.194.0-255,1484,137819,13,278237
5979,0.0364,172.217.194.0-255,4320,142139,13,278237
5980,0.036405,172.31.36.0-255,66,142205,13,278237
5981,0.038533,172.217.194.0-255,5738,147943,13,278237
5982,0.038538,172.31.36.0-255,66,148009,13,278237
5983,0.040657,172.217.194.0-255,5738,153747,13,278237
5984,0.040663,172.31.36.0-255,66,153813,13,278237
5985,0.042837,172.217.194.0-255,5738,159551,13,278237
5986,0.042844,172.31.36.0-255,66,159617,13,278237
5987,0.044975,172.217.194.0-255,5738,165355,13,278237
5988,0.044982,172.31.36.0-255,66,165421,13,278237
5989,0.047065,172.217.194.0-255,5738,171159,13,278237
5990,0.04707,172.31.36.0-255,66,171225,13,278237
5991,0.049213,172.217.194.0-255,4320,175545,13,278237
5992,0.049218,172.31.36.0-255,66,175611,13,278237
5993,0.049243,172.217.194.0-255,1484,177095,13,278237
5994,0.051306,172.217.194.0-255,4320,181415,13,278237
5995,0.051313,172.31.36.0-255,66,181481,13,278237
5996,0.053429,172.217.194.0-255,4320,185801,13,278237
5997,0.053435,172.31.36.0-255,66,185867,13,278237
5998,0.053466,172.217.194.0-255,1484,187351,13,278237
5999,0.055528,172.217.194.0-255,4320,191671,13,278237
6000,0.055533,172.31.36.0-255,66,191737,13,278237
6001,0.057637,172.217.194.0-255,2902,194639,13,278237
6002,0.057642,172.31.36.0-255,66,194705,13,278237
6003,0.057673,172.217.194.0-255,2902,197607,13,278237
6004,0.057677,172.31.36.0-255,66,197673,13,278237
6005,0.059759,172.217.194.0-255,5738,203411,13,278237
6006,0.059764,172.31.36.0-255,66,203477,13,278237
6007,0.061906,172.217.194.0-255,5738,209215,13,278237
6008,0.061912,172.31.36.0-255,66,209281,13,278237
6009,0.064032,172.217.194.0-255,2902,212183,13,278237
6010,0.064037,172.31.36.0-255,66,212249,13,278237
6011,0.06407,172.217.194.0-255,2902,215151,13,278237
6012,0.064074,172.31.36.0-255,66,215217,13,278237
6013,0.066153,172.217.194.0-255,2902,218119,13,278237
6014,0.066159,172.31.36.0-255,66,218185,13,278237
6015,0.066194,172.217.194.0-255,2902,221087,13,278237
6016,0.066196,172.31.36.0-255,66,221153,13,278237
6017,0.06828,172.217.194.0-255,4320,225473,13,278237
6018,0.068286,172.31.36.0-255,66,225539,13,278237
6019,0.068314,172.217.194.0-255,1484,227023,13,278237
6020,0.070393,172.217.194.0-255,4320,231343,13,278237
6021,0.0704,172.31.36.0-255,66,231409,13,278237
6022,0.072559,172.217.194.0-255,4320,235729,13,278237
6023,0.072565,172.31.36.0-255,66,235795,13,278237
6024,0.072591,172.217.194.0-255,1484,237279,13,278237
6025,0.074687,172.217.194.0-255,4320,241599,13,278237
6026,0.074693,172.31.36.0-255,66,241665,13,278237
6027,0.076802,172.217.194.0-255,4320,245985,13,278237
6028,0.076808,172.31.36.0-255,66,246051,13,278237
6029,0.076836,172.217.194.0-255,1484,247535,13,278237
6030,0.078903,172.217.194.0-255,2902,250437,13,278237
6031,0.078909,172.31.36.0-255,66,250503,13,278237
6032,0.078936,172.217.194.0-255,1484,251987,13,278237
6033,0.081013,172.217.194.0-255,4320,256307,13,278237
6034,0.081019,172.31.36.0-255,66,256373,13,278237
6035,0.083129,172.217.194.0-255,4320,260693,13,278237
6036,0.083136,172.31.36.0-255,66,260759,13,278237
6037,0.083155,172.217.194.0-255,1484,262243,13,278237
6038,0.085259,172.217.194.0-255,4320,266563,13,278237
6039,0.085265,172.31.36.0-255,66,266629,13,278237
6040,0.087383,172.217.194.0-255,5738,272367,13,278237
6041,0.087389,172.31.36.0-255,66,272433,13,278237
6042,0.089482,172.217.194.0-255,5738,278171,13,278237
6043,0.089488,172.31.36.0-255,66,278237,13,278237
6044,0.0,172.217.27.0-255,149,149,13,366635
6045,2.6e-05,172.31.36.0-255,66,215,13,366635
6046,3.2e-05,172.217.27.0-255,1484,1699,13,366635
6047,3.7e-05,172.31.36.0-255,66,1765,13,366635
6048,4.9e-05,172.217.27.0-255,2902,4667,13,366635
6049,5.2e-05,172.31.36.0-255,66,4733,13,366635
6050,5.7e-05,172.217.27.0-255,4320,9053,13,366635
6051,6e-05,172.31.36.0-255,66,9119,13,366635
6052,6.6e-05,172.217.27.0-255,4847,13966,13,366635
6053,6.9e-05,172.31.36.0-255,66,14032,13,366635
6054,0.000173,172.217.27.0-255,1484,15516,13,366635
6055,0.000177,172.31.36.0-255,66,15582,13,366635
6056,0.000197,172.217.27.0-255,2902,18484,13,366635
6057,0.000199,172.31.36.0-255,66,18550,13,366635
6058,0.000206,172.217.27.0-255,5738,24288,13,366635
6059,0.000209,172.31.36.0-255,66,24354,13,366635
6060,0.000215,172.217.27.0-255,5738,30092,13,366635
6061,0.000217,172.31.36.0-255,66,30158,13,366635
6062,0.000247,172.217.27.0-255,1125,31283,13,366635
6063,0.00025,172.31.36.0-255,66,31349,13,366635
6064,0.000736,172.217.27.0-255,1484,32833,13,366635
6065,0.000742,172.31.36.0-255,66,32899,13,366635
6066,0.000751,172.217.27.0-255,2902,35801,13,366635
6067,0.000754,172.31.36.0-255,66,35867,13,366635
6068,0.000767,172.217.27.0-255,5738,41605,13,366635
6069,0.00077,172.31.36.0-255,66,41671,13,366635
6070,0.000817,172.31.36.0-255,66,41737,13,366635
6071,0.000825,172.217.27.0-255,8574,50311,13,366635
6072,0.000827,172.31.36.0-255,66,50377,13,366635
6073,0.000836,172.217.27.0-255,1125,51502,13,366635
6074,0.00084,172.31.36.0-255,66,51568,13,366635
6075,0.002512,172.217.27.0-255,5738,57306,13,366635
6076,0.002519,172.31.36.0-255,66,57372,13,366635
6077,0.004154,172.217.27.0-255,5738,63110,13,366635
6078,0.004159,172.31.36.0-255,66,63176,13,366635
6079,0.005794,172.217.27.0-255,5738,68914,13,366635
6080,0.005798,172.31.36.0-255,66,68980,13,366635
6081,0.007426,172.217.27.0-255,5738,74718,13,366635
6082,0.007433,172.31.36.0-255,66,74784,13,366635
6083,0.009066,172.217.27.0-255,5738,80522,13,366635
6084,0.009074,172.31.36.0-255,66,80588,13,366635
6085,0.010704,172.217.27.0-255,5738,86326,13,366635
6086,0.010711,172.31.36.0-255,66,86392,13,366635
6087,0.012352,172.217.27.0-255,5738,92130,13,366635
6088,0.01236,172.31.36.0-255,66,92196,13,366635
6089,0.013999,172.217.27.0-255,5738,97934,13,366635
6090,0.014007,172.31.36.0-255,66,98000,13,366635
6091,0.015637,172.217.27.0-255,5738,103738,13,366635
6092,0.015643,172.31.36.0-255,66,103804,13,366635
6093,0.017312,172.217.27.0-255,5738,109542,13,366635
6094,0.017319,172.31.36.0-255,66,109608,13,366635
6095,0.018951,172.217.27.0-255,5738,115346,13,366635
6096,0.018957,172.31.36.0-255,66,115412,13,366635
6097,0.020615,172.217.27.0-255,5738,121150,13,366635
6098,0.020622,172.31.36.0-255,66,121216,13,366635
6099,0.022258,172.217.27.0-255,5738,126954,13,366635
6100,0.022266,172.31.36.0-255,66,127020,13,366635
6101,0.0239,172.217.27.0-255,5738,132758,13,366635
6102,0.023907,172.31.36.0-255,66,132824,13,366635
6103,0.025552,172.217.27.0-255,5738,138562,13,366635
6104,0.025559,172.31.36.0-255,66,138628,13,366635
6105,0.027177,172.217.27.0-255,1484,140112,13,366635
6106,0.027214,172.217.27.0-255,4320,144432,13,366635
6107,0.027219,172.31.36.0-255,66,144498,13,366635
6108,0.028247,172.31.36.0-255,172,144670,13,366635
6109,0.028278,172.31.36.0-255,1106,145776,13,366635
6110,0.028312,172.31.36.0-255,1514,147290,13,366635
6111,0.028314,172.31.36.0-255,1299,148589,13,366635
6112,0.028865,172.217.27.0-255,5738,154327,13,366635
6113,0.028872,172.31.36.0-255,66,154393,13,366635
6114,0.029788,104.244.42.0-255,66,154459,13,366635
6115,0.029837,104.244.42.0-255,66,154525,13,366635
6116,0.029888,104.244.42.0-255,66,154591,13,366635
6117,0.030493,172.217.27.0-255,4320,158911,13,366635
6118,0.030497,172.31.36.0-255,66,158977,13,366635
6119,0.030527,172.217.27.0-255,1484,160461,13,366635
6120,0.03212,172.217.27.0-255,4320,164781,13,366635
6121,0.032125,172.31.36.0-255,66,164847,13,366635
6122,0.033756,172.217.27.0-255,5738,170585,13,366635
6123,0.033762,172.31.36.0-255,66,170651,13,366635
6124,0.03539,172.217.27.0-255,5738,176389,13,366635
6125,0.035395,172.31.36.0-255,66,176455,13,366635
6126,0.03702,172.217.27.0-255,4320,180775,13,366635
6127,0.037026,172.31.36.0-255,66,180841,13,366635
6128,0.037058,172.217.27.0-255,1484,182325,13,366635
6129,0.038659,172.217.27.0-255,4320,186645,13,366635
6130,0.038664,172.31.36.0-255,66,186711,13,366635
6131,0.040296,172.217.27.0-255,5738,192449,13,366635
6132,0.040302,172.31.36.0-255,66,192515,13,366635
6133,0.041929,172.217.27.0-255,5738,198253,13,366635
6134,0.041934,172.31.36.0-255,66,198319,13,366635
6135,0.043584,172.217.27.0-255,5738,204057,13,366635
6136,0.043591,172.31.36.0-255,66,204123,13,366635
6137,0.045225,172.217.27.0-255,5738,209861,13,366635
6138,0.045231,172.31.36.0-255,66,209927,13,366635
6139,0.046857,172.217.27.0-255,5738,215665,13,366635
6140,0.046862,172.31.36.0-255,66,215731,13,366635
6141,0.048491,172.217.27.0-255,5738,221469,13,366635
6142,0.048497,172.31.36.0-255,66,221535,13,366635
6143,0.050133,172.217.27.0-255,5738,227273,13,366635
6144,0.050138,172.31.36.0-255,66,227339,13,366635
6145,0.051767,172.217.27.0-255,5738,233077,13,366635
6146,0.051772,172.31.36.0-255,66,233143,13,366635
6147,0.05341,172.217.27.0-255,5738,238881,13,366635
6148,0.053416,172.31.36.0-255,66,238947,13,366635
6149,0.055075,172.217.27.0-255,5738,244685,13,366635
6150,0.055081,172.31.36.0-255,66,244751,13,366635
6151,0.056722,172.217.27.0-255,5738,250489,13,366635
6152,0.056728,172.31.36.0-255,66,250555,13,366635
6153,0.058361,172.217.27.0-255,5738,256293,13,366635
6154,0.058367,172.31.36.0-255,66,256359,13,366635
6155,0.060012,172.217.27.0-255,5738,262097,13,366635
6156,0.060018,172.31.36.0-255,66,262163,13,366635
6157,0.06165,172.217.27.0-255,5738,267901,13,366635
6158,0.061655,172.31.36.0-255,66,267967,13,366635
6159,0.063278,172.217.27.0-255,5738,273705,13,366635
6160,0.063284,172.31.36.0-255,66,273771,13,366635
6161,0.064913,172.217.27.0-255,5738,279509,13,366635
6162,0.064918,172.31.36.0-255,66,279575,13,366635
6163,0.066551,172.217.27.0-255,5738,285313,13,366635
6164,0.066557,172.31.36.0-255,66,285379,13,366635
6165,0.068189,172.217.27.0-255,5738,291117,13,366635
6166,0.068195,172.31.36.0-255,66,291183,13,366635
6167,0.069821,172.217.27.0-255,5738,296921,13,366635
6168,0.069827,172.31.36.0-255,66,296987,13,366635
6169,0.071493,172.217.27.0-255,5738,302725,13,366635
6170,0.071498,172.31.36.0-255,66,302791,13,366635
6171,0.073132,172.217.27.0-255,5738,308529,13,366635
6172,0.073137,172.31.36.0-255,66,308595,13,366635
6173,0.074769,172.217.27.0-255,5738,314333,13,366635
6174,0.07479,172.31.36.0-255,66,314399,13,366635
6175,0.076418,172.217.27.0-255,5738,320137,13,366635
6176,0.076424,172.31.36.0-255,66,320203,13,366635
6177,0.078059,172.217.27.0-255,5738,325941,13,366635
6178,0.078064,172.31.36.0-255,66,326007,13,366635
6179,0.079688,172.217.27.0-255,5738,331745,13,366635
6180,0.079695,172.31.36.0-255,66,331811,13,366635
6181,0.08133,172.217.27.0-255,5738,337549,13,366635
6182,0.081336,172.31.36.0-255,66,337615,13,366635
6183,0.082966,172.217.27.0-255,5738,343353,13,366635
6184,0.082971,172.31.36.0-255,66,343419,13,366635
6185,0.084605,172.217.27.0-255,5738,349157,13,366635
6186,0.08461,172.31.36.0-255,66,349223,13,366635
6187,0.086239,172.217.27.0-255,5738,354961,13,366635
6188,0.086245,172.31.36.0-255,66,355027,13,366635
6189,0.087885,172.217.27.0-255,5738,360765,13,366635
6190,0.087891,172.31.36.0-255,66,360831,13,366635
6191,0.089533,172.217.27.0-255,5738,366569,13,366635
6192,0.089539,172.31.36.0-255,66,366635,13,366635
6193,0.0,74.125.130.0-255,297,297,13,393202
6194,2.4e-05,172.31.36.0-255,66,363,13,393202
6195,3.2e-05,74.125.130.0-255,1484,1847,13,393202
6196,3.6e-05,172.31.36.0-255,66,1913,13,393202
6197,4.3e-05,74.125.130.0-255,2902,4815,13,393202
6198,4.6e-05,172.31.36.0-255,66,4881,13,393202
6199,5.3e-05,74.125.130.0-255,5738,10619,13,393202
6200,5.6e-05,172.31.36.0-255,66,10685,13,393202
6201,6.2e-05,74.125.130.0-255,3294,13979,13,393202
6202,6.5e-05,172.31.36.0-255,66,14045,13,393202
6203,8.6e-05,74.125.130.0-255,1484,15529,13,393202
6204,8.9e-05,172.31.36.0-255,66,15595,13,393202
6205,0.000106,74.125.130.0-255,2902,18497,13,393202
6206,0.000108,172.31.36.0-255,66,18563,13,393202
6207,0.000133,74.125.130.0-255,5738,24301,13,393202
6208,0.000135,172.31.36.0-255,66,24367,13,393202
6209,0.00014,74.125.130.0-255,2902,27269,13,393202
6210,0.000142,172.31.36.0-255,66,27335,13,393202
6211,0.000157,74.125.130.0-255,1484,28819,13,393202
6212,0.000159,172.31.36.0-255,66,28885,13,393202
6213,0.000175,74.125.130.0-255,4320,33205,13,393202
6214,0.000178,172.31.36.0-255,66,33271,13,393202
6215,0.000204,74.125.130.0-255,1484,34755,13,393202
6216,0.000207,172.31.36.0-255,66,34821,13,393202
6217,0.000212,74.125.130.0-255,4320,39141,13,393202
6218,0.000214,172.31.36.0-255,66,39207,13,393202
6219,0.000221,74.125.130.0-255,5738,44945,13,393202
6220,0.000223,172.31.36.0-255,66,45011,13,393202
6221,0.000244,74.125.130.0-255,3602,48613,13,393202
6222,0.000247,172.31.36.0-255,66,48679,13,393202
6223,0.000308,74.125.130.0-255,1484,50163,13,393202
6224,0.000311,172.31.36.0-255,66,50229,13,393202
6225,0.000315,74.125.130.0-255,1484,51713,13,393202
6226,0.000317,172.31.36.0-255,66,51779,13,393202
6227,0.00033,74.125.130.0-255,1484,53263,13,393202
6228,0.000332,172.31.36.0-255,66,53329,13,393202
6229,0.000339,74.125.130.0-255,4320,57649,13,393202
6230,0.000342,172.31.36.0-255,66,57715,13,393202
6231,0.000357,74.125.130.0-255,1484,59199,13,393202
6232,0.00036,172.31.36.0-255,66,59265,13,393202
6233,0.000364,74.125.130.0-255,2902,62167,13,393202
6234,0.000367,172.31.36.0-255,66,62233,13,393202
6235,0.00037,74.125.130.0-255,1484,63717,13,393202
6236,0.000371,172.31.36.0-255,66,63783,13,393202
6237,0.000387,74.125.130.0-255,2795,66578,13,393202
6238,0.00039,172.31.36.0-255,66,66644,13,393202
6239,0.00043,74.125.130.0-255,118,66762,13,393202
6240,0.000433,172.31.36.0-255,66,66828,13,393202
6241,0.000548,74.125.130.0-255,1484,68312,13,393202
6242,0.000552,172.31.36.0-255,66,68378,13,393202
6243,0.000575,74.125.130.0-255,2902,71280,13,393202
6244,0.000578,172.31.36.0-255,66,71346,13,393202
6245,0.000602,74.125.130.0-255,5738,77084,13,393202
6246,0.000607,74.125.130.0-255,2902,79986,13,393202
6247,0.00061,74.125.130.0-255,1484,81470,13,393202
6248,0.000625,74.125.130.0-255,2543,84013,13,393202
6249,0.000664,74.125.130.0-255,1484,85497,13,393202
6250,0.000678,74.125.130.0-255,2902,88399,13,393202
6251,0.000709,74.125.130.0-255,5738,94137,13,393202
6252,0.000713,74.125.130.0-255,2902,97039,13,393202
6253,0.000718,74.125.130.0-255,3961,101000,13,393202
6254,0.000746,172.31.36.0-255,66,101066,13,393202
6255,0.001326,74.125.130.0-255,1484,102550,13,393202
6256,0.001335,74.125.130.0-255,2902,105452,13,393202
6257,0.00134,172.31.36.0-255,66,105518,13,393202
6258,0.001364,74.125.130.0-255,5738,111256,13,393202
6259,0.001391,74.125.130.0-255,2902,114158,13,393202
6260,0.001411,74.125.130.0-255,4320,118478,13,393202
6261,0.001414,74.125.130.0-255,1484,119962,13,393202
6262,0.001429,74.125.130.0-255,2902,122864,13,393202
6263,0.001432,74.125.130.0-255,1484,124348,13,393202
6264,0.001455,74.125.130.0-255,4320,128668,13,393202
6265,0.001478,74.125.130.0-255,6438,135106,13,393202
6266,0.001587,74.125.130.0-255,1484,136590,13,393202
6267,0.001616,74.125.130.0-255,1484,138074,13,393202
6268,0.001643,74.125.130.0-255,2902,140976,13,393202
6269,0.001668,74.125.130.0-255,1484,142460,13,393202
6270,0.001678,74.125.130.0-255,1484,143944,13,393202
6271,0.001706,74.125.130.0-255,2902,146846,13,393202
6272,0.001713,74.125.130.0-255,4320,151166,13,393202
6273,0.001724,74.125.130.0-255,2902,154068,13,393202
6274,0.001762,74.125.130.0-255,1484,155552,13,393202
6275,0.00178,74.125.130.0-255,4320,159872,13,393202
6276,0.001788,74.125.130.0-255,7156,167028,13,393202
6277,0.001792,74.125.130.0-255,2184,169212,13,393202
6278,0.001956,74.125.130.0-255,1484,170696,13,393202
6279,0.001971,74.125.130.0-255,2902,173598,13,393202
6280,0.001974,74.125.130.0-255,1484,175082,13,393202
6281,0.001995,74.125.130.0-255,2902,177984,13,393202
6282,0.002012,74.125.130.0-255,4320,182304,13,393202
6283,0.002029,74.125.130.0-255,1484,183788,13,393202
6284,0.002033,74.125.130.0-255,2902,186690,13,393202
6285,0.002039,74.125.130.0-255,4320,191010,13,393202
6286,0.002056,74.125.130.0-255,1484,192494,13,393202
6287,0.002076,74.125.130.0-255,7156,199650,13,393202
6288,0.002082,74.125.130.0-255,3602,203252,13,393202
6289,0.00236,74.125.130.0-255,1484,204736,13,393202
6290,0.002378,74.125.130.0-255,2902,207638,13,393202
6291,0.00244,74.125.130.0-255,2902,210540,13,393202
6292,0.002465,74.125.130.0-255,2902,213442,13,393202
6293,0.002487,74.125.130.0-255,1484,214926,13,393202
6294,0.002492,74.125.130.0-255,2902,217828,13,393202
6295,0.002498,74.125.130.0-255,4320,222148,13,393202
6296,0.002521,74.125.130.0-255,7156,229304,13,393202
6297,0.002541,74.125.130.0-255,1484,230788,13,393202
6298,0.002546,74.125.130.0-255,2902,233690,13,393202
6299,0.002551,74.125.130.0-255,3602,237292,13,393202
6300,0.00642,172.31.36.0-255,66,237358,13,393202
6301,0.009019,74.125.130.0-255,5738,243096,13,393202
6302,0.009026,172.31.36.0-255,66,243162,13,393202
6303,0.011603,74.125.130.0-255,5738,248900,13,393202
6304,0.011611,172.31.36.0-255,66,248966,13,393202
6305,0.014187,74.125.130.0-255,5738,254704,13,393202
6306,0.014198,172.31.36.0-255,66,254770,13,393202
6307,0.016757,74.125.130.0-255,5738,260508,13,393202
6308,0.016765,172.31.36.0-255,66,260574,13,393202
6309,0.019344,74.125.130.0-255,5738,266312,13,393202
6310,0.019355,172.31.36.0-255,66,266378,13,393202
6311,0.021936,74.125.130.0-255,5738,272116,13,393202
6312,0.021948,172.31.36.0-255,66,272182,13,393202
6313,0.024512,74.125.130.0-255,5738,277920,13,393202
6314,0.02452,172.31.36.0-255,66,277986,13,393202
6315,0.02709,74.125.130.0-255,5738,283724,13,393202
6316,0.027098,172.31.36.0-255,66,283790,13,393202
6317,0.029675,74.125.130.0-255,5738,289528,13,393202
6318,0.029684,172.31.36.0-255,66,289594,13,393202
6319,0.032258,74.125.130.0-255,5738,295332,13,393202
6320,0.032267,172.31.36.0-255,66,295398,13,393202
6321,0.034843,74.125.130.0-255,5738,301136,13,393202
6322,0.034853,172.31.36.0-255,66,301202,13,393202
6323,0.037093,172.31.36.0-255,172,301374,13,393202
6324,0.037125,172.31.36.0-255,1111,302485,13,393202
6325,0.037225,172.31.36.0-255,1514,303999,13,393202
6326,0.037227,172.31.36.0-255,1514,305513,13,393202
6327,0.037229,172.31.36.0-255,1514,307027,13,393202
6328,0.037236,172.31.36.0-255,1514,308541,13,393202
6329,0.037237,172.31.36.0-255,1514,310055,13,393202
6330,0.037238,172.31.36.0-255,70,310125,13,393202
6331,0.037426,74.125.130.0-255,5738,315863,13,393202
6332,0.037432,172.31.36.0-255,66,315929,13,393202
6333,0.038656,104.244.42.0-255,66,315995,13,393202
6334,0.038754,104.244.42.0-255,66,316061,13,393202
6335,0.038798,104.244.42.0-255,66,316127,13,393202
6336,0.038803,104.244.42.0-255,66,316193,13,393202
6337,0.040028,74.125.130.0-255,5738,321931,13,393202
6338,0.040034,172.31.36.0-255,66,321997,13,393202
6339,0.042602,74.125.130.0-255,5738,327735,13,393202
6340,0.042612,172.31.36.0-255,66,327801,13,393202
6341,0.045179,74.125.130.0-255,5738,333539,13,393202
6342,0.045198,172.31.36.0-255,66,333605,13,393202
6343,0.047767,74.125.130.0-255,5738,339343,13,393202
6344,0.047773,172.31.36.0-255,66,339409,13,393202
6345,0.050371,74.125.130.0-255,5738,345147,13,393202
6346,0.050379,172.31.36.0-255,66,345213,13,393202
6347,0.052954,74.125.130.0-255,5738,350951,13,393202
6348,0.052966,172.31.36.0-255,66,351017,13,393202
6349,0.055545,74.125.130.0-255,5738,356755,13,393202
6350,0.055553,172.31.36.0-255,66,356821,13,393202
6351,0.058125,74.125.130.0-255,5738,362559,13,393202
6352,0.058132,172.31.36.0-255,66,362625,13,393202
6353,0.060719,74.125.130.0-255,5738,368363,13,393202
6354,0.060726,172.31.36.0-255,66,368429,13,393202
6355,0.06331,74.125.130.0-255,5738,374167,13,393202
6356,0.063317,172.31.36.0-255,66,374233,13,393202
6357,0.065892,74.125.130.0-255,5738,379971,13,393202
6358,0.065899,172.31.36.0-255,66,380037,13,393202
6359,0.068461,74.125.130.0-255,5738,385775,13,393202
6360,0.068467,172.31.36.0-255,66,385841,13,393202
6361,0.071055,74.125.130.0-255,5738,391579,13,393202
6362,0.071061,172.31.36.0-255,66,391645,13,393202
6363,0.073661,74.125.130.0-255,1320,392965,13,393202
6364,0.073803,172.31.36.0-255,66,393031,13,393202
6365,0.073841,172.31.36.0-255,105,393136,13,393202
6366,0.076372,74.125.130.0-255,66,393202,13,393202
6367,0.0,172.31.36.0-255,105,105,13,459
6368,0.000219,172.31.36.0-255,90,195,13,459
6369,0.000228,172.31.36.0-255,66,261,13,459
6370,0.002573,172.217.194.0-255,66,327,13,459
6371,0.002585,172.217.194.0-255,66,393,13,459
6372,0.002595,172.31.36.0-255,66,459,13,459
6373,0.0,74.125.24.0-255,185,185,13,231941
6374,2.9e-05,74.125.24.0-255,1484,1669,13,231941
6375,3.9e-05,172.31.36.0-255,66,1735,13,231941
6376,4.7e-05,74.125.24.0-255,2902,4637,13,231941
6377,5.1e-05,172.31.36.0-255,66,4703,13,231941
6378,5.5e-05,74.125.24.0-255,2902,7605,13,231941
6379,5.8e-05,172.31.36.0-255,66,7671,13,231941
6380,6.8e-05,74.125.24.0-255,10546,18217,13,231941
6381,7.1e-05,172.31.36.0-255,66,18283,13,231941
6382,0.000111,172.31.36.0-255,66,18349,13,231941
6383,0.000167,74.125.24.0-255,1484,19833,13,231941
6384,0.000171,74.125.24.0-255,1484,21317,13,231941
6385,0.000173,172.31.36.0-255,66,21383,13,231941
6386,0.000186,74.125.24.0-255,1484,22867,13,231941
6387,0.000195,74.125.24.0-255,5738,28605,13,231941
6388,0.000198,172.31.36.0-255,66,28671,13,231941
6389,0.000217,74.125.24.0-255,2902,31573,13,231941
6390,0.00022,172.31.36.0-255,66,31639,13,231941
6391,0.00025,172.31.36.0-255,66,31705,13,231941
6392,0.000257,74.125.24.0-255,7156,38861,13,231941
6393,0.00026,172.31.36.0-255,66,38927,13,231941
6394,0.000283,74.125.24.0-255,2883,41810,13,231941
6395,0.000285,172.31.36.0-255,66,41876,13,231941
6396,0.000309,74.125.24.0-255,346,42222,13,231941
6397,0.000645,74.125.24.0-255,1484,43706,13,231941
6398,0.000651,172.31.36.0-255,66,43772,13,231941
6399,0.000674,74.125.24.0-255,2902,46674,13,231941
6400,0.000678,172.31.36.0-255,66,46740,13,231941
6401,0.000684,74.125.24.0-255,5738,52478,13,231941
6402,0.000686,172.31.36.0-255,66,52544,13,231941
6403,0.000694,74.125.24.0-255,7156,59700,13,231941
6404,0.000697,172.31.36.0-255,66,59766,13,231941
6405,0.000726,74.125.24.0-255,5738,65504,13,231941
6406,0.000731,172.31.36.0-255,66,65570,13,231941
6407,0.000734,74.125.24.0-255,8574,74144,13,231941
6408,0.000736,172.31.36.0-255,66,74210,13,231941
6409,0.000752,74.125.24.0-255,2184,76394,13,231941
6410,0.000756,172.31.36.0-255,66,76460,13,231941
6411,0.000924,74.125.24.0-255,1484,77944,13,231941
6412,0.00093,74.125.24.0-255,2902,80846,13,231941
6413,0.000933,172.31.36.0-255,66,80912,13,231941
6414,0.000957,74.125.24.0-255,5738,86650,13,231941
6415,0.00096,172.31.36.0-255,66,86716,13,231941
6416,0.000966,74.125.24.0-255,4320,91036,13,231941
6417,0.000968,172.31.36.0-255,66,91102,13,231941
6418,0.000988,74.125.24.0-255,5738,96840,13,231941
6419,0.000992,172.31.36.0-255,66,96906,13,231941
6420,0.001025,74.125.24.0-255,7156,104062,13,231941
6421,0.001029,172.31.36.0-255,66,104128,13,231941
6422,0.00104,74.125.24.0-255,6438,110566,13,231941
6423,0.001043,172.31.36.0-255,66,110632,13,231941
6424,0.001114,74.125.24.0-255,1484,112116,13,231941
6425,0.001132,74.125.24.0-255,2902,115018,13,231941
6426,0.001136,172.31.36.0-255,66,115084,13,231941
6427,0.001142,74.125.24.0-255,2902,117986,13,231941
6428,0.001144,172.31.36.0-255,66,118052,13,231941
6429,0.00116,74.125.24.0-255,2902,120954,13,231941
6430,0.001163,172.31.36.0-255,66,121020,13,231941
6431,0.001171,74.125.24.0-255,7156,128176,13,231941
6432,0.001174,172.31.36.0-255,66,128242,13,231941
6433,0.001191,74.125.24.0-255,2902,131144,13,231941
6434,0.001194,172.31.36.0-255,66,131210,13,231941
6435,0.001249,74.125.24.0-255,1484,132694,13,231941
6436,0.001276,172.31.36.0-255,66,132760,13,231941
6437,0.001288,74.125.24.0-255,1484,134244,13,231941
6438,0.001292,74.125.24.0-255,2902,137146,13,231941
6439,0.001295,172.31.36.0-255,66,137212,13,231941
6440,0.001319,74.125.24.0-255,5738,142950,13,231941
6441,0.001322,172.31.36.0-255,66,143016,13,231941
6442,0.001329,74.125.24.0-255,7156,150172,13,231941
6443,0.001331,172.31.36.0-255,66,150238,13,231941
6444,0.001344,74.125.24.0-255,2902,153140,13,231941
6445,0.001347,172.31.36.0-255,66,153206,13,231941
6446,0.001382,74.125.24.0-255,4320,157526,13,231941
6447,0.001385,172.31.36.0-255,66,157592,13,231941
6448,0.001411,74.125.24.0-255,9274,166866,13,231941
6449,0.001414,172.31.36.0-255,66,166932,13,231941
6450,0.001576,74.125.24.0-255,1484,168416,13,231941
6451,0.001582,74.125.24.0-255,2902,171318,13,231941
6452,0.001585,172.31.36.0-255,66,171384,13,231941
6453,0.00161,74.125.24.0-255,5738,177122,13,231941
6454,0.001613,172.31.36.0-255,66,177188,13,231941
6455,0.001621,74.125.24.0-255,8574,185762,13,231941
6456,0.001624,172.31.36.0-255,66,185828,13,231941
6457,0.001641,74.125.24.0-255,4320,190148,13,231941
6458,0.001644,172.31.36.0-255,66,190214,13,231941
6459,0.001651,74.125.24.0-255,8574,198788,13,231941
6460,0.001654,172.31.36.0-255,66,198854,13,231941
6461,0.001691,74.125.24.0-255,7156,206010,13,231941
6462,0.001695,172.31.36.0-255,66,206076,13,231941
6463,0.001732,74.125.24.0-255,1484,207560,13,231941
6464,0.001735,172.31.36.0-255,66,207626,13,231941
6465,0.00179,172.31.36.0-255,66,207692,13,231941
6466,0.001797,74.125.24.0-255,5738,213430,13,231941
6467,0.0018,172.31.36.0-255,66,213496,13,231941
6468,0.001834,172.31.36.0-255,66,213562,13,231941
6469,0.001842,172.31.36.0-255,66,213628,13,231941
6470,0.001891,172.31.36.0-255,66,213694,13,231941
6471,0.0019,74.125.24.0-255,7856,221550,13,231941
6472,0.001903,172.31.36.0-255,66,221616,13,231941
6473,0.001976,172.31.36.0-255,66,221682,13,231941
6474,0.001989,172.31.36.0-255,66,221748,13,231941
6475,0.001992,74.125.24.0-255,105,221853,13,231941
6476,0.002016,74.125.24.0-255,129,221982,13,231941
6477,0.003402,172.31.36.0-255,105,222087,13,231941
6478,0.003431,172.31.36.0-255,105,222192,13,231941
6479,0.003656,172.31.36.0-255,90,222282,13,231941
6480,0.003666,172.31.36.0-255,66,222348,13,231941
6481,0.005661,74.125.24.0-255,66,222414,13,231941
6482,0.00567,74.125.24.0-255,66,222480,13,231941
6483,0.00585,74.125.24.0-255,66,222546,13,231941
6484,0.005869,74.125.24.0-255,66,222612,13,231941
6485,0.005875,172.31.36.0-255,66,222678,13,231941
6486,0.005922,74.125.24.0-255,66,222744,13,231941
6487,0.039154,172.31.36.0-255,172,222916,13,231941
6488,0.039184,172.31.36.0-255,1109,224025,13,231941
6489,0.039244,172.31.36.0-255,1514,225539,13,231941
6490,0.039246,172.31.36.0-255,1514,227053,13,231941
6491,0.039251,172.31.36.0-255,1514,228567,13,231941
6492,0.039252,172.31.36.0-255,1514,230081,13,231941
6493,0.039276,172.31.36.0-255,1514,231595,13,231941
6494,0.039277,172.31.36.0-255,82,231677,13,231941
6495,0.040633,104.244.42.0-255,66,231743,13,231941
6496,0.040665,104.244.42.0-255,66,231809,13,231941
6497,0.040755,104.244.42.0-255,66,231875,13,231941
6498,0.040768,104.244.42.0-255,66,231941,13,231941
6499,0.0,172.253.118.0-255,153,153,13,339638
6500,2.6e-05,172.31.36.0-255,66,219,13,339638
6501,3.2e-05,172.253.118.0-255,1484,1703,13,339638
6502,3.6e-05,172.31.36.0-255,66,1769,13,339638
6503,4.1e-05,172.253.118.0-255,2902,4671,13,339638
6504,5.1e-05,172.31.36.0-255,66,4737,13,339638
6505,5.9e-05,172.253.118.0-255,7156,11893,13,339638
6506,6.1e-05,172.31.36.0-255,66,11959,13,339638
6507,6.5e-05,172.253.118.0-255,2058,14017,13,339638
6508,6.7e-05,172.31.36.0-255,66,14083,13,339638
6509,0.000322,172.253.118.0-255,1484,15567,13,339638
6510,0.000327,172.31.36.0-255,66,15633,13,339638
6511,0.000333,172.253.118.0-255,2902,18535,13,339638
6512,0.000336,172.31.36.0-255,66,18601,13,339638
6513,0.000372,172.253.118.0-255,5738,24339,13,339638
6514,0.000376,172.31.36.0-255,66,24405,13,339638
6515,0.000383,172.253.118.0-255,5738,30143,13,339638
6516,0.000385,172.31.36.0-255,66,30209,13,339638
6517,0.000409,172.253.118.0-255,1125,31334,13,339638
6518,0.000412,172.31.36.0-255,66,31400,13,339638
6519,0.000601,172.253.118.0-255,1484,32884,13,339638
6520,0.000606,172.31.36.0-255,66,32950,13,339638
6521,0.000616,172.253.118.0-255,2902,35852,13,339638
6522,0.000618,172.31.36.0-255,66,35918,13,339638
6523,0.000633,172.253.118.0-255,5738,41656,13,339638
6524,0.000635,172.31.36.0-255,66,41722,13,339638
6525,0.000688,172.31.36.0-255,66,41788,13,339638
6526,0.000697,172.253.118.0-255,8574,50362,13,339638
6527,0.0007,172.31.36.0-255,66,50428,13,339638
6528,0.000737,172.253.118.0-255,1396,51824,13,339638
6529,0.00074,172.31.36.0-255,66,51890,13,339638
6530,0.000849,172.253.118.0-255,135,52025,13,339638
6531,0.000854,172.253.118.0-255,347,52372,13,339638
6532,0.001081,172.253.118.0-255,1484,53856,13,339638
6533,0.001087,172.31.36.0-255,66,53922,13,339638
6534,0.001096,172.253.118.0-255,2902,56824,13,339638
6535,0.001098,172.31.36.0-255,66,56890,13,339638
6536,0.001109,172.253.118.0-255,5738,62628,13,339638
6537,0.001112,172.31.36.0-255,66,62694,13,339638
6538,0.001144,172.253.118.0-255,8574,71268,13,339638
6539,0.001148,172.31.36.0-255,66,71334,13,339638
6540,0.001177,172.253.118.0-255,4320,75654,13,339638
6541,0.00118,172.31.36.0-255,66,75720,13,339638
6542,0.00119,172.253.118.0-255,10692,86412,13,339638
6543,0.001194,172.31.36.0-255,66,86478,13,339638
6544,0.001456,172.253.118.0-255,1484,87962,13,339638
6545,0.001462,172.253.118.0-255,2902,90864,13,339638
6546,0.001466,172.31.36.0-255,66,90930,13,339638
6547,0.001474,172.253.118.0-255,5738,96668,13,339638
6548,0.001476,172.31.36.0-255,66,96734,13,339638
6549,0.00148,172.253.118.0-255,2902,99636,13,339638
6550,0.001486,172.31.36.0-255,66,99702,13,339638
6551,0.00151,172.253.118.0-255,1484,101186,13,339638
6552,0.001522,172.31.36.0-255,66,101252,13,339638
6553,0.001568,172.253.118.0-255,7856,109108,13,339638
6554,0.001571,172.31.36.0-255,66,109174,13,339638
6555,0.001615,172.253.118.0-255,1484,110658,13,339638
6556,0.001635,172.253.118.0-255,2902,113560,13,339638
6557,0.001638,172.31.36.0-255,66,113626,13,339638
6558,0.001643,172.253.118.0-255,4320,117946,13,339638
6559,0.001645,172.31.36.0-255,66,118012,13,339638
6560,0.001671,172.253.118.0-255,1484,119496,13,339638
6561,0.001685,172.31.36.0-255,66,119562,13,339638
6562,0.001713,172.253.118.0-255,4320,123882,13,339638
6563,0.001716,172.31.36.0-255,66,123948,13,339638
6564,0.001743,172.253.118.0-255,6438,130386,13,339638
6565,0.001749,172.31.36.0-255,66,130452,13,339638
6566,0.001785,172.253.118.0-255,4320,134772,13,339638
6567,0.001788,172.31.36.0-255,66,134838,13,339638
6568,0.001793,172.253.118.0-255,4320,139158,13,339638
6569,0.001795,172.31.36.0-255,66,139224,13,339638
6570,0.001827,172.253.118.0-255,1484,140708,13,339638
6571,0.001841,172.31.36.0-255,66,140774,13,339638
6572,0.001846,172.253.118.0-255,4320,145094,13,339638
6573,0.001848,172.31.36.0-255,66,145160,13,339638
6574,0.001884,172.253.118.0-255,7856,153016,13,339638
6575,0.001888,172.31.36.0-255,66,153082,13,339638
6576,0.003935,172.253.118.0-255,5738,158820,13,339638
6577,0.003941,172.31.36.0-255,66,158886,13,339638
6578,0.005993,172.253.118.0-255,5738,164624,13,339638
6579,0.005998,172.31.36.0-255,66,164690,13,339638
6580,0.008048,172.253.118.0-255,5738,170428,13,339638
6581,0.008055,172.31.36.0-255,66,170494,13,339638
6582,0.010137,172.253.118.0-255,5738,176232,13,339638
6583,0.010144,172.31.36.0-255,66,176298,13,339638
6584,0.01219,172.253.118.0-255,5738,182036,13,339638
6585,0.012197,172.31.36.0-255,66,182102,13,339638
6586,0.014251,172.253.118.0-255,5738,187840,13,339638
6587,0.014257,172.31.36.0-255,66,187906,13,339638
6588,0.016324,172.253.118.0-255,4320,192226,13,339638
6589,0.01633,172.31.36.0-255,66,192292,13,339638
6590,0.016367,172.253.118.0-255,1484,193776,13,339638
6591,0.018361,172.253.118.0-255,4320,198096,13,339638
6592,0.018368,172.31.36.0-255,66,198162,13,339638
6593,0.02044,172.253.118.0-255,5738,203900,13,339638
6594,0.020447,172.31.36.0-255,66,203966,13,339638
6595,0.022491,172.253.118.0-255,5738,209704,13,339638
6596,0.022501,172.31.36.0-255,66,209770,13,339638
6597,0.02455,172.253.118.0-255,5738,215508,13,339638
6598,0.02456,172.31.36.0-255,66,215574,13,339638
6599,0.026621,172.253.118.0-255,5738,221312,13,339638
6600,0.026632,172.31.36.0-255,66,221378,13,339638
6601,0.02813,172.31.36.0-255,167,221545,13,339638
6602,0.028159,172.31.36.0-255,1106,222651,13,339638
6603,0.028216,172.31.36.0-255,1514,224165,13,339638
6604,0.028218,172.31.36.0-255,1299,225464,13,339638
6605,0.02868,172.253.118.0-255,5738,231202,13,339638
6606,0.028688,172.31.36.0-255,66,231268,13,339638
6607,0.029734,104.244.42.0-255,66,231334,13,339638
6608,0.029762,104.244.42.0-255,66,231400,13,339638
6609,0.029781,104.244.42.0-255,66,231466,13,339638
6610,0.030747,172.253.118.0-255,5738,237204,13,339638
6611,0.030752,172.31.36.0-255,66,237270,13,339638
6612,0.03253,104.244.42.0-255,108,237378,13,339638
6613,0.032539,172.31.36.0-255,66,237444,13,339638
6614,0.032799,172.253.118.0-255,5738,243182,13,339638
6615,0.032804,172.31.36.0-255,66,243248,13,339638
6616,0.03485,172.253.118.0-255,5738,248986,13,339638
6617,0.034856,172.31.36.0-255,66,249052,13,339638
6618,0.036908,172.253.118.0-255,5738,254790,13,339638
6619,0.036915,172.31.36.0-255,66,254856,13,339638
6620,0.038965,172.253.118.0-255,5738,260594,13,339638
6621,0.038971,172.31.36.0-255,66,260660,13,339638
6622,0.041039,172.253.118.0-255,5738,266398,13,339638
6623,0.041045,172.31.36.0-255,66,266464,13,339638
6624,0.043105,172.253.118.0-255,5738,272202,13,339638
6625,0.043112,172.31.36.0-255,66,272268,13,339638
6626,0.045164,172.253.118.0-255,5738,278006,13,339638
6627,0.045171,172.31.36.0-255,66,278072,13,339638
6628,0.047235,172.253.118.0-255,5738,283810,13,339638
6629,0.047242,172.31.36.0-255,66,283876,13,339638
6630,0.049303,172.253.118.0-255,5738,289614,13,339638
6631,0.04931,172.31.36.0-255,66,289680,13,339638
6632,0.051381,172.253.118.0-255,5738,295418,13,339638
6633,0.051388,172.31.36.0-255,66,295484,13,339638
6634,0.053449,172.253.118.0-255,5738,301222,13,339638
6635,0.053456,172.31.36.0-255,66,301288,13,339638
6636,0.055515,172.253.118.0-255,5738,307026,13,339638
6637,0.055521,172.31.36.0-255,66,307092,13,339638
6638,0.057587,172.253.118.0-255,5738,312830,13,339638
6639,0.057594,172.31.36.0-255,66,312896,13,339638
6640,0.059651,172.253.118.0-255,5738,318634,13,339638
6641,0.059657,172.31.36.0-255,66,318700,13,339638
6642,0.061726,172.253.118.0-255,5738,324438,13,339638
6643,0.061733,172.31.36.0-255,66,324504,13,339638
6644,0.063788,172.253.118.0-255,5738,330242,13,339638
6645,0.063795,172.31.36.0-255,66,330308,13,339638
6646,0.065856,172.253.118.0-255,5738,336046,13,339638
6647,0.065863,172.31.36.0-255,66,336112,13,339638
6648,0.067899,172.253.118.0-255,3289,339401,13,339638
6649,0.067905,172.31.36.0-255,66,339467,13,339638
6650,0.06807,172.31.36.0-255,105,339572,13,339638
6651,0.070089,172.253.118.0-255,66,339638,13,339638
6652,0.0,172.217.194.0-255,403,403,13,267104
6653,3e-05,172.217.194.0-255,1484,1887,13,267104
6654,4.2e-05,172.31.36.0-255,66,1953,13,267104
6655,5e-05,172.217.194.0-255,2902,4855,13,267104
6656,5.2e-05,172.31.36.0-255,66,4921,13,267104
6657,5.9e-05,172.217.194.0-255,5738,10659,13,267104
6658,7.2e-05,172.31.36.0-255,66,10725,13,267104
6659,0.000112,172.31.36.0-255,66,10791,13,267104
6660,0.000136,172.217.194.0-255,1991,12782,13,267104
6661,0.000139,172.31.36.0-255,66,12848,13,267104
6662,0.000154,172.31.36.0-255,66,12914,13,267104
6663,0.00018,172.217.194.0-255,1484,14398,13,267104
6664,0.000188,172.217.194.0-255,9274,23672,13,267104
6665,0.000191,172.31.36.0-255,66,23738,13,267104
6666,0.000262,172.217.194.0-255,1484,25222,13,267104
6667,0.000275,172.217.194.0-255,2902,28124,13,267104
6668,0.000278,172.31.36.0-255,66,28190,13,267104
6669,0.00031,172.217.194.0-255,4320,32510,13,267104
6670,0.000316,172.31.36.0-255,66,32576,13,267104
6671,0.000331,172.217.194.0-255,1484,34060,13,267104
6672,0.000353,172.217.194.0-255,7376,41436,13,267104
6673,0.000356,172.31.36.0-255,66,41502,13,267104
6674,0.000412,172.217.194.0-255,1484,42986,13,267104
6675,0.000417,172.217.194.0-255,1484,44470,13,267104
6676,0.000419,172.31.36.0-255,66,44536,13,267104
6677,0.000445,172.217.194.0-255,1484,46020,13,267104
6678,0.000454,172.217.194.0-255,5738,51758,13,267104
6679,0.000457,172.31.36.0-255,66,51824,13,267104
6680,0.000463,172.217.194.0-255,5738,57562,13,267104
6681,0.000466,172.31.36.0-255,66,57628,13,267104
6682,0.000505,172.31.36.0-255,66,57694,13,267104
6683,0.000515,172.217.194.0-255,10692,68386,13,267104
6684,0.000517,172.31.36.0-255,66,68452,13,267104
6685,0.000523,172.217.194.0-255,5738,74190,13,267104
6686,0.000526,172.31.36.0-255,66,74256,13,267104
6687,0.000567,172.217.194.0-255,5738,79994,13,267104
6688,0.000571,172.31.36.0-255,66,80060,13,267104
6689,0.000589,172.31.36.0-255,66,80126,13,267104
6690,0.000593,172.217.194.0-255,2902,83028,13,267104
6691,0.000597,172.31.36.0-255,66,83094,13,267104
6692,0.000635,172.217.194.0-255,4320,87414,13,267104
6693,0.000639,172.31.36.0-255,66,87480,13,267104
6694,0.000648,172.217.194.0-255,8574,96054,13,267104
6695,0.000651,172.31.36.0-255,66,96120,13,267104
6696,0.000667,172.31.36.0-255,66,96186,13,267104
6697,0.00067,172.217.194.0-255,218,96404,13,267104
6698,0.001005,172.217.194.0-255,1484,97888,13,267104
6699,0.00101,172.31.36.0-255,66,97954,13,267104
6700,0.001036,172.217.194.0-255,2902,100856,13,267104
6701,0.001039,172.31.36.0-255,66,100922,13,267104
6702,0.001046,172.217.194.0-255,5738,106660,13,267104
6703,0.001048,172.31.36.0-255,66,106726,13,267104
6704,0.001061,172.31.36.0-255,66,106792,13,267104
6705,0.001092,172.217.194.0-255,1484,108276,13,267104
6706,0.001101,172.217.194.0-255,9992,118268,13,267104
6707,0.001104,172.31.36.0-255,66,118334,13,267104
6708,0.001108,172.217.194.0-255,766,119100,13,267104
6709,0.001782,172.217.194.0-255,1484,120584,13,267104
6710,0.001787,172.31.36.0-255,66,120650,13,267104
6711,0.001792,172.217.194.0-255,2902,123552,13,267104
6712,0.001795,172.31.36.0-255,66,123618,13,267104
6713,0.001798,172.217.194.0-255,1484,125102,13,267104
6714,0.001827,172.217.194.0-255,4320,129422,13,267104
6715,0.00183,172.31.36.0-255,66,129488,13,267104
6716,0.001837,172.217.194.0-255,7156,136644,13,267104
6717,0.00184,172.31.36.0-255,66,136710,13,267104
6718,0.001844,172.217.194.0-255,2902,139612,13,267104
6719,0.001846,172.31.36.0-255,66,139678,13,267104
6720,0.001889,172.31.36.0-255,66,139744,13,267104
6721,0.001894,172.217.194.0-255,2184,141928,13,267104
6722,0.001902,172.31.36.0-255,66,141994,13,267104
6723,0.001989,172.217.194.0-255,1484,143478,13,267104
6724,0.002003,172.217.194.0-255,2902,146380,13,267104
6725,0.002006,172.31.36.0-255,66,146446,13,267104
6726,0.002013,172.217.194.0-255,5738,152184,13,267104
6727,0.002015,172.31.36.0-255,66,152250,13,267104
6728,0.002048,172.217.194.0-255,7156,159406,13,267104
6729,0.002051,172.31.36.0-255,66,159472,13,267104
6730,0.002064,172.217.194.0-255,7156,166628,13,267104
6731,0.002067,172.31.36.0-255,66,166694,13,267104
6732,0.002102,172.217.194.0-255,7156,173850,13,267104
6733,0.002106,172.217.194.0-255,2184,176034,13,267104
6734,0.002109,172.31.36.0-255,66,176100,13,267104
6735,0.002112,172.31.36.0-255,66,176166,13,267104
6736,0.002139,172.217.194.0-255,2902,179068,13,267104
6737,0.002142,172.31.36.0-255,66,179134,13,267104
6738,0.002153,172.217.194.0-255,4320,183454,13,267104
6739,0.002156,172.31.36.0-255,66,183520,13,267104
6740,0.002162,172.217.194.0-255,4320,187840,13,267104
6741,0.002164,172.31.36.0-255,66,187906,13,267104
6742,0.002199,172.217.194.0-255,2902,190808,13,267104
6743,0.002203,172.31.36.0-255,66,190874,13,267104
6744,0.002206,172.217.194.0-255,1484,192358,13,267104
6745,0.002211,172.217.194.0-255,4320,196678,13,267104
6746,0.002213,172.31.36.0-255,66,196744,13,267104
6747,0.002222,172.217.194.0-255,9992,206736,13,267104
6748,0.002224,172.31.36.0-255,66,206802,13,267104
6749,0.002229,172.217.194.0-255,3602,210404,13,267104
6750,0.002232,172.217.194.0-255,1484,211888,13,267104
6751,0.002236,172.31.36.0-255,66,211954,13,267104
6752,0.002269,172.217.194.0-255,1484,213438,13,267104
6753,0.002273,172.31.36.0-255,66,213504,13,267104
6754,0.002276,172.217.194.0-255,1484,214988,13,267104
6755,0.002279,172.217.194.0-255,1484,216472,13,267104
6756,0.002281,172.31.36.0-255,66,216538,13,267104
6757,0.002286,172.217.194.0-255,4320,220858,13,267104
6758,0.002288,172.31.36.0-255,66,220924,13,267104
6759,0.002298,172.217.194.0-255,9992,230916,13,267104
6760,0.002304,172.31.36.0-255,66,230982,13,267104
6761,0.00233,172.217.194.0-255,1484,232466,13,267104
6762,0.002333,172.217.194.0-255,1484,233950,13,267104
6763,0.002337,172.31.36.0-255,78,234028,13,267104
6764,0.002349,172.217.194.0-255,1484,235512,13,267104
6765,0.002352,172.31.36.0-255,66,235578,13,267104
6766,0.002355,172.217.194.0-255,4320,239898,13,267104
6767,0.002357,172.31.36.0-255,66,239964,13,267104
6768,0.002404,172.31.36.0-255,66,240030,13,267104
6769,0.002413,172.217.194.0-255,9992,250022,13,267104
6770,0.002416,172.31.36.0-255,66,250088,13,267104
6771,0.002419,172.217.194.0-255,1484,251572,13,267104
6772,0.002423,172.217.194.0-255,2184,253756,13,267104
6773,0.002425,172.31.36.0-255,66,253822,13,267104
6774,0.002427,172.217.194.0-255,1484,255306,13,267104
6775,0.002499,172.217.194.0-255,1484,256790,13,267104
6776,0.002504,172.31.36.0-255,66,256856,13,267104
6777,0.002511,172.217.194.0-255,5666,262522,13,267104
6778,0.002513,172.31.36.0-255,66,262588,13,267104
6779,0.002546,172.217.194.0-255,105,262693,13,267104
6780,0.003363,172.31.36.0-255,66,262759,13,267104
6781,0.003388,172.31.36.0-255,105,262864,13,267104
6782,0.005448,172.217.194.0-255,66,262930,13,267104
6783,0.025528,172.31.36.0-255,172,263102,13,267104
6784,0.025561,172.31.36.0-255,1109,264211,13,267104
6785,0.025598,172.31.36.0-255,1514,265725,13,267104
6786,0.025599,172.31.36.0-255,1181,266906,13,267104
6787,0.027227,104.244.42.0-255,66,266972,13,267104
6788,0.027235,104.244.42.0-255,66,267038,13,267104
6789,0.027267,104.244.42.0-255,66,267104,13,267104
6790,0.0,74.125.24.0-255,153,153,13,349959
6791,2.3e-05,172.31.36.0-255,66,219,13,349959
6792,3e-05,74.125.24.0-255,1484,1703,13,349959
6793,3.6e-05,172.31.36.0-255,66,1769,13,349959
6794,4.9e-05,74.125.24.0-255,2902,4671,13,349959
6795,5.3e-05,172.31.36.0-255,66,4737,13,349959
6796,6e-05,74.125.24.0-255,7156,11893,13,349959
6797,6.4e-05,172.31.36.0-255,66,11959,13,349959
6798,0.000104,74.125.24.0-255,10553,22512,13,349959
6799,0.000107,172.31.36.0-255,66,22578,13,349959
6800,0.000146,74.125.24.0-255,4320,26898,13,349959
6801,0.000149,172.31.36.0-255,66,26964,13,349959
6802,0.000176,74.125.24.0-255,3961,30925,13,349959
6803,0.000179,172.31.36.0-255,66,30991,13,349959
6804,0.000182,74.125.24.0-255,1484,32475,13,349959
6805,0.000184,172.31.36.0-255,66,32541,13,349959
6806,0.000189,74.125.24.0-255,2902,35443,13,349959
6807,0.000196,172.31.36.0-255,66,35509,13,349959
6808,0.000214,74.125.24.0-255,5738,41247,13,349959
6809,0.000218,172.31.36.0-255,66,41313,13,349959
6810,0.000238,74.125.24.0-255,1484,42797,13,349959
6811,0.000241,172.31.36.0-255,66,42863,13,349959
6812,0.00027,172.31.36.0-255,66,42929,13,349959
6813,0.000295,74.125.24.0-255,4320,47249,13,349959
6814,0.000298,172.31.36.0-255,66,47315,13,349959
6815,0.00033,74.125.24.0-255,5678,52993,13,349959
6816,0.000332,172.31.36.0-255,66,53059,13,349959
6817,0.000335,74.125.24.0-255,128,53187,13,349959
6818,0.000337,172.31.36.0-255,66,53253,13,349959
6819,0.00034,74.125.24.0-255,347,53600,13,349959
6820,0.000343,172.31.36.0-255,66,53666,13,349959
6821,0.000736,74.125.24.0-255,1484,55150,13,349959
6822,0.000744,74.125.24.0-255,2902,58052,13,349959
6823,0.000748,172.31.36.0-255,66,58118,13,349959
6824,0.000753,74.125.24.0-255,2902,61020,13,349959
6825,0.000755,172.31.36.0-255,66,61086,13,349959
6826,0.000778,74.125.24.0-255,2902,63988,13,349959
6827,0.00078,172.31.36.0-255,66,64054,13,349959
6828,0.000799,172.31.36.0-255,66,64120,13,349959
6829,0.000804,74.125.24.0-255,4320,68440,13,349959
6830,0.000807,172.31.36.0-255,66,68506,13,349959
6831,0.000841,74.125.24.0-255,5738,74244,13,349959
6832,0.000849,172.31.36.0-255,66,74310,13,349959
6833,0.000852,74.125.24.0-255,766,75076,13,349959
6834,0.001165,74.125.24.0-255,1484,76560,13,349959
6835,0.001171,172.31.36.0-255,66,76626,13,349959
6836,0.001178,74.125.24.0-255,2902,79528,13,349959
6837,0.001181,172.31.36.0-255,66,79594,13,349959
6838,0.001193,74.125.24.0-255,5738,85332,13,349959
6839,0.001196,172.31.36.0-255,66,85398,13,349959
6840,0.001203,74.125.24.0-255,5738,91136,13,349959
6841,0.001205,172.31.36.0-255,66,91202,13,349959
6842,0.001261,74.125.24.0-255,4320,95522,13,349959
6843,0.001264,172.31.36.0-255,66,95588,13,349959
6844,0.001301,74.125.24.0-255,8574,104162,13,349959
6845,0.001304,172.31.36.0-255,66,104228,13,349959
6846,0.001311,74.125.24.0-255,5020,109248,13,349959
6847,0.001313,172.31.36.0-255,66,109314,13,349959
6848,0.00133,74.125.24.0-255,1484,110798,13,349959
6849,0.001371,74.125.24.0-255,1484,112282,13,349959
6850,0.001375,172.31.36.0-255,66,112348,13,349959
6851,0.001378,74.125.24.0-255,1484,113832,13,349959
6852,0.0014,74.125.24.0-255,1484,115316,13,349959
6853,0.001402,172.31.36.0-255,66,115382,13,349959
6854,0.001409,74.125.24.0-255,4320,119702,13,349959
6855,0.001411,172.31.36.0-255,66,119768,13,349959
6856,0.001434,74.125.24.0-255,1484,121252,13,349959
6857,0.00144,74.125.24.0-255,4320,125572,13,349959
6858,0.001447,172.31.36.0-255,66,125638,13,349959
6859,0.001455,74.125.24.0-255,5738,131376,13,349959
6860,0.001457,172.31.36.0-255,66,131442,13,349959
6861,0.001485,74.125.24.0-255,5738,137180,13,349959
6862,0.001487,172.31.36.0-255,66,137246,13,349959
6863,0.001495,74.125.24.0-255,1484,138730,13,349959
6864,0.001523,74.125.24.0-255,5020,143750,13,349959
6865,0.001526,172.31.36.0-255,66,143816,13,349959
6866,0.00175,74.125.24.0-255,1484,145300,13,349959
6867,0.001758,74.125.24.0-255,2902,148202,13,349959
6868,0.001762,172.31.36.0-255,66,148268,13,349959
6869,0.001769,74.125.24.0-255,5738,154006,13,349959
6870,0.001772,172.31.36.0-255,66,154072,13,349959
6871,0.001804,74.125.24.0-255,5738,159810,13,349959
6872,0.001807,172.31.36.0-255,66,159876,13,349959
6873,0.001834,74.125.24.0-255,1484,161360,13,349959
6874,0.001848,172.31.36.0-255,66,161426,13,349959
6875,0.001876,74.125.24.0-255,3602,165028,13,349959
6876,0.001878,172.31.36.0-255,66,165094,13,349959
6877,0.002079,74.125.24.0-255,1484,166578,13,349959
6878,0.002082,74.125.24.0-255,1484,168062,13,349959
6879,0.002085,172.31.36.0-255,66,168128,13,349959
6880,0.002109,74.125.24.0-255,1484,169612,13,349959
6881,0.002113,74.125.24.0-255,1484,171096,13,349959
6882,0.002115,172.31.36.0-255,66,171162,13,349959
6883,0.002147,74.125.24.0-255,2902,174064,13,349959
6884,0.002149,172.31.36.0-255,66,174130,13,349959
6885,0.002156,74.125.24.0-255,5738,179868,13,349959
6886,0.002159,172.31.36.0-255,66,179934,13,349959
6887,0.002183,74.125.24.0-255,4320,184254,13,349959
6888,0.002186,172.31.36.0-255,66,184320,13,349959
6889,0.002213,74.125.24.0-255,5738,190058,13,349959
6890,0.002215,172.31.36.0-255,66,190124,13,349959
6891,0.002279,74.125.24.0-255,9274,199398,13,349959
6892,0.004172,172.31.36.0-255,66,199464,13,349959
6893,0.006783,74.125.24.0-255,5738,205202,13,349959
6894,0.00679,172.31.36.0-255,66,205268,13,349959
6895,0.009407,74.125.24.0-255,5738,211006,13,349959
6896,0.009416,172.31.36.0-255,66,211072,13,349959
6897,0.012066,74.125.24.0-255,5738,216810,13,349959
6898,0.012075,172.31.36.0-255,66,216876,13,349959
6899,0.014691,74.125.24.0-255,5738,222614,13,349959
6900,0.014702,172.31.36.0-255,66,222680,13,349959
6901,0.01733,74.125.24.0-255,5738,228418,13,349959
6902,0.017337,172.31.36.0-255,66,228484,13,349959
6903,0.019939,74.125.24.0-255,5738,234222,13,349959
6904,0.019946,172.31.36.0-255,66,234288,13,349959
6905,0.022556,74.125.24.0-255,5738,240026,13,349959
6906,0.022564,172.31.36.0-255,66,240092,13,349959
6907,0.025182,74.125.24.0-255,5738,245830,13,349959
6908,0.02519,172.31.36.0-255,66,245896,13,349959
6909,0.027819,74.125.24.0-255,5738,251634,13,349959
6910,0.027827,172.31.36.0-255,66,251700,13,349959
6911,0.02828,172.31.36.0-255,172,251872,13,349959
6912,0.028313,172.31.36.0-255,1106,252978,13,349959
6913,0.028374,172.31.36.0-255,1514,254492,13,349959
6914,0.028376,172.31.36.0-255,1299,255791,13,349959
6915,0.029802,104.244.42.0-255,66,255857,13,349959
6916,0.029844,104.244.42.0-255,66,255923,13,349959
6917,0.029936,104.244.42.0-255,66,255989,13,349959
6918,0.030438,74.125.24.0-255,5738,261727,13,349959
6919,0.030444,172.31.36.0-255,66,261793,13,349959
6920,0.033041,74.125.24.0-255,5738,267531,13,349959
6921,0.033048,172.31.36.0-255,66,267597,13,349959
6922,0.035671,74.125.24.0-255,5738,273335,13,349959
6923,0.03568,172.31.36.0-255,66,273401,13,349959
6924,0.038304,74.125.24.0-255,5738,279139,13,349959
6925,0.038311,172.31.36.0-255,66,279205,13,349959
6926,0.040917,74.125.24.0-255,5738,284943,13,349959
6927,0.040927,172.31.36.0-255,66,285009,13,349959
6928,0.04359,74.125.24.0-255,5738,290747,13,349959
6929,0.043596,172.31.36.0-255,66,290813,13,349959
6930,0.046219,74.125.24.0-255,5738,296551,13,349959
6931,0.046226,172.31.36.0-255,66,296617,13,349959
6932,0.048846,74.125.24.0-255,5738,302355,13,349959
6933,0.048853,172.31.36.0-255,66,302421,13,349959
6934,0.051477,74.125.24.0-255,5738,308159,13,349959
6935,0.051484,172.31.36.0-255,66,308225,13,349959
6936,0.054091,74.125.24.0-255,5738,313963,13,349959
6937,0.054097,172.31.36.0-255,66,314029,13,349959
6938,0.056709,74.125.24.0-255,5738,319767,13,349959
6939,0.056718,172.31.36.0-255,66,319833,13,349959
6940,0.059334,74.125.24.0-255,5738,325571,13,349959
6941,0.059341,172.31.36.0-255,66,325637,13,349959
6942,0.061978,74.125.24.0-255,5738,331375,13,349959
6943,0.061984,172.31.36.0-255,66,331441,13,349959
6944,0.064599,74.125.24.0-255,5738,337179,13,349959
6945,0.064606,172.31.36.0-255,66,337245,13,349959
6946,0.067239,74.125.24.0-255,5738,342983,13,349959
6947,0.067246,172.31.36.0-255,66,343049,13,349959
6948,0.069866,74.125.24.0-255,5738,348787,13,349959
6949,0.069874,172.31.36.0-255,66,348853,13,349959
6950,0.072472,74.125.24.0-255,869,349722,13,349959
6951,0.072596,172.31.36.0-255,66,349788,13,349959
6952,0.072633,172.31.36.0-255,105,349893,13,349959
6953,0.075219,74.125.24.0-255,66,349959,13,349959
6954,0.0,74.125.24.0-255,295,295,13,357094
6955,2.3e-05,172.31.36.0-255,66,361,13,357094
6956,2.9e-05,74.125.24.0-255,1484,1845,13,357094
6957,3.4e-05,172.31.36.0-255,66,1911,13,357094
6958,6.3e-05,74.125.24.0-255,4320,6231,13,357094
6959,6.5e-05,172.31.36.0-255,66,6297,13,357094
6960,9.2e-05,74.125.24.0-255,7528,13825,13,357094
6961,9.5e-05,172.31.36.0-255,66,13891,13,357094
6962,0.000123,74.125.24.0-255,4320,18211,13,357094
6963,0.000126,172.31.36.0-255,66,18277,13,357094
6964,0.000131,74.125.24.0-255,2902,21179,13,357094
6965,0.000133,172.31.36.0-255,66,21245,13,357094
6966,0.000154,74.125.24.0-255,2902,24147,13,357094
6967,0.00016,172.31.36.0-255,66,24213,13,357094
6968,0.000188,74.125.24.0-255,6797,31010,13,357094
6969,0.000193,172.31.36.0-255,66,31076,13,357094
6970,0.000465,74.125.24.0-255,1484,32560,13,357094
6971,0.00047,172.31.36.0-255,66,32626,13,357094
6972,0.000475,74.125.24.0-255,2902,35528,13,357094
6973,0.000477,172.31.36.0-255,66,35594,13,357094
6974,0.000482,74.125.24.0-255,2902,38496,13,357094
6975,0.000484,172.31.36.0-255,66,38562,13,357094
6976,0.000511,74.125.24.0-255,2902,41464,13,357094
6977,0.000515,172.31.36.0-255,66,41530,13,357094
6978,0.000535,172.31.36.0-255,66,41596,13,357094
6979,0.000541,74.125.24.0-255,5738,47334,13,357094
6980,0.000544,172.31.36.0-255,66,47400,13,357094
6981,0.000574,74.125.24.0-255,3961,51361,13,357094
6982,0.000583,172.31.36.0-255,66,51427,13,357094
6983,0.000587,74.125.24.0-255,362,51789,13,357094
6984,0.00059,172.31.36.0-255,66,51855,13,357094
6985,0.000612,74.125.24.0-255,130,51985,13,357094
6986,0.000632,74.125.24.0-255,347,52332,13,357094
6987,0.000824,172.31.36.0-255,66,52398,13,357094
6988,0.001054,74.125.24.0-255,1484,53882,13,357094
6989,0.001064,74.125.24.0-255,2902,56784,13,357094
6990,0.001068,74.125.24.0-255,1484,58268,13,357094
6991,0.001083,74.125.24.0-255,4320,62588,13,357094
6992,0.001089,74.125.24.0-255,5738,68326,13,357094
6993,0.001109,74.125.24.0-255,1484,69810,13,357094
6994,0.001122,74.125.24.0-255,5738,75548,13,357094
6995,0.001144,74.125.24.0-255,5738,81286,13,357094
6996,0.001165,74.125.24.0-255,5020,86306,13,357094
6997,0.001252,74.125.24.0-255,1484,87790,13,357094
6998,0.00127,74.125.24.0-255,2902,90692,13,357094
6999,0.001274,74.125.24.0-255,4320,95012,13,357094
7000,0.001294,74.125.24.0-255,1484,96496,13,357094
7001,0.001299,74.125.24.0-255,4320,100816,13,357094
7002,0.001351,74.125.24.0-255,7156,107972,13,357094
7003,0.001372,74.125.24.0-255,4320,112292,13,357094
7004,0.001381,74.125.24.0-255,7856,120148,13,357094
7005,0.001398,74.125.24.0-255,1484,121632,13,357094
7006,0.001402,74.125.24.0-255,2902,124534,13,357094
7007,0.001406,74.125.24.0-255,1484,126018,13,357094
7008,0.001423,74.125.24.0-255,4320,130338,13,357094
7009,0.001428,74.125.24.0-255,2902,133240,13,357094
7010,0.00145,74.125.24.0-255,9992,143232,13,357094
7011,0.00146,74.125.24.0-255,8574,151806,13,357094
7012,0.001475,74.125.24.0-255,1484,153290,13,357094
7013,0.001491,74.125.24.0-255,766,154056,13,357094
7014,0.00185,74.125.24.0-255,1484,155540,13,357094
7015,0.001857,74.125.24.0-255,2902,158442,13,357094
7016,0.001862,74.125.24.0-255,2902,161344,13,357094
7017,0.00188,74.125.24.0-255,2902,164246,13,357094
7018,0.001886,74.125.24.0-255,7156,171402,13,357094
7019,0.001911,74.125.24.0-255,5738,177140,13,357094
7020,0.001919,74.125.24.0-255,10692,187832,13,357094
7021,0.001996,74.125.24.0-255,1484,189316,13,357094
7022,0.002013,74.125.24.0-255,2902,192218,13,357094
7023,0.002015,74.125.24.0-255,1484,193702,13,357094
7024,0.002033,74.125.24.0-255,4320,198022,13,357094
7025,0.002057,74.125.24.0-255,9992,208014,13,357094
7026,0.002071,74.125.24.0-255,2902,210916,13,357094
7027,0.002077,74.125.24.0-255,7156,218072,13,357094
7028,0.002097,74.125.24.0-255,3602,221674,13,357094
7029,0.002122,74.125.24.0-255,2902,224576,13,357094
7030,0.002183,74.125.24.0-255,8574,233150,13,357094
7031,0.002191,74.125.24.0-255,7856,241006,13,357094
7032,0.002213,74.125.24.0-255,1484,242490,13,357094
7033,0.002235,74.125.24.0-255,2902,245392,13,357094
7034,0.002239,74.125.24.0-255,2902,248294,13,357094
7035,0.002257,74.125.24.0-255,2902,251196,13,357094
7036,0.002263,74.125.24.0-255,5738,256934,13,357094
7037,0.00228,74.125.24.0-255,2902,259836,13,357094
7038,0.002285,74.125.24.0-255,5738,265574,13,357094
7039,0.002303,74.125.24.0-255,4320,269894,13,357094
7040,0.002309,74.125.24.0-255,5020,274914,13,357094
7041,0.002378,74.125.24.0-255,1484,276398,13,357094
7042,0.002399,74.125.24.0-255,2902,279300,13,357094
7043,0.002418,74.125.24.0-255,2902,282202,13,357094
7044,0.002427,74.125.24.0-255,1484,283686,13,357094
7045,0.002444,74.125.24.0-255,2902,286588,13,357094
7046,0.00246,74.125.24.0-255,5738,292326,13,357094
7047,0.002463,74.125.24.0-255,1484,293810,13,357094
7048,0.002468,74.125.24.0-255,4320,298130,13,357094
7049,0.002481,74.125.24.0-255,5738,303868,13,357094
7050,0.002511,74.125.24.0-255,1484,305352,13,357094
7051,0.002525,74.125.24.0-255,5738,311090,13,357094
7052,0.002538,74.125.24.0-255,3602,314692,13,357094
7053,0.002541,74.125.24.0-255,2902,317594,13,357094
7054,0.002568,74.125.24.0-255,8574,326168,13,357094
7055,0.002572,74.125.24.0-255,2902,329070,13,357094
7056,0.002588,74.125.24.0-255,5738,334808,13,357094
7057,0.002598,74.125.24.0-255,2902,337710,13,357094
7058,0.002635,74.125.24.0-255,5738,343448,13,357094
7059,0.002656,74.125.24.0-255,8918,352366,13,357094
7060,0.002658,74.125.24.0-255,97,352463,13,357094
7061,0.002703,74.125.24.0-255,105,352568,13,357094
7062,0.007113,172.31.36.0-255,66,352634,13,357094
7063,0.010134,172.31.36.0-255,105,352739,13,357094
7064,0.01236,74.125.24.0-255,66,352805,13,357094
7065,0.031515,172.31.36.0-255,172,352977,13,357094
7066,0.031547,172.31.36.0-255,1106,354083,13,357094
7067,0.031585,172.31.36.0-255,1514,355597,13,357094
7068,0.031587,172.31.36.0-255,1299,356896,13,357094
7069,0.033049,104.244.42.0-255,66,356962,13,357094
7070,0.03312,104.244.42.0-255,66,357028,13,357094
7071,0.033122,104.244.42.0-255,66,357094,13,357094
7072,0.0,74.125.68.0-255,153,153,13,388451
7073,2.1e-05,172.31.36.0-255,66,219,13,388451
7074,2.8e-05,74.125.68.0-255,1484,1703,13,388451
7075,3.3e-05,172.31.36.0-255,66,1769,13,388451
7076,4.8e-05,74.125.68.0-255,2902,4671,13,388451
7077,5.2e-05,172.31.36.0-255,66,4737,13,388451
7078,5.6e-05,74.125.68.0-255,2902,7639,13,388451
7079,5.9e-05,172.31.36.0-255,66,7705,13,388451
7080,9.3e-05,74.125.68.0-255,4320,12025,13,388451
7081,9.7e-05,172.31.36.0-255,66,12091,13,388451
7082,0.00013,74.125.68.0-255,1484,13575,13,388451
7083,0.000132,172.31.36.0-255,66,13641,13,388451
7084,0.000136,74.125.68.0-255,627,14268,13,388451
7085,0.000138,172.31.36.0-255,66,14334,13,388451
7086,0.000168,74.125.68.0-255,1484,15818,13,388451
7087,0.00017,172.31.36.0-255,66,15884,13,388451
7088,0.000177,74.125.68.0-255,4320,20204,13,388451
7089,0.00018,172.31.36.0-255,66,20270,13,388451
7090,0.000203,74.125.68.0-255,4320,24590,13,388451
7091,0.000206,172.31.36.0-255,66,24656,13,388451
7092,0.000239,74.125.68.0-255,5738,30394,13,388451
7093,0.000242,172.31.36.0-255,66,30460,13,388451
7094,0.000245,74.125.68.0-255,1125,31585,13,388451
7095,0.000247,172.31.36.0-255,66,31651,13,388451
7096,0.000718,74.125.68.0-255,1484,33135,13,388451
7097,0.000724,172.31.36.0-255,66,33201,13,388451
7098,0.00073,74.125.68.0-255,2902,36103,13,388451
7099,0.000733,172.31.36.0-255,66,36169,13,388451
7100,0.000764,74.125.68.0-255,2902,39071,13,388451
7101,0.000766,172.31.36.0-255,66,39137,13,388451
7102,0.000771,74.125.68.0-255,4320,43457,13,388451
7103,0.000774,172.31.36.0-255,66,43523,13,388451
7104,0.000818,74.125.68.0-255,8215,51738,13,388451
7105,0.000821,172.31.36.0-255,66,51804,13,388451
7106,0.000848,74.125.68.0-255,4320,56124,13,388451
7107,0.000853,172.31.36.0-255,66,56190,13,388451
7108,0.000864,74.125.68.0-255,4320,60510,13,388451
7109,0.000866,172.31.36.0-255,66,60576,13,388451
7110,0.00089,74.125.68.0-255,1484,62060,13,388451
7111,0.000893,172.31.36.0-255,66,62126,13,388451
7112,0.000898,74.125.68.0-255,2902,65028,13,388451
7113,0.0009,172.31.36.0-255,66,65094,13,388451
7114,0.000902,74.125.68.0-255,1437,66531,13,388451
7115,0.000904,172.31.36.0-255,66,66597,13,388451
7116,0.00105,74.125.68.0-255,109,66706,13,388451
7117,0.001054,172.31.36.0-255,66,66772,13,388451
7118,0.00123,74.125.68.0-255,1484,68256,13,388451
7119,0.001234,172.31.36.0-255,66,68322,13,388451
7120,0.001241,74.125.68.0-255,2902,71224,13,388451
7121,0.001243,172.31.36.0-255,66,71290,13,388451
7122,0.001264,74.125.68.0-255,2902,74192,13,388451
7123,0.001267,172.31.36.0-255,66,74258,13,388451
7124,0.001298,74.125.68.0-255,4320,78578,13,388451
7125,0.001302,74.125.68.0-255,1484,80062,13,388451
7126,0.00131,172.31.36.0-255,66,80128,13,388451
7127,0.001315,74.125.68.0-255,2902,83030,13,388451
7128,0.001334,74.125.68.0-255,2902,85932,13,388451
7129,0.001337,172.31.36.0-255,66,85998,13,388451
7130,0.001357,74.125.68.0-255,2902,88900,13,388451
7131,0.001363,74.125.68.0-255,5738,94638,13,388451
7132,0.001376,74.125.68.0-255,1484,96122,13,388451
7133,0.001387,172.31.36.0-255,66,96188,13,388451
7134,0.001417,74.125.68.0-255,4320,100508,13,388451
7135,0.001422,172.31.36.0-255,66,100574,13,388451
7136,0.00143,74.125.68.0-255,766,101340,13,388451
7137,0.001512,74.125.68.0-255,1484,102824,13,388451
7138,0.001518,74.125.68.0-255,2902,105726,13,388451
7139,0.001534,74.125.68.0-255,1484,107210,13,388451
7140,0.001539,172.31.36.0-255,66,107276,13,388451
7141,0.001567,74.125.68.0-255,4320,111596,13,388451
7142,0.001576,74.125.68.0-255,8574,120170,13,388451
7143,0.001597,74.125.68.0-255,5738,125908,13,388451
7144,0.0016,172.31.36.0-255,66,125974,13,388451
7145,0.001605,172.31.36.0-255,66,126040,13,388451
7146,0.001619,74.125.68.0-255,4320,130360,13,388451
7147,0.001622,74.125.68.0-255,1484,131844,13,388451
7148,0.001678,74.125.68.0-255,2902,134746,13,388451
7149,0.001681,74.125.68.0-255,766,135512,13,388451
7150,0.001689,172.31.36.0-255,66,135578,13,388451
7151,0.001712,74.125.68.0-255,1484,137062,13,388451
7152,0.001717,74.125.68.0-255,2902,139964,13,388451
7153,0.001741,172.31.36.0-255,66,140030,13,388451
7154,0.001769,74.125.68.0-255,2902,142932,13,388451
7155,0.001786,172.31.36.0-255,66,142998,13,388451
7156,0.001791,74.125.68.0-255,4320,147318,13,388451
7157,0.001797,172.31.36.0-255,66,147384,13,388451
7158,0.001827,74.125.68.0-255,1484,148868,13,388451
7159,0.001838,74.125.68.0-255,2902,151770,13,388451
7160,0.001862,74.125.68.0-255,4320,156090,13,388451
7161,0.001868,172.31.36.0-255,66,156156,13,388451
7162,0.00191,74.125.68.0-255,5738,161894,13,388451
7163,0.001914,74.125.68.0-255,1484,163378,13,388451
7164,0.00193,74.125.68.0-255,1484,164862,13,388451
7165,0.001938,172.31.36.0-255,66,164928,13,388451
7166,0.001976,74.125.68.0-255,4320,169248,13,388451
7167,0.001983,172.31.36.0-255,66,169314,13,388451
7168,0.001995,74.125.68.0-255,766,170080,13,388451
7169,0.002143,74.125.68.0-255,1484,171564,13,388451
7170,0.002147,172.31.36.0-255,66,171630,13,388451
7171,0.002151,74.125.68.0-255,1484,173114,13,388451
7172,0.002178,74.125.68.0-255,1484,174598,13,388451
7173,0.002182,74.125.68.0-255,2902,177500,13,388451
7174,0.002187,74.125.68.0-255,4320,181820,13,388451
7175,0.002199,172.31.36.0-255,66,181886,13,388451
7176,0.002219,74.125.68.0-255,8574,190460,13,388451
7177,0.002223,74.125.68.0-255,2902,193362,13,388451
7178,0.002241,74.125.68.0-255,4320,197682,13,388451
7179,0.002251,172.31.36.0-255,66,197748,13,388451
7180,0.002283,74.125.68.0-255,6438,204186,13,388451
7181,0.002308,172.31.36.0-255,66,204252,13,388451
7182,0.002348,74.125.68.0-255,1484,205736,13,388451
7183,0.002352,74.125.68.0-255,1484,207220,13,388451
7184,0.002362,74.125.68.0-255,1484,208704,13,388451
7185,0.002367,74.125.68.0-255,2902,211606,13,388451
7186,0.002389,74.125.68.0-255,4320,215926,13,388451
7187,0.002394,172.31.36.0-255,66,215992,13,388451
7188,0.002399,172.31.36.0-255,66,216058,13,388451
7189,0.002429,74.125.68.0-255,8574,224632,13,388451
7190,0.002436,74.125.68.0-255,7156,231788,13,388451
7191,0.002457,172.31.36.0-255,66,231854,13,388451
7192,0.002487,74.125.68.0-255,6438,238292,13,388451
7193,0.002501,172.31.36.0-255,66,238358,13,388451
7194,0.002506,74.125.68.0-255,4320,242678,13,388451
7195,0.002511,172.31.36.0-255,66,242744,13,388451
7196,0.002526,74.125.68.0-255,2902,245646,13,388451
7197,0.002538,74.125.68.0-255,5738,251384,13,388451
7198,0.002541,74.125.68.0-255,2902,254286,13,388451
7199,0.002569,74.125.68.0-255,4320,258606,13,388451
7200,0.002585,74.125.68.0-255,7156,265762,13,388451
7201,0.0026,74.125.68.0-255,5738,271500,13,388451
7202,0.002616,74.125.68.0-255,1484,272984,13,388451
7203,0.00264,74.125.68.0-255,9992,282976,13,388451
7204,0.002663,74.125.68.0-255,2184,285160,13,388451
7205,0.002669,74.125.68.0-255,5738,290898,13,388451
7206,0.002676,74.125.68.0-255,8574,299472,13,388451
7207,0.009662,172.31.36.0-255,66,299538,13,388451
7208,0.012351,74.125.68.0-255,5738,305276,13,388451
7209,0.01236,172.31.36.0-255,66,305342,13,388451
7210,0.015013,74.125.68.0-255,5738,311080,13,388451
7211,0.015024,172.31.36.0-255,66,311146,13,388451
7212,0.01772,74.125.68.0-255,5738,316884,13,388451
7213,0.01773,172.31.36.0-255,66,316950,13,388451
7214,0.020377,74.125.68.0-255,5738,322688,13,388451
7215,0.020478,172.31.36.0-255,66,322754,13,388451
7216,0.023127,74.125.68.0-255,5738,328492,13,388451
7217,0.023139,172.31.36.0-255,66,328558,13,388451
7218,0.025798,74.125.68.0-255,5738,334296,13,388451
7219,0.025805,172.31.36.0-255,66,334362,13,388451
7220,0.028451,74.125.68.0-255,5738,340100,13,388451
7221,0.028458,172.31.36.0-255,66,340166,13,388451
7222,0.031147,74.125.68.0-255,5738,345904,13,388451
7223,0.031154,172.31.36.0-255,66,345970,13,388451
7224,0.033352,172.31.36.0-255,172,346142,13,388451
7225,0.033405,172.31.36.0-255,1110,347252,13,388451
7226,0.033466,172.31.36.0-255,1514,348766,13,388451
7227,0.033468,172.31.36.0-255,1297,350063,13,388451
7228,0.033804,74.125.68.0-255,5738,355801,13,388451
7229,0.03381,172.31.36.0-255,66,355867,13,388451
7230,0.035028,104.244.42.0-255,66,355933,13,388451
7231,0.035056,104.244.42.0-255,66,355999,13,388451
7232,0.035112,104.244.42.0-255,66,356065,13,388451
7233,0.036462,74.125.68.0-255,5738,361803,13,388451
7234,0.036468,172.31.36.0-255,66,361869,13,388451
7235,0.039132,74.125.68.0-255,5738,367607,13,388451
7236,0.039139,172.31.36.0-255,66,367673,13,388451
7237,0.041809,74.125.68.0-255,5738,373411,13,388451
7238,0.041817,172.31.36.0-255,66,373477,13,388451
7239,0.044467,74.125.68.0-255,5738,379215,13,388451
7240,0.044474,172.31.36.0-255,66,379281,13,388451
7241,0.04713,74.125.68.0-255,5738,385019,13,388451
7242,0.047137,172.31.36.0-255,66,385085,13,388451
7243,0.049797,74.125.68.0-255,3129,388214,13,388451
7244,0.049805,172.31.36.0-255,66,388280,13,388451
7245,0.04999,172.31.36.0-255,105,388385,13,388451
7246,0.052598,74.125.68.0-255,66,388451,13,388451
7247,0.0,74.125.24.0-255,153,153,13,318982
7248,2.4e-05,172.31.36.0-255,66,219,13,318982
7249,3.2e-05,74.125.24.0-255,1484,1703,13,318982
7250,3.7e-05,172.31.36.0-255,66,1769,13,318982
7251,5.1e-05,74.125.24.0-255,2902,4671,13,318982
7252,5.4e-05,172.31.36.0-255,66,4737,13,318982
7253,6.1e-05,74.125.24.0-255,5738,10475,13,318982
7254,6.4e-05,172.31.36.0-255,66,10541,13,318982
7255,9.7e-05,74.125.24.0-255,1484,12025,13,318982
7256,0.0001,172.31.36.0-255,66,12091,13,318982
7257,0.000105,74.125.24.0-255,2046,14137,13,318982
7258,0.000107,172.31.36.0-255,66,14203,13,318982
7259,0.000559,74.125.24.0-255,1484,15687,13,318982
7260,0.000566,172.31.36.0-255,66,15753,13,318982
7261,0.000574,74.125.24.0-255,2902,18655,13,318982
7262,0.000576,172.31.36.0-255,66,18721,13,318982
7263,0.000588,74.125.24.0-255,5738,24459,13,318982
7264,0.000591,172.31.36.0-255,66,24525,13,318982
7265,0.000597,74.125.24.0-255,4320,28845,13,318982
7266,0.000599,172.31.36.0-255,66,28911,13,318982
7267,0.000613,74.125.24.0-255,2543,31454,13,318982
7268,0.000616,172.31.36.0-255,66,31520,13,318982
7269,0.000628,74.125.24.0-255,7156,38676,13,318982
7270,0.000631,172.31.36.0-255,66,38742,13,318982
7271,0.00067,172.31.36.0-255,66,38808,13,318982
7272,0.000702,74.125.24.0-255,4320,43128,13,318982
7273,0.000704,172.31.36.0-255,66,43194,13,318982
7274,0.00072,74.125.24.0-255,10692,53886,13,318982
7275,0.000723,172.31.36.0-255,66,53952,13,318982
7276,0.000725,74.125.24.0-255,447,54399,13,318982
7277,0.000727,172.31.36.0-255,66,54465,13,318982
7278,0.000853,74.125.24.0-255,1484,55949,13,318982
7279,0.00086,74.125.24.0-255,2902,58851,13,318982
7280,0.000883,74.125.24.0-255,5738,64589,13,318982
7281,0.000889,74.125.24.0-255,4320,68909,13,318982
7282,0.000909,74.125.24.0-255,8574,77483,13,318982
7283,0.000921,74.125.24.0-255,9992,87475,13,318982
7284,0.00095,74.125.24.0-255,766,88241,13,318982
7285,0.001395,74.125.24.0-255,1484,89725,13,318982
7286,0.001403,74.125.24.0-255,2902,92627,13,318982
7287,0.00142,74.125.24.0-255,5738,98365,13,318982
7288,0.001435,74.125.24.0-255,1484,99849,13,318982
7289,0.001448,74.125.24.0-255,5738,105587,13,318982
7290,0.001464,74.125.24.0-255,1484,107071,13,318982
7291,0.001494,74.125.24.0-255,4320,111391,13,318982
7292,0.001516,74.125.24.0-255,10692,122083,13,318982
7293,0.001685,74.125.24.0-255,1484,123567,13,318982
7294,0.0017,74.125.24.0-255,2902,126469,13,318982
7295,0.001703,74.125.24.0-255,1484,127953,13,318982
7296,0.001722,74.125.24.0-255,4320,132273,13,318982
7297,0.001739,74.125.24.0-255,5738,138011,13,318982
7298,0.001751,74.125.24.0-255,4320,142331,13,318982
7299,0.00179,74.125.24.0-255,2902,145233,13,318982
7300,0.001812,74.125.24.0-255,8574,153807,13,318982
7301,0.001839,74.125.24.0-255,7156,160963,13,318982
7302,0.001857,74.125.24.0-255,3602,164565,13,318982
7303,0.001896,74.125.24.0-255,5738,170303,13,318982
7304,0.001899,74.125.24.0-255,1484,171787,13,318982
7305,0.001919,74.125.24.0-255,5738,177525,13,318982
7306,0.001927,74.125.24.0-255,7156,184681,13,318982
7307,0.001948,74.125.24.0-255,7156,191837,13,318982
7308,0.001954,74.125.24.0-255,6438,198275,13,318982
7309,0.001986,74.125.24.0-255,2902,201177,13,318982
7310,0.002007,74.125.24.0-255,5738,206915,13,318982
7311,0.002016,74.125.24.0-255,9992,216907,13,318982
7312,0.002064,74.125.24.0-255,5738,222645,13,318982
7313,0.002081,74.125.24.0-255,5738,228383,13,318982
7314,0.00211,74.125.24.0-255,5020,233403,13,318982
7315,0.002134,74.125.24.0-255,9992,243395,13,318982
7316,0.00216,74.125.24.0-255,5738,249133,13,318982
7317,0.002179,74.125.24.0-255,9992,259125,13,318982
7318,0.002197,74.125.24.0-255,3602,262727,13,318982
7319,0.0022,74.125.24.0-255,1484,264211,13,318982
7320,0.002206,172.31.36.0-255,78,264289,13,318982
7321,0.00222,172.31.36.0-255,78,264367,13,318982
7322,0.002251,74.125.24.0-255,5738,270105,13,318982
7323,0.002254,74.125.24.0-255,766,270871,13,318982
7324,0.002259,74.125.24.0-255,2902,273773,13,318982
7325,0.002266,74.125.24.0-255,8574,282347,13,318982
7326,0.002275,74.125.24.0-255,9992,292339,13,318982
7327,0.002323,74.125.24.0-255,4320,296659,13,318982
7328,0.00234,74.125.24.0-255,7856,304515,13,318982
7329,0.002343,74.125.24.0-255,1484,305999,13,318982
7330,0.00235,74.125.24.0-255,8006,314005,13,318982
7331,0.002353,74.125.24.0-255,97,314102,13,318982
7332,0.002364,74.125.24.0-255,105,314207,13,318982
7333,0.003849,172.31.36.0-255,66,314273,13,318982
7334,0.006688,172.31.36.0-255,105,314378,13,318982
7335,0.008888,74.125.24.0-255,66,314444,13,318982
7336,0.037096,172.31.36.0-255,247,314691,13,318982
7337,0.037134,172.31.36.0-255,1110,315801,13,318982
7338,0.037194,172.31.36.0-255,1514,317315,13,318982
7339,0.037196,172.31.36.0-255,1295,318610,13,318982
7340,0.038796,104.244.42.0-255,66,318676,13,318982
7341,0.038807,104.244.42.0-255,66,318742,13,318982
7342,0.03883,104.244.42.0-255,66,318808,13,318982
7343,0.039615,104.244.42.0-255,108,318916,13,318982
7344,0.039624,172.31.36.0-255,66,318982,13,318982
7345,0.0,172.217.194.0-255,153,153,13,390852
7346,2.3e-05,172.31.36.0-255,66,219,13,390852
7347,3.1e-05,172.217.194.0-255,1484,1703,13,390852
7348,3.5e-05,172.31.36.0-255,66,1769,13,390852
7349,3.8e-05,172.217.194.0-255,1484,3253,13,390852
7350,4.1e-05,172.31.36.0-255,66,3319,13,390852
7351,5.5e-05,172.217.194.0-255,2902,6221,13,390852
7352,5.8e-05,172.31.36.0-255,66,6287,13,390852
7353,7.8e-05,172.217.194.0-255,4320,10607,13,390852
7354,8.1e-05,172.31.36.0-255,66,10673,13,390852
7355,9.9e-05,172.217.194.0-255,1484,12157,13,390852
7356,0.000102,172.31.36.0-255,66,12223,13,390852
7357,0.000111,172.217.194.0-255,2083,14306,13,390852
7358,0.000114,172.31.36.0-255,66,14372,13,390852
7359,0.000178,172.217.194.0-255,1484,15856,13,390852
7360,0.000181,172.31.36.0-255,66,15922,13,390852
7361,0.000212,172.217.194.0-255,2902,18824,13,390852
7362,0.000215,172.31.36.0-255,66,18890,13,390852
7363,0.000221,172.217.194.0-255,5738,24628,13,390852
7364,0.000223,172.31.36.0-255,66,24694,13,390852
7365,0.000244,172.217.194.0-255,1484,26178,13,390852
7366,0.000246,172.31.36.0-255,66,26244,13,390852
7367,0.00025,172.217.194.0-255,1484,27728,13,390852
7368,0.000253,172.31.36.0-255,66,27794,13,390852
7369,0.000284,172.217.194.0-255,1484,29278,13,390852
7370,0.000286,172.31.36.0-255,66,29344,13,390852
7371,0.000291,172.217.194.0-255,2543,31887,13,390852
7372,0.000294,172.31.36.0-255,66,31953,13,390852
7373,0.000298,172.217.194.0-255,2902,34855,13,390852
7374,0.000301,172.31.36.0-255,66,34921,13,390852
7375,0.000321,172.217.194.0-255,1484,36405,13,390852
7376,0.000323,172.31.36.0-255,66,36471,13,390852
7377,0.000351,172.217.194.0-255,5738,42209,13,390852
7378,0.000358,172.217.194.0-255,4320,46529,13,390852
7379,0.00041,172.217.194.0-255,2543,49072,13,390852
7380,0.00053,172.31.36.0-255,66,49138,13,390852
7381,0.000579,172.217.194.0-255,1484,50622,13,390852
7382,0.000606,172.217.194.0-255,1484,52106,13,390852
7383,0.000612,172.31.36.0-255,66,52172,13,390852
7384,0.000639,172.217.194.0-255,1484,53656,13,390852
7385,0.000647,172.217.194.0-255,5738,59394,13,390852
7386,0.000656,172.217.194.0-255,6797,66191,13,390852
7387,0.000658,172.217.194.0-255,1484,67675,13,390852
7388,0.00067,172.31.36.0-255,66,67741,13,390852
7389,0.000677,172.217.194.0-255,5738,73479,13,390852
7390,0.000693,172.31.36.0-255,66,73545,13,390852
7391,0.000707,172.217.194.0-255,4320,77865,13,390852
7392,0.000727,172.217.194.0-255,2902,80767,13,390852
7393,0.000734,172.31.36.0-255,66,80833,13,390852
7394,0.000761,172.217.194.0-255,2543,83376,13,390852
7395,0.00078,172.31.36.0-255,66,83442,13,390852
7396,0.000865,172.217.194.0-255,1484,84926,13,390852
7397,0.00087,172.217.194.0-255,1484,86410,13,390852
7398,0.00088,172.217.194.0-255,1484,87894,13,390852
7399,0.000893,172.31.36.0-255,66,87960,13,390852
7400,0.000903,172.217.194.0-255,4320,92280,13,390852
7401,0.000909,172.217.194.0-255,5738,98018,13,390852
7402,0.000916,172.217.194.0-255,1484,99502,13,390852
7403,0.000929,172.217.194.0-255,4320,103822,13,390852
7404,0.000933,172.31.36.0-255,66,103888,13,390852
7405,0.000965,172.217.194.0-255,5738,109626,13,390852
7406,0.000973,172.217.194.0-255,7742,117368,13,390852
7407,0.000997,172.31.36.0-255,66,117434,13,390852
7408,0.001993,172.217.194.0-255,1484,118918,13,390852
7409,0.002003,172.217.194.0-255,2902,121820,13,390852
7410,0.002008,172.31.36.0-255,66,121886,13,390852
7411,0.002016,172.217.194.0-255,5738,127624,13,390852
7412,0.00202,172.217.194.0-255,4320,131944,13,390852
7413,0.002047,172.217.194.0-255,8574,140518,13,390852
7414,0.002067,172.217.194.0-255,4320,144838,13,390852
7415,0.002092,172.217.194.0-255,6438,151276,13,390852
7416,0.002223,172.217.194.0-255,1484,152760,13,390852
7417,0.002239,172.217.194.0-255,2902,155662,13,390852
7418,0.002243,172.217.194.0-255,2902,158564,13,390852
7419,0.002256,172.217.194.0-255,2902,161466,13,390852
7420,0.002268,172.217.194.0-255,1484,162950,13,390852
7421,0.002279,172.217.194.0-255,1484,164434,13,390852
7422,0.002301,172.217.194.0-255,7156,171590,13,390852
7423,0.002319,172.217.194.0-255,2902,174492,13,390852
7424,0.007306,172.31.36.0-255,66,174558,13,390852
7425,0.009458,172.217.194.0-255,5738,180296,13,390852
7426,0.009466,172.31.36.0-255,66,180362,13,390852
7427,0.011609,172.217.194.0-255,5738,186100,13,390852
7428,0.011652,172.31.36.0-255,66,186166,13,390852
7429,0.01384,172.217.194.0-255,5738,191904,13,390852
7430,0.013851,172.31.36.0-255,66,191970,13,390852
7431,0.016057,172.217.194.0-255,5738,197708,13,390852
7432,0.016067,172.31.36.0-255,66,197774,13,390852
7433,0.01825,172.217.194.0-255,5738,203512,13,390852
7434,0.018258,172.31.36.0-255,66,203578,13,390852
7435,0.020421,172.217.194.0-255,5738,209316,13,390852
7436,0.020427,172.31.36.0-255,66,209382,13,390852
7437,0.022573,172.217.194.0-255,5738,215120,13,390852
7438,0.02258,172.31.36.0-255,66,215186,13,390852
7439,0.024735,172.217.194.0-255,4320,219506,13,390852
7440,0.024743,172.31.36.0-255,66,219572,13,390852
7441,0.024772,172.217.194.0-255,1484,221056,13,390852
7442,0.026886,172.217.194.0-255,4320,225376,13,390852
7443,0.026893,172.31.36.0-255,66,225442,13,390852
7444,0.027601,172.31.36.0-255,176,225618,13,390852
7445,0.027632,172.31.36.0-255,1110,226728,13,390852
7446,0.027689,172.31.36.0-255,1514,228242,13,390852
7447,0.027691,172.31.36.0-255,1296,229538,13,390852
7448,0.029051,172.217.194.0-255,5738,235276,13,390852
7449,0.029091,172.31.36.0-255,66,235342,13,390852
7450,0.029268,104.244.42.0-255,66,235408,13,390852
7451,0.029324,104.244.42.0-255,66,235474,13,390852
7452,0.029362,104.244.42.0-255,66,235540,13,390852
7453,0.031242,172.217.194.0-255,2902,238442,13,390852
7454,0.031249,172.31.36.0-255,66,238508,13,390852
7455,0.031276,172.217.194.0-255,2902,241410,13,390852
7456,0.031463,172.31.36.0-255,66,241476,13,390852
7457,0.033384,172.217.194.0-255,2902,244378,13,390852
7458,0.033396,172.31.36.0-255,66,244444,13,390852
7459,0.033587,172.217.194.0-255,2902,247346,13,390852
7460,0.033593,172.31.36.0-255,66,247412,13,390852
7461,0.03558,172.217.194.0-255,2902,250314,13,390852
7462,0.035586,172.31.36.0-255,66,250380,13,390852
7463,0.035758,172.217.194.0-255,2902,253282,13,390852
7464,0.035764,172.31.36.0-255,66,253348,13,390852
7465,0.037744,172.217.194.0-255,2902,256250,13,390852
7466,0.037751,172.31.36.0-255,66,256316,13,390852
7467,0.037913,172.217.194.0-255,2902,259218,13,390852
7468,0.037919,172.31.36.0-255,66,259284,13,390852
7469,0.039886,172.217.194.0-255,2902,262186,13,390852
7470,0.039893,172.31.36.0-255,66,262252,13,390852
7471,0.040064,172.217.194.0-255,2902,265154,13,390852
7472,0.04007,172.31.36.0-255,66,265220,13,390852
7473,0.042044,172.217.194.0-255,2902,268122,13,390852
7474,0.042051,172.31.36.0-255,66,268188,13,390852
7475,0.042231,172.217.194.0-255,2902,271090,13,390852
7476,0.042236,172.31.36.0-255,66,271156,13,390852
7477,0.0442,172.217.194.0-255,2902,274058,13,390852
7478,0.044207,172.31.36.0-255,66,274124,13,390852
7479,0.044394,172.217.194.0-255,2902,277026,13,390852
7480,0.044399,172.31.36.0-255,66,277092,13,390852
7481,0.046377,172.217.194.0-255,2902,279994,13,390852
7482,0.046383,172.31.36.0-255,66,280060,13,390852
7483,0.046555,172.217.194.0-255,2902,282962,13,390852
7484,0.04656,172.31.36.0-255,66,283028,13,390852
7485,0.048523,172.217.194.0-255,2902,285930,13,390852
7486,0.04853,172.31.36.0-255,66,285996,13,390852
7487,0.048713,172.217.194.0-255,1484,287480,13,390852
7488,0.048731,172.217.194.0-255,1484,288964,13,390852
7489,0.048916,172.31.36.0-255,66,289030,13,390852
7490,0.050691,172.217.194.0-255,2902,291932,13,390852
7491,0.050698,172.31.36.0-255,66,291998,13,390852
7492,0.051074,172.217.194.0-255,2902,294900,13,390852
7493,0.05108,172.31.36.0-255,66,294966,13,390852
7494,0.05287,172.217.194.0-255,2902,297868,13,390852
7495,0.05288,172.31.36.0-255,66,297934,13,390852
7496,0.053267,172.217.194.0-255,2902,300836,13,390852
7497,0.053274,172.31.36.0-255,66,300902,13,390852
7498,0.055051,172.217.194.0-255,2902,303804,13,390852
7499,0.055057,172.31.36.0-255,66,303870,13,390852
7500,0.055426,172.217.194.0-255,2902,306772,13,390852
7501,0.055433,172.31.36.0-255,66,306838,13,390852
7502,0.057227,172.217.194.0-255,2902,309740,13,390852
7503,0.057234,172.31.36.0-255,66,309806,13,390852
7504,0.057582,172.217.194.0-255,2902,312708,13,390852
7505,0.057588,172.31.36.0-255,66,312774,13,390852
7506,0.059413,172.217.194.0-255,1484,314258,13,390852
7507,0.059749,172.217.194.0-255,4320,318578,13,390852
7508,0.05979,172.31.36.0-255,66,318644,13,390852
7509,0.061936,172.217.194.0-255,5738,324382,13,390852
7510,0.061987,172.31.36.0-255,66,324448,13,390852
7511,0.064141,172.217.194.0-255,5738,330186,13,390852
7512,0.064148,172.31.36.0-255,66,330252,13,390852
7513,0.066292,172.217.194.0-255,2902,333154,13,390852
7514,0.066299,172.31.36.0-255,66,333220,13,390852
7515,0.066326,172.217.194.0-255,2902,336122,13,390852
7516,0.066722,172.31.36.0-255,66,336188,13,390852
7517,0.068482,172.217.194.0-255,2902,339090,13,390852
7518,0.068489,172.31.36.0-255,66,339156,13,390852
7519,0.068898,172.217.194.0-255,2902,342058,13,390852
7520,0.068904,172.31.36.0-255,66,342124,13,390852
7521,0.070659,172.217.194.0-255,2902,345026,13,390852
7522,0.070669,172.31.36.0-255,66,345092,13,390852
7523,0.071053,172.217.194.0-255,2902,347994,13,390852
7524,0.071059,172.31.36.0-255,66,348060,13,390852
7525,0.072858,172.217.194.0-255,2902,350962,13,390852
7526,0.072865,172.31.36.0-255,66,351028,13,390852
7527,0.073224,172.217.194.0-255,2902,353930,13,390852
7528,0.07323,172.31.36.0-255,66,353996,13,390852
7529,0.075017,172.217.194.0-255,2902,356898,13,390852
7530,0.075023,172.31.36.0-255,66,356964,13,390852
7531,0.075383,172.217.194.0-255,2902,359866,13,390852
7532,0.075389,172.31.36.0-255,66,359932,13,390852
7533,0.077199,172.217.194.0-255,2902,362834,13,390852
7534,0.077205,172.31.36.0-255,66,362900,13,390852
7535,0.077562,172.217.194.0-255,2902,365802,13,390852
7536,0.077568,172.31.36.0-255,66,365868,13,390852
7537,0.079373,172.217.194.0-255,2902,368770,13,390852
7538,0.079379,172.31.36.0-255,66,368836,13,390852
7539,0.079775,172.217.194.0-255,2902,371738,13,390852
7540,0.079781,172.31.36.0-255,66,371804,13,390852
7541,0.081532,172.217.194.0-255,2902,374706,13,390852
7542,0.081539,172.31.36.0-255,66,374772,13,390852
7543,0.081963,172.217.194.0-255,2902,377674,13,390852
7544,0.081969,172.31.36.0-255,66,377740,13,390852
7545,0.083726,172.217.194.0-255,2902,380642,13,390852
7546,0.083733,172.31.36.0-255,66,380708,13,390852
7547,0.084121,172.217.194.0-255,2902,383610,13,390852
7548,0.084127,172.31.36.0-255,66,383676,13,390852
7549,0.085889,172.217.194.0-255,2902,386578,13,390852
7550,0.085896,172.31.36.0-255,66,386644,13,390852
7551,0.086322,172.217.194.0-255,2902,389546,13,390852
7552,0.086328,172.31.36.0-255,66,389612,13,390852
7553,0.088046,172.217.194.0-255,1069,390681,13,390852
7554,0.088209,172.31.36.0-255,66,390747,13,390852
7555,0.088249,172.31.36.0-255,105,390852,13,390852
7556,0.0,172.217.194.0-255,162,162,13,220693
7557,2e-05,172.217.194.0-255,1484,1646,13,220693
7558,3.2e-05,172.31.36.0-255,66,1712,13,220693
7559,4e-05,172.217.194.0-255,2902,4614,13,220693
7560,4.4e-05,172.31.36.0-255,66,4680,13,220693
7561,5.2e-05,172.217.194.0-255,7156,11836,13,220693
7562,6.5e-05,172.31.36.0-255,66,11902,13,220693
7563,8.4e-05,172.31.36.0-255,66,11968,13,220693
7564,8.8e-05,172.217.194.0-255,2543,14511,13,220693
7565,9e-05,172.31.36.0-255,66,14577,13,220693
7566,0.001193,172.217.194.0-255,1484,16061,13,220693
7567,0.001214,172.217.194.0-255,2902,18963,13,220693
7568,0.001219,172.31.36.0-255,66,19029,13,220693
7569,0.001228,172.217.194.0-255,5738,24767,13,220693
7570,0.00123,172.31.36.0-255,66,24833,13,220693
7571,0.001265,172.217.194.0-255,7156,31989,13,220693
7572,0.001268,172.31.36.0-255,66,32055,13,220693
7573,0.001304,172.217.194.0-255,3961,36016,13,220693
7574,0.001307,172.31.36.0-255,66,36082,13,220693
7575,0.00134,172.31.36.0-255,66,36148,13,220693
7576,0.001365,172.217.194.0-255,1484,37632,13,220693
7577,0.001381,172.217.194.0-255,2902,40534,13,220693
7578,0.001384,172.31.36.0-255,66,40600,13,220693
7579,0.001412,172.217.194.0-255,4320,44920,13,220693
7580,0.001415,172.31.36.0-255,66,44986,13,220693
7581,0.001441,172.217.194.0-255,1484,46470,13,220693
7582,0.001456,172.31.36.0-255,66,46536,13,220693
7583,0.001464,172.217.194.0-255,8574,55110,13,220693
7584,0.001466,172.31.36.0-255,66,55176,13,220693
7585,0.001498,172.217.194.0-255,2184,57360,13,220693
7586,0.0015,172.31.36.0-255,66,57426,13,220693
7587,0.001528,172.217.194.0-255,2902,60328,13,220693
7588,0.00153,172.31.36.0-255,66,60394,13,220693
7589,0.001536,172.217.194.0-255,4320,64714,13,220693
7590,0.001538,172.31.36.0-255,66,64780,13,220693
7591,0.001543,172.217.194.0-255,2902,67682,13,220693
7592,0.00155,172.31.36.0-255,66,67748,13,220693
7593,0.001583,172.217.194.0-255,5738,73486,13,220693
7594,0.001586,172.31.36.0-255,66,73552,13,220693
7595,0.001588,172.217.194.0-255,1156,74708,13,220693
7596,0.001657,172.217.194.0-255,1484,76192,13,220693
7597,0.001661,172.31.36.0-255,66,76258,13,220693
7598,0.001668,172.217.194.0-255,2902,79160,13,220693
7599,0.00167,172.31.36.0-255,66,79226,13,220693
7600,0.001682,172.217.194.0-255,5738,84964,13,220693
7601,0.001684,172.31.36.0-255,66,85030,13,220693
7602,0.001689,172.217.194.0-255,2902,87932,13,220693
7603,0.001691,172.31.36.0-255,66,87998,13,220693
7604,0.001725,172.217.194.0-255,5738,93736,13,220693
7605,0.001729,172.31.36.0-255,66,93802,13,220693
7606,0.001758,172.217.194.0-255,8574,102376,13,220693
7607,0.001761,172.31.36.0-255,66,102442,13,220693
7608,0.001789,172.217.194.0-255,6438,108880,13,220693
7609,0.001792,172.31.36.0-255,66,108946,13,220693
7610,0.001937,172.217.194.0-255,1484,110430,13,220693
7611,0.001944,172.217.194.0-255,2902,113332,13,220693
7612,0.001947,172.31.36.0-255,66,113398,13,220693
7613,0.001954,172.217.194.0-255,5738,119136,13,220693
7614,0.001956,172.31.36.0-255,66,119202,13,220693
7615,0.002029,172.217.194.0-255,9992,129194,13,220693
7616,0.002032,172.31.36.0-255,66,129260,13,220693
7617,0.002052,172.31.36.0-255,66,129326,13,220693
7618,0.002193,172.217.194.0-255,1484,130810,13,220693
7619,0.002199,172.217.194.0-255,2902,133712,13,220693
7620,0.002202,172.31.36.0-255,66,133778,13,220693
7621,0.002225,172.217.194.0-255,2902,136680,13,220693
7622,0.002228,172.31.36.0-255,66,136746,13,220693
7623,0.002244,172.217.194.0-255,2902,139648,13,220693
7624,0.002247,172.31.36.0-255,66,139714,13,220693
7625,0.002262,172.31.36.0-255,66,139780,13,220693
7626,0.002283,172.217.194.0-255,1484,141264,13,220693
7627,0.002295,172.217.194.0-255,8574,149838,13,220693
7628,0.002298,172.31.36.0-255,66,149904,13,220693
7629,0.002349,172.31.36.0-255,66,149970,13,220693
7630,0.002375,172.217.194.0-255,4320,154290,13,220693
7631,0.002378,172.31.36.0-255,66,154356,13,220693
7632,0.002409,172.217.194.0-255,4320,158676,13,220693
7633,0.002411,172.31.36.0-255,66,158742,13,220693
7634,0.002417,172.217.194.0-255,3602,162344,13,220693
7635,0.002419,172.31.36.0-255,66,162410,13,220693
7636,0.002423,172.217.194.0-255,1484,163894,13,220693
7637,0.002468,172.31.36.0-255,66,163960,13,220693
7638,0.002497,172.217.194.0-255,5738,169698,13,220693
7639,0.002499,172.31.36.0-255,66,169764,13,220693
7640,0.002508,172.217.194.0-255,7156,176920,13,220693
7641,0.00251,172.31.36.0-255,66,176986,13,220693
7642,0.002527,172.217.194.0-255,7856,184842,13,220693
7643,0.002529,172.31.36.0-255,66,184908,13,220693
7644,0.002537,172.217.194.0-255,8574,193482,13,220693
7645,0.00254,172.31.36.0-255,66,193548,13,220693
7646,0.002558,172.31.36.0-255,66,193614,13,220693
7647,0.002566,172.217.194.0-255,6438,200052,13,220693
7648,0.002568,172.31.36.0-255,66,200118,13,220693
7649,0.002603,172.217.194.0-255,5738,205856,13,220693
7650,0.002606,172.31.36.0-255,66,205922,13,220693
7651,0.002646,172.31.36.0-255,66,205988,13,220693
7652,0.002649,172.217.194.0-255,1484,207472,13,220693
7653,0.002688,172.31.36.0-255,66,207538,13,220693
7654,0.002696,172.217.194.0-255,8574,216112,13,220693
7655,0.002699,172.31.36.0-255,66,216178,13,220693
7656,0.002779,172.31.36.0-255,66,216244,13,220693
7657,0.002782,172.217.194.0-255,105,216349,13,220693
7658,0.005067,172.31.36.0-255,105,216454,13,220693
7659,0.007367,172.217.194.0-255,66,216520,13,220693
7660,0.028957,172.31.36.0-255,172,216692,13,220693
7661,0.028988,172.31.36.0-255,1109,217801,13,220693
7662,0.029052,172.31.36.0-255,1514,219315,13,220693
7663,0.029054,172.31.36.0-255,1180,220495,13,220693
7664,0.030503,104.244.42.0-255,66,220561,13,220693
7665,0.030594,104.244.42.0-255,66,220627,13,220693
7666,0.030622,104.244.42.0-255,66,220693,13,220693
7667,0.0,172.217.194.0-255,152,152,13,318076
7668,1e-05,172.31.36.0-255,66,218,13,318076
7669,3e-05,172.217.194.0-255,1484,1702,13,318076
7670,3.5e-05,172.31.36.0-255,66,1768,13,318076
7671,4.1e-05,172.217.194.0-255,2902,4670,13,318076
7672,4.4e-05,172.31.36.0-255,66,4736,13,318076
7673,4.9e-05,172.217.194.0-255,2902,7638,13,318076
7674,5.2e-05,172.31.36.0-255,66,7704,13,318076
7675,0.000101,172.217.194.0-255,5738,13442,13,318076
7676,0.000103,172.31.36.0-255,66,13508,13,318076
7677,0.00013,172.217.194.0-255,630,14138,13,318076
7678,0.000132,172.31.36.0-255,66,14204,13,318076
7679,0.00015,172.217.194.0-255,1484,15688,13,318076
7680,0.000152,172.31.36.0-255,66,15754,13,318076
7681,0.000157,172.217.194.0-255,2902,18656,13,318076
7682,0.000159,172.31.36.0-255,66,18722,13,318076
7683,0.000162,172.217.194.0-255,1484,20206,13,318076
7684,0.000164,172.31.36.0-255,66,20272,13,318076
7685,0.000188,172.217.194.0-255,4320,24592,13,318076
7686,0.00019,172.31.36.0-255,66,24658,13,318076
7687,0.000204,172.217.194.0-255,6797,31455,13,318076
7688,0.000206,172.31.36.0-255,66,31521,13,318076
7689,0.000242,172.217.194.0-255,7156,38677,13,318076
7690,0.000245,172.31.36.0-255,66,38743,13,318076
7691,0.000266,172.217.194.0-255,7156,45899,13,318076
7692,0.000269,172.31.36.0-255,66,45965,13,318076
7693,0.000292,172.217.194.0-255,2543,48508,13,318076
7694,0.000294,172.31.36.0-255,66,48574,13,318076
7695,0.000653,172.217.194.0-255,1484,50058,13,318076
7696,0.000659,172.31.36.0-255,66,50124,13,318076
7697,0.000665,172.217.194.0-255,2902,53026,13,318076
7698,0.000667,172.31.36.0-255,66,53092,13,318076
7699,0.000673,172.217.194.0-255,2902,55994,13,318076
7700,0.000682,172.31.36.0-255,66,56060,13,318076
7701,0.000713,172.217.194.0-255,2902,58962,13,318076
7702,0.000717,172.31.36.0-255,66,59028,13,318076
7703,0.000724,172.217.194.0-255,6797,65825,13,318076
7704,0.000727,172.31.36.0-255,66,65891,13,318076
7705,0.000862,172.217.194.0-255,1484,67375,13,318076
7706,0.000868,172.217.194.0-255,1484,68859,13,318076
7707,0.00087,172.31.36.0-255,66,68925,13,318076
7708,0.000903,172.217.194.0-255,1484,70409,13,318076
7709,0.000911,172.217.194.0-255,5738,76147,13,318076
7710,0.000913,172.31.36.0-255,66,76213,13,318076
7711,0.000959,172.31.36.0-255,66,76279,13,318076
7712,0.000979,172.217.194.0-255,4320,80599,13,318076
7713,0.000981,172.31.36.0-255,66,80665,13,318076
7714,0.001012,172.217.194.0-255,5958,86623,13,318076
7715,0.001015,172.31.36.0-255,66,86689,13,318076
7716,0.001085,172.217.194.0-255,1484,88173,13,318076
7717,0.001089,172.217.194.0-255,1484,89657,13,318076
7718,0.001092,172.31.36.0-255,66,89723,13,318076
7719,0.001118,172.217.194.0-255,1484,91207,13,318076
7720,0.001124,172.217.194.0-255,5738,96945,13,318076
7721,0.001127,172.31.36.0-255,66,97011,13,318076
7722,0.001133,172.217.194.0-255,4320,101331,13,318076
7723,0.001135,172.31.36.0-255,66,101397,13,318076
7724,0.001138,172.217.194.0-255,1484,102881,13,318076
7725,0.001175,172.217.194.0-255,9992,112873,13,318076
7726,0.00118,172.31.36.0-255,66,112939,13,318076
7727,0.001191,172.217.194.0-255,2902,115841,13,318076
7728,0.001197,172.31.36.0-255,66,115907,13,318076
7729,0.00123,172.217.194.0-255,5020,120927,13,318076
7730,0.001233,172.31.36.0-255,66,120993,13,318076
7731,0.001399,172.217.194.0-255,1484,122477,13,318076
7732,0.001408,172.217.194.0-255,2902,125379,13,318076
7733,0.001411,172.31.36.0-255,66,125445,13,318076
7734,0.001418,172.217.194.0-255,5738,131183,13,318076
7735,0.00142,172.31.36.0-255,66,131249,13,318076
7736,0.001432,172.217.194.0-255,5738,136987,13,318076
7737,0.001435,172.31.36.0-255,66,137053,13,318076
7738,0.001464,172.217.194.0-255,1484,138537,13,318076
7739,0.00148,172.31.36.0-255,66,138603,13,318076
7740,0.001524,172.217.194.0-255,7156,145759,13,318076
7741,0.001526,172.31.36.0-255,66,145825,13,318076
7742,0.001549,172.217.194.0-255,6438,152263,13,318076
7743,0.001551,172.31.36.0-255,66,152329,13,318076
7744,0.001567,172.31.36.0-255,66,152395,13,318076
7745,0.001575,172.217.194.0-255,7856,160251,13,318076
7746,0.001577,172.31.36.0-255,66,160317,13,318076
7747,0.001638,172.217.194.0-255,1484,161801,13,318076
7748,0.001642,172.217.194.0-255,1484,163285,13,318076
7749,0.001645,172.31.36.0-255,66,163351,13,318076
7750,0.001671,172.217.194.0-255,1484,164835,13,318076
7751,0.001678,172.217.194.0-255,5738,170573,13,318076
7752,0.001682,172.31.36.0-255,66,170639,13,318076
7753,0.001713,172.217.194.0-255,5738,176377,13,318076
7754,0.001716,172.31.36.0-255,66,176443,13,318076
7755,0.001725,172.217.194.0-255,8574,185017,13,318076
7756,0.001727,172.31.36.0-255,66,185083,13,318076
7757,0.001747,172.217.194.0-255,4320,189403,13,318076
7758,0.001749,172.31.36.0-255,66,189469,13,318076
7759,0.001756,172.217.194.0-255,5020,194489,13,318076
7760,0.001759,172.31.36.0-255,66,194555,13,318076
7761,0.001915,172.217.194.0-255,1484,196039,13,318076
7762,0.001922,172.217.194.0-255,2902,198941,13,318076
7763,0.001926,172.31.36.0-255,66,199007,13,318076
7764,0.001929,172.217.194.0-255,1484,200491,13,318076
7765,0.001956,172.217.194.0-255,4320,204811,13,318076
7766,0.001959,172.31.36.0-255,66,204877,13,318076
7767,0.001972,172.217.194.0-255,7156,212033,13,318076
7768,0.001975,172.31.36.0-255,66,212099,13,318076
7769,0.002012,172.217.194.0-255,5738,217837,13,318076
7770,0.002016,172.31.36.0-255,66,217903,13,318076
7771,0.002023,172.217.194.0-255,5738,223641,13,318076
7772,0.002025,172.31.36.0-255,66,223707,13,318076
7773,0.002036,172.217.194.0-255,5020,228727,13,318076
7774,0.002039,172.31.36.0-255,66,228793,13,318076
7775,0.002047,172.217.194.0-255,8574,237367,13,318076
7776,0.002049,172.31.36.0-255,66,237433,13,318076
7777,0.002057,172.217.194.0-255,7156,244589,13,318076
7778,0.002059,172.31.36.0-255,66,244655,13,318076
7779,0.002062,172.217.194.0-255,1484,246139,13,318076
7780,0.002065,172.217.194.0-255,1484,247623,13,318076
7781,0.002067,172.31.36.0-255,66,247689,13,318076
7782,0.002113,172.31.36.0-255,66,247755,13,318076
7783,0.002116,172.217.194.0-255,766,248521,13,318076
7784,0.002118,172.217.194.0-255,1484,250005,13,318076
7785,0.00212,172.31.36.0-255,66,250071,13,318076
7786,0.002125,172.217.194.0-255,4320,254391,13,318076
7787,0.002128,172.31.36.0-255,66,254457,13,318076
7788,0.002168,172.217.194.0-255,8574,263031,13,318076
7789,0.002171,172.31.36.0-255,66,263097,13,318076
7790,0.00218,172.217.194.0-255,9992,273089,13,318076
7791,0.002182,172.31.36.0-255,66,273155,13,318076
7792,0.002192,172.217.194.0-255,4320,277475,13,318076
7793,0.002194,172.31.36.0-255,66,277541,13,318076
7794,0.002201,172.217.194.0-255,5020,282561,13,318076
7795,0.002203,172.31.36.0-255,66,282627,13,318076
7796,0.002218,172.217.194.0-255,5738,288365,13,318076
7797,0.002221,172.31.36.0-255,66,288431,13,318076
7798,0.002257,172.31.36.0-255,66,288497,13,318076
7799,0.002266,172.217.194.0-255,8574,297071,13,318076
7800,0.002268,172.31.36.0-255,66,297137,13,318076
7801,0.002309,172.217.194.0-255,1484,298621,13,318076
7802,0.002337,172.217.194.0-255,7856,306477,13,318076
7803,0.00234,172.31.36.0-255,66,306543,13,318076
7804,0.002343,172.217.194.0-255,1484,308027,13,318076
7805,0.002348,172.217.194.0-255,4320,312347,13,318076
7806,0.002351,172.31.36.0-255,66,312413,13,318076
7807,0.002358,172.217.194.0-255,849,313262,13,318076
7808,0.002361,172.217.194.0-255,105,313367,13,318076
7809,0.010539,172.31.36.0-255,66,313433,13,318076
7810,0.010578,172.31.36.0-255,105,313538,13,318076
7811,0.01081,172.217.194.0-255,105,313643,13,318076
7812,0.010819,172.31.36.0-255,78,313721,13,318076
7813,0.012578,172.217.194.0-255,66,313787,13,318076
7814,0.033014,172.31.36.0-255,172,313959,13,318076
7815,0.033049,172.31.36.0-255,1106,315065,13,318076
7816,0.033111,172.31.36.0-255,1514,316579,13,318076
7817,0.033113,172.31.36.0-255,1299,317878,13,318076
7818,0.034587,104.244.42.0-255,66,317944,13,318076
7819,0.034618,104.244.42.0-255,66,318010,13,318076
7820,0.034638,104.244.42.0-255,66,318076,13,318076
7821,0.0,172.217.194.0-255,143,143,13,319745
7822,2.3e-05,172.31.36.0-255,66,209,13,319745
7823,3.1e-05,172.217.194.0-255,1484,1693,13,319745
7824,3.7e-05,172.31.36.0-255,66,1759,13,319745
7825,4.3e-05,172.217.194.0-255,2902,4661,13,319745
7826,4.6e-05,172.31.36.0-255,66,4727,13,319745
7827,4.9e-05,172.217.194.0-255,1484,6211,13,319745
7828,5.1e-05,172.31.36.0-255,66,6277,13,319745
7829,5.5e-05,172.217.194.0-255,1484,7761,13,319745
7830,5.7e-05,172.31.36.0-255,66,7827,13,319745
7831,8.7e-05,172.217.194.0-255,4320,12147,13,319745
7832,9.1e-05,172.31.36.0-255,66,12213,13,319745
7833,9.6e-05,172.217.194.0-255,2048,14261,13,319745
7834,9.9e-05,172.31.36.0-255,66,14327,13,319745
7835,0.001042,172.217.194.0-255,1484,15811,13,319745
7836,0.00105,172.31.36.0-255,66,15877,13,319745
7837,0.001061,172.217.194.0-255,2902,18779,13,319745
7838,0.001063,172.31.36.0-255,66,18845,13,319745
7839,0.001071,172.217.194.0-255,5738,24583,13,319745
7840,0.001073,172.31.36.0-255,66,24649,13,319745
7841,0.001114,172.217.194.0-255,4320,28969,13,319745
7842,0.001116,172.31.36.0-255,66,29035,13,319745
7843,0.001141,172.217.194.0-255,8215,37250,13,319745
7844,0.001145,172.31.36.0-255,66,37316,13,319745
7845,0.001164,172.217.194.0-255,2902,40218,13,319745
7846,0.001166,172.31.36.0-255,66,40284,13,319745
7847,0.001194,172.217.194.0-255,8215,48499,13,319745
7848,0.001197,172.31.36.0-255,66,48565,13,319745
7849,0.001324,172.217.194.0-255,1484,50049,13,319745
7850,0.001326,172.31.36.0-255,66,50115,13,319745
7851,0.00134,172.217.194.0-255,2902,53017,13,319745
7852,0.001342,172.31.36.0-255,66,53083,13,319745
7853,0.001374,172.217.194.0-255,4320,57403,13,319745
7854,0.001378,172.31.36.0-255,66,57469,13,319745
7855,0.001396,172.217.194.0-255,1484,58953,13,319745
7856,0.001403,172.217.194.0-255,4320,63273,13,319745
7857,0.001406,172.31.36.0-255,66,63339,13,319745
7858,0.00142,172.217.194.0-255,2543,65882,13,319745
7859,0.001422,172.31.36.0-255,66,65948,13,319745
7860,0.001755,172.217.194.0-255,646,66594,13,319745
7861,0.001874,172.217.194.0-255,1484,68078,13,319745
7862,0.001877,172.31.36.0-255,66,68144,13,319745
7863,0.001881,172.217.194.0-255,2902,71046,13,319745
7864,0.001884,172.31.36.0-255,66,71112,13,319745
7865,0.001908,172.217.194.0-255,5738,76850,13,319745
7866,0.001911,172.31.36.0-255,66,76916,13,319745
7867,0.001921,172.217.194.0-255,1484,78400,13,319745
7868,0.00194,172.217.194.0-255,4830,83230,13,319745
7869,0.001942,172.31.36.0-255,66,83296,13,319745
7870,0.004089,172.217.194.0-255,5738,89034,13,319745
7871,0.0041,172.31.36.0-255,66,89100,13,319745
7872,0.006251,172.217.194.0-255,5738,94838,13,319745
7873,0.00626,172.31.36.0-255,66,94904,13,319745
7874,0.008408,172.217.194.0-255,5738,100642,13,319745
7875,0.008418,172.31.36.0-255,66,100708,13,319745
7876,0.010569,172.217.194.0-255,5738,106446,13,319745
7877,0.010578,172.31.36.0-255,66,106512,13,319745
7878,0.012728,172.217.194.0-255,5738,112250,13,319745
7879,0.01274,172.31.36.0-255,66,112316,13,319745
7880,0.014897,172.217.194.0-255,5738,118054,13,319745
7881,0.014908,172.31.36.0-255,66,118120,13,319745
7882,0.017067,172.217.194.0-255,5738,123858,13,319745
7883,0.017078,172.31.36.0-255,66,123924,13,319745
7884,0.019215,172.217.194.0-255,5738,129662,13,319745
7885,0.019225,172.31.36.0-255,66,129728,13,319745
7886,0.021376,172.217.194.0-255,5738,135466,13,319745
7887,0.021391,172.31.36.0-255,66,135532,13,319745
7888,0.023571,172.217.194.0-255,5738,141270,13,319745
7889,0.023578,172.31.36.0-255,66,141336,13,319745
7890,0.025724,172.217.194.0-255,5738,147074,13,319745
7891,0.025732,172.31.36.0-255,66,147140,13,319745
7892,0.027873,172.217.194.0-255,5738,152878,13,319745
7893,0.027881,172.31.36.0-255,66,152944,13,319745
7894,0.030022,172.217.194.0-255,5738,158682,13,319745
7895,0.030034,172.31.36.0-255,66,158748,13,319745
7896,0.032186,172.217.194.0-255,5738,164486,13,319745
7897,0.032202,172.31.36.0-255,66,164552,13,319745
7898,0.033658,172.31.36.0-255,172,164724,13,319745
7899,0.0337,172.31.36.0-255,1110,165834,13,319745
7900,0.033763,172.31.36.0-255,1514,167348,13,319745
7901,0.033764,172.31.36.0-255,1295,168643,13,319745
7902,0.034339,172.217.194.0-255,5738,174381,13,319745
7903,0.034348,172.31.36.0-255,66,174447,13,319745
7904,0.035318,104.244.42.0-255,66,174513,13,319745
7905,0.035364,104.244.42.0-255,66,174579,13,319745
7906,0.035424,104.244.42.0-255,66,174645,13,319745
7907,0.036512,172.217.194.0-255,5738,180383,13,319745
7908,0.036524,172.31.36.0-255,66,180449,13,319745
7909,0.038652,172.217.194.0-255,5738,186187,13,319745
7910,0.038663,172.31.36.0-255,66,186253,13,319745
7911,0.040833,172.217.194.0-255,5738,191991,13,319745
7912,0.040843,172.31.36.0-255,66,192057,13,319745
7913,0.042968,172.217.194.0-255,5738,197795,13,319745
7914,0.042979,172.31.36.0-255,66,197861,13,319745
7915,0.045099,172.217.194.0-255,5738,203599,13,319745
7916,0.045108,172.31.36.0-255,66,203665,13,319745
7917,0.047259,172.217.194.0-255,5738,209403,13,319745
7918,0.047268,172.31.36.0-255,66,209469,13,319745
7919,0.049403,172.217.194.0-255,5738,215207,13,319745
7920,0.04941,172.31.36.0-255,66,215273,13,319745
7921,0.051564,172.217.194.0-255,5738,221011,13,319745
7922,0.051574,172.31.36.0-255,66,221077,13,319745
7923,0.053741,172.217.194.0-255,5738,226815,13,319745
7924,0.053754,172.31.36.0-255,66,226881,13,319745
7925,0.055914,172.217.194.0-255,5738,232619,13,319745
7926,0.055925,172.31.36.0-255,66,232685,13,319745
7927,0.058051,172.217.194.0-255,5738,238423,13,319745
7928,0.058061,172.31.36.0-255,66,238489,13,319745
7929,0.060212,172.217.194.0-255,5738,244227,13,319745
7930,0.060224,172.31.36.0-255,66,244293,13,319745
7931,0.062347,172.217.194.0-255,5738,250031,13,319745
7932,0.062356,172.31.36.0-255,66,250097,13,319745
7933,0.064493,172.217.194.0-255,5738,255835,13,319745
7934,0.064499,172.31.36.0-255,66,255901,13,319745
7935,0.066646,172.217.194.0-255,5738,261639,13,319745
7936,0.066653,172.31.36.0-255,66,261705,13,319745
7937,0.068792,172.217.194.0-255,5738,267443,13,319745
7938,0.0688,172.31.36.0-255,66,267509,13,319745
7939,0.070956,172.217.194.0-255,5738,273247,13,319745
7940,0.070963,172.31.36.0-255,66,273313,13,319745
7941,0.073128,172.217.194.0-255,5738,279051,13,319745
7942,0.073134,172.31.36.0-255,66,279117,13,319745
7943,0.075315,172.217.194.0-255,5738,284855,13,319745
7944,0.075325,172.31.36.0-255,66,284921,13,319745
7945,0.077473,172.217.194.0-255,5738,290659,13,319745
7946,0.077482,172.31.36.0-255,66,290725,13,319745
7947,0.079652,172.217.194.0-255,5738,296463,13,319745
7948,0.079664,172.31.36.0-255,66,296529,13,319745
7949,0.081839,172.217.194.0-255,5738,302267,13,319745
7950,0.081847,172.31.36.0-255,66,302333,13,319745
7951,0.084045,172.217.194.0-255,5738,308071,13,319745
7952,0.084054,172.31.36.0-255,66,308137,13,319745
7953,0.086175,172.217.194.0-255,5738,313875,13,319745
7954,0.086182,172.31.36.0-255,66,313941,13,319745
7955,0.08831,172.217.194.0-255,5738,319679,13,319745
7956,0.088317,172.31.36.0-255,66,319745,13,319745
7957,0.0,74.125.24.0-255,153,153,13,336508
7958,2.6e-05,74.125.24.0-255,1484,1637,13,336508
7959,3.3e-05,172.31.36.0-255,66,1703,13,336508
7960,5.7e-05,74.125.24.0-255,2902,4605,13,336508
7961,6e-05,172.31.36.0-255,66,4671,13,336508
7962,6.8e-05,74.125.24.0-255,7156,11827,13,336508
7963,7e-05,172.31.36.0-255,66,11893,13,336508
7964,7.4e-05,74.125.24.0-255,2040,13933,13,336508
7965,7.8e-05,172.31.36.0-255,66,13999,13,336508
7966,0.000111,74.125.24.0-255,4320,18319,13,336508
7967,0.000115,172.31.36.0-255,66,18385,13,336508
7968,0.000142,74.125.24.0-255,7156,25541,13,336508
7969,0.000145,172.31.36.0-255,66,25607,13,336508
7970,0.000153,74.125.24.0-255,9992,35599,13,336508
7971,0.000155,172.31.36.0-255,66,35665,13,336508
7972,0.000173,74.125.24.0-255,2902,38567,13,336508
7973,0.000175,172.31.36.0-255,66,38633,13,336508
7974,0.000204,74.125.24.0-255,9274,47907,13,336508
7975,0.00025,172.31.36.0-255,66,47973,13,336508
7976,0.000652,74.125.24.0-255,1484,49457,13,336508
7977,0.000657,74.125.24.0-255,2902,52359,13,336508
7978,0.00066,172.31.36.0-255,66,52425,13,336508
7979,0.000667,74.125.24.0-255,4320,56745,13,336508
7980,0.000685,172.31.36.0-255,66,56811,13,336508
7981,0.000703,74.125.24.0-255,1484,58295,13,336508
7982,0.000711,74.125.24.0-255,5738,64033,13,336508
7983,0.000713,172.31.36.0-255,66,64099,13,336508
7984,0.000716,74.125.24.0-255,1394,65493,13,336508
7985,0.001084,74.125.24.0-255,136,65629,13,336508
7986,0.00135,74.125.24.0-255,347,65976,13,336508
7987,0.001356,172.31.36.0-255,66,66042,13,336508
7988,0.002163,74.125.24.0-255,1484,67526,13,336508
7989,0.002175,74.125.24.0-255,2902,70428,13,336508
7990,0.002177,172.31.36.0-255,66,70494,13,336508
7991,0.002183,74.125.24.0-255,4320,74814,13,336508
7992,0.002184,172.31.36.0-255,66,74880,13,336508
7993,0.002196,74.125.24.0-255,1484,76364,13,336508
7994,0.002203,74.125.24.0-255,7156,83520,13,336508
7995,0.002205,172.31.36.0-255,66,83586,13,336508
7996,0.002227,74.125.24.0-255,5738,89324,13,336508
7997,0.002228,172.31.36.0-255,66,89390,13,336508
7998,0.002233,74.125.24.0-255,4320,93710,13,336508
7999,0.002249,74.125.24.0-255,5738,99448,13,336508
8000,0.002251,74.125.24.0-255,766,100214,13,336508
8001,0.003172,74.125.24.0-255,1484,101698,13,336508
8002,0.003176,74.125.24.0-255,2902,104600,13,336508
8003,0.003195,74.125.24.0-255,5738,110338,13,336508
8004,0.00321,74.125.24.0-255,1484,111822,13,336508
8005,0.003231,74.125.24.0-255,8574,120396,13,336508
8006,0.003247,74.125.24.0-255,5738,126134,13,336508
8007,0.00326,74.125.24.0-255,4320,130454,13,336508
8008,0.0033,74.125.24.0-255,3602,134056,13,336508
8009,0.003674,74.125.24.0-255,1484,135540,13,336508
8010,0.003692,74.125.24.0-255,2902,138442,13,336508
8011,0.003698,74.125.24.0-255,5738,144180,13,336508
8012,0.003722,74.125.24.0-255,2902,147082,13,336508
8013,0.003744,74.125.24.0-255,9992,157074,13,336508
8014,0.003754,74.125.24.0-255,9992,167066,13,336508
8015,0.003767,74.125.24.0-255,766,167832,13,336508
8016,0.004195,74.125.24.0-255,1484,169316,13,336508
8017,0.004199,74.125.24.0-255,2902,172218,13,336508
8018,0.004213,74.125.24.0-255,5738,177956,13,336508
8019,0.004237,74.125.24.0-255,2902,180858,13,336508
8020,0.004253,74.125.24.0-255,7156,188014,13,336508
8021,0.004265,74.125.24.0-255,2902,190916,13,336508
8022,0.004271,74.125.24.0-255,7156,198072,13,336508
8023,0.004291,74.125.24.0-255,3602,201674,13,336508
8024,0.004376,74.125.24.0-255,1484,203158,13,336508
8025,0.00438,74.125.24.0-255,2902,206060,13,336508
8026,0.004407,74.125.24.0-255,2902,208962,13,336508
8027,0.00443,74.125.24.0-255,2902,211864,13,336508
8028,0.004432,74.125.24.0-255,1484,213348,13,336508
8029,0.004469,74.125.24.0-255,10692,224040,13,336508
8030,0.004473,74.125.24.0-255,4320,228360,13,336508
8031,0.004476,74.125.24.0-255,1484,229844,13,336508
8032,0.004496,74.125.24.0-255,4320,234164,13,336508
8033,0.004502,74.125.24.0-255,5738,239902,13,336508
8034,0.004538,74.125.24.0-255,4320,244222,13,336508
8035,0.004561,74.125.24.0-255,2184,246406,13,336508
8036,0.00461,74.125.24.0-255,1484,247890,13,336508
8037,0.004623,74.125.24.0-255,2902,250792,13,336508
8038,0.004627,74.125.24.0-255,1484,252276,13,336508
8039,0.004641,74.125.24.0-255,4320,256596,13,336508
8040,0.004664,74.125.24.0-255,2902,259498,13,336508
8041,0.004695,74.125.24.0-255,9992,269490,13,336508
8042,0.004699,74.125.24.0-255,1484,270974,13,336508
8043,0.004723,74.125.24.0-255,8574,279548,13,336508
8044,0.004739,74.125.24.0-255,7856,287404,13,336508
8045,0.004776,74.125.24.0-255,4320,291724,13,336508
8046,0.004797,74.125.24.0-255,7156,298880,13,336508
8047,0.004842,74.125.24.0-255,10692,309572,13,336508
8048,0.004848,74.125.24.0-255,5738,315310,13,336508
8049,0.004883,74.125.24.0-255,5738,321048,13,336508
8050,0.004897,74.125.24.0-255,5581,326629,13,336508
8051,0.004913,74.125.24.0-255,105,326734,13,336508
8052,0.004963,172.31.36.0-255,66,326800,13,336508
8053,0.005379,172.31.36.0-255,101,326901,13,336508
8054,0.007409,172.31.36.0-255,105,327006,13,336508
8055,0.007618,74.125.24.0-255,66,327072,13,336508
8056,0.009666,74.125.24.0-255,66,327138,13,336508
8057,0.032322,172.31.36.0-255,172,327310,13,336508
8058,0.032353,172.31.36.0-255,1109,328419,13,336508
8059,0.032398,172.31.36.0-255,1514,329933,13,336508
8060,0.032399,172.31.36.0-255,1514,331447,13,336508
8061,0.032401,172.31.36.0-255,1514,332961,13,336508
8062,0.032402,172.31.36.0-255,1514,334475,13,336508
8063,0.03243,172.31.36.0-255,1514,335989,13,336508
8064,0.032437,172.31.36.0-255,81,336070,13,336508
8065,0.033843,104.244.42.0-255,66,336136,13,336508
8066,0.03387,104.244.42.0-255,66,336202,13,336508
8067,0.033954,104.244.42.0-255,66,336268,13,336508
8068,0.034001,104.244.42.0-255,66,336334,13,336508
8069,0.034942,104.244.42.0-255,108,336442,13,336508
8070,0.034965,172.31.36.0-255,66,336508,13,336508
8071,0.0,74.125.68.0-255,150,150,13,391789
8072,2.8e-05,74.125.68.0-255,1484,1634,13,391789
8073,3.6e-05,172.31.36.0-255,66,1700,13,391789
8074,4.1e-05,74.125.68.0-255,1484,3184,13,391789
8075,4.7e-05,74.125.68.0-255,2902,6086,13,391789
8076,5e-05,172.31.36.0-255,66,6152,13,391789
8077,7.9e-05,74.125.68.0-255,5738,11890,13,391789
8078,8.2e-05,172.31.36.0-255,66,11956,13,391789
8079,8.5e-05,74.125.68.0-255,1484,13440,13,391789
8080,0.000103,74.125.68.0-255,3418,16858,13,391789
8081,0.000105,172.31.36.0-255,66,16924,13,391789
8082,0.000112,74.125.68.0-255,5738,22662,13,391789
8083,0.000115,172.31.36.0-255,66,22728,13,391789
8084,0.000151,74.125.68.0-255,8215,30943,13,391789
8085,0.000154,172.31.36.0-255,66,31009,13,391789
8086,0.00082,74.125.68.0-255,1484,32493,13,391789
8087,0.00083,74.125.68.0-255,2902,35395,13,391789
8088,0.000834,172.31.36.0-255,66,35461,13,391789
8089,0.000839,74.125.68.0-255,1484,36945,13,391789
8090,0.000854,74.125.68.0-255,1484,38429,13,391789
8091,0.000857,172.31.36.0-255,66,38495,13,391789
8092,0.000863,74.125.68.0-255,4320,42815,13,391789
8093,0.000865,172.31.36.0-255,66,42881,13,391789
8094,0.000914,74.125.68.0-255,8574,51455,13,391789
8095,0.000917,172.31.36.0-255,66,51521,13,391789
8096,0.000923,74.125.68.0-255,4320,55841,13,391789
8097,0.000925,172.31.36.0-255,66,55907,13,391789
8098,0.000932,74.125.68.0-255,5738,61645,13,391789
8099,0.000934,172.31.36.0-255,66,61711,13,391789
8100,0.000969,74.125.68.0-255,3602,65313,13,391789
8101,0.000972,172.31.36.0-255,66,65379,13,391789
8102,0.001138,74.125.68.0-255,395,65774,13,391789
8103,0.001179,74.125.68.0-255,115,65889,13,391789
8104,0.001471,74.125.68.0-255,1484,67373,13,391789
8105,0.001477,172.31.36.0-255,66,67439,13,391789
8106,0.001485,74.125.68.0-255,2902,70341,13,391789
8107,0.001488,172.31.36.0-255,66,70407,13,391789
8108,0.001503,74.125.68.0-255,1484,71891,13,391789
8109,0.001517,74.125.68.0-255,4320,76211,13,391789
8110,0.001519,172.31.36.0-255,66,76277,13,391789
8111,0.001541,74.125.68.0-255,7156,83433,13,391789
8112,0.001543,172.31.36.0-255,66,83499,13,391789
8113,0.001569,74.125.68.0-255,1484,84983,13,391789
8114,0.001578,74.125.68.0-255,9992,94975,13,391789
8115,0.001581,172.31.36.0-255,66,95041,13,391789
8116,0.001587,74.125.68.0-255,5020,100061,13,391789
8117,0.001589,172.31.36.0-255,66,100127,13,391789
8118,0.001978,74.125.68.0-255,1484,101611,13,391789
8119,0.001995,74.125.68.0-255,2902,104513,13,391789
8120,0.001998,172.31.36.0-255,66,104579,13,391789
8121,0.002011,74.125.68.0-255,1484,106063,13,391789
8122,0.002047,74.125.68.0-255,4320,110383,13,391789
8123,0.00205,172.31.36.0-255,66,110449,13,391789
8124,0.002062,74.125.68.0-255,1484,111933,13,391789
8125,0.002065,74.125.68.0-255,1484,113417,13,391789
8126,0.002068,172.31.36.0-255,66,113483,13,391789
8127,0.002089,74.125.68.0-255,2902,116385,13,391789
8128,0.002092,172.31.36.0-255,66,116451,13,391789
8129,0.002096,74.125.68.0-255,2902,119353,13,391789
8130,0.002098,172.31.36.0-255,66,119419,13,391789
8131,0.002111,74.125.68.0-255,2902,122321,13,391789
8132,0.002114,172.31.36.0-255,66,122387,13,391789
8133,0.002119,74.125.68.0-255,4320,126707,13,391789
8134,0.002122,172.31.36.0-255,66,126773,13,391789
8135,0.002143,74.125.68.0-255,1484,128257,13,391789
8136,0.002147,74.125.68.0-255,2902,131159,13,391789
8137,0.00215,172.31.36.0-255,66,131225,13,391789
8138,0.00217,74.125.68.0-255,3602,134827,13,391789
8139,0.002172,172.31.36.0-255,66,134893,13,391789
8140,0.002673,74.125.68.0-255,1484,136377,13,391789
8141,0.002691,74.125.68.0-255,2902,139279,13,391789
8142,0.002694,172.31.36.0-255,66,139345,13,391789
8143,0.002731,74.125.68.0-255,5738,145083,13,391789
8144,0.002734,172.31.36.0-255,66,145149,13,391789
8145,0.002739,74.125.68.0-255,2902,148051,13,391789
8146,0.002742,172.31.36.0-255,66,148117,13,391789
8147,0.002774,74.125.68.0-255,5738,153855,13,391789
8148,0.002777,172.31.36.0-255,66,153921,13,391789
8149,0.002785,74.125.68.0-255,9992,163913,13,391789
8150,0.002788,172.31.36.0-255,66,163979,13,391789
8151,0.002794,74.125.68.0-255,5020,168999,13,391789
8152,0.002797,172.31.36.0-255,66,169065,13,391789
8153,0.002976,74.125.68.0-255,1484,170549,13,391789
8154,0.002995,74.125.68.0-255,2902,173451,13,391789
8155,0.002998,172.31.36.0-255,66,173517,13,391789
8156,0.003019,74.125.68.0-255,5738,179255,13,391789
8157,0.003021,172.31.36.0-255,66,179321,13,391789
8158,0.003025,74.125.68.0-255,1484,180805,13,391789
8159,0.003041,74.125.68.0-255,2902,183707,13,391789
8160,0.003044,172.31.36.0-255,66,183773,13,391789
8161,0.003061,74.125.68.0-255,1484,185257,13,391789
8162,0.00308,74.125.68.0-255,4320,189577,13,391789
8163,0.003083,172.31.36.0-255,66,189643,13,391789
8164,0.003089,74.125.68.0-255,5738,195381,13,391789
8165,0.003092,172.31.36.0-255,66,195447,13,391789
8166,0.003095,74.125.68.0-255,1484,196931,13,391789
8167,0.003126,74.125.68.0-255,5738,202669,13,391789
8168,0.003129,172.31.36.0-255,66,202735,13,391789
8169,0.003132,74.125.68.0-255,766,203501,13,391789
8170,0.003135,74.125.68.0-255,1484,204985,13,391789
8171,0.003137,172.31.36.0-255,66,205051,13,391789
8172,0.003157,74.125.68.0-255,1484,206535,13,391789
8173,0.003177,74.125.68.0-255,4320,210855,13,391789
8174,0.00318,172.31.36.0-255,66,210921,13,391789
8175,0.003183,74.125.68.0-255,1484,212405,13,391789
8176,0.003187,74.125.68.0-255,2902,215307,13,391789
8177,0.00319,172.31.36.0-255,66,215373,13,391789
8178,0.003217,74.125.68.0-255,5738,221111,13,391789
8179,0.00322,172.31.36.0-255,66,221177,13,391789
8180,0.003223,74.125.68.0-255,1484,222661,13,391789
8181,0.00324,74.125.68.0-255,2902,225563,13,391789
8182,0.003242,172.31.36.0-255,66,225629,13,391789
8183,0.003245,74.125.68.0-255,1484,227113,13,391789
8184,0.003304,74.125.68.0-255,4320,231433,13,391789
8185,0.003306,172.31.36.0-255,66,231499,13,391789
8186,0.003313,74.125.68.0-255,6438,237937,13,391789
8187,0.003316,172.31.36.0-255,66,238003,13,391789
8188,0.003403,74.125.68.0-255,1484,239487,13,391789
8189,0.003406,74.125.68.0-255,1484,240971,13,391789
8190,0.003409,172.31.36.0-255,66,241037,13,391789
8191,0.003425,74.125.68.0-255,1484,242521,13,391789
8192,0.003429,74.125.68.0-255,2902,245423,13,391789
8193,0.003432,172.31.36.0-255,66,245489,13,391789
8194,0.003454,74.125.68.0-255,2902,248391,13,391789
8195,0.003456,172.31.36.0-255,66,248457,13,391789
8196,0.003459,74.125.68.0-255,1484,249941,13,391789
8197,0.003467,74.125.68.0-255,2902,252843,13,391789
8198,0.00347,172.31.36.0-255,66,252909,13,391789
8199,0.003473,74.125.68.0-255,1484,254393,13,391789
8200,0.003491,74.125.68.0-255,4320,258713,13,391789
8201,0.003494,172.31.36.0-255,66,258779,13,391789
8202,0.0035,74.125.68.0-255,5738,264517,13,391789
8203,0.003502,172.31.36.0-255,66,264583,13,391789
8204,0.003518,74.125.68.0-255,2902,267485,13,391789
8205,0.003521,172.31.36.0-255,66,267551,13,391789
8206,0.00354,74.125.68.0-255,5020,272571,13,391789
8207,0.003542,172.31.36.0-255,66,272637,13,391789
8208,0.003673,74.125.68.0-255,1484,274121,13,391789
8209,0.003693,74.125.68.0-255,2902,277023,13,391789
8210,0.003698,172.31.36.0-255,66,277089,13,391789
8211,0.003703,74.125.68.0-255,4320,281409,13,391789
8212,0.003729,74.125.68.0-255,1484,282893,13,391789
8213,0.003755,74.125.68.0-255,7156,290049,13,391789
8214,0.00376,74.125.68.0-255,2902,292951,13,391789
8215,0.003777,74.125.68.0-255,7156,300107,13,391789
8216,0.003803,74.125.68.0-255,5738,305845,13,391789
8217,0.003806,74.125.68.0-255,766,306611,13,391789
8218,0.003809,74.125.68.0-255,1484,308095,13,391789
8219,0.003822,74.125.68.0-255,2902,310997,13,391789
8220,0.003833,74.125.68.0-255,1484,312481,13,391789
8221,0.003835,74.125.68.0-255,1484,313965,13,391789
8222,0.003838,74.125.68.0-255,1484,315449,13,391789
8223,0.00385,74.125.68.0-255,1484,316933,13,391789
8224,0.003868,74.125.68.0-255,2902,319835,13,391789
8225,0.003883,74.125.68.0-255,1484,321319,13,391789
8226,0.003889,74.125.68.0-255,4320,325639,13,391789
8227,0.003892,74.125.68.0-255,1484,327123,13,391789
8228,0.003902,74.125.68.0-255,1484,328607,13,391789
8229,0.003938,74.125.68.0-255,1484,330091,13,391789
8230,0.003958,74.125.68.0-255,8574,338665,13,391789
8231,0.003995,74.125.68.0-255,2184,340849,13,391789
8232,0.004155,172.31.36.0-255,66,340915,13,391789
8233,0.004224,74.125.68.0-255,1484,342399,13,391789
8234,0.004248,74.125.68.0-255,2902,345301,13,391789
8235,0.004253,74.125.68.0-255,2902,348203,13,391789
8236,0.004265,74.125.68.0-255,1484,349687,13,391789
8237,0.004286,74.125.68.0-255,7156,356843,13,391789
8238,0.004292,172.31.36.0-255,66,356909,13,391789
8239,0.004306,74.125.68.0-255,1484,358393,13,391789
8240,0.004313,74.125.68.0-255,4320,362713,13,391789
8241,0.004318,74.125.68.0-255,5738,368451,13,391789
8242,0.004336,74.125.68.0-255,1484,369935,13,391789
8243,0.00434,172.31.36.0-255,66,370001,13,391789
8244,0.004362,74.125.68.0-255,5020,375021,13,391789
8245,0.00437,172.31.36.0-255,66,375087,13,391789
8246,0.004572,74.125.68.0-255,1484,376571,13,391789
8247,0.004578,74.125.68.0-255,2902,379473,13,391789
8248,0.004588,172.31.36.0-255,66,379539,13,391789
8249,0.004605,74.125.68.0-255,5738,385277,13,391789
8250,0.004626,172.31.36.0-255,66,385343,13,391789
8251,0.004658,74.125.68.0-255,1646,386989,13,391789
8252,0.004662,74.125.68.0-255,105,387094,13,391789
8253,0.004681,172.31.36.0-255,66,387160,13,391789
8254,0.007099,172.31.36.0-255,105,387265,13,391789
8255,0.009378,74.125.68.0-255,66,387331,13,391789
8256,0.032985,172.31.36.0-255,167,387498,13,391789
8257,0.033018,172.31.36.0-255,1109,388607,13,391789
8258,0.033076,172.31.36.0-255,1514,390121,13,391789
8259,0.033078,172.31.36.0-255,1296,391417,13,391789
8260,0.034557,104.244.42.0-255,66,391483,13,391789
8261,0.034588,104.244.42.0-255,66,391549,13,391789
8262,0.034636,104.244.42.0-255,66,391615,13,391789
8263,0.03808,104.244.42.0-255,108,391723,13,391789
8264,0.038089,172.31.36.0-255,66,391789,13,391789
8265,0.0,74.125.68.0-255,66,66,13,66
8266,0.0,74.125.24.0-255,153,153,13,311065
8267,3.1e-05,74.125.24.0-255,1484,1637,13,311065
8268,4.3e-05,172.31.36.0-255,66,1703,13,311065
8269,5e-05,74.125.24.0-255,2902,4605,13,311065
8270,5.2e-05,172.31.36.0-255,66,4671,13,311065
8271,6.1e-05,74.125.24.0-255,7156,11827,13,311065
8272,6.4e-05,172.31.36.0-255,66,11893,13,311065
8273,6.8e-05,74.125.24.0-255,2039,13932,13,311065
8274,7.1e-05,172.31.36.0-255,66,13998,13,311065
8275,0.00033,74.125.24.0-255,1484,15482,13,311065
8276,0.000347,74.125.24.0-255,2902,18384,13,311065
8277,0.000352,172.31.36.0-255,66,18450,13,311065
8278,0.000359,74.125.24.0-255,5738,24188,13,311065
8279,0.000361,172.31.36.0-255,66,24254,13,311065
8280,0.000381,74.125.24.0-255,2902,27156,13,311065
8281,0.000383,172.31.36.0-255,66,27222,13,311065
8282,0.00041,74.125.24.0-255,3961,31183,13,311065
8283,0.000413,172.31.36.0-255,66,31249,13,311065
8284,0.000421,74.125.24.0-255,7156,38405,13,311065
8285,0.000424,172.31.36.0-255,66,38471,13,311065
8286,0.000465,74.125.24.0-255,9633,48104,13,311065
8287,0.000469,172.31.36.0-255,66,48170,13,311065
8288,0.000495,74.125.24.0-255,1484,49654,13,311065
8289,0.0005,74.125.24.0-255,2902,52556,13,311065
8290,0.000503,172.31.36.0-255,66,52622,13,311065
8291,0.000523,74.125.24.0-255,4320,56942,13,311065
8292,0.000526,172.31.36.0-255,66,57008,13,311065
8293,0.000538,74.125.24.0-255,1484,58492,13,311065
8294,0.000602,74.125.24.0-255,7094,65586,13,311065
8295,0.000606,172.31.36.0-255,66,65652,13,311065
8296,0.000618,74.125.24.0-255,126,65778,13,311065
8297,0.000793,74.125.24.0-255,1484,67262,13,311065
8298,0.000798,172.31.36.0-255,66,67328,13,311065
8299,0.000804,74.125.24.0-255,2902,70230,13,311065
8300,0.000809,172.31.36.0-255,66,70296,13,311065
8301,0.000819,74.125.24.0-255,5738,76034,13,311065
8302,0.000822,172.31.36.0-255,66,76100,13,311065
8303,0.000852,74.125.24.0-255,5738,81838,13,311065
8304,0.000855,172.31.36.0-255,66,81904,13,311065
8305,0.00086,74.125.24.0-255,2902,84806,13,311065
8306,0.000864,172.31.36.0-255,66,84872,13,311065
8307,0.000887,172.31.36.0-255,66,84938,13,311065
8308,0.00092,74.125.24.0-255,1484,86422,13,311065
8309,0.000935,74.125.24.0-255,2543,88965,13,311065
8310,0.000938,172.31.36.0-255,66,89031,13,311065
8311,0.001354,74.125.24.0-255,1484,90515,13,311065
8312,0.001363,74.125.24.0-255,2902,93417,13,311065
8313,0.001367,172.31.36.0-255,66,93483,13,311065
8314,0.001375,74.125.24.0-255,5738,99221,13,311065
8315,0.001377,172.31.36.0-255,66,99287,13,311065
8316,0.001381,74.125.24.0-255,1484,100771,13,311065
8317,0.001408,74.125.24.0-255,5738,106509,13,311065
8318,0.001412,172.31.36.0-255,66,106575,13,311065
8319,0.00142,74.125.24.0-255,7156,113731,13,311065
8320,0.001422,172.31.36.0-255,66,113797,13,311065
8321,0.001452,74.125.24.0-255,7156,120953,13,311065
8322,0.001455,172.31.36.0-255,66,121019,13,311065
8323,0.001459,74.125.24.0-255,2184,123203,13,311065
8324,0.001461,172.31.36.0-255,66,123269,13,311065
8325,0.001823,74.125.24.0-255,1484,124753,13,311065
8326,0.001831,74.125.24.0-255,2902,127655,13,311065
8327,0.001835,172.31.36.0-255,66,127721,13,311065
8328,0.00184,74.125.24.0-255,1484,129205,13,311065
8329,0.001861,74.125.24.0-255,4320,133525,13,311065
8330,0.001864,172.31.36.0-255,66,133591,13,311065
8331,0.00187,74.125.24.0-255,4320,137911,13,311065
8332,0.001872,172.31.36.0-255,66,137977,13,311065
8333,0.001876,74.125.24.0-255,1484,139461,13,311065
8334,0.001902,74.125.24.0-255,7156,146617,13,311065
8335,0.001905,172.31.36.0-255,66,146683,13,311065
8336,0.001927,74.125.24.0-255,2902,149585,13,311065
8337,0.001929,172.31.36.0-255,66,149651,13,311065
8338,0.001938,74.125.24.0-255,7856,157507,13,311065
8339,0.00194,172.31.36.0-255,66,157573,13,311065
8340,0.001992,172.31.36.0-255,66,157639,13,311065
8341,0.001999,74.125.24.0-255,5738,163377,13,311065
8342,0.002,172.31.36.0-255,66,163443,13,311065
8343,0.002018,74.125.24.0-255,6438,169881,13,311065
8344,0.00202,172.31.36.0-255,66,169947,13,311065
8345,0.002044,74.125.24.0-255,7156,177103,13,311065
8346,0.002046,172.31.36.0-255,66,177169,13,311065
8347,0.002061,74.125.24.0-255,4320,181489,13,311065
8348,0.002063,172.31.36.0-255,66,181555,13,311065
8349,0.00209,172.31.36.0-255,66,181621,13,311065
8350,0.002112,74.125.24.0-255,8574,190195,13,311065
8351,0.002115,172.31.36.0-255,66,190261,13,311065
8352,0.002133,74.125.24.0-255,2184,192445,13,311065
8353,0.002135,172.31.36.0-255,66,192511,13,311065
8354,0.002309,74.125.24.0-255,1484,193995,13,311065
8355,0.002314,74.125.24.0-255,2902,196897,13,311065
8356,0.002316,172.31.36.0-255,66,196963,13,311065
8357,0.002334,74.125.24.0-255,4320,201283,13,311065
8358,0.002336,172.31.36.0-255,66,201349,13,311065
8359,0.002364,74.125.24.0-255,1484,202833,13,311065
8360,0.002382,172.31.36.0-255,66,202899,13,311065
8361,0.002389,74.125.24.0-255,8574,211473,13,311065
8362,0.002391,172.31.36.0-255,66,211539,13,311065
8363,0.002432,74.125.24.0-255,2902,214441,13,311065
8364,0.002435,172.31.36.0-255,66,214507,13,311065
8365,0.002467,74.125.24.0-255,2184,216691,13,311065
8366,0.002469,172.31.36.0-255,66,216757,13,311065
8367,0.002478,74.125.24.0-255,9992,226749,13,311065
8368,0.00248,172.31.36.0-255,66,226815,13,311065
8369,0.002492,172.31.36.0-255,66,226881,13,311065
8370,0.002496,74.125.24.0-255,4320,231201,13,311065
8371,0.002498,172.31.36.0-255,66,231267,13,311065
8372,0.002504,74.125.24.0-255,5020,236287,13,311065
8373,0.002506,172.31.36.0-255,66,236353,13,311065
8374,0.002875,74.125.24.0-255,1484,237837,13,311065
8375,0.002886,74.125.24.0-255,2902,240739,13,311065
8376,0.002889,172.31.36.0-255,66,240805,13,311065
8377,0.002927,74.125.24.0-255,5738,246543,13,311065
8378,0.002929,172.31.36.0-255,66,246609,13,311065
8379,0.002934,74.125.24.0-255,4320,250929,13,311065
8380,0.002936,172.31.36.0-255,66,250995,13,311065
8381,0.002958,74.125.24.0-255,8574,259569,13,311065
8382,0.002961,172.31.36.0-255,66,259635,13,311065
8383,0.002965,74.125.24.0-255,4320,263955,13,311065
8384,0.002967,172.31.36.0-255,66,264021,13,311065
8385,0.002991,74.125.24.0-255,6438,270459,13,311065
8386,0.002993,172.31.36.0-255,66,270525,13,311065
8387,0.003018,74.125.24.0-255,1484,272009,13,311065
8388,0.003032,74.125.24.0-255,1484,273493,13,311065
8389,0.003034,172.31.36.0-255,66,273559,13,311065
8390,0.003051,74.125.24.0-255,1484,275043,13,311065
8391,0.003056,74.125.24.0-255,5738,280781,13,311065
8392,0.003059,172.31.36.0-255,66,280847,13,311065
8393,0.003091,172.31.36.0-255,66,280913,13,311065
8394,0.003096,74.125.24.0-255,4320,285233,13,311065
8395,0.003099,172.31.36.0-255,66,285299,13,311065
8396,0.003112,74.125.24.0-255,4320,289619,13,311065
8397,0.003114,172.31.36.0-255,66,289685,13,311065
8398,0.003134,74.125.24.0-255,1484,291169,13,311065
8399,0.003155,74.125.24.0-255,10358,301527,13,311065
8400,0.003157,172.31.36.0-255,66,301593,13,311065
8401,0.00316,74.125.24.0-255,105,301698,13,311065
8402,0.006871,172.31.36.0-255,105,301803,13,311065
8403,0.008849,74.125.24.0-255,66,301869,13,311065
8404,0.042019,172.31.36.0-255,172,302041,13,311065
8405,0.042052,172.31.36.0-255,1109,303150,13,311065
8406,0.042097,172.31.36.0-255,1514,304664,13,311065
8407,0.042099,172.31.36.0-255,1514,306178,13,311065
8408,0.0421,172.31.36.0-255,1514,307692,13,311065
8409,0.042101,172.31.36.0-255,1514,309206,13,311065
8410,0.042136,172.31.36.0-255,1514,310720,13,311065
8411,0.042138,172.31.36.0-255,81,310801,13,311065
8412,0.043574,104.244.42.0-255,66,310867,13,311065
8413,0.043596,104.244.42.0-255,66,310933,13,311065
8414,0.043705,104.244.42.0-255,66,310999,13,311065
8415,0.043711,104.244.42.0-255,66,311065,13,311065
8416,0.0,74.125.24.0-255,154,154,13,265832
8417,2e-05,172.31.36.0-255,66,220,13,265832
8418,4.6e-05,74.125.24.0-255,1484,1704,13,265832
8419,5.2e-05,172.31.36.0-255,66,1770,13,265832
8420,5.7e-05,74.125.24.0-255,2902,4672,13,265832
8421,6e-05,172.31.36.0-255,66,4738,13,265832
8422,9.6e-05,74.125.24.0-255,2902,7640,13,265832
8423,0.0001,172.31.36.0-255,66,7706,13,265832
8424,0.000132,74.125.24.0-255,7742,15448,13,265832
8425,0.000136,172.31.36.0-255,66,15514,13,265832
8426,0.000143,74.125.24.0-255,5738,21252,13,265832
8427,0.000146,172.31.36.0-255,66,21318,13,265832
8428,0.000159,74.125.24.0-255,7156,28474,13,265832
8429,0.000161,172.31.36.0-255,66,28540,13,265832
8430,0.000202,172.31.36.0-255,66,28606,13,265832
8431,0.000205,74.125.24.0-255,1484,30090,13,265832
8432,0.000207,172.31.36.0-255,66,30156,13,265832
8433,0.000262,74.125.24.0-255,3602,33758,13,265832
8434,0.000266,172.31.36.0-255,66,33824,13,265832
8435,0.0003,74.125.24.0-255,1484,35308,13,265832
8436,0.000304,172.31.36.0-255,66,35374,13,265832
8437,0.000309,74.125.24.0-255,2902,38276,13,265832
8438,0.000311,172.31.36.0-255,66,38342,13,265832
8439,0.000315,74.125.24.0-255,2902,41244,13,265832
8440,0.000318,172.31.36.0-255,66,41310,13,265832
8441,0.000339,74.125.24.0-255,2902,44212,13,265832
8442,0.000347,172.31.36.0-255,66,44278,13,265832
8443,0.000354,74.125.24.0-255,6797,51075,13,265832
8444,0.000356,172.31.36.0-255,66,51141,13,265832
8445,0.000743,74.125.24.0-255,399,51540,13,265832
8446,0.000751,172.31.36.0-255,66,51606,13,265832
8447,0.000785,74.125.24.0-255,1484,53090,13,265832
8448,0.000792,74.125.24.0-255,4320,57410,13,265832
8449,0.000795,172.31.36.0-255,66,57476,13,265832
8450,0.000799,74.125.24.0-255,1484,58960,13,265832
8451,0.00083,74.125.24.0-255,5738,64698,13,265832
8452,0.000834,172.31.36.0-255,66,64764,13,265832
8453,0.000847,172.31.36.0-255,66,64830,13,265832
8454,0.00087,74.125.24.0-255,2902,67732,13,265832
8455,0.000878,172.31.36.0-255,66,67798,13,265832
8456,0.000885,74.125.24.0-255,5020,72818,13,265832
8457,0.000888,172.31.36.0-255,66,72884,13,265832
8458,0.000995,74.125.24.0-255,1484,74368,13,265832
8459,0.001001,74.125.24.0-255,2902,77270,13,265832
8460,0.001004,172.31.36.0-255,66,77336,13,265832
8461,0.00101,74.125.24.0-255,5738,83074,13,265832
8462,0.001012,172.31.36.0-255,66,83140,13,265832
8463,0.001039,74.125.24.0-255,5738,88878,13,265832
8464,0.001041,172.31.36.0-255,66,88944,13,265832
8465,0.001066,74.125.24.0-255,7156,96100,13,265832
8466,0.001069,172.31.36.0-255,66,96166,13,265832
8467,0.001075,74.125.24.0-255,5738,101904,13,265832
8468,0.001082,172.31.36.0-255,66,101970,13,265832
8469,0.001112,74.125.24.0-255,2902,104872,13,265832
8470,0.001114,172.31.36.0-255,66,104938,13,265832
8471,0.001123,74.125.24.0-255,2184,107122,13,265832
8472,0.001126,172.31.36.0-255,66,107188,13,265832
8473,0.001249,74.125.24.0-255,1484,108672,13,265832
8474,0.001255,74.125.24.0-255,2902,111574,13,265832
8475,0.00126,172.31.36.0-255,66,111640,13,265832
8476,0.001265,74.125.24.0-255,4320,115960,13,265832
8477,0.001269,172.31.36.0-255,66,116026,13,265832
8478,0.001299,74.125.24.0-255,1484,117510,13,265832
8479,0.001316,172.31.36.0-255,66,117576,13,265832
8480,0.001325,74.125.24.0-255,10692,128268,13,265832
8481,0.001327,172.31.36.0-255,66,128334,13,265832
8482,0.001465,74.125.24.0-255,1484,129818,13,265832
8483,0.001484,74.125.24.0-255,2902,132720,13,265832
8484,0.001487,172.31.36.0-255,66,132786,13,265832
8485,0.001493,74.125.24.0-255,5738,138524,13,265832
8486,0.001495,172.31.36.0-255,66,138590,13,265832
8487,0.001538,172.31.36.0-255,66,138656,13,265832
8488,0.00157,74.125.24.0-255,10692,149348,13,265832
8489,0.001573,172.31.36.0-255,66,149414,13,265832
8490,0.001775,74.125.24.0-255,1484,150898,13,265832
8491,0.001779,74.125.24.0-255,1484,152382,13,265832
8492,0.001782,172.31.36.0-255,66,152448,13,265832
8493,0.001806,74.125.24.0-255,1484,153932,13,265832
8494,0.001811,74.125.24.0-255,5738,159670,13,265832
8495,0.001815,172.31.36.0-255,66,159736,13,265832
8496,0.001847,74.125.24.0-255,7156,166892,13,265832
8497,0.00185,172.31.36.0-255,66,166958,13,265832
8498,0.001858,74.125.24.0-255,8574,175532,13,265832
8499,0.001859,172.31.36.0-255,66,175598,13,265832
8500,0.001904,74.125.24.0-255,5738,181336,13,265832
8501,0.001907,172.31.36.0-255,66,181402,13,265832
8502,0.001936,74.125.24.0-255,5020,186422,13,265832
8503,0.001939,172.31.36.0-255,66,186488,13,265832
8504,0.00195,172.31.36.0-255,66,186554,13,265832
8505,0.001977,172.31.36.0-255,66,186620,13,265832
8506,0.001989,172.31.36.0-255,66,186686,13,265832
8507,0.001993,74.125.24.0-255,2902,189588,13,265832
8508,0.001996,172.31.36.0-255,66,189654,13,265832
8509,0.002034,74.125.24.0-255,9992,199646,13,265832
8510,0.002037,172.31.36.0-255,66,199712,13,265832
8511,0.002044,74.125.24.0-255,7156,206868,13,265832
8512,0.002047,172.31.36.0-255,66,206934,13,265832
8513,0.002074,74.125.24.0-255,2902,209836,13,265832
8514,0.00208,172.31.36.0-255,66,209902,13,265832
8515,0.002107,74.125.24.0-255,10692,220594,13,265832
8516,0.00211,172.31.36.0-255,66,220660,13,265832
8517,0.002113,74.125.24.0-255,1484,222144,13,265832
8518,0.002148,172.31.36.0-255,66,222210,13,265832
8519,0.002155,74.125.24.0-255,7856,230066,13,265832
8520,0.002158,172.31.36.0-255,66,230132,13,265832
8521,0.002187,74.125.24.0-255,7156,237288,13,265832
8522,0.00219,172.31.36.0-255,66,237354,13,265832
8523,0.002228,172.31.36.0-255,66,237420,13,265832
8524,0.002235,74.125.24.0-255,8574,245994,13,265832
8525,0.002238,172.31.36.0-255,66,246060,13,265832
8526,0.002263,74.125.24.0-255,10172,256232,13,265832
8527,0.002267,172.31.36.0-255,66,256298,13,265832
8528,0.002302,74.125.24.0-255,105,256403,13,265832
8529,0.004354,172.31.36.0-255,66,256469,13,265832
8530,0.004388,172.31.36.0-255,105,256574,13,265832
8531,0.007022,74.125.24.0-255,66,256640,13,265832
8532,0.0345,172.31.36.0-255,176,256816,13,265832
8533,0.034547,172.31.36.0-255,1111,257927,13,265832
8534,0.034645,172.31.36.0-255,1514,259441,13,265832
8535,0.034647,172.31.36.0-255,1514,260955,13,265832
8536,0.034648,172.31.36.0-255,1514,262469,13,265832
8537,0.034653,172.31.36.0-255,1514,263983,13,265832
8538,0.034654,172.31.36.0-255,1514,265497,13,265832
8539,0.034655,172.31.36.0-255,71,265568,13,265832
8540,0.036071,104.244.42.0-255,66,265634,13,265832
8541,0.036116,104.244.42.0-255,66,265700,13,265832
8542,0.036198,104.244.42.0-255,66,265766,13,265832
8543,0.036201,104.244.42.0-255,66,265832,13,265832
8544,0.0,74.125.200.0-255,153,153,13,359796
8545,3.7e-05,172.31.36.0-255,66,219,13,359796
8546,4.5e-05,74.125.200.0-255,1484,1703,13,359796
8547,4.9e-05,172.31.36.0-255,66,1769,13,359796
8548,5.5e-05,74.125.200.0-255,2902,4671,13,359796
8549,5.7e-05,172.31.36.0-255,66,4737,13,359796
8550,6.5e-05,74.125.200.0-255,7156,11893,13,359796
8551,6.7e-05,172.31.36.0-255,66,11959,13,359796
8552,0.000109,74.125.200.0-255,2048,14007,13,359796
8553,0.000112,172.31.36.0-255,66,14073,13,359796
8554,0.000117,74.125.200.0-255,2902,16975,13,359796
8555,0.000119,172.31.36.0-255,66,17041,13,359796
8556,0.000143,74.125.200.0-255,2902,19943,13,359796
8557,0.000146,172.31.36.0-255,66,20009,13,359796
8558,0.000157,74.125.200.0-255,4320,24329,13,359796
8559,0.000159,172.31.36.0-255,66,24395,13,359796
8560,0.000163,74.125.200.0-255,1484,25879,13,359796
8561,0.000165,172.31.36.0-255,66,25945,13,359796
8562,0.000193,74.125.200.0-255,4320,30265,13,359796
8563,0.000195,172.31.36.0-255,66,30331,13,359796
8564,0.000198,74.125.200.0-255,1125,31456,13,359796
8565,0.0002,172.31.36.0-255,66,31522,13,359796
8566,0.000278,74.125.200.0-255,1484,33006,13,359796
8567,0.000282,172.31.36.0-255,66,33072,13,359796
8568,0.000302,74.125.200.0-255,2902,35974,13,359796
8569,0.000304,172.31.36.0-255,66,36040,13,359796
8570,0.000312,74.125.200.0-255,5738,41778,13,359796
8571,0.000315,172.31.36.0-255,66,41844,13,359796
8572,0.000318,74.125.200.0-255,1484,43328,13,359796
8573,0.000323,172.31.36.0-255,66,43394,13,359796
8574,0.000338,74.125.200.0-255,5379,48773,13,359796
8575,0.000342,172.31.36.0-255,66,48839,13,359796
8576,0.000359,74.125.200.0-255,1484,50323,13,359796
8577,0.000383,74.125.200.0-255,5738,56061,13,359796
8578,0.000387,172.31.36.0-255,66,56127,13,359796
8579,0.00041,74.125.200.0-255,8574,64701,13,359796
8580,0.000413,172.31.36.0-255,66,64767,13,359796
8581,0.000417,74.125.200.0-255,1398,66165,13,359796
8582,0.000435,74.125.200.0-255,131,66296,13,359796
8583,0.000462,74.125.200.0-255,347,66643,13,359796
8584,0.000465,172.31.36.0-255,66,66709,13,359796
8585,0.000763,74.125.200.0-255,1484,68193,13,359796
8586,0.000768,74.125.200.0-255,1484,69677,13,359796
8587,0.000771,172.31.36.0-255,66,69743,13,359796
8588,0.000787,74.125.200.0-255,1484,71227,13,359796
8589,0.000794,74.125.200.0-255,5738,76965,13,359796
8590,0.000797,172.31.36.0-255,66,77031,13,359796
8591,0.00082,74.125.200.0-255,4320,81351,13,359796
8592,0.000823,172.31.36.0-255,66,81417,13,359796
8593,0.000838,74.125.200.0-255,4320,85737,13,359796
8594,0.00084,172.31.36.0-255,66,85803,13,359796
8595,0.000849,74.125.200.0-255,9992,95795,13,359796
8596,0.000852,172.31.36.0-255,66,95861,13,359796
8597,0.000869,74.125.200.0-255,5020,100881,13,359796
8598,0.000872,172.31.36.0-255,66,100947,13,359796
8599,0.000984,74.125.200.0-255,1484,102431,13,359796
8600,0.001006,74.125.200.0-255,2902,105333,13,359796
8601,0.001009,172.31.36.0-255,66,105399,13,359796
8602,0.001015,74.125.200.0-255,4320,109719,13,359796
8603,0.001018,172.31.36.0-255,66,109785,13,359796
8604,0.00104,74.125.200.0-255,1484,111269,13,359796
8605,0.001072,74.125.200.0-255,5738,117007,13,359796
8606,0.001076,172.31.36.0-255,66,117073,13,359796
8607,0.001091,74.125.200.0-255,1484,118557,13,359796
8608,0.001101,74.125.200.0-255,8574,127131,13,359796
8609,0.001104,172.31.36.0-255,66,127197,13,359796
8610,0.00112,74.125.200.0-255,2902,130099,13,359796
8611,0.001123,172.31.36.0-255,66,130165,13,359796
8612,0.001145,74.125.200.0-255,5020,135185,13,359796
8613,0.001148,172.31.36.0-255,66,135251,13,359796
8614,0.001209,74.125.200.0-255,1484,136735,13,359796
8615,0.001226,74.125.200.0-255,2902,139637,13,359796
8616,0.001229,172.31.36.0-255,66,139703,13,359796
8617,0.001232,74.125.200.0-255,1484,141187,13,359796
8618,0.00125,74.125.200.0-255,4320,145507,13,359796
8619,0.001253,172.31.36.0-255,66,145573,13,359796
8620,0.001277,74.125.200.0-255,4320,149893,13,359796
8621,0.00128,172.31.36.0-255,66,149959,13,359796
8622,0.001304,74.125.200.0-255,7156,157115,13,359796
8623,0.001307,172.31.36.0-255,66,157181,13,359796
8624,0.001322,74.125.200.0-255,5738,162919,13,359796
8625,0.001325,172.31.36.0-255,66,162985,13,359796
8626,0.001355,74.125.200.0-255,6438,169423,13,359796
8627,0.001358,172.31.36.0-255,66,169489,13,359796
8628,0.002103,74.125.200.0-255,1484,170973,13,359796
8629,0.002113,74.125.200.0-255,2902,173875,13,359796
8630,0.002118,172.31.36.0-255,66,173941,13,359796
8631,0.002124,74.125.200.0-255,2902,176843,13,359796
8632,0.002126,172.31.36.0-255,66,176909,13,359796
8633,0.002143,74.125.200.0-255,2902,179811,13,359796
8634,0.002145,172.31.36.0-255,66,179877,13,359796
8635,0.002152,74.125.200.0-255,5738,185615,13,359796
8636,0.002154,172.31.36.0-255,66,185681,13,359796
8637,0.00216,74.125.200.0-255,4320,190001,13,359796
8638,0.002162,172.31.36.0-255,66,190067,13,359796
8639,0.002183,74.125.200.0-255,2902,192969,13,359796
8640,0.002185,172.31.36.0-255,66,193035,13,359796
8641,0.002203,74.125.200.0-255,7156,200191,13,359796
8642,0.002206,172.31.36.0-255,66,200257,13,359796
8643,0.002221,74.125.200.0-255,3602,203859,13,359796
8644,0.002225,172.31.36.0-255,66,203925,13,359796
8645,0.002278,74.125.200.0-255,1484,205409,13,359796
8646,0.002281,74.125.200.0-255,1484,206893,13,359796
8647,0.002283,172.31.36.0-255,66,206959,13,359796
8648,0.0023,74.125.200.0-255,2902,209861,13,359796
8649,0.002303,172.31.36.0-255,66,209927,13,359796
8650,0.002317,74.125.200.0-255,4320,214247,13,359796
8651,0.002319,172.31.36.0-255,66,214313,13,359796
8652,0.002335,74.125.200.0-255,1484,215797,13,359796
8653,0.002368,172.31.36.0-255,66,215863,13,359796
8654,0.002394,74.125.200.0-255,4320,220183,13,359796
8655,0.002396,172.31.36.0-255,66,220249,13,359796
8656,0.002419,74.125.200.0-255,7856,228105,13,359796
8657,0.002421,172.31.36.0-255,66,228171,13,359796
8658,0.002428,74.125.200.0-255,7156,235327,13,359796
8659,0.00243,172.31.36.0-255,66,235393,13,359796
8660,0.002459,74.125.200.0-255,1484,236877,13,359796
8661,0.002496,172.31.36.0-255,66,236943,13,359796
8662,0.002516,74.125.200.0-255,7156,244099,13,359796
8663,0.002519,172.31.36.0-255,66,244165,13,359796
8664,0.002534,74.125.200.0-255,7856,252021,13,359796
8665,0.002536,172.31.36.0-255,66,252087,13,359796
8666,0.002561,74.125.200.0-255,9992,262079,13,359796
8667,0.002564,172.31.36.0-255,66,262145,13,359796
8668,0.005068,74.125.200.0-255,4320,266465,13,359796
8669,0.005072,172.31.36.0-255,66,266531,13,359796
8670,0.005086,74.125.200.0-255,1484,268015,13,359796
8671,0.007624,74.125.200.0-255,4320,272335,13,359796
8672,0.007635,172.31.36.0-255,66,272401,13,359796
8673,0.01016,74.125.200.0-255,5738,278139,13,359796
8674,0.010172,172.31.36.0-255,66,278205,13,359796
8675,0.012725,74.125.200.0-255,5738,283943,13,359796
8676,0.012741,172.31.36.0-255,66,284009,13,359796
8677,0.015281,74.125.200.0-255,5738,289747,13,359796
8678,0.015294,172.31.36.0-255,66,289813,13,359796
8679,0.017821,74.125.200.0-255,5738,295551,13,359796
8680,0.017835,172.31.36.0-255,66,295617,13,359796
8681,0.020356,74.125.200.0-255,5738,301355,13,359796
8682,0.020371,172.31.36.0-255,66,301421,13,359796
8683,0.022901,74.125.200.0-255,5738,307159,13,359796
8684,0.022921,172.31.36.0-255,66,307225,13,359796
8685,0.025437,74.125.200.0-255,5738,312963,13,359796
8686,0.025451,172.31.36.0-255,66,313029,13,359796
8687,0.02796,74.125.200.0-255,5738,318767,13,359796
8688,0.027968,172.31.36.0-255,66,318833,13,359796
8689,0.030485,74.125.200.0-255,5738,324571,13,359796
8690,0.030493,172.31.36.0-255,66,324637,13,359796
8691,0.033,74.125.200.0-255,5738,330375,13,359796
8692,0.033007,172.31.36.0-255,66,330441,13,359796
8693,0.033482,172.31.36.0-255,172,330613,13,359796
8694,0.033511,172.31.36.0-255,1106,331719,13,359796
8695,0.033615,172.31.36.0-255,1514,333233,13,359796
8696,0.033617,172.31.36.0-255,1299,334532,13,359796
8697,0.034996,104.244.42.0-255,66,334598,13,359796
8698,0.035041,104.244.42.0-255,66,334664,13,359796
8699,0.035146,104.244.42.0-255,66,334730,13,359796
8700,0.035503,74.125.200.0-255,5738,340468,13,359796
8701,0.035509,172.31.36.0-255,66,340534,13,359796
8702,0.03802,74.125.200.0-255,5738,346272,13,359796
8703,0.038025,172.31.36.0-255,66,346338,13,359796
8704,0.040536,74.125.200.0-255,5738,352076,13,359796
8705,0.040573,172.31.36.0-255,66,352142,13,359796
8706,0.043075,74.125.200.0-255,5738,357880,13,359796
8707,0.043083,172.31.36.0-255,66,357946,13,359796
8708,0.045584,74.125.200.0-255,1613,359559,13,359796
8709,0.045607,172.31.36.0-255,66,359625,13,359796
8710,0.045783,172.31.36.0-255,105,359730,13,359796
8711,0.048249,74.125.200.0-255,66,359796,13,359796
8712,0.0,172.217.194.0-255,298,298,13,314318
8713,2.9e-05,172.217.194.0-255,1484,1782,13,314318
8714,3.7e-05,172.217.194.0-255,4320,6102,13,314318
8715,5.1e-05,172.217.194.0-255,4320,10422,13,314318
8716,6.7e-05,172.217.194.0-255,4672,15094,13,314318
8717,7.9e-05,172.217.194.0-255,4320,19414,13,314318
8718,9.9e-05,172.217.194.0-255,7156,26570,13,314318
8719,9.9e-05,172.31.36.0-255,66,26636,13,314318
8720,0.000107,172.31.36.0-255,66,26702,13,314318
8721,0.000138,172.217.194.0-255,3961,30663,13,314318
8722,0.000178,172.217.194.0-255,4320,34983,13,314318
8723,0.000187,172.217.194.0-255,1484,36467,13,314318
8724,0.000206,172.217.194.0-255,4320,40787,13,314318
8725,0.000209,172.217.194.0-255,1484,42271,13,314318
8726,0.000244,172.217.194.0-255,9992,52263,13,314318
8727,0.000274,172.217.194.0-255,1424,53687,13,314318
8728,0.000309,172.217.194.0-255,377,54064,13,314318
8729,0.000313,172.31.36.0-255,66,54130,13,314318
8730,0.000397,172.217.194.0-255,1484,55614,13,314318
8731,0.000403,172.217.194.0-255,2902,58516,13,314318
8732,0.000404,172.31.36.0-255,66,58582,13,314318
8733,0.00041,172.31.36.0-255,66,58648,13,314318
8734,0.000426,172.217.194.0-255,5738,64386,13,314318
8735,0.000436,172.31.36.0-255,66,64452,13,314318
8736,0.000476,172.217.194.0-255,6797,71249,13,314318
8737,0.000484,172.217.194.0-255,7156,78405,13,314318
8738,0.000489,172.31.36.0-255,66,78471,13,314318
8739,0.000514,172.217.194.0-255,1484,79955,13,314318
8740,0.000533,172.217.194.0-255,8215,88170,13,314318
8741,0.000537,172.31.36.0-255,66,88236,13,314318
8742,0.000774,172.217.194.0-255,1484,89720,13,314318
8743,0.000779,172.217.194.0-255,2902,92622,13,314318
8744,0.000783,172.31.36.0-255,66,92688,13,314318
8745,0.000795,172.217.194.0-255,2902,95590,13,314318
8746,0.000806,172.31.36.0-255,66,95656,13,314318
8747,0.000811,172.217.194.0-255,2902,98558,13,314318
8748,0.000814,172.217.194.0-255,1484,100042,13,314318
8749,0.000819,172.31.36.0-255,66,100108,13,314318
8750,0.000854,172.217.194.0-255,9992,110100,13,314318
8751,0.000857,172.31.36.0-255,66,110166,13,314318
8752,0.000883,172.31.36.0-255,66,110232,13,314318
8753,0.001684,172.217.194.0-255,1484,111716,13,314318
8754,0.001695,172.217.194.0-255,2902,114618,13,314318
8755,0.001699,172.31.36.0-255,66,114684,13,314318
8756,0.001705,172.217.194.0-255,2902,117586,13,314318
8757,0.001733,172.217.194.0-255,2902,120488,13,314318
8758,0.001769,172.217.194.0-255,2902,123390,13,314318
8759,0.001794,172.217.194.0-255,7856,131246,13,314318
8760,0.002019,172.217.194.0-255,1484,132730,13,314318
8761,0.002026,172.217.194.0-255,2902,135632,13,314318
8762,0.002038,172.217.194.0-255,1484,137116,13,314318
8763,0.002052,172.217.194.0-255,4320,141436,13,314318
8764,0.002066,172.217.194.0-255,1484,142920,13,314318
8765,0.002081,172.217.194.0-255,5738,148658,13,314318
8766,0.002096,172.217.194.0-255,4320,152978,13,314318
8767,0.002112,172.217.194.0-255,1484,154462,13,314318
8768,0.002132,172.217.194.0-255,1484,155946,13,314318
8769,0.002153,172.217.194.0-255,9274,165220,13,314318
8770,0.00221,172.217.194.0-255,1484,166704,13,314318
8771,0.002214,172.217.194.0-255,1484,168188,13,314318
8772,0.002229,172.217.194.0-255,1484,169672,13,314318
8773,0.002235,172.217.194.0-255,5738,175410,13,314318
8774,0.002246,172.217.194.0-255,1484,176894,13,314318
8775,0.002257,172.217.194.0-255,2902,179796,13,314318
8776,0.002277,172.217.194.0-255,8574,188370,13,314318
8777,0.002286,172.217.194.0-255,10692,199062,13,314318
8778,0.002324,172.217.194.0-255,1484,200546,13,314318
8779,0.002343,172.217.194.0-255,2902,203448,13,314318
8780,0.002366,172.217.194.0-255,5738,209186,13,314318
8781,0.002371,172.217.194.0-255,4320,213506,13,314318
8782,0.002388,172.217.194.0-255,5738,219244,13,314318
8783,0.002431,172.217.194.0-255,2902,222146,13,314318
8784,0.002448,172.217.194.0-255,10692,232838,13,314318
8785,0.002484,172.217.194.0-255,4320,237158,13,314318
8786,0.002512,172.217.194.0-255,8574,245732,13,314318
8787,0.002533,172.217.194.0-255,2902,248634,13,314318
8788,0.002565,172.217.194.0-255,6438,255072,13,314318
8789,0.002727,172.217.194.0-255,1484,256556,13,314318
8790,0.002739,172.217.194.0-255,2902,259458,13,314318
8791,0.002778,172.217.194.0-255,5738,265196,13,314318
8792,0.002835,172.217.194.0-255,7156,272352,13,314318
8793,0.002864,172.217.194.0-255,3602,275954,13,314318
8794,0.002873,172.217.194.0-255,8574,284528,13,314318
8795,0.002875,172.217.194.0-255,1484,286012,13,314318
8796,0.002883,172.217.194.0-255,8574,294586,13,314318
8797,0.002889,172.217.194.0-255,5738,300324,13,314318
8798,0.002918,172.217.194.0-255,5020,305344,13,314318
8799,0.002939,172.217.194.0-255,4348,309692,13,314318
8800,0.002956,172.217.194.0-255,105,309797,13,314318
8801,0.00336,172.31.36.0-255,66,309863,13,314318
8802,0.005272,172.31.36.0-255,105,309968,13,314318
8803,0.007571,172.217.194.0-255,66,310034,13,314318
8804,0.033047,172.31.36.0-255,167,310201,13,314318
8805,0.033077,172.31.36.0-255,1109,311310,13,314318
8806,0.033116,172.31.36.0-255,1514,312824,13,314318
8807,0.033118,172.31.36.0-255,1296,314120,13,314318
8808,0.034584,104.244.42.0-255,66,314186,13,314318
8809,0.034662,104.244.42.0-255,66,314252,13,314318
8810,0.034665,104.244.42.0-255,66,314318,13,314318
8811,0.0,172.217.194.0-255,297,297,13,376458
8812,3.1e-05,172.31.36.0-255,66,363,13,376458
8813,3.9e-05,172.217.194.0-255,1484,1847,13,376458
8814,4.3e-05,172.31.36.0-255,66,1913,13,376458
8815,4.7e-05,172.217.194.0-255,1484,3397,13,376458
8816,4.9e-05,172.31.36.0-255,66,3463,13,376458
8817,6.3e-05,172.217.194.0-255,1484,4947,13,376458
8818,6.5e-05,172.31.36.0-255,66,5013,13,376458
8819,8.4e-05,172.217.194.0-255,4320,9333,13,376458
8820,8.6e-05,172.31.36.0-255,66,9399,13,376458
8821,0.000129,172.217.194.0-255,4320,13719,13,376458
8822,0.000133,172.31.36.0-255,66,13785,13,376458
8823,0.000159,172.217.194.0-255,3230,17015,13,376458
8824,0.000161,172.31.36.0-255,66,17081,13,376458
8825,0.00017,172.217.194.0-255,8574,25655,13,376458
8826,0.000173,172.31.36.0-255,66,25721,13,376458
8827,0.000193,172.217.194.0-255,5379,31100,13,376458
8828,0.000197,172.31.36.0-255,66,31166,13,376458
8829,0.000609,172.217.194.0-255,1484,32650,13,376458
8830,0.000614,172.31.36.0-255,66,32716,13,376458
8831,0.000623,172.217.194.0-255,2902,35618,13,376458
8832,0.000625,172.31.36.0-255,66,35684,13,376458
8833,0.000632,172.217.194.0-255,5738,41422,13,376458
8834,0.000635,172.31.36.0-255,66,41488,13,376458
8835,0.000667,172.217.194.0-255,8215,49703,13,376458
8836,0.00067,172.31.36.0-255,66,49769,13,376458
8837,0.000675,172.217.194.0-255,4320,54089,13,376458
8838,0.000677,172.31.36.0-255,66,54155,13,376458
8839,0.000697,172.217.194.0-255,4320,58475,13,376458
8840,0.0007,172.31.36.0-255,66,58541,13,376458
8841,0.000704,172.217.194.0-255,2902,61443,13,376458
8842,0.000708,172.31.36.0-255,66,61509,13,376458
8843,0.000729,172.217.194.0-255,4252,65761,13,376458
8844,0.000733,172.31.36.0-255,66,65827,13,376458
8845,0.000908,172.217.194.0-255,1484,67311,13,376458
8846,0.000928,172.217.194.0-255,2902,70213,13,376458
8847,0.000934,172.31.36.0-255,66,70279,13,376458
8848,0.000939,172.217.194.0-255,2902,73181,13,376458
8849,0.000942,172.31.36.0-255,66,73247,13,376458
8850,0.000964,172.217.194.0-255,2902,76149,13,376458
8851,0.000968,172.31.36.0-255,66,76215,13,376458
8852,0.000973,172.217.194.0-255,4320,80535,13,376458
8853,0.000976,172.31.36.0-255,66,80601,13,376458
8854,0.001012,172.217.194.0-255,2543,83144,13,376458
8855,0.001017,172.31.36.0-255,66,83210,13,376458
8856,0.001039,172.217.194.0-255,363,83573,13,376458
8857,0.001143,172.217.194.0-255,1484,85057,13,376458
8858,0.001148,172.31.36.0-255,66,85123,13,376458
8859,0.001168,172.217.194.0-255,2902,88025,13,376458
8860,0.001172,172.31.36.0-255,66,88091,13,376458
8861,0.001233,172.217.194.0-255,2902,90993,13,376458
8862,0.001238,172.31.36.0-255,66,91059,13,376458
8863,0.001245,172.217.194.0-255,4320,95379,13,376458
8864,0.001247,172.31.36.0-255,66,95445,13,376458
8865,0.001263,172.217.194.0-255,1484,96929,13,376458
8866,0.001299,172.217.194.0-255,4320,101249,13,376458
8867,0.001303,172.31.36.0-255,66,101315,13,376458
8868,0.001311,172.217.194.0-255,7156,108471,13,376458
8869,0.001313,172.31.36.0-255,66,108537,13,376458
8870,0.001318,172.217.194.0-255,2902,111439,13,376458
8871,0.001321,172.31.36.0-255,66,111505,13,376458
8872,0.001344,172.217.194.0-255,5772,117277,13,376458
8873,0.001347,172.31.36.0-255,66,117343,13,376458
8874,0.001387,172.217.194.0-255,100,117443,13,376458
8875,0.001427,172.217.194.0-255,1484,118927,13,376458
8876,0.001431,172.31.36.0-255,66,118993,13,376458
8877,0.001455,172.217.194.0-255,2902,121895,13,376458
8878,0.00146,172.31.36.0-255,66,121961,13,376458
8879,0.00149,172.217.194.0-255,2902,124863,13,376458
8880,0.001494,172.31.36.0-255,66,124929,13,376458
8881,0.001499,172.217.194.0-255,2902,127831,13,376458
8882,0.001502,172.31.36.0-255,66,127897,13,376458
8883,0.001524,172.217.194.0-255,1484,129381,13,376458
8884,0.001536,172.217.194.0-255,8574,137955,13,376458
8885,0.00154,172.31.36.0-255,66,138021,13,376458
8886,0.001542,172.217.194.0-255,1484,139505,13,376458
8887,0.001573,172.217.194.0-255,1484,140989,13,376458
8888,0.001576,172.31.36.0-255,66,141055,13,376458
8889,0.001601,172.217.194.0-255,7156,148211,13,376458
8890,0.001604,172.31.36.0-255,66,148277,13,376458
8891,0.001629,172.217.194.0-255,3602,151879,13,376458
8892,0.001632,172.31.36.0-255,66,151945,13,376458
8893,0.002139,172.217.194.0-255,1484,153429,13,376458
8894,0.002145,172.217.194.0-255,2902,156331,13,376458
8895,0.002149,172.31.36.0-255,66,156397,13,376458
8896,0.002156,172.217.194.0-255,5738,162135,13,376458
8897,0.002158,172.31.36.0-255,66,162201,13,376458
8898,0.002166,172.217.194.0-255,8574,170775,13,376458
8899,0.002168,172.31.36.0-255,66,170841,13,376458
8900,0.002214,172.217.194.0-255,4320,175161,13,376458
8901,0.002218,172.31.36.0-255,66,175227,13,376458
8902,0.002227,172.217.194.0-255,10692,185919,13,376458
8903,0.002229,172.31.36.0-255,66,185985,13,376458
8904,0.002232,172.217.194.0-255,1484,187469,13,376458
8905,0.002235,172.217.194.0-255,1484,188953,13,376458
8906,0.002237,172.31.36.0-255,66,189019,13,376458
8907,0.002256,172.217.194.0-255,1484,190503,13,376458
8908,0.002262,172.217.194.0-255,5738,196241,13,376458
8909,0.002264,172.31.36.0-255,66,196307,13,376458
8910,0.002323,172.31.36.0-255,66,196373,13,376458
8911,0.002332,172.217.194.0-255,10692,207065,13,376458
8912,0.002334,172.31.36.0-255,66,207131,13,376458
8913,0.004586,172.217.194.0-255,5738,212869,13,376458
8914,0.004592,172.31.36.0-255,66,212935,13,376458
8915,0.006872,172.217.194.0-255,5738,218673,13,376458
8916,0.006878,172.31.36.0-255,66,218739,13,376458
8917,0.009151,172.217.194.0-255,5738,224477,13,376458
8918,0.009158,172.31.36.0-255,66,224543,13,376458
8919,0.01142,172.217.194.0-255,5738,230281,13,376458
8920,0.011427,172.31.36.0-255,66,230347,13,376458
8921,0.013712,172.217.194.0-255,5738,236085,13,376458
8922,0.013721,172.31.36.0-255,66,236151,13,376458
8923,0.015994,172.217.194.0-255,5738,241889,13,376458
8924,0.016002,172.31.36.0-255,66,241955,13,376458
8925,0.018277,172.217.194.0-255,5738,247693,13,376458
8926,0.018285,172.31.36.0-255,66,247759,13,376458
8927,0.020579,172.217.194.0-255,5738,253497,13,376458
8928,0.020586,172.31.36.0-255,66,253563,13,376458
8929,0.022866,172.217.194.0-255,5738,259301,13,376458
8930,0.022878,172.31.36.0-255,66,259367,13,376458
8931,0.025157,172.217.194.0-255,5738,265105,13,376458
8932,0.025164,172.31.36.0-255,66,265171,13,376458
8933,0.027425,172.217.194.0-255,5738,270909,13,376458
8934,0.027436,172.31.36.0-255,66,270975,13,376458
8935,0.028872,172.31.36.0-255,172,271147,13,376458
8936,0.028908,172.31.36.0-255,1106,272253,13,376458
8937,0.028971,172.31.36.0-255,1514,273767,13,376458
8938,0.028973,172.31.36.0-255,1299,275066,13,376458
8939,0.029709,172.217.194.0-255,5738,280804,13,376458
8940,0.029714,172.31.36.0-255,66,280870,13,376458
8941,0.030428,104.244.42.0-255,66,280936,13,376458
8942,0.030435,104.244.42.0-255,66,281002,13,376458
8943,0.030536,104.244.42.0-255,66,281068,13,376458
8944,0.031981,172.217.194.0-255,5738,286806,13,376458
8945,0.031985,172.31.36.0-255,66,286872,13,376458
8946,0.034238,172.217.194.0-255,2902,289774,13,376458
8947,0.034244,172.31.36.0-255,66,289840,13,376458
8948,0.034275,172.217.194.0-255,2902,292742,13,376458
8949,0.034278,172.31.36.0-255,66,292808,13,376458
8950,0.03651,172.217.194.0-255,2902,295710,13,376458
8951,0.036515,172.31.36.0-255,66,295776,13,376458
8952,0.036552,172.217.194.0-255,2902,298678,13,376458
8953,0.036555,172.31.36.0-255,66,298744,13,376458
8954,0.038831,172.217.194.0-255,5738,304482,13,376458
8955,0.038837,172.31.36.0-255,66,304548,13,376458
8956,0.041109,172.217.194.0-255,5738,310286,13,376458
8957,0.041116,172.31.36.0-255,66,310352,13,376458
8958,0.0434,172.217.194.0-255,4320,314672,13,376458
8959,0.043423,172.31.36.0-255,66,314738,13,376458
8960,0.04344,172.217.194.0-255,1484,316222,13,376458
8961,0.045688,172.217.194.0-255,4320,320542,13,376458
8962,0.045693,172.31.36.0-255,66,320608,13,376458
8963,0.047973,172.217.194.0-255,5738,326346,13,376458
8964,0.047979,172.31.36.0-255,66,326412,13,376458
8965,0.050233,172.217.194.0-255,5738,332150,13,376458
8966,0.050238,172.31.36.0-255,66,332216,13,376458
8967,0.052499,172.217.194.0-255,4320,336536,13,376458
8968,0.052504,172.31.36.0-255,66,336602,13,376458
8969,0.05253,172.217.194.0-255,1484,338086,13,376458
8970,0.054772,172.217.194.0-255,4320,342406,13,376458
8971,0.054779,172.31.36.0-255,66,342472,13,376458
8972,0.05705,172.217.194.0-255,5738,348210,13,376458
8973,0.057055,172.31.36.0-255,66,348276,13,376458
8974,0.059309,172.217.194.0-255,5738,354014,13,376458
8975,0.059314,172.31.36.0-255,66,354080,13,376458
8976,0.061581,172.217.194.0-255,5738,359818,13,376458
8977,0.061587,172.31.36.0-255,66,359884,13,376458
8978,0.063931,172.217.194.0-255,2902,362786,13,376458
8979,0.063937,172.31.36.0-255,66,362852,13,376458
8980,0.063967,172.217.194.0-255,2902,365754,13,376458
8981,0.06397,172.31.36.0-255,66,365820,13,376458
8982,0.066214,172.217.194.0-255,2902,368722,13,376458
8983,0.066221,172.31.36.0-255,66,368788,13,376458
8984,0.066286,172.217.194.0-255,2902,371690,13,376458
8985,0.066291,172.31.36.0-255,66,371756,13,376458
8986,0.068494,172.217.194.0-255,2902,374658,13,376458
8987,0.0685,172.31.36.0-255,66,374724,13,376458
8988,0.068559,172.217.194.0-255,1497,376221,13,376458
8989,0.068563,172.31.36.0-255,66,376287,13,376458
8990,0.068698,172.31.36.0-255,105,376392,13,376458
8991,0.070942,172.217.194.0-255,66,376458,13,376458
8992,0.0,172.217.27.0-255,153,153,13,376445
8993,2.6e-05,172.31.36.0-255,66,219,13,376445
8994,3.3e-05,172.217.27.0-255,1484,1703,13,376445
8995,3.7e-05,172.31.36.0-255,66,1769,13,376445
8996,4.2e-05,172.217.27.0-255,2902,4671,13,376445
8997,4.5e-05,172.31.36.0-255,66,4737,13,376445
8998,5.1e-05,172.217.27.0-255,7156,11893,13,376445
8999,5.4e-05,172.31.36.0-255,66,11959,13,376445
9000,5.7e-05,172.217.27.0-255,2012,13971,13,376445
9001,5.9e-05,172.31.36.0-255,66,14037,13,376445
9002,0.00011,172.217.27.0-255,1484,15521,13,376445
9003,0.000113,172.31.36.0-255,66,15587,13,376445
9004,0.000117,172.217.27.0-255,2902,18489,13,376445
9005,0.000119,172.31.36.0-255,66,18555,13,376445
9006,0.000135,172.217.27.0-255,5738,24293,13,376445
9007,0.000137,172.31.36.0-255,66,24359,13,376445
9008,0.000172,172.217.27.0-255,6797,31156,13,376445
9009,0.000175,172.31.36.0-255,66,31222,13,376445
9010,0.000332,172.217.27.0-255,1484,32706,13,376445
9011,0.000336,172.31.36.0-255,66,32772,13,376445
9012,0.00034,172.217.27.0-255,2902,35674,13,376445
9013,0.000342,172.31.36.0-255,66,35740,13,376445
9014,0.00036,172.217.27.0-255,5738,41478,13,376445
9015,0.000363,172.31.36.0-255,66,41544,13,376445
9016,0.00037,172.217.27.0-255,6797,48341,13,376445
9017,0.000372,172.31.36.0-255,66,48407,13,376445
9018,0.000376,172.217.27.0-255,2902,51309,13,376445
9019,0.000378,172.31.36.0-255,66,51375,13,376445
9020,0.000399,172.217.27.0-255,4320,55695,13,376445
9021,0.000401,172.31.36.0-255,66,55761,13,376445
9022,0.000435,172.217.27.0-255,9633,65394,13,376445
9023,0.000437,172.31.36.0-255,66,65460,13,376445
9024,0.000737,172.217.27.0-255,392,65852,13,376445
9025,0.000778,172.31.36.0-255,66,65918,13,376445
9026,0.001047,172.217.27.0-255,115,66033,13,376445
9027,0.001267,172.217.27.0-255,1484,67517,13,376445
9028,0.001273,172.31.36.0-255,66,67583,13,376445
9029,0.001279,172.217.27.0-255,2902,70485,13,376445
9030,0.001284,172.217.27.0-255,4320,74805,13,376445
9031,0.0013,172.217.27.0-255,1484,76289,13,376445
9032,0.001306,172.217.27.0-255,2902,79191,13,376445
9033,0.001338,172.217.27.0-255,9633,88824,13,376445
9034,0.001886,172.31.36.0-255,66,88890,13,376445
9035,0.001932,172.31.36.0-255,101,88991,13,376445
9036,0.003522,172.217.27.0-255,5738,94729,13,376445
9037,0.003527,172.31.36.0-255,66,94795,13,376445
9038,0.003558,172.217.27.0-255,66,94861,13,376445
9039,0.005164,172.217.27.0-255,5738,100599,13,376445
9040,0.00517,172.31.36.0-255,66,100665,13,376445
9041,0.006807,172.217.27.0-255,5738,106403,13,376445
9042,0.006814,172.31.36.0-255,66,106469,13,376445
9043,0.008452,172.217.27.0-255,5738,112207,13,376445
9044,0.008458,172.31.36.0-255,66,112273,13,376445
9045,0.010098,172.217.27.0-255,5738,118011,13,376445
9046,0.010105,172.31.36.0-255,66,118077,13,376445
9047,0.011746,172.217.27.0-255,5738,123815,13,376445
9048,0.011753,172.31.36.0-255,66,123881,13,376445
9049,0.013402,172.217.27.0-255,5738,129619,13,376445
9050,0.013409,172.31.36.0-255,66,129685,13,376445
9051,0.015046,172.217.27.0-255,5738,135423,13,376445
9052,0.015054,172.31.36.0-255,66,135489,13,376445
9053,0.016697,172.217.27.0-255,5738,141227,13,376445
9054,0.016708,172.31.36.0-255,66,141293,13,376445
9055,0.018345,172.217.27.0-255,5738,147031,13,376445
9056,0.018353,172.31.36.0-255,66,147097,13,376445
9057,0.019994,172.217.27.0-255,5738,152835,13,376445
9058,0.020002,172.31.36.0-255,66,152901,13,376445
9059,0.021644,172.217.27.0-255,5738,158639,13,376445
9060,0.021652,172.31.36.0-255,66,158705,13,376445
9061,0.023297,172.217.27.0-255,5738,164443,13,376445
9062,0.023303,172.31.36.0-255,66,164509,13,376445
9063,0.024451,172.31.36.0-255,172,164681,13,376445
9064,0.024483,172.31.36.0-255,1106,165787,13,376445
9065,0.02452,172.31.36.0-255,1514,167301,13,376445
9066,0.024522,172.31.36.0-255,1299,168600,13,376445
9067,0.024941,172.217.27.0-255,5738,174338,13,376445
9068,0.024947,172.31.36.0-255,66,174404,13,376445
9069,0.025991,104.244.42.0-255,66,174470,13,376445
9070,0.026044,104.244.42.0-255,66,174536,13,376445
9071,0.026093,104.244.42.0-255,66,174602,13,376445
9072,0.026585,172.217.27.0-255,5738,180340,13,376445
9073,0.026592,172.31.36.0-255,66,180406,13,376445
9074,0.028231,172.217.27.0-255,5738,186144,13,376445
9075,0.028237,172.31.36.0-255,66,186210,13,376445
9076,0.029871,172.217.27.0-255,5738,191948,13,376445
9077,0.029877,172.31.36.0-255,66,192014,13,376445
9078,0.031537,172.217.27.0-255,5738,197752,13,376445
9079,0.031542,172.31.36.0-255,66,197818,13,376445
9080,0.033175,172.217.27.0-255,5738,203556,13,376445
9081,0.03318,172.31.36.0-255,66,203622,13,376445
9082,0.034812,172.217.27.0-255,5738,209360,13,376445
9083,0.034819,172.31.36.0-255,66,209426,13,376445
9084,0.036461,172.217.27.0-255,5738,215164,13,376445
9085,0.036469,172.31.36.0-255,66,215230,13,376445
9086,0.038109,172.217.27.0-255,5738,220968,13,376445
9087,0.038117,172.31.36.0-255,66,221034,13,376445
9088,0.039759,172.217.27.0-255,4320,225354,13,376445
9089,0.039766,172.31.36.0-255,66,225420,13,376445
9090,0.039803,172.217.27.0-255,1484,226904,13,376445
9091,0.04144,172.217.27.0-255,4320,231224,13,376445
9092,0.041446,172.31.36.0-255,66,231290,13,376445
9093,0.043088,172.217.27.0-255,4320,235610,13,376445
9094,0.043093,172.31.36.0-255,66,235676,13,376445
9095,0.043127,172.217.27.0-255,1484,237160,13,376445
9096,0.044725,172.217.27.0-255,4320,241480,13,376445
9097,0.044731,172.31.36.0-255,66,241546,13,376445
9098,0.046379,172.217.27.0-255,5738,247284,13,376445
9099,0.046774,172.31.36.0-255,66,247350,13,376445
9100,0.048427,172.217.27.0-255,5738,253088,13,376445
9101,0.048433,172.31.36.0-255,66,253154,13,376445
9102,0.050098,172.217.27.0-255,5738,258892,13,376445
9103,0.050103,172.31.36.0-255,66,258958,13,376445
9104,0.051735,172.217.27.0-255,5738,264696,13,376445
9105,0.05174,172.31.36.0-255,66,264762,13,376445
9106,0.053375,172.217.27.0-255,4320,269082,13,376445
9107,0.053381,172.31.36.0-255,66,269148,13,376445
9108,0.053408,172.217.27.0-255,1484,270632,13,376445
9109,0.05502,172.217.27.0-255,4320,274952,13,376445
9110,0.055026,172.31.36.0-255,66,275018,13,376445
9111,0.056667,172.217.27.0-255,5738,280756,13,376445
9112,0.056728,172.31.36.0-255,66,280822,13,376445
9113,0.058367,172.217.27.0-255,5738,286560,13,376445
9114,0.058373,172.31.36.0-255,66,286626,13,376445
9115,0.060012,172.217.27.0-255,5738,292364,13,376445
9116,0.060018,172.31.36.0-255,66,292430,13,376445
9117,0.061647,172.217.27.0-255,5738,298168,13,376445
9118,0.061653,172.31.36.0-255,66,298234,13,376445
9119,0.063305,172.217.27.0-255,4320,302554,13,376445
9120,0.063311,172.31.36.0-255,66,302620,13,376445
9121,0.063342,172.217.27.0-255,1484,304104,13,376445
9122,0.064948,172.217.27.0-255,4320,308424,13,376445
9123,0.064954,172.31.36.0-255,66,308490,13,376445
9124,0.066594,172.217.27.0-255,5738,314228,13,376445
9125,0.066651,172.31.36.0-255,66,314294,13,376445
9126,0.068292,172.217.27.0-255,5738,320032,13,376445
9127,0.068298,172.31.36.0-255,66,320098,13,376445
9128,0.069934,172.217.27.0-255,5738,325836,13,376445
9129,0.069939,172.31.36.0-255,66,325902,13,376445
9130,0.071581,172.217.27.0-255,5738,331640,13,376445
9131,0.071587,172.31.36.0-255,66,331706,13,376445
9132,0.073221,172.217.27.0-255,5738,337444,13,376445
9133,0.073226,172.31.36.0-255,66,337510,13,376445
9134,0.07487,172.217.27.0-255,5738,343248,13,376445
9135,0.074875,172.31.36.0-255,66,343314,13,376445
9136,0.076505,172.217.27.0-255,5738,349052,13,376445
9137,0.07651,172.31.36.0-255,66,349118,13,376445
9138,0.078144,172.217.27.0-255,5738,354856,13,376445
9139,0.07815,172.31.36.0-255,66,354922,13,376445
9140,0.079784,172.217.27.0-255,5738,360660,13,376445
9141,0.07979,172.31.36.0-255,66,360726,13,376445
9142,0.081434,172.217.27.0-255,5738,366464,13,376445
9143,0.081439,172.31.36.0-255,66,366530,13,376445
9144,0.083086,172.217.27.0-255,5738,372268,13,376445
9145,0.083092,172.31.36.0-255,66,372334,13,376445
9146,0.084722,172.217.27.0-255,3940,376274,13,376445
9147,0.084728,172.31.36.0-255,66,376340,13,376445
9148,0.084911,172.31.36.0-255,105,376445,13,376445
9149,0.0,74.125.24.0-255,146,146,13,200475
9150,2.3e-05,172.31.36.0-255,66,212,13,200475
9151,3.1e-05,74.125.24.0-255,1484,1696,13,200475
9152,3.6e-05,172.31.36.0-255,66,1762,13,200475
9153,4.2e-05,74.125.24.0-255,2902,4664,13,200475
9154,4.6e-05,172.31.36.0-255,66,4730,13,200475
9155,5.5e-05,74.125.24.0-255,7156,11886,13,200475
9156,5.9e-05,172.31.36.0-255,66,11952,13,200475
9157,6.3e-05,74.125.24.0-255,2075,14027,13,200475
9158,6.6e-05,172.31.36.0-255,66,14093,13,200475
9159,0.000105,74.125.24.0-255,1484,15577,13,200475
9160,0.000108,172.31.36.0-255,66,15643,13,200475
9161,0.000114,74.125.24.0-255,2902,18545,13,200475
9162,0.000118,172.31.36.0-255,66,18611,13,200475
9163,0.000148,74.125.24.0-255,5738,24349,13,200475
9164,0.000151,172.31.36.0-255,66,24415,13,200475
9165,0.000198,74.125.24.0-255,2902,27317,13,200475
9166,0.000201,172.31.36.0-255,66,27383,13,200475
9167,0.000217,74.125.24.0-255,3961,31344,13,200475
9168,0.000223,172.31.36.0-255,66,31410,13,200475
9169,0.000262,74.125.24.0-255,1484,32894,13,200475
9170,0.000265,172.31.36.0-255,66,32960,13,200475
9171,0.000268,74.125.24.0-255,1484,34444,13,200475
9172,0.000271,172.31.36.0-255,66,34510,13,200475
9173,0.000284,74.125.24.0-255,1484,35994,13,200475
9174,0.000286,172.31.36.0-255,66,36060,13,200475
9175,0.000293,74.125.24.0-255,5738,41798,13,200475
9176,0.000295,172.31.36.0-255,66,41864,13,200475
9177,0.000347,172.31.36.0-255,66,41930,13,200475
9178,0.000361,172.31.36.0-255,66,41996,13,200475
9179,0.000363,74.125.24.0-255,1401,43397,13,200475
9180,0.000383,74.125.24.0-255,132,43529,13,200475
9181,0.000397,74.125.24.0-255,346,43875,13,200475
9182,0.0004,172.31.36.0-255,66,43941,13,200475
9183,0.000637,74.125.24.0-255,1484,45425,13,200475
9184,0.000644,74.125.24.0-255,2902,48327,13,200475
9185,0.000648,172.31.36.0-255,66,48393,13,200475
9186,0.000655,74.125.24.0-255,5738,54131,13,200475
9187,0.000658,172.31.36.0-255,66,54197,13,200475
9188,0.000696,172.31.36.0-255,66,54263,13,200475
9189,0.000732,74.125.24.0-255,7156,61419,13,200475
9190,0.000735,172.31.36.0-255,66,61485,13,200475
9191,0.000756,74.125.24.0-255,5020,66505,13,200475
9192,0.000758,172.31.36.0-255,66,66571,13,200475
9193,0.001368,74.125.24.0-255,1484,68055,13,200475
9194,0.001375,74.125.24.0-255,2902,70957,13,200475
9195,0.001378,172.31.36.0-255,66,71023,13,200475
9196,0.001386,74.125.24.0-255,5738,76761,13,200475
9197,0.001388,172.31.36.0-255,66,76827,13,200475
9198,0.001395,74.125.24.0-255,5738,82565,13,200475
9199,0.001398,172.31.36.0-255,66,82631,13,200475
9200,0.001422,74.125.24.0-255,7156,89787,13,200475
9201,0.001425,172.31.36.0-255,66,89853,13,200475
9202,0.001441,74.125.24.0-255,1484,91337,13,200475
9203,0.001455,74.125.24.0-255,4320,95657,13,200475
9204,0.001459,172.31.36.0-255,66,95723,13,200475
9205,0.00148,74.125.24.0-255,5020,100743,13,200475
9206,0.001483,172.31.36.0-255,66,100809,13,200475
9207,0.001514,74.125.24.0-255,1484,102293,13,200475
9208,0.001532,74.125.24.0-255,2902,105195,13,200475
9209,0.001535,172.31.36.0-255,66,105261,13,200475
9210,0.001542,74.125.24.0-255,5738,110999,13,200475
9211,0.001544,172.31.36.0-255,66,111065,13,200475
9212,0.00155,74.125.24.0-255,4320,115385,13,200475
9213,0.001552,172.31.36.0-255,66,115451,13,200475
9214,0.001579,74.125.24.0-255,5738,121189,13,200475
9215,0.001581,172.31.36.0-255,66,121255,13,200475
9216,0.001584,74.125.24.0-255,1484,122739,13,200475
9217,0.001619,172.31.36.0-255,66,122805,13,200475
9218,0.001631,172.31.36.0-255,66,122871,13,200475
9219,0.001684,172.31.36.0-255,66,122937,13,200475
9220,0.001706,74.125.24.0-255,2184,125121,13,200475
9221,0.001709,172.31.36.0-255,66,125187,13,200475
9222,0.00174,74.125.24.0-255,2902,128089,13,200475
9223,0.001743,172.31.36.0-255,66,128155,13,200475
9224,0.00176,74.125.24.0-255,4320,132475,13,200475
9225,0.001763,172.31.36.0-255,66,132541,13,200475
9226,0.001821,74.125.24.0-255,8574,141115,13,200475
9227,0.001824,172.31.36.0-255,66,141181,13,200475
9228,0.001842,172.31.36.0-255,66,141247,13,200475
9229,0.001894,74.125.24.0-255,1484,142731,13,200475
9230,0.001899,74.125.24.0-255,2902,145633,13,200475
9231,0.001902,172.31.36.0-255,66,145699,13,200475
9232,0.001919,74.125.24.0-255,4320,150019,13,200475
9233,0.001921,172.31.36.0-255,66,150085,13,200475
9234,0.001941,74.125.24.0-255,1484,151569,13,200475
9235,0.001949,74.125.24.0-255,5738,157307,13,200475
9236,0.001951,172.31.36.0-255,66,157373,13,200475
9237,0.001983,74.125.24.0-255,7156,164529,13,200475
9238,0.001986,172.31.36.0-255,66,164595,13,200475
9239,0.001997,74.125.24.0-255,10692,175287,13,200475
9240,0.002,172.31.36.0-255,66,175353,13,200475
9241,0.002023,74.125.24.0-255,2902,178255,13,200475
9242,0.002025,172.31.36.0-255,66,178321,13,200475
9243,0.002068,74.125.24.0-255,2902,181223,13,200475
9244,0.00207,74.125.24.0-255,1484,182707,13,200475
9245,0.002077,172.31.36.0-255,66,182773,13,200475
9246,0.002138,74.125.24.0-255,5738,188511,13,200475
9247,0.002142,172.31.36.0-255,66,188577,13,200475
9248,0.002148,172.31.36.0-255,66,188643,13,200475
9249,0.002187,74.125.24.0-255,1484,190127,13,200475
9250,0.002215,74.125.24.0-255,5652,195779,13,200475
9251,0.002218,74.125.24.0-255,105,195884,13,200475
9252,0.002221,172.31.36.0-255,66,195950,13,200475
9253,0.002232,172.31.36.0-255,66,196016,13,200475
9254,0.004173,172.31.36.0-255,105,196121,13,200475
9255,0.006485,74.125.24.0-255,66,196187,13,200475
9256,0.030866,172.31.36.0-255,171,196358,13,200475
9257,0.030903,172.31.36.0-255,1134,197492,13,200475
9258,0.030964,172.31.36.0-255,1514,199006,13,200475
9259,0.030966,172.31.36.0-255,1271,200277,13,200475
9260,0.032524,104.244.42.0-255,66,200343,13,200475
9261,0.032554,104.244.42.0-255,66,200409,13,200475
9262,0.032608,104.244.42.0-255,66,200475,13,200475
9263,0.0,172.217.194.0-255,162,162,13,310447
9264,2.4e-05,172.31.36.0-255,66,228,13,310447
9265,3.2e-05,172.217.194.0-255,1484,1712,13,310447
9266,3.7e-05,172.31.36.0-255,66,1778,13,310447
9267,5e-05,172.217.194.0-255,2902,4680,13,310447
9268,5.3e-05,172.31.36.0-255,66,4746,13,310447
9269,5.9e-05,172.217.194.0-255,4320,9066,13,310447
9270,6.3e-05,172.31.36.0-255,66,9132,13,310447
9271,7.3e-05,172.217.194.0-255,9992,19124,13,310447
9272,7.6e-05,172.31.36.0-255,66,19190,13,310447
9273,0.000108,172.217.194.0-255,2058,21248,13,310447
9274,0.000111,172.31.36.0-255,66,21314,13,310447
9275,0.000121,172.217.194.0-255,7156,28470,13,310447
9276,0.000123,172.31.36.0-255,66,28536,13,310447
9277,0.000128,172.217.194.0-255,2543,31079,13,310447
9278,0.000129,172.31.36.0-255,66,31145,13,310447
9279,0.000912,172.217.194.0-255,1484,32629,13,310447
9280,0.000918,172.31.36.0-255,66,32695,13,310447
9281,0.000927,172.217.194.0-255,2902,35597,13,310447
9282,0.000929,172.31.36.0-255,66,35663,13,310447
9283,0.000942,172.217.194.0-255,5738,41401,13,310447
9284,0.000944,172.31.36.0-255,66,41467,13,310447
9285,0.000949,172.217.194.0-255,4320,45787,13,310447
9286,0.000951,172.31.36.0-255,66,45853,13,310447
9287,0.000979,172.217.194.0-255,2902,48755,13,310447
9288,0.000981,172.31.36.0-255,66,48821,13,310447
9289,0.001029,172.217.194.0-255,9633,58454,13,310447
9290,0.001032,172.31.36.0-255,66,58520,13,310447
9291,0.00104,172.217.194.0-255,7048,65568,13,310447
9292,0.001043,172.31.36.0-255,66,65634,13,310447
9293,0.001046,172.217.194.0-255,120,65754,13,310447
9294,0.001047,172.31.36.0-255,66,65820,13,310447
9295,0.001134,172.217.194.0-255,1484,67304,13,310447
9296,0.001151,172.217.194.0-255,2902,70206,13,310447
9297,0.001167,172.217.194.0-255,2902,73108,13,310447
9298,0.00118,172.217.194.0-255,2902,76010,13,310447
9299,0.001204,172.217.194.0-255,5738,81748,13,310447
9300,0.001221,172.217.194.0-255,7156,88904,13,310447
9301,0.001248,172.217.194.0-255,4320,93224,13,310447
9302,0.001268,172.217.194.0-255,6752,99976,13,310447
9303,0.00162,172.217.194.0-255,1484,101460,13,310447
9304,0.001634,172.217.194.0-255,2902,104362,13,310447
9305,0.001637,172.217.194.0-255,1484,105846,13,310447
9306,0.001656,172.217.194.0-255,4320,110166,13,310447
9307,0.001663,172.217.194.0-255,5738,115904,13,310447
9308,0.001736,172.217.194.0-255,5020,120924,13,310447
9309,0.001769,172.217.194.0-255,5738,126662,13,310447
9310,0.001777,172.217.194.0-255,7156,133818,13,310447
9311,0.001813,172.217.194.0-255,1484,135302,13,310447
9312,0.001819,172.217.194.0-255,5738,141040,13,310447
9313,0.001841,172.217.194.0-255,5020,146060,13,310447
9314,0.001864,172.217.194.0-255,4320,150380,13,310447
9315,0.00191,172.217.194.0-255,2184,152564,13,310447
9316,0.001938,172.217.194.0-255,5738,158302,13,310447
9317,0.001945,172.217.194.0-255,5738,164040,13,310447
9318,0.001958,172.217.194.0-255,1484,165524,13,310447
9319,0.002,172.217.194.0-255,6438,171962,13,310447
9320,0.002075,172.217.194.0-255,1484,173446,13,310447
9321,0.002079,172.217.194.0-255,1484,174930,13,310447
9322,0.002093,172.217.194.0-255,1484,176414,13,310447
9323,0.0021,172.217.194.0-255,5738,182152,13,310447
9324,0.002132,172.217.194.0-255,7156,189308,13,310447
9325,0.002153,172.217.194.0-255,5738,195046,13,310447
9326,0.002162,172.217.194.0-255,8574,203620,13,310447
9327,0.002188,172.217.194.0-255,2184,205804,13,310447
9328,0.002297,172.217.194.0-255,1484,207288,13,310447
9329,0.002303,172.217.194.0-255,2902,210190,13,310447
9330,0.002307,172.217.194.0-255,1484,211674,13,310447
9331,0.002319,172.217.194.0-255,4320,215994,13,310447
9332,0.002351,172.217.194.0-255,7156,223150,13,310447
9333,0.002368,172.217.194.0-255,4320,227470,13,310447
9334,0.002401,172.217.194.0-255,7156,234626,13,310447
9335,0.00242,172.217.194.0-255,5020,239646,13,310447
9336,0.002434,172.217.194.0-255,2902,242548,13,310447
9337,0.002453,172.217.194.0-255,9992,252540,13,310447
9338,0.002461,172.217.194.0-255,7156,259696,13,310447
9339,0.002536,172.217.194.0-255,2902,262598,13,310447
9340,0.00256,172.217.194.0-255,4320,266918,13,310447
9341,0.002566,172.217.194.0-255,4320,271238,13,310447
9342,0.002582,172.217.194.0-255,4320,275558,13,310447
9343,0.008309,172.31.36.0-255,66,275624,13,310447
9344,0.010921,172.217.194.0-255,5738,281362,13,310447
9345,0.01093,172.31.36.0-255,66,281428,13,310447
9346,0.013529,172.217.194.0-255,5738,287166,13,310447
9347,0.013539,172.31.36.0-255,66,287232,13,310447
9348,0.016142,172.217.194.0-255,5738,292970,13,310447
9349,0.016151,172.31.36.0-255,66,293036,13,310447
9350,0.018728,172.217.194.0-255,5738,298774,13,310447
9351,0.018741,172.31.36.0-255,66,298840,13,310447
9352,0.021317,172.217.194.0-255,5738,304578,13,310447
9353,0.021326,172.31.36.0-255,66,304644,13,310447
9354,0.023899,172.217.194.0-255,1277,305921,13,310447
9355,0.024039,172.31.36.0-255,66,305987,13,310447
9356,0.024077,172.31.36.0-255,105,306092,13,310447
9357,0.026619,172.217.194.0-255,66,306158,13,310447
9358,0.036792,172.31.36.0-255,172,306330,13,310447
9359,0.036827,172.31.36.0-255,1106,307436,13,310447
9360,0.036889,172.31.36.0-255,1514,308950,13,310447
9361,0.036891,172.31.36.0-255,1299,310249,13,310447
9362,0.038338,104.244.42.0-255,66,310315,13,310447
9363,0.038399,104.244.42.0-255,66,310381,13,310447
9364,0.038453,104.244.42.0-255,66,310447,13,310447
9365,0.0,74.125.24.0-255,153,153,13,222867
9366,2.9e-05,172.31.36.0-255,66,219,13,222867
9367,3.7e-05,74.125.24.0-255,1484,1703,13,222867
9368,4e-05,172.31.36.0-255,66,1769,13,222867
9369,4.6e-05,74.125.24.0-255,2902,4671,13,222867
9370,5.6e-05,172.31.36.0-255,66,4737,13,222867
9371,6.3e-05,74.125.24.0-255,7156,11893,13,222867
9372,6.7e-05,172.31.36.0-255,66,11959,13,222867
9373,7e-05,74.125.24.0-255,1484,13443,13,222867
9374,7.2e-05,172.31.36.0-255,66,13509,13,222867
9375,0.00011,172.31.36.0-255,66,13575,13,222867
9376,0.00014,74.125.24.0-255,3473,17048,13,222867
9377,0.000143,172.31.36.0-255,66,17114,13,222867
9378,0.000147,74.125.24.0-255,2543,19657,13,222867
9379,0.000149,172.31.36.0-255,66,19723,13,222867
9380,0.000201,74.125.24.0-255,1484,21207,13,222867
9381,0.000204,172.31.36.0-255,66,21273,13,222867
9382,0.000209,74.125.24.0-255,2902,24175,13,222867
9383,0.000212,172.31.36.0-255,66,24241,13,222867
9384,0.000242,74.125.24.0-255,5738,29979,13,222867
9385,0.000246,172.31.36.0-255,66,30045,13,222867
9386,0.000261,74.125.24.0-255,5738,35783,13,222867
9387,0.000269,172.31.36.0-255,66,35849,13,222867
9388,0.000306,74.125.24.0-255,8215,44064,13,222867
9389,0.000309,172.31.36.0-255,66,44130,13,222867
9390,0.000319,74.125.24.0-255,9907,54037,13,222867
9391,0.000327,172.31.36.0-255,66,54103,13,222867
9392,0.000575,74.125.24.0-255,131,54234,13,222867
9393,0.000581,172.31.36.0-255,66,54300,13,222867
9394,0.000725,74.125.24.0-255,1484,55784,13,222867
9395,0.000729,172.31.36.0-255,66,55850,13,222867
9396,0.000734,74.125.24.0-255,2902,58752,13,222867
9397,0.000737,172.31.36.0-255,66,58818,13,222867
9398,0.000773,74.125.24.0-255,4320,63138,13,222867
9399,0.000776,172.31.36.0-255,66,63204,13,222867
9400,0.000783,74.125.24.0-255,5738,68942,13,222867
9401,0.000785,172.31.36.0-255,66,69008,13,222867
9402,0.000845,74.125.24.0-255,2543,71551,13,222867
9403,0.000849,172.31.36.0-255,66,71617,13,222867
9404,0.000853,74.125.24.0-255,2902,74519,13,222867
9405,0.000855,172.31.36.0-255,66,74585,13,222867
9406,0.000868,74.125.24.0-255,7156,81741,13,222867
9407,0.00087,172.31.36.0-255,66,81807,13,222867
9408,0.000898,74.125.24.0-255,1484,83291,13,222867
9409,0.000915,74.125.24.0-255,5379,88670,13,222867
9410,0.000919,172.31.36.0-255,66,88736,13,222867
9411,0.001263,74.125.24.0-255,1484,90220,13,222867
9412,0.001276,74.125.24.0-255,2902,93122,13,222867
9413,0.00128,172.31.36.0-255,66,93188,13,222867
9414,0.001287,74.125.24.0-255,4320,97508,13,222867
9415,0.001289,172.31.36.0-255,66,97574,13,222867
9416,0.001307,74.125.24.0-255,1484,99058,13,222867
9417,0.001313,74.125.24.0-255,5738,104796,13,222867
9418,0.001315,172.31.36.0-255,66,104862,13,222867
9419,0.001351,172.31.36.0-255,66,104928,13,222867
9420,0.001357,74.125.24.0-255,5020,109948,13,222867
9421,0.00136,172.31.36.0-255,66,110014,13,222867
9422,0.001441,74.125.24.0-255,1484,111498,13,222867
9423,0.001446,74.125.24.0-255,1484,112982,13,222867
9424,0.001449,172.31.36.0-255,66,113048,13,222867
9425,0.001481,74.125.24.0-255,1484,114532,13,222867
9426,0.001488,74.125.24.0-255,5738,120270,13,222867
9427,0.001491,172.31.36.0-255,66,120336,13,222867
9428,0.001512,172.31.36.0-255,66,120402,13,222867
9429,0.001522,74.125.24.0-255,10692,131094,13,222867
9430,0.001525,172.31.36.0-255,66,131160,13,222867
9431,0.001689,74.125.24.0-255,1484,132644,13,222867
9432,0.001709,74.125.24.0-255,2902,135546,13,222867
9433,0.001714,172.31.36.0-255,66,135612,13,222867
9434,0.001719,74.125.24.0-255,2902,138514,13,222867
9435,0.001721,172.31.36.0-255,66,138580,13,222867
9436,0.001759,74.125.24.0-255,7156,145736,13,222867
9437,0.001764,172.31.36.0-255,66,145802,13,222867
9438,0.001769,74.125.24.0-255,2902,148704,13,222867
9439,0.001772,172.31.36.0-255,66,148770,13,222867
9440,0.001809,172.31.36.0-255,66,148836,13,222867
9441,0.001814,74.125.24.0-255,5020,153856,13,222867
9442,0.001817,172.31.36.0-255,66,153922,13,222867
9443,0.001916,74.125.24.0-255,1484,155406,13,222867
9444,0.00192,74.125.24.0-255,1484,156890,13,222867
9445,0.001923,172.31.36.0-255,66,156956,13,222867
9446,0.001953,74.125.24.0-255,1484,158440,13,222867
9447,0.001958,74.125.24.0-255,5738,164178,13,222867
9448,0.001961,172.31.36.0-255,66,164244,13,222867
9449,0.001969,74.125.24.0-255,9992,174236,13,222867
9450,0.001972,172.31.36.0-255,66,174302,13,222867
9451,0.001994,74.125.24.0-255,2902,177204,13,222867
9452,0.001996,172.31.36.0-255,66,177270,13,222867
9453,0.002004,74.125.24.0-255,8574,185844,13,222867
9454,0.002007,172.31.36.0-255,66,185910,13,222867
9455,0.002032,74.125.24.0-255,5738,191648,13,222867
9456,0.00204,172.31.36.0-255,66,191714,13,222867
9457,0.002086,172.31.36.0-255,66,191780,13,222867
9458,0.002141,172.31.36.0-255,66,191846,13,222867
9459,0.002179,172.31.36.0-255,66,191912,13,222867
9460,0.002201,172.31.36.0-255,66,191978,13,222867
9461,0.002221,172.31.36.0-255,66,192044,13,222867
9462,0.002229,74.125.24.0-255,9274,201318,13,222867
9463,0.002232,172.31.36.0-255,66,201384,13,222867
9464,0.002258,74.125.24.0-255,9992,211376,13,222867
9465,0.002264,172.31.36.0-255,66,211442,13,222867
9466,0.002306,74.125.24.0-255,6729,218171,13,222867
9467,0.007136,172.31.36.0-255,66,218237,13,222867
9468,0.00941,74.125.24.0-255,105,218342,13,222867
9469,0.009474,172.31.36.0-255,66,218408,13,222867
9470,0.009506,172.31.36.0-255,105,218513,13,222867
9471,0.011783,74.125.24.0-255,66,218579,13,222867
9472,0.028184,172.31.36.0-255,171,218750,13,222867
9473,0.028213,172.31.36.0-255,1130,219880,13,222867
9474,0.028253,172.31.36.0-255,1514,221394,13,222867
9475,0.028255,172.31.36.0-255,1275,222669,13,222867
9476,0.0297,104.244.42.0-255,66,222735,13,222867
9477,0.029768,104.244.42.0-255,66,222801,13,222867
9478,0.029773,104.244.42.0-255,66,222867,13,222867
9479,0.0,216.58.221.0-255,292,292,13,335343
9480,1.1e-05,172.31.36.0-255,66,358,13,335343
9481,3.4e-05,216.58.221.0-255,1484,1842,13,335343
9482,3.8e-05,172.31.36.0-255,66,1908,13,335343
9483,4.4e-05,216.58.221.0-255,2902,4810,13,335343
9484,4.7e-05,172.31.36.0-255,66,4876,13,335343
9485,5.3e-05,216.58.221.0-255,5738,10614,13,335343
9486,5.6e-05,172.31.36.0-255,66,10680,13,335343
9487,7.7e-05,216.58.221.0-255,3239,13919,13,335343
9488,7.9e-05,172.31.36.0-255,66,13985,13,335343
9489,0.000205,216.58.221.0-255,1484,15469,13,335343
9490,0.00021,172.31.36.0-255,66,15535,13,335343
9491,0.000215,216.58.221.0-255,2902,18437,13,335343
9492,0.000218,172.31.36.0-255,66,18503,13,335343
9493,0.000236,216.58.221.0-255,4320,22823,13,335343
9494,0.000238,172.31.36.0-255,66,22889,13,335343
9495,0.000246,216.58.221.0-255,5738,28627,13,335343
9496,0.000248,172.31.36.0-255,66,28693,13,335343
9497,0.000277,216.58.221.0-255,2543,31236,13,335343
9498,0.000279,172.31.36.0-255,66,31302,13,335343
9499,0.000487,216.58.221.0-255,1484,32786,13,335343
9500,0.000492,172.31.36.0-255,66,32852,13,335343
9501,0.000496,216.58.221.0-255,1484,34336,13,335343
9502,0.000498,172.31.36.0-255,66,34402,13,335343
9503,0.000513,216.58.221.0-255,1484,35886,13,335343
9504,0.000516,172.31.36.0-255,66,35952,13,335343
9505,0.000523,216.58.221.0-255,5738,41690,13,335343
9506,0.000525,172.31.36.0-255,66,41756,13,335343
9507,0.000539,216.58.221.0-255,1484,43240,13,335343
9508,0.000541,172.31.36.0-255,66,43306,13,335343
9509,0.000557,216.58.221.0-255,5379,48685,13,335343
9510,0.00056,172.31.36.0-255,66,48751,13,335343
9511,0.000595,216.58.221.0-255,2902,51653,13,335343
9512,0.000598,172.31.36.0-255,66,51719,13,335343
9513,0.000604,216.58.221.0-255,4320,56039,13,335343
9514,0.000607,172.31.36.0-255,66,56105,13,335343
9515,0.000611,216.58.221.0-255,2902,59007,13,335343
9516,0.000613,172.31.36.0-255,66,59073,13,335343
9517,0.000642,216.58.221.0-255,5738,64811,13,335343
9518,0.000645,172.31.36.0-255,66,64877,13,335343
9519,0.000648,216.58.221.0-255,1452,66329,13,335343
9520,0.001047,172.31.36.0-255,66,66395,13,335343
9521,0.00186,216.58.221.0-255,350,66745,13,335343
9522,0.001952,216.58.221.0-255,1484,68229,13,335343
9523,0.001957,172.31.36.0-255,66,68295,13,335343
9524,0.002695,216.58.221.0-255,1484,69779,13,335343
9525,0.002963,216.58.221.0-255,1484,71263,13,335343
9526,0.002966,172.31.36.0-255,66,71329,13,335343
9527,0.003905,216.58.221.0-255,2902,74231,13,335343
9528,0.003909,172.31.36.0-255,66,74297,13,335343
9529,0.004916,216.58.221.0-255,2902,77199,13,335343
9530,0.004922,172.31.36.0-255,66,77265,13,335343
9531,0.005832,216.58.221.0-255,2902,80167,13,335343
9532,0.005835,172.31.36.0-255,66,80233,13,335343
9533,0.006853,216.58.221.0-255,2902,83135,13,335343
9534,0.006856,172.31.36.0-255,66,83201,13,335343
9535,0.007768,216.58.221.0-255,2902,86103,13,335343
9536,0.007774,172.31.36.0-255,66,86169,13,335343
9537,0.008786,216.58.221.0-255,2902,89071,13,335343
9538,0.008805,172.31.36.0-255,66,89137,13,335343
9539,0.009703,216.58.221.0-255,2902,92039,13,335343
9540,0.00971,172.31.36.0-255,66,92105,13,335343
9541,0.010737,216.58.221.0-255,2902,95007,13,335343
9542,0.010744,172.31.36.0-255,66,95073,13,335343
9543,0.01164,216.58.221.0-255,2902,97975,13,335343
9544,0.011647,172.31.36.0-255,66,98041,13,335343
9545,0.012677,216.58.221.0-255,2902,100943,13,335343
9546,0.012684,172.31.36.0-255,66,101009,13,335343
9547,0.013575,216.58.221.0-255,2902,103911,13,335343
9548,0.013582,172.31.36.0-255,66,103977,13,335343
9549,0.014618,216.58.221.0-255,2902,106879,13,335343
9550,0.014625,172.31.36.0-255,66,106945,13,335343
9551,0.015573,216.58.221.0-255,2902,109847,13,335343
9552,0.01558,172.31.36.0-255,66,109913,13,335343
9553,0.016555,216.58.221.0-255,2902,112815,13,335343
9554,0.016562,172.31.36.0-255,66,112881,13,335343
9555,0.017506,216.58.221.0-255,2902,115783,13,335343
9556,0.017513,172.31.36.0-255,66,115849,13,335343
9557,0.018486,216.58.221.0-255,2902,118751,13,335343
9558,0.018493,172.31.36.0-255,66,118817,13,335343
9559,0.019441,216.58.221.0-255,2902,121719,13,335343
9560,0.019448,172.31.36.0-255,66,121785,13,335343
9561,0.020426,216.58.221.0-255,2902,124687,13,335343
9562,0.020432,172.31.36.0-255,66,124753,13,335343
9563,0.021373,216.58.221.0-255,2902,127655,13,335343
9564,0.021381,172.31.36.0-255,66,127721,13,335343
9565,0.022368,216.58.221.0-255,2902,130623,13,335343
9566,0.022375,172.31.36.0-255,66,130689,13,335343
9567,0.023344,216.58.221.0-255,2902,133591,13,335343
9568,0.023352,172.31.36.0-255,66,133657,13,335343
9569,0.024299,216.58.221.0-255,1484,135141,13,335343
9570,0.025283,216.58.221.0-255,4320,139461,13,335343
9571,0.02529,172.31.36.0-255,66,139527,13,335343
9572,0.027233,216.58.221.0-255,5738,145265,13,335343
9573,0.02724,172.31.36.0-255,66,145331,13,335343
9574,0.028912,172.31.36.0-255,167,145498,13,335343
9575,0.028944,172.31.36.0-255,1106,146604,13,335343
9576,0.029002,172.31.36.0-255,1514,148118,13,335343
9577,0.029004,172.31.36.0-255,1299,149417,13,335343
9578,0.029169,216.58.221.0-255,5738,155155,13,335343
9579,0.029175,172.31.36.0-255,66,155221,13,335343
9580,0.030439,104.244.42.0-255,66,155287,13,335343
9581,0.030502,104.244.42.0-255,66,155353,13,335343
9582,0.030506,104.244.42.0-255,66,155419,13,335343
9583,0.031109,216.58.221.0-255,5738,161157,13,335343
9584,0.031116,172.31.36.0-255,66,161223,13,335343
9585,0.033059,216.58.221.0-255,5738,166961,13,335343
9586,0.033066,172.31.36.0-255,66,167027,13,335343
9587,0.035015,216.58.221.0-255,5738,172765,13,335343
9588,0.035021,172.31.36.0-255,66,172831,13,335343
9589,0.036965,216.58.221.0-255,5738,178569,13,335343
9590,0.036972,172.31.36.0-255,66,178635,13,335343
9591,0.038916,216.58.221.0-255,5738,184373,13,335343
9592,0.038923,172.31.36.0-255,66,184439,13,335343
9593,0.040867,216.58.221.0-255,5738,190177,13,335343
9594,0.040874,172.31.36.0-255,66,190243,13,335343
9595,0.042815,216.58.221.0-255,5738,195981,13,335343
9596,0.042821,172.31.36.0-255,66,196047,13,335343
9597,0.044779,216.58.221.0-255,5738,201785,13,335343
9598,0.044786,172.31.36.0-255,66,201851,13,335343
9599,0.046721,216.58.221.0-255,5738,207589,13,335343
9600,0.046727,172.31.36.0-255,66,207655,13,335343
9601,0.048664,216.58.221.0-255,5738,213393,13,335343
9602,0.048671,172.31.36.0-255,66,213459,13,335343
9603,0.050617,216.58.221.0-255,5738,219197,13,335343
9604,0.050624,172.31.36.0-255,66,219263,13,335343
9605,0.05256,216.58.221.0-255,5738,225001,13,335343
9606,0.052566,172.31.36.0-255,66,225067,13,335343
9607,0.054509,216.58.221.0-255,5738,230805,13,335343
9608,0.054515,172.31.36.0-255,66,230871,13,335343
9609,0.056464,216.58.221.0-255,5738,236609,13,335343
9610,0.056471,172.31.36.0-255,66,236675,13,335343
9611,0.058417,216.58.221.0-255,5738,242413,13,335343
9612,0.058424,172.31.36.0-255,66,242479,13,335343
9613,0.060357,216.58.221.0-255,5738,248217,13,335343
9614,0.060364,172.31.36.0-255,66,248283,13,335343
9615,0.062309,216.58.221.0-255,5738,254021,13,335343
9616,0.062315,172.31.36.0-255,66,254087,13,335343
9617,0.064254,216.58.221.0-255,5738,259825,13,335343
9618,0.064263,172.31.36.0-255,66,259891,13,335343
9619,0.0662,216.58.221.0-255,5738,265629,13,335343
9620,0.066206,172.31.36.0-255,66,265695,13,335343
9621,0.068135,216.58.221.0-255,5738,271433,13,335343
9622,0.068142,172.31.36.0-255,66,271499,13,335343
9623,0.070088,216.58.221.0-255,5738,277237,13,335343
9624,0.070095,172.31.36.0-255,66,277303,13,335343
9625,0.072035,216.58.221.0-255,5738,283041,13,335343
9626,0.072042,172.31.36.0-255,66,283107,13,335343
9627,0.073987,216.58.221.0-255,5738,288845,13,335343
9628,0.073993,172.31.36.0-255,66,288911,13,335343
9629,0.075944,216.58.221.0-255,5738,294649,13,335343
9630,0.07595,172.31.36.0-255,66,294715,13,335343
9631,0.077896,216.58.221.0-255,5738,300453,13,335343
9632,0.077903,172.31.36.0-255,66,300519,13,335343
9633,0.079856,216.58.221.0-255,5738,306257,13,335343
9634,0.079862,172.31.36.0-255,66,306323,13,335343
9635,0.081814,216.58.221.0-255,5738,312061,13,335343
9636,0.081821,172.31.36.0-255,66,312127,13,335343
9637,0.083786,216.58.221.0-255,5738,317865,13,335343
9638,0.083792,172.31.36.0-255,66,317931,13,335343
9639,0.085763,216.58.221.0-255,5738,323669,13,335343
9640,0.085769,172.31.36.0-255,66,323735,13,335343
9641,0.087711,216.58.221.0-255,5738,329473,13,335343
9642,0.087718,172.31.36.0-255,66,329539,13,335343
9643,0.089664,216.58.221.0-255,5738,335277,13,335343
9644,0.08967,172.31.36.0-255,66,335343,13,335343
9645,0.0,74.125.130.0-255,153,153,13,377616
9646,2.2e-05,172.31.36.0-255,66,219,13,377616
9647,2.9e-05,74.125.130.0-255,1484,1703,13,377616
9648,3.3e-05,172.31.36.0-255,66,1769,13,377616
9649,3.8e-05,74.125.130.0-255,2902,4671,13,377616
9650,4e-05,172.31.36.0-255,66,4737,13,377616
9651,5.7e-05,74.125.130.0-255,7156,11893,13,377616
9652,6e-05,172.31.36.0-255,66,11959,13,377616
9653,6.4e-05,74.125.130.0-255,2084,14043,13,377616
9654,6.6e-05,172.31.36.0-255,66,14109,13,377616
9655,0.000318,74.125.130.0-255,1484,15593,13,377616
9656,0.000325,172.31.36.0-255,66,15659,13,377616
9657,0.000332,74.125.130.0-255,2902,18561,13,377616
9658,0.000334,172.31.36.0-255,66,18627,13,377616
9659,0.00034,74.125.130.0-255,4320,22947,13,377616
9660,0.000348,172.31.36.0-255,66,23013,13,377616
9661,0.000373,74.125.130.0-255,1484,24497,13,377616
9662,0.000376,172.31.36.0-255,66,24563,13,377616
9663,0.000381,74.125.130.0-255,2902,27465,13,377616
9664,0.000389,172.31.36.0-255,66,27531,13,377616
9665,0.000394,74.125.130.0-255,3961,31492,13,377616
9666,0.000396,172.31.36.0-255,66,31558,13,377616
9667,0.000399,74.125.130.0-255,1484,33042,13,377616
9668,0.000401,172.31.36.0-255,66,33108,13,377616
9669,0.000442,74.125.130.0-255,7156,40264,13,377616
9670,0.000446,172.31.36.0-255,66,40330,13,377616
9671,0.000454,74.125.130.0-255,9992,50322,13,377616
9672,0.000456,172.31.36.0-255,66,50388,13,377616
9673,0.000469,74.125.130.0-255,7156,57544,13,377616
9674,0.000472,172.31.36.0-255,66,57610,13,377616
9675,0.000499,74.125.130.0-255,4320,61930,13,377616
9676,0.000503,172.31.36.0-255,66,61996,13,377616
9677,0.000513,74.125.130.0-255,3602,65598,13,377616
9678,0.000515,172.31.36.0-255,66,65664,13,377616
9679,0.000545,74.125.130.0-255,708,66372,13,377616
9680,0.000966,74.125.130.0-255,1484,67856,13,377616
9681,0.000973,172.31.36.0-255,66,67922,13,377616
9682,0.000979,74.125.130.0-255,2902,70824,13,377616
9683,0.000981,172.31.36.0-255,66,70890,13,377616
9684,0.000999,74.125.130.0-255,2902,73792,13,377616
9685,0.001001,172.31.36.0-255,66,73858,13,377616
9686,0.001031,74.125.130.0-255,2902,76760,13,377616
9687,0.001033,172.31.36.0-255,66,76826,13,377616
9688,0.001042,74.125.130.0-255,2902,79728,13,377616
9689,0.001044,172.31.36.0-255,66,79794,13,377616
9690,0.001049,74.125.130.0-255,4320,84114,13,377616
9691,0.001052,172.31.36.0-255,66,84180,13,377616
9692,0.001058,74.125.130.0-255,5738,89918,13,377616
9693,0.00106,172.31.36.0-255,66,89984,13,377616
9694,0.001093,74.125.130.0-255,2902,92886,13,377616
9695,0.001095,172.31.36.0-255,66,92952,13,377616
9696,0.001102,74.125.130.0-255,5738,98690,13,377616
9697,0.001104,172.31.36.0-255,66,98756,13,377616
9698,0.001134,74.125.130.0-255,2184,100940,13,377616
9699,0.001136,172.31.36.0-255,66,101006,13,377616
9700,0.001185,74.125.130.0-255,1484,102490,13,377616
9701,0.0012,74.125.130.0-255,2902,105392,13,377616
9702,0.001202,172.31.36.0-255,66,105458,13,377616
9703,0.00124,74.125.130.0-255,4320,109778,13,377616
9704,0.001243,172.31.36.0-255,66,109844,13,377616
9705,0.00125,74.125.130.0-255,5738,115582,13,377616
9706,0.001252,172.31.36.0-255,66,115648,13,377616
9707,0.00126,74.125.130.0-255,1484,117132,13,377616
9708,0.001295,74.125.130.0-255,9992,127124,13,377616
9709,0.001299,172.31.36.0-255,66,127190,13,377616
9710,0.001304,74.125.130.0-255,4320,131510,13,377616
9711,0.001306,172.31.36.0-255,66,131576,13,377616
9712,0.001339,74.125.130.0-255,3602,135178,13,377616
9713,0.001342,172.31.36.0-255,66,135244,13,377616
9714,0.001384,74.125.130.0-255,1484,136728,13,377616
9715,0.0014,74.125.130.0-255,2902,139630,13,377616
9716,0.001403,172.31.36.0-255,66,139696,13,377616
9717,0.00142,74.125.130.0-255,1484,141180,13,377616
9718,0.001426,74.125.130.0-255,2902,144082,13,377616
9719,0.001428,172.31.36.0-255,66,144148,13,377616
9720,0.001439,74.125.130.0-255,1484,145632,13,377616
9721,0.001458,74.125.130.0-255,4320,149952,13,377616
9722,0.00146,172.31.36.0-255,66,150018,13,377616
9723,0.001486,74.125.130.0-255,8574,158592,13,377616
9724,0.001489,172.31.36.0-255,66,158658,13,377616
9725,0.001509,74.125.130.0-255,5738,164396,13,377616
9726,0.001512,172.31.36.0-255,66,164462,13,377616
9727,0.001542,74.125.130.0-255,4320,168782,13,377616
9728,0.001545,172.31.36.0-255,66,168848,13,377616
9729,0.001548,74.125.130.0-255,766,169614,13,377616
9730,0.001583,172.31.36.0-255,101,169715,13,377616
9731,0.001721,74.125.130.0-255,1484,171199,13,377616
9732,0.001728,74.125.130.0-255,1484,172683,13,377616
9733,0.001731,172.31.36.0-255,66,172749,13,377616
9734,0.001765,74.125.130.0-255,1484,174233,13,377616
9735,0.001772,74.125.130.0-255,5738,179971,13,377616
9736,0.00178,74.125.130.0-255,8574,188545,13,377616
9737,0.001785,172.31.36.0-255,66,188611,13,377616
9738,0.001792,172.31.36.0-255,66,188677,13,377616
9739,0.001798,74.125.130.0-255,4320,192997,13,377616
9740,0.001804,172.31.36.0-255,66,193063,13,377616
9741,0.001833,74.125.130.0-255,5738,198801,13,377616
9742,0.001836,172.31.36.0-255,66,198867,13,377616
9743,0.001843,74.125.130.0-255,5020,203887,13,377616
9744,0.001845,172.31.36.0-255,66,203953,13,377616
9745,0.002652,74.125.130.0-255,1484,205437,13,377616
9746,0.002668,74.125.130.0-255,2902,208339,13,377616
9747,0.002672,172.31.36.0-255,66,208405,13,377616
9748,0.0027,74.125.130.0-255,4320,212725,13,377616
9749,0.002703,172.31.36.0-255,66,212791,13,377616
9750,0.002709,74.125.130.0-255,5738,218529,13,377616
9751,0.002711,172.31.36.0-255,66,218595,13,377616
9752,0.002745,172.31.36.0-255,66,218661,13,377616
9753,0.002749,74.125.130.0-255,1484,220145,13,377616
9754,0.002771,74.125.130.0-255,1484,221629,13,377616
9755,0.002774,172.31.36.0-255,66,221695,13,377616
9756,0.002808,74.125.130.0-255,5020,226715,13,377616
9757,0.002811,172.31.36.0-255,66,226781,13,377616
9758,0.004313,74.125.130.0-255,66,226847,13,377616
9759,0.005589,74.125.130.0-255,5738,232585,13,377616
9760,0.005597,172.31.36.0-255,66,232651,13,377616
9761,0.008369,74.125.130.0-255,4320,236971,13,377616
9762,0.008375,172.31.36.0-255,66,237037,13,377616
9763,0.008402,74.125.130.0-255,1484,238521,13,377616
9764,0.011158,74.125.130.0-255,4320,242841,13,377616
9765,0.011175,172.31.36.0-255,66,242907,13,377616
9766,0.013973,74.125.130.0-255,5738,248645,13,377616
9767,0.013989,172.31.36.0-255,66,248711,13,377616
9768,0.016769,74.125.130.0-255,5738,254449,13,377616
9769,0.016781,172.31.36.0-255,66,254515,13,377616
9770,0.019563,74.125.130.0-255,5738,260253,13,377616
9771,0.019574,172.31.36.0-255,66,260319,13,377616
9772,0.02237,74.125.130.0-255,5738,266057,13,377616
9773,0.022378,172.31.36.0-255,66,266123,13,377616
9774,0.024623,172.31.36.0-255,171,266294,13,377616
9775,0.024676,172.31.36.0-255,1134,267428,13,377616
9776,0.024746,172.31.36.0-255,1514,268942,13,377616
9777,0.024748,172.31.36.0-255,1271,270213,13,377616
9778,0.025166,74.125.130.0-255,4320,274533,13,377616
9779,0.025172,172.31.36.0-255,66,274599,13,377616
9780,0.025203,74.125.130.0-255,1484,276083,13,377616
9781,0.026297,104.244.42.0-255,66,276149,13,377616
9782,0.026331,104.244.42.0-255,66,276215,13,377616
9783,0.0264,104.244.42.0-255,66,276281,13,377616
9784,0.027963,74.125.130.0-255,4320,280601,13,377616
9785,0.027968,172.31.36.0-255,66,280667,13,377616
9786,0.030733,74.125.130.0-255,5738,286405,13,377616
9787,0.030739,172.31.36.0-255,66,286471,13,377616
9788,0.033511,74.125.130.0-255,4320,290791,13,377616
9789,0.033516,172.31.36.0-255,66,290857,13,377616
9790,0.033551,74.125.130.0-255,1484,292341,13,377616
9791,0.036274,74.125.130.0-255,2902,295243,13,377616
9792,0.036279,172.31.36.0-255,66,295309,13,377616
9793,0.039074,74.125.130.0-255,4320,299629,13,377616
9794,0.03908,172.31.36.0-255,66,299695,13,377616
9795,0.039118,74.125.130.0-255,1484,301179,13,377616
9796,0.041976,74.125.130.0-255,4320,305499,13,377616
9797,0.041985,172.31.36.0-255,66,305565,13,377616
9798,0.044754,74.125.130.0-255,5738,311303,13,377616
9799,0.044764,172.31.36.0-255,66,311369,13,377616
9800,0.047545,74.125.130.0-255,5738,317107,13,377616
9801,0.047557,172.31.36.0-255,66,317173,13,377616
9802,0.050322,74.125.130.0-255,5738,322911,13,377616
9803,0.050332,172.31.36.0-255,66,322977,13,377616
9804,0.053101,74.125.130.0-255,5738,328715,13,377616
9805,0.053109,172.31.36.0-255,66,328781,13,377616
9806,0.055895,74.125.130.0-255,5738,334519,13,377616
9807,0.05591,172.31.36.0-255,66,334585,13,377616
9808,0.058703,74.125.130.0-255,5738,340323,13,377616
9809,0.058711,172.31.36.0-255,66,340389,13,377616
9810,0.061559,74.125.130.0-255,5738,346127,13,377616
9811,0.061567,172.31.36.0-255,66,346193,13,377616
9812,0.064336,74.125.130.0-255,5738,351931,13,377616
9813,0.064343,172.31.36.0-255,66,351997,13,377616
9814,0.067118,74.125.130.0-255,5738,357735,13,377616
9815,0.06713,172.31.36.0-255,66,357801,13,377616
9816,0.0699,74.125.130.0-255,5738,363539,13,377616
9817,0.069909,172.31.36.0-255,66,363605,13,377616
9818,0.072677,74.125.130.0-255,5738,369343,13,377616
9819,0.072684,172.31.36.0-255,66,369409,13,377616
9820,0.075494,74.125.130.0-255,5738,375147,13,377616
9821,0.0755,172.31.36.0-255,66,375213,13,377616
9822,0.078262,74.125.130.0-255,2166,377379,13,377616
9823,0.078283,172.31.36.0-255,66,377445,13,377616
9824,0.078438,172.31.36.0-255,105,377550,13,377616
9825,0.085115,74.125.130.0-255,66,377616,13,377616
9826,0.0,172.217.194.0-255,153,153,13,283183
9827,2.6e-05,172.31.36.0-255,66,219,13,283183
9828,3.4e-05,172.217.194.0-255,1484,1703,13,283183
9829,3.9e-05,172.31.36.0-255,66,1769,13,283183
9830,4.6e-05,172.217.194.0-255,2902,4671,13,283183
9831,5e-05,172.31.36.0-255,66,4737,13,283183
9832,5.6e-05,172.217.194.0-255,4320,9057,13,283183
9833,5.9e-05,172.31.36.0-255,66,9123,13,283183
9834,6.9e-05,172.217.194.0-255,9166,18289,13,283183
9835,7.3e-05,172.31.36.0-255,66,18355,13,283183
9836,0.000125,172.31.36.0-255,66,18421,13,283183
9837,0.000422,172.217.194.0-255,1484,19905,13,283183
9838,0.000427,172.31.36.0-255,66,19971,13,283183
9839,0.000435,172.217.194.0-255,2902,22873,13,283183
9840,0.000437,172.31.36.0-255,66,22939,13,283183
9841,0.000462,172.217.194.0-255,4320,27259,13,283183
9842,0.000466,172.31.36.0-255,66,27325,13,283183
9843,0.000473,172.217.194.0-255,5738,33063,13,283183
9844,0.000475,172.31.36.0-255,66,33129,13,283183
9845,0.0005,172.217.194.0-255,3961,37090,13,283183
9846,0.000503,172.31.36.0-255,66,37156,13,283183
9847,0.000511,172.217.194.0-255,8574,45730,13,283183
9848,0.000514,172.31.36.0-255,66,45796,13,283183
9849,0.000541,172.217.194.0-255,4320,50116,13,283183
9850,0.000545,172.217.194.0-255,2836,52952,13,283183
9851,0.000551,172.31.36.0-255,66,53018,13,283183
9852,0.000558,172.31.36.0-255,66,53084,13,283183
9853,0.000569,172.217.194.0-255,383,53467,13,283183
9854,0.000571,172.31.36.0-255,66,53533,13,283183
9855,0.000668,172.217.194.0-255,1484,55017,13,283183
9856,0.000672,172.31.36.0-255,66,55083,13,283183
9857,0.000678,172.217.194.0-255,2902,57985,13,283183
9858,0.000684,172.217.194.0-255,4320,62305,13,283183
9859,0.0007,172.217.194.0-255,1484,63789,13,283183
9860,0.000705,172.217.194.0-255,4320,68109,13,283183
9861,0.000715,172.31.36.0-255,66,68175,13,283183
9862,0.000743,172.217.194.0-255,2902,71077,13,283183
9863,0.000761,172.217.194.0-255,9633,80710,13,283183
9864,0.000766,172.31.36.0-255,66,80776,13,283183
9865,0.000808,172.217.194.0-255,6797,87573,13,283183
9866,0.000833,172.31.36.0-255,66,87639,13,283183
9867,0.00134,172.217.194.0-255,1484,89123,13,283183
9868,0.001345,172.217.194.0-255,1484,90607,13,283183
9869,0.001349,172.31.36.0-255,66,90673,13,283183
9870,0.001364,172.217.194.0-255,1484,92157,13,283183
9871,0.001371,172.217.194.0-255,5738,97895,13,283183
9872,0.001387,172.31.36.0-255,66,97961,13,283183
9873,0.001418,172.217.194.0-255,1484,99445,13,283183
9874,0.001428,172.31.36.0-255,66,99511,13,283183
9875,0.001463,172.217.194.0-255,9274,108785,13,283183
9876,0.001486,172.217.194.0-255,1484,110269,13,283183
9877,0.001493,172.31.36.0-255,66,110335,13,283183
9878,0.001512,172.217.194.0-255,2902,113237,13,283183
9879,0.001528,172.217.194.0-255,5738,118975,13,283183
9880,0.001535,172.217.194.0-255,5738,124713,13,283183
9881,0.001538,172.31.36.0-255,66,124779,13,283183
9882,0.001547,172.217.194.0-255,1484,126263,13,283183
9883,0.001567,172.217.194.0-255,5020,131283,13,283183
9884,0.001571,172.31.36.0-255,66,131349,13,283183
9885,0.001596,172.217.194.0-255,4320,135669,13,283183
9886,0.001607,172.31.36.0-255,66,135735,13,283183
9887,0.001642,172.217.194.0-255,9274,145009,13,283183
9888,0.001687,172.217.194.0-255,1484,146493,13,283183
9889,0.001691,172.217.194.0-255,2902,149395,13,283183
9890,0.001696,172.217.194.0-255,4320,153715,13,283183
9891,0.001709,172.217.194.0-255,1484,155199,13,283183
9892,0.001714,172.217.194.0-255,4320,159519,13,283183
9893,0.00172,172.31.36.0-255,66,159585,13,283183
9894,0.001732,172.217.194.0-255,7156,166741,13,283183
9895,0.001738,172.31.36.0-255,66,166807,13,283183
9896,0.0018,172.31.36.0-255,66,166873,13,283183
9897,0.001916,172.217.194.0-255,1484,168357,13,283183
9898,0.001942,172.217.194.0-255,2902,171259,13,283183
9899,0.001961,172.31.36.0-255,66,171325,13,283183
9900,0.001968,172.217.194.0-255,5738,177063,13,283183
9901,0.00199,172.217.194.0-255,7156,184219,13,283183
9902,0.001998,172.31.36.0-255,66,184285,13,283183
9903,0.002008,172.217.194.0-255,2902,187187,13,283183
9904,0.002034,172.217.194.0-255,4320,191507,13,283183
9905,0.002046,172.31.36.0-255,66,191573,13,283183
9906,0.00205,172.217.194.0-255,2184,193757,13,283183
9907,0.002057,172.217.194.0-255,7156,200913,13,283183
9908,0.002059,172.217.194.0-255,1484,202397,13,283183
9909,0.002065,172.31.36.0-255,66,202463,13,283183
9910,0.002091,172.217.194.0-255,5020,207483,13,283183
9911,0.002111,172.31.36.0-255,66,207549,13,283183
9912,0.002184,172.217.194.0-255,1484,209033,13,283183
9913,0.002191,172.217.194.0-255,2902,211935,13,283183
9914,0.002193,172.217.194.0-255,1484,213419,13,283183
9915,0.002214,172.217.194.0-255,4320,217739,13,283183
9916,0.002218,172.217.194.0-255,1484,219223,13,283183
9917,0.002234,172.31.36.0-255,66,219289,13,283183
9918,0.002247,172.217.194.0-255,1484,220773,13,283183
9919,0.002253,172.31.36.0-255,66,220839,13,283183
9920,0.002267,172.217.194.0-255,9274,230113,13,283183
9921,0.002291,172.31.36.0-255,66,230179,13,283183
9922,0.002317,172.217.194.0-255,1484,231663,13,283183
9923,0.002339,172.217.194.0-255,2902,234565,13,283183
9924,0.002341,172.217.194.0-255,1484,236049,13,283183
9925,0.002361,172.217.194.0-255,4320,240369,13,283183
9926,0.002364,172.217.194.0-255,1484,241853,13,283183
9927,0.002376,172.31.36.0-255,66,241919,13,283183
9928,0.002382,172.217.194.0-255,4320,246239,13,283183
9929,0.002387,172.31.36.0-255,66,246305,13,283183
9930,0.0024,172.217.194.0-255,7156,253461,13,283183
9931,0.002405,172.217.194.0-255,4320,257781,13,283183
9932,0.002425,172.31.36.0-255,66,257847,13,283183
9933,0.004766,172.217.194.0-255,5738,263585,13,283183
9934,0.004773,172.31.36.0-255,66,263651,13,283183
9935,0.007114,172.217.194.0-255,5738,269389,13,283183
9936,0.010437,172.31.36.0-255,66,269455,13,283183
9937,0.012798,172.217.194.0-255,4300,273755,13,283183
9938,0.012809,172.31.36.0-255,66,273821,13,283183
9939,0.018179,172.31.36.0-255,105,273926,13,283183
9940,0.020479,172.217.194.0-255,66,273992,13,283183
9941,0.038958,172.31.36.0-255,176,274168,13,283183
9942,0.038992,172.31.36.0-255,1111,275279,13,283183
9943,0.039073,172.31.36.0-255,1514,276793,13,283183
9944,0.039075,172.31.36.0-255,1514,278307,13,283183
9945,0.039077,172.31.36.0-255,1514,279821,13,283183
9946,0.039078,172.31.36.0-255,1514,281335,13,283183
9947,0.039103,172.31.36.0-255,1514,282849,13,283183
9948,0.039107,172.31.36.0-255,70,282919,13,283183
9949,0.040494,104.244.42.0-255,66,282985,13,283183
9950,0.040608,104.244.42.0-255,66,283051,13,283183
9951,0.040679,104.244.42.0-255,66,283117,13,283183
9952,0.040686,104.244.42.0-255,66,283183,13,283183
9953,0.0,74.125.24.0-255,153,153,13,281493
9954,1.9e-05,172.31.36.0-255,66,219,13,281493
9955,4e-05,74.125.24.0-255,1484,1703,13,281493
9956,4.3e-05,172.31.36.0-255,66,1769,13,281493
9957,6.4e-05,74.125.24.0-255,2902,4671,13,281493
9958,6.6e-05,172.31.36.0-255,66,4737,13,281493
9959,7.3e-05,74.125.24.0-255,5738,10475,13,281493
9960,7.6e-05,172.31.36.0-255,66,10541,13,281493
9961,9.1e-05,74.125.24.0-255,1484,12025,13,281493
9962,9.3e-05,172.31.36.0-255,66,12091,13,281493
9963,9.6e-05,74.125.24.0-255,1484,13575,13,281493
9964,9.7e-05,172.31.36.0-255,66,13641,13,281493
9965,0.000128,74.125.24.0-255,10574,24215,13,281493
9966,0.000131,172.31.36.0-255,66,24281,13,281493
9967,0.000134,74.125.24.0-255,1484,25765,13,281493
9968,0.000136,172.31.36.0-255,66,25831,13,281493
9969,0.000155,74.125.24.0-255,4320,30151,13,281493
9970,0.000158,172.31.36.0-255,66,30217,13,281493
9971,0.000178,74.125.24.0-255,1125,31342,13,281493
9972,0.000181,172.31.36.0-255,66,31408,13,281493
9973,0.000764,74.125.24.0-255,1484,32892,13,281493
9974,0.00077,172.31.36.0-255,66,32958,13,281493
9975,0.000779,74.125.24.0-255,2902,35860,13,281493
9976,0.000781,172.31.36.0-255,66,35926,13,281493
9977,0.000801,74.125.24.0-255,4320,40246,13,281493
9978,0.000804,172.31.36.0-255,66,40312,13,281493
9979,0.000817,74.125.24.0-255,1484,41796,13,281493
9980,0.000819,172.31.36.0-255,66,41862,13,281493
9981,0.000824,74.125.24.0-255,4320,46182,13,281493
9982,0.000826,172.31.36.0-255,66,46248,13,281493
9983,0.000829,74.125.24.0-255,1484,47732,13,281493
9984,0.00083,172.31.36.0-255,66,47798,13,281493
9985,0.000874,172.31.36.0-255,66,47864,13,281493
9986,0.00088,74.125.24.0-255,5738,53602,13,281493
9987,0.000882,172.31.36.0-255,66,53668,13,281493
9988,0.000904,74.125.24.0-255,1399,55067,13,281493
9989,0.001155,74.125.24.0-255,381,55448,13,281493
9990,0.00116,172.31.36.0-255,66,55514,13,281493
9991,0.001628,74.125.24.0-255,1484,56998,13,281493
9992,0.001644,74.125.24.0-255,2902,59900,13,281493
9993,0.001646,172.31.36.0-255,66,59966,13,281493
9994,0.001662,74.125.24.0-255,1484,61450,13,281493
9995,0.001665,74.125.24.0-255,1484,62934,13,281493
9996,0.001667,172.31.36.0-255,66,63000,13,281493
9997,0.001683,74.125.24.0-255,1484,64484,13,281493
9998,0.001688,74.125.24.0-255,4320,68804,13,281493
9999,0.00169,172.31.36.0-255,66,68870,13,281493
10000,0.001706,74.125.24.0-255,1484,70354,13,281493
10001,0.001711,74.125.24.0-255,4320,74674,13,281493
10002,0.001724,74.125.24.0-255,5738,80412,13,281493
10003,0.001736,74.125.24.0-255,2902,83314,13,281493
10004,0.001742,74.125.24.0-255,6438,89752,13,281493
10005,0.001837,74.125.24.0-255,1484,91236,13,281493
10006,0.001855,74.125.24.0-255,2902,94138,13,281493
10007,0.001872,74.125.24.0-255,4320,98458,13,281493
10008,0.001887,74.125.24.0-255,1484,99942,13,281493
10009,0.001889,74.125.24.0-255,1484,101426,13,281493
10010,0.001908,74.125.24.0-255,5738,107164,13,281493
10011,0.001923,74.125.24.0-255,5738,112902,13,281493
10012,0.001927,74.125.24.0-255,4320,117222,13,281493
10013,0.001946,74.125.24.0-255,4320,121542,13,281493
10014,0.001968,74.125.24.0-255,2902,124444,13,281493
10015,0.001983,74.125.24.0-255,8574,133018,13,281493
10016,0.002028,74.125.24.0-255,5738,138756,13,281493
10017,0.002049,74.125.24.0-255,6438,145194,13,281493
10018,0.002128,74.125.24.0-255,1484,146678,13,281493
10019,0.002132,74.125.24.0-255,2902,149580,13,281493
10020,0.002154,74.125.24.0-255,2902,152482,13,281493
10021,0.002165,74.125.24.0-255,2902,155384,13,281493
10022,0.002169,74.125.24.0-255,2902,158286,13,281493
10023,0.002179,74.125.24.0-255,1484,159770,13,281493
10024,0.002195,74.125.24.0-255,4320,164090,13,281493
10025,0.00221,74.125.24.0-255,4320,168410,13,281493
10026,0.002246,74.125.24.0-255,8574,176984,13,281493
10027,0.00226,74.125.24.0-255,2184,179168,13,281493
10028,0.002398,74.125.24.0-255,1484,180652,13,281493
10029,0.002402,74.125.24.0-255,2902,183554,13,281493
10030,0.002435,74.125.24.0-255,5738,189292,13,281493
10031,0.002437,74.125.24.0-255,1484,190776,13,281493
10032,0.002442,74.125.24.0-255,4320,195096,13,281493
10033,0.002455,74.125.24.0-255,4320,199416,13,281493
10034,0.002528,74.125.24.0-255,5738,205154,13,281493
10035,0.002552,74.125.24.0-255,9992,215146,13,281493
10036,0.002566,74.125.24.0-255,9992,225138,13,281493
10037,0.002596,74.125.24.0-255,5738,230876,13,281493
10038,0.002678,74.125.24.0-255,5738,236614,13,281493
10039,0.002694,74.125.24.0-255,2184,238798,13,281493
10040,0.002697,74.125.24.0-255,2902,241700,13,281493
10041,0.002752,74.125.24.0-255,4320,246020,13,281493
10042,0.002759,74.125.24.0-255,7156,253176,13,281493
10043,0.002796,74.125.24.0-255,3602,256778,13,281493
10044,0.002802,74.125.24.0-255,5738,262516,13,281493
10045,0.002828,74.125.24.0-255,7856,270372,13,281493
10046,0.002835,74.125.24.0-255,6486,276858,13,281493
10047,0.002838,74.125.24.0-255,105,276963,13,281493
10048,0.005508,172.31.36.0-255,66,277029,13,281493
10049,0.008635,172.31.36.0-255,105,277134,13,281493
10050,0.010843,74.125.24.0-255,66,277200,13,281493
10051,0.030993,172.31.36.0-255,176,277376,13,281493
10052,0.031022,172.31.36.0-255,1110,278486,13,281493
10053,0.031081,172.31.36.0-255,1514,280000,13,281493
10054,0.031083,172.31.36.0-255,1295,281295,13,281493
10055,0.032651,104.244.42.0-255,66,281361,13,281493
10056,0.03269,104.244.42.0-255,66,281427,13,281493
10057,0.032735,104.244.42.0-255,66,281493,13,281493
10058,0.0,172.217.194.0-255,150,150,13,278676
10059,1.5e-05,172.217.194.0-255,1484,1634,13,278676
10060,2.2e-05,172.31.36.0-255,66,1700,13,278676
10061,3.3e-05,172.217.194.0-255,2902,4602,13,278676
10062,3.7e-05,172.31.36.0-255,66,4668,13,278676
10063,4.5e-05,172.217.194.0-255,7156,11824,13,278676
10064,4.9e-05,172.31.36.0-255,66,11890,13,278676
10065,5.4e-05,172.217.194.0-255,4320,16210,13,278676
10066,5.7e-05,172.31.36.0-255,66,16276,13,278676
10067,8.1e-05,172.217.194.0-255,3456,19732,13,278676
10068,8.4e-05,172.31.36.0-255,66,19798,13,278676
10069,9.1e-05,172.217.194.0-255,5738,25536,13,278676
10070,9.4e-05,172.31.36.0-255,66,25602,13,278676
10071,0.00012,172.217.194.0-255,5379,30981,13,278676
10072,0.000123,172.31.36.0-255,66,31047,13,278676
10073,0.00021,172.217.194.0-255,1484,32531,13,278676
10074,0.000216,172.217.194.0-255,2902,35433,13,278676
10075,0.000219,172.31.36.0-255,66,35499,13,278676
10076,0.000243,172.217.194.0-255,5738,41237,13,278676
10077,0.000246,172.31.36.0-255,66,41303,13,278676
10078,0.000281,172.31.36.0-255,66,41369,13,278676
10079,0.000291,172.217.194.0-255,9633,51002,13,278676
10080,0.000293,172.31.36.0-255,66,51068,13,278676
10081,0.000627,172.217.194.0-255,363,51431,13,278676
10082,0.000901,172.217.194.0-255,1484,52915,13,278676
10083,0.000906,172.31.36.0-255,66,52981,13,278676
10084,0.000913,172.217.194.0-255,2902,55883,13,278676
10085,0.000915,172.31.36.0-255,66,55949,13,278676
10086,0.000921,172.217.194.0-255,4320,60269,13,278676
10087,0.000923,172.31.36.0-255,66,60335,13,278676
10088,0.000937,172.217.194.0-255,1484,61819,13,278676
10089,0.000944,172.217.194.0-255,5738,67557,13,278676
10090,0.000947,172.31.36.0-255,66,67623,13,278676
10091,0.00097,172.217.194.0-255,2834,70457,13,278676
10092,0.000973,172.31.36.0-255,66,70523,13,278676
10093,0.000981,172.217.194.0-255,8574,79097,13,278676
10094,0.000983,172.31.36.0-255,66,79163,13,278676
10095,0.001008,172.217.194.0-255,4320,83483,13,278676
10096,0.001012,172.31.36.0-255,66,83549,13,278676
10097,0.001022,172.217.194.0-255,2543,86092,13,278676
10098,0.001024,172.31.36.0-255,66,86158,13,278676
10099,0.001416,172.217.194.0-255,1484,87642,13,278676
10100,0.001434,172.217.194.0-255,2902,90544,13,278676
10101,0.001438,172.31.36.0-255,66,90610,13,278676
10102,0.001444,172.217.194.0-255,2902,93512,13,278676
10103,0.001446,172.31.36.0-255,66,93578,13,278676
10104,0.001463,172.217.194.0-255,1484,95062,13,278676
10105,0.001487,172.217.194.0-255,5738,100800,13,278676
10106,0.00149,172.31.36.0-255,66,100866,13,278676
10107,0.001521,172.217.194.0-255,4320,105186,13,278676
10108,0.001524,172.31.36.0-255,66,105252,13,278676
10109,0.001553,172.31.36.0-255,66,105318,13,278676
10110,0.001559,172.217.194.0-255,3602,108920,13,278676
10111,0.001562,172.31.36.0-255,66,108986,13,278676
10112,0.001735,172.217.194.0-255,1484,110470,13,278676
10113,0.001755,172.217.194.0-255,2902,113372,13,278676
10114,0.001758,172.31.36.0-255,66,113438,13,278676
10115,0.001766,172.217.194.0-255,5738,119176,13,278676
10116,0.001768,172.31.36.0-255,66,119242,13,278676
10117,0.00181,172.31.36.0-255,66,119308,13,278676
10118,0.001821,172.217.194.0-255,10692,130000,13,278676
10119,0.001823,172.31.36.0-255,66,130066,13,278676
10120,0.001955,172.217.194.0-255,1484,131550,13,278676
10121,0.001963,172.217.194.0-255,2902,134452,13,278676
10122,0.001966,172.31.36.0-255,66,134518,13,278676
10123,0.001971,172.217.194.0-255,2902,137420,13,278676
10124,0.001973,172.31.36.0-255,66,137486,13,278676
10125,0.001988,172.217.194.0-255,2902,140388,13,278676
10126,0.001992,172.31.36.0-255,66,140454,13,278676
10127,0.001997,172.217.194.0-255,4320,144774,13,278676
10128,0.001999,172.31.36.0-255,66,144840,13,278676
10129,0.002027,172.217.194.0-255,8574,153414,13,278676
10130,0.002031,172.31.36.0-255,66,153480,13,278676
10131,0.002037,172.217.194.0-255,4320,157800,13,278676
10132,0.002039,172.31.36.0-255,66,157866,13,278676
10133,0.002058,172.217.194.0-255,4320,162186,13,278676
10134,0.002061,172.31.36.0-255,66,162252,13,278676
10135,0.002066,172.217.194.0-255,2184,164436,13,278676
10136,0.002068,172.31.36.0-255,66,164502,13,278676
10137,0.002201,172.217.194.0-255,1484,165986,13,278676
10138,0.002208,172.217.194.0-255,2902,168888,13,278676
10139,0.002213,172.31.36.0-255,66,168954,13,278676
10140,0.002239,172.217.194.0-255,5738,174692,13,278676
10141,0.002242,172.31.36.0-255,66,174758,13,278676
10142,0.002257,172.31.36.0-255,66,174824,13,278676
10143,0.002286,172.217.194.0-255,1484,176308,13,278676
10144,0.002296,172.217.194.0-255,10692,187000,13,278676
10145,0.002299,172.31.36.0-255,66,187066,13,278676
10146,0.00232,172.217.194.0-255,8574,195640,13,278676
10147,0.002322,172.31.36.0-255,66,195706,13,278676
10148,0.002372,172.31.36.0-255,66,195772,13,278676
10149,0.00238,172.217.194.0-255,7856,203628,13,278676
10150,0.002383,172.31.36.0-255,66,203694,13,278676
10151,0.002441,172.217.194.0-255,1484,205178,13,278676
10152,0.002464,172.217.194.0-255,2902,208080,13,278676
10153,0.002467,172.31.36.0-255,66,208146,13,278676
10154,0.002474,172.217.194.0-255,5738,213884,13,278676
10155,0.002477,172.31.36.0-255,66,213950,13,278676
10156,0.002484,172.217.194.0-255,7156,221106,13,278676
10157,0.002487,172.31.36.0-255,66,221172,13,278676
10158,0.002534,172.31.36.0-255,66,221238,13,278676
10159,0.002554,172.217.194.0-255,2184,223422,13,278676
10160,0.002556,172.31.36.0-255,66,223488,13,278676
10161,0.002595,172.217.194.0-255,1484,224972,13,278676
10162,0.002611,172.217.194.0-255,1484,226456,13,278676
10163,0.002614,172.31.36.0-255,66,226522,13,278676
10164,0.002629,172.217.194.0-255,1484,228006,13,278676
10165,0.002634,172.217.194.0-255,2902,230908,13,278676
10166,0.002636,172.31.36.0-255,66,230974,13,278676
10167,0.00264,172.217.194.0-255,1484,232458,13,278676
10168,0.002654,172.217.194.0-255,2902,235360,13,278676
10169,0.002656,172.31.36.0-255,66,235426,13,278676
10170,0.002661,172.217.194.0-255,4320,239746,13,278676
10171,0.002664,172.31.36.0-255,66,239812,13,278676
10172,0.002685,172.217.194.0-255,4320,244132,13,278676
10173,0.002687,172.31.36.0-255,66,244198,13,278676
10174,0.002696,172.217.194.0-255,7156,251354,13,278676
10175,0.002698,172.31.36.0-255,66,251420,13,278676
10176,0.002747,172.217.194.0-255,6438,257858,13,278676
10177,0.002751,172.31.36.0-255,66,257924,13,278676
10178,0.002766,172.31.36.0-255,66,257990,13,278676
10179,0.00281,172.217.194.0-255,2902,260892,13,278676
10180,0.002812,172.31.36.0-255,66,260958,13,278676
10181,0.002841,172.31.36.0-255,66,261024,13,278676
10182,0.002847,172.217.194.0-255,5020,266044,13,278676
10183,0.002849,172.31.36.0-255,66,266110,13,278676
10184,0.002858,172.217.194.0-255,7940,274050,13,278676
10185,0.00286,172.31.36.0-255,66,274116,13,278676
10186,0.002885,172.217.194.0-255,105,274221,13,278676
10187,0.005551,172.31.36.0-255,105,274326,13,278676
10188,0.007866,172.217.194.0-255,66,274392,13,278676
10189,0.031605,172.31.36.0-255,167,274559,13,278676
10190,0.031637,172.31.36.0-255,1109,275668,13,278676
10191,0.031697,172.31.36.0-255,1514,277182,13,278676
10192,0.031699,172.31.36.0-255,1296,278478,13,278676
10193,0.033156,104.244.42.0-255,66,278544,13,278676
10194,0.033198,104.244.42.0-255,66,278610,13,278676
10195,0.033245,104.244.42.0-255,66,278676,13,278676
10196,0.0,74.125.68.0-255,143,143,13,338565
10197,2.2e-05,172.31.36.0-255,66,209,13,338565
10198,3e-05,74.125.68.0-255,1484,1693,13,338565
10199,3.5e-05,172.31.36.0-255,66,1759,13,338565
10200,4.1e-05,74.125.68.0-255,2902,4661,13,338565
10201,4.5e-05,172.31.36.0-255,66,4727,13,338565
10202,4.8e-05,74.125.68.0-255,1484,6211,13,338565
10203,5.1e-05,172.31.36.0-255,66,6277,13,338565
10204,7.8e-05,74.125.68.0-255,5738,12015,13,338565
10205,8.1e-05,172.31.36.0-255,66,12081,13,338565
10206,8.5e-05,74.125.68.0-255,1484,13565,13,338565
10207,8.7e-05,172.31.36.0-255,66,13631,13,338565
10208,0.000118,74.125.68.0-255,6300,19931,13,338565
10209,0.000121,172.31.36.0-255,66,19997,13,338565
10210,0.000125,74.125.68.0-255,2902,22899,13,338565
10211,0.000128,172.31.36.0-255,66,22965,13,338565
10212,0.000134,74.125.68.0-255,4320,27285,13,338565
10213,0.000136,172.31.36.0-255,66,27351,13,338565
10214,0.000144,74.125.68.0-255,8574,35925,13,338565
10215,0.000147,172.31.36.0-255,66,35991,13,338565
10216,0.000153,74.125.68.0-255,5738,41729,13,338565
10217,0.000156,172.31.36.0-255,66,41795,13,338565
10218,0.000175,74.125.68.0-255,1484,43279,13,338565
10219,0.000177,172.31.36.0-255,66,43345,13,338565
10220,0.000201,74.125.68.0-255,2902,46247,13,338565
10221,0.000203,172.31.36.0-255,66,46313,13,338565
10222,0.000222,74.125.68.0-255,2184,48497,13,338565
10223,0.000224,172.31.36.0-255,66,48563,13,338565
10224,0.000248,74.125.68.0-255,5738,54301,13,338565
10225,0.000251,172.31.36.0-255,66,54367,13,338565
10226,0.000256,74.125.68.0-255,4320,58687,13,338565
10227,0.000259,172.31.36.0-255,66,58753,13,338565
10228,0.000263,74.125.68.0-255,2902,61655,13,338565
10229,0.000266,172.31.36.0-255,66,61721,13,338565
10230,0.000289,74.125.68.0-255,2902,64623,13,338565
10231,0.000292,172.31.36.0-255,66,64689,13,338565
10232,0.000295,74.125.68.0-255,1465,66154,13,338565
10233,0.000348,74.125.68.0-255,1484,67638,13,338565
10234,0.000352,74.125.68.0-255,1484,69122,13,338565
10235,0.000367,74.125.68.0-255,1484,70606,13,338565
10236,0.000383,74.125.68.0-255,5738,76344,13,338565
10237,0.00041,74.125.68.0-255,4320,80664,13,338565
10238,0.000435,74.125.68.0-255,7156,87820,13,338565
10239,0.000461,74.125.68.0-255,1484,89304,13,338565
10240,0.00048,74.125.68.0-255,10692,99996,13,338565
10241,0.000496,74.125.68.0-255,1484,101480,13,338565
10242,0.000511,74.125.68.0-255,2902,104382,13,338565
10243,0.000538,74.125.68.0-255,5738,110120,13,338565
10244,0.000556,74.125.68.0-255,5738,115858,13,338565
10245,0.000575,74.125.68.0-255,7156,123014,13,338565
10246,0.00058,74.125.68.0-255,4320,127334,13,338565
10247,0.000619,74.125.68.0-255,4320,131654,13,338565
10248,0.00063,74.125.68.0-255,2184,133838,13,338565
10249,0.000658,74.125.68.0-255,4320,138158,13,338565
10250,0.00068,74.125.68.0-255,2902,141060,13,338565
10251,0.000685,74.125.68.0-255,2902,143962,13,338565
10252,0.000694,172.31.36.0-255,66,144028,13,338565
10253,0.000703,74.125.68.0-255,1484,145512,13,338565
10254,0.000723,74.125.68.0-255,8574,154086,13,338565
10255,0.000742,74.125.68.0-255,1484,155570,13,338565
10256,0.00075,74.125.68.0-255,7156,162726,13,338565
10257,0.000762,172.31.36.0-255,66,162792,13,338565
10258,0.000787,74.125.68.0-255,5020,167812,13,338565
10259,0.000795,172.31.36.0-255,66,167878,13,338565
10260,0.000928,74.125.68.0-255,1484,169362,13,338565
10261,0.000933,74.125.68.0-255,1484,170846,13,338565
10262,0.000948,172.31.36.0-255,66,170912,13,338565
10263,0.000952,74.125.68.0-255,1484,172396,13,338565
10264,0.000958,74.125.68.0-255,5738,178134,13,338565
10265,0.00097,172.31.36.0-255,66,178200,13,338565
10266,0.000987,74.125.68.0-255,4320,182520,13,338565
10267,0.001004,74.125.68.0-255,5738,188258,13,338565
10268,0.001012,74.125.68.0-255,7156,195414,13,338565
10269,0.001017,172.31.36.0-255,66,195480,13,338565
10270,0.001034,74.125.68.0-255,4320,199800,13,338565
10271,0.001039,74.125.68.0-255,2184,201984,13,338565
10272,0.001055,172.31.36.0-255,66,202050,13,338565
10273,0.001124,74.125.68.0-255,1484,203534,13,338565
10274,0.001147,74.125.68.0-255,2902,206436,13,338565
10275,0.001154,74.125.68.0-255,5738,212174,13,338565
10276,0.001173,172.31.36.0-255,66,212240,13,338565
10277,0.00119,74.125.68.0-255,9992,222232,13,338565
10278,0.001208,74.125.68.0-255,2902,225134,13,338565
10279,0.001214,172.31.36.0-255,66,225200,13,338565
10280,0.001262,74.125.68.0-255,10692,235892,13,338565
10281,0.001269,172.31.36.0-255,66,235958,13,338565
10282,0.001281,74.125.68.0-255,2902,238860,13,338565
10283,0.001305,74.125.68.0-255,8574,247434,13,338565
10284,0.001309,74.125.68.0-255,2902,250336,13,338565
10285,0.001312,172.31.36.0-255,66,250402,13,338565
10286,0.001318,172.31.36.0-255,66,250468,13,338565
10287,0.001343,74.125.68.0-255,9992,260460,13,338565
10288,0.001351,74.125.68.0-255,7156,267616,13,338565
10289,0.001365,74.125.68.0-255,2184,269800,13,338565
10290,0.001401,74.125.68.0-255,1484,271284,13,338565
10291,0.001422,74.125.68.0-255,8574,279858,13,338565
10292,0.001427,74.125.68.0-255,4320,284178,13,338565
10293,0.001432,74.125.68.0-255,4320,288498,13,338565
10294,0.00145,172.31.36.0-255,66,288564,13,338565
10295,0.001476,74.125.68.0-255,3602,292166,13,338565
10296,0.001497,172.31.36.0-255,66,292232,13,338565
10297,0.001508,74.125.68.0-255,5738,297970,13,338565
10298,0.001514,172.31.36.0-255,66,298036,13,338565
10299,0.001528,74.125.68.0-255,8574,306610,13,338565
10300,0.001545,74.125.68.0-255,4320,310930,13,338565
10301,0.001558,172.31.36.0-255,66,310996,13,338565
10302,0.001592,74.125.68.0-255,3602,314598,13,338565
10303,0.001604,74.125.68.0-255,2902,317500,13,338565
10304,0.001637,172.31.36.0-255,66,317566,13,338565
10305,0.001695,74.125.68.0-255,2902,320468,13,338565
10306,0.0017,74.125.68.0-255,3602,324070,13,338565
10307,0.001703,172.31.36.0-255,66,324136,13,338565
10308,0.001713,172.31.36.0-255,66,324202,13,338565
10309,0.001718,74.125.68.0-255,4320,328522,13,338565
10310,0.001734,74.125.68.0-255,5349,333871,13,338565
10311,0.001755,172.31.36.0-255,66,333937,13,338565
10312,0.001759,74.125.68.0-255,105,334042,13,338565
10313,0.009996,172.31.36.0-255,66,334108,13,338565
10314,0.010043,172.31.36.0-255,105,334213,13,338565
10315,0.012535,74.125.68.0-255,66,334279,13,338565
10316,0.030756,172.31.36.0-255,167,334446,13,338565
10317,0.030794,172.31.36.0-255,1106,335552,13,338565
10318,0.030853,172.31.36.0-255,1514,337066,13,338565
10319,0.030855,172.31.36.0-255,1301,338367,13,338565
10320,0.032256,104.244.42.0-255,66,338433,13,338565
10321,0.032356,104.244.42.0-255,66,338499,13,338565
10322,0.032398,104.244.42.0-255,66,338565,13,338565
10323,0.0,74.125.24.0-255,146,146,13,281351
10324,2.3e-05,172.31.36.0-255,66,212,13,281351
10325,3.2e-05,74.125.24.0-255,1484,1696,13,281351
10326,3.7e-05,172.31.36.0-255,66,1762,13,281351
10327,4.3e-05,74.125.24.0-255,2902,4664,13,281351
10328,5.4e-05,172.31.36.0-255,66,4730,13,281351
10329,6.2e-05,74.125.24.0-255,7156,11886,13,281351
10330,6.6e-05,172.31.36.0-255,66,11952,13,281351
10331,7e-05,74.125.24.0-255,2012,13964,13,281351
10332,7.4e-05,172.31.36.0-255,66,14030,13,281351
10333,0.000106,74.125.24.0-255,2902,16932,13,281351
10334,0.00011,172.31.36.0-255,66,16998,13,281351
10335,0.000118,74.125.24.0-255,7156,24154,13,281351
10336,0.000121,172.31.36.0-255,66,24220,13,281351
10337,0.000131,74.125.24.0-255,4320,28540,13,281351
10338,0.000134,172.31.36.0-255,66,28606,13,281351
10339,0.000179,74.125.24.0-255,2543,31149,13,281351
10340,0.000182,172.31.36.0-255,66,31215,13,281351
10341,0.000264,74.125.24.0-255,1484,32699,13,281351
10342,0.000267,172.31.36.0-255,66,32765,13,281351
10343,0.000272,74.125.24.0-255,2902,35667,13,281351
10344,0.000274,172.31.36.0-255,66,35733,13,281351
10345,0.000277,74.125.24.0-255,1484,37217,13,281351
10346,0.000285,172.31.36.0-255,66,37283,13,281351
10347,0.000316,74.125.24.0-255,4320,41603,13,281351
10348,0.000319,172.31.36.0-255,66,41669,13,281351
10349,0.000359,172.31.36.0-255,66,41735,13,281351
10350,0.000368,74.125.24.0-255,9633,51368,13,281351
10351,0.000375,172.31.36.0-255,66,51434,13,281351
10352,0.000378,74.125.24.0-255,445,51879,13,281351
10353,0.00038,172.31.36.0-255,66,51945,13,281351
10354,0.00041,74.125.24.0-255,329,52274,13,281351
10355,0.000412,172.31.36.0-255,66,52340,13,281351
10356,0.000674,74.125.24.0-255,1484,53824,13,281351
10357,0.00068,172.31.36.0-255,66,53890,13,281351
10358,0.000686,74.125.24.0-255,2902,56792,13,281351
10359,0.000689,172.31.36.0-255,66,56858,13,281351
10360,0.000701,74.125.24.0-255,5738,62596,13,281351
10361,0.000703,172.31.36.0-255,66,62662,13,281351
10362,0.000744,172.31.36.0-255,66,62728,13,281351
10363,0.000754,74.125.24.0-255,8574,71302,13,281351
10364,0.000756,172.31.36.0-255,66,71368,13,281351
10365,0.000772,74.125.24.0-255,2184,73552,13,281351
10366,0.000774,172.31.36.0-255,66,73618,13,281351
10367,0.000992,74.125.24.0-255,1484,75102,13,281351
10368,0.000997,172.31.36.0-255,66,75168,13,281351
10369,0.001003,74.125.24.0-255,2902,78070,13,281351
10370,0.001005,172.31.36.0-255,66,78136,13,281351
10371,0.001035,74.125.24.0-255,5738,83874,13,281351
10372,0.001037,172.31.36.0-255,66,83940,13,281351
10373,0.001045,74.125.24.0-255,5738,89678,13,281351
10374,0.001071,74.125.24.0-255,7156,96834,13,281351
10375,0.001078,74.125.24.0-255,7156,103990,13,281351
10376,0.001091,172.31.36.0-255,66,104056,13,281351
10377,0.001117,74.125.24.0-255,3602,107658,13,281351
10378,0.001127,172.31.36.0-255,66,107724,13,281351
10379,0.001706,74.125.24.0-255,1484,109208,13,281351
10380,0.00171,172.31.36.0-255,66,109274,13,281351
10381,0.001717,74.125.24.0-255,2902,112176,13,281351
10382,0.001719,172.31.36.0-255,66,112242,13,281351
10383,0.001751,74.125.24.0-255,5738,117980,13,281351
10384,0.001759,74.125.24.0-255,8574,126554,13,281351
10385,0.001763,172.31.36.0-255,66,126620,13,281351
10386,0.001791,172.31.36.0-255,66,126686,13,281351
10387,0.001845,172.31.36.0-255,66,126752,13,281351
10388,0.001869,74.125.24.0-255,2902,129654,13,281351
10389,0.001874,172.31.36.0-255,66,129720,13,281351
10390,0.001914,172.31.36.0-255,66,129786,13,281351
10391,0.001935,172.31.36.0-255,66,129852,13,281351
10392,0.001957,74.125.24.0-255,5738,135590,13,281351
10393,0.001964,74.125.24.0-255,766,136356,13,281351
10394,0.001967,74.125.24.0-255,1484,137840,13,281351
10395,0.001971,74.125.24.0-255,2902,140742,13,281351
10396,0.002014,74.125.24.0-255,4320,145062,13,281351
10397,0.002032,74.125.24.0-255,1484,146546,13,281351
10398,0.002038,74.125.24.0-255,5738,152284,13,281351
10399,0.002054,74.125.24.0-255,5020,157304,13,281351
10400,0.002058,172.31.36.0-255,66,157370,13,281351
10401,0.002069,172.31.36.0-255,66,157436,13,281351
10402,0.002159,74.125.24.0-255,1484,158920,13,281351
10403,0.002176,74.125.24.0-255,2902,161822,13,281351
10404,0.002183,74.125.24.0-255,5738,167560,13,281351
10405,0.002206,74.125.24.0-255,7156,174716,13,281351
10406,0.002222,74.125.24.0-255,2902,177618,13,281351
10407,0.002227,172.31.36.0-255,66,177684,13,281351
10408,0.00225,74.125.24.0-255,1484,179168,13,281351
10409,0.002267,74.125.24.0-255,8574,187742,13,281351
10410,0.002293,74.125.24.0-255,3602,191344,13,281351
10411,0.002295,74.125.24.0-255,1484,192828,13,281351
10412,0.002355,74.125.24.0-255,3602,196430,13,281351
10413,0.002364,74.125.24.0-255,9992,206422,13,281351
10414,0.002389,74.125.24.0-255,5738,212160,13,281351
10415,0.002392,74.125.24.0-255,1484,213644,13,281351
10416,0.002399,74.125.24.0-255,7156,220800,13,281351
10417,0.002424,74.125.24.0-255,7856,228656,13,281351
10418,0.002686,74.125.24.0-255,1484,230140,13,281351
10419,0.0027,74.125.24.0-255,2902,233042,13,281351
10420,0.00271,74.125.24.0-255,1484,234526,13,281351
10421,0.002727,74.125.24.0-255,4320,238846,13,281351
10422,0.002729,74.125.24.0-255,1484,240330,13,281351
10423,0.002748,74.125.24.0-255,8574,248904,13,281351
10424,0.002774,74.125.24.0-255,2902,251806,13,281351
10425,0.002784,74.125.24.0-255,10692,262498,13,281351
10426,0.002808,74.125.24.0-255,4320,266818,13,281351
10427,0.002828,74.125.24.0-255,7028,273846,13,281351
10428,0.002843,74.125.24.0-255,105,273951,13,281351
10429,0.008507,172.31.36.0-255,66,274017,13,281351
10430,0.010425,172.31.36.0-255,105,274122,13,281351
10431,0.012628,74.125.24.0-255,66,274188,13,281351
10432,0.033914,172.31.36.0-255,172,274360,13,281351
10433,0.033944,172.31.36.0-255,1106,275466,13,281351
10434,0.034008,172.31.36.0-255,1514,276980,13,281351
10435,0.03401,172.31.36.0-255,1514,278494,13,281351
10436,0.034016,172.31.36.0-255,1514,280008,13,281351
10437,0.034017,172.31.36.0-255,1079,281087,13,281351
10438,0.035454,104.244.42.0-255,66,281153,13,281351
10439,0.035513,104.244.42.0-255,66,281219,13,281351
10440,0.035565,104.244.42.0-255,66,281285,13,281351
10441,0.035568,104.244.42.0-255,66,281351,13,281351
10442,0.0,74.125.68.0-255,150,150,13,394901
10443,1.7e-05,172.31.36.0-255,66,216,13,394901
10444,4.7e-05,74.125.68.0-255,1484,1700,13,394901
10445,5.2e-05,172.31.36.0-255,66,1766,13,394901
10446,5.8e-05,74.125.68.0-255,2902,4668,13,394901
10447,6e-05,172.31.36.0-255,66,4734,13,394901
10448,6.6e-05,74.125.68.0-255,5738,10472,13,394901
10449,7e-05,172.31.36.0-255,66,10538,13,394901
10450,7.4e-05,74.125.68.0-255,2902,13440,13,394901
10451,7.7e-05,172.31.36.0-255,66,13506,13,394901
10452,0.000127,74.125.68.0-255,653,14159,13,394901
10453,0.000132,172.31.36.0-255,66,14225,13,394901
10454,0.000167,74.125.68.0-255,1484,15709,13,394901
10455,0.000171,172.31.36.0-255,66,15775,13,394901
10456,0.000198,74.125.68.0-255,4320,20095,13,394901
10457,0.000203,172.31.36.0-255,66,20161,13,394901
10458,0.00022,74.125.68.0-255,2902,23063,13,394901
10459,0.000223,172.31.36.0-255,66,23129,13,394901
10460,0.000226,74.125.68.0-255,1484,24613,13,394901
10461,0.000229,172.31.36.0-255,66,24679,13,394901
10462,0.000251,74.125.68.0-255,2902,27581,13,394901
10463,0.000254,172.31.36.0-255,66,27647,13,394901
10464,0.000258,74.125.68.0-255,3961,31608,13,394901
10465,0.000261,172.31.36.0-255,66,31674,13,394901
10466,0.00032,74.125.68.0-255,1484,33158,13,394901
10467,0.000323,172.31.36.0-255,66,33224,13,394901
10468,0.000329,74.125.68.0-255,2902,36126,13,394901
10469,0.00033,172.31.36.0-255,66,36192,13,394901
10470,0.000341,74.125.68.0-255,1484,37676,13,394901
10471,0.000343,172.31.36.0-255,66,37742,13,394901
10472,0.000364,74.125.68.0-255,4320,42062,13,394901
10473,0.000366,172.31.36.0-255,66,42128,13,394901
10474,0.000378,74.125.68.0-255,1484,43612,13,394901
10475,0.000396,74.125.68.0-255,5379,48991,13,394901
10476,0.000398,172.31.36.0-255,66,49057,13,394901
10477,0.000401,74.125.68.0-255,1484,50541,13,394901
10478,0.000416,74.125.68.0-255,2902,53443,13,394901
10479,0.000418,172.31.36.0-255,66,53509,13,394901
10480,0.000439,74.125.68.0-255,2902,56411,13,394901
10481,0.000441,172.31.36.0-255,66,56477,13,394901
10482,0.000445,74.125.68.0-255,4320,60797,13,394901
10483,0.000448,172.31.36.0-255,66,60863,13,394901
10484,0.000462,74.125.68.0-255,5379,66242,13,394901
10485,0.000464,172.31.36.0-255,66,66308,13,394901
10486,0.000899,74.125.68.0-255,400,66708,13,394901
10487,0.000912,74.125.68.0-255,342,67050,13,394901
10488,0.000994,172.31.36.0-255,66,67116,13,394901
10489,0.00159,74.125.68.0-255,1484,68600,13,394901
10490,0.001599,74.125.68.0-255,2902,71502,13,394901
10491,0.001603,172.31.36.0-255,66,71568,13,394901
10492,0.001641,74.125.68.0-255,5738,77306,13,394901
10493,0.001643,172.31.36.0-255,66,77372,13,394901
10494,0.001664,74.125.68.0-255,4320,81692,13,394901
10495,0.001666,172.31.36.0-255,66,81758,13,394901
10496,0.00169,74.125.68.0-255,4320,86078,13,394901
10497,0.001691,172.31.36.0-255,66,86144,13,394901
10498,0.0017,74.125.68.0-255,9992,96136,13,394901
10499,0.001702,172.31.36.0-255,66,96202,13,394901
10500,0.001707,74.125.68.0-255,2902,99104,13,394901
10501,0.001708,172.31.36.0-255,66,99170,13,394901
10502,0.001748,74.125.68.0-255,2184,101354,13,394901
10503,0.00175,172.31.36.0-255,66,101420,13,394901
10504,0.002799,74.125.68.0-255,1484,102904,13,394901
10505,0.002814,74.125.68.0-255,1484,104388,13,394901
10506,0.002816,172.31.36.0-255,66,104454,13,394901
10507,0.002836,74.125.68.0-255,1484,105938,13,394901
10508,0.00284,74.125.68.0-255,4320,110258,13,394901
10509,0.002842,172.31.36.0-255,66,110324,13,394901
10510,0.002859,74.125.68.0-255,4320,114644,13,394901
10511,0.00286,172.31.36.0-255,66,114710,13,394901
10512,0.002871,74.125.68.0-255,1484,116194,13,394901
10513,0.002877,74.125.68.0-255,4320,120514,13,394901
10514,0.002879,172.31.36.0-255,66,120580,13,394901
10515,0.002901,74.125.68.0-255,2902,123482,13,394901
10516,0.002903,172.31.36.0-255,66,123548,13,394901
10517,0.002905,74.125.68.0-255,1484,125032,13,394901
10518,0.00292,74.125.68.0-255,1484,126516,13,394901
10519,0.002922,172.31.36.0-255,66,126582,13,394901
10520,0.002944,74.125.68.0-255,5738,132320,13,394901
10521,0.002946,172.31.36.0-255,66,132386,13,394901
10522,0.00298,74.125.68.0-255,3602,135988,13,394901
10523,0.002981,172.31.36.0-255,66,136054,13,394901
10524,0.003352,74.125.68.0-255,1484,137538,13,394901
10525,0.003368,74.125.68.0-255,2902,140440,13,394901
10526,0.00337,172.31.36.0-255,66,140506,13,394901
10527,0.003373,74.125.68.0-255,1484,141990,13,394901
10528,0.003389,74.125.68.0-255,2902,144892,13,394901
10529,0.003392,172.31.36.0-255,66,144958,13,394901
10530,0.003409,74.125.68.0-255,4320,149278,13,394901
10531,0.003411,172.31.36.0-255,66,149344,13,394901
10532,0.003436,74.125.68.0-255,1484,150828,13,394901
10533,0.003448,74.125.68.0-255,1484,152312,13,394901
10534,0.00345,172.31.36.0-255,66,152378,13,394901
10535,0.003475,74.125.68.0-255,7156,159534,13,394901
10536,0.003477,172.31.36.0-255,66,159600,13,394901
10537,0.003486,74.125.68.0-255,9992,169592,13,394901
10538,0.003488,172.31.36.0-255,66,169658,13,394901
10539,0.00349,74.125.68.0-255,766,170424,13,394901
10540,0.003493,74.125.68.0-255,1484,171908,13,394901
10541,0.003495,172.31.36.0-255,66,171974,13,394901
10542,0.0035,74.125.68.0-255,4320,176294,13,394901
10543,0.003502,172.31.36.0-255,66,176360,13,394901
10544,0.003515,74.125.68.0-255,2902,179262,13,394901
10545,0.003517,172.31.36.0-255,66,179328,13,394901
10546,0.003541,74.125.68.0-255,4320,183648,13,394901
10547,0.003544,172.31.36.0-255,66,183714,13,394901
10548,0.003549,74.125.68.0-255,4320,188034,13,394901
10549,0.00355,172.31.36.0-255,66,188100,13,394901
10550,0.003556,74.125.68.0-255,5738,193838,13,394901
10551,0.003558,172.31.36.0-255,66,193904,13,394901
10552,0.003618,74.125.68.0-255,5738,199642,13,394901
10553,0.00362,172.31.36.0-255,66,199708,13,394901
10554,0.003639,74.125.68.0-255,5020,204728,13,394901
10555,0.003641,172.31.36.0-255,66,204794,13,394901
10556,0.00376,74.125.68.0-255,1484,206278,13,394901
10557,0.003773,74.125.68.0-255,1484,207762,13,394901
10558,0.003774,172.31.36.0-255,66,207828,13,394901
10559,0.003794,74.125.68.0-255,1484,209312,13,394901
10560,0.003799,74.125.68.0-255,4320,213632,13,394901
10561,0.003801,172.31.36.0-255,66,213698,13,394901
10562,0.003816,74.125.68.0-255,2902,216600,13,394901
10563,0.003818,172.31.36.0-255,66,216666,13,394901
10564,0.003843,74.125.68.0-255,5738,222404,13,394901
10565,0.003845,172.31.36.0-255,66,222470,13,394901
10566,0.003848,74.125.68.0-255,1484,223954,13,394901
10567,0.00387,74.125.68.0-255,5738,229692,13,394901
10568,0.003872,172.31.36.0-255,66,229758,13,394901
10569,0.003894,74.125.68.0-255,1484,231242,13,394901
10570,0.003908,74.125.68.0-255,2902,234144,13,394901
10571,0.003911,172.31.36.0-255,66,234210,13,394901
10572,0.003932,74.125.68.0-255,4320,238530,13,394901
10573,0.003934,172.31.36.0-255,66,238596,13,394901
10574,0.003937,74.125.68.0-255,766,239362,13,394901
10575,0.003991,74.125.68.0-255,1484,240846,13,394901
10576,0.003993,172.31.36.0-255,66,240912,13,394901
10577,0.004011,74.125.68.0-255,2902,243814,13,394901
10578,0.004013,172.31.36.0-255,66,243880,13,394901
10579,0.00404,74.125.68.0-255,5738,249618,13,394901
10580,0.004042,172.31.36.0-255,66,249684,13,394901
10581,0.004062,74.125.68.0-255,5738,255422,13,394901
10582,0.004066,74.125.68.0-255,1484,256906,13,394901
10583,0.004071,74.125.68.0-255,4320,261226,13,394901
10584,0.004093,74.125.68.0-255,4320,265546,13,394901
10585,0.004096,74.125.68.0-255,1484,267030,13,394901
10586,0.004116,74.125.68.0-255,2902,269932,13,394901
10587,0.004145,74.125.68.0-255,3602,273534,13,394901
10588,0.004167,74.125.68.0-255,4320,277854,13,394901
10589,0.004193,74.125.68.0-255,4320,282174,13,394901
10590,0.004215,74.125.68.0-255,4320,286494,13,394901
10591,0.00422,74.125.68.0-255,2902,289396,13,394901
10592,0.004243,74.125.68.0-255,2902,292298,13,394901
10593,0.004263,74.125.68.0-255,5738,298036,13,394901
10594,0.004268,74.125.68.0-255,2902,300938,13,394901
10595,0.004296,74.125.68.0-255,2902,303840,13,394901
10596,0.00431,74.125.68.0-255,3602,307442,13,394901
10597,0.004313,74.125.68.0-255,1484,308926,13,394901
10598,0.00434,74.125.68.0-255,2902,311828,13,394901
10599,0.004364,74.125.68.0-255,7156,318984,13,394901
10600,0.004369,74.125.68.0-255,2902,321886,13,394901
10601,0.004382,74.125.68.0-255,1484,323370,13,394901
10602,0.004387,74.125.68.0-255,2902,326272,13,394901
10603,0.0044,74.125.68.0-255,1484,327756,13,394901
10604,0.004409,74.125.68.0-255,5738,333494,13,394901
10605,0.004431,74.125.68.0-255,7856,341350,13,394901
10606,0.004446,74.125.68.0-255,5738,347088,13,394901
10607,0.004469,74.125.68.0-255,7156,354244,13,394901
10608,0.004493,74.125.68.0-255,4320,358564,13,394901
10609,0.00451,74.125.68.0-255,7156,365720,13,394901
10610,0.004535,74.125.68.0-255,4320,370040,13,394901
10611,0.004564,74.125.68.0-255,7856,377896,13,394901
10612,0.004569,74.125.68.0-255,4320,382216,13,394901
10613,0.004612,74.125.68.0-255,2255,384471,13,394901
10614,0.004629,74.125.68.0-255,105,384576,13,394901
10615,0.004664,74.125.68.0-255,129,384705,13,394901
10616,0.008719,172.31.36.0-255,66,384771,13,394901
10617,0.011096,172.31.36.0-255,105,384876,13,394901
10618,0.011128,172.31.36.0-255,105,384981,13,394901
10619,0.011348,172.31.36.0-255,90,385071,13,394901
10620,0.011357,172.31.36.0-255,66,385137,13,394901
10621,0.013542,74.125.68.0-255,66,385203,13,394901
10622,0.01355,74.125.68.0-255,66,385269,13,394901
10623,0.013764,74.125.68.0-255,66,385335,13,394901
10624,0.013802,74.125.68.0-255,66,385401,13,394901
10625,0.013808,172.31.36.0-255,66,385467,13,394901
10626,0.04229,172.31.36.0-255,172,385639,13,394901
10627,0.04232,172.31.36.0-255,1110,386749,13,394901
10628,0.042363,172.31.36.0-255,1514,388263,13,394901
10629,0.042365,172.31.36.0-255,1514,389777,13,394901
10630,0.042366,172.31.36.0-255,1514,391291,13,394901
10631,0.042372,172.31.36.0-255,1514,392805,13,394901
10632,0.042373,172.31.36.0-255,1514,394319,13,394901
10633,0.042374,172.31.36.0-255,144,394463,13,394901
10634,0.043955,104.244.42.0-255,66,394529,13,394901
10635,0.04401,104.244.42.0-255,66,394595,13,394901
10636,0.044066,104.244.42.0-255,66,394661,13,394901
10637,0.04407,104.244.42.0-255,66,394727,13,394901
10638,0.045473,104.244.42.0-255,108,394835,13,394901
10639,0.045492,172.31.36.0-255,66,394901,13,394901
10640,0.0,74.125.24.0-255,153,153,13,333607
10641,2.4e-05,172.31.36.0-255,66,219,13,333607
10642,3.2e-05,74.125.24.0-255,1484,1703,13,333607
10643,3.6e-05,172.31.36.0-255,66,1769,13,333607
10644,4.2e-05,74.125.24.0-255,2902,4671,13,333607
10645,5.5e-05,172.31.36.0-255,66,4737,13,333607
10646,6.3e-05,74.125.24.0-255,7156,11893,13,333607
10647,6.6e-05,172.31.36.0-255,66,11959,13,333607
10648,7e-05,74.125.24.0-255,2035,13994,13,333607
10649,7.2e-05,172.31.36.0-255,66,14060,13,333607
10650,0.000124,74.125.24.0-255,1484,15544,13,333607
10651,0.000127,172.31.36.0-255,66,15610,13,333607
10652,0.000132,74.125.24.0-255,2902,18512,13,333607
10653,0.000135,172.31.36.0-255,66,18578,13,333607
10654,0.000138,74.125.24.0-255,1484,20062,13,333607
10655,0.00014,172.31.36.0-255,66,20128,13,333607
10656,0.000158,74.125.24.0-255,4320,24448,13,333607
10657,0.000161,172.31.36.0-255,66,24514,13,333607
10658,0.000174,74.125.24.0-255,6797,31311,13,333607
10659,0.000176,172.31.36.0-255,66,31377,13,333607
10660,0.00033,74.125.24.0-255,1484,32861,13,333607
10661,0.000335,172.31.36.0-255,66,32927,13,333607
10662,0.00034,74.125.24.0-255,2902,35829,13,333607
10663,0.000343,172.31.36.0-255,66,35895,13,333607
10664,0.000355,74.125.24.0-255,5738,41633,13,333607
10665,0.000358,172.31.36.0-255,66,41699,13,333607
10666,0.000361,74.125.24.0-255,1484,43183,13,333607
10667,0.000363,172.31.36.0-255,66,43249,13,333607
10668,0.000393,74.125.24.0-255,2902,46151,13,333607
10669,0.000396,172.31.36.0-255,66,46217,13,333607
10670,0.000423,74.125.24.0-255,2543,48760,13,333607
10671,0.000427,172.31.36.0-255,66,48826,13,333607
10672,0.000883,74.125.24.0-255,1484,50310,13,333607
10673,0.000904,74.125.24.0-255,2902,53212,13,333607
10674,0.000909,172.31.36.0-255,66,53278,13,333607
10675,0.000916,74.125.24.0-255,5738,59016,13,333607
10676,0.000918,172.31.36.0-255,66,59082,13,333607
10677,0.000927,74.125.24.0-255,2902,61984,13,333607
10678,0.000929,172.31.36.0-255,66,62050,13,333607
10679,0.000975,74.125.24.0-255,4540,66590,13,333607
10680,0.000978,172.31.36.0-255,66,66656,13,333607
10681,0.001316,74.125.24.0-255,1484,68140,13,333607
10682,0.001326,74.125.24.0-255,2902,71042,13,333607
10683,0.00133,172.31.36.0-255,66,71108,13,333607
10684,0.001368,74.125.24.0-255,5738,76846,13,333607
10685,0.001371,172.31.36.0-255,66,76912,13,333607
10686,0.00139,172.31.36.0-255,66,76978,13,333607
10687,0.001396,74.125.24.0-255,4320,81298,13,333607
10688,0.001398,172.31.36.0-255,66,81364,13,333607
10689,0.001443,74.125.24.0-255,6438,87802,13,333607
10690,0.001446,172.31.36.0-255,66,87868,13,333607
10691,0.001491,74.125.24.0-255,1484,89352,13,333607
10692,0.001495,74.125.24.0-255,1484,90836,13,333607
10693,0.001498,172.31.36.0-255,66,90902,13,333607
10694,0.001523,74.125.24.0-255,1484,92386,13,333607
10695,0.00153,74.125.24.0-255,5738,98124,13,333607
10696,0.001532,172.31.36.0-255,66,98190,13,333607
10697,0.001539,74.125.24.0-255,4320,102510,13,333607
10698,0.001541,172.31.36.0-255,66,102576,13,333607
10699,0.001581,172.31.36.0-255,66,102642,13,333607
10700,0.001619,74.125.24.0-255,5738,108380,13,333607
10701,0.001623,172.31.36.0-255,66,108446,13,333607
10702,0.001656,74.125.24.0-255,2184,110630,13,333607
10703,0.001659,172.31.36.0-255,66,110696,13,333607
10704,0.001668,74.125.24.0-255,8574,119270,13,333607
10705,0.00167,172.31.36.0-255,66,119336,13,333607
10706,0.00168,74.125.24.0-255,4320,123656,13,333607
10707,0.001682,172.31.36.0-255,66,123722,13,333607
10708,0.001698,172.31.36.0-255,66,123788,13,333607
10709,0.001703,74.125.24.0-255,4320,128108,13,333607
10710,0.001705,172.31.36.0-255,66,128174,13,333607
10711,0.001749,74.125.24.0-255,2184,130358,13,333607
10712,0.001752,172.31.36.0-255,66,130424,13,333607
10713,0.002444,74.125.24.0-255,1484,131908,13,333607
10714,0.002452,74.125.24.0-255,2902,134810,13,333607
10715,0.002458,172.31.36.0-255,66,134876,13,333607
10716,0.002462,74.125.24.0-255,1484,136360,13,333607
10717,0.002483,74.125.24.0-255,4320,140680,13,333607
10718,0.002486,172.31.36.0-255,66,140746,13,333607
10719,0.0025,172.31.36.0-255,66,140812,13,333607
10720,0.002524,74.125.24.0-255,10692,151504,13,333607
10721,0.002527,172.31.36.0-255,66,151570,13,333607
10722,0.005101,74.125.24.0-255,5738,157308,13,333607
10723,0.005108,172.31.36.0-255,66,157374,13,333607
10724,0.007661,74.125.24.0-255,5738,163112,13,333607
10725,0.007665,172.31.36.0-255,66,163178,13,333607
10726,0.010228,74.125.24.0-255,5738,168916,13,333607
10727,0.010236,172.31.36.0-255,66,168982,13,333607
10728,0.012809,74.125.24.0-255,5738,174720,13,333607
10729,0.012818,172.31.36.0-255,66,174786,13,333607
10730,0.01541,74.125.24.0-255,5738,180524,13,333607
10731,0.015422,172.31.36.0-255,66,180590,13,333607
10732,0.017986,74.125.24.0-255,5738,186328,13,333607
10733,0.017995,172.31.36.0-255,66,186394,13,333607
10734,0.020592,74.125.24.0-255,5738,192132,13,333607
10735,0.020601,172.31.36.0-255,66,192198,13,333607
10736,0.023151,74.125.24.0-255,5738,197936,13,333607
10737,0.023158,172.31.36.0-255,66,198002,13,333607
10738,0.025734,74.125.24.0-255,5738,203740,13,333607
10739,0.025742,172.31.36.0-255,66,203806,13,333607
10740,0.02837,74.125.24.0-255,5738,209544,13,333607
10741,0.028389,172.31.36.0-255,66,209610,13,333607
10742,0.03094,74.125.24.0-255,5738,215348,13,333607
10743,0.030956,172.31.36.0-255,66,215414,13,333607
10744,0.033523,74.125.24.0-255,5738,221152,13,333607
10745,0.033539,172.31.36.0-255,66,221218,13,333607
10746,0.035753,172.31.36.0-255,172,221390,13,333607
10747,0.035786,172.31.36.0-255,1110,222500,13,333607
10748,0.035848,172.31.36.0-255,1514,224014,13,333607
10749,0.03585,172.31.36.0-255,1295,225309,13,333607
10750,0.036072,74.125.24.0-255,5738,231047,13,333607
10751,0.036079,172.31.36.0-255,66,231113,13,333607
10752,0.037317,104.244.42.0-255,66,231179,13,333607
10753,0.037504,104.244.42.0-255,66,231245,13,333607
10754,0.03751,104.244.42.0-255,66,231311,13,333607
10755,0.038624,74.125.24.0-255,5738,237049,13,333607
10756,0.038634,172.31.36.0-255,66,237115,13,333607
10757,0.041209,74.125.24.0-255,5738,242853,13,333607
10758,0.041217,172.31.36.0-255,66,242919,13,333607
10759,0.043806,74.125.24.0-255,5738,248657,13,333607
10760,0.043813,172.31.36.0-255,66,248723,13,333607
10761,0.046371,74.125.24.0-255,5738,254461,13,333607
10762,0.046378,172.31.36.0-255,66,254527,13,333607
10763,0.048952,74.125.24.0-255,5738,260265,13,333607
10764,0.048959,172.31.36.0-255,66,260331,13,333607
10765,0.051512,74.125.24.0-255,5738,266069,13,333607
10766,0.051518,172.31.36.0-255,66,266135,13,333607
10767,0.054117,74.125.24.0-255,5738,271873,13,333607
10768,0.054125,172.31.36.0-255,66,271939,13,333607
10769,0.056695,74.125.24.0-255,5738,277677,13,333607
10770,0.056701,172.31.36.0-255,66,277743,13,333607
10771,0.05926,74.125.24.0-255,4320,282063,13,333607
10772,0.05927,172.31.36.0-255,66,282129,13,333607
10773,0.059301,74.125.24.0-255,1484,283613,13,333607
10774,0.061849,74.125.24.0-255,4320,287933,13,333607
10775,0.061862,172.31.36.0-255,66,287999,13,333607
10776,0.064465,74.125.24.0-255,5738,293737,13,333607
10777,0.064476,172.31.36.0-255,66,293803,13,333607
10778,0.067072,74.125.24.0-255,5738,299541,13,333607
10779,0.06708,172.31.36.0-255,66,299607,13,333607
10780,0.069665,74.125.24.0-255,5738,305345,13,333607
10781,0.069673,172.31.36.0-255,66,305411,13,333607
10782,0.072256,74.125.24.0-255,5738,311149,13,333607
10783,0.072264,172.31.36.0-255,66,311215,13,333607
10784,0.074804,74.125.24.0-255,5738,316953,13,333607
10785,0.074814,172.31.36.0-255,66,317019,13,333607
10786,0.077377,74.125.24.0-255,5738,322757,13,333607
10787,0.077385,172.31.36.0-255,66,322823,13,333607
10788,0.079938,74.125.24.0-255,5738,328561,13,333607
10789,0.079949,172.31.36.0-255,66,328627,13,333607
10790,0.082539,74.125.24.0-255,4743,333370,13,333607
10791,0.082556,172.31.36.0-255,66,333436,13,333607
10792,0.08286,172.31.36.0-255,105,333541,13,333607
10793,0.085374,74.125.24.0-255,66,333607,13,333607
10794,0.0,74.125.24.0-255,153,153,13,351555
10795,2.6e-05,74.125.24.0-255,1484,1637,13,351555
10796,3.3e-05,172.31.36.0-255,66,1703,13,351555
10797,4.1e-05,74.125.24.0-255,2902,4605,13,351555
10798,4.3e-05,172.31.36.0-255,66,4671,13,351555
10799,8e-05,74.125.24.0-255,5738,10409,13,351555
10800,8.3e-05,172.31.36.0-255,66,10475,13,351555
10801,0.000116,74.125.24.0-255,7663,18138,13,351555
10802,0.000119,172.31.36.0-255,66,18204,13,351555
10803,0.000127,74.125.24.0-255,8574,26778,13,351555
10804,0.00013,172.31.36.0-255,66,26844,13,351555
10805,0.00015,74.125.24.0-255,3961,30805,13,351555
10806,0.000153,172.31.36.0-255,66,30871,13,351555
10807,0.000163,74.125.24.0-255,4320,35191,13,351555
10808,0.000166,172.31.36.0-255,66,35257,13,351555
10809,0.000171,74.125.24.0-255,1484,36741,13,351555
10810,0.000208,74.125.24.0-255,8574,45315,13,351555
10811,0.000211,172.31.36.0-255,66,45381,13,351555
10812,0.000241,74.125.24.0-255,2543,47924,13,351555
10813,0.000244,172.31.36.0-255,66,47990,13,351555
10814,0.000477,74.125.24.0-255,1484,49474,13,351555
10815,0.000494,74.125.24.0-255,1484,50958,13,351555
10816,0.000497,172.31.36.0-255,66,51024,13,351555
10817,0.000525,74.125.24.0-255,1484,52508,13,351555
10818,0.000532,74.125.24.0-255,5738,58246,13,351555
10819,0.000535,172.31.36.0-255,66,58312,13,351555
10820,0.000542,74.125.24.0-255,4320,62632,13,351555
10821,0.000544,172.31.36.0-255,66,62698,13,351555
10822,0.000575,74.125.24.0-255,2543,65241,13,351555
10823,0.000578,172.31.36.0-255,66,65307,13,351555
10824,0.000653,74.125.24.0-255,1484,66791,13,351555
10825,0.000669,74.125.24.0-255,1484,68275,13,351555
10826,0.000672,172.31.36.0-255,66,68341,13,351555
10827,0.000683,74.125.24.0-255,1484,69825,13,351555
10828,0.000703,74.125.24.0-255,2902,72727,13,351555
10829,0.000706,172.31.36.0-255,66,72793,13,351555
10830,0.000746,74.125.24.0-255,2902,75695,13,351555
10831,0.000752,172.31.36.0-255,66,75761,13,351555
10832,0.000753,74.125.24.0-255,7376,83137,13,351555
10833,0.000757,172.31.36.0-255,66,83203,13,351555
10834,0.000799,74.125.24.0-255,8574,91777,13,351555
10835,0.000803,172.31.36.0-255,66,91843,13,351555
10836,0.000811,74.125.24.0-255,8215,100058,13,351555
10837,0.000813,172.31.36.0-255,66,100124,13,351555
10838,0.00119,74.125.24.0-255,1484,101608,13,351555
10839,0.001198,74.125.24.0-255,1484,103092,13,351555
10840,0.001202,172.31.36.0-255,66,103158,13,351555
10841,0.001221,74.125.24.0-255,1484,104642,13,351555
10842,0.001228,74.125.24.0-255,5738,110380,13,351555
10843,0.001231,172.31.36.0-255,66,110446,13,351555
10844,0.001261,74.125.24.0-255,7156,117602,13,351555
10845,0.001265,172.31.36.0-255,66,117668,13,351555
10846,0.001304,74.125.24.0-255,5738,123406,13,351555
10847,0.001308,172.31.36.0-255,66,123472,13,351555
10848,0.001318,74.125.24.0-255,10692,134164,13,351555
10849,0.001327,172.31.36.0-255,66,134230,13,351555
10850,0.001412,74.125.24.0-255,1484,135714,13,351555
10851,0.001419,74.125.24.0-255,2902,138616,13,351555
10852,0.001422,172.31.36.0-255,66,138682,13,351555
10853,0.001446,74.125.24.0-255,5738,144420,13,351555
10854,0.001449,172.31.36.0-255,66,144486,13,351555
10855,0.001485,74.125.24.0-255,9992,154478,13,351555
10856,0.001489,172.31.36.0-255,66,154544,13,351555
10857,0.001516,74.125.24.0-255,2902,157446,13,351555
10858,0.001519,172.31.36.0-255,66,157512,13,351555
10859,0.001527,74.125.24.0-255,8574,166086,13,351555
10860,0.00153,172.31.36.0-255,66,166152,13,351555
10861,0.001539,74.125.24.0-255,2184,168336,13,351555
10862,0.001541,172.31.36.0-255,66,168402,13,351555
10863,0.001628,74.125.24.0-255,1484,169886,13,351555
10864,0.001634,74.125.24.0-255,2902,172788,13,351555
10865,0.001639,172.31.36.0-255,66,172854,13,351555
10866,0.001646,74.125.24.0-255,5738,178592,13,351555
10867,0.001649,172.31.36.0-255,66,178658,13,351555
10868,0.001669,172.31.36.0-255,66,178724,13,351555
10869,0.001697,74.125.24.0-255,7156,185880,13,351555
10870,0.001699,172.31.36.0-255,66,185946,13,351555
10871,0.001725,74.125.24.0-255,3602,189548,13,351555
10872,0.001727,172.31.36.0-255,66,189614,13,351555
10873,0.001767,74.125.24.0-255,1484,191098,13,351555
10874,0.00177,74.125.24.0-255,1484,192582,13,351555
10875,0.001773,172.31.36.0-255,66,192648,13,351555
10876,0.001786,74.125.24.0-255,1484,194132,13,351555
10877,0.001795,74.125.24.0-255,4320,198452,13,351555
10878,0.001798,172.31.36.0-255,66,198518,13,351555
10879,0.001803,74.125.24.0-255,5738,204256,13,351555
10880,0.001805,172.31.36.0-255,66,204322,13,351555
10881,0.001846,172.31.36.0-255,66,204388,13,351555
10882,0.001854,74.125.24.0-255,7856,212244,13,351555
10883,0.001856,172.31.36.0-255,66,212310,13,351555
10884,0.001909,74.125.24.0-255,1484,213794,13,351555
10885,0.001923,74.125.24.0-255,2902,216696,13,351555
10886,0.001925,172.31.36.0-255,66,216762,13,351555
10887,0.00193,74.125.24.0-255,2902,219664,13,351555
10888,0.001933,172.31.36.0-255,66,219730,13,351555
10889,0.001951,74.125.24.0-255,1484,221214,13,351555
10890,0.00197,74.125.24.0-255,8574,229788,13,351555
10891,0.001972,172.31.36.0-255,66,229854,13,351555
10892,0.001999,74.125.24.0-255,8574,238428,13,351555
10893,0.002002,172.31.36.0-255,66,238494,13,351555
10894,0.002033,74.125.24.0-255,7856,246350,13,351555
10895,0.002036,172.31.36.0-255,66,246416,13,351555
10896,0.002043,74.125.24.0-255,8574,254990,13,351555
10897,0.002045,172.31.36.0-255,66,255056,13,351555
10898,0.002067,74.125.24.0-255,7156,262212,13,351555
10899,0.002069,172.31.36.0-255,66,262278,13,351555
10900,0.002117,74.125.24.0-255,5738,268016,13,351555
10901,0.002119,172.31.36.0-255,66,268082,13,351555
10902,0.002154,172.31.36.0-255,66,268148,13,351555
10903,0.002157,74.125.24.0-255,766,268914,13,351555
10904,0.002159,74.125.24.0-255,1484,270398,13,351555
10905,0.002161,172.31.36.0-255,66,270464,13,351555
10906,0.002166,74.125.24.0-255,2902,273366,13,351555
10907,0.002172,172.31.36.0-255,66,273432,13,351555
10908,0.002178,74.125.24.0-255,5738,279170,13,351555
10909,0.002181,172.31.36.0-255,66,279236,13,351555
10910,0.002186,74.125.24.0-255,5738,284974,13,351555
10911,0.002189,172.31.36.0-255,66,285040,13,351555
10912,0.002222,74.125.24.0-255,7156,292196,13,351555
10913,0.002225,172.31.36.0-255,66,292262,13,351555
10914,0.002239,74.125.24.0-255,1484,293746,13,351555
10915,0.00226,74.125.24.0-255,9274,303020,13,351555
10916,0.002262,172.31.36.0-255,66,303086,13,351555
10917,0.002463,74.125.24.0-255,1484,304570,13,351555
10918,0.002493,74.125.24.0-255,2902,307472,13,351555
10919,0.002495,172.31.36.0-255,66,307538,13,351555
10920,0.002498,74.125.24.0-255,1484,309022,13,351555
10921,0.002526,74.125.24.0-255,4320,313342,13,351555
10922,0.002528,172.31.36.0-255,66,313408,13,351555
10923,0.002533,74.125.24.0-255,5738,319146,13,351555
10924,0.002535,172.31.36.0-255,66,319212,13,351555
10925,0.002546,74.125.24.0-255,7156,326368,13,351555
10926,0.002548,172.31.36.0-255,66,326434,13,351555
10927,0.002585,74.125.24.0-255,4320,330754,13,351555
10928,0.002587,172.31.36.0-255,66,330820,13,351555
10929,0.002612,74.125.24.0-255,6438,337258,13,351555
10930,0.002615,172.31.36.0-255,66,337324,13,351555
10931,0.002704,74.125.24.0-255,1484,338808,13,351555
10932,0.002735,74.125.24.0-255,2902,341710,13,351555
10933,0.002737,172.31.36.0-255,66,341776,13,351555
10934,0.00274,74.125.24.0-255,1484,343260,13,351555
10935,0.002763,74.125.24.0-255,3781,347041,13,351555
10936,0.002765,172.31.36.0-255,66,347107,13,351555
10937,0.002768,74.125.24.0-255,105,347212,13,351555
10938,0.007283,172.31.36.0-255,105,347317,13,351555
10939,0.010025,74.125.24.0-255,66,347383,13,351555
10940,0.027863,172.31.36.0-255,171,347554,13,351555
10941,0.027898,172.31.36.0-255,1133,348687,13,351555
10942,0.027977,172.31.36.0-255,1514,350201,13,351555
10943,0.027979,172.31.36.0-255,1156,351357,13,351555
10944,0.029643,104.244.42.0-255,66,351423,13,351555
10945,0.029677,104.244.42.0-255,66,351489,13,351555
10946,0.029704,104.244.42.0-255,66,351555,13,351555
10947,0.0,74.125.200.0-255,147,147,13,375218
10948,2.7e-05,172.31.36.0-255,66,213,13,375218
10949,3.4e-05,74.125.200.0-255,1484,1697,13,375218
10950,3.9e-05,172.31.36.0-255,66,1763,13,375218
10951,4.5e-05,74.125.200.0-255,2902,4665,13,375218
10952,4.8e-05,172.31.36.0-255,66,4731,13,375218
10953,5.5e-05,74.125.200.0-255,4320,9051,13,375218
10954,5.8e-05,172.31.36.0-255,66,9117,13,375218
10955,8.2e-05,74.125.200.0-255,2902,12019,13,375218
10956,8.5e-05,172.31.36.0-255,66,12085,13,375218
10957,0.000145,74.125.200.0-255,2080,14165,13,375218
10958,0.000148,172.31.36.0-255,66,14231,13,375218
10959,0.000212,74.125.200.0-255,1484,15715,13,375218
10960,0.000215,172.31.36.0-255,66,15781,13,375218
10961,0.000246,74.125.200.0-255,2902,18683,13,375218
10962,0.000249,172.31.36.0-255,66,18749,13,375218
10963,0.000254,74.125.200.0-255,2902,21651,13,375218
10964,0.000256,172.31.36.0-255,66,21717,13,375218
10965,0.000271,74.125.200.0-255,2902,24619,13,375218
10966,0.000273,172.31.36.0-255,66,24685,13,375218
10967,0.000318,74.125.200.0-255,5738,30423,13,375218
10968,0.000321,172.31.36.0-255,66,30489,13,375218
10969,0.000377,74.125.200.0-255,2543,33032,13,375218
10970,0.00038,172.31.36.0-255,66,33098,13,375218
10971,0.000402,74.125.200.0-255,1484,34582,13,375218
10972,0.000405,172.31.36.0-255,66,34648,13,375218
10973,0.000426,74.125.200.0-255,1484,36132,13,375218
10974,0.000428,172.31.36.0-255,66,36198,13,375218
10975,0.000444,74.125.200.0-255,4320,40518,13,375218
10976,0.000446,172.31.36.0-255,66,40584,13,375218
10977,0.000459,74.125.200.0-255,2902,43486,13,375218
10978,0.000461,172.31.36.0-255,66,43552,13,375218
10979,0.000537,74.125.200.0-255,5379,48931,13,375218
10980,0.000541,172.31.36.0-255,66,48997,13,375218
10981,0.000601,74.125.200.0-255,4320,53317,13,375218
10982,0.000605,172.31.36.0-255,66,53383,13,375218
10983,0.000635,172.31.36.0-255,66,53449,13,375218
10984,0.000775,74.125.200.0-255,399,53848,13,375218
10985,0.000793,74.125.200.0-255,1761,55609,13,375218
10986,0.000796,172.31.36.0-255,66,55675,13,375218
10987,0.00082,74.125.200.0-255,2902,58577,13,375218
10988,0.000823,172.31.36.0-255,66,58643,13,375218
10989,0.000841,74.125.200.0-255,1484,60127,13,375218
10990,0.000873,74.125.200.0-255,1484,61611,13,375218
10991,0.000876,172.31.36.0-255,66,61677,13,375218
10992,0.000895,74.125.200.0-255,4320,65997,13,375218
10993,0.000898,172.31.36.0-255,66,66063,13,375218
10994,0.000921,74.125.200.0-255,2902,68965,13,375218
10995,0.000924,172.31.36.0-255,66,69031,13,375218
10996,0.000983,74.125.200.0-255,2543,71574,13,375218
10997,0.000987,172.31.36.0-255,66,71640,13,375218
10998,0.001004,74.125.200.0-255,1484,73124,13,375218
10999,0.001048,74.125.200.0-255,8574,81698,13,375218
11000,0.001053,172.31.36.0-255,66,81764,13,375218
11001,0.001136,74.125.200.0-255,4320,86084,13,375218
11002,0.00114,172.31.36.0-255,66,86150,13,375218
11003,0.001159,74.125.200.0-255,2543,88693,13,375218
11004,0.001162,172.31.36.0-255,66,88759,13,375218
11005,0.001706,74.125.200.0-255,1484,90243,13,375218
11006,0.00173,74.125.200.0-255,2902,93145,13,375218
11007,0.001734,172.31.36.0-255,66,93211,13,375218
11008,0.00177,74.125.200.0-255,4320,97531,13,375218
11009,0.001774,172.31.36.0-255,66,97597,13,375218
11010,0.001789,74.125.200.0-255,2902,100499,13,375218
11011,0.001791,172.31.36.0-255,66,100565,13,375218
11012,0.001832,74.125.200.0-255,4320,104885,13,375218
11013,0.001836,172.31.36.0-255,66,104951,13,375218
11014,0.001869,74.125.200.0-255,1484,106435,13,375218
11015,0.001892,74.125.200.0-255,7156,113591,13,375218
11016,0.001895,172.31.36.0-255,66,113657,13,375218
11017,0.001985,74.125.200.0-255,7156,120813,13,375218
11018,0.00199,172.31.36.0-255,66,120879,13,375218
11019,0.002068,74.125.200.0-255,2184,123063,13,375218
11020,0.002073,172.31.36.0-255,66,123129,13,375218
11021,0.004009,74.125.200.0-255,2902,126031,13,375218
11022,0.004016,172.31.36.0-255,66,126097,13,375218
11023,0.004076,74.125.200.0-255,2902,128999,13,375218
11024,0.004079,172.31.36.0-255,66,129065,13,375218
11025,0.006039,74.125.200.0-255,2902,131967,13,375218
11026,0.006043,172.31.36.0-255,66,132033,13,375218
11027,0.00608,74.125.200.0-255,1484,133517,13,375218
11028,0.006091,74.125.200.0-255,1484,135001,13,375218
11029,0.006094,172.31.36.0-255,66,135067,13,375218
11030,0.008053,74.125.200.0-255,2902,137969,13,375218
11031,0.008061,172.31.36.0-255,66,138035,13,375218
11032,0.0081,74.125.200.0-255,2902,140937,13,375218
11033,0.008103,172.31.36.0-255,66,141003,13,375218
11034,0.010082,74.125.200.0-255,2902,143905,13,375218
11035,0.01009,172.31.36.0-255,66,143971,13,375218
11036,0.010124,74.125.200.0-255,2902,146873,13,375218
11037,0.010127,172.31.36.0-255,66,146939,13,375218
11038,0.01211,74.125.200.0-255,2902,149841,13,375218
11039,0.012118,172.31.36.0-255,66,149907,13,375218
11040,0.012148,74.125.200.0-255,2902,152809,13,375218
11041,0.012151,172.31.36.0-255,66,152875,13,375218
11042,0.014141,74.125.200.0-255,2902,155777,13,375218
11043,0.014148,172.31.36.0-255,66,155843,13,375218
11044,0.014169,74.125.200.0-255,2902,158745,13,375218
11045,0.014172,172.31.36.0-255,66,158811,13,375218
11046,0.016171,74.125.200.0-255,5738,164549,13,375218
11047,0.016178,172.31.36.0-255,66,164615,13,375218
11048,0.018205,74.125.200.0-255,5738,170353,13,375218
11049,0.018213,172.31.36.0-255,66,170419,13,375218
11050,0.020244,74.125.200.0-255,5738,176157,13,375218
11051,0.020251,172.31.36.0-255,66,176223,13,375218
11052,0.022266,74.125.200.0-255,5738,181961,13,375218
11053,0.022273,172.31.36.0-255,66,182027,13,375218
11054,0.02429,74.125.200.0-255,5738,187765,13,375218
11055,0.024296,172.31.36.0-255,66,187831,13,375218
11056,0.024857,172.31.36.0-255,167,187998,13,375218
11057,0.02489,172.31.36.0-255,1108,189106,13,375218
11058,0.024948,172.31.36.0-255,1514,190620,13,375218
11059,0.024949,172.31.36.0-255,333,190953,13,375218
11060,0.026322,74.125.200.0-255,5738,196691,13,375218
11061,0.02633,172.31.36.0-255,66,196757,13,375218
11062,0.026405,104.244.42.0-255,66,196823,13,375218
11063,0.026446,104.244.42.0-255,66,196889,13,375218
11064,0.026491,104.244.42.0-255,66,196955,13,375218
11065,0.028357,74.125.200.0-255,5738,202693,13,375218
11066,0.028364,172.31.36.0-255,66,202759,13,375218
11067,0.030455,74.125.200.0-255,5738,208497,13,375218
11068,0.030461,172.31.36.0-255,66,208563,13,375218
11069,0.032498,74.125.200.0-255,5738,214301,13,375218
11070,0.032507,172.31.36.0-255,66,214367,13,375218
11071,0.03456,74.125.200.0-255,5738,220105,13,375218
11072,0.034566,172.31.36.0-255,66,220171,13,375218
11073,0.036608,74.125.200.0-255,5738,225909,13,375218
11074,0.036615,172.31.36.0-255,66,225975,13,375218
11075,0.038646,74.125.200.0-255,5738,231713,13,375218
11076,0.038652,172.31.36.0-255,66,231779,13,375218
11077,0.040687,74.125.200.0-255,5738,237517,13,375218
11078,0.040693,172.31.36.0-255,66,237583,13,375218
11079,0.042729,74.125.200.0-255,5738,243321,13,375218
11080,0.042736,172.31.36.0-255,66,243387,13,375218
11081,0.044764,74.125.200.0-255,5738,249125,13,375218
11082,0.044774,172.31.36.0-255,66,249191,13,375218
11083,0.046799,74.125.200.0-255,5738,254929,13,375218
11084,0.046809,172.31.36.0-255,66,254995,13,375218
11085,0.048837,74.125.200.0-255,5738,260733,13,375218
11086,0.048844,172.31.36.0-255,66,260799,13,375218
11087,0.050861,74.125.200.0-255,5738,266537,13,375218
11088,0.050868,172.31.36.0-255,66,266603,13,375218
11089,0.052898,74.125.200.0-255,5738,272341,13,375218
11090,0.052905,172.31.36.0-255,66,272407,13,375218
11091,0.054931,74.125.200.0-255,5738,278145,13,375218
11092,0.054939,172.31.36.0-255,66,278211,13,375218
11093,0.056984,74.125.200.0-255,5738,283949,13,375218
11094,0.056991,172.31.36.0-255,66,284015,13,375218
11095,0.059039,74.125.200.0-255,2902,286917,13,375218
11096,0.059046,172.31.36.0-255,66,286983,13,375218
11097,0.059068,74.125.200.0-255,2902,289885,13,375218
11098,0.059071,172.31.36.0-255,66,289951,13,375218
11099,0.061068,74.125.200.0-255,2902,292853,13,375218
11100,0.061075,172.31.36.0-255,66,292919,13,375218
11101,0.061096,74.125.200.0-255,2902,295821,13,375218
11102,0.061099,172.31.36.0-255,66,295887,13,375218
11103,0.063129,74.125.200.0-255,5738,301625,13,375218
11104,0.063136,172.31.36.0-255,66,301691,13,375218
11105,0.065174,74.125.200.0-255,5738,307429,13,375218
11106,0.065181,172.31.36.0-255,66,307495,13,375218
11107,0.067206,74.125.200.0-255,5738,313233,13,375218
11108,0.067213,172.31.36.0-255,66,313299,13,375218
11109,0.069253,74.125.200.0-255,4320,317619,13,375218
11110,0.069259,172.31.36.0-255,66,317685,13,375218
11111,0.069278,74.125.200.0-255,1484,319169,13,375218
11112,0.071291,74.125.200.0-255,4320,323489,13,375218
11113,0.071298,172.31.36.0-255,66,323555,13,375218
11114,0.073326,74.125.200.0-255,5738,329293,13,375218
11115,0.073333,172.31.36.0-255,66,329359,13,375218
11116,0.075371,74.125.200.0-255,5738,335097,13,375218
11117,0.075378,172.31.36.0-255,66,335163,13,375218
11118,0.077423,74.125.200.0-255,5738,340901,13,375218
11119,0.077431,172.31.36.0-255,66,340967,13,375218
11120,0.079468,74.125.200.0-255,5738,346705,13,375218
11121,0.079475,172.31.36.0-255,66,346771,13,375218
11122,0.081508,74.125.200.0-255,5738,352509,13,375218
11123,0.081514,172.31.36.0-255,66,352575,13,375218
11124,0.083545,74.125.200.0-255,5738,358313,13,375218
11125,0.083552,172.31.36.0-255,66,358379,13,375218
11126,0.085573,74.125.200.0-255,5738,364117,13,375218
11127,0.08558,172.31.36.0-255,66,364183,13,375218
11128,0.087619,74.125.200.0-255,5738,369921,13,375218
11129,0.087625,172.31.36.0-255,66,369987,13,375218
11130,0.089649,74.125.200.0-255,5060,375047,13,375218
11131,0.089655,172.31.36.0-255,66,375113,13,375218
11132,0.089852,172.31.36.0-255,105,375218,13,375218
11133,0.0,172.217.194.0-255,153,153,13,256006
11134,2.3e-05,172.31.36.0-255,66,219,13,256006
11135,3.1e-05,172.217.194.0-255,1484,1703,13,256006
11136,3.5e-05,172.31.36.0-255,66,1769,13,256006
11137,4.9e-05,172.217.194.0-255,2902,4671,13,256006
11138,5.3e-05,172.31.36.0-255,66,4737,13,256006
11139,6.1e-05,172.217.194.0-255,7156,11893,13,256006
11140,6.5e-05,172.31.36.0-255,66,11959,13,256006
11141,7.5e-05,172.217.194.0-255,7730,19689,13,256006
11142,7.8e-05,172.31.36.0-255,66,19755,13,256006
11143,8.7e-05,172.217.194.0-255,8574,28329,13,256006
11144,9e-05,172.31.36.0-255,66,28395,13,256006
11145,0.000129,172.217.194.0-255,2543,30938,13,256006
11146,0.000133,172.31.36.0-255,66,31004,13,256006
11147,0.000159,172.217.194.0-255,1484,32488,13,256006
11148,0.000162,172.31.36.0-255,66,32554,13,256006
11149,0.000167,172.217.194.0-255,2902,35456,13,256006
11150,0.000169,172.31.36.0-255,66,35522,13,256006
11151,0.000199,172.217.194.0-255,5738,41260,13,256006
11152,0.000202,172.31.36.0-255,66,41326,13,256006
11153,0.00021,172.217.194.0-255,7156,48482,13,256006
11154,0.000212,172.31.36.0-255,66,48548,13,256006
11155,0.000237,172.217.194.0-255,1125,49673,13,256006
11156,0.00024,172.31.36.0-255,66,49739,13,256006
11157,0.000248,172.217.194.0-255,7156,56895,13,256006
11158,0.000251,172.31.36.0-255,66,56961,13,256006
11159,0.000282,172.217.194.0-255,8468,65429,13,256006
11160,0.000285,172.31.36.0-255,66,65495,13,256006
11161,0.000288,172.217.194.0-255,434,65929,13,256006
11162,0.00029,172.31.36.0-255,66,65995,13,256006
11163,0.000582,172.217.194.0-255,1484,67479,13,256006
11164,0.000588,172.31.36.0-255,66,67545,13,256006
11165,0.000594,172.217.194.0-255,2902,70447,13,256006
11166,0.000597,172.31.36.0-255,66,70513,13,256006
11167,0.00061,172.217.194.0-255,5738,76251,13,256006
11168,0.000613,172.31.36.0-255,66,76317,13,256006
11169,0.000621,172.217.194.0-255,7156,83473,13,256006
11170,0.000623,172.31.36.0-255,66,83539,13,256006
11171,0.000628,172.217.194.0-255,2902,86441,13,256006
11172,0.00063,172.31.36.0-255,66,86507,13,256006
11173,0.000671,172.31.36.0-255,66,86573,13,256006
11174,0.000676,172.217.194.0-255,2184,88757,13,256006
11175,0.000678,172.31.36.0-255,66,88823,13,256006
11176,0.000952,172.217.194.0-255,1484,90307,13,256006
11177,0.000961,172.217.194.0-255,2902,93209,13,256006
11178,0.000964,172.31.36.0-255,66,93275,13,256006
11179,0.000997,172.217.194.0-255,5738,99013,13,256006
11180,0.001001,172.31.36.0-255,66,99079,13,256006
11181,0.001014,172.31.36.0-255,66,99145,13,256006
11182,0.001044,172.217.194.0-255,1484,100629,13,256006
11183,0.001056,172.217.194.0-255,10692,111321,13,256006
11184,0.001058,172.31.36.0-255,66,111387,13,256006
11185,0.001061,172.217.194.0-255,1484,112871,13,256006
11186,0.001083,172.217.194.0-255,2902,115773,13,256006
11187,0.001086,172.31.36.0-255,66,115839,13,256006
11188,0.001092,172.217.194.0-255,5738,121577,13,256006
11189,0.001095,172.31.36.0-255,66,121643,13,256006
11190,0.001098,172.217.194.0-255,1484,123127,13,256006
11191,0.001137,172.31.36.0-255,66,123193,13,256006
11192,0.001147,172.217.194.0-255,10692,133885,13,256006
11193,0.00115,172.31.36.0-255,66,133951,13,256006
11194,0.00119,172.217.194.0-255,1484,135435,13,256006
11195,0.001194,172.217.194.0-255,2902,138337,13,256006
11196,0.001197,172.31.36.0-255,66,138403,13,256006
11197,0.001203,172.217.194.0-255,5738,144141,13,256006
11198,0.001206,172.31.36.0-255,66,144207,13,256006
11199,0.001265,172.31.36.0-255,66,144273,13,256006
11200,0.001295,172.217.194.0-255,10692,154965,13,256006
11201,0.001299,172.31.36.0-255,66,155031,13,256006
11202,0.001328,172.217.194.0-255,5738,160769,13,256006
11203,0.00133,172.31.36.0-255,66,160835,13,256006
11204,0.001364,172.217.194.0-255,4320,165155,13,256006
11205,0.001367,172.31.36.0-255,66,165221,13,256006
11206,0.001417,172.217.194.0-255,1484,166705,13,256006
11207,0.001439,172.217.194.0-255,10692,177397,13,256006
11208,0.001453,172.31.36.0-255,66,177463,13,256006
11209,0.001544,172.217.194.0-255,1484,178947,13,256006
11210,0.00155,172.217.194.0-255,2902,181849,13,256006
11211,0.001557,172.217.194.0-255,5738,187587,13,256006
11212,0.001566,172.31.36.0-255,66,187653,13,256006
11213,0.001579,172.217.194.0-255,7156,194809,13,256006
11214,0.001599,172.31.36.0-255,66,194875,13,256006
11215,0.001611,172.217.194.0-255,5738,200613,13,256006
11216,0.001636,172.217.194.0-255,4320,204933,13,256006
11217,0.001654,172.217.194.0-255,6438,211371,13,256006
11218,0.001659,172.31.36.0-255,66,211437,13,256006
11219,0.001668,172.217.194.0-255,2902,214339,13,256006
11220,0.001673,172.31.36.0-255,66,214405,13,256006
11221,0.001702,172.217.194.0-255,8574,222979,13,256006
11222,0.001711,172.217.194.0-255,9992,232971,13,256006
11223,0.001727,172.31.36.0-255,66,233037,13,256006
11224,0.001738,172.217.194.0-255,4320,237357,13,256006
11225,0.001743,172.31.36.0-255,66,237423,13,256006
11226,0.001814,172.217.194.0-255,2902,240325,13,256006
11227,0.001821,172.217.194.0-255,6438,246763,13,256006
11228,0.001837,172.31.36.0-255,66,246829,13,256006
11229,0.001848,172.217.194.0-255,4320,251149,13,256006
11230,0.001853,172.31.36.0-255,66,251215,13,256006
11231,0.001909,172.217.194.0-255,97,251312,13,256006
11232,0.001928,172.31.36.0-255,66,251378,13,256006
11233,0.001953,172.217.194.0-255,105,251483,13,256006
11234,0.004237,172.31.36.0-255,66,251549,13,256006
11235,0.004273,172.31.36.0-255,105,251654,13,256006
11236,0.006553,172.217.194.0-255,66,251720,13,256006
11237,0.030956,172.31.36.0-255,167,251887,13,256006
11238,0.030989,172.31.36.0-255,1106,252993,13,256006
11239,0.031068,172.31.36.0-255,1514,254507,13,256006
11240,0.03107,172.31.36.0-255,1301,255808,13,256006
11241,0.032528,104.244.42.0-255,66,255874,13,256006
11242,0.032685,104.244.42.0-255,66,255940,13,256006
11243,0.032732,104.244.42.0-255,66,256006,13,256006
11244,0.0,172.217.194.0-255,152,152,13,319127
11245,2.5e-05,172.31.36.0-255,66,218,13,319127
11246,3e-05,172.217.194.0-255,1484,1702,13,319127
11247,3.4e-05,172.31.36.0-255,66,1768,13,319127
11248,3.9e-05,172.217.194.0-255,2902,4670,13,319127
11249,4.7e-05,172.31.36.0-255,66,4736,13,319127
11250,5e-05,172.217.194.0-255,1484,6220,13,319127
11251,5.2e-05,172.31.36.0-255,66,6286,13,319127
11252,9.4e-05,172.217.194.0-255,5738,12024,13,319127
11253,9.7e-05,172.31.36.0-255,66,12090,13,319127
11254,0.000104,172.217.194.0-255,6273,18363,13,319127
11255,0.000106,172.31.36.0-255,66,18429,13,319127
11256,0.000139,172.217.194.0-255,9992,28421,13,319127
11257,0.000142,172.31.36.0-255,66,28487,13,319127
11258,0.000169,172.217.194.0-255,2543,31030,13,319127
11259,0.000172,172.31.36.0-255,66,31096,13,319127
11260,0.000177,172.217.194.0-255,2902,33998,13,319127
11261,0.000178,172.31.36.0-255,66,34064,13,319127
11262,0.000183,172.217.194.0-255,4320,38384,13,319127
11263,0.000186,172.31.36.0-255,66,38450,13,319127
11264,0.000225,172.217.194.0-255,8574,47024,13,319127
11265,0.000229,172.31.36.0-255,66,47090,13,319127
11266,0.000236,172.217.194.0-255,7156,54246,13,319127
11267,0.000239,172.31.36.0-255,66,54312,13,319127
11268,0.000261,172.217.194.0-255,3961,58273,13,319127
11269,0.000264,172.31.36.0-255,66,58339,13,319127
11270,0.000271,172.217.194.0-255,1484,59823,13,319127
11271,0.000274,172.31.36.0-255,66,59889,13,319127
11272,0.000321,172.217.194.0-255,5692,65581,13,319127
11273,0.000326,172.31.36.0-255,66,65647,13,319127
11274,0.000574,172.217.194.0-255,365,66012,13,319127
11275,0.000579,172.31.36.0-255,66,66078,13,319127
11276,0.000828,172.217.194.0-255,1484,67562,13,319127
11277,0.000837,172.217.194.0-255,2902,70464,13,319127
11278,0.000841,172.31.36.0-255,66,70530,13,319127
11279,0.000848,172.217.194.0-255,2902,73432,13,319127
11280,0.000871,172.217.194.0-255,2902,76334,13,319127
11281,0.000875,172.217.194.0-255,1484,77818,13,319127
11282,0.000891,172.217.194.0-255,8574,86392,13,319127
11283,0.000915,172.217.194.0-255,2902,89294,13,319127
11284,0.00092,172.217.194.0-255,4320,93614,13,319127
11285,0.000947,172.217.194.0-255,6438,100052,13,319127
11286,0.001112,172.217.194.0-255,1484,101536,13,319127
11287,0.001119,172.217.194.0-255,2902,104438,13,319127
11288,0.001125,172.217.194.0-255,5738,110176,13,319127
11289,0.001139,172.217.194.0-255,1484,111660,13,319127
11290,0.001156,172.217.194.0-255,7156,118816,13,319127
11291,0.001171,172.217.194.0-255,1484,120300,13,319127
11292,0.001219,172.217.194.0-255,2902,123202,13,319127
11293,0.001239,172.217.194.0-255,7156,130358,13,319127
11294,0.001265,172.217.194.0-255,3602,133960,13,319127
11295,0.001287,172.217.194.0-255,1484,135444,13,319127
11296,0.001291,172.217.194.0-255,1484,136928,13,319127
11297,0.001315,172.217.194.0-255,1484,138412,13,319127
11298,0.001323,172.217.194.0-255,5738,144150,13,319127
11299,0.001331,172.217.194.0-255,7156,151306,13,319127
11300,0.001349,172.217.194.0-255,5738,157044,13,319127
11301,0.001356,172.217.194.0-255,5738,162782,13,319127
11302,0.001373,172.217.194.0-255,5020,167802,13,319127
11303,0.001408,172.217.194.0-255,1484,169286,13,319127
11304,0.001423,172.217.194.0-255,2902,172188,13,319127
11305,0.00147,172.217.194.0-255,5738,177926,13,319127
11306,0.001475,172.217.194.0-255,4320,182246,13,319127
11307,0.001498,172.217.194.0-255,2902,185148,13,319127
11308,0.001515,172.217.194.0-255,5020,190168,13,319127
11309,0.001701,172.217.194.0-255,1484,191652,13,319127
11310,0.001716,172.217.194.0-255,2902,194554,13,319127
11311,0.001729,172.217.194.0-255,5738,200292,13,319127
11312,0.001757,172.217.194.0-255,4320,204612,13,319127
11313,0.001783,172.217.194.0-255,8574,213186,13,319127
11314,0.001792,172.217.194.0-255,9992,223178,13,319127
11315,0.001805,172.217.194.0-255,766,223944,13,319127
11316,0.001911,172.217.194.0-255,1484,225428,13,319127
11317,0.001913,172.217.194.0-255,1484,226912,13,319127
11318,0.001929,172.217.194.0-255,1484,228396,13,319127
11319,0.001936,172.217.194.0-255,5738,234134,13,319127
11320,0.001965,172.217.194.0-255,8574,242708,13,319127
11321,0.001987,172.217.194.0-255,4320,247028,13,319127
11322,0.002004,172.217.194.0-255,5738,252766,13,319127
11323,0.002026,172.217.194.0-255,8574,261340,13,319127
11324,0.002033,172.217.194.0-255,8574,269914,13,319127
11325,0.00205,172.217.194.0-255,7856,277770,13,319127
11326,0.002078,172.217.194.0-255,5738,283508,13,319127
11327,0.002086,172.217.194.0-255,8574,292082,13,319127
11328,0.002107,172.217.194.0-255,7856,299938,13,319127
11329,0.002118,172.217.194.0-255,1484,301422,13,319127
11330,0.002141,172.217.194.0-255,9992,311414,13,319127
11331,0.002236,172.217.194.0-255,2985,314399,13,319127
11332,0.002238,172.217.194.0-255,97,314496,13,319127
11333,0.00224,172.217.194.0-255,105,314601,13,319127
11334,0.004344,172.31.36.0-255,66,314667,13,319127
11335,0.006711,172.31.36.0-255,105,314772,13,319127
11336,0.009213,172.217.194.0-255,66,314838,13,319127
11337,0.032759,172.31.36.0-255,172,315010,13,319127
11338,0.032804,172.31.36.0-255,1106,316116,13,319127
11339,0.032835,172.31.36.0-255,1514,317630,13,319127
11340,0.032837,172.31.36.0-255,1299,318929,13,319127
11341,0.034317,104.244.42.0-255,66,318995,13,319127
11342,0.034354,104.244.42.0-255,66,319061,13,319127
11343,0.034407,104.244.42.0-255,66,319127,13,319127
11344,0.0,172.217.194.0-255,152,152,13,270870
11345,3.3e-05,172.31.36.0-255,66,218,13,270870
11346,4e-05,172.217.194.0-255,1484,1702,13,270870
11347,4.5e-05,172.31.36.0-255,66,1768,13,270870
11348,5.2e-05,172.217.194.0-255,2902,4670,13,270870
11349,5.6e-05,172.31.36.0-255,66,4736,13,270870
11350,6.3e-05,172.217.194.0-255,7156,11892,13,270870
11351,6.6e-05,172.31.36.0-255,66,11958,13,270870
11352,7e-05,172.217.194.0-255,2019,13977,13,270870
11353,7.3e-05,172.31.36.0-255,66,14043,13,270870
11354,9.9e-05,172.217.194.0-255,7156,21199,13,270870
11355,0.000103,172.31.36.0-255,66,21265,13,270870
11356,0.000125,172.217.194.0-255,4320,25585,13,270870
11357,0.000128,172.31.36.0-255,66,25651,13,270870
11358,0.000134,172.217.194.0-255,5379,31030,13,270870
11359,0.000136,172.31.36.0-255,66,31096,13,270870
11360,0.000199,172.217.194.0-255,1484,32580,13,270870
11361,0.000204,172.31.36.0-255,66,32646,13,270870
11362,0.000209,172.217.194.0-255,2902,35548,13,270870
11363,0.000212,172.31.36.0-255,66,35614,13,270870
11364,0.000218,172.217.194.0-255,2902,38516,13,270870
11365,0.00022,172.31.36.0-255,66,38582,13,270870
11366,0.000238,172.217.194.0-255,2902,41484,13,270870
11367,0.000242,172.31.36.0-255,66,41550,13,270870
11368,0.000254,172.217.194.0-255,1484,43034,13,270870
11369,0.000257,172.31.36.0-255,66,43100,13,270870
11370,0.000288,172.31.36.0-255,66,43166,13,270870
11371,0.000295,172.217.194.0-255,5738,48904,13,270870
11372,0.000298,172.31.36.0-255,66,48970,13,270870
11373,0.000325,172.217.194.0-255,2902,51872,13,270870
11374,0.000329,172.217.194.0-255,1714,53586,13,270870
11375,0.000331,172.31.36.0-255,66,53652,13,270870
11376,0.000336,172.31.36.0-255,66,53718,13,270870
11377,0.000526,172.217.194.0-255,1484,55202,13,270870
11378,0.000534,172.217.194.0-255,2902,58104,13,270870
11379,0.000539,172.31.36.0-255,66,58170,13,270870
11380,0.000548,172.217.194.0-255,5738,63908,13,270870
11381,0.00055,172.31.36.0-255,66,63974,13,270870
11382,0.000553,172.217.194.0-255,1484,65458,13,270870
11383,0.000592,172.31.36.0-255,66,65524,13,270870
11384,0.000628,172.217.194.0-255,8574,74098,13,270870
11385,0.000632,172.31.36.0-255,66,74164,13,270870
11386,0.000652,172.217.194.0-255,1484,75648,13,270870
11387,0.000656,172.217.194.0-255,766,76414,13,270870
11388,0.000659,172.31.36.0-255,66,76480,13,270870
11389,0.000864,172.217.194.0-255,1484,77964,13,270870
11390,0.000872,172.217.194.0-255,2902,80866,13,270870
11391,0.000876,172.31.36.0-255,66,80932,13,270870
11392,0.000884,172.217.194.0-255,5738,86670,13,270870
11393,0.000886,172.31.36.0-255,66,86736,13,270870
11394,0.000889,172.217.194.0-255,1484,88220,13,270870
11395,0.000931,172.31.36.0-255,66,88286,13,270870
11396,0.000963,172.217.194.0-255,5738,94024,13,270870
11397,0.000967,172.31.36.0-255,66,94090,13,270870
11398,0.000989,172.217.194.0-255,3602,97692,13,270870
11399,0.000992,172.31.36.0-255,66,97758,13,270870
11400,0.001048,172.217.194.0-255,1484,99242,13,270870
11401,0.001054,172.217.194.0-255,2902,102144,13,270870
11402,0.001058,172.31.36.0-255,66,102210,13,270870
11403,0.001086,172.217.194.0-255,5738,107948,13,270870
11404,0.00109,172.31.36.0-255,66,108014,13,270870
11405,0.0011,172.217.194.0-255,8574,116588,13,270870
11406,0.001103,172.31.36.0-255,66,116654,13,270870
11407,0.001126,172.217.194.0-255,4320,120974,13,270870
11408,0.00113,172.31.36.0-255,66,121040,13,270870
11409,0.001157,172.217.194.0-255,8574,129614,13,270870
11410,0.001161,172.31.36.0-255,66,129680,13,270870
11411,0.001174,172.217.194.0-255,2184,131864,13,270870
11412,0.001177,172.31.36.0-255,66,131930,13,270870
11413,0.001532,172.217.194.0-255,1484,133414,13,270870
11414,0.00154,172.217.194.0-255,2902,136316,13,270870
11415,0.001545,172.31.36.0-255,66,136382,13,270870
11416,0.001552,172.217.194.0-255,4320,140702,13,270870
11417,0.001554,172.31.36.0-255,66,140768,13,270870
11418,0.001568,172.217.194.0-255,1484,142252,13,270870
11419,0.001576,172.217.194.0-255,7156,149408,13,270870
11420,0.001579,172.31.36.0-255,66,149474,13,270870
11421,0.001599,172.217.194.0-255,5738,155212,13,270870
11422,0.001603,172.31.36.0-255,66,155278,13,270870
11423,0.001613,172.217.194.0-255,10692,165970,13,270870
11424,0.001615,172.31.36.0-255,66,166036,13,270870
11425,0.001801,172.217.194.0-255,1484,167520,13,270870
11426,0.001807,172.217.194.0-255,2902,170422,13,270870
11427,0.00181,172.31.36.0-255,66,170488,13,270870
11428,0.001837,172.217.194.0-255,5738,176226,13,270870
11429,0.00184,172.31.36.0-255,66,176292,13,270870
11430,0.001848,172.217.194.0-255,7156,183448,13,270870
11431,0.001851,172.31.36.0-255,66,183514,13,270870
11432,0.001882,172.217.194.0-255,5738,189252,13,270870
11433,0.001886,172.31.36.0-255,66,189318,13,270870
11434,0.001896,172.217.194.0-255,9992,199310,13,270870
11435,0.001898,172.31.36.0-255,66,199376,13,270870
11436,0.001913,172.217.194.0-255,1484,200860,13,270870
11437,0.001939,172.31.36.0-255,66,200926,13,270870
11438,0.001966,172.217.194.0-255,7856,208782,13,270870
11439,0.00197,172.31.36.0-255,66,208848,13,270870
11440,0.001995,172.217.194.0-255,9992,218840,13,270870
11441,0.001998,172.31.36.0-255,66,218906,13,270870
11442,0.002041,172.217.194.0-255,9274,228180,13,270870
11443,0.002045,172.31.36.0-255,66,228246,13,270870
11444,0.002061,172.31.36.0-255,66,228312,13,270870
11445,0.002104,172.217.194.0-255,8574,236886,13,270870
11446,0.002108,172.31.36.0-255,66,236952,13,270870
11447,0.002127,172.217.194.0-255,6438,243390,13,270870
11448,0.002132,172.31.36.0-255,66,243456,13,270870
11449,0.00214,172.31.36.0-255,66,243522,13,270870
11450,0.002147,172.217.194.0-255,7156,250678,13,270870
11451,0.002149,172.31.36.0-255,66,250744,13,270870
11452,0.002197,172.31.36.0-255,66,250810,13,270870
11453,0.002201,172.217.194.0-255,1484,252294,13,270870
11454,0.002217,172.31.36.0-255,66,252360,13,270870
11455,0.00224,172.217.194.0-255,2184,254544,13,270870
11456,0.002243,172.31.36.0-255,66,254610,13,270870
11457,0.00225,172.217.194.0-255,5738,260348,13,270870
11458,0.002252,172.31.36.0-255,66,260414,13,270870
11459,0.002282,172.217.194.0-255,5759,266173,13,270870
11460,0.002286,172.31.36.0-255,66,266239,13,270870
11461,0.002289,172.217.194.0-255,105,266344,13,270870
11462,0.003377,172.31.36.0-255,66,266410,13,270870
11463,0.003403,172.31.36.0-255,105,266515,13,270870
11464,0.005595,172.217.194.0-255,66,266581,13,270870
11465,0.024401,172.31.36.0-255,172,266753,13,270870
11466,0.024433,172.31.36.0-255,1106,267859,13,270870
11467,0.024473,172.31.36.0-255,1514,269373,13,270870
11468,0.024475,172.31.36.0-255,1299,270672,13,270870
11469,0.025935,104.244.42.0-255,66,270738,13,270870
11470,0.025985,104.244.42.0-255,66,270804,13,270870
11471,0.026026,104.244.42.0-255,66,270870,13,270870
11472,0.0,74.125.130.0-255,153,153,13,390107
11473,3.3e-05,172.31.36.0-255,66,219,13,390107
11474,4e-05,74.125.130.0-255,1484,1703,13,390107
11475,4.4e-05,172.31.36.0-255,66,1769,13,390107
11476,5.9e-05,74.125.130.0-255,2902,4671,13,390107
11477,6.2e-05,172.31.36.0-255,66,4737,13,390107
11478,7.9e-05,74.125.130.0-255,1484,6221,13,390107
11479,8.1e-05,172.31.36.0-255,66,6287,13,390107
11480,0.000104,74.125.130.0-255,2902,9189,13,390107
11481,0.000107,172.31.36.0-255,66,9255,13,390107
11482,0.000145,74.125.130.0-255,6337,15592,13,390107
11483,0.000149,172.31.36.0-255,66,15658,13,390107
11484,0.000153,74.125.130.0-255,2902,18560,13,390107
11485,0.000155,172.31.36.0-255,66,18626,13,390107
11486,0.00016,74.125.130.0-255,4320,22946,13,390107
11487,0.000163,172.31.36.0-255,66,23012,13,390107
11488,0.000191,74.125.130.0-255,2902,25914,13,390107
11489,0.000193,172.31.36.0-255,66,25980,13,390107
11490,0.000205,74.125.130.0-255,1484,27464,13,390107
11491,0.000208,172.31.36.0-255,66,27530,13,390107
11492,0.000225,74.125.130.0-255,3961,31491,13,390107
11493,0.000227,172.31.36.0-255,66,31557,13,390107
11494,0.000491,74.125.130.0-255,1484,33041,13,390107
11495,0.000495,172.31.36.0-255,66,33107,13,390107
11496,0.000499,74.125.130.0-255,1484,34591,13,390107
11497,0.000501,172.31.36.0-255,66,34657,13,390107
11498,0.000515,74.125.130.0-255,1484,36141,13,390107
11499,0.000517,172.31.36.0-255,66,36207,13,390107
11500,0.000523,74.125.130.0-255,4320,40527,13,390107
11501,0.000525,172.31.36.0-255,66,40593,13,390107
11502,0.000543,74.125.130.0-255,1484,42077,13,390107
11503,0.000548,74.125.130.0-255,4320,46397,13,390107
11504,0.000548,172.31.36.0-255,66,46463,13,390107
11505,0.000552,172.31.36.0-255,66,46529,13,390107
11506,0.000559,74.125.130.0-255,1484,48013,13,390107
11507,0.000581,74.125.130.0-255,3961,51974,13,390107
11508,0.000584,172.31.36.0-255,66,52040,13,390107
11509,0.000587,74.125.130.0-255,1484,53524,13,390107
11510,0.000606,74.125.130.0-255,4320,57844,13,390107
11511,0.000609,172.31.36.0-255,66,57910,13,390107
11512,0.000614,74.125.130.0-255,2902,60812,13,390107
11513,0.000616,172.31.36.0-255,66,60878,13,390107
11514,0.000633,74.125.130.0-255,4320,65198,13,390107
11515,0.000636,172.31.36.0-255,66,65264,13,390107
11516,0.000639,74.125.130.0-255,1125,66389,13,390107
11517,0.000693,74.125.130.0-255,358,66747,13,390107
11518,0.000789,172.31.36.0-255,66,66813,13,390107
11519,0.000826,74.125.130.0-255,1484,68297,13,390107
11520,0.000842,74.125.130.0-255,2902,71199,13,390107
11521,0.000844,172.31.36.0-255,66,71265,13,390107
11522,0.00086,74.125.130.0-255,1484,72749,13,390107
11523,0.000873,74.125.130.0-255,4320,77069,13,390107
11524,0.000876,172.31.36.0-255,66,77135,13,390107
11525,0.000881,74.125.130.0-255,2902,80037,13,390107
11526,0.000883,172.31.36.0-255,66,80103,13,390107
11527,0.000895,74.125.130.0-255,1484,81587,13,390107
11528,0.000912,74.125.130.0-255,2902,84489,13,390107
11529,0.000915,172.31.36.0-255,66,84555,13,390107
11530,0.000956,74.125.130.0-255,5738,90293,13,390107
11531,0.00096,172.31.36.0-255,66,90359,13,390107
11532,0.000987,74.125.130.0-255,4320,94679,13,390107
11533,0.000991,172.31.36.0-255,66,94745,13,390107
11534,0.001001,74.125.130.0-255,2902,97647,13,390107
11535,0.001003,172.31.36.0-255,66,97713,13,390107
11536,0.001008,74.125.130.0-255,3602,101315,13,390107
11537,0.00101,172.31.36.0-255,66,101381,13,390107
11538,0.001042,74.125.130.0-255,384,101765,13,390107
11539,0.001088,74.125.130.0-255,1484,103249,13,390107
11540,0.001092,172.31.36.0-255,66,103315,13,390107
11541,0.001105,74.125.130.0-255,2902,106217,13,390107
11542,0.001107,172.31.36.0-255,66,106283,13,390107
11543,0.001139,74.125.130.0-255,5738,112021,13,390107
11544,0.001142,172.31.36.0-255,66,112087,13,390107
11545,0.001146,74.125.130.0-255,2902,114989,13,390107
11546,0.001148,172.31.36.0-255,66,115055,13,390107
11547,0.001153,74.125.130.0-255,4320,119375,13,390107
11548,0.001155,172.31.36.0-255,66,119441,13,390107
11549,0.001171,74.125.130.0-255,2902,122343,13,390107
11550,0.001175,172.31.36.0-255,66,122409,13,390107
11551,0.001184,74.125.130.0-255,5738,128147,13,390107
11552,0.001186,172.31.36.0-255,66,128213,13,390107
11553,0.00119,74.125.130.0-255,1484,129697,13,390107
11554,0.001213,74.125.130.0-255,2902,132599,13,390107
11555,0.001216,172.31.36.0-255,66,132665,13,390107
11556,0.001246,74.125.130.0-255,3054,135719,13,390107
11557,0.00125,172.31.36.0-255,66,135785,13,390107
11558,0.001496,74.125.130.0-255,1484,137269,13,390107
11559,0.001518,74.125.130.0-255,2902,140171,13,390107
11560,0.001521,172.31.36.0-255,66,140237,13,390107
11561,0.001526,74.125.130.0-255,1484,141721,13,390107
11562,0.001542,74.125.130.0-255,4320,146041,13,390107
11563,0.001544,172.31.36.0-255,66,146107,13,390107
11564,0.00155,74.125.130.0-255,4320,150427,13,390107
11565,0.001552,172.31.36.0-255,66,150493,13,390107
11566,0.001573,74.125.130.0-255,7156,157649,13,390107
11567,0.001576,172.31.36.0-255,66,157715,13,390107
11568,0.001581,74.125.130.0-255,2902,160617,13,390107
11569,0.001583,172.31.36.0-255,66,160683,13,390107
11570,0.001606,74.125.130.0-255,9274,169957,13,390107
11571,0.001609,172.31.36.0-255,66,170023,13,390107
11572,0.00172,74.125.130.0-255,1484,171507,13,390107
11573,0.001736,74.125.130.0-255,2902,174409,13,390107
11574,0.001739,172.31.36.0-255,66,174475,13,390107
11575,0.001743,74.125.130.0-255,1484,175959,13,390107
11576,0.00176,74.125.130.0-255,2902,178861,13,390107
11577,0.001762,172.31.36.0-255,66,178927,13,390107
11578,0.001784,74.125.130.0-255,4320,183247,13,390107
11579,0.001788,172.31.36.0-255,66,183313,13,390107
11580,0.001805,74.125.130.0-255,1484,184797,13,390107
11581,0.00182,74.125.130.0-255,7156,191953,13,390107
11582,0.001823,172.31.36.0-255,66,192019,13,390107
11583,0.00185,74.125.130.0-255,8574,200593,13,390107
11584,0.001853,172.31.36.0-255,66,200659,13,390107
11585,0.001858,74.125.130.0-255,3602,204261,13,390107
11586,0.00186,172.31.36.0-255,66,204327,13,390107
11587,0.001885,74.125.130.0-255,4320,208647,13,390107
11588,0.001887,172.31.36.0-255,66,208713,13,390107
11589,0.001904,74.125.130.0-255,1484,210197,13,390107
11590,0.001924,74.125.130.0-255,8574,218771,13,390107
11591,0.001927,172.31.36.0-255,66,218837,13,390107
11592,0.001935,74.125.130.0-255,7156,225993,13,390107
11593,0.001938,172.31.36.0-255,66,226059,13,390107
11594,0.001944,74.125.130.0-255,7156,233215,13,390107
11595,0.001947,172.31.36.0-255,66,233281,13,390107
11596,0.001962,74.125.130.0-255,1484,234765,13,390107
11597,0.001968,74.125.130.0-255,3602,238367,13,390107
11598,0.001971,172.31.36.0-255,66,238433,13,390107
11599,0.002049,74.125.130.0-255,1484,239917,13,390107
11600,0.002067,74.125.130.0-255,1484,241401,13,390107
11601,0.00207,172.31.36.0-255,66,241467,13,390107
11602,0.002089,74.125.130.0-255,1484,242951,13,390107
11603,0.002092,74.125.130.0-255,1484,244435,13,390107
11604,0.002094,172.31.36.0-255,66,244501,13,390107
11605,0.002115,74.125.130.0-255,4320,248821,13,390107
11606,0.002118,172.31.36.0-255,66,248887,13,390107
11607,0.002136,74.125.130.0-255,2902,251789,13,390107
11608,0.002139,172.31.36.0-255,66,251855,13,390107
11609,0.002162,74.125.130.0-255,5738,257593,13,390107
11610,0.002164,172.31.36.0-255,66,257659,13,390107
11611,0.00217,74.125.130.0-255,7156,264815,13,390107
11612,0.002172,172.31.36.0-255,66,264881,13,390107
11613,0.002194,74.125.130.0-255,2902,267783,13,390107
11614,0.002196,172.31.36.0-255,66,267849,13,390107
11615,0.002202,74.125.130.0-255,5020,272869,13,390107
11616,0.002204,172.31.36.0-255,66,272935,13,390107
11617,0.002593,74.125.130.0-255,1484,274419,13,390107
11618,0.00261,74.125.130.0-255,2902,277321,13,390107
11619,0.002612,172.31.36.0-255,66,277387,13,390107
11620,0.002617,74.125.130.0-255,2902,280289,13,390107
11621,0.00262,172.31.36.0-255,66,280355,13,390107
11622,0.002676,74.125.130.0-255,4320,284675,13,390107
11623,0.002679,172.31.36.0-255,66,284741,13,390107
11624,0.002687,74.125.130.0-255,8574,293315,13,390107
11625,0.002689,172.31.36.0-255,66,293381,13,390107
11626,0.002691,74.125.130.0-255,1484,294865,13,390107
11627,0.002695,74.125.130.0-255,2902,297767,13,390107
11628,0.002697,172.31.36.0-255,66,297833,13,390107
11629,0.002729,74.125.130.0-255,8574,306407,13,390107
11630,0.002731,172.31.36.0-255,66,306473,13,390107
11631,0.002733,74.125.130.0-255,766,307239,13,390107
11632,0.005421,74.125.130.0-255,4320,311559,13,390107
11633,0.005428,172.31.36.0-255,66,311625,13,390107
11634,0.008133,74.125.130.0-255,5738,317363,13,390107
11635,0.008141,172.31.36.0-255,66,317429,13,390107
11636,0.010839,74.125.130.0-255,5738,323167,13,390107
11637,0.010849,172.31.36.0-255,66,323233,13,390107
11638,0.013536,74.125.130.0-255,5738,328971,13,390107
11639,0.013546,172.31.36.0-255,66,329037,13,390107
11640,0.016243,74.125.130.0-255,5738,334775,13,390107
11641,0.016251,172.31.36.0-255,66,334841,13,390107
11642,0.018955,74.125.130.0-255,5738,340579,13,390107
11643,0.018965,172.31.36.0-255,66,340645,13,390107
11644,0.02165,74.125.130.0-255,4320,344965,13,390107
11645,0.021657,172.31.36.0-255,66,345031,13,390107
11646,0.021687,74.125.130.0-255,1484,346515,13,390107
11647,0.024351,74.125.130.0-255,4320,350835,13,390107
11648,0.024358,172.31.36.0-255,66,350901,13,390107
11649,0.027044,74.125.130.0-255,5738,356639,13,390107
11650,0.027051,172.31.36.0-255,66,356705,13,390107
11651,0.029756,74.125.130.0-255,5738,362443,13,390107
11652,0.029771,172.31.36.0-255,66,362509,13,390107
11653,0.032112,172.31.36.0-255,172,362681,13,390107
11654,0.032145,172.31.36.0-255,1110,363791,13,390107
11655,0.032179,172.31.36.0-255,1514,365305,13,390107
11656,0.032181,172.31.36.0-255,1295,366600,13,390107
11657,0.032462,74.125.130.0-255,5738,372338,13,390107
11658,0.032471,172.31.36.0-255,66,372404,13,390107
11659,0.033754,104.244.42.0-255,66,372470,13,390107
11660,0.033805,104.244.42.0-255,66,372536,13,390107
11661,0.033838,104.244.42.0-255,66,372602,13,390107
11662,0.03514,74.125.130.0-255,1484,374086,13,390107
11663,0.035167,74.125.130.0-255,4320,378406,13,390107
11664,0.035174,172.31.36.0-255,66,378472,13,390107
11665,0.037859,74.125.130.0-255,5738,384210,13,390107
11666,0.037865,172.31.36.0-255,66,384276,13,390107
11667,0.040547,74.125.130.0-255,5594,389870,13,390107
11668,0.040553,172.31.36.0-255,66,389936,13,390107
11669,0.040862,172.31.36.0-255,105,390041,13,390107
11670,0.043502,74.125.130.0-255,66,390107,13,390107
11671,0.0,172.217.194.0-255,143,143,13,264802
11672,1.9e-05,172.31.36.0-255,66,209,13,264802
11673,2.5e-05,172.217.194.0-255,1484,1693,13,264802
11674,2.9e-05,172.31.36.0-255,66,1759,13,264802
11675,3.5e-05,172.217.194.0-255,2902,4661,13,264802
11676,4.6e-05,172.31.36.0-255,66,4727,13,264802
11677,5.2e-05,172.217.194.0-255,2902,7629,13,264802
11678,5.6e-05,172.31.36.0-255,66,7695,13,264802
11679,6.2e-05,172.217.194.0-255,2902,10597,13,264802
11680,6.4e-05,172.31.36.0-255,66,10663,13,264802
11681,9.1e-05,172.217.194.0-255,4856,15519,13,264802
11682,9.4e-05,172.31.36.0-255,66,15585,13,264802
11683,0.000155,172.31.36.0-255,66,15651,13,264802
11684,0.000183,172.217.194.0-255,1484,17135,13,264802
11685,0.000186,172.31.36.0-255,66,17201,13,264802
11686,0.000191,172.217.194.0-255,2902,20103,13,264802
11687,0.000193,172.31.36.0-255,66,20169,13,264802
11688,0.000204,172.217.194.0-255,5738,25907,13,264802
11689,0.000207,172.31.36.0-255,66,25973,13,264802
11690,0.000215,172.217.194.0-255,6797,32770,13,264802
11691,0.000217,172.31.36.0-255,66,32836,13,264802
11692,0.000269,172.217.194.0-255,7156,39992,13,264802
11693,0.000272,172.31.36.0-255,66,40058,13,264802
11694,0.000307,172.217.194.0-255,7156,47214,13,264802
11695,0.000311,172.217.194.0-255,2833,50047,13,264802
11696,0.000313,172.217.194.0-255,365,50412,13,264802
11697,0.000318,172.31.36.0-255,66,50478,13,264802
11698,0.000325,172.31.36.0-255,66,50544,13,264802
11699,0.000328,172.31.36.0-255,66,50610,13,264802
11700,0.000393,172.217.194.0-255,1484,52094,13,264802
11701,0.000396,172.31.36.0-255,66,52160,13,264802
11702,0.000402,172.217.194.0-255,2902,55062,13,264802
11703,0.000404,172.31.36.0-255,66,55128,13,264802
11704,0.000409,172.217.194.0-255,2902,58030,13,264802
11705,0.000416,172.31.36.0-255,66,58096,13,264802
11706,0.00044,172.217.194.0-255,2902,60998,13,264802
11707,0.000444,172.31.36.0-255,66,61064,13,264802
11708,0.000453,172.217.194.0-255,9992,71056,13,264802
11709,0.00046,172.31.36.0-255,66,71122,13,264802
11710,0.000488,172.217.194.0-255,3961,75083,13,264802
11711,0.000496,172.31.36.0-255,66,75149,13,264802
11712,0.000502,172.217.194.0-255,4320,79469,13,264802
11713,0.000504,172.31.36.0-255,66,79535,13,264802
11714,0.000507,172.217.194.0-255,1484,81019,13,264802
11715,0.000541,172.217.194.0-255,3961,84980,13,264802
11716,0.000545,172.31.36.0-255,66,85046,13,264802
11717,0.000551,172.217.194.0-255,5738,90784,13,264802
11718,0.000553,172.31.36.0-255,66,90850,13,264802
11719,0.000581,172.217.194.0-255,2902,93752,13,264802
11720,0.000583,172.31.36.0-255,66,93818,13,264802
11721,0.000587,172.217.194.0-255,1484,95302,13,264802
11722,0.000615,172.217.194.0-255,8574,103876,13,264802
11723,0.000617,172.31.36.0-255,66,103942,13,264802
11724,0.000635,172.31.36.0-255,66,104008,13,264802
11725,0.000661,172.217.194.0-255,3053,107061,13,264802
11726,0.000663,172.31.36.0-255,66,107127,13,264802
11727,0.00078,172.217.194.0-255,1484,108611,13,264802
11728,0.000787,172.217.194.0-255,2902,111513,13,264802
11729,0.000805,172.31.36.0-255,66,111579,13,264802
11730,0.000813,172.217.194.0-255,5738,117317,13,264802
11731,0.000815,172.31.36.0-255,66,117383,13,264802
11732,0.000828,172.217.194.0-255,7156,124539,13,264802
11733,0.00083,172.31.36.0-255,66,124605,13,264802
11734,0.000875,172.31.36.0-255,66,124671,13,264802
11735,0.00088,172.217.194.0-255,2184,126855,13,264802
11736,0.000882,172.31.36.0-255,66,126921,13,264802
11737,0.001047,172.217.194.0-255,1484,128405,13,264802
11738,0.001053,172.217.194.0-255,2902,131307,13,264802
11739,0.001056,172.31.36.0-255,66,131373,13,264802
11740,0.001087,172.217.194.0-255,5738,137111,13,264802
11741,0.00109,172.31.36.0-255,66,137177,13,264802
11742,0.001103,172.31.36.0-255,66,137243,13,264802
11743,0.001135,172.217.194.0-255,1484,138727,13,264802
11744,0.001147,172.217.194.0-255,10692,149419,13,264802
11745,0.00115,172.31.36.0-255,66,149485,13,264802
11746,0.001172,172.31.36.0-255,66,149551,13,264802
11747,0.001225,172.217.194.0-255,7156,156707,13,264802
11748,0.001228,172.31.36.0-255,66,156773,13,264802
11749,0.001261,172.217.194.0-255,8574,165347,13,264802
11750,0.001264,172.31.36.0-255,66,165413,13,264802
11751,0.001271,172.217.194.0-255,6438,171851,13,264802
11752,0.001274,172.31.36.0-255,66,171917,13,264802
11753,0.00128,172.217.194.0-255,7156,179073,13,264802
11754,0.001282,172.31.36.0-255,66,179139,13,264802
11755,0.001289,172.217.194.0-255,5738,184877,13,264802
11756,0.001291,172.31.36.0-255,66,184943,13,264802
11757,0.001344,172.31.36.0-255,66,185009,13,264802
11758,0.001352,172.217.194.0-255,6438,191447,13,264802
11759,0.001354,172.31.36.0-255,66,191513,13,264802
11760,0.001389,172.217.194.0-255,7156,198669,13,264802
11761,0.001392,172.31.36.0-255,66,198735,13,264802
11762,0.001401,172.217.194.0-255,8574,207309,13,264802
11763,0.001403,172.31.36.0-255,66,207375,13,264802
11764,0.001412,172.217.194.0-255,2902,210277,13,264802
11765,0.001415,172.31.36.0-255,66,210343,13,264802
11766,0.001464,172.31.36.0-255,66,210409,13,264802
11767,0.001468,172.217.194.0-255,2184,212593,13,264802
11768,0.00147,172.31.36.0-255,66,212659,13,264802
11769,0.001477,172.217.194.0-255,5738,218397,13,264802
11770,0.001479,172.31.36.0-255,66,218463,13,264802
11771,0.001523,172.31.36.0-255,66,218529,13,264802
11772,0.001533,172.217.194.0-255,10692,229221,13,264802
11773,0.001535,172.31.36.0-255,66,229287,13,264802
11774,0.001569,172.217.194.0-255,9992,239279,13,264802
11775,0.001574,172.31.36.0-255,66,239345,13,264802
11776,0.001593,172.217.194.0-255,9992,249337,13,264802
11777,0.001599,172.31.36.0-255,66,249403,13,264802
11778,0.001636,172.31.36.0-255,66,249469,13,264802
11779,0.001646,172.217.194.0-255,10639,260108,13,264802
11780,0.001653,172.31.36.0-255,66,260174,13,264802
11781,0.001656,172.217.194.0-255,105,260279,13,264802
11782,0.004332,172.31.36.0-255,66,260345,13,264802
11783,0.004372,172.31.36.0-255,105,260450,13,264802
11784,0.006416,172.217.194.0-255,66,260516,13,264802
11785,0.032248,172.31.36.0-255,167,260683,13,264802
11786,0.032282,172.31.36.0-255,1106,261789,13,264802
11787,0.03236,172.31.36.0-255,1514,263303,13,264802
11788,0.032361,172.31.36.0-255,1301,264604,13,264802
11789,0.033794,104.244.42.0-255,66,264670,13,264802
11790,0.033805,104.244.42.0-255,66,264736,13,264802
11791,0.03397,104.244.42.0-255,66,264802,13,264802
11792,0.0,172.217.194.0-255,144,144,13,246639
11793,2.2e-05,172.31.36.0-255,66,210,13,246639
11794,2.9e-05,172.217.194.0-255,1484,1694,13,246639
11795,3.3e-05,172.31.36.0-255,66,1760,13,246639
11796,3.8e-05,172.217.194.0-255,2902,4662,13,246639
11797,4.1e-05,172.31.36.0-255,66,4728,13,246639
11798,4.7e-05,172.217.194.0-255,7156,11884,13,246639
11799,5e-05,172.31.36.0-255,66,11950,13,246639
11800,7.2e-05,172.217.194.0-255,2070,14020,13,246639
11801,7.5e-05,172.31.36.0-255,66,14086,13,246639
11802,0.000872,172.217.194.0-255,1484,15570,13,246639
11803,0.000878,172.31.36.0-255,66,15636,13,246639
11804,0.000899,172.217.194.0-255,2902,18538,13,246639
11805,0.000902,172.31.36.0-255,66,18604,13,246639
11806,0.000905,172.217.194.0-255,1484,20088,13,246639
11807,0.000906,172.31.36.0-255,66,20154,13,246639
11808,0.000912,172.217.194.0-255,4320,24474,13,246639
11809,0.000913,172.31.36.0-255,66,24540,13,246639
11810,0.00093,172.217.194.0-255,1484,26024,13,246639
11811,0.000932,172.31.36.0-255,66,26090,13,246639
11812,0.000979,172.31.36.0-255,66,26156,13,246639
11813,0.000987,172.217.194.0-255,8574,34730,13,246639
11814,0.000989,172.31.36.0-255,66,34796,13,246639
11815,0.001004,172.217.194.0-255,4320,39116,13,246639
11816,0.001006,172.31.36.0-255,66,39182,13,246639
11817,0.001044,172.31.36.0-255,66,39248,13,246639
11818,0.001046,172.217.194.0-255,645,39893,13,246639
11819,0.001048,172.31.36.0-255,66,39959,13,246639
11820,0.00116,172.217.194.0-255,1484,41443,13,246639
11821,0.001163,172.31.36.0-255,66,41509,13,246639
11822,0.001169,172.217.194.0-255,2902,44411,13,246639
11823,0.001171,172.31.36.0-255,66,44477,13,246639
11824,0.00119,172.217.194.0-255,2902,47379,13,246639
11825,0.001192,172.31.36.0-255,66,47445,13,246639
11826,0.001215,172.217.194.0-255,2902,50347,13,246639
11827,0.001218,172.31.36.0-255,66,50413,13,246639
11828,0.001229,172.31.36.0-255,66,50479,13,246639
11829,0.001247,172.217.194.0-255,1484,51963,13,246639
11830,0.001254,172.217.194.0-255,5738,57701,13,246639
11831,0.001256,172.31.36.0-255,66,57767,13,246639
11832,0.001284,172.217.194.0-255,5020,62787,13,246639
11833,0.001287,172.31.36.0-255,66,62853,13,246639
11834,0.001464,172.217.194.0-255,1484,64337,13,246639
11835,0.001477,172.217.194.0-255,2902,67239,13,246639
11836,0.001481,172.31.36.0-255,66,67305,13,246639
11837,0.001484,172.217.194.0-255,1484,68789,13,246639
11838,0.001503,172.217.194.0-255,4320,73109,13,246639
11839,0.001505,172.31.36.0-255,66,73175,13,246639
11840,0.00151,172.217.194.0-255,5738,78913,13,246639
11841,0.001513,172.31.36.0-255,66,78979,13,246639
11842,0.001529,172.217.194.0-255,7156,86135,13,246639
11843,0.001531,172.31.36.0-255,66,86201,13,246639
11844,0.001546,172.217.194.0-255,2902,89103,13,246639
11845,0.001548,172.31.36.0-255,66,89169,13,246639
11846,0.001571,172.31.36.0-255,66,89235,13,246639
11847,0.001577,172.217.194.0-255,5738,94973,13,246639
11848,0.00158,172.31.36.0-255,66,95039,13,246639
11849,0.001612,172.31.36.0-255,66,95105,13,246639
11850,0.001624,172.31.36.0-255,66,95171,13,246639
11851,0.00166,172.217.194.0-255,5738,100909,13,246639
11852,0.001662,172.31.36.0-255,66,100975,13,246639
11853,0.001697,172.31.36.0-255,66,101041,13,246639
11854,0.001749,172.217.194.0-255,9992,111033,13,246639
11855,0.001752,172.31.36.0-255,66,111099,13,246639
11856,0.001785,172.31.36.0-255,66,111165,13,246639
11857,0.001789,172.217.194.0-255,2184,113349,13,246639
11858,0.001791,172.31.36.0-255,66,113415,13,246639
11859,0.001959,172.217.194.0-255,1484,114899,13,246639
11860,0.001963,172.217.194.0-255,2902,117801,13,246639
11861,0.001966,172.31.36.0-255,66,117867,13,246639
11862,0.001989,172.217.194.0-255,1484,119351,13,246639
11863,0.002,172.217.194.0-255,1484,120835,13,246639
11864,0.002003,172.31.36.0-255,66,120901,13,246639
11865,0.002008,172.217.194.0-255,4320,125221,13,246639
11866,0.00201,172.31.36.0-255,66,125287,13,246639
11867,0.002015,172.217.194.0-255,4320,129607,13,246639
11868,0.002017,172.31.36.0-255,66,129673,13,246639
11869,0.002043,172.217.194.0-255,4320,133993,13,246639
11870,0.002045,172.31.36.0-255,66,134059,13,246639
11871,0.00205,172.217.194.0-255,2902,136961,13,246639
11872,0.002052,172.31.36.0-255,66,137027,13,246639
11873,0.002077,172.217.194.0-255,10692,147719,13,246639
11874,0.002079,172.31.36.0-255,66,147785,13,246639
11875,0.002126,172.217.194.0-255,1484,149269,13,246639
11876,0.002129,172.217.194.0-255,1484,150753,13,246639
11877,0.002131,172.31.36.0-255,66,150819,13,246639
11878,0.002143,172.217.194.0-255,1484,152303,13,246639
11879,0.002163,172.217.194.0-255,2902,155205,13,246639
11880,0.002165,172.31.36.0-255,66,155271,13,246639
11881,0.002183,172.217.194.0-255,2902,158173,13,246639
11882,0.002185,172.31.36.0-255,66,158239,13,246639
11883,0.002194,172.217.194.0-255,9992,168231,13,246639
11884,0.002196,172.31.36.0-255,66,168297,13,246639
11885,0.002221,172.217.194.0-255,2902,171199,13,246639
11886,0.002223,172.31.36.0-255,66,171265,13,246639
11887,0.002231,172.217.194.0-255,8574,179839,13,246639
11888,0.002243,172.217.194.0-255,2184,182023,13,246639
11889,0.002264,172.217.194.0-255,9992,192015,13,246639
11890,0.002301,172.217.194.0-255,7856,199871,13,246639
11891,0.002313,172.217.194.0-255,1484,201355,13,246639
11892,0.002333,172.217.194.0-255,8574,209929,13,246639
11893,0.002338,172.217.194.0-255,2902,212831,13,246639
11894,0.002359,172.217.194.0-255,8574,221405,13,246639
11895,0.002362,172.217.194.0-255,1484,222889,13,246639
11896,0.002374,172.217.194.0-255,4320,227209,13,246639
11897,0.00239,172.217.194.0-255,6438,233647,13,246639
11898,0.002425,172.217.194.0-255,8362,242009,13,246639
11899,0.002428,172.217.194.0-255,105,242114,13,246639
11900,0.008534,172.31.36.0-255,66,242180,13,246639
11901,0.011576,172.31.36.0-255,105,242285,13,246639
11902,0.014213,172.217.194.0-255,66,242351,13,246639
11903,0.034177,172.31.36.0-255,171,242522,13,246639
11904,0.034213,172.31.36.0-255,1134,243656,13,246639
11905,0.034278,172.31.36.0-255,1514,245170,13,246639
11906,0.03428,172.31.36.0-255,1271,246441,13,246639
11907,0.035715,104.244.42.0-255,66,246507,13,246639
11908,0.035868,104.244.42.0-255,66,246573,13,246639
11909,0.03591,104.244.42.0-255,66,246639,13,246639
11910,0.0,74.125.200.0-255,66,66,13,66
11911,0.0,74.125.130.0-255,153,153,13,350118
11912,2e-05,172.31.36.0-255,66,219,13,350118
11913,5.4e-05,74.125.130.0-255,1484,1703,13,350118
11914,5.9e-05,172.31.36.0-255,66,1769,13,350118
11915,6.6e-05,74.125.130.0-255,2902,4671,13,350118
11916,7e-05,172.31.36.0-255,66,4737,13,350118
11917,7.3e-05,74.125.130.0-255,1484,6221,13,350118
11918,7.6e-05,172.31.36.0-255,66,6287,13,350118
11919,0.000107,74.125.130.0-255,2902,9189,13,350118
11920,0.00011,172.31.36.0-255,66,9255,13,350118
11921,0.000129,74.125.130.0-255,4855,14110,13,350118
11922,0.000132,172.31.36.0-255,66,14176,13,350118
11923,0.000316,74.125.130.0-255,1484,15660,13,350118
11924,0.000321,172.31.36.0-255,66,15726,13,350118
11925,0.000328,74.125.130.0-255,2902,18628,13,350118
11926,0.00033,172.31.36.0-255,66,18694,13,350118
11927,0.000358,74.125.130.0-255,5738,24432,13,350118
11928,0.000362,172.31.36.0-255,66,24498,13,350118
11929,0.000389,74.125.130.0-255,4320,28818,13,350118
11930,0.000392,172.31.36.0-255,66,28884,13,350118
11931,0.000419,74.125.130.0-255,5379,34263,13,350118
11932,0.000422,172.31.36.0-255,66,34329,13,350118
11933,0.000426,74.125.130.0-255,2902,37231,13,350118
11934,0.000428,172.31.36.0-255,66,37297,13,350118
11935,0.000431,74.125.130.0-255,1484,38781,13,350118
11936,0.000433,172.31.36.0-255,66,38847,13,350118
11937,0.000466,74.125.130.0-255,2902,41749,13,350118
11938,0.000469,172.31.36.0-255,66,41815,13,350118
11939,0.000487,74.125.130.0-255,4320,46135,13,350118
11940,0.00049,172.31.36.0-255,66,46201,13,350118
11941,0.000515,74.125.130.0-255,2543,48744,13,350118
11942,0.000518,172.31.36.0-255,66,48810,13,350118
11943,0.000866,74.125.130.0-255,1484,50294,13,350118
11944,0.000872,74.125.130.0-255,1484,51778,13,350118
11945,0.000876,172.31.36.0-255,66,51844,13,350118
11946,0.000908,74.125.130.0-255,2902,54746,13,350118
11947,0.000914,74.125.130.0-255,5738,60484,13,350118
11948,0.000918,172.31.36.0-255,66,60550,13,350118
11949,0.000928,172.31.36.0-255,66,60616,13,350118
11950,0.000939,74.125.130.0-255,5379,65995,13,350118
11951,0.000941,172.31.36.0-255,66,66061,13,350118
11952,0.001236,74.125.130.0-255,1484,67545,13,350118
11953,0.001245,74.125.130.0-255,2902,70447,13,350118
11954,0.001249,172.31.36.0-255,66,70513,13,350118
11955,0.001291,74.125.130.0-255,2902,73415,13,350118
11956,0.001295,172.31.36.0-255,66,73481,13,350118
11957,0.001343,74.125.130.0-255,4320,77801,13,350118
11958,0.001346,172.31.36.0-255,66,77867,13,350118
11959,0.001391,74.125.130.0-255,5738,83605,13,350118
11960,0.001395,172.31.36.0-255,66,83671,13,350118
11961,0.001451,74.125.130.0-255,5738,89409,13,350118
11962,0.001454,172.31.36.0-255,66,89475,13,350118
11963,0.001485,74.125.130.0-255,7156,96631,13,350118
11964,0.001487,172.31.36.0-255,66,96697,13,350118
11965,0.001492,74.125.130.0-255,2902,99599,13,350118
11966,0.001495,172.31.36.0-255,66,99665,13,350118
11967,0.00153,74.125.130.0-255,766,100431,13,350118
11968,0.003546,74.125.130.0-255,4320,104751,13,350118
11969,0.003554,172.31.36.0-255,66,104817,13,350118
11970,0.005625,74.125.130.0-255,5738,110555,13,350118
11971,0.005633,172.31.36.0-255,66,110621,13,350118
11972,0.007681,74.125.130.0-255,5738,116359,13,350118
11973,0.007685,172.31.36.0-255,66,116425,13,350118
11974,0.009739,74.125.130.0-255,5738,122163,13,350118
11975,0.009747,172.31.36.0-255,66,122229,13,350118
11976,0.0118,74.125.130.0-255,5738,127967,13,350118
11977,0.01181,172.31.36.0-255,66,128033,13,350118
11978,0.013862,74.125.130.0-255,5738,133771,13,350118
11979,0.013869,172.31.36.0-255,66,133837,13,350118
11980,0.015942,74.125.130.0-255,5738,139575,13,350118
11981,0.015951,172.31.36.0-255,66,139641,13,350118
11982,0.01802,74.125.130.0-255,5738,145379,13,350118
11983,0.018032,172.31.36.0-255,66,145445,13,350118
11984,0.020117,74.125.130.0-255,5738,151183,13,350118
11985,0.020126,172.31.36.0-255,66,151249,13,350118
11986,0.022184,74.125.130.0-255,5738,156987,13,350118
11987,0.022192,172.31.36.0-255,66,157053,13,350118
11988,0.024241,74.125.130.0-255,5738,162791,13,350118
11989,0.024249,172.31.36.0-255,66,162857,13,350118
11990,0.026293,74.125.130.0-255,5738,168595,13,350118
11991,0.0263,172.31.36.0-255,66,168661,13,350118
11992,0.026478,172.31.36.0-255,172,168833,13,350118
11993,0.026507,172.31.36.0-255,1106,169939,13,350118
11994,0.026629,172.31.36.0-255,1514,171453,13,350118
11995,0.026632,172.31.36.0-255,1514,172967,13,350118
11996,0.026633,172.31.36.0-255,1514,174481,13,350118
11997,0.026634,172.31.36.0-255,1079,175560,13,350118
11998,0.028065,104.244.42.0-255,66,175626,13,350118
11999,0.028073,104.244.42.0-255,66,175692,13,350118
12000,0.028241,104.244.42.0-255,66,175758,13,350118
12001,0.028267,104.244.42.0-255,66,175824,13,350118
12002,0.028353,74.125.130.0-255,5738,181562,13,350118
12003,0.028358,172.31.36.0-255,66,181628,13,350118
12004,0.028837,104.244.42.0-255,108,181736,13,350118
12005,0.028846,172.31.36.0-255,66,181802,13,350118
12006,0.030395,74.125.130.0-255,5738,187540,13,350118
12007,0.0304,172.31.36.0-255,66,187606,13,350118
12008,0.032455,74.125.130.0-255,5738,193344,13,350118
12009,0.032462,172.31.36.0-255,66,193410,13,350118
12010,0.03452,74.125.130.0-255,5738,199148,13,350118
12011,0.034527,172.31.36.0-255,66,199214,13,350118
12012,0.036585,74.125.130.0-255,5738,204952,13,350118
12013,0.036592,172.31.36.0-255,66,205018,13,350118
12014,0.038657,74.125.130.0-255,5738,210756,13,350118
12015,0.038664,172.31.36.0-255,66,210822,13,350118
12016,0.040737,74.125.130.0-255,5738,216560,13,350118
12017,0.040745,172.31.36.0-255,66,216626,13,350118
12018,0.0428,74.125.130.0-255,5738,222364,13,350118
12019,0.042809,172.31.36.0-255,66,222430,13,350118
12020,0.04486,74.125.130.0-255,5738,228168,13,350118
12021,0.044868,172.31.36.0-255,66,228234,13,350118
12022,0.046935,74.125.130.0-255,5738,233972,13,350118
12023,0.046944,172.31.36.0-255,66,234038,13,350118
12024,0.048994,74.125.130.0-255,5738,239776,13,350118
12025,0.049,172.31.36.0-255,66,239842,13,350118
12026,0.051042,74.125.130.0-255,5738,245580,13,350118
12027,0.051048,172.31.36.0-255,66,245646,13,350118
12028,0.05311,74.125.130.0-255,5738,251384,13,350118
12029,0.053117,172.31.36.0-255,66,251450,13,350118
12030,0.055168,74.125.130.0-255,5738,257188,13,350118
12031,0.055174,172.31.36.0-255,66,257254,13,350118
12032,0.057235,74.125.130.0-255,5738,262992,13,350118
12033,0.057242,172.31.36.0-255,66,263058,13,350118
12034,0.059296,74.125.130.0-255,5738,268796,13,350118
12035,0.059302,172.31.36.0-255,66,268862,13,350118
12036,0.061369,74.125.130.0-255,5738,274600,13,350118
12037,0.061375,172.31.36.0-255,66,274666,13,350118
12038,0.063431,74.125.130.0-255,5738,280404,13,350118
12039,0.063438,172.31.36.0-255,66,280470,13,350118
12040,0.065495,74.125.130.0-255,5738,286208,13,350118
12041,0.065501,172.31.36.0-255,66,286274,13,350118
12042,0.067556,74.125.130.0-255,5738,292012,13,350118
12043,0.067562,172.31.36.0-255,66,292078,13,350118
12044,0.069612,74.125.130.0-255,5738,297816,13,350118
12045,0.069619,172.31.36.0-255,66,297882,13,350118
12046,0.071659,74.125.130.0-255,5738,303620,13,350118
12047,0.071667,172.31.36.0-255,66,303686,13,350118
12048,0.073724,74.125.130.0-255,5738,309424,13,350118
12049,0.07373,172.31.36.0-255,66,309490,13,350118
12050,0.075792,74.125.130.0-255,5738,315228,13,350118
12051,0.075799,172.31.36.0-255,66,315294,13,350118
12052,0.077854,74.125.130.0-255,5738,321032,13,350118
12053,0.077861,172.31.36.0-255,66,321098,13,350118
12054,0.079917,74.125.130.0-255,5738,326836,13,350118
12055,0.079923,172.31.36.0-255,66,326902,13,350118
12056,0.082006,74.125.130.0-255,5738,332640,13,350118
12057,0.082013,172.31.36.0-255,66,332706,13,350118
12058,0.084071,74.125.130.0-255,5738,338444,13,350118
12059,0.084078,172.31.36.0-255,66,338510,13,350118
12060,0.086175,74.125.130.0-255,5738,344248,13,350118
12061,0.086182,172.31.36.0-255,66,344314,13,350118
12062,0.088245,74.125.130.0-255,5738,350052,13,350118
12063,0.088252,172.31.36.0-255,66,350118,13,350118
12064,0.0,74.125.24.0-255,151,151,13,379899
12065,1.5e-05,172.31.36.0-255,66,217,13,379899
12066,2e-05,74.125.24.0-255,1484,1701,13,379899
12067,2.4e-05,172.31.36.0-255,66,1767,13,379899
12068,2.8e-05,74.125.24.0-255,1484,3251,13,379899
12069,3e-05,172.31.36.0-255,66,3317,13,379899
12070,4.7e-05,74.125.24.0-255,1484,4801,13,379899
12071,4.9e-05,172.31.36.0-255,66,4867,13,379899
12072,6.5e-05,74.125.24.0-255,2902,7769,13,379899
12073,6.8e-05,172.31.36.0-255,66,7835,13,379899
12074,9.8e-05,74.125.24.0-255,4320,12155,13,379899
12075,0.000101,172.31.36.0-255,66,12221,13,379899
12076,0.000105,74.125.24.0-255,2011,14232,13,379899
12077,0.000107,172.31.36.0-255,66,14298,13,379899
12078,0.000223,74.125.24.0-255,1484,15782,13,379899
12079,0.000227,172.31.36.0-255,66,15848,13,379899
12080,0.000257,74.125.24.0-255,2902,18750,13,379899
12081,0.00026,172.31.36.0-255,66,18816,13,379899
12082,0.000264,74.125.24.0-255,1484,20300,13,379899
12083,0.000266,172.31.36.0-255,66,20366,13,379899
12084,0.000284,74.125.24.0-255,4320,24686,13,379899
12085,0.000286,172.31.36.0-255,66,24752,13,379899
12086,0.000293,74.125.24.0-255,5738,30490,13,379899
12087,0.000295,172.31.36.0-255,66,30556,13,379899
12088,0.000324,74.125.24.0-255,1125,31681,13,379899
12089,0.000327,172.31.36.0-255,66,31747,13,379899
12090,0.000684,74.125.24.0-255,1484,33231,13,379899
12091,0.000688,172.31.36.0-255,66,33297,13,379899
12092,0.000694,74.125.24.0-255,2902,36199,13,379899
12093,0.000697,172.31.36.0-255,66,36265,13,379899
12094,0.000703,74.125.24.0-255,5738,42003,13,379899
12095,0.000706,172.31.36.0-255,66,42069,13,379899
12096,0.000742,74.125.24.0-255,1484,43553,13,379899
12097,0.000788,172.31.36.0-255,66,43619,13,379899
12098,0.000803,74.125.24.0-255,4320,47939,13,379899
12099,0.000821,74.125.24.0-255,5688,53627,13,379899
12100,0.000828,172.31.36.0-255,66,53693,13,379899
12101,0.001006,74.125.24.0-255,345,54038,13,379899
12102,0.001084,172.31.36.0-255,66,54104,13,379899
12103,0.001105,74.125.24.0-255,1484,55588,13,379899
12104,0.001127,74.125.24.0-255,2902,58490,13,379899
12105,0.001131,74.125.24.0-255,1484,59974,13,379899
12106,0.001145,74.125.24.0-255,4320,64294,13,379899
12107,0.001163,74.125.24.0-255,2902,67196,13,379899
12108,0.001168,172.31.36.0-255,66,67262,13,379899
12109,0.001249,74.125.24.0-255,3961,71223,13,379899
12110,0.001264,172.31.36.0-255,66,71289,13,379899
12111,0.001313,74.125.24.0-255,1484,72773,13,379899
12112,0.00133,74.125.24.0-255,2902,75675,13,379899
12113,0.001343,74.125.24.0-255,2902,78577,13,379899
12114,0.001357,74.125.24.0-255,2902,81479,13,379899
12115,0.00136,74.125.24.0-255,1484,82963,13,379899
12116,0.001367,172.31.36.0-255,66,83029,13,379899
12117,0.001383,74.125.24.0-255,5379,88408,13,379899
12118,0.00139,74.125.24.0-255,7156,95564,13,379899
12119,0.001402,172.31.36.0-255,66,95630,13,379899
12120,0.001416,74.125.24.0-255,7156,102786,13,379899
12121,0.001424,74.125.24.0-255,7156,109942,13,379899
12122,0.001426,74.125.24.0-255,1484,111426,13,379899
12123,0.00143,172.31.36.0-255,66,111492,13,379899
12124,0.001458,74.125.24.0-255,7156,118648,13,379899
12125,0.001463,74.125.24.0-255,3602,122250,13,379899
12126,0.001489,74.125.24.0-255,4320,126570,13,379899
12127,0.001522,172.31.36.0-255,66,126636,13,379899
12128,0.00154,74.125.24.0-255,9992,136628,13,379899
12129,0.001546,74.125.24.0-255,5738,142366,13,379899
12130,0.001563,74.125.24.0-255,7156,149522,13,379899
12131,0.001573,172.31.36.0-255,66,149588,13,379899
12132,0.001582,74.125.24.0-255,2902,152490,13,379899
12133,0.001587,172.31.36.0-255,66,152556,13,379899
12134,0.001642,74.125.24.0-255,3602,156158,13,379899
12135,0.001669,172.31.36.0-255,66,156224,13,379899
12136,0.001905,74.125.24.0-255,1484,157708,13,379899
12137,0.001925,74.125.24.0-255,2902,160610,13,379899
12138,0.001928,172.31.36.0-255,66,160676,13,379899
12139,0.001951,74.125.24.0-255,5738,166414,13,379899
12140,0.001969,172.31.36.0-255,66,166480,13,379899
12141,0.001993,74.125.24.0-255,9992,176472,13,379899
12142,0.002009,172.31.36.0-255,66,176538,13,379899
12143,0.002019,74.125.24.0-255,4320,180858,13,379899
12144,0.002043,74.125.24.0-255,7156,188014,13,379899
12145,0.002051,172.31.36.0-255,66,188080,13,379899
12146,0.002071,74.125.24.0-255,2184,190264,13,379899
12147,0.002075,172.31.36.0-255,66,190330,13,379899
12148,0.00234,74.125.24.0-255,1484,191814,13,379899
12149,0.002347,74.125.24.0-255,2902,194716,13,379899
12150,0.00235,172.31.36.0-255,66,194782,13,379899
12151,0.002374,74.125.24.0-255,5738,200520,13,379899
12152,0.002377,74.125.24.0-255,1484,202004,13,379899
12153,0.002397,74.125.24.0-255,8574,210578,13,379899
12154,0.002416,172.31.36.0-255,66,210644,13,379899
12155,0.002425,74.125.24.0-255,2902,213546,13,379899
12156,0.002435,74.125.24.0-255,10692,224238,13,379899
12157,0.002441,172.31.36.0-255,66,224304,13,379899
12158,0.002484,74.125.24.0-255,1484,225788,13,379899
12159,0.002502,74.125.24.0-255,2902,228690,13,379899
12160,0.002506,74.125.24.0-255,2902,231592,13,379899
12161,0.002515,172.31.36.0-255,66,231658,13,379899
12162,0.00252,74.125.24.0-255,2902,234560,13,379899
12163,0.002525,172.31.36.0-255,66,234626,13,379899
12164,0.002534,74.125.24.0-255,2902,237528,13,379899
12165,0.002558,74.125.24.0-255,9992,247520,13,379899
12166,0.002562,74.125.24.0-255,2902,250422,13,379899
12167,0.002582,74.125.24.0-255,7856,258278,13,379899
12168,0.003365,172.31.36.0-255,66,258344,13,379899
12169,0.005984,74.125.24.0-255,5738,264082,13,379899
12170,0.005993,172.31.36.0-255,66,264148,13,379899
12171,0.008552,74.125.24.0-255,5738,269886,13,379899
12172,0.008559,172.31.36.0-255,66,269952,13,379899
12173,0.01115,74.125.24.0-255,5738,275690,13,379899
12174,0.011157,172.31.36.0-255,66,275756,13,379899
12175,0.013833,74.125.24.0-255,5738,281494,13,379899
12176,0.013842,172.31.36.0-255,66,281560,13,379899
12177,0.016467,74.125.24.0-255,5738,287298,13,379899
12178,0.016477,172.31.36.0-255,66,287364,13,379899
12179,0.019089,74.125.24.0-255,5738,293102,13,379899
12180,0.019097,172.31.36.0-255,66,293168,13,379899
12181,0.021724,74.125.24.0-255,5738,298906,13,379899
12182,0.021737,172.31.36.0-255,66,298972,13,379899
12183,0.024377,74.125.24.0-255,5738,304710,13,379899
12184,0.024387,172.31.36.0-255,66,304776,13,379899
12185,0.027063,74.125.24.0-255,5738,310514,13,379899
12186,0.027071,172.31.36.0-255,66,310580,13,379899
12187,0.029668,74.125.24.0-255,5738,316318,13,379899
12188,0.029676,172.31.36.0-255,66,316384,13,379899
12189,0.032271,74.125.24.0-255,5738,322122,13,379899
12190,0.032278,172.31.36.0-255,66,322188,13,379899
12191,0.0331,172.31.36.0-255,171,322359,13,379899
12192,0.033129,172.31.36.0-255,1106,323465,13,379899
12193,0.033192,172.31.36.0-255,1514,324979,13,379899
12194,0.033194,172.31.36.0-255,1514,326493,13,379899
12195,0.033195,172.31.36.0-255,1514,328007,13,379899
12196,0.033196,172.31.36.0-255,1079,329086,13,379899
12197,0.034637,104.244.42.0-255,66,329152,13,379899
12198,0.034684,104.244.42.0-255,66,329218,13,379899
12199,0.034766,104.244.42.0-255,66,329284,13,379899
12200,0.034772,104.244.42.0-255,66,329350,13,379899
12201,0.034908,74.125.24.0-255,5738,335088,13,379899
12202,0.034914,172.31.36.0-255,66,335154,13,379899
12203,0.035972,104.244.42.0-255,108,335262,13,379899
12204,0.035982,172.31.36.0-255,66,335328,13,379899
12205,0.037488,74.125.24.0-255,5738,341066,13,379899
12206,0.037494,172.31.36.0-255,66,341132,13,379899
12207,0.040095,74.125.24.0-255,5738,346870,13,379899
12208,0.040101,172.31.36.0-255,66,346936,13,379899
12209,0.042716,74.125.24.0-255,5738,352674,13,379899
12210,0.042726,172.31.36.0-255,66,352740,13,379899
12211,0.045354,74.125.24.0-255,5738,358478,13,379899
12212,0.045361,172.31.36.0-255,66,358544,13,379899
12213,0.047972,74.125.24.0-255,5738,364282,13,379899
12214,0.047979,172.31.36.0-255,66,364348,13,379899
12215,0.050588,74.125.24.0-255,5738,370086,13,379899
12216,0.050594,172.31.36.0-255,66,370152,13,379899
12217,0.05321,74.125.24.0-255,5738,375890,13,379899
12218,0.053217,172.31.36.0-255,66,375956,13,379899
12219,0.05587,74.125.24.0-255,3706,379662,13,379899
12220,0.055877,172.31.36.0-255,66,379728,13,379899
12221,0.05606,172.31.36.0-255,105,379833,13,379899
12222,0.058597,74.125.24.0-255,66,379899,13,379899
12223,0.0,172.217.194.0-255,153,153,13,311967
12224,3.2e-05,172.217.194.0-255,1484,1637,13,311967
12225,4.2e-05,172.31.36.0-255,66,1703,13,311967
12226,5e-05,172.217.194.0-255,2902,4605,13,311967
12227,5.3e-05,172.31.36.0-255,66,4671,13,311967
12228,6.9e-05,172.217.194.0-255,7156,11827,13,311967
12229,7.2e-05,172.31.36.0-255,66,11893,13,311967
12230,7.6e-05,172.217.194.0-255,1991,13884,13,311967
12231,7.9e-05,172.31.36.0-255,66,13950,13,311967
12232,0.000118,172.217.194.0-255,1484,15434,13,311967
12233,0.000121,172.217.194.0-255,1484,16918,13,311967
12234,0.000125,172.31.36.0-255,66,16984,13,311967
12235,0.000147,172.217.194.0-255,1484,18468,13,311967
12236,0.000154,172.217.194.0-255,5738,24206,13,311967
12237,0.000157,172.31.36.0-255,66,24272,13,311967
12238,0.000161,172.217.194.0-255,2902,27174,13,311967
12239,0.000163,172.31.36.0-255,66,27240,13,311967
12240,0.0002,172.217.194.0-255,1484,28724,13,311967
12241,0.000227,172.217.194.0-255,9633,38357,13,311967
12242,0.00023,172.31.36.0-255,66,38423,13,311967
12243,0.000257,172.217.194.0-255,4320,42743,13,311967
12244,0.000261,172.31.36.0-255,66,42809,13,311967
12245,0.000289,172.217.194.0-255,5379,48188,13,311967
12246,0.000292,172.31.36.0-255,66,48254,13,311967
12247,0.000324,172.217.194.0-255,7156,55410,13,311967
12248,0.000328,172.31.36.0-255,66,55476,13,311967
12249,0.000334,172.217.194.0-255,5738,61214,13,311967
12250,0.000336,172.31.36.0-255,66,61280,13,311967
12251,0.000355,172.217.194.0-255,2902,64182,13,311967
12252,0.000364,172.31.36.0-255,66,64248,13,311967
12253,0.000367,172.217.194.0-255,1125,65373,13,311967
12254,0.000392,172.217.194.0-255,645,66018,13,311967
12255,0.000395,172.31.36.0-255,66,66084,13,311967
12256,0.000406,172.217.194.0-255,1484,67568,13,311967
12257,0.000415,172.217.194.0-255,2902,70470,13,311967
12258,0.000418,172.31.36.0-255,66,70536,13,311967
12259,0.000443,172.217.194.0-255,1484,72020,13,311967
12260,0.000454,172.217.194.0-255,9992,82012,13,311967
12261,0.000458,172.31.36.0-255,66,82078,13,311967
12262,0.000461,172.217.194.0-255,1125,83203,13,311967
12263,0.000511,172.217.194.0-255,5738,88941,13,311967
12264,0.000515,172.31.36.0-255,66,89007,13,311967
12265,0.000542,172.217.194.0-255,7156,96163,13,311967
12266,0.000546,172.31.36.0-255,66,96229,13,311967
12267,0.000552,172.217.194.0-255,3961,100190,13,311967
12268,0.000554,172.31.36.0-255,66,100256,13,311967
12269,0.000993,172.217.194.0-255,1484,101740,13,311967
12270,0.001012,172.217.194.0-255,2902,104642,13,311967
12271,0.001016,172.31.36.0-255,66,104708,13,311967
12272,0.001023,172.217.194.0-255,5738,110446,13,311967
12273,0.001025,172.31.36.0-255,66,110512,13,311967
12274,0.001072,172.31.36.0-255,66,110578,13,311967
12275,0.001078,172.217.194.0-255,4320,114898,13,311967
12276,0.00108,172.31.36.0-255,66,114964,13,311967
12277,0.001109,172.217.194.0-255,6438,121402,13,311967
12278,0.001112,172.31.36.0-255,66,121468,13,311967
12279,0.001163,172.217.194.0-255,1484,122952,13,311967
12280,0.001168,172.217.194.0-255,2902,125854,13,311967
12281,0.001172,172.31.36.0-255,66,125920,13,311967
12282,0.001179,172.217.194.0-255,5738,131658,13,311967
12283,0.001183,172.31.36.0-255,66,131724,13,311967
12284,0.001204,172.217.194.0-255,2902,134626,13,311967
12285,0.001208,172.31.36.0-255,66,134692,13,311967
12286,0.001239,172.217.194.0-255,9992,144684,13,311967
12287,0.001247,172.31.36.0-255,66,144750,13,311967
12288,0.001255,172.217.194.0-255,7156,151906,13,311967
12289,0.001257,172.31.36.0-255,66,151972,13,311967
12290,0.001291,172.217.194.0-255,3602,155574,13,311967
12291,0.001294,172.31.36.0-255,66,155640,13,311967
12292,0.001326,172.217.194.0-255,1484,157124,13,311967
12293,0.001329,172.217.194.0-255,1484,158608,13,311967
12294,0.001332,172.31.36.0-255,66,158674,13,311967
12295,0.001356,172.217.194.0-255,1484,160158,13,311967
12296,0.001362,172.217.194.0-255,5738,165896,13,311967
12297,0.001366,172.31.36.0-255,66,165962,13,311967
12298,0.001397,172.217.194.0-255,9992,175954,13,311967
12299,0.001401,172.31.36.0-255,66,176020,13,311967
12300,0.001432,172.217.194.0-255,5738,181758,13,311967
12301,0.001435,172.31.36.0-255,66,181824,13,311967
12302,0.001467,172.217.194.0-255,7856,189680,13,311967
12303,0.00147,172.31.36.0-255,66,189746,13,311967
12304,0.001555,172.217.194.0-255,1484,191230,13,311967
12305,0.00156,172.217.194.0-255,2902,194132,13,311967
12306,0.001563,172.31.36.0-255,66,194198,13,311967
12307,0.001567,172.217.194.0-255,1484,195682,13,311967
12308,0.001595,172.217.194.0-255,4320,200002,13,311967
12309,0.001598,172.31.36.0-255,66,200068,13,311967
12310,0.001603,172.217.194.0-255,2902,202970,13,311967
12311,0.001605,172.31.36.0-255,66,203036,13,311967
12312,0.001636,172.217.194.0-255,9992,213028,13,311967
12313,0.00164,172.31.36.0-255,66,213094,13,311967
12314,0.001647,172.217.194.0-255,7156,220250,13,311967
12315,0.00165,172.31.36.0-255,66,220316,13,311967
12316,0.001654,172.217.194.0-255,3602,223918,13,311967
12317,0.001657,172.31.36.0-255,66,223984,13,311967
12318,0.00169,172.217.194.0-255,4320,228304,13,311967
12319,0.001694,172.31.36.0-255,66,228370,13,311967
12320,0.0017,172.217.194.0-255,4320,232690,13,311967
12321,0.001702,172.31.36.0-255,66,232756,13,311967
12322,0.001736,172.217.194.0-255,5738,238494,13,311967
12323,0.001739,172.31.36.0-255,66,238560,13,311967
12324,0.001751,172.217.194.0-255,7156,245716,13,311967
12325,0.001759,172.31.36.0-255,66,245782,13,311967
12326,0.001773,172.31.36.0-255,66,245848,13,311967
12327,0.001815,172.31.36.0-255,66,245914,13,311967
12328,0.001884,172.31.36.0-255,66,245980,13,311967
12329,0.001892,172.217.194.0-255,6438,252418,13,311967
12330,0.001894,172.31.36.0-255,66,252484,13,311967
12331,0.001936,172.217.194.0-255,7156,259640,13,311967
12332,0.00194,172.31.36.0-255,66,259706,13,311967
12333,0.001949,172.217.194.0-255,8574,268280,13,311967
12334,0.001957,172.31.36.0-255,66,268346,13,311967
12335,0.001996,172.217.194.0-255,2902,271248,13,311967
12336,0.002001,172.31.36.0-255,66,271314,13,311967
12337,0.00204,172.31.36.0-255,66,271380,13,311967
12338,0.002043,172.217.194.0-255,766,272146,13,311967
12339,0.002046,172.217.194.0-255,1484,273630,13,311967
12340,0.002048,172.31.36.0-255,66,273696,13,311967
12341,0.002052,172.217.194.0-255,2902,276598,13,311967
12342,0.002064,172.31.36.0-255,66,276664,13,311967
12343,0.002069,172.217.194.0-255,4320,280984,13,311967
12344,0.002071,172.31.36.0-255,66,281050,13,311967
12345,0.002121,172.31.36.0-255,66,281116,13,311967
12346,0.002127,172.217.194.0-255,5738,286854,13,311967
12347,0.002129,172.31.36.0-255,66,286920,13,311967
12348,0.002156,172.217.194.0-255,1484,288404,13,311967
12349,0.002179,172.217.194.0-255,6438,294842,13,311967
12350,0.002183,172.31.36.0-255,66,294908,13,311967
12351,0.002191,172.217.194.0-255,8574,303482,13,311967
12352,0.002193,172.31.36.0-255,66,303548,13,311967
12353,0.002202,172.217.194.0-255,931,304479,13,311967
12354,0.002205,172.217.194.0-255,97,304576,13,311967
12355,0.002267,172.217.194.0-255,105,304681,13,311967
12356,0.003383,172.31.36.0-255,66,304747,13,311967
12357,0.003408,172.31.36.0-255,105,304852,13,311967
12358,0.005314,172.217.194.0-255,66,304918,13,311967
12359,0.02749,172.31.36.0-255,172,305090,13,311967
12360,0.027522,172.31.36.0-255,1109,306199,13,311967
12361,0.02756,172.31.36.0-255,1514,307713,13,311967
12362,0.027561,172.31.36.0-255,1514,309227,13,311967
12363,0.027567,172.31.36.0-255,1514,310741,13,311967
12364,0.027568,172.31.36.0-255,962,311703,13,311967
12365,0.029026,104.244.42.0-255,66,311769,13,311967
12366,0.029054,104.244.42.0-255,66,311835,13,311967
12367,0.029109,104.244.42.0-255,66,311901,13,311967
12368,0.029112,104.244.42.0-255,66,311967,13,311967
12369,0.0,172.217.194.0-255,307,307,13,244149
12370,3e-05,172.217.194.0-255,1484,1791,13,244149
12371,4.1e-05,172.31.36.0-255,66,1857,13,244149
12372,5e-05,172.217.194.0-255,4320,6177,13,244149
12373,5.3e-05,172.31.36.0-255,66,6243,13,244149
12374,6.8e-05,172.217.194.0-255,7512,13755,13,244149
12375,7.1e-05,172.31.36.0-255,66,13821,13,244149
12376,7.7e-05,172.217.194.0-255,4320,18141,13,244149
12377,7.9e-05,172.31.36.0-255,66,18207,13,244149
12378,0.000118,172.217.194.0-255,9992,28199,13,244149
12379,0.000121,172.31.36.0-255,66,28265,13,244149
12380,0.000126,172.217.194.0-255,2543,30808,13,244149
12381,0.00013,172.31.36.0-255,66,30874,13,244149
12382,0.000134,172.217.194.0-255,2902,33776,13,244149
12383,0.000136,172.31.36.0-255,66,33842,13,244149
12384,0.000147,172.217.194.0-255,4320,38162,13,244149
12385,0.00015,172.31.36.0-255,66,38228,13,244149
12386,0.000158,172.217.194.0-255,7156,45384,13,244149
12387,0.00016,172.31.36.0-255,66,45450,13,244149
12388,0.000197,172.217.194.0-255,1484,46934,13,244149
12389,0.000216,172.31.36.0-255,66,47000,13,244149
12390,0.00022,172.217.194.0-255,118,47118,13,244149
12391,0.000302,172.217.194.0-255,381,47499,13,244149
12392,0.000454,172.217.194.0-255,1484,48983,13,244149
12393,0.000459,172.31.36.0-255,66,49049,13,244149
12394,0.000466,172.217.194.0-255,2902,51951,13,244149
12395,0.000467,172.31.36.0-255,66,52017,13,244149
12396,0.000482,172.217.194.0-255,5738,57755,13,244149
12397,0.000484,172.31.36.0-255,66,57821,13,244149
12398,0.000491,172.217.194.0-255,4320,62141,13,244149
12399,0.000493,172.31.36.0-255,66,62207,13,244149
12400,0.000532,172.217.194.0-255,8574,70781,13,244149
12401,0.000537,172.31.36.0-255,66,70847,13,244149
12402,0.000574,172.217.194.0-255,4320,75167,13,244149
12403,0.000577,172.31.36.0-255,66,75233,13,244149
12404,0.00061,172.217.194.0-255,6438,81671,13,244149
12405,0.000616,172.31.36.0-255,66,81737,13,244149
12406,0.000622,172.31.36.0-255,66,81803,13,244149
12407,0.000629,172.217.194.0-255,7156,88959,13,244149
12408,0.000631,172.31.36.0-255,66,89025,13,244149
12409,0.000653,172.217.194.0-255,5738,94763,13,244149
12410,0.000661,172.31.36.0-255,66,94829,13,244149
12411,0.00067,172.217.194.0-255,9274,104103,13,244149
12412,0.000673,172.31.36.0-255,66,104169,13,244149
12413,0.000713,172.217.194.0-255,1484,105653,13,244149
12414,0.000718,172.217.194.0-255,2902,108555,13,244149
12415,0.000721,172.217.194.0-255,1484,110039,13,244149
12416,0.000722,172.31.36.0-255,66,110105,13,244149
12417,0.000737,172.217.194.0-255,4320,114425,13,244149
12418,0.000745,172.31.36.0-255,66,114491,13,244149
12419,0.00078,172.217.194.0-255,8574,123065,13,244149
12420,0.000783,172.31.36.0-255,66,123131,13,244149
12421,0.000813,172.217.194.0-255,2902,126033,13,244149
12422,0.000817,172.31.36.0-255,66,126099,13,244149
12423,0.000857,172.31.36.0-255,66,126165,13,244149
12424,0.00086,172.217.194.0-255,1484,127649,13,244149
12425,0.000887,172.217.194.0-255,2902,130551,13,244149
12426,0.000891,172.31.36.0-255,66,130617,13,244149
12427,0.000898,172.217.194.0-255,5738,136355,13,244149
12428,0.000901,172.31.36.0-255,66,136421,13,244149
12429,0.000906,172.217.194.0-255,5738,142159,13,244149
12430,0.000909,172.31.36.0-255,66,142225,13,244149
12431,0.000945,172.217.194.0-255,7156,149381,13,244149
12432,0.000949,172.31.36.0-255,66,149447,13,244149
12433,0.000957,172.217.194.0-255,7156,156603,13,244149
12434,0.000959,172.31.36.0-255,66,156669,13,244149
12435,0.000983,172.217.194.0-255,3602,160271,13,244149
12436,0.000987,172.31.36.0-255,66,160337,13,244149
12437,0.000988,172.217.194.0-255,5738,166075,13,244149
12438,0.000991,172.31.36.0-255,66,166141,13,244149
12439,0.001034,172.217.194.0-255,5738,171879,13,244149
12440,0.001039,172.31.36.0-255,66,171945,13,244149
12441,0.00106,172.31.36.0-255,66,172011,13,244149
12442,0.001076,172.31.36.0-255,66,172077,13,244149
12443,0.001115,172.31.36.0-255,66,172143,13,244149
12444,0.001132,172.31.36.0-255,66,172209,13,244149
12445,0.001135,172.217.194.0-255,1484,173693,13,244149
12446,0.001139,172.217.194.0-255,2902,176595,13,244149
12447,0.001141,172.31.36.0-255,66,176661,13,244149
12448,0.001147,172.217.194.0-255,5738,182399,13,244149
12449,0.00115,172.31.36.0-255,66,182465,13,244149
12450,0.001196,172.217.194.0-255,5738,188203,13,244149
12451,0.001199,172.31.36.0-255,66,188269,13,244149
12452,0.001237,172.217.194.0-255,7156,195425,13,244149
12453,0.001241,172.31.36.0-255,66,195491,13,244149
12454,0.001249,172.217.194.0-255,8574,204065,13,244149
12455,0.001252,172.31.36.0-255,66,204131,13,244149
12456,0.001262,172.217.194.0-255,2184,206315,13,244149
12457,0.001264,172.31.36.0-255,66,206381,13,244149
12458,0.001269,172.217.194.0-255,2902,209283,13,244149
12459,0.001271,172.31.36.0-255,66,209349,13,244149
12460,0.001277,172.217.194.0-255,7156,216505,13,244149
12461,0.001279,172.31.36.0-255,66,216571,13,244149
12462,0.001295,172.31.36.0-255,66,216637,13,244149
12463,0.001301,172.217.194.0-255,7156,223793,13,244149
12464,0.001305,172.31.36.0-255,66,223859,13,244149
12465,0.00136,172.31.36.0-255,66,223925,13,244149
12466,0.001393,172.217.194.0-255,9274,233199,13,244149
12467,0.001398,172.31.36.0-255,66,233265,13,244149
12468,0.001418,172.31.36.0-255,66,233331,13,244149
12469,0.00142,172.217.194.0-255,1106,234437,13,244149
12470,0.001443,172.217.194.0-255,105,234542,13,244149
12471,0.003352,172.31.36.0-255,66,234608,13,244149
12472,0.00338,172.31.36.0-255,105,234713,13,244149
12473,0.00603,172.217.194.0-255,66,234779,13,244149
12474,0.038377,172.31.36.0-255,172,234951,13,244149
12475,0.03841,172.31.36.0-255,1109,236060,13,244149
12476,0.038457,172.31.36.0-255,1514,237574,13,244149
12477,0.038459,172.31.36.0-255,1514,239088,13,244149
12478,0.03846,172.31.36.0-255,1514,240602,13,244149
12479,0.038461,172.31.36.0-255,1514,242116,13,244149
12480,0.038488,172.31.36.0-255,1514,243630,13,244149
12481,0.038494,172.31.36.0-255,81,243711,13,244149
12482,0.039948,104.244.42.0-255,66,243777,13,244149
12483,0.03998,104.244.42.0-255,66,243843,13,244149
12484,0.040032,104.244.42.0-255,66,243909,13,244149
12485,0.040036,104.244.42.0-255,66,243975,13,244149
12486,0.043216,104.244.42.0-255,108,244083,13,244149
12487,0.043231,172.31.36.0-255,66,244149,13,244149
12488,0.0,74.125.24.0-255,150,150,13,340917
12489,2.1e-05,172.31.36.0-255,66,216,13,340917
12490,2.8e-05,74.125.24.0-255,1484,1700,13,340917
12491,3.2e-05,172.31.36.0-255,66,1766,13,340917
12492,3.8e-05,74.125.24.0-255,2902,4668,13,340917
12493,5.2e-05,172.31.36.0-255,66,4734,13,340917
12494,6e-05,74.125.24.0-255,7156,11890,13,340917
12495,6.3e-05,172.31.36.0-255,66,11956,13,340917
12496,8.6e-05,74.125.24.0-255,4320,16276,13,340917
12497,9.4e-05,172.31.36.0-255,66,16342,13,340917
12498,0.000125,74.125.24.0-255,4883,21225,13,340917
12499,0.000128,172.31.36.0-255,66,21291,13,340917
12500,0.000133,74.125.24.0-255,4320,25611,13,340917
12501,0.000136,172.31.36.0-255,66,25677,13,340917
12502,0.000173,74.125.24.0-255,5379,31056,13,340917
12503,0.000175,172.31.36.0-255,66,31122,13,340917
12504,0.000181,74.125.24.0-255,4320,35442,13,340917
12505,0.000183,172.31.36.0-255,66,35508,13,340917
12506,0.000188,74.125.24.0-255,4320,39828,13,340917
12507,0.00019,172.31.36.0-255,66,39894,13,340917
12508,0.00022,74.125.24.0-255,1484,41378,13,340917
12509,0.000227,172.31.36.0-255,66,41444,13,340917
12510,0.000241,172.31.36.0-255,66,41510,13,340917
12511,0.000246,74.125.24.0-255,4320,45830,13,340917
12512,0.000248,172.31.36.0-255,66,45896,13,340917
12513,0.000283,74.125.24.0-255,7108,53004,13,340917
12514,0.000285,172.31.36.0-255,66,53070,13,340917
12515,0.000456,74.125.24.0-255,111,53181,13,340917
12516,0.000461,172.31.36.0-255,66,53247,13,340917
12517,0.000633,74.125.24.0-255,1484,54731,13,340917
12518,0.000638,172.31.36.0-255,66,54797,13,340917
12519,0.000642,74.125.24.0-255,1484,56281,13,340917
12520,0.000664,74.125.24.0-255,1484,57765,13,340917
12521,0.000672,74.125.24.0-255,5738,63503,13,340917
12522,0.000674,74.125.24.0-255,1484,64987,13,340917
12523,0.000692,172.31.36.0-255,66,65053,13,340917
12524,0.000726,74.125.24.0-255,1484,66537,13,340917
12525,0.000744,74.125.24.0-255,3961,70498,13,340917
12526,0.000756,74.125.24.0-255,1484,71982,13,340917
12527,0.000776,74.125.24.0-255,4320,76302,13,340917
12528,0.000792,172.31.36.0-255,66,76368,13,340917
12529,0.00117,74.125.24.0-255,1484,77852,13,340917
12530,0.001175,74.125.24.0-255,1484,79336,13,340917
12531,0.001178,172.31.36.0-255,66,79402,13,340917
12532,0.001207,74.125.24.0-255,1484,80886,13,340917
12533,0.001214,74.125.24.0-255,5738,86624,13,340917
12534,0.001222,74.125.24.0-255,9992,96616,13,340917
12535,0.001239,74.125.24.0-255,2902,99518,13,340917
12536,0.001245,74.125.24.0-255,4320,103838,13,340917
12537,0.001254,172.31.36.0-255,66,103904,13,340917
12538,0.001271,74.125.24.0-255,6438,110342,13,340917
12539,0.00129,172.31.36.0-255,66,110408,13,340917
12540,0.00135,74.125.24.0-255,1484,111892,13,340917
12541,0.00137,74.125.24.0-255,2902,114794,13,340917
12542,0.001375,74.125.24.0-255,2902,117696,13,340917
12543,0.001383,172.31.36.0-255,66,117762,13,340917
12544,0.001392,74.125.24.0-255,2902,120664,13,340917
12545,0.00143,74.125.24.0-255,1484,122148,13,340917
12546,0.001438,74.125.24.0-255,8574,130722,13,340917
12547,0.001476,172.31.36.0-255,66,130788,13,340917
12548,0.001503,74.125.24.0-255,2184,132972,13,340917
12549,0.001507,74.125.24.0-255,2902,135874,13,340917
12550,0.001514,74.125.24.0-255,7156,143030,13,340917
12551,0.001517,74.125.24.0-255,2902,145932,13,340917
12552,0.001524,172.31.36.0-255,66,145998,13,340917
12553,0.001545,172.31.36.0-255,66,146064,13,340917
12554,0.001557,74.125.24.0-255,1484,147548,13,340917
12555,0.001579,74.125.24.0-255,7856,155404,13,340917
12556,0.001602,172.31.36.0-255,66,155470,13,340917
12557,0.002174,74.125.24.0-255,1484,156954,13,340917
12558,0.002197,74.125.24.0-255,2902,159856,13,340917
12559,0.002201,172.31.36.0-255,66,159922,13,340917
12560,0.002208,74.125.24.0-255,5738,165660,13,340917
12561,0.00221,74.125.24.0-255,1484,167144,13,340917
12562,0.002236,74.125.24.0-255,2902,170046,13,340917
12563,0.00224,74.125.24.0-255,2902,172948,13,340917
12564,0.002245,172.31.36.0-255,66,173014,13,340917
12565,0.002278,74.125.24.0-255,8574,181588,13,340917
12566,0.002281,172.31.36.0-255,66,181654,13,340917
12567,0.002289,74.125.24.0-255,7856,189510,13,340917
12568,0.002311,172.31.36.0-255,66,189576,13,340917
12569,0.002468,74.125.24.0-255,1484,191060,13,340917
12570,0.002472,74.125.24.0-255,1484,192544,13,340917
12571,0.002485,172.31.36.0-255,66,192610,13,340917
12572,0.002493,74.125.24.0-255,1484,194094,13,340917
12573,0.002513,74.125.24.0-255,4320,198414,13,340917
12574,0.002527,74.125.24.0-255,1484,199898,13,340917
12575,0.002535,172.31.36.0-255,66,199964,13,340917
12576,0.002575,74.125.24.0-255,9992,209956,13,340917
12577,0.002582,172.31.36.0-255,66,210022,13,340917
12578,0.005058,74.125.24.0-255,5738,215760,13,340917
12579,0.008,172.31.36.0-255,66,215826,13,340917
12580,0.010514,74.125.24.0-255,5738,221564,13,340917
12581,0.01052,172.31.36.0-255,66,221630,13,340917
12582,0.013016,74.125.24.0-255,5738,227368,13,340917
12583,0.013024,172.31.36.0-255,66,227434,13,340917
12584,0.015507,74.125.24.0-255,5738,233172,13,340917
12585,0.015516,172.31.36.0-255,66,233238,13,340917
12586,0.018053,74.125.24.0-255,5738,238976,13,340917
12587,0.018063,172.31.36.0-255,66,239042,13,340917
12588,0.020564,74.125.24.0-255,5738,244780,13,340917
12589,0.020579,172.31.36.0-255,66,244846,13,340917
12590,0.023069,74.125.24.0-255,5738,250584,13,340917
12591,0.023077,172.31.36.0-255,66,250650,13,340917
12592,0.02556,74.125.24.0-255,5738,256388,13,340917
12593,0.025568,172.31.36.0-255,66,256454,13,340917
12594,0.028018,74.125.24.0-255,5738,262192,13,340917
12595,0.028027,172.31.36.0-255,66,262258,13,340917
12596,0.030571,74.125.24.0-255,4320,266578,13,340917
12597,0.03058,172.31.36.0-255,66,266644,13,340917
12598,0.030611,74.125.24.0-255,1484,268128,13,340917
12599,0.033071,74.125.24.0-255,4320,272448,13,340917
12600,0.033077,172.31.36.0-255,66,272514,13,340917
12601,0.033859,172.31.36.0-255,176,272690,13,340917
12602,0.033893,172.31.36.0-255,1110,273800,13,340917
12603,0.033948,172.31.36.0-255,1514,275314,13,340917
12604,0.033949,172.31.36.0-255,1295,276609,13,340917
12605,0.035487,104.244.42.0-255,66,276675,13,340917
12606,0.035507,104.244.42.0-255,66,276741,13,340917
12607,0.035559,74.125.24.0-255,4320,281061,13,340917
12608,0.035564,172.31.36.0-255,66,281127,13,340917
12609,0.035595,74.125.24.0-255,1484,282611,13,340917
12610,0.035608,104.244.42.0-255,66,282677,13,340917
12611,0.038069,74.125.24.0-255,4320,286997,13,340917
12612,0.038079,172.31.36.0-255,66,287063,13,340917
12613,0.040597,74.125.24.0-255,5738,292801,13,340917
12614,0.041138,172.31.36.0-255,66,292867,13,340917
12615,0.043657,74.125.24.0-255,2902,295769,13,340917
12616,0.043664,172.31.36.0-255,66,295835,13,340917
12617,0.043694,74.125.24.0-255,2902,298737,13,340917
12618,0.043716,172.31.36.0-255,66,298803,13,340917
12619,0.046162,74.125.24.0-255,2902,301705,13,340917
12620,0.046169,172.31.36.0-255,66,301771,13,340917
12621,0.046203,74.125.24.0-255,2902,304673,13,340917
12622,0.046223,172.31.36.0-255,66,304739,13,340917
12623,0.048644,74.125.24.0-255,2902,307641,13,340917
12624,0.04865,172.31.36.0-255,66,307707,13,340917
12625,0.048697,74.125.24.0-255,2902,310609,13,340917
12626,0.04871,172.31.36.0-255,66,310675,13,340917
12627,0.051158,74.125.24.0-255,5738,316413,13,340917
12628,0.051694,172.31.36.0-255,66,316479,13,340917
12629,0.054165,74.125.24.0-255,5738,322217,13,340917
12630,0.054173,172.31.36.0-255,66,322283,13,340917
12631,0.056634,74.125.24.0-255,5738,328021,13,340917
12632,0.05664,172.31.36.0-255,66,328087,13,340917
12633,0.059103,74.125.24.0-255,5738,333825,13,340917
12634,0.05911,172.31.36.0-255,66,333891,13,340917
12635,0.061579,74.125.24.0-255,5738,339629,13,340917
12636,0.061585,172.31.36.0-255,66,339695,13,340917
12637,0.064054,74.125.24.0-255,985,340680,13,340917
12638,0.064313,172.31.36.0-255,66,340746,13,340917
12639,0.06435,172.31.36.0-255,105,340851,13,340917
12640,0.066774,74.125.24.0-255,66,340917,13,340917
12641,0.0,172.217.24.0-255,153,153,13,293826
12642,3e-05,172.217.24.0-255,1484,1637,13,293826
12643,4.2e-05,172.31.36.0-255,66,1703,13,293826
12644,4.9e-05,172.217.24.0-255,2902,4605,13,293826
12645,5.3e-05,172.31.36.0-255,66,4671,13,293826
12646,5.8e-05,172.217.24.0-255,4320,8991,13,293826
12647,6.2e-05,172.31.36.0-255,66,9057,13,293826
12648,8.4e-05,172.217.24.0-255,2902,11959,13,293826
12649,8.7e-05,172.31.36.0-255,66,12025,13,293826
12650,9.5e-05,172.217.24.0-255,7700,19725,13,293826
12651,9.7e-05,172.31.36.0-255,66,19791,13,293826
12652,0.000101,172.217.24.0-255,2902,22693,13,293826
12653,0.000102,172.31.36.0-255,66,22759,13,293826
12654,0.000128,172.217.24.0-255,4320,27079,13,293826
12655,0.000131,172.31.36.0-255,66,27145,13,293826
12656,0.000162,172.217.24.0-255,3961,31106,13,293826
12657,0.000165,172.31.36.0-255,66,31172,13,293826
12658,0.000288,172.217.24.0-255,1484,32656,13,293826
12659,0.000301,172.217.24.0-255,1484,34140,13,293826
12660,0.000304,172.31.36.0-255,66,34206,13,293826
12661,0.000308,172.217.24.0-255,1484,35690,13,293826
12662,0.000323,172.217.24.0-255,1484,37174,13,293826
12663,0.000326,172.31.36.0-255,66,37240,13,293826
12664,0.000329,172.217.24.0-255,1484,38724,13,293826
12665,0.000352,172.217.24.0-255,5738,44462,13,293826
12666,0.000355,172.31.36.0-255,66,44528,13,293826
12667,0.000359,172.217.24.0-255,2902,47430,13,293826
12668,0.000361,172.31.36.0-255,66,47496,13,293826
12669,0.000402,172.217.24.0-255,5738,53234,13,293826
12670,0.000406,172.31.36.0-255,66,53300,13,293826
12671,0.000422,172.217.24.0-255,5379,58679,13,293826
12672,0.000425,172.31.36.0-255,66,58745,13,293826
12673,0.000431,172.217.24.0-255,5738,64483,13,293826
12674,0.000433,172.31.36.0-255,66,64549,13,293826
12675,0.000471,172.217.24.0-255,1393,65942,13,293826
12676,0.001001,172.217.24.0-255,132,66074,13,293826
12677,0.001139,172.217.24.0-255,1484,67558,13,293826
12678,0.001144,172.31.36.0-255,66,67624,13,293826
12679,0.00115,172.217.24.0-255,2902,70526,13,293826
12680,0.001152,172.31.36.0-255,66,70592,13,293826
12681,0.001158,172.217.24.0-255,2902,73494,13,293826
12682,0.00116,172.31.36.0-255,66,73560,13,293826
12683,0.001194,172.217.24.0-255,2902,76462,13,293826
12684,0.001197,172.31.36.0-255,66,76528,13,293826
12685,0.001204,172.217.24.0-255,6797,83325,13,293826
12686,0.001206,172.31.36.0-255,66,83391,13,293826
12687,0.001237,172.31.36.0-255,66,83457,13,293826
12688,0.001239,172.217.24.0-255,1484,84941,13,293826
12689,0.001264,172.217.24.0-255,1125,86066,13,293826
12690,0.001267,172.31.36.0-255,66,86132,13,293826
12691,0.001404,172.217.24.0-255,1484,87616,13,293826
12692,0.001417,172.217.24.0-255,1484,89100,13,293826
12693,0.001422,172.31.36.0-255,66,89166,13,293826
12694,0.001427,172.217.24.0-255,2902,92068,13,293826
12695,0.001429,172.31.36.0-255,66,92134,13,293826
12696,0.001456,172.217.24.0-255,2902,95036,13,293826
12697,0.001459,172.31.36.0-255,66,95102,13,293826
12698,0.001464,172.217.24.0-255,4320,99422,13,293826
12699,0.001466,172.31.36.0-255,66,99488,13,293826
12700,0.001489,172.217.24.0-255,1484,100972,13,293826
12701,0.001494,172.217.24.0-255,2902,103874,13,293826
12702,0.001496,172.31.36.0-255,66,103940,13,293826
12703,0.001508,172.217.24.0-255,2902,106842,13,293826
12704,0.00151,172.31.36.0-255,66,106908,13,293826
12705,0.001526,172.217.24.0-255,2902,109810,13,293826
12706,0.001528,172.31.36.0-255,66,109876,13,293826
12707,0.001534,172.217.24.0-255,5738,115614,13,293826
12708,0.001536,172.31.36.0-255,66,115680,13,293826
12709,0.001565,172.217.24.0-255,4320,120000,13,293826
12710,0.001567,172.31.36.0-255,66,120066,13,293826
12711,0.001581,172.217.24.0-255,766,120832,13,293826
12712,0.001751,172.217.24.0-255,1484,122316,13,293826
12713,0.001753,172.31.36.0-255,66,122382,13,293826
12714,0.001756,172.217.24.0-255,1484,123866,13,293826
12715,0.001766,172.217.24.0-255,1484,125350,13,293826
12716,0.001768,172.31.36.0-255,66,125416,13,293826
12717,0.001797,172.217.24.0-255,4320,129736,13,293826
12718,0.0018,172.31.36.0-255,66,129802,13,293826
12719,0.001805,172.217.24.0-255,5738,135540,13,293826
12720,0.001807,172.31.36.0-255,66,135606,13,293826
12721,0.00182,172.31.36.0-255,66,135672,13,293826
12722,0.001845,172.217.24.0-255,7856,143528,13,293826
12723,0.001847,172.31.36.0-255,66,143594,13,293826
12724,0.001854,172.217.24.0-255,7156,150750,13,293826
12725,0.001856,172.31.36.0-255,66,150816,13,293826
12726,0.001869,172.217.24.0-255,1484,152300,13,293826
12727,0.001897,172.31.36.0-255,66,152366,13,293826
12728,0.001904,172.217.24.0-255,6438,158804,13,293826
12729,0.001906,172.31.36.0-255,66,158870,13,293826
12730,0.001961,172.217.24.0-255,1484,160354,13,293826
12731,0.001974,172.217.24.0-255,2902,163256,13,293826
12732,0.001977,172.31.36.0-255,66,163322,13,293826
12733,0.001979,172.217.24.0-255,1484,164806,13,293826
12734,0.001983,172.217.24.0-255,2902,167708,13,293826
12735,0.001985,172.31.36.0-255,66,167774,13,293826
12736,0.002001,172.217.24.0-255,2902,170676,13,293826
12737,0.002003,172.31.36.0-255,66,170742,13,293826
12738,0.002015,172.217.24.0-255,1484,172226,13,293826
12739,0.002019,172.217.24.0-255,2902,175128,13,293826
12740,0.002021,172.31.36.0-255,66,175194,13,293826
12741,0.002024,172.217.24.0-255,1484,176678,13,293826
12742,0.00204,172.217.24.0-255,2902,179580,13,293826
12743,0.002042,172.31.36.0-255,66,179646,13,293826
12744,0.002056,172.217.24.0-255,7156,186802,13,293826
12745,0.002059,172.31.36.0-255,66,186868,13,293826
12746,0.002079,172.217.24.0-255,2902,189770,13,293826
12747,0.002081,172.31.36.0-255,66,189836,13,293826
12748,0.002093,172.217.24.0-255,3602,193438,13,293826
12749,0.002095,172.31.36.0-255,66,193504,13,293826
12750,0.002127,172.217.24.0-255,1484,194988,13,293826
12751,0.002142,172.217.24.0-255,2902,197890,13,293826
12752,0.002144,172.31.36.0-255,66,197956,13,293826
12753,0.002165,172.217.24.0-255,5738,203694,13,293826
12754,0.002167,172.31.36.0-255,66,203760,13,293826
12755,0.002229,172.31.36.0-255,66,203826,13,293826
12756,0.002236,172.217.24.0-255,7156,210982,13,293826
12757,0.002238,172.31.36.0-255,66,211048,13,293826
12758,0.002243,172.217.24.0-255,2902,213950,13,293826
12759,0.002245,172.31.36.0-255,66,214016,13,293826
12760,0.002248,172.217.24.0-255,766,214782,13,293826
12761,0.002274,172.217.24.0-255,5738,220520,13,293826
12762,0.002277,172.31.36.0-255,66,220586,13,293826
12763,0.002279,172.217.24.0-255,1484,222070,13,293826
12764,0.002283,172.217.24.0-255,2902,224972,13,293826
12765,0.002285,172.31.36.0-255,66,225038,13,293826
12766,0.002288,172.217.24.0-255,1484,226522,13,293826
12767,0.002308,172.217.24.0-255,4320,230842,13,293826
12768,0.00231,172.31.36.0-255,66,230908,13,293826
12769,0.002315,172.217.24.0-255,4320,235228,13,293826
12770,0.002317,172.31.36.0-255,66,235294,13,293826
12771,0.002338,172.217.24.0-255,8574,243868,13,293826
12772,0.00234,172.31.36.0-255,66,243934,13,293826
12773,0.002346,172.217.24.0-255,5020,248954,13,293826
12774,0.002348,172.31.36.0-255,66,249020,13,293826
12775,0.002351,172.217.24.0-255,2902,251922,13,293826
12776,0.002354,172.31.36.0-255,66,251988,13,293826
12777,0.002377,172.217.24.0-255,2902,254890,13,293826
12778,0.002379,172.31.36.0-255,66,254956,13,293826
12779,0.002417,172.31.36.0-255,66,255022,13,293826
12780,0.002424,172.217.24.0-255,8574,263596,13,293826
12781,0.002426,172.31.36.0-255,66,263662,13,293826
12782,0.002475,172.31.36.0-255,66,263728,13,293826
12783,0.002506,172.31.36.0-255,66,263794,13,293826
12784,0.002512,172.217.24.0-255,5738,269532,13,293826
12785,0.002514,172.31.36.0-255,66,269598,13,293826
12786,0.002533,172.217.24.0-255,9992,279590,13,293826
12787,0.002536,172.31.36.0-255,66,279656,13,293826
12788,0.002557,172.217.24.0-255,6605,286261,13,293826
12789,0.002579,172.31.36.0-255,66,286327,13,293826
12790,0.002582,172.217.24.0-255,105,286432,13,293826
12791,0.007072,172.31.36.0-255,105,286537,13,293826
12792,0.008969,172.217.24.0-255,66,286603,13,293826
12793,0.027428,172.31.36.0-255,172,286775,13,293826
12794,0.027462,172.31.36.0-255,1109,287884,13,293826
12795,0.027502,172.31.36.0-255,1514,289398,13,293826
12796,0.027504,172.31.36.0-255,1514,290912,13,293826
12797,0.02751,172.31.36.0-255,1514,292426,13,293826
12798,0.027511,172.31.36.0-255,962,293388,13,293826
12799,0.028984,104.244.42.0-255,66,293454,13,293826
12800,0.029031,104.244.42.0-255,66,293520,13,293826
12801,0.029064,104.244.42.0-255,66,293586,13,293826
12802,0.029067,104.244.42.0-255,66,293652,13,293826
12803,0.029759,104.244.42.0-255,108,293760,13,293826
12804,0.029766,172.31.36.0-255,66,293826,13,293826
12805,0.0,172.217.194.0-255,297,297,13,193742
12806,2.8e-05,172.31.36.0-255,66,363,13,193742
12807,3.4e-05,172.217.194.0-255,1484,1847,13,193742
12808,3.8e-05,172.31.36.0-255,66,1913,13,193742
12809,6.7e-05,172.217.194.0-255,4320,6233,13,193742
12810,7.1e-05,172.31.36.0-255,66,6299,13,193742
12811,0.000108,172.217.194.0-255,7521,13820,13,193742
12812,0.000111,172.31.36.0-255,66,13886,13,193742
12813,0.000172,172.217.194.0-255,4320,18206,13,193742
12814,0.000176,172.31.36.0-255,66,18272,13,193742
12815,0.000196,172.217.194.0-255,4320,22592,13,193742
12816,0.000199,172.31.36.0-255,66,22658,13,193742
12817,0.000281,172.217.194.0-255,5738,28396,13,193742
12818,0.000285,172.31.36.0-255,66,28462,13,193742
12819,0.000296,172.217.194.0-255,2543,31005,13,193742
12820,0.000304,172.31.36.0-255,66,31071,13,193742
12821,0.00038,172.217.194.0-255,5738,36809,13,193742
12822,0.000384,172.31.36.0-255,66,36875,13,193742
12823,0.000423,172.31.36.0-255,66,36941,13,193742
12824,0.000621,172.217.194.0-255,4320,41261,13,193742
12825,0.000626,172.31.36.0-255,66,41327,13,193742
12826,0.00065,172.217.194.0-255,9992,51319,13,193742
12827,0.000654,172.31.36.0-255,66,51385,13,193742
12828,0.000768,172.217.194.0-255,766,52151,13,193742
12829,0.000772,172.31.36.0-255,66,52217,13,193742
12830,0.000797,172.217.194.0-255,646,52863,13,193742
12831,0.000801,172.31.36.0-255,66,52929,13,193742
12832,0.000817,172.31.36.0-255,66,52995,13,193742
12833,0.000847,172.217.194.0-255,3412,56407,13,193742
12834,0.00085,172.31.36.0-255,66,56473,13,193742
12835,0.001049,172.217.194.0-255,7156,63629,13,193742
12836,0.001054,172.31.36.0-255,66,63695,13,193742
12837,0.001086,172.217.194.0-255,6797,70492,13,193742
12838,0.00109,172.31.36.0-255,66,70558,13,193742
12839,0.001228,172.217.194.0-255,8574,79132,13,193742
12840,0.001233,172.31.36.0-255,66,79198,13,193742
12841,0.001261,172.217.194.0-255,5738,84936,13,193742
12842,0.001264,172.31.36.0-255,66,85002,13,193742
12843,0.001394,172.217.194.0-255,2902,87904,13,193742
12844,0.001398,172.31.36.0-255,66,87970,13,193742
12845,0.001445,172.31.36.0-255,66,88036,13,193742
12846,0.001464,172.217.194.0-255,2543,90579,13,193742
12847,0.001467,172.31.36.0-255,66,90645,13,193742
12848,0.00177,172.217.194.0-255,6438,97083,13,193742
12849,0.001776,172.31.36.0-255,66,97149,13,193742
12850,0.001849,172.217.194.0-255,2902,100051,13,193742
12851,0.001853,172.31.36.0-255,66,100117,13,193742
12852,0.001892,172.31.36.0-255,66,100183,13,193742
12853,0.001922,172.217.194.0-255,9992,110175,13,193742
12854,0.001924,172.31.36.0-255,66,110241,13,193742
12855,0.001949,172.31.36.0-255,66,110307,13,193742
12856,0.001985,172.31.36.0-255,66,110373,13,193742
12857,0.002515,172.217.194.0-255,5738,116111,13,193742
12858,0.002518,172.31.36.0-255,66,116177,13,193742
12859,0.002551,172.31.36.0-255,66,116243,13,193742
12860,0.002582,172.217.194.0-255,9274,125517,13,193742
12861,0.002584,172.31.36.0-255,66,125583,13,193742
12862,0.002908,172.217.194.0-255,4320,129903,13,193742
12863,0.002913,172.31.36.0-255,66,129969,13,193742
12864,0.002943,172.217.194.0-255,4320,134289,13,193742
12865,0.002947,172.31.36.0-255,66,134355,13,193742
12866,0.002988,172.217.194.0-255,1484,135839,13,193742
12867,0.003008,172.217.194.0-255,7156,142995,13,193742
12868,0.003011,172.31.36.0-255,66,143061,13,193742
12869,0.003062,172.31.36.0-255,66,143127,13,193742
12870,0.003106,172.31.36.0-255,66,143193,13,193742
12871,0.003546,172.217.194.0-255,5738,148931,13,193742
12872,0.003553,172.31.36.0-255,66,148997,13,193742
12873,0.003599,172.31.36.0-255,66,149063,13,193742
12874,0.003652,172.31.36.0-255,66,149129,13,193742
12875,0.003677,172.217.194.0-255,9992,159121,13,193742
12876,0.003681,172.31.36.0-255,66,159187,13,193742
12877,0.005866,172.217.194.0-255,4320,163507,13,193742
12878,0.005871,172.31.36.0-255,66,163573,13,193742
12879,0.005893,172.217.194.0-255,1484,165057,13,193742
12880,0.008051,172.217.194.0-255,4320,169377,13,193742
12881,0.008055,172.31.36.0-255,66,169443,13,193742
12882,0.010266,172.217.194.0-255,5738,175181,13,193742
12883,0.010273,172.31.36.0-255,66,175247,13,193742
12884,0.012481,172.217.194.0-255,5738,180985,13,193742
12885,0.012488,172.31.36.0-255,66,181051,13,193742
12886,0.014687,172.217.194.0-255,5738,186789,13,193742
12887,0.014697,172.31.36.0-255,66,186855,13,193742
12888,0.016866,172.217.194.0-255,2361,189216,13,193742
12889,0.016874,172.31.36.0-255,66,189282,13,193742
12890,0.017076,172.31.36.0-255,105,189387,13,193742
12891,0.01922,172.217.194.0-255,66,189453,13,193742
12892,0.029828,172.31.36.0-255,172,189625,13,193742
12893,0.029861,172.31.36.0-255,1110,190735,13,193742
12894,0.029896,172.31.36.0-255,1514,192249,13,193742
12895,0.029898,172.31.36.0-255,1295,193544,13,193742
12896,0.031525,104.244.42.0-255,66,193610,13,193742
12897,0.031564,104.244.42.0-255,66,193676,13,193742
12898,0.031566,104.244.42.0-255,66,193742,13,193742
12899,0.0,172.217.194.0-255,152,152,13,321637
12900,1.4e-05,172.31.36.0-255,66,218,13,321637
12901,3.5e-05,172.217.194.0-255,1484,1702,13,321637
12902,3.9e-05,172.31.36.0-255,66,1768,13,321637
12903,4.4e-05,172.217.194.0-255,2902,4670,13,321637
12904,4.7e-05,172.31.36.0-255,66,4736,13,321637
12905,6.8e-05,172.217.194.0-255,4320,9056,13,321637
12906,7.1e-05,172.31.36.0-255,66,9122,13,321637
12907,8.8e-05,172.217.194.0-255,2902,12024,13,321637
12908,9e-05,172.31.36.0-255,66,12090,13,321637
12909,0.000128,172.217.194.0-255,2047,14137,13,321637
12910,0.00013,172.31.36.0-255,66,14203,13,321637
12911,0.000163,172.217.194.0-255,2902,17105,13,321637
12912,0.000165,172.31.36.0-255,66,17171,13,321637
12913,0.0002,172.217.194.0-255,4320,21491,13,321637
12914,0.000203,172.31.36.0-255,66,21557,13,321637
12915,0.000206,172.217.194.0-255,1484,23041,13,321637
12916,0.000208,172.31.36.0-255,66,23107,13,321637
12917,0.000227,172.217.194.0-255,7156,30263,13,321637
12918,0.000229,172.31.36.0-255,66,30329,13,321637
12919,0.000232,172.217.194.0-255,1125,31454,13,321637
12920,0.000234,172.31.36.0-255,66,31520,13,321637
12921,0.000378,172.217.194.0-255,1484,33004,13,321637
12922,0.000383,172.31.36.0-255,66,33070,13,321637
12923,0.000399,172.217.194.0-255,2902,35972,13,321637
12924,0.000401,172.31.36.0-255,66,36038,13,321637
12925,0.000429,172.217.194.0-255,5738,41776,13,321637
12926,0.000432,172.31.36.0-255,66,41842,13,321637
12927,0.000435,172.217.194.0-255,1484,43326,13,321637
12928,0.000436,172.31.36.0-255,66,43392,13,321637
12929,0.000474,172.217.194.0-255,4320,47712,13,321637
12930,0.000476,172.31.36.0-255,66,47778,13,321637
12931,0.000501,172.217.194.0-255,9633,57411,13,321637
12932,0.000504,172.31.36.0-255,66,57477,13,321637
12933,0.00052,172.217.194.0-255,1484,58961,13,321637
12934,0.000542,172.217.194.0-255,4320,63281,13,321637
12935,0.000545,172.31.36.0-255,66,63347,13,321637
12936,0.000562,172.217.194.0-255,2543,65890,13,321637
12937,0.000564,172.31.36.0-255,66,65956,13,321637
12938,0.001818,172.217.194.0-255,645,66601,13,321637
12939,0.002154,172.217.194.0-255,1484,68085,13,321637
12940,0.00216,172.31.36.0-255,66,68151,13,321637
12941,0.002179,172.217.194.0-255,2902,71053,13,321637
12942,0.002181,172.31.36.0-255,66,71119,13,321637
12943,0.002188,172.217.194.0-255,5738,76857,13,321637
12944,0.00219,172.31.36.0-255,66,76923,13,321637
12945,0.002209,172.217.194.0-255,2902,79825,13,321637
12946,0.002211,172.31.36.0-255,66,79891,13,321637
12947,0.002238,172.217.194.0-255,7156,87047,13,321637
12948,0.002241,172.31.36.0-255,66,87113,13,321637
12949,0.002254,172.217.194.0-255,2902,90015,13,321637
12950,0.002257,172.31.36.0-255,66,90081,13,321637
12951,0.002262,172.217.194.0-255,4320,94401,13,321637
12952,0.002264,172.31.36.0-255,66,94467,13,321637
12953,0.002291,172.217.194.0-255,5890,100357,13,321637
12954,0.002293,172.31.36.0-255,66,100423,13,321637
12955,0.004615,172.217.194.0-255,2902,103325,13,321637
12956,0.004618,172.31.36.0-255,66,103391,13,321637
12957,0.004637,172.217.194.0-255,2902,106293,13,321637
12958,0.004639,172.31.36.0-255,66,106359,13,321637
12959,0.006926,172.217.194.0-255,2902,109261,13,321637
12960,0.006933,172.31.36.0-255,66,109327,13,321637
12961,0.006953,172.217.194.0-255,2902,112229,13,321637
12962,0.006956,172.31.36.0-255,66,112295,13,321637
12963,0.009272,172.217.194.0-255,5738,118033,13,321637
12964,0.00928,172.31.36.0-255,66,118099,13,321637
12965,0.011585,172.217.194.0-255,5738,123837,13,321637
12966,0.011593,172.31.36.0-255,66,123903,13,321637
12967,0.013885,172.217.194.0-255,5738,129641,13,321637
12968,0.013893,172.31.36.0-255,66,129707,13,321637
12969,0.016191,172.217.194.0-255,5738,135445,13,321637
12970,0.016201,172.31.36.0-255,66,135511,13,321637
12971,0.018579,172.217.194.0-255,5738,141249,13,321637
12972,0.018589,172.31.36.0-255,66,141315,13,321637
12973,0.019939,172.31.36.0-255,172,141487,13,321637
12974,0.019973,172.31.36.0-255,1108,142595,13,321637
12975,0.020036,172.31.36.0-255,1514,144109,13,321637
12976,0.020038,172.31.36.0-255,1514,145623,13,321637
12977,0.02004,172.31.36.0-255,1514,147137,13,321637
12978,0.020041,172.31.36.0-255,116,147253,13,321637
12979,0.02091,172.217.194.0-255,5738,152991,13,321637
12980,0.020918,172.31.36.0-255,66,153057,13,321637
12981,0.021507,104.244.42.0-255,66,153123,13,321637
12982,0.021535,104.244.42.0-255,66,153189,13,321637
12983,0.021645,104.244.42.0-255,66,153255,13,321637
12984,0.021657,104.244.42.0-255,66,153321,13,321637
12985,0.023237,172.217.194.0-255,5738,159059,13,321637
12986,0.023243,172.31.36.0-255,66,159125,13,321637
12987,0.025556,172.217.194.0-255,5738,164863,13,321637
12988,0.025563,172.31.36.0-255,66,164929,13,321637
12989,0.027872,172.217.194.0-255,5738,170667,13,321637
12990,0.027879,172.31.36.0-255,66,170733,13,321637
12991,0.030169,172.217.194.0-255,5738,176471,13,321637
12992,0.030179,172.31.36.0-255,66,176537,13,321637
12993,0.032497,172.217.194.0-255,5738,182275,13,321637
12994,0.032505,172.31.36.0-255,66,182341,13,321637
12995,0.034806,172.217.194.0-255,5738,188079,13,321637
12996,0.034816,172.31.36.0-255,66,188145,13,321637
12997,0.037134,172.217.194.0-255,5738,193883,13,321637
12998,0.037141,172.31.36.0-255,66,193949,13,321637
12999,0.039443,172.217.194.0-255,5738,199687,13,321637
13000,0.039453,172.31.36.0-255,66,199753,13,321637
13001,0.041788,172.217.194.0-255,5738,205491,13,321637
13002,0.041795,172.31.36.0-255,66,205557,13,321637
13003,0.044096,172.217.194.0-255,5738,211295,13,321637
13004,0.044103,172.31.36.0-255,66,211361,13,321637
13005,0.046427,172.217.194.0-255,5738,217099,13,321637
13006,0.046434,172.31.36.0-255,66,217165,13,321637
13007,0.048751,172.217.194.0-255,5738,222903,13,321637
13008,0.048758,172.31.36.0-255,66,222969,13,321637
13009,0.051097,172.217.194.0-255,5738,228707,13,321637
13010,0.051103,172.31.36.0-255,66,228773,13,321637
13011,0.053413,172.217.194.0-255,5738,234511,13,321637
13012,0.05342,172.31.36.0-255,66,234577,13,321637
13013,0.055732,172.217.194.0-255,5738,240315,13,321637
13014,0.055739,172.31.36.0-255,66,240381,13,321637
13015,0.058087,172.217.194.0-255,5738,246119,13,321637
13016,0.058094,172.31.36.0-255,66,246185,13,321637
13017,0.060423,172.217.194.0-255,5738,251923,13,321637
13018,0.060429,172.31.36.0-255,66,251989,13,321637
13019,0.062748,172.217.194.0-255,5738,257727,13,321637
13020,0.062765,172.31.36.0-255,66,257793,13,321637
13021,0.065067,172.217.194.0-255,5738,263531,13,321637
13022,0.06508,172.31.36.0-255,66,263597,13,321637
13023,0.067468,172.217.194.0-255,5738,269335,13,321637
13024,0.067475,172.31.36.0-255,66,269401,13,321637
13025,0.06983,172.217.194.0-255,5738,275139,13,321637
13026,0.069837,172.31.36.0-255,66,275205,13,321637
13027,0.072171,172.217.194.0-255,5738,280943,13,321637
13028,0.072178,172.31.36.0-255,66,281009,13,321637
13029,0.074507,172.217.194.0-255,5738,286747,13,321637
13030,0.074514,172.31.36.0-255,66,286813,13,321637
13031,0.07686,172.217.194.0-255,5738,292551,13,321637
13032,0.076865,172.31.36.0-255,66,292617,13,321637
13033,0.079165,172.217.194.0-255,5738,298355,13,321637
13034,0.079171,172.31.36.0-255,66,298421,13,321637
13035,0.081521,172.217.194.0-255,5738,304159,13,321637
13036,0.081528,172.31.36.0-255,66,304225,13,321637
13037,0.083905,172.217.194.0-255,5738,309963,13,321637
13038,0.083912,172.31.36.0-255,66,310029,13,321637
13039,0.086235,172.217.194.0-255,5738,315767,13,321637
13040,0.086241,172.31.36.0-255,66,315833,13,321637
13041,0.088568,172.217.194.0-255,5738,321571,13,321637
13042,0.088576,172.31.36.0-255,66,321637,13,321637
13043,0.0,74.125.24.0-255,153,153,13,341853
13044,2.5e-05,172.31.36.0-255,66,219,13,341853
13045,3.2e-05,74.125.24.0-255,1484,1703,13,341853
13046,3.7e-05,172.31.36.0-255,66,1769,13,341853
13047,4.2e-05,74.125.24.0-255,2902,4671,13,341853
13048,4.5e-05,172.31.36.0-255,66,4737,13,341853
13049,5.3e-05,74.125.24.0-255,7156,11893,13,341853
13050,5.6e-05,172.31.36.0-255,66,11959,13,341853
13051,6e-05,74.125.24.0-255,2036,13995,13,341853
13052,6.4e-05,172.31.36.0-255,66,14061,13,341853
13053,8e-05,172.31.36.0-255,66,14127,13,341853
13054,0.000104,74.125.24.0-255,1484,15611,13,341853
13055,0.000107,172.31.36.0-255,66,15677,13,341853
13056,0.000111,74.125.24.0-255,1125,16802,13,341853
13057,0.000113,172.31.36.0-255,66,16868,13,341853
13058,0.000117,74.125.24.0-255,1484,18352,13,341853
13059,0.00012,172.31.36.0-255,66,18418,13,341853
13060,0.000156,74.125.24.0-255,2902,21320,13,341853
13061,0.000158,172.31.36.0-255,66,21386,13,341853
13062,0.000165,74.125.24.0-255,5738,27124,13,341853
13063,0.000168,172.31.36.0-255,66,27190,13,341853
13064,0.000174,74.125.24.0-255,4320,31510,13,341853
13065,0.000176,172.31.36.0-255,66,31576,13,341853
13066,0.000195,74.125.24.0-255,2543,34119,13,341853
13067,0.000198,172.31.36.0-255,66,34185,13,341853
13068,0.000226,74.125.24.0-255,2902,37087,13,341853
13069,0.000229,172.31.36.0-255,66,37153,13,341853
13070,0.000235,74.125.24.0-255,4320,41473,13,341853
13071,0.000237,172.31.36.0-255,66,41539,13,341853
13072,0.000244,74.125.24.0-255,5738,47277,13,341853
13073,0.000246,172.31.36.0-255,66,47343,13,341853
13074,0.000274,74.125.24.0-255,2902,50245,13,341853
13075,0.000277,172.31.36.0-255,66,50311,13,341853
13076,0.000282,74.125.24.0-255,1504,51815,13,341853
13077,0.000283,172.31.36.0-255,66,51881,13,341853
13078,0.000453,74.125.24.0-255,329,52210,13,341853
13079,0.000655,74.125.24.0-255,1484,53694,13,341853
13080,0.000661,172.31.36.0-255,66,53760,13,341853
13081,0.000667,74.125.24.0-255,2902,56662,13,341853
13082,0.000669,172.31.36.0-255,66,56728,13,341853
13083,0.000674,74.125.24.0-255,2902,59630,13,341853
13084,0.000676,172.31.36.0-255,66,59696,13,341853
13085,0.000702,74.125.24.0-255,2902,62598,13,341853
13086,0.000704,172.31.36.0-255,66,62664,13,341853
13087,0.000739,74.125.24.0-255,4320,66984,13,341853
13088,0.000742,172.31.36.0-255,66,67050,13,341853
13089,0.000765,74.125.24.0-255,2543,69593,13,341853
13090,0.000769,172.31.36.0-255,66,69659,13,341853
13091,0.000788,74.125.24.0-255,1484,71143,13,341853
13092,0.00081,74.125.24.0-255,2902,74045,13,341853
13093,0.000814,172.31.36.0-255,66,74111,13,341853
13094,0.000821,74.125.24.0-255,5738,79849,13,341853
13095,0.000823,172.31.36.0-255,66,79915,13,341853
13096,0.000835,74.125.24.0-255,1484,81399,13,341853
13097,0.000855,74.125.24.0-255,5379,86778,13,341853
13098,0.000859,172.31.36.0-255,66,86844,13,341853
13099,0.001531,74.125.24.0-255,1484,88328,13,341853
13100,0.001539,74.125.24.0-255,2902,91230,13,341853
13101,0.001543,172.31.36.0-255,66,91296,13,341853
13102,0.00155,74.125.24.0-255,5738,97034,13,341853
13103,0.001552,172.31.36.0-255,66,97100,13,341853
13104,0.001559,74.125.24.0-255,5738,102838,13,341853
13105,0.001561,172.31.36.0-255,66,102904,13,341853
13106,0.001621,172.31.36.0-255,66,102970,13,341853
13107,0.001624,74.125.24.0-255,766,103736,13,341853
13108,0.00167,74.125.24.0-255,1484,105220,13,341853
13109,0.001673,172.31.36.0-255,66,105286,13,341853
13110,0.001678,74.125.24.0-255,2902,108188,13,341853
13111,0.00168,172.31.36.0-255,66,108254,13,341853
13112,0.001704,74.125.24.0-255,5738,113992,13,341853
13113,0.001707,172.31.36.0-255,66,114058,13,341853
13114,0.001713,74.125.24.0-255,4320,118378,13,341853
13115,0.001715,172.31.36.0-255,66,118444,13,341853
13116,0.00172,74.125.24.0-255,2902,121346,13,341853
13117,0.001722,172.31.36.0-255,66,121412,13,341853
13118,0.001757,74.125.24.0-255,8574,129986,13,341853
13119,0.00176,172.31.36.0-255,66,130052,13,341853
13120,0.001766,74.125.24.0-255,5738,135790,13,341853
13121,0.001768,172.31.36.0-255,66,135856,13,341853
13122,0.001782,74.125.24.0-255,2184,138040,13,341853
13123,0.001785,172.31.36.0-255,66,138106,13,341853
13124,0.001971,74.125.24.0-255,1484,139590,13,341853
13125,0.001977,74.125.24.0-255,2902,142492,13,341853
13126,0.00198,172.31.36.0-255,66,142558,13,341853
13127,0.001987,74.125.24.0-255,4320,146878,13,341853
13128,0.001989,172.31.36.0-255,66,146944,13,341853
13129,0.002001,74.125.24.0-255,1484,148428,13,341853
13130,0.002015,74.125.24.0-255,1484,149912,13,341853
13131,0.002017,172.31.36.0-255,66,149978,13,341853
13132,0.002044,74.125.24.0-255,8574,158552,13,341853
13133,0.002046,172.31.36.0-255,66,158618,13,341853
13134,0.002067,74.125.24.0-255,2902,161520,13,341853
13135,0.00207,172.31.36.0-255,66,161586,13,341853
13136,0.002073,74.125.24.0-255,1484,163070,13,341853
13137,0.002098,74.125.24.0-255,2902,165972,13,341853
13138,0.002101,172.31.36.0-255,66,166038,13,341853
13139,0.002127,74.125.24.0-255,6438,172476,13,341853
13140,0.002129,172.31.36.0-255,66,172542,13,341853
13141,0.002188,74.125.24.0-255,1484,174026,13,341853
13142,0.002194,74.125.24.0-255,2902,176928,13,341853
13143,0.002197,172.31.36.0-255,66,176994,13,341853
13144,0.002217,74.125.24.0-255,4320,181314,13,341853
13145,0.002221,172.31.36.0-255,66,181380,13,341853
13146,0.002236,74.125.24.0-255,1484,182864,13,341853
13147,0.002239,74.125.24.0-255,1484,184348,13,341853
13148,0.002242,172.31.36.0-255,66,184414,13,341853
13149,0.002268,74.125.24.0-255,5738,190152,13,341853
13150,0.002271,172.31.36.0-255,66,190218,13,341853
13151,0.002285,172.31.36.0-255,66,190284,13,341853
13152,0.002297,74.125.24.0-255,1484,191768,13,341853
13153,0.002301,74.125.24.0-255,2184,193952,13,341853
13154,0.002303,172.31.36.0-255,66,194018,13,341853
13155,0.00455,74.125.24.0-255,5738,199756,13,341853
13156,0.004562,172.31.36.0-255,66,199822,13,341853
13157,0.006814,74.125.24.0-255,5738,205560,13,341853
13158,0.006818,172.31.36.0-255,66,205626,13,341853
13159,0.009092,74.125.24.0-255,5738,211364,13,341853
13160,0.009101,172.31.36.0-255,66,211430,13,341853
13161,0.011403,74.125.24.0-255,5738,217168,13,341853
13162,0.011424,172.31.36.0-255,66,217234,13,341853
13163,0.013708,74.125.24.0-255,5738,222972,13,341853
13164,0.013723,172.31.36.0-255,66,223038,13,341853
13165,0.015991,74.125.24.0-255,5738,228776,13,341853
13166,0.016008,172.31.36.0-255,66,228842,13,341853
13167,0.018296,74.125.24.0-255,5738,234580,13,341853
13168,0.01831,172.31.36.0-255,66,234646,13,341853
13169,0.020581,74.125.24.0-255,5738,240384,13,341853
13170,0.020592,172.31.36.0-255,66,240450,13,341853
13171,0.022888,74.125.24.0-255,5738,246188,13,341853
13172,0.0229,172.31.36.0-255,66,246254,13,341853
13173,0.025169,74.125.24.0-255,5738,251992,13,341853
13174,0.025178,172.31.36.0-255,66,252058,13,341853
13175,0.027481,74.125.24.0-255,5738,257796,13,341853
13176,0.027488,172.31.36.0-255,66,257862,13,341853
13177,0.029759,74.125.24.0-255,5738,263600,13,341853
13178,0.029767,172.31.36.0-255,66,263666,13,341853
13179,0.032024,74.125.24.0-255,5738,269404,13,341853
13180,0.032033,172.31.36.0-255,66,269470,13,341853
13181,0.034295,74.125.24.0-255,5738,275208,13,341853
13182,0.034303,172.31.36.0-255,66,275274,13,341853
13183,0.036586,74.125.24.0-255,5738,281012,13,341853
13184,0.036594,172.31.36.0-255,66,281078,13,341853
13185,0.038844,74.125.24.0-255,5738,286816,13,341853
13186,0.038852,172.31.36.0-255,66,286882,13,341853
13187,0.041107,74.125.24.0-255,5738,292620,13,341853
13188,0.041116,172.31.36.0-255,66,292686,13,341853
13189,0.041486,172.31.36.0-255,172,292858,13,341853
13190,0.041518,172.31.36.0-255,1110,293968,13,341853
13191,0.041579,172.31.36.0-255,1514,295482,13,341853
13192,0.041581,172.31.36.0-255,1295,296777,13,341853
13193,0.043049,104.244.42.0-255,66,296843,13,341853
13194,0.043109,104.244.42.0-255,66,296909,13,341853
13195,0.043145,104.244.42.0-255,66,296975,13,341853
13196,0.043374,74.125.24.0-255,5738,302713,13,341853
13197,0.043379,172.31.36.0-255,66,302779,13,341853
13198,0.045644,74.125.24.0-255,5738,308517,13,341853
13199,0.045651,172.31.36.0-255,66,308583,13,341853
13200,0.047974,74.125.24.0-255,5738,314321,13,341853
13201,0.047981,172.31.36.0-255,66,314387,13,341853
13202,0.050261,74.125.24.0-255,5738,320125,13,341853
13203,0.050268,172.31.36.0-255,66,320191,13,341853
13204,0.052519,74.125.24.0-255,5738,325929,13,341853
13205,0.052526,172.31.36.0-255,66,325995,13,341853
13206,0.054781,74.125.24.0-255,5738,331733,13,341853
13207,0.054788,172.31.36.0-255,66,331799,13,341853
13208,0.05706,74.125.24.0-255,5738,337537,13,341853
13209,0.057068,172.31.36.0-255,66,337603,13,341853
13210,0.059334,74.125.24.0-255,4013,341616,13,341853
13211,0.059341,172.31.36.0-255,66,341682,13,341853
13212,0.05951,172.31.36.0-255,105,341787,13,341853
13213,0.06174,74.125.24.0-255,66,341853,13,341853
13214,0.0,74.125.24.0-255,153,153,13,313550
13215,2.1e-05,172.31.36.0-255,66,219,13,313550
13216,2.8e-05,74.125.24.0-255,1484,1703,13,313550
13217,3.3e-05,172.31.36.0-255,66,1769,13,313550
13218,3.9e-05,74.125.24.0-255,2902,4671,13,313550
13219,4.2e-05,172.31.36.0-255,66,4737,13,313550
13220,5e-05,74.125.24.0-255,7156,11893,13,313550
13221,5.3e-05,172.31.36.0-255,66,11959,13,313550
13222,5.8e-05,74.125.24.0-255,2036,13995,13,313550
13223,6.1e-05,172.31.36.0-255,66,14061,13,313550
13224,9.9e-05,74.125.24.0-255,2902,16963,13,313550
13225,0.000102,172.31.36.0-255,66,17029,13,313550
13226,0.000109,74.125.24.0-255,5738,22767,13,313550
13227,0.000112,172.31.36.0-255,66,22833,13,313550
13228,0.000165,172.31.36.0-255,66,22899,13,313550
13229,0.000173,74.125.24.0-255,7156,30055,13,313550
13230,0.000175,172.31.36.0-255,66,30121,13,313550
13231,0.000194,74.125.24.0-255,1484,31605,13,313550
13232,0.000196,172.31.36.0-255,66,31671,13,313550
13233,0.000236,74.125.24.0-255,5379,37050,13,313550
13234,0.000239,172.31.36.0-255,66,37116,13,313550
13235,0.000979,74.125.24.0-255,1484,38600,13,313550
13236,0.000986,172.31.36.0-255,66,38666,13,313550
13237,0.000995,74.125.24.0-255,2902,41568,13,313550
13238,0.000997,172.31.36.0-255,66,41634,13,313550
13239,0.001003,74.125.24.0-255,2902,44536,13,313550
13240,0.001006,172.31.36.0-255,66,44602,13,313550
13241,0.001029,74.125.24.0-255,2902,47504,13,313550
13242,0.001032,172.31.36.0-255,66,47570,13,313550
13243,0.001037,74.125.24.0-255,2902,50472,13,313550
13244,0.001039,172.31.36.0-255,66,50538,13,313550
13245,0.001082,74.125.24.0-255,4305,54843,13,313550
13246,0.001086,172.31.36.0-255,66,54909,13,313550
13247,0.001169,74.125.24.0-255,332,55241,13,313550
13248,0.001501,74.125.24.0-255,1484,56725,13,313550
13249,0.001507,172.31.36.0-255,66,56791,13,313550
13250,0.001514,74.125.24.0-255,2902,59693,13,313550
13251,0.001516,172.31.36.0-255,66,59759,13,313550
13252,0.001523,74.125.24.0-255,5738,65497,13,313550
13253,0.001526,172.31.36.0-255,66,65563,13,313550
13254,0.001532,74.125.24.0-255,2902,68465,13,313550
13255,0.001534,172.31.36.0-255,66,68531,13,313550
13256,0.001589,74.125.24.0-255,3961,72492,13,313550
13257,0.001591,172.31.36.0-255,66,72558,13,313550
13258,0.001611,74.125.24.0-255,4320,76878,13,313550
13259,0.001614,172.31.36.0-255,66,76944,13,313550
13260,0.00164,74.125.24.0-255,5738,82682,13,313550
13261,0.001642,172.31.36.0-255,66,82748,13,313550
13262,0.001686,74.125.24.0-255,6797,89545,13,313550
13263,0.00169,172.31.36.0-255,66,89611,13,313550
13264,0.004032,74.125.24.0-255,5738,95349,13,313550
13265,0.004037,172.31.36.0-255,66,95415,13,313550
13266,0.006396,74.125.24.0-255,5738,101153,13,313550
13267,0.006402,172.31.36.0-255,66,101219,13,313550
13268,0.008731,74.125.24.0-255,5738,106957,13,313550
13269,0.008739,172.31.36.0-255,66,107023,13,313550
13270,0.011064,74.125.24.0-255,5738,112761,13,313550
13271,0.011074,172.31.36.0-255,66,112827,13,313550
13272,0.013403,74.125.24.0-255,5738,118565,13,313550
13273,0.013411,172.31.36.0-255,66,118631,13,313550
13274,0.015748,74.125.24.0-255,5738,124369,13,313550
13275,0.01576,172.31.36.0-255,66,124435,13,313550
13276,0.018094,74.125.24.0-255,5738,130173,13,313550
13277,0.018105,172.31.36.0-255,66,130239,13,313550
13278,0.02043,74.125.24.0-255,5738,135977,13,313550
13279,0.020439,172.31.36.0-255,66,136043,13,313550
13280,0.02277,74.125.24.0-255,5738,141781,13,313550
13281,0.022778,172.31.36.0-255,66,141847,13,313550
13282,0.025158,74.125.24.0-255,5738,147585,13,313550
13283,0.025168,172.31.36.0-255,66,147651,13,313550
13284,0.027477,74.125.24.0-255,5738,153389,13,313550
13285,0.027486,172.31.36.0-255,66,153455,13,313550
13286,0.029825,74.125.24.0-255,5738,159193,13,313550
13287,0.029836,172.31.36.0-255,66,159259,13,313550
13288,0.031588,172.31.36.0-255,176,159435,13,313550
13289,0.03162,172.31.36.0-255,1111,160546,13,313550
13290,0.031694,172.31.36.0-255,1514,162060,13,313550
13291,0.031695,172.31.36.0-255,1514,163574,13,313550
13292,0.031697,172.31.36.0-255,1514,165088,13,313550
13293,0.031698,172.31.36.0-255,1514,166602,13,313550
13294,0.031699,172.31.36.0-255,1514,168116,13,313550
13295,0.031727,172.31.36.0-255,70,168186,13,313550
13296,0.032156,74.125.24.0-255,5738,173924,13,313550
13297,0.032163,172.31.36.0-255,66,173990,13,313550
13298,0.033149,104.244.42.0-255,66,174056,13,313550
13299,0.033181,104.244.42.0-255,66,174122,13,313550
13300,0.033287,104.244.42.0-255,66,174188,13,313550
13301,0.033293,104.244.42.0-255,66,174254,13,313550
13302,0.034511,74.125.24.0-255,5738,179992,13,313550
13303,0.03453,172.31.36.0-255,66,180058,13,313550
13304,0.036911,74.125.24.0-255,5738,185796,13,313550
13305,0.036918,172.31.36.0-255,66,185862,13,313550
13306,0.039232,74.125.24.0-255,5738,191600,13,313550
13307,0.039241,172.31.36.0-255,66,191666,13,313550
13308,0.041578,74.125.24.0-255,5738,197404,13,313550
13309,0.041585,172.31.36.0-255,66,197470,13,313550
13310,0.043915,74.125.24.0-255,5738,203208,13,313550
13311,0.043923,172.31.36.0-255,66,203274,13,313550
13312,0.046258,74.125.24.0-255,5738,209012,13,313550
13313,0.046265,172.31.36.0-255,66,209078,13,313550
13314,0.04862,74.125.24.0-255,5738,214816,13,313550
13315,0.048627,172.31.36.0-255,66,214882,13,313550
13316,0.050964,74.125.24.0-255,5738,220620,13,313550
13317,0.05097,172.31.36.0-255,66,220686,13,313550
13318,0.053303,74.125.24.0-255,5738,226424,13,313550
13319,0.053309,172.31.36.0-255,66,226490,13,313550
13320,0.055664,74.125.24.0-255,5738,232228,13,313550
13321,0.05567,172.31.36.0-255,66,232294,13,313550
13322,0.057981,74.125.24.0-255,5738,238032,13,313550
13323,0.057988,172.31.36.0-255,66,238098,13,313550
13324,0.060324,74.125.24.0-255,5738,243836,13,313550
13325,0.06033,172.31.36.0-255,66,243902,13,313550
13326,0.06266,74.125.24.0-255,5738,249640,13,313550
13327,0.062666,172.31.36.0-255,66,249706,13,313550
13328,0.064986,74.125.24.0-255,5738,255444,13,313550
13329,0.064992,172.31.36.0-255,66,255510,13,313550
13330,0.067348,74.125.24.0-255,5738,261248,13,313550
13331,0.067354,172.31.36.0-255,66,261314,13,313550
13332,0.069697,74.125.24.0-255,5738,267052,13,313550
13333,0.069703,172.31.36.0-255,66,267118,13,313550
13334,0.072034,74.125.24.0-255,5738,272856,13,313550
13335,0.07204,172.31.36.0-255,66,272922,13,313550
13336,0.074404,74.125.24.0-255,5738,278660,13,313550
13337,0.074411,172.31.36.0-255,66,278726,13,313550
13338,0.076746,74.125.24.0-255,5738,284464,13,313550
13339,0.076752,172.31.36.0-255,66,284530,13,313550
13340,0.079052,74.125.24.0-255,5738,290268,13,313550
13341,0.079059,172.31.36.0-255,66,290334,13,313550
13342,0.081364,74.125.24.0-255,5738,296072,13,313550
13343,0.081371,172.31.36.0-255,66,296138,13,313550
13344,0.083702,74.125.24.0-255,5738,301876,13,313550
13345,0.083708,172.31.36.0-255,66,301942,13,313550
13346,0.086055,74.125.24.0-255,5738,307680,13,313550
13347,0.086062,172.31.36.0-255,66,307746,13,313550
13348,0.088382,74.125.24.0-255,5738,313484,13,313550
13349,0.088388,172.31.36.0-255,66,313550,13,313550
13350,0.0,172.217.24.0-255,150,150,13,391823
13351,3.5e-05,172.31.36.0-255,66,216,13,391823
13352,4.2e-05,172.217.24.0-255,1484,1700,13,391823
13353,4.7e-05,172.31.36.0-255,66,1766,13,391823
13354,5e-05,172.217.24.0-255,1484,3250,13,391823
13355,5.2e-05,172.31.36.0-255,66,3316,13,391823
13356,6.7e-05,172.217.24.0-255,2902,6218,13,391823
13357,7e-05,172.31.36.0-255,66,6284,13,391823
13358,7.7e-05,172.217.24.0-255,5738,12022,13,391823
13359,7.9e-05,172.31.36.0-255,66,12088,13,391823
13360,8.2e-05,172.217.24.0-255,2036,14124,13,391823
13361,8.4e-05,172.31.36.0-255,66,14190,13,391823
13362,0.000117,172.217.24.0-255,2902,17092,13,391823
13363,0.00012,172.31.36.0-255,66,17158,13,391823
13364,0.000123,172.217.24.0-255,1484,18642,13,391823
13365,0.000125,172.31.36.0-255,66,18708,13,391823
13366,0.000129,172.217.24.0-255,2902,21610,13,391823
13367,0.000131,172.31.36.0-255,66,21676,13,391823
13368,0.000136,172.217.24.0-255,5738,27414,13,391823
13369,0.000138,172.31.36.0-255,66,27480,13,391823
13370,0.000172,172.217.24.0-255,3961,31441,13,391823
13371,0.000175,172.31.36.0-255,66,31507,13,391823
13372,0.000355,172.217.24.0-255,1484,32991,13,391823
13373,0.000362,172.31.36.0-255,66,33057,13,391823
13374,0.000366,172.217.24.0-255,1484,34541,13,391823
13375,0.000369,172.31.36.0-255,66,34607,13,391823
13376,0.000395,172.217.24.0-255,1484,36091,13,391823
13377,0.000398,172.31.36.0-255,66,36157,13,391823
13378,0.000405,172.217.24.0-255,5738,41895,13,391823
13379,0.000408,172.31.36.0-255,66,41961,13,391823
13380,0.000421,172.217.24.0-255,6797,48758,13,391823
13381,0.000424,172.31.36.0-255,66,48824,13,391823
13382,0.000643,172.217.24.0-255,1484,50308,13,391823
13383,0.00065,172.217.24.0-255,2902,53210,13,391823
13384,0.000653,172.31.36.0-255,66,53276,13,391823
13385,0.000681,172.217.24.0-255,2902,56178,13,391823
13386,0.000684,172.31.36.0-255,66,56244,13,391823
13387,0.000689,172.217.24.0-255,4320,60564,13,391823
13388,0.000693,172.31.36.0-255,66,60630,13,391823
13389,0.000728,172.217.24.0-255,5709,66339,13,391823
13390,0.000731,172.31.36.0-255,66,66405,13,391823
13391,0.001187,172.217.24.0-255,114,66519,13,391823
13392,0.001195,172.217.24.0-255,1484,68003,13,391823
13393,0.001199,172.31.36.0-255,66,68069,13,391823
13394,0.001205,172.217.24.0-255,2902,70971,13,391823
13395,0.001208,172.31.36.0-255,66,71037,13,391823
13396,0.001219,172.217.24.0-255,1484,72521,13,391823
13397,0.001252,172.217.24.0-255,5738,78259,13,391823
13398,0.001256,172.31.36.0-255,66,78325,13,391823
13399,0.001263,172.217.24.0-255,5379,83704,13,391823
13400,0.001265,172.31.36.0-255,66,83770,13,391823
13401,0.001321,172.217.24.0-255,1484,85254,13,391823
13402,0.001326,172.217.24.0-255,2902,88156,13,391823
13403,0.001329,172.31.36.0-255,66,88222,13,391823
13404,0.001337,172.217.24.0-255,5738,93960,13,391823
13405,0.001339,172.31.36.0-255,66,94026,13,391823
13406,0.001346,172.217.24.0-255,6797,100823,13,391823
13407,0.001348,172.31.36.0-255,66,100889,13,391823
13408,0.001608,172.217.24.0-255,1484,102373,13,391823
13409,0.001615,172.217.24.0-255,1484,103857,13,391823
13410,0.001619,172.31.36.0-255,66,103923,13,391823
13411,0.001648,172.217.24.0-255,1484,105407,13,391823
13412,0.001654,172.217.24.0-255,4320,109727,13,391823
13413,0.001657,172.31.36.0-255,66,109793,13,391823
13414,0.001664,172.217.24.0-255,5738,115531,13,391823
13415,0.001666,172.31.36.0-255,66,115597,13,391823
13416,0.001693,172.217.24.0-255,7156,122753,13,391823
13417,0.001696,172.31.36.0-255,66,122819,13,391823
13418,0.001725,172.217.24.0-255,4320,127139,13,391823
13419,0.001727,172.31.36.0-255,66,127205,13,391823
13420,0.001734,172.217.24.0-255,5738,132943,13,391823
13421,0.001736,172.31.36.0-255,66,133009,13,391823
13422,0.00174,172.217.24.0-255,2184,135193,13,391823
13423,0.001742,172.31.36.0-255,66,135259,13,391823
13424,0.001803,172.217.24.0-255,1484,136743,13,391823
13425,0.001816,172.217.24.0-255,1484,138227,13,391823
13426,0.001819,172.31.36.0-255,66,138293,13,391823
13427,0.00183,172.217.24.0-255,1484,139777,13,391823
13428,0.001839,172.217.24.0-255,5738,145515,13,391823
13429,0.001842,172.31.36.0-255,66,145581,13,391823
13430,0.001846,172.217.24.0-255,2902,148483,13,391823
13431,0.001848,172.31.36.0-255,66,148549,13,391823
13432,0.001889,172.217.24.0-255,4320,152869,13,391823
13433,0.001891,172.31.36.0-255,66,152935,13,391823
13434,0.001896,172.217.24.0-255,2902,155837,13,391823
13435,0.001897,172.31.36.0-255,66,155903,13,391823
13436,0.001923,172.217.24.0-255,4320,160223,13,391823
13437,0.001926,172.31.36.0-255,66,160289,13,391823
13438,0.001949,172.217.24.0-255,1484,161773,13,391823
13439,0.001952,172.217.24.0-255,1484,163257,13,391823
13440,0.001954,172.31.36.0-255,66,163323,13,391823
13441,0.001977,172.217.24.0-255,1484,164807,13,391823
13442,0.001997,172.217.24.0-255,2902,167709,13,391823
13443,0.001999,172.31.36.0-255,66,167775,13,391823
13444,0.002021,172.217.24.0-255,2184,169959,13,391823
13445,0.002023,172.31.36.0-255,66,170025,13,391823
13446,0.003927,172.217.24.0-255,2902,172927,13,391823
13447,0.003931,172.31.36.0-255,66,172993,13,391823
13448,0.003941,172.217.24.0-255,1484,174477,13,391823
13449,0.003958,172.217.24.0-255,1484,175961,13,391823
13450,0.00396,172.31.36.0-255,66,176027,13,391823
13451,0.005867,172.217.24.0-255,2902,178929,13,391823
13452,0.005871,172.31.36.0-255,66,178995,13,391823
13453,0.005897,172.217.24.0-255,2902,181897,13,391823
13454,0.005899,172.31.36.0-255,66,181963,13,391823
13455,0.007804,172.217.24.0-255,2902,184865,13,391823
13456,0.00781,172.31.36.0-255,66,184931,13,391823
13457,0.007844,172.217.24.0-255,2902,187833,13,391823
13458,0.007847,172.31.36.0-255,66,187899,13,391823
13459,0.009782,172.217.24.0-255,2902,190801,13,391823
13460,0.00979,172.31.36.0-255,66,190867,13,391823
13461,0.009821,172.217.24.0-255,2902,193769,13,391823
13462,0.009824,172.31.36.0-255,66,193835,13,391823
13463,0.011748,172.217.24.0-255,2902,196737,13,391823
13464,0.011758,172.31.36.0-255,66,196803,13,391823
13465,0.011788,172.217.24.0-255,2902,199705,13,391823
13466,0.011792,172.31.36.0-255,66,199771,13,391823
13467,0.013706,172.217.24.0-255,2902,202673,13,391823
13468,0.013713,172.31.36.0-255,66,202739,13,391823
13469,0.013744,172.217.24.0-255,2902,205641,13,391823
13470,0.013748,172.31.36.0-255,66,205707,13,391823
13471,0.015654,172.217.24.0-255,2902,208609,13,391823
13472,0.015665,172.31.36.0-255,66,208675,13,391823
13473,0.015695,172.217.24.0-255,2902,211577,13,391823
13474,0.015698,172.31.36.0-255,66,211643,13,391823
13475,0.017612,172.217.24.0-255,2902,214545,13,391823
13476,0.017623,172.31.36.0-255,66,214611,13,391823
13477,0.017663,172.217.24.0-255,2902,217513,13,391823
13478,0.017666,172.31.36.0-255,66,217579,13,391823
13479,0.019574,172.217.24.0-255,2902,220481,13,391823
13480,0.01959,172.31.36.0-255,66,220547,13,391823
13481,0.019619,172.217.24.0-255,2902,223449,13,391823
13482,0.019623,172.31.36.0-255,66,223515,13,391823
13483,0.021528,172.217.24.0-255,2902,226417,13,391823
13484,0.021537,172.31.36.0-255,66,226483,13,391823
13485,0.02158,172.217.24.0-255,2902,229385,13,391823
13486,0.021584,172.31.36.0-255,66,229451,13,391823
13487,0.023516,172.217.24.0-255,5738,235189,13,391823
13488,0.023523,172.31.36.0-255,66,235255,13,391823
13489,0.02548,172.217.24.0-255,5738,240993,13,391823
13490,0.025489,172.31.36.0-255,66,241059,13,391823
13491,0.027437,172.217.24.0-255,5738,246797,13,391823
13492,0.027444,172.31.36.0-255,66,246863,13,391823
13493,0.029411,172.217.24.0-255,5738,252601,13,391823
13494,0.029418,172.31.36.0-255,66,252667,13,391823
13495,0.029842,172.31.36.0-255,172,252839,13,391823
13496,0.029876,172.31.36.0-255,1110,253949,13,391823
13497,0.029913,172.31.36.0-255,1514,255463,13,391823
13498,0.029915,172.31.36.0-255,1295,256758,13,391823
13499,0.031424,104.244.42.0-255,66,256824,13,391823
13500,0.03144,104.244.42.0-255,66,256890,13,391823
13501,0.031448,172.217.24.0-255,5738,262628,13,391823
13502,0.031458,172.31.36.0-255,66,262694,13,391823
13503,0.031517,104.244.42.0-255,66,262760,13,391823
13504,0.033423,172.217.24.0-255,5738,268498,13,391823
13505,0.033439,172.31.36.0-255,66,268564,13,391823
13506,0.035477,172.217.24.0-255,5738,274302,13,391823
13507,0.035496,172.31.36.0-255,66,274368,13,391823
13508,0.037447,172.217.24.0-255,5738,280106,13,391823
13509,0.03746,172.31.36.0-255,66,280172,13,391823
13510,0.039403,172.217.24.0-255,5738,285910,13,391823
13511,0.039409,172.31.36.0-255,66,285976,13,391823
13512,0.041358,172.217.24.0-255,2902,288878,13,391823
13513,0.041364,172.31.36.0-255,66,288944,13,391823
13514,0.041402,172.217.24.0-255,2902,291846,13,391823
13515,0.041405,172.31.36.0-255,66,291912,13,391823
13516,0.043318,172.217.24.0-255,2902,294814,13,391823
13517,0.043324,172.31.36.0-255,66,294880,13,391823
13518,0.043358,172.217.24.0-255,2902,297782,13,391823
13519,0.043361,172.31.36.0-255,66,297848,13,391823
13520,0.04526,172.217.24.0-255,2902,300750,13,391823
13521,0.045283,172.31.36.0-255,66,300816,13,391823
13522,0.045314,172.217.24.0-255,2902,303718,13,391823
13523,0.045319,172.31.36.0-255,66,303784,13,391823
13524,0.047227,172.217.24.0-255,2902,306686,13,391823
13525,0.047233,172.31.36.0-255,66,306752,13,391823
13526,0.04727,172.217.24.0-255,2902,309654,13,391823
13527,0.047274,172.31.36.0-255,66,309720,13,391823
13528,0.049173,172.217.24.0-255,2902,312622,13,391823
13529,0.049178,172.31.36.0-255,66,312688,13,391823
13530,0.049216,172.217.24.0-255,2902,315590,13,391823
13531,0.049219,172.31.36.0-255,66,315656,13,391823
13532,0.05113,172.217.24.0-255,2902,318558,13,391823
13533,0.05114,172.31.36.0-255,66,318624,13,391823
13534,0.05118,172.217.24.0-255,2902,321526,13,391823
13535,0.051184,172.31.36.0-255,66,321592,13,391823
13536,0.053069,172.217.24.0-255,2902,324494,13,391823
13537,0.053075,172.31.36.0-255,66,324560,13,391823
13538,0.05311,172.217.24.0-255,2902,327462,13,391823
13539,0.053113,172.31.36.0-255,66,327528,13,391823
13540,0.055009,172.217.24.0-255,2902,330430,13,391823
13541,0.055014,172.31.36.0-255,66,330496,13,391823
13542,0.055048,172.217.24.0-255,2902,333398,13,391823
13543,0.055051,172.31.36.0-255,66,333464,13,391823
13544,0.056958,172.217.24.0-255,2902,336366,13,391823
13545,0.056964,172.31.36.0-255,66,336432,13,391823
13546,0.057,172.217.24.0-255,2902,339334,13,391823
13547,0.057003,172.31.36.0-255,66,339400,13,391823
13548,0.058906,172.217.24.0-255,2902,342302,13,391823
13549,0.058914,172.31.36.0-255,66,342368,13,391823
13550,0.058946,172.217.24.0-255,2902,345270,13,391823
13551,0.058949,172.31.36.0-255,66,345336,13,391823
13552,0.060849,172.217.24.0-255,2902,348238,13,391823
13553,0.060854,172.31.36.0-255,66,348304,13,391823
13554,0.06089,172.217.24.0-255,2902,351206,13,391823
13555,0.060893,172.31.36.0-255,66,351272,13,391823
13556,0.062788,172.217.24.0-255,2902,354174,13,391823
13557,0.062794,172.31.36.0-255,66,354240,13,391823
13558,0.062836,172.217.24.0-255,2902,357142,13,391823
13559,0.062839,172.31.36.0-255,66,357208,13,391823
13560,0.064748,172.217.24.0-255,2902,360110,13,391823
13561,0.064754,172.31.36.0-255,66,360176,13,391823
13562,0.064793,172.217.24.0-255,2902,363078,13,391823
13563,0.064797,172.31.36.0-255,66,363144,13,391823
13564,0.066742,172.217.24.0-255,2902,366046,13,391823
13565,0.066748,172.31.36.0-255,66,366112,13,391823
13566,0.066784,172.217.24.0-255,2902,369014,13,391823
13567,0.066787,172.31.36.0-255,66,369080,13,391823
13568,0.068745,172.217.24.0-255,2902,371982,13,391823
13569,0.068751,172.31.36.0-255,66,372048,13,391823
13570,0.068783,172.217.24.0-255,2902,374950,13,391823
13571,0.068786,172.31.36.0-255,66,375016,13,391823
13572,0.070698,172.217.24.0-255,2902,377918,13,391823
13573,0.070706,172.31.36.0-255,66,377984,13,391823
13574,0.070746,172.217.24.0-255,2902,380886,13,391823
13575,0.070749,172.31.36.0-255,66,380952,13,391823
13576,0.07265,172.217.24.0-255,2902,383854,13,391823
13577,0.072655,172.31.36.0-255,66,383920,13,391823
13578,0.072691,172.217.24.0-255,2902,386822,13,391823
13579,0.072694,172.31.36.0-255,66,386888,13,391823
13580,0.074599,172.217.24.0-255,2902,389790,13,391823
13581,0.074604,172.31.36.0-255,66,389856,13,391823
13582,0.074636,172.217.24.0-255,1730,391586,13,391823
13583,0.074639,172.31.36.0-255,66,391652,13,391823
13584,0.074807,172.31.36.0-255,105,391757,13,391823
13585,0.076725,172.217.24.0-255,66,391823,13,391823
13586,0.0,172.217.194.0-255,152,152,13,363842
13587,2.9e-05,172.31.36.0-255,66,218,13,363842
13588,3.6e-05,172.217.194.0-255,1484,1702,13,363842
13589,4e-05,172.31.36.0-255,66,1768,13,363842
13590,4.5e-05,172.217.194.0-255,2902,4670,13,363842
13591,5.6e-05,172.31.36.0-255,66,4736,13,363842
13592,6.3e-05,172.217.194.0-255,7156,11892,13,363842
13593,6.6e-05,172.31.36.0-255,66,11958,13,363842
13594,0.0001,172.217.194.0-255,2045,14003,13,363842
13595,0.000102,172.31.36.0-255,66,14069,13,363842
13596,0.000135,172.217.194.0-255,2902,16971,13,363842
13597,0.000139,172.31.36.0-255,66,17037,13,363842
13598,0.000146,172.217.194.0-255,7156,24193,13,363842
13599,0.000148,172.31.36.0-255,66,24259,13,363842
13600,0.00016,172.217.194.0-255,6797,31056,13,363842
13601,0.000164,172.31.36.0-255,66,31122,13,363842
13602,0.000237,172.217.194.0-255,1484,32606,13,363842
13603,0.00024,172.31.36.0-255,66,32672,13,363842
13604,0.000245,172.217.194.0-255,2902,35574,13,363842
13605,0.000247,172.31.36.0-255,66,35640,13,363842
13606,0.00025,172.217.194.0-255,1484,37124,13,363842
13607,0.000252,172.31.36.0-255,66,37190,13,363842
13608,0.000288,172.217.194.0-255,4320,41510,13,363842
13609,0.000292,172.31.36.0-255,66,41576,13,363842
13610,0.0003,172.217.194.0-255,6797,48373,13,363842
13611,0.000302,172.31.36.0-255,66,48439,13,363842
13612,0.000372,172.217.194.0-255,7156,55595,13,363842
13613,0.000376,172.31.36.0-255,66,55661,13,363842
13614,0.000385,172.217.194.0-255,9633,65294,13,363842
13615,0.000394,172.31.36.0-255,66,65360,13,363842
13616,0.000877,172.217.194.0-255,646,66006,13,363842
13617,0.000882,172.31.36.0-255,66,66072,13,363842
13618,0.000913,172.217.194.0-255,1484,67556,13,363842
13619,0.000919,172.217.194.0-255,2902,70458,13,363842
13620,0.000922,172.31.36.0-255,66,70524,13,363842
13621,0.000928,172.217.194.0-255,5738,76262,13,363842
13622,0.00093,172.31.36.0-255,66,76328,13,363842
13623,0.000969,172.31.36.0-255,66,76394,13,363842
13624,0.000977,172.217.194.0-255,5738,82132,13,363842
13625,0.00098,172.31.36.0-255,66,82198,13,363842
13626,0.00101,172.217.194.0-255,5020,87218,13,363842
13627,0.001013,172.31.36.0-255,66,87284,13,363842
13628,0.001017,172.217.194.0-255,1484,88768,13,363842
13629,0.001021,172.217.194.0-255,2902,91670,13,363842
13630,0.001024,172.31.36.0-255,66,91736,13,363842
13631,0.001055,172.217.194.0-255,5738,97474,13,363842
13632,0.001059,172.31.36.0-255,66,97540,13,363842
13633,0.001066,172.217.194.0-255,6248,103788,13,363842
13634,0.001069,172.31.36.0-255,66,103854,13,363842
13635,0.001107,172.217.194.0-255,2902,106756,13,363842
13636,0.001111,172.31.36.0-255,66,106822,13,363842
13637,0.001116,172.217.194.0-255,4320,111142,13,363842
13638,0.001118,172.31.36.0-255,66,111208,13,363842
13639,0.001129,172.217.194.0-255,4320,115528,13,363842
13640,0.001132,172.31.36.0-255,66,115594,13,363842
13641,0.001163,172.217.194.0-255,4320,119914,13,363842
13642,0.001166,172.31.36.0-255,66,119980,13,363842
13643,0.001176,172.217.194.0-255,9992,129972,13,363842
13644,0.001184,172.31.36.0-255,66,130038,13,363842
13645,0.001214,172.217.194.0-255,7856,137894,13,363842
13646,0.001217,172.31.36.0-255,66,137960,13,363842
13647,0.001609,172.217.194.0-255,1484,139444,13,363842
13648,0.001616,172.217.194.0-255,2902,142346,13,363842
13649,0.00162,172.31.36.0-255,66,142412,13,363842
13650,0.001626,172.217.194.0-255,2902,145314,13,363842
13651,0.001628,172.31.36.0-255,66,145380,13,363842
13652,0.00165,172.217.194.0-255,2902,148282,13,363842
13653,0.001654,172.31.36.0-255,66,148348,13,363842
13654,0.001659,172.217.194.0-255,4320,152668,13,363842
13655,0.001661,172.31.36.0-255,66,152734,13,363842
13656,0.001693,172.217.194.0-255,8574,161308,13,363842
13657,0.001696,172.31.36.0-255,66,161374,13,363842
13658,0.001704,172.217.194.0-255,9992,171366,13,363842
13659,0.001706,172.31.36.0-255,66,171432,13,363842
13660,0.001713,172.217.194.0-255,766,172198,13,363842
13661,0.001716,172.217.194.0-255,1484,173682,13,363842
13662,0.001718,172.31.36.0-255,66,173748,13,363842
13663,0.001722,172.217.194.0-255,1484,175232,13,363842
13664,0.001745,172.217.194.0-255,2902,178134,13,363842
13665,0.001747,172.31.36.0-255,66,178200,13,363842
13666,0.001755,172.217.194.0-255,9992,188192,13,363842
13667,0.001757,172.31.36.0-255,66,188258,13,363842
13668,0.001764,172.217.194.0-255,1484,189742,13,363842
13669,0.001791,172.217.194.0-255,7156,196898,13,363842
13670,0.001794,172.31.36.0-255,66,196964,13,363842
13671,0.00182,172.217.194.0-255,7156,204120,13,363842
13672,0.001822,172.31.36.0-255,66,204186,13,363842
13673,0.001845,172.217.194.0-255,2184,206370,13,363842
13674,0.001847,172.31.36.0-255,66,206436,13,363842
13675,0.001871,172.217.194.0-255,1484,207920,13,363842
13676,0.001874,172.217.194.0-255,2902,210822,13,363842
13677,0.001877,172.31.36.0-255,66,210888,13,363842
13678,0.001903,172.217.194.0-255,5738,216626,13,363842
13679,0.001905,172.31.36.0-255,66,216692,13,363842
13680,0.00195,172.217.194.0-255,1484,218176,13,363842
13681,0.001973,172.31.36.0-255,66,218242,13,363842
13682,0.001982,172.217.194.0-255,9992,228234,13,363842
13683,0.001984,172.31.36.0-255,66,228300,13,363842
13684,0.001995,172.217.194.0-255,766,229066,13,363842
13685,0.002017,172.217.194.0-255,1484,230550,13,363842
13686,0.002019,172.31.36.0-255,66,230616,13,363842
13687,0.002022,172.217.194.0-255,1484,232100,13,363842
13688,0.002042,172.217.194.0-255,1484,233584,13,363842
13689,0.002044,172.31.36.0-255,66,233650,13,363842
13690,0.002049,172.217.194.0-255,4320,237970,13,363842
13691,0.002051,172.31.36.0-255,66,238036,13,363842
13692,0.00207,172.217.194.0-255,1484,239520,13,363842
13693,0.002077,172.217.194.0-255,7156,246676,13,363842
13694,0.002079,172.31.36.0-255,66,246742,13,363842
13695,0.002105,172.217.194.0-255,5738,252480,13,363842
13696,0.002107,172.31.36.0-255,66,252546,13,363842
13697,0.002114,172.217.194.0-255,8574,261120,13,363842
13698,0.002116,172.31.36.0-255,66,261186,13,363842
13699,0.002124,172.217.194.0-255,2184,263370,13,363842
13700,0.002126,172.31.36.0-255,66,263436,13,363842
13701,0.004167,172.217.194.0-255,2902,266338,13,363842
13702,0.004173,172.31.36.0-255,66,266404,13,363842
13703,0.004201,172.217.194.0-255,2902,269306,13,363842
13704,0.004204,172.31.36.0-255,66,269372,13,363842
13705,0.00622,172.217.194.0-255,2902,272274,13,363842
13706,0.006229,172.31.36.0-255,66,272340,13,363842
13707,0.006258,172.217.194.0-255,2902,275242,13,363842
13708,0.006261,172.31.36.0-255,66,275308,13,363842
13709,0.008314,172.217.194.0-255,5738,281046,13,363842
13710,0.008319,172.31.36.0-255,66,281112,13,363842
13711,0.010395,172.217.194.0-255,5738,286850,13,363842
13712,0.010404,172.31.36.0-255,66,286916,13,363842
13713,0.012488,172.217.194.0-255,5738,292654,13,363842
13714,0.012495,172.31.36.0-255,66,292720,13,363842
13715,0.014542,172.217.194.0-255,5738,298458,13,363842
13716,0.014549,172.31.36.0-255,66,298524,13,363842
13717,0.016621,172.217.194.0-255,5738,304262,13,363842
13718,0.016631,172.31.36.0-255,66,304328,13,363842
13719,0.018719,172.217.194.0-255,5738,310066,13,363842
13720,0.018727,172.31.36.0-255,66,310132,13,363842
13721,0.020834,172.217.194.0-255,4320,314452,13,363842
13722,0.020843,172.31.36.0-255,66,314518,13,363842
13723,0.0209,172.217.194.0-255,1484,316002,13,363842
13724,0.022905,172.217.194.0-255,4320,320322,13,363842
13725,0.022913,172.31.36.0-255,66,320388,13,363842
13726,0.024973,172.217.194.0-255,4320,324708,13,363842
13727,0.024979,172.31.36.0-255,66,324774,13,363842
13728,0.025015,172.217.194.0-255,1484,326258,13,363842
13729,0.02704,172.217.194.0-255,4320,330578,13,363842
13730,0.027047,172.31.36.0-255,66,330644,13,363842
13731,0.029122,172.217.194.0-255,5738,336382,13,363842
13732,0.02913,172.31.36.0-255,66,336448,13,363842
13733,0.031185,172.217.194.0-255,5738,342186,13,363842
13734,0.031191,172.31.36.0-255,66,342252,13,363842
13735,0.032089,172.31.36.0-255,172,342424,13,363842
13736,0.032127,172.31.36.0-255,1110,343534,13,363842
13737,0.032154,172.31.36.0-255,1514,345048,13,363842
13738,0.032155,172.31.36.0-255,1295,346343,13,363842
13739,0.033256,172.217.194.0-255,5738,352081,13,363842
13740,0.033261,172.31.36.0-255,66,352147,13,363842
13741,0.033745,104.244.42.0-255,66,352213,13,363842
13742,0.033759,104.244.42.0-255,66,352279,13,363842
13743,0.033812,104.244.42.0-255,66,352345,13,363842
13744,0.035322,172.217.194.0-255,4320,356665,13,363842
13745,0.035327,172.31.36.0-255,66,356731,13,363842
13746,0.035362,172.217.194.0-255,1484,358215,13,363842
13747,0.037369,172.217.194.0-255,4320,362535,13,363842
13748,0.037376,172.31.36.0-255,66,362601,13,363842
13749,0.039428,172.217.194.0-255,1004,363605,13,363842
13750,0.039563,172.31.36.0-255,66,363671,13,363842
13751,0.03959,172.31.36.0-255,105,363776,13,363842
13752,0.041609,172.217.194.0-255,66,363842,13,363842
13753,0.0,74.125.68.0-255,153,153,13,349423
13754,3.8e-05,74.125.68.0-255,1484,1637,13,349423
13755,4.4e-05,172.31.36.0-255,66,1703,13,349423
13756,7.6e-05,74.125.68.0-255,2902,4605,13,349423
13757,8e-05,172.31.36.0-255,66,4671,13,349423
13758,8.3e-05,74.125.68.0-255,1484,6155,13,349423
13759,0.000107,74.125.68.0-255,2902,9057,13,349423
13760,0.00011,172.31.36.0-255,66,9123,13,349423
13761,0.000137,74.125.68.0-255,4871,13994,13,349423
13762,0.00014,172.31.36.0-255,66,14060,13,349423
13763,0.000192,74.125.68.0-255,1484,15544,13,349423
13764,0.000195,74.125.68.0-255,1484,17028,13,349423
13765,0.000198,172.31.36.0-255,66,17094,13,349423
13766,0.000226,74.125.68.0-255,1484,18578,13,349423
13767,0.000232,74.125.68.0-255,4320,22898,13,349423
13768,0.000235,172.31.36.0-255,66,22964,13,349423
13769,0.000239,74.125.68.0-255,2902,25866,13,349423
13770,0.000241,172.31.36.0-255,66,25932,13,349423
13771,0.000273,74.125.68.0-255,2902,28834,13,349423
13772,0.000276,172.31.36.0-255,66,28900,13,349423
13773,0.00028,74.125.68.0-255,2543,31443,13,349423
13774,0.000283,172.31.36.0-255,66,31509,13,349423
13775,0.000392,74.125.68.0-255,1484,32993,13,349423
13776,0.000411,74.125.68.0-255,1484,34477,13,349423
13777,0.000416,172.31.36.0-255,66,34543,13,349423
13778,0.000426,74.125.68.0-255,1484,36027,13,349423
13779,0.000434,74.125.68.0-255,1484,37511,13,349423
13780,0.000437,172.31.36.0-255,66,37577,13,349423
13781,0.000466,74.125.68.0-255,4320,41897,13,349423
13782,0.000469,172.31.36.0-255,66,41963,13,349423
13783,0.000476,74.125.68.0-255,6797,48760,13,349423
13784,0.000479,172.31.36.0-255,66,48826,13,349423
13785,0.00049,74.125.68.0-255,5738,54564,13,349423
13786,0.000493,172.31.36.0-255,66,54630,13,349423
13787,0.000498,74.125.68.0-255,4320,58950,13,349423
13788,0.000501,172.31.36.0-255,66,59016,13,349423
13789,0.000537,74.125.68.0-255,2902,61918,13,349423
13790,0.00054,172.31.36.0-255,66,61984,13,349423
13791,0.000545,74.125.68.0-255,4239,66223,13,349423
13792,0.000549,172.31.36.0-255,66,66289,13,349423
13793,0.000565,74.125.68.0-255,407,66696,13,349423
13794,0.000976,74.125.68.0-255,1484,68180,13,349423
13795,0.000983,172.31.36.0-255,66,68246,13,349423
13796,0.000989,74.125.68.0-255,2902,71148,13,349423
13797,0.000991,172.31.36.0-255,66,71214,13,349423
13798,0.000995,74.125.68.0-255,2902,74116,13,349423
13799,0.000998,172.31.36.0-255,66,74182,13,349423
13800,0.001022,74.125.68.0-255,2902,77084,13,349423
13801,0.001032,172.31.36.0-255,66,77150,13,349423
13802,0.001038,74.125.68.0-255,5738,82888,13,349423
13803,0.001041,172.31.36.0-255,66,82954,13,349423
13804,0.001079,74.125.68.0-255,5738,88692,13,349423
13805,0.001082,172.31.36.0-255,66,88758,13,349423
13806,0.001103,172.31.36.0-255,66,88824,13,349423
13807,0.001713,74.125.68.0-255,1484,90308,13,349423
13808,0.001733,74.125.68.0-255,2902,93210,13,349423
13809,0.001735,172.31.36.0-255,66,93276,13,349423
13810,0.001739,74.125.68.0-255,1484,94760,13,349423
13811,0.001742,74.125.68.0-255,1484,96244,13,349423
13812,0.001744,172.31.36.0-255,66,96310,13,349423
13813,0.001762,74.125.68.0-255,1484,97794,13,349423
13814,0.00177,74.125.68.0-255,4320,102114,13,349423
13815,0.001773,172.31.36.0-255,66,102180,13,349423
13816,0.001796,74.125.68.0-255,1484,103664,13,349423
13817,0.001799,74.125.68.0-255,1484,105148,13,349423
13818,0.001801,172.31.36.0-255,66,105214,13,349423
13819,0.001826,74.125.68.0-255,5738,110952,13,349423
13820,0.001828,172.31.36.0-255,66,111018,13,349423
13821,0.001849,74.125.68.0-255,8574,119592,13,349423
13822,0.001851,172.31.36.0-255,66,119658,13,349423
13823,0.001894,74.125.68.0-255,1484,121142,13,349423
13824,0.001912,74.125.68.0-255,2184,123326,13,349423
13825,0.001915,172.31.36.0-255,66,123392,13,349423
13826,0.002103,74.125.68.0-255,1484,124876,13,349423
13827,0.002106,74.125.68.0-255,2902,127778,13,349423
13828,0.002109,172.31.36.0-255,66,127844,13,349423
13829,0.002134,74.125.68.0-255,5738,133582,13,349423
13830,0.002136,172.31.36.0-255,66,133648,13,349423
13831,0.002161,74.125.68.0-255,4320,137968,13,349423
13832,0.002163,172.31.36.0-255,66,138034,13,349423
13833,0.002169,74.125.68.0-255,5738,143772,13,349423
13834,0.002171,172.31.36.0-255,66,143838,13,349423
13835,0.002206,172.31.36.0-255,66,143904,13,349423
13836,0.00221,74.125.68.0-255,2184,146088,13,349423
13837,0.002212,172.31.36.0-255,66,146154,13,349423
13838,0.002302,74.125.68.0-255,1484,147638,13,349423
13839,0.00232,74.125.68.0-255,2902,150540,13,349423
13840,0.002322,172.31.36.0-255,66,150606,13,349423
13841,0.002382,74.125.68.0-255,5738,156344,13,349423
13842,0.002385,172.31.36.0-255,66,156410,13,349423
13843,0.00239,74.125.68.0-255,5738,162148,13,349423
13844,0.002392,172.31.36.0-255,66,162214,13,349423
13845,0.002403,74.125.68.0-255,7156,169370,13,349423
13846,0.002406,172.31.36.0-255,66,169436,13,349423
13847,0.00241,74.125.68.0-255,4320,173756,13,349423
13848,0.002412,172.31.36.0-255,66,173822,13,349423
13849,0.002442,74.125.68.0-255,6438,180260,13,349423
13850,0.002444,172.31.36.0-255,66,180326,13,349423
13851,0.002455,74.125.68.0-255,7156,187482,13,349423
13852,0.002457,172.31.36.0-255,66,187548,13,349423
13853,0.002485,74.125.68.0-255,4320,191868,13,349423
13854,0.002487,172.31.36.0-255,66,191934,13,349423
13855,0.002492,74.125.68.0-255,4320,196254,13,349423
13856,0.002494,172.31.36.0-255,66,196320,13,349423
13857,0.002532,172.31.36.0-255,66,196386,13,349423
13858,0.002535,74.125.68.0-255,766,197152,13,349423
13859,0.002587,74.125.68.0-255,1484,198636,13,349423
13860,0.002589,172.31.36.0-255,66,198702,13,349423
13861,0.002607,74.125.68.0-255,2902,201604,13,349423
13862,0.002609,172.31.36.0-255,66,201670,13,349423
13863,0.002612,74.125.68.0-255,1484,203154,13,349423
13864,0.002635,74.125.68.0-255,2902,206056,13,349423
13865,0.002637,172.31.36.0-255,66,206122,13,349423
13866,0.002639,74.125.68.0-255,1484,207606,13,349423
13867,0.002676,74.125.68.0-255,7156,214762,13,349423
13868,0.002679,172.31.36.0-255,66,214828,13,349423
13869,0.002702,74.125.68.0-255,1484,216312,13,349423
13870,0.002709,74.125.68.0-255,7156,223468,13,349423
13871,0.002711,172.31.36.0-255,66,223534,13,349423
13872,0.002714,74.125.68.0-255,1484,225018,13,349423
13873,0.002719,74.125.68.0-255,4320,229338,13,349423
13874,0.002721,172.31.36.0-255,66,229404,13,349423
13875,0.002749,74.125.68.0-255,2184,231588,13,349423
13876,0.002751,172.31.36.0-255,66,231654,13,349423
13877,0.002864,74.125.68.0-255,1484,233138,13,349423
13878,0.002869,74.125.68.0-255,2902,236040,13,349423
13879,0.002872,172.31.36.0-255,66,236106,13,349423
13880,0.002897,74.125.68.0-255,2902,239008,13,349423
13881,0.0029,172.31.36.0-255,66,239074,13,349423
13882,0.002912,74.125.68.0-255,2902,241976,13,349423
13883,0.002918,172.31.36.0-255,66,242042,13,349423
13884,0.002921,74.125.68.0-255,1484,243526,13,349423
13885,0.002955,74.125.68.0-255,9992,253518,13,349423
13886,0.002958,172.31.36.0-255,66,253584,13,349423
13887,0.00296,74.125.68.0-255,1484,255068,13,349423
13888,0.002988,74.125.68.0-255,10692,265760,13,349423
13889,0.002991,172.31.36.0-255,66,265826,13,349423
13890,0.002994,74.125.68.0-255,1484,267310,13,349423
13891,0.003016,74.125.68.0-255,1484,268794,13,349423
13892,0.003018,172.31.36.0-255,66,268860,13,349423
13893,0.003021,74.125.68.0-255,1484,270344,13,349423
13894,0.003025,74.125.68.0-255,2902,273246,13,349423
13895,0.003028,172.31.36.0-255,66,273312,13,349423
13896,0.003051,74.125.68.0-255,1484,274796,13,349423
13897,0.003054,74.125.68.0-255,1484,276280,13,349423
13898,0.003056,172.31.36.0-255,66,276346,13,349423
13899,0.003059,74.125.68.0-255,1484,277830,13,349423
13900,0.003062,74.125.68.0-255,1484,279314,13,349423
13901,0.003064,172.31.36.0-255,66,279380,13,349423
13902,0.003073,74.125.68.0-255,2902,282282,13,349423
13903,0.003075,172.31.36.0-255,66,282348,13,349423
13904,0.003098,74.125.68.0-255,1484,283832,13,349423
13905,0.003124,74.125.68.0-255,7156,290988,13,349423
13906,0.003127,172.31.36.0-255,66,291054,13,349423
13907,0.003131,74.125.68.0-255,2902,293956,13,349423
13908,0.003133,172.31.36.0-255,66,294022,13,349423
13909,0.003135,74.125.68.0-255,1484,295506,13,349423
13910,0.003158,74.125.68.0-255,2902,298408,13,349423
13911,0.003164,172.31.36.0-255,66,298474,13,349423
13912,0.003168,74.125.68.0-255,2184,300658,13,349423
13913,0.00317,172.31.36.0-255,66,300724,13,349423
13914,0.003201,74.125.68.0-255,2902,303626,13,349423
13915,0.003204,172.31.36.0-255,66,303692,13,349423
13916,0.003211,74.125.68.0-255,7156,310848,13,349423
13917,0.003213,172.31.36.0-255,66,310914,13,349423
13918,0.003245,74.125.68.0-255,7156,318070,13,349423
13919,0.003248,172.31.36.0-255,66,318136,13,349423
13920,0.003294,74.125.68.0-255,2902,321038,13,349423
13921,0.003296,172.31.36.0-255,66,321104,13,349423
13922,0.003324,74.125.68.0-255,5738,326842,13,349423
13923,0.003327,172.31.36.0-255,66,326908,13,349423
13924,0.003332,74.125.68.0-255,5738,332646,13,349423
13925,0.003334,172.31.36.0-255,66,332712,13,349423
13926,0.003344,74.125.68.0-255,5020,337732,13,349423
13927,0.003346,172.31.36.0-255,66,337798,13,349423
13928,0.003351,74.125.68.0-255,4320,342118,13,349423
13929,0.003353,172.31.36.0-255,66,342184,13,349423
13930,0.003374,74.125.68.0-255,1484,343668,13,349423
13931,0.003377,74.125.68.0-255,865,344533,13,349423
13932,0.003383,172.31.36.0-255,66,344599,13,349423
13933,0.003387,74.125.68.0-255,97,344696,13,349423
13934,0.003473,74.125.68.0-255,105,344801,13,349423
13935,0.005618,172.31.36.0-255,101,344902,13,349423
13936,0.007247,172.31.36.0-255,105,345007,13,349423
13937,0.008101,74.125.68.0-255,66,345073,13,349423
13938,0.009724,74.125.68.0-255,66,345139,13,349423
13939,0.027784,172.31.36.0-255,167,345306,13,349423
13940,0.027816,172.31.36.0-255,1109,346415,13,349423
13941,0.027855,172.31.36.0-255,1514,347929,13,349423
13942,0.027857,172.31.36.0-255,1296,349225,13,349423
13943,0.029322,104.244.42.0-255,66,349291,13,349423
13944,0.029368,104.244.42.0-255,66,349357,13,349423
13945,0.029412,104.244.42.0-255,66,349423,13,349423
13946,0.0,172.217.194.0-255,153,153,13,248357
13947,2.4e-05,172.31.36.0-255,66,219,13,248357
13948,3.2e-05,172.217.194.0-255,1484,1703,13,248357
13949,3.6e-05,172.31.36.0-255,66,1769,13,248357
13950,4.2e-05,172.217.194.0-255,2902,4671,13,248357
13951,4.5e-05,172.31.36.0-255,66,4737,13,248357
13952,5.1e-05,172.217.194.0-255,4320,9057,13,248357
13953,5.3e-05,172.31.36.0-255,66,9123,13,248357
13954,6.3e-05,172.217.194.0-255,9138,18261,13,248357
13955,6.6e-05,172.31.36.0-255,66,18327,13,248357
13956,0.000105,172.31.36.0-255,66,18393,13,248357
13957,0.000158,172.217.194.0-255,1484,19877,13,248357
13958,0.000161,172.31.36.0-255,66,19943,13,248357
13959,0.000165,172.217.194.0-255,2902,22845,13,248357
13960,0.000167,172.31.36.0-255,66,22911,13,248357
13961,0.000196,172.217.194.0-255,5738,28649,13,248357
13962,0.000199,172.31.36.0-255,66,28715,13,248357
13963,0.000222,172.217.194.0-255,7156,35871,13,248357
13964,0.000225,172.31.36.0-255,66,35937,13,248357
13965,0.000251,172.217.194.0-255,6797,42734,13,248357
13966,0.000254,172.31.36.0-255,66,42800,13,248357
13967,0.000264,172.217.194.0-255,9633,52433,13,248357
13968,0.000266,172.31.36.0-255,66,52499,13,248357
13969,0.000284,172.217.194.0-255,645,53144,13,248357
13970,0.000287,172.31.36.0-255,66,53210,13,248357
13971,0.00061,172.217.194.0-255,1484,54694,13,248357
13972,0.000615,172.31.36.0-255,66,54760,13,248357
13973,0.000621,172.217.194.0-255,2902,57662,13,248357
13974,0.000624,172.31.36.0-255,66,57728,13,248357
13975,0.00063,172.217.194.0-255,2902,60630,13,248357
13976,0.000632,172.31.36.0-255,66,60696,13,248357
13977,0.000661,172.217.194.0-255,2902,63598,13,248357
13978,0.000664,172.31.36.0-255,66,63664,13,248357
13979,0.000674,172.217.194.0-255,9992,73656,13,248357
13980,0.000676,172.31.36.0-255,66,73722,13,248357
13981,0.000701,172.217.194.0-255,2902,76624,13,248357
13982,0.000704,172.31.36.0-255,66,76690,13,248357
13983,0.000724,172.217.194.0-255,10692,87382,13,248357
13984,0.000728,172.31.36.0-255,66,87448,13,248357
13985,0.000804,172.217.194.0-255,1484,88932,13,248357
13986,0.000809,172.217.194.0-255,1484,90416,13,248357
13987,0.000812,172.31.36.0-255,66,90482,13,248357
13988,0.00083,172.217.194.0-255,1484,91966,13,248357
13989,0.000838,172.217.194.0-255,5738,97704,13,248357
13990,0.000841,172.31.36.0-255,66,97770,13,248357
13991,0.000847,172.217.194.0-255,5738,103508,13,248357
13992,0.00085,172.31.36.0-255,66,103574,13,248357
13993,0.000881,172.217.194.0-255,7156,110730,13,248357
13994,0.000885,172.31.36.0-255,66,110796,13,248357
13995,0.000894,172.217.194.0-255,9992,120788,13,248357
13996,0.000897,172.31.36.0-255,66,120854,13,248357
13997,0.000931,172.217.194.0-255,4320,125174,13,248357
13998,0.000934,172.31.36.0-255,66,125240,13,248357
13999,0.000982,172.31.36.0-255,66,125306,13,248357
14000,0.000992,172.217.194.0-255,9274,134580,13,248357
14001,0.000994,172.31.36.0-255,66,134646,13,248357
14002,0.001234,172.217.194.0-255,1484,136130,13,248357
14003,0.001241,172.217.194.0-255,2902,139032,13,248357
14004,0.001245,172.31.36.0-255,66,139098,13,248357
14005,0.001252,172.217.194.0-255,5738,144836,13,248357
14006,0.001254,172.31.36.0-255,66,144902,13,248357
14007,0.00127,172.217.194.0-255,1484,146386,13,248357
14008,0.00129,172.217.194.0-255,8574,154960,13,248357
14009,0.001293,172.31.36.0-255,66,155026,13,248357
14010,0.0013,172.217.194.0-255,5738,160764,13,248357
14011,0.001302,172.31.36.0-255,66,160830,13,248357
14012,0.00133,172.217.194.0-255,5738,166568,13,248357
14013,0.001333,172.31.36.0-255,66,166634,13,248357
14014,0.00135,172.31.36.0-255,66,166700,13,248357
14015,0.001371,172.217.194.0-255,2184,168884,13,248357
14016,0.001374,172.31.36.0-255,66,168950,13,248357
14017,0.001397,172.31.36.0-255,66,169016,13,248357
14018,0.001424,172.217.194.0-255,6438,175454,13,248357
14019,0.001427,172.31.36.0-255,66,175520,13,248357
14020,0.001431,172.217.194.0-255,1484,177004,13,248357
14021,0.001462,172.31.36.0-255,66,177070,13,248357
14022,0.001472,172.217.194.0-255,1484,178554,13,248357
14023,0.001507,172.31.36.0-255,66,178620,13,248357
14024,0.001523,172.31.36.0-255,66,178686,13,248357
14025,0.001547,172.217.194.0-255,1484,180170,13,248357
14026,0.001555,172.217.194.0-255,7156,187326,13,248357
14027,0.001561,172.31.36.0-255,66,187392,13,248357
14028,0.001572,172.217.194.0-255,5738,193130,13,248357
14029,0.001574,172.31.36.0-255,66,193196,13,248357
14030,0.001595,172.217.194.0-255,4320,197516,13,248357
14031,0.001598,172.31.36.0-255,66,197582,13,248357
14032,0.001623,172.217.194.0-255,9992,207574,13,248357
14033,0.001626,172.31.36.0-255,66,207640,13,248357
14034,0.001695,172.31.36.0-255,66,207706,13,248357
14035,0.001722,172.217.194.0-255,10692,218398,13,248357
14036,0.001724,172.31.36.0-255,66,218464,13,248357
14037,0.001727,172.217.194.0-255,1484,219948,13,248357
14038,0.001732,172.217.194.0-255,2902,222850,13,248357
14039,0.001734,172.31.36.0-255,66,222916,13,248357
14040,0.00174,172.217.194.0-255,5738,228654,13,248357
14041,0.001744,172.31.36.0-255,66,228720,13,248357
14042,0.001747,172.217.194.0-255,1484,230204,13,248357
14043,0.001767,172.217.194.0-255,9992,240196,13,248357
14044,0.00177,172.31.36.0-255,66,240262,13,248357
14045,0.001803,172.217.194.0-255,1484,241746,13,248357
14046,0.001807,172.217.194.0-255,1484,243230,13,248357
14047,0.001809,172.31.36.0-255,66,243296,13,248357
14048,0.001826,172.31.36.0-255,66,243362,13,248357
14049,0.001829,172.217.194.0-255,267,243629,13,248357
14050,0.001832,172.217.194.0-255,97,243726,13,248357
14051,0.001852,172.217.194.0-255,105,243831,13,248357
14052,0.004044,172.31.36.0-255,66,243897,13,248357
14053,0.004082,172.31.36.0-255,105,244002,13,248357
14054,0.006376,172.217.194.0-255,66,244068,13,248357
14055,0.035154,172.31.36.0-255,172,244240,13,248357
14056,0.035201,172.31.36.0-255,1110,245350,13,248357
14057,0.035271,172.31.36.0-255,1514,246864,13,248357
14058,0.035273,172.31.36.0-255,1295,248159,13,248357
14059,0.036687,104.244.42.0-255,66,248225,13,248357
14060,0.036737,104.244.42.0-255,66,248291,13,248357
14061,0.036846,104.244.42.0-255,66,248357,13,248357
14062,0.0,74.125.24.0-255,188,188,13,263385
14063,1.9e-05,74.125.24.0-255,1484,1672,13,263385
14064,2.9e-05,172.31.36.0-255,66,1738,13,263385
14065,3.7e-05,74.125.24.0-255,2902,4640,13,263385
14066,4.1e-05,172.31.36.0-255,66,4706,13,263385
14067,4.6e-05,74.125.24.0-255,4320,9026,13,263385
14068,5e-05,172.31.36.0-255,66,9092,13,263385
14069,8.9e-05,172.31.36.0-255,66,9158,13,263385
14070,9.9e-05,74.125.24.0-255,9992,19150,13,263385
14071,0.000101,172.31.36.0-255,66,19216,13,263385
14072,0.000121,74.125.24.0-255,1484,20700,13,263385
14073,0.000137,74.125.24.0-255,5738,26438,13,263385
14074,0.00014,172.31.36.0-255,66,26504,13,263385
14075,0.000161,74.125.24.0-255,9274,35778,13,263385
14076,0.000164,172.31.36.0-255,66,35844,13,263385
14077,0.00021,172.31.36.0-255,66,35910,13,263385
14078,0.000213,74.125.24.0-255,1484,37394,13,263385
14079,0.000227,74.125.24.0-255,1458,38852,13,263385
14080,0.00023,172.31.36.0-255,66,38918,13,263385
14081,0.000379,74.125.24.0-255,1484,40402,13,263385
14082,0.000397,74.125.24.0-255,2902,43304,13,263385
14083,0.000402,172.31.36.0-255,66,43370,13,263385
14084,0.000409,74.125.24.0-255,5738,49108,13,263385
14085,0.000411,172.31.36.0-255,66,49174,13,263385
14086,0.000455,172.31.36.0-255,66,49240,13,263385
14087,0.000465,74.125.24.0-255,10692,59932,13,263385
14088,0.000468,172.31.36.0-255,66,59998,13,263385
14089,0.000471,74.125.24.0-255,352,60350,13,263385
14090,0.000634,74.125.24.0-255,1484,61834,13,263385
14091,0.000639,172.31.36.0-255,66,61900,13,263385
14092,0.000646,74.125.24.0-255,2902,64802,13,263385
14093,0.000648,172.31.36.0-255,66,64868,13,263385
14094,0.000678,74.125.24.0-255,5738,70606,13,263385
14095,0.000687,172.31.36.0-255,66,70672,13,263385
14096,0.000697,74.125.24.0-255,8574,79246,13,263385
14097,0.0007,172.31.36.0-255,66,79312,13,263385
14098,0.000726,74.125.24.0-255,2902,82214,13,263385
14099,0.000729,172.31.36.0-255,66,82280,13,263385
14100,0.000743,172.31.36.0-255,66,82346,13,263385
14101,0.000802,74.125.24.0-255,1484,83830,13,263385
14102,0.000806,74.125.24.0-255,1484,85314,13,263385
14103,0.000809,172.31.36.0-255,66,85380,13,263385
14104,0.000822,74.125.24.0-255,1484,86864,13,263385
14105,0.000828,74.125.24.0-255,5738,92602,13,263385
14106,0.000832,172.31.36.0-255,66,92668,13,263385
14107,0.000858,74.125.24.0-255,8574,101242,13,263385
14108,0.000868,172.31.36.0-255,66,101308,13,263385
14109,0.000911,172.31.36.0-255,66,101374,13,263385
14110,0.000931,74.125.24.0-255,3602,104976,13,263385
14111,0.000933,172.31.36.0-255,66,105042,13,263385
14112,0.000976,172.31.36.0-255,66,105108,13,263385
14113,0.000991,172.31.36.0-255,66,105174,13,263385
14114,0.001012,74.125.24.0-255,2902,108076,13,263385
14115,0.001015,172.31.36.0-255,66,108142,13,263385
14116,0.001018,74.125.24.0-255,766,108908,13,263385
14117,0.001022,74.125.24.0-255,1484,110392,13,263385
14118,0.001024,172.31.36.0-255,66,110458,13,263385
14119,0.00103,74.125.24.0-255,4320,114778,13,263385
14120,0.001032,172.31.36.0-255,66,114844,13,263385
14121,0.001037,74.125.24.0-255,2902,117746,13,263385
14122,0.001039,172.31.36.0-255,66,117812,13,263385
14123,0.001056,74.125.24.0-255,1484,119296,13,263385
14124,0.001062,74.125.24.0-255,5738,125034,13,263385
14125,0.001065,172.31.36.0-255,66,125100,13,263385
14126,0.001078,74.125.24.0-255,4320,129420,13,263385
14127,0.001081,172.31.36.0-255,66,129486,13,263385
14128,0.001102,74.125.24.0-255,4320,133806,13,263385
14129,0.001105,172.31.36.0-255,66,133872,13,263385
14130,0.001127,74.125.24.0-255,9274,143146,13,263385
14131,0.00113,172.31.36.0-255,66,143212,13,263385
14132,0.00118,74.125.24.0-255,1484,144696,13,263385
14133,0.001194,74.125.24.0-255,2902,147598,13,263385
14134,0.001197,172.31.36.0-255,66,147664,13,263385
14135,0.001204,74.125.24.0-255,5738,153402,13,263385
14136,0.001206,172.31.36.0-255,66,153468,13,263385
14137,0.001229,74.125.24.0-255,4320,157788,13,263385
14138,0.001232,172.31.36.0-255,66,157854,13,263385
14139,0.001269,74.125.24.0-255,8574,166428,13,263385
14140,0.001272,172.31.36.0-255,66,166494,13,263385
14141,0.001283,74.125.24.0-255,10692,177186,13,263385
14142,0.001285,172.31.36.0-255,66,177252,13,263385
14143,0.001363,74.125.24.0-255,1484,178736,13,263385
14144,0.001369,74.125.24.0-255,2902,181638,13,263385
14145,0.001371,172.31.36.0-255,66,181704,13,263385
14146,0.001376,74.125.24.0-255,2902,184606,13,263385
14147,0.001379,172.31.36.0-255,66,184672,13,263385
14148,0.001393,74.125.24.0-255,2902,187574,13,263385
14149,0.001395,172.31.36.0-255,66,187640,13,263385
14150,0.001431,74.125.24.0-255,2902,190542,13,263385
14151,0.001434,172.31.36.0-255,66,190608,13,263385
14152,0.001455,74.125.24.0-255,9992,200600,13,263385
14153,0.001457,172.31.36.0-255,66,200666,13,263385
14154,0.001467,74.125.24.0-255,9992,210658,13,263385
14155,0.001469,172.31.36.0-255,66,210724,13,263385
14156,0.001488,74.125.24.0-255,766,211490,13,263385
14157,0.001504,74.125.24.0-255,5738,217228,13,263385
14158,0.001507,172.31.36.0-255,66,217294,13,263385
14159,0.001524,74.125.24.0-255,2902,220196,13,263385
14160,0.001526,172.31.36.0-255,66,220262,13,263385
14161,0.001536,74.125.24.0-255,9992,230254,13,263385
14162,0.001538,172.31.36.0-255,66,230320,13,263385
14163,0.001563,74.125.24.0-255,7156,237476,13,263385
14164,0.001566,172.31.36.0-255,66,237542,13,263385
14165,0.001597,74.125.24.0-255,7856,245398,13,263385
14166,0.0016,172.31.36.0-255,66,245464,13,263385
14167,0.001615,172.31.36.0-255,66,245530,13,263385
14168,0.001632,172.31.36.0-255,66,245596,13,263385
14169,0.001635,74.125.24.0-255,766,246362,13,263385
14170,0.002125,74.125.24.0-255,1484,247846,13,263385
14171,0.002131,172.31.36.0-255,66,247912,13,263385
14172,0.002137,74.125.24.0-255,2902,250814,13,263385
14173,0.00214,172.31.36.0-255,66,250880,13,263385
14174,0.00216,74.125.24.0-255,5116,255996,13,263385
14175,0.002163,172.31.36.0-255,66,256062,13,263385
14176,0.002207,74.125.24.0-255,105,256167,13,263385
14177,0.0079,172.31.36.0-255,105,256272,13,263385
14178,0.010424,74.125.24.0-255,66,256338,13,263385
14179,0.028089,172.31.36.0-255,172,256510,13,263385
14180,0.028126,172.31.36.0-255,1109,257619,13,263385
14181,0.028186,172.31.36.0-255,1514,259133,13,263385
14182,0.028188,172.31.36.0-255,1514,260647,13,263385
14183,0.028189,172.31.36.0-255,1514,262161,13,263385
14184,0.02819,172.31.36.0-255,960,263121,13,263385
14185,0.02965,104.244.42.0-255,66,263187,13,263385
14186,0.029662,104.244.42.0-255,66,263253,13,263385
14187,0.029761,104.244.42.0-255,66,263319,13,263385
14188,0.029765,104.244.42.0-255,66,263385,13,263385
14189,0.0,74.125.200.0-255,152,152,13,289285
14190,1.5e-05,172.31.36.0-255,66,218,13,289285
14191,2.2e-05,74.125.200.0-255,1484,1702,13,289285
14192,2.7e-05,172.31.36.0-255,66,1768,13,289285
14193,3.2e-05,74.125.200.0-255,2902,4670,13,289285
14194,4.4e-05,172.31.36.0-255,66,4736,13,289285
14195,8.5e-05,74.125.200.0-255,5738,10474,13,289285
14196,8.8e-05,172.31.36.0-255,66,10540,13,289285
14197,0.000116,74.125.200.0-255,1484,12024,13,289285
14198,0.000118,172.31.36.0-255,66,12090,13,289285
14199,0.000243,74.125.200.0-255,2056,14146,13,289285
14200,0.000247,172.31.36.0-255,66,14212,13,289285
14201,0.000287,74.125.200.0-255,2902,17114,13,289285
14202,0.00029,172.31.36.0-255,66,17180,13,289285
14203,0.000341,74.125.200.0-255,2902,20082,13,289285
14204,0.000344,172.31.36.0-255,66,20148,13,289285
14205,0.000371,74.125.200.0-255,4320,24468,13,289285
14206,0.000374,172.31.36.0-255,66,24534,13,289285
14207,0.00051,74.125.200.0-255,9992,34526,13,289285
14208,0.000515,172.31.36.0-255,66,34592,13,289285
14209,0.000558,74.125.200.0-255,5379,39971,13,289285
14210,0.000564,172.31.36.0-255,66,40037,13,289285
14211,0.000823,74.125.200.0-255,8215,48252,13,289285
14212,0.000831,172.31.36.0-255,66,48318,13,289285
14213,0.000993,74.125.200.0-255,5738,54056,13,289285
14214,0.000998,172.31.36.0-255,66,54122,13,289285
14215,0.001039,172.31.36.0-255,66,54188,13,289285
14216,0.001346,74.125.200.0-255,5738,59926,13,289285
14217,0.00135,172.31.36.0-255,66,59992,13,289285
14218,0.001387,172.31.36.0-255,66,60058,13,289285
14219,0.001697,74.125.200.0-255,4320,64378,13,289285
14220,0.001703,172.31.36.0-255,66,64444,13,289285
14221,0.001789,74.125.200.0-255,5738,70182,13,289285
14222,0.004587,172.31.36.0-255,66,70248,13,289285
14223,0.006845,74.125.200.0-255,5738,75986,13,289285
14224,0.00685,172.31.36.0-255,66,76052,13,289285
14225,0.009113,74.125.200.0-255,5738,81790,13,289285
14226,0.009121,172.31.36.0-255,66,81856,13,289285
14227,0.011391,74.125.200.0-255,5738,87594,13,289285
14228,0.011399,172.31.36.0-255,66,87660,13,289285
14229,0.013662,74.125.200.0-255,5738,93398,13,289285
14230,0.013668,172.31.36.0-255,66,93464,13,289285
14231,0.015955,74.125.200.0-255,5738,99202,13,289285
14232,0.015962,172.31.36.0-255,66,99268,13,289285
14233,0.018237,74.125.200.0-255,5738,105006,13,289285
14234,0.018248,172.31.36.0-255,66,105072,13,289285
14235,0.020513,74.125.200.0-255,5738,110810,13,289285
14236,0.020521,172.31.36.0-255,66,110876,13,289285
14237,0.022785,74.125.200.0-255,5738,116614,13,289285
14238,0.022792,172.31.36.0-255,66,116680,13,289285
14239,0.025056,74.125.200.0-255,5738,122418,13,289285
14240,0.025064,172.31.36.0-255,66,122484,13,289285
14241,0.027335,74.125.200.0-255,5738,128222,13,289285
14242,0.027342,172.31.36.0-255,66,128288,13,289285
14243,0.027488,172.31.36.0-255,172,128460,13,289285
14244,0.027535,172.31.36.0-255,1106,129566,13,289285
14245,0.027671,172.31.36.0-255,1514,131080,13,289285
14246,0.027673,172.31.36.0-255,1299,132379,13,289285
14247,0.029052,104.244.42.0-255,66,132445,13,289285
14248,0.029088,104.244.42.0-255,66,132511,13,289285
14249,0.029244,104.244.42.0-255,66,132577,13,289285
14250,0.029616,74.125.200.0-255,5738,138315,13,289285
14251,0.029623,172.31.36.0-255,66,138381,13,289285
14252,0.0319,74.125.200.0-255,5738,144119,13,289285
14253,0.031907,172.31.36.0-255,66,144185,13,289285
14254,0.034193,74.125.200.0-255,5738,149923,13,289285
14255,0.0342,172.31.36.0-255,66,149989,13,289285
14256,0.036496,74.125.200.0-255,5738,155727,13,289285
14257,0.036502,172.31.36.0-255,66,155793,13,289285
14258,0.038773,74.125.200.0-255,5738,161531,13,289285
14259,0.038781,172.31.36.0-255,66,161597,13,289285
14260,0.041041,74.125.200.0-255,5738,167335,13,289285
14261,0.04105,172.31.36.0-255,66,167401,13,289285
14262,0.043367,74.125.200.0-255,5738,173139,13,289285
14263,0.043373,172.31.36.0-255,66,173205,13,289285
14264,0.045646,74.125.200.0-255,5738,178943,13,289285
14265,0.045652,172.31.36.0-255,66,179009,13,289285
14266,0.047932,74.125.200.0-255,5738,184747,13,289285
14267,0.047938,172.31.36.0-255,66,184813,13,289285
14268,0.050205,74.125.200.0-255,5738,190551,13,289285
14269,0.050212,172.31.36.0-255,66,190617,13,289285
14270,0.052486,74.125.200.0-255,5738,196355,13,289285
14271,0.052492,172.31.36.0-255,66,196421,13,289285
14272,0.054769,74.125.200.0-255,5738,202159,13,289285
14273,0.054775,172.31.36.0-255,66,202225,13,289285
14274,0.057059,74.125.200.0-255,5738,207963,13,289285
14275,0.057066,172.31.36.0-255,66,208029,13,289285
14276,0.059334,74.125.200.0-255,5738,213767,13,289285
14277,0.05934,172.31.36.0-255,66,213833,13,289285
14278,0.06161,74.125.200.0-255,5738,219571,13,289285
14279,0.061617,172.31.36.0-255,66,219637,13,289285
14280,0.063887,74.125.200.0-255,5738,225375,13,289285
14281,0.063893,172.31.36.0-255,66,225441,13,289285
14282,0.066153,74.125.200.0-255,5738,231179,13,289285
14283,0.06616,172.31.36.0-255,66,231245,13,289285
14284,0.068435,74.125.200.0-255,5738,236983,13,289285
14285,0.068442,172.31.36.0-255,66,237049,13,289285
14286,0.070714,74.125.200.0-255,5738,242787,13,289285
14287,0.07072,172.31.36.0-255,66,242853,13,289285
14288,0.072992,74.125.200.0-255,5738,248591,13,289285
14289,0.072998,172.31.36.0-255,66,248657,13,289285
14290,0.075263,74.125.200.0-255,5738,254395,13,289285
14291,0.075269,172.31.36.0-255,66,254461,13,289285
14292,0.077538,74.125.200.0-255,5738,260199,13,289285
14293,0.077544,172.31.36.0-255,66,260265,13,289285
14294,0.079823,74.125.200.0-255,5738,266003,13,289285
14295,0.07983,172.31.36.0-255,66,266069,13,289285
14296,0.082097,74.125.200.0-255,5738,271807,13,289285
14297,0.082103,172.31.36.0-255,66,271873,13,289285
14298,0.084371,74.125.200.0-255,5738,277611,13,289285
14299,0.084379,172.31.36.0-255,66,277677,13,289285
14300,0.086649,74.125.200.0-255,5738,283415,13,289285
14301,0.086656,172.31.36.0-255,66,283481,13,289285
14302,0.088928,74.125.200.0-255,5738,289219,13,289285
14303,0.088935,172.31.36.0-255,66,289285,13,289285
14304,0.0,74.125.24.0-255,296,296,13,325830
14305,2.5e-05,172.31.36.0-255,66,362,13,325830
14306,3.2e-05,74.125.24.0-255,1484,1846,13,325830
14307,3.6e-05,172.31.36.0-255,66,1912,13,325830
14308,4.4e-05,74.125.24.0-255,4320,6232,13,325830
14309,4.7e-05,172.31.36.0-255,66,6298,13,325830
14310,8.1e-05,74.125.24.0-255,7156,13454,13,325830
14311,8.4e-05,172.31.36.0-255,66,13520,13,325830
14312,0.000104,74.125.24.0-255,1849,15369,13,325830
14313,0.000106,172.31.36.0-255,66,15435,13,325830
14314,0.000117,74.125.24.0-255,9992,25427,13,325830
14315,0.000119,172.31.36.0-255,66,25493,13,325830
14316,0.000125,74.125.24.0-255,4320,29813,13,325830
14317,0.000128,172.31.36.0-255,66,29879,13,325830
14318,0.00015,74.125.24.0-255,1125,31004,13,325830
14319,0.000153,172.31.36.0-255,66,31070,13,325830
14320,0.000634,74.125.24.0-255,1484,32554,13,325830
14321,0.000641,172.31.36.0-255,66,32620,13,325830
14322,0.000648,74.125.24.0-255,2902,35522,13,325830
14323,0.00065,172.31.36.0-255,66,35588,13,325830
14324,0.000657,74.125.24.0-255,5738,41326,13,325830
14325,0.00066,172.31.36.0-255,66,41392,13,325830
14326,0.000682,74.125.24.0-255,6797,48189,13,325830
14327,0.000684,172.31.36.0-255,66,48255,13,325830
14328,0.000704,74.125.24.0-255,7156,55411,13,325830
14329,0.000707,172.31.36.0-255,66,55477,13,325830
14330,0.000737,74.125.24.0-255,7156,62633,13,325830
14331,0.00074,172.31.36.0-255,66,62699,13,325830
14332,0.000745,74.125.24.0-255,2853,65552,13,325830
14333,0.000748,172.31.36.0-255,66,65618,13,325830
14334,0.000835,74.125.24.0-255,111,65729,13,325830
14335,0.00084,172.31.36.0-255,66,65795,13,325830
14336,0.000962,74.125.24.0-255,1484,67279,13,325830
14337,0.000969,74.125.24.0-255,2902,70181,13,325830
14338,0.000973,172.31.36.0-255,66,70247,13,325830
14339,0.000978,74.125.24.0-255,2902,73149,13,325830
14340,0.000981,74.125.24.0-255,1484,74633,13,325830
14341,0.000986,172.31.36.0-255,66,74699,13,325830
14342,0.000996,74.125.24.0-255,2902,77601,13,325830
14343,0.001001,172.31.36.0-255,66,77667,13,325830
14344,0.001038,74.125.24.0-255,5379,83046,13,325830
14345,0.001043,172.31.36.0-255,66,83112,13,325830
14346,0.001322,74.125.24.0-255,1484,84596,13,325830
14347,0.001329,74.125.24.0-255,2902,87498,13,325830
14348,0.001332,172.31.36.0-255,66,87564,13,325830
14349,0.001338,74.125.24.0-255,5738,93302,13,325830
14350,0.00134,172.31.36.0-255,66,93368,13,325830
14351,0.001346,74.125.24.0-255,5738,99106,13,325830
14352,0.001357,172.31.36.0-255,66,99172,13,325830
14353,0.00136,74.125.24.0-255,1125,100297,13,325830
14354,0.001416,74.125.24.0-255,1484,101781,13,325830
14355,0.001433,74.125.24.0-255,2902,104683,13,325830
14356,0.001439,74.125.24.0-255,5738,110421,13,325830
14357,0.001462,74.125.24.0-255,1484,111905,13,325830
14358,0.001505,74.125.24.0-255,1484,113389,13,325830
14359,0.001522,74.125.24.0-255,5738,119127,13,325830
14360,0.001542,74.125.24.0-255,3602,122729,13,325830
14361,0.001573,74.125.24.0-255,7156,129885,13,325830
14362,0.001581,74.125.24.0-255,8574,138459,13,325830
14363,0.001591,74.125.24.0-255,1484,139943,13,325830
14364,0.001625,74.125.24.0-255,766,140709,13,325830
14365,0.001708,74.125.24.0-255,3602,144311,13,325830
14366,0.001732,74.125.24.0-255,1484,145795,13,325830
14367,0.001745,74.125.24.0-255,1484,147279,13,325830
14368,0.001757,74.125.24.0-255,1484,148763,13,325830
14369,0.00176,74.125.24.0-255,1484,150247,13,325830
14370,0.00178,74.125.24.0-255,4320,154567,13,325830
14371,0.00179,74.125.24.0-255,8574,163141,13,325830
14372,0.001804,74.125.24.0-255,4320,167461,13,325830
14373,0.001811,74.125.24.0-255,5738,173199,13,325830
14374,0.001831,74.125.24.0-255,5020,178219,13,325830
14375,0.001962,74.125.24.0-255,1484,179703,13,325830
14376,0.001967,74.125.24.0-255,1484,181187,13,325830
14377,0.001981,74.125.24.0-255,1484,182671,13,325830
14378,0.001987,74.125.24.0-255,4320,186991,13,325830
14379,0.002,74.125.24.0-255,1484,188475,13,325830
14380,0.002019,74.125.24.0-255,2902,191377,13,325830
14381,0.002044,74.125.24.0-255,7156,198533,13,325830
14382,0.002055,74.125.24.0-255,1484,200017,13,325830
14383,0.002058,74.125.24.0-255,1484,201501,13,325830
14384,0.002089,74.125.24.0-255,10692,212193,13,325830
14385,0.008502,172.31.36.0-255,66,212259,13,325830
14386,0.010428,74.125.24.0-255,1484,213743,13,325830
14387,0.010836,74.125.24.0-255,2902,216645,13,325830
14388,0.010843,172.31.36.0-255,66,216711,13,325830
14389,0.010859,74.125.24.0-255,1484,218195,13,325830
14390,0.01308,74.125.24.0-255,4320,222515,13,325830
14391,0.013088,172.31.36.0-255,66,222581,13,325830
14392,0.015355,74.125.24.0-255,5738,228319,13,325830
14393,0.015364,172.31.36.0-255,66,228385,13,325830
14394,0.017611,74.125.24.0-255,5738,234123,13,325830
14395,0.01762,172.31.36.0-255,66,234189,13,325830
14396,0.019881,74.125.24.0-255,5738,239927,13,325830
14397,0.019889,172.31.36.0-255,66,239993,13,325830
14398,0.02215,74.125.24.0-255,4320,244313,13,325830
14399,0.022159,172.31.36.0-255,66,244379,13,325830
14400,0.02218,74.125.24.0-255,1484,245863,13,325830
14401,0.024411,74.125.24.0-255,4320,250183,13,325830
14402,0.024419,172.31.36.0-255,66,250249,13,325830
14403,0.026684,74.125.24.0-255,5738,255987,13,325830
14404,0.026692,172.31.36.0-255,66,256053,13,325830
14405,0.028925,74.125.24.0-255,4320,260373,13,325830
14406,0.028932,172.31.36.0-255,66,260439,13,325830
14407,0.028952,74.125.24.0-255,1484,261923,13,325830
14408,0.031195,74.125.24.0-255,4320,266243,13,325830
14409,0.031207,172.31.36.0-255,66,266309,13,325830
14410,0.03324,172.31.36.0-255,167,266476,13,325830
14411,0.033272,172.31.36.0-255,1108,267584,13,325830
14412,0.033332,172.31.36.0-255,1514,269098,13,325830
14413,0.033334,172.31.36.0-255,333,269431,13,325830
14414,0.033517,74.125.24.0-255,5738,275169,13,325830
14415,0.033524,172.31.36.0-255,66,275235,13,325830
14416,0.034822,104.244.42.0-255,66,275301,13,325830
14417,0.034857,104.244.42.0-255,66,275367,13,325830
14418,0.034922,104.244.42.0-255,66,275433,13,325830
14419,0.035777,74.125.24.0-255,5738,281171,13,325830
14420,0.035782,172.31.36.0-255,66,281237,13,325830
14421,0.038045,74.125.24.0-255,5738,286975,13,325830
14422,0.038052,172.31.36.0-255,66,287041,13,325830
14423,0.040316,74.125.24.0-255,5738,292779,13,325830
14424,0.040323,172.31.36.0-255,66,292845,13,325830
14425,0.042628,74.125.24.0-255,5738,298583,13,325830
14426,0.042636,172.31.36.0-255,66,298649,13,325830
14427,0.044893,74.125.24.0-255,5738,304387,13,325830
14428,0.044899,172.31.36.0-255,66,304453,13,325830
14429,0.047162,74.125.24.0-255,5738,310191,13,325830
14430,0.047171,172.31.36.0-255,66,310257,13,325830
14431,0.049407,74.125.24.0-255,5738,315995,13,325830
14432,0.049414,172.31.36.0-255,66,316061,13,325830
14433,0.051702,74.125.24.0-255,5738,321799,13,325830
14434,0.051709,172.31.36.0-255,66,321865,13,325830
14435,0.053952,74.125.24.0-255,3728,325593,13,325830
14436,0.053959,172.31.36.0-255,66,325659,13,325830
14437,0.05414,172.31.36.0-255,105,325764,13,325830
14438,0.056337,74.125.24.0-255,66,325830,13,325830
14439,0.0,172.217.194.0-255,143,143,13,357248
14440,1.9e-05,172.31.36.0-255,66,209,13,357248
14441,2.5e-05,172.217.194.0-255,1484,1693,13,357248
14442,3e-05,172.31.36.0-255,66,1759,13,357248
14443,4.4e-05,172.217.194.0-255,2902,4661,13,357248
14444,4.7e-05,172.31.36.0-255,66,4727,13,357248
14445,5.5e-05,172.217.194.0-255,5738,10465,13,357248
14446,5.8e-05,172.31.36.0-255,66,10531,13,357248
14447,8.4e-05,172.217.194.0-255,1484,12015,13,357248
14448,8.7e-05,172.31.36.0-255,66,12081,13,357248
14449,0.000121,172.217.194.0-255,2070,14151,13,357248
14450,0.000124,172.31.36.0-255,66,14217,13,357248
14451,0.000902,172.217.194.0-255,1484,15701,13,357248
14452,0.000909,172.31.36.0-255,66,15767,13,357248
14453,0.00092,172.217.194.0-255,2902,18669,13,357248
14454,0.000922,172.31.36.0-255,66,18735,13,357248
14455,0.000963,172.217.194.0-255,5738,24473,13,357248
14456,0.000966,172.31.36.0-255,66,24539,13,357248
14457,0.001001,172.217.194.0-255,6797,31336,13,357248
14458,0.001005,172.31.36.0-255,66,31402,13,357248
14459,0.001071,172.217.194.0-255,1484,32886,13,357248
14460,0.001074,172.31.36.0-255,66,32952,13,357248
14461,0.001079,172.217.194.0-255,2902,35854,13,357248
14462,0.001081,172.31.36.0-255,66,35920,13,357248
14463,0.001086,172.217.194.0-255,2902,38822,13,357248
14464,0.001089,172.31.36.0-255,66,38888,13,357248
14465,0.001116,172.217.194.0-255,2902,41790,13,357248
14466,0.001122,172.31.36.0-255,66,41856,13,357248
14467,0.001143,172.217.194.0-255,6797,48653,13,357248
14468,0.001146,172.31.36.0-255,66,48719,13,357248
14469,0.001216,172.217.194.0-255,1484,50203,13,357248
14470,0.00122,172.31.36.0-255,66,50269,13,357248
14471,0.001224,172.217.194.0-255,1484,51753,13,357248
14472,0.001247,172.217.194.0-255,1484,53237,13,357248
14473,0.001249,172.31.36.0-255,66,53303,13,357248
14474,0.001256,172.217.194.0-255,5738,59041,13,357248
14475,0.001258,172.31.36.0-255,66,59107,13,357248
14476,0.001287,172.217.194.0-255,4320,63427,13,357248
14477,0.001291,172.31.36.0-255,66,63493,13,357248
14478,0.001318,172.217.194.0-255,2821,66314,13,357248
14479,0.001321,172.31.36.0-255,66,66380,13,357248
14480,0.001491,172.217.194.0-255,118,66498,13,357248
14481,0.001495,172.217.194.0-255,377,66875,13,357248
14482,0.001684,172.217.194.0-255,1484,68359,13,357248
14483,0.001688,172.31.36.0-255,66,68425,13,357248
14484,0.001692,172.217.194.0-255,1484,69909,13,357248
14485,0.001712,172.217.194.0-255,1484,71393,13,357248
14486,0.001715,172.31.36.0-255,66,71459,13,357248
14487,0.00172,172.217.194.0-255,2902,74361,13,357248
14488,0.001722,172.31.36.0-255,66,74427,13,357248
14489,0.00174,172.217.194.0-255,2902,77329,13,357248
14490,0.001742,172.31.36.0-255,66,77395,13,357248
14491,0.001752,172.217.194.0-255,4320,81715,13,357248
14492,0.001754,172.31.36.0-255,66,81781,13,357248
14493,0.001779,172.217.194.0-255,2543,84324,13,357248
14494,0.001781,172.31.36.0-255,66,84390,13,357248
14495,0.001793,172.217.194.0-255,7156,91546,13,357248
14496,0.001795,172.31.36.0-255,66,91612,13,357248
14497,0.001829,172.217.194.0-255,5738,97350,13,357248
14498,0.001832,172.31.36.0-255,66,97416,13,357248
14499,0.001864,172.217.194.0-255,3961,101377,13,357248
14500,0.001866,172.31.36.0-255,66,101443,13,357248
14501,0.002074,172.217.194.0-255,1484,102927,13,357248
14502,0.002079,172.217.194.0-255,1484,104411,13,357248
14503,0.002091,172.31.36.0-255,66,104477,13,357248
14504,0.002095,172.217.194.0-255,1484,105961,13,357248
14505,0.002102,172.217.194.0-255,5738,111699,13,357248
14506,0.002109,172.31.36.0-255,66,111765,13,357248
14507,0.002112,172.217.194.0-255,1484,113249,13,357248
14508,0.002145,172.217.194.0-255,8574,121823,13,357248
14509,0.002148,172.31.36.0-255,66,121889,13,357248
14510,0.002166,172.217.194.0-255,1484,123373,13,357248
14511,0.002204,172.31.36.0-255,66,123439,13,357248
14512,0.002266,172.217.194.0-255,1484,124923,13,357248
14513,0.00227,172.217.194.0-255,1484,126407,13,357248
14514,0.002273,172.31.36.0-255,66,126473,13,357248
14515,0.002291,172.217.194.0-255,1484,127957,13,357248
14516,0.002298,172.217.194.0-255,5738,133695,13,357248
14517,0.0023,172.31.36.0-255,66,133761,13,357248
14518,0.002304,172.217.194.0-255,1484,135245,13,357248
14519,0.002342,172.31.36.0-255,66,135311,13,357248
14520,0.002368,172.217.194.0-255,4320,139631,13,357248
14521,0.002371,172.31.36.0-255,66,139697,13,357248
14522,0.002406,172.217.194.0-255,5020,144717,13,357248
14523,0.002409,172.31.36.0-255,66,144783,13,357248
14524,0.004839,172.217.194.0-255,5738,150521,13,357248
14525,0.004846,172.31.36.0-255,66,150587,13,357248
14526,0.007281,172.217.194.0-255,5738,156325,13,357248
14527,0.007288,172.31.36.0-255,66,156391,13,357248
14528,0.009723,172.217.194.0-255,5738,162129,13,357248
14529,0.009731,172.31.36.0-255,66,162195,13,357248
14530,0.012194,172.217.194.0-255,5738,167933,13,357248
14531,0.012201,172.31.36.0-255,66,167999,13,357248
14532,0.014663,172.217.194.0-255,5738,173737,13,357248
14533,0.014671,172.31.36.0-255,66,173803,13,357248
14534,0.017129,172.217.194.0-255,5738,179541,13,357248
14535,0.017141,172.31.36.0-255,66,179607,13,357248
14536,0.019552,172.217.194.0-255,5738,185345,13,357248
14537,0.01956,172.31.36.0-255,66,185411,13,357248
14538,0.021984,172.217.194.0-255,5738,191149,13,357248
14539,0.021991,172.31.36.0-255,66,191215,13,357248
14540,0.024412,172.217.194.0-255,5738,196953,13,357248
14541,0.02442,172.31.36.0-255,66,197019,13,357248
14542,0.0269,172.217.194.0-255,5738,202757,13,357248
14543,0.026909,172.31.36.0-255,66,202823,13,357248
14544,0.029345,172.217.194.0-255,5738,208561,13,357248
14545,0.029352,172.31.36.0-255,66,208627,13,357248
14546,0.031779,172.217.194.0-255,5738,214365,13,357248
14547,0.031787,172.31.36.0-255,66,214431,13,357248
14548,0.034216,172.217.194.0-255,5738,220169,13,357248
14549,0.034226,172.31.36.0-255,66,220235,13,357248
14550,0.036133,172.31.36.0-255,172,220407,13,357248
14551,0.036164,172.31.36.0-255,1110,221517,13,357248
14552,0.036228,172.31.36.0-255,1514,223031,13,357248
14553,0.03623,172.31.36.0-255,1514,224545,13,357248
14554,0.036231,172.31.36.0-255,1514,226059,13,357248
14555,0.036241,172.31.36.0-255,1514,227573,13,357248
14556,0.036243,172.31.36.0-255,1514,229087,13,357248
14557,0.036244,172.31.36.0-255,143,229230,13,357248
14558,0.03673,172.217.194.0-255,1484,230714,13,357248
14559,0.036756,172.217.194.0-255,4320,235034,13,357248
14560,0.036761,172.31.36.0-255,66,235100,13,357248
14561,0.037798,104.244.42.0-255,66,235166,13,357248
14562,0.037835,104.244.42.0-255,66,235232,13,357248
14563,0.03794,104.244.42.0-255,66,235298,13,357248
14564,0.037947,104.244.42.0-255,66,235364,13,357248
14565,0.039221,172.217.194.0-255,5738,241102,13,357248
14566,0.039228,172.31.36.0-255,66,241168,13,357248
14567,0.041676,172.217.194.0-255,5738,246906,13,357248
14568,0.041683,172.31.36.0-255,66,246972,13,357248
14569,0.04417,172.217.194.0-255,5738,252710,13,357248
14570,0.044177,172.31.36.0-255,66,252776,13,357248
14571,0.046629,172.217.194.0-255,5738,258514,13,357248
14572,0.046635,172.31.36.0-255,66,258580,13,357248
14573,0.049112,172.217.194.0-255,5738,264318,13,357248
14574,0.049119,172.31.36.0-255,66,264384,13,357248
14575,0.05159,172.217.194.0-255,5738,270122,13,357248
14576,0.051597,172.31.36.0-255,66,270188,13,357248
14577,0.054067,172.217.194.0-255,5738,275926,13,357248
14578,0.054074,172.31.36.0-255,66,275992,13,357248
14579,0.056511,172.217.194.0-255,5738,281730,13,357248
14580,0.056518,172.31.36.0-255,66,281796,13,357248
14581,0.059008,172.217.194.0-255,5738,287534,13,357248
14582,0.059015,172.31.36.0-255,66,287600,13,357248
14583,0.061451,172.217.194.0-255,5738,293338,13,357248
14584,0.061456,172.31.36.0-255,66,293404,13,357248
14585,0.063949,172.217.194.0-255,5738,299142,13,357248
14586,0.063955,172.31.36.0-255,66,299208,13,357248
14587,0.066392,172.217.194.0-255,5738,304946,13,357248
14588,0.066399,172.31.36.0-255,66,305012,13,357248
14589,0.068853,172.217.194.0-255,5738,310750,13,357248
14590,0.06886,172.31.36.0-255,66,310816,13,357248
14591,0.071325,172.217.194.0-255,5738,316554,13,357248
14592,0.071332,172.31.36.0-255,66,316620,13,357248
14593,0.073786,172.217.194.0-255,5738,322358,13,357248
14594,0.073795,172.31.36.0-255,66,322424,13,357248
14595,0.076262,172.217.194.0-255,5738,328162,13,357248
14596,0.076276,172.31.36.0-255,66,328228,13,357248
14597,0.078724,172.217.194.0-255,5738,333966,13,357248
14598,0.078738,172.31.36.0-255,66,334032,13,357248
14599,0.081182,172.217.194.0-255,5738,339770,13,357248
14600,0.081194,172.31.36.0-255,66,339836,13,357248
14601,0.083675,172.217.194.0-255,5738,345574,13,357248
14602,0.083686,172.31.36.0-255,66,345640,13,357248
14603,0.086112,172.217.194.0-255,5738,351378,13,357248
14604,0.086118,172.31.36.0-255,66,351444,13,357248
14605,0.088552,172.217.194.0-255,5738,357182,13,357248
14606,0.088559,172.31.36.0-255,66,357248,13,357248
14607,0.0,74.125.24.0-255,143,143,13,237984
14608,2.8e-05,172.31.36.0-255,66,209,13,237984
14609,3.4e-05,74.125.24.0-255,1484,1693,13,237984
14610,3.8e-05,172.31.36.0-255,66,1759,13,237984
14611,4.4e-05,74.125.24.0-255,2902,4661,13,237984
14612,5.5e-05,172.31.36.0-255,66,4727,13,237984
14613,6.2e-05,74.125.24.0-255,7156,11883,13,237984
14614,6.5e-05,172.31.36.0-255,66,11949,13,237984
14615,6.9e-05,74.125.24.0-255,2059,14008,13,237984
14616,7.2e-05,172.31.36.0-255,66,14074,13,237984
14617,0.000124,74.125.24.0-255,1484,15558,13,237984
14618,0.000128,172.31.36.0-255,66,15624,13,237984
14619,0.000133,74.125.24.0-255,2902,18526,13,237984
14620,0.000136,172.31.36.0-255,66,18592,13,237984
14621,0.000141,74.125.24.0-255,4320,22912,13,237984
14622,0.000149,172.31.36.0-255,66,22978,13,237984
14623,0.000174,74.125.24.0-255,1484,24462,13,237984
14624,0.000177,172.31.36.0-255,66,24528,13,237984
14625,0.000185,74.125.24.0-255,6797,31325,13,237984
14626,0.000188,172.31.36.0-255,66,31391,13,237984
14627,0.000199,74.125.24.0-255,7156,38547,13,237984
14628,0.000201,172.31.36.0-255,66,38613,13,237984
14629,0.000227,74.125.24.0-255,5738,44351,13,237984
14630,0.00023,172.31.36.0-255,66,44417,13,237984
14631,0.000261,74.125.24.0-255,3961,48378,13,237984
14632,0.000265,172.31.36.0-255,66,48444,13,237984
14633,0.000301,74.125.24.0-255,1484,49928,13,237984
14634,0.000304,172.31.36.0-255,66,49994,13,237984
14635,0.000309,74.125.24.0-255,2902,52896,13,237984
14636,0.000312,172.31.36.0-255,66,52962,13,237984
14637,0.00033,74.125.24.0-255,5738,58700,13,237984
14638,0.000341,172.31.36.0-255,66,58766,13,237984
14639,0.000382,74.125.24.0-255,7408,66174,13,237984
14640,0.000386,172.31.36.0-255,66,66240,13,237984
14641,0.000438,74.125.24.0-255,1484,67724,13,237984
14642,0.000443,74.125.24.0-255,2902,70626,13,237984
14643,0.00045,172.31.36.0-255,66,70692,13,237984
14644,0.000458,74.125.24.0-255,5738,76430,13,237984
14645,0.000461,172.31.36.0-255,66,76496,13,237984
14646,0.000493,74.125.24.0-255,6797,83293,13,237984
14647,0.000496,74.125.24.0-255,1484,84777,13,237984
14648,0.000497,172.31.36.0-255,66,84843,13,237984
14649,0.000547,172.31.36.0-255,66,84909,13,237984
14650,0.000551,74.125.24.0-255,2543,87452,13,237984
14651,0.000555,172.31.36.0-255,66,87518,13,237984
14652,0.000881,74.125.24.0-255,1484,89002,13,237984
14653,0.000888,74.125.24.0-255,2902,91904,13,237984
14654,0.000891,172.31.36.0-255,66,91970,13,237984
14655,0.000896,74.125.24.0-255,2902,94872,13,237984
14656,0.000899,172.31.36.0-255,66,94938,13,237984
14657,0.000917,74.125.24.0-255,2902,97840,13,237984
14658,0.000921,172.31.36.0-255,66,97906,13,237984
14659,0.000926,74.125.24.0-255,9992,107898,13,237984
14660,0.000934,172.31.36.0-255,66,107964,13,237984
14661,0.000961,74.125.24.0-255,2902,110866,13,237984
14662,0.000965,172.31.36.0-255,66,110932,13,237984
14663,0.000974,74.125.24.0-255,9992,120924,13,237984
14664,0.000976,172.31.36.0-255,66,120990,13,237984
14665,0.000979,74.125.24.0-255,766,121756,13,237984
14666,0.001277,172.31.36.0-255,66,121822,13,237984
14667,0.001283,74.125.24.0-255,1484,123306,13,237984
14668,0.001288,74.125.24.0-255,2902,126208,13,237984
14669,0.001292,172.31.36.0-255,66,126274,13,237984
14670,0.001311,74.125.24.0-255,5738,132012,13,237984
14671,0.001319,172.31.36.0-255,66,132078,13,237984
14672,0.001325,74.125.24.0-255,5738,137816,13,237984
14673,0.001328,172.31.36.0-255,66,137882,13,237984
14674,0.001367,74.125.24.0-255,7156,145038,13,237984
14675,0.00137,172.31.36.0-255,66,145104,13,237984
14676,0.00138,74.125.24.0-255,10692,155796,13,237984
14677,0.001389,172.31.36.0-255,66,155862,13,237984
14678,0.001547,74.125.24.0-255,1484,157346,13,237984
14679,0.001562,74.125.24.0-255,1484,158830,13,237984
14680,0.001566,172.31.36.0-255,66,158896,13,237984
14681,0.001604,74.125.24.0-255,1484,160380,13,237984
14682,0.001612,74.125.24.0-255,5738,166118,13,237984
14683,0.001615,172.31.36.0-255,66,166184,13,237984
14684,0.001628,172.31.36.0-255,66,166250,13,237984
14685,0.001648,172.31.36.0-255,66,166316,13,237984
14686,0.001685,74.125.24.0-255,9274,175590,13,237984
14687,0.001688,172.31.36.0-255,66,175656,13,237984
14688,0.001696,74.125.24.0-255,7156,182812,13,237984
14689,0.001699,172.31.36.0-255,66,182878,13,237984
14690,0.001702,74.125.24.0-255,1484,184362,13,237984
14691,0.001753,172.31.36.0-255,66,184428,13,237984
14692,0.001767,172.31.36.0-255,66,184494,13,237984
14693,0.001799,172.31.36.0-255,66,184560,13,237984
14694,0.001831,74.125.24.0-255,7856,192416,13,237984
14695,0.001836,172.31.36.0-255,66,192482,13,237984
14696,0.001844,74.125.24.0-255,8574,201056,13,237984
14697,0.001848,172.31.36.0-255,66,201122,13,237984
14698,0.001862,172.31.36.0-255,66,201188,13,237984
14699,0.001895,74.125.24.0-255,4320,205508,13,237984
14700,0.001899,172.31.36.0-255,66,205574,13,237984
14701,0.001909,74.125.24.0-255,5020,210594,13,237984
14702,0.001911,172.31.36.0-255,66,210660,13,237984
14703,0.001931,172.31.36.0-255,66,210726,13,237984
14704,0.001962,74.125.24.0-255,1484,212210,13,237984
14705,0.00197,74.125.24.0-255,7856,220066,13,237984
14706,0.001974,172.31.36.0-255,66,220132,13,237984
14707,0.001978,74.125.24.0-255,2902,223034,13,237984
14708,0.00198,172.31.36.0-255,66,223100,13,237984
14709,0.002043,172.31.36.0-255,66,223166,13,237984
14710,0.002047,74.125.24.0-255,766,223932,13,237984
14711,0.004002,74.125.24.0-255,4320,228252,13,237984
14712,0.004009,172.31.36.0-255,66,228318,13,237984
14713,0.005965,74.125.24.0-255,5145,233463,13,237984
14714,0.005972,172.31.36.0-255,66,233529,13,237984
14715,0.007924,172.31.36.0-255,105,233634,13,237984
14716,0.009856,74.125.24.0-255,66,233700,13,237984
14717,0.028801,172.31.36.0-255,167,233867,13,237984
14718,0.028832,172.31.36.0-255,1106,234973,13,237984
14719,0.028875,172.31.36.0-255,1514,236487,13,237984
14720,0.028877,172.31.36.0-255,1299,237786,13,237984
14721,0.030369,104.244.42.0-255,66,237852,13,237984
14722,0.030377,104.244.42.0-255,66,237918,13,237984
14723,0.030475,104.244.42.0-255,66,237984,13,237984
14724,0.0,172.217.194.0-255,143,143,13,273380
14725,2.6e-05,172.31.36.0-255,66,209,13,273380
14726,3.2e-05,172.217.194.0-255,1484,1693,13,273380
14727,3.6e-05,172.31.36.0-255,66,1759,13,273380
14728,4.1e-05,172.217.194.0-255,2902,4661,13,273380
14729,4.3e-05,172.31.36.0-255,66,4727,13,273380
14730,5.1e-05,172.217.194.0-255,5738,10465,13,273380
14731,5.3e-05,172.31.36.0-255,66,10531,13,273380
14732,8.1e-05,172.217.194.0-255,3467,13998,13,273380
14733,8.4e-05,172.31.36.0-255,66,14064,13,273380
14734,0.000118,172.217.194.0-255,4320,18384,13,273380
14735,0.000121,172.31.36.0-255,66,18450,13,273380
14736,0.000125,172.217.194.0-255,1484,19934,13,273380
14737,0.000128,172.31.36.0-255,66,20000,13,273380
14738,0.000141,172.217.194.0-255,2902,22902,13,273380
14739,0.000144,172.31.36.0-255,66,22968,13,273380
14740,0.000188,172.217.194.0-255,8574,31542,13,273380
14741,0.000191,172.31.36.0-255,66,31608,13,273380
14742,0.000213,172.217.194.0-255,2543,34151,13,273380
14743,0.000215,172.31.36.0-255,66,34217,13,273380
14744,0.000223,172.217.194.0-255,8574,42791,13,273380
14745,0.000225,172.31.36.0-255,66,42857,13,273380
14746,0.000228,172.217.194.0-255,1484,44341,13,273380
14747,0.00023,172.31.36.0-255,66,44407,13,273380
14748,0.000247,172.217.194.0-255,3961,48368,13,273380
14749,0.000249,172.31.36.0-255,66,48434,13,273380
14750,0.000289,172.217.194.0-255,1484,49918,13,273380
14751,0.000293,172.31.36.0-255,66,49984,13,273380
14752,0.000298,172.217.194.0-255,2902,52886,13,273380
14753,0.0003,172.31.36.0-255,66,52952,13,273380
14754,0.000305,172.217.194.0-255,4320,57272,13,273380
14755,0.000308,172.31.36.0-255,66,57338,13,273380
14756,0.00033,172.217.194.0-255,1484,58822,13,273380
14757,0.000334,172.217.194.0-255,1484,60306,13,273380
14758,0.000337,172.31.36.0-255,66,60372,13,273380
14759,0.000364,172.217.194.0-255,5671,66043,13,273380
14760,0.000367,172.31.36.0-255,66,66109,13,273380
14761,0.000558,172.217.194.0-255,385,66494,13,273380
14762,0.000587,172.217.194.0-255,1484,67978,13,273380
14763,0.000591,172.31.36.0-255,66,68044,13,273380
14764,0.000595,172.217.194.0-255,1484,69528,13,273380
14765,0.000611,172.217.194.0-255,2902,72430,13,273380
14766,0.000614,172.31.36.0-255,66,72496,13,273380
14767,0.000633,172.217.194.0-255,4320,76816,13,273380
14768,0.000636,172.31.36.0-255,66,76882,13,273380
14769,0.000655,172.217.194.0-255,5738,82620,13,273380
14770,0.000658,172.31.36.0-255,66,82686,13,273380
14771,0.000661,172.217.194.0-255,1125,83811,13,273380
14772,0.00069,172.217.194.0-255,2902,86713,13,273380
14773,0.000693,172.31.36.0-255,66,86779,13,273380
14774,0.000696,172.217.194.0-255,1484,88263,13,273380
14775,0.000712,172.217.194.0-255,2902,91165,13,273380
14776,0.000715,172.31.36.0-255,66,91231,13,273380
14777,0.000741,172.217.194.0-255,8574,99805,13,273380
14778,0.000744,172.31.36.0-255,66,99871,13,273380
14779,0.000747,172.217.194.0-255,1125,100996,13,273380
14780,0.001056,172.31.36.0-255,66,101062,13,273380
14781,0.001486,172.217.194.0-255,1484,102546,13,273380
14782,0.001496,172.217.194.0-255,2902,105448,13,273380
14783,0.0015,172.31.36.0-255,66,105514,13,273380
14784,0.001509,172.217.194.0-255,5738,111252,13,273380
14785,0.001511,172.31.36.0-255,66,111318,13,273380
14786,0.001514,172.217.194.0-255,1484,112802,13,273380
14787,0.001531,172.217.194.0-255,4320,117122,13,273380
14788,0.001534,172.31.36.0-255,66,117188,13,273380
14789,0.001542,172.217.194.0-255,7156,124344,13,273380
14790,0.001544,172.31.36.0-255,66,124410,13,273380
14791,0.001568,172.217.194.0-255,5738,130148,13,273380
14792,0.001571,172.31.36.0-255,66,130214,13,273380
14793,0.001578,172.217.194.0-255,5020,135234,13,273380
14794,0.00158,172.31.36.0-255,66,135300,13,273380
14795,0.001637,172.217.194.0-255,1484,136784,13,273380
14796,0.001654,172.217.194.0-255,2902,139686,13,273380
14797,0.001659,172.31.36.0-255,66,139752,13,273380
14798,0.001664,172.217.194.0-255,1484,141236,13,273380
14799,0.001682,172.217.194.0-255,4320,145556,13,273380
14800,0.001684,172.31.36.0-255,66,145622,13,273380
14801,0.00169,172.217.194.0-255,2902,148524,13,273380
14802,0.001691,172.31.36.0-255,66,148590,13,273380
14803,0.001717,172.217.194.0-255,9992,158582,13,273380
14804,0.00172,172.31.36.0-255,66,158648,13,273380
14805,0.001727,172.217.194.0-255,7156,165804,13,273380
14806,0.00173,172.31.36.0-255,66,165870,13,273380
14807,0.001751,172.217.194.0-255,3602,169472,13,273380
14808,0.001755,172.31.36.0-255,66,169538,13,273380
14809,0.001805,172.217.194.0-255,1484,171022,13,273380
14810,0.001812,172.217.194.0-255,2902,173924,13,273380
14811,0.001815,172.31.36.0-255,66,173990,13,273380
14812,0.001839,172.217.194.0-255,5738,179728,13,273380
14813,0.001844,172.31.36.0-255,66,179794,13,273380
14814,0.001914,172.31.36.0-255,66,179860,13,273380
14815,0.001928,172.217.194.0-255,10692,190552,13,273380
14816,0.001931,172.31.36.0-255,66,190618,13,273380
14817,0.002009,172.217.194.0-255,1484,192102,13,273380
14818,0.002015,172.217.194.0-255,2902,195004,13,273380
14819,0.002019,172.31.36.0-255,66,195070,13,273380
14820,0.002044,172.217.194.0-255,5738,200808,13,273380
14821,0.002047,172.31.36.0-255,66,200874,13,273380
14822,0.00205,172.217.194.0-255,1484,202358,13,273380
14823,0.002067,172.217.194.0-255,4320,206678,13,273380
14824,0.00207,172.31.36.0-255,66,206744,13,273380
14825,0.002102,172.217.194.0-255,7156,213900,13,273380
14826,0.002105,172.31.36.0-255,66,213966,13,273380
14827,0.002114,172.217.194.0-255,10692,224658,13,273380
14828,0.002117,172.31.36.0-255,66,224724,13,273380
14829,0.002155,172.217.194.0-255,4320,229044,13,273380
14830,0.002158,172.31.36.0-255,66,229110,13,273380
14831,0.002208,172.31.36.0-255,66,229176,13,273380
14832,0.002229,172.217.194.0-255,4320,233496,13,273380
14833,0.002231,172.31.36.0-255,66,233562,13,273380
14834,0.002239,172.217.194.0-255,7856,241418,13,273380
14835,0.002242,172.31.36.0-255,66,241484,13,273380
14836,0.002246,172.217.194.0-255,2902,244386,13,273380
14837,0.002248,172.31.36.0-255,66,244452,13,273380
14838,0.002296,172.31.36.0-255,66,244518,13,273380
14839,0.002322,172.217.194.0-255,3602,248120,13,273380
14840,0.002327,172.31.36.0-255,66,248186,13,273380
14841,0.002353,172.31.36.0-255,66,248252,13,273380
14842,0.002369,172.31.36.0-255,66,248318,13,273380
14843,0.002377,172.217.194.0-255,8574,256892,13,273380
14844,0.00238,172.31.36.0-255,66,256958,13,273380
14845,0.002406,172.217.194.0-255,2184,259142,13,273380
14846,0.00241,172.31.36.0-255,66,259208,13,273380
14847,0.002443,172.31.36.0-255,66,259274,13,273380
14848,0.002478,172.217.194.0-255,9343,268617,13,273380
14849,0.00248,172.217.194.0-255,105,268722,13,273380
14850,0.002526,172.31.36.0-255,66,268788,13,273380
14851,0.002535,172.31.36.0-255,66,268854,13,273380
14852,0.004315,172.31.36.0-255,66,268920,13,273380
14853,0.00435,172.31.36.0-255,105,269025,13,273380
14854,0.00683,172.217.194.0-255,66,269091,13,273380
14855,0.025375,172.31.36.0-255,172,269263,13,273380
14856,0.025461,172.31.36.0-255,1106,270369,13,273380
14857,0.025695,172.31.36.0-255,1514,271883,13,273380
14858,0.025697,172.31.36.0-255,1299,273182,13,273380
14859,0.026913,104.244.42.0-255,66,273248,13,273380
14860,0.026998,104.244.42.0-255,66,273314,13,273380
14861,0.027252,104.244.42.0-255,66,273380,13,273380
14862,0.0,74.125.24.0-255,143,143,13,328068
14863,2.9e-05,172.31.36.0-255,66,209,13,328068
14864,3.6e-05,74.125.24.0-255,1484,1693,13,328068
14865,4e-05,172.31.36.0-255,66,1759,13,328068
14866,4.5e-05,74.125.24.0-255,2902,4661,13,328068
14867,4.8e-05,172.31.36.0-255,66,4727,13,328068
14868,5.3e-05,74.125.24.0-255,2902,7629,13,328068
14869,5.5e-05,172.31.36.0-255,66,7695,13,328068
14870,8.1e-05,74.125.24.0-255,4320,12015,13,328068
14871,8.4e-05,172.31.36.0-255,66,12081,13,328068
14872,0.000129,74.125.24.0-255,2082,14163,13,328068
14873,0.000132,172.31.36.0-255,66,14229,13,328068
14874,0.000136,74.125.24.0-255,1484,15713,13,328068
14875,0.000138,172.31.36.0-255,66,15779,13,328068
14876,0.000152,74.125.24.0-255,1484,17263,13,328068
14877,0.000154,172.31.36.0-255,66,17329,13,328068
14878,0.000184,74.125.24.0-255,4320,21649,13,328068
14879,0.000187,172.31.36.0-255,66,21715,13,328068
14880,0.000208,74.125.24.0-255,2902,24617,13,328068
14881,0.000211,172.31.36.0-255,66,24683,13,328068
14882,0.000249,74.125.24.0-255,4320,29003,13,328068
14883,0.000252,172.31.36.0-255,66,29069,13,328068
14884,0.000268,74.125.24.0-255,1484,30553,13,328068
14885,0.00027,172.31.36.0-255,66,30619,13,328068
14886,0.000296,74.125.24.0-255,1125,31744,13,328068
14887,0.000298,172.31.36.0-255,66,31810,13,328068
14888,0.000339,74.125.24.0-255,4320,36130,13,328068
14889,0.000342,172.31.36.0-255,66,36196,13,328068
14890,0.000363,74.125.24.0-255,4320,40516,13,328068
14891,0.000366,172.31.36.0-255,66,40582,13,328068
14892,0.00041,74.125.24.0-255,5738,46320,13,328068
14893,0.000414,172.31.36.0-255,66,46386,13,328068
14894,0.000434,74.125.24.0-255,5379,51765,13,328068
14895,0.000437,172.31.36.0-255,66,51831,13,328068
14896,0.000521,74.125.24.0-255,4320,56151,13,328068
14897,0.000524,172.31.36.0-255,66,56217,13,328068
14898,0.000548,74.125.24.0-255,4320,60537,13,328068
14899,0.000553,172.31.36.0-255,66,60603,13,328068
14900,0.000611,74.125.24.0-255,2902,63505,13,328068
14901,0.000615,172.31.36.0-255,66,63571,13,328068
14902,0.000628,74.125.24.0-255,2543,66114,13,328068
14903,0.000632,172.31.36.0-255,66,66180,13,328068
14904,0.000712,74.125.24.0-255,645,66825,13,328068
14905,0.000824,74.125.24.0-255,1484,68309,13,328068
14906,0.000828,172.31.36.0-255,66,68375,13,328068
14907,0.000833,74.125.24.0-255,2902,71277,13,328068
14908,0.000836,172.31.36.0-255,66,71343,13,328068
14909,0.000857,74.125.24.0-255,5738,77081,13,328068
14910,0.00086,172.31.36.0-255,66,77147,13,328068
14911,0.000912,74.125.24.0-255,1484,78631,13,328068
14912,0.000931,74.125.24.0-255,8574,87205,13,328068
14913,0.000934,172.31.36.0-255,66,87271,13,328068
14914,0.000946,74.125.24.0-255,1125,88396,13,328068
14915,0.001025,74.125.24.0-255,2902,91298,13,328068
14916,0.001027,172.31.36.0-255,66,91364,13,328068
14917,0.00103,172.31.36.0-255,66,91430,13,328068
14918,0.00105,74.125.24.0-255,9633,101063,13,328068
14919,0.001054,172.31.36.0-255,66,101129,13,328068
14920,0.001183,74.125.24.0-255,1484,102613,13,328068
14921,0.001204,74.125.24.0-255,4320,106933,13,328068
14922,0.001209,172.31.36.0-255,66,106999,13,328068
14923,0.001228,74.125.24.0-255,4320,111319,13,328068
14924,0.001231,172.31.36.0-255,66,111385,13,328068
14925,0.001256,172.31.36.0-255,66,111451,13,328068
14926,0.001272,74.125.24.0-255,1484,112935,13,328068
14927,0.001443,74.125.24.0-255,4320,117255,13,328068
14928,0.001447,172.31.36.0-255,66,117321,13,328068
14929,0.001469,74.125.24.0-255,3054,120375,13,328068
14930,0.001472,172.31.36.0-255,66,120441,13,328068
14931,0.001522,74.125.24.0-255,7156,127597,13,328068
14932,0.001525,172.31.36.0-255,66,127663,13,328068
14933,0.001556,172.31.36.0-255,66,127729,13,328068
14934,0.001586,172.31.36.0-255,66,127795,13,328068
14935,0.00187,74.125.24.0-255,9992,137787,13,328068
14936,0.001877,172.31.36.0-255,66,137853,13,328068
14937,0.001915,172.31.36.0-255,66,137919,13,328068
14938,0.002162,74.125.24.0-255,3602,141521,13,328068
14939,0.002164,172.31.36.0-255,66,141587,13,328068
14940,0.00253,74.125.24.0-255,1484,143071,13,328068
14941,0.002545,74.125.24.0-255,2902,145973,13,328068
14942,0.002547,172.31.36.0-255,66,146039,13,328068
14943,0.002563,74.125.24.0-255,1484,147523,13,328068
14944,0.002578,74.125.24.0-255,4320,151843,13,328068
14945,0.00258,172.31.36.0-255,66,151909,13,328068
14946,0.002614,74.125.24.0-255,4320,156229,13,328068
14947,0.002617,172.31.36.0-255,66,156295,13,328068
14948,0.002636,74.125.24.0-255,8574,164869,13,328068
14949,0.002639,172.31.36.0-255,66,164935,13,328068
14950,0.002747,74.125.24.0-255,1484,166419,13,328068
14951,0.002775,74.125.24.0-255,9274,175693,13,328068
14952,0.002868,74.125.24.0-255,2902,178595,13,328068
14953,0.002888,74.125.24.0-255,8574,187169,13,328068
14954,0.002979,74.125.24.0-255,2902,190071,13,328068
14955,0.002998,74.125.24.0-255,2902,192973,13,328068
14956,0.003994,172.31.36.0-255,66,193039,13,328068
14957,0.006702,74.125.24.0-255,5738,198777,13,328068
14958,0.006708,172.31.36.0-255,66,198843,13,328068
14959,0.009515,74.125.24.0-255,5738,204581,13,328068
14960,0.009523,172.31.36.0-255,66,204647,13,328068
14961,0.012232,74.125.24.0-255,5738,210385,13,328068
14962,0.012242,172.31.36.0-255,66,210451,13,328068
14963,0.014965,74.125.24.0-255,5738,216189,13,328068
14964,0.014977,172.31.36.0-255,66,216255,13,328068
14965,0.017703,74.125.24.0-255,5738,221993,13,328068
14966,0.017714,172.31.36.0-255,66,222059,13,328068
14967,0.020407,74.125.24.0-255,5738,227797,13,328068
14968,0.020415,172.31.36.0-255,66,227863,13,328068
14969,0.023113,74.125.24.0-255,5738,233601,13,328068
14970,0.023122,172.31.36.0-255,66,233667,13,328068
14971,0.025854,74.125.24.0-255,5738,239405,13,328068
14972,0.025863,172.31.36.0-255,66,239471,13,328068
14973,0.028578,74.125.24.0-255,2902,242373,13,328068
14974,0.028588,172.31.36.0-255,66,242439,13,328068
14975,0.028611,74.125.24.0-255,2902,245341,13,328068
14976,0.028614,172.31.36.0-255,66,245407,13,328068
14977,0.031289,74.125.24.0-255,2902,248309,13,328068
14978,0.031296,172.31.36.0-255,66,248375,13,328068
14979,0.031327,74.125.24.0-255,1484,249859,13,328068
14980,0.031339,74.125.24.0-255,1484,251343,13,328068
14981,0.031341,172.31.36.0-255,66,251409,13,328068
14982,0.034005,74.125.24.0-255,2902,254311,13,328068
14983,0.034013,172.31.36.0-255,66,254377,13,328068
14984,0.034033,74.125.24.0-255,2902,257279,13,328068
14985,0.034036,172.31.36.0-255,66,257345,13,328068
14986,0.034966,172.31.36.0-255,176,257521,13,328068
14987,0.034997,172.31.36.0-255,1110,258631,13,328068
14988,0.035038,172.31.36.0-255,1514,260145,13,328068
14989,0.035039,172.31.36.0-255,1296,261441,13,328068
14990,0.036608,104.244.42.0-255,66,261507,13,328068
14991,0.036634,104.244.42.0-255,66,261573,13,328068
14992,0.036679,104.244.42.0-255,66,261639,13,328068
14993,0.036699,74.125.24.0-255,2902,264541,13,328068
14994,0.036703,172.31.36.0-255,66,264607,13,328068
14995,0.036748,74.125.24.0-255,2902,267509,13,328068
14996,0.036751,172.31.36.0-255,66,267575,13,328068
14997,0.039394,74.125.24.0-255,2902,270477,13,328068
14998,0.0394,172.31.36.0-255,66,270543,13,328068
14999,0.039465,74.125.24.0-255,2902,273445,13,328068
15000,0.039469,172.31.36.0-255,66,273511,13,328068
15001,0.042119,74.125.24.0-255,2902,276413,13,328068
15002,0.042124,172.31.36.0-255,66,276479,13,328068
15003,0.042185,74.125.24.0-255,2902,279381,13,328068
15004,0.042189,172.31.36.0-255,66,279447,13,328068
15005,0.044829,74.125.24.0-255,1484,280931,13,328068
15006,0.044862,74.125.24.0-255,4320,285251,13,328068
15007,0.044867,172.31.36.0-255,66,285317,13,328068
15008,0.047627,74.125.24.0-255,4320,289637,13,328068
15009,0.047635,172.31.36.0-255,66,289703,13,328068
15010,0.04765,74.125.24.0-255,1484,291187,13,328068
15011,0.050396,74.125.24.0-255,4320,295507,13,328068
15012,0.050404,172.31.36.0-255,66,295573,13,328068
15013,0.053119,74.125.24.0-255,2902,298475,13,328068
15014,0.053126,172.31.36.0-255,66,298541,13,328068
15015,0.053155,74.125.24.0-255,2902,301443,13,328068
15016,0.053158,172.31.36.0-255,66,301509,13,328068
15017,0.055823,74.125.24.0-255,2902,304411,13,328068
15018,0.055828,172.31.36.0-255,66,304477,13,328068
15019,0.05586,74.125.24.0-255,2902,307379,13,328068
15020,0.055863,172.31.36.0-255,66,307445,13,328068
15021,0.058519,74.125.24.0-255,2902,310347,13,328068
15022,0.058526,172.31.36.0-255,66,310413,13,328068
15023,0.058554,74.125.24.0-255,2902,313315,13,328068
15024,0.058556,172.31.36.0-255,66,313381,13,328068
15025,0.061244,74.125.24.0-255,4320,317701,13,328068
15026,0.06125,172.31.36.0-255,66,317767,13,328068
15027,0.061275,74.125.24.0-255,1484,319251,13,328068
15028,0.063957,74.125.24.0-255,4320,323571,13,328068
15029,0.063964,172.31.36.0-255,66,323637,13,328068
15030,0.06667,74.125.24.0-255,4194,327831,13,328068
15031,0.06668,172.31.36.0-255,66,327897,13,328068
15032,0.066912,172.31.36.0-255,105,328002,13,328068
15033,0.069572,74.125.24.0-255,66,328068,13,328068
15034,0.0,74.125.200.0-255,154,154,13,363805
15035,4e-05,172.31.36.0-255,66,220,13,363805
15036,4.7e-05,74.125.200.0-255,1484,1704,13,363805
15037,5e-05,172.31.36.0-255,66,1770,13,363805
15038,5.6e-05,74.125.200.0-255,2902,4672,13,363805
15039,5.9e-05,172.31.36.0-255,66,4738,13,363805
15040,7.3e-05,74.125.200.0-255,7156,11894,13,363805
15041,7.6e-05,172.31.36.0-255,66,11960,13,363805
15042,8.5e-05,74.125.200.0-255,7721,19681,13,363805
15043,8.8e-05,172.31.36.0-255,66,19747,13,363805
15044,0.000103,74.125.200.0-255,4320,24067,13,363805
15045,0.000105,172.31.36.0-255,66,24133,13,363805
15046,0.000135,74.125.200.0-255,5738,29871,13,363805
15047,0.000138,172.31.36.0-255,66,29937,13,363805
15048,0.000141,74.125.200.0-255,1125,31062,13,363805
15049,0.000143,172.31.36.0-255,66,31128,13,363805
15050,0.000263,74.125.200.0-255,1484,32612,13,363805
15051,0.000266,172.31.36.0-255,66,32678,13,363805
15052,0.00027,74.125.200.0-255,1484,34162,13,363805
15053,0.000272,172.31.36.0-255,66,34228,13,363805
15054,0.000291,74.125.200.0-255,1484,35712,13,363805
15055,0.000294,172.31.36.0-255,66,35778,13,363805
15056,0.000305,74.125.200.0-255,5738,41516,13,363805
15057,0.000308,172.31.36.0-255,66,41582,13,363805
15058,0.000316,74.125.200.0-255,6797,48379,13,363805
15059,0.000319,172.31.36.0-255,66,48445,13,363805
15060,0.000356,74.125.200.0-255,4320,52765,13,363805
15061,0.00036,172.31.36.0-255,66,52831,13,363805
15062,0.000395,74.125.200.0-255,9992,62823,13,363805
15063,0.000399,74.125.200.0-255,2543,65366,13,363805
15064,0.000401,172.31.36.0-255,66,65432,13,363805
15065,0.000405,172.31.36.0-255,66,65498,13,363805
15066,0.000428,74.125.200.0-255,678,66176,13,363805
15067,0.000597,74.125.200.0-255,1484,67660,13,363805
15068,0.000601,172.31.36.0-255,66,67726,13,363805
15069,0.000606,74.125.200.0-255,2902,70628,13,363805
15070,0.000609,172.31.36.0-255,66,70694,13,363805
15071,0.000639,74.125.200.0-255,5738,76432,13,363805
15072,0.000642,172.31.36.0-255,66,76498,13,363805
15073,0.000662,74.125.200.0-255,6247,82745,13,363805
15074,0.000665,172.31.36.0-255,66,82811,13,363805
15075,0.000732,74.125.200.0-255,1484,84295,13,363805
15076,0.000747,74.125.200.0-255,2902,87197,13,363805
15077,0.000751,172.31.36.0-255,66,87263,13,363805
15078,0.000777,74.125.200.0-255,4320,91583,13,363805
15079,0.00078,172.31.36.0-255,66,91649,13,363805
15080,0.000813,74.125.200.0-255,2902,94551,13,363805
15081,0.000816,172.31.36.0-255,66,94617,13,363805
15082,0.000851,74.125.200.0-255,4320,98937,13,363805
15083,0.000855,172.31.36.0-255,66,99003,13,363805
15084,0.000858,74.125.200.0-255,1125,100128,13,363805
15085,0.001041,74.125.200.0-255,1484,101612,13,363805
15086,0.001045,172.31.36.0-255,66,101678,13,363805
15087,0.00105,74.125.200.0-255,2902,104580,13,363805
15088,0.001052,172.31.36.0-255,66,104646,13,363805
15089,0.001056,74.125.200.0-255,1484,106130,13,363805
15090,0.001084,74.125.200.0-255,2902,109032,13,363805
15091,0.001088,172.31.36.0-255,66,109098,13,363805
15092,0.001096,74.125.200.0-255,7156,116254,13,363805
15093,0.001098,172.31.36.0-255,66,116320,13,363805
15094,0.001131,74.125.200.0-255,1484,117804,13,363805
15095,0.001141,74.125.200.0-255,9992,127796,13,363805
15096,0.001144,172.31.36.0-255,66,127862,13,363805
15097,0.001175,74.125.200.0-255,6438,134300,13,363805
15098,0.001178,172.31.36.0-255,66,134366,13,363805
15099,0.001456,74.125.200.0-255,1484,135850,13,363805
15100,0.001466,74.125.200.0-255,2902,138752,13,363805
15101,0.001471,172.31.36.0-255,66,138818,13,363805
15102,0.001511,74.125.200.0-255,1484,140302,13,363805
15103,0.001517,74.125.200.0-255,2902,143204,13,363805
15104,0.001519,172.31.36.0-255,66,143270,13,363805
15105,0.001553,74.125.200.0-255,5738,149008,13,363805
15106,0.001556,172.31.36.0-255,66,149074,13,363805
15107,0.001561,74.125.200.0-255,2902,151976,13,363805
15108,0.001564,172.31.36.0-255,66,152042,13,363805
15109,0.0016,74.125.200.0-255,7156,159198,13,363805
15110,0.001605,172.31.36.0-255,66,159264,13,363805
15111,0.001634,74.125.200.0-255,9274,168538,13,363805
15112,0.001638,172.31.36.0-255,66,168604,13,363805
15113,0.00167,74.125.200.0-255,1484,170088,13,363805
15114,0.00169,74.125.200.0-255,2902,172990,13,363805
15115,0.001694,172.31.36.0-255,66,173056,13,363805
15116,0.001721,74.125.200.0-255,5738,178794,13,363805
15117,0.001724,172.31.36.0-255,66,178860,13,363805
15118,0.00173,74.125.200.0-255,4320,183180,13,363805
15119,0.001733,172.31.36.0-255,66,183246,13,363805
15120,0.001771,74.125.200.0-255,2902,186148,13,363805
15121,0.001774,172.31.36.0-255,66,186214,13,363805
15122,0.001788,172.31.36.0-255,66,186280,13,363805
15123,0.001809,74.125.200.0-255,1484,187764,13,363805
15124,0.001813,74.125.200.0-255,2184,189948,13,363805
15125,0.001815,172.31.36.0-255,66,190014,13,363805
15126,0.001867,74.125.200.0-255,2902,192916,13,363805
15127,0.001873,172.31.36.0-255,66,192982,13,363805
15128,0.001877,74.125.200.0-255,1484,194466,13,363805
15129,0.00188,74.125.200.0-255,2902,197368,13,363805
15130,0.001883,172.31.36.0-255,66,197434,13,363805
15131,0.001892,74.125.200.0-255,2902,200336,13,363805
15132,0.001894,172.31.36.0-255,66,200402,13,363805
15133,0.001918,74.125.200.0-255,2902,203304,13,363805
15134,0.001922,172.31.36.0-255,66,203370,13,363805
15135,0.001956,172.31.36.0-255,66,203436,13,363805
15136,0.001975,74.125.200.0-255,4320,207756,13,363805
15137,0.001978,172.31.36.0-255,66,207822,13,363805
15138,0.00201,74.125.200.0-255,3602,211424,13,363805
15139,0.002019,172.31.36.0-255,66,211490,13,363805
15140,0.003935,74.125.200.0-255,1484,212974,13,363805
15141,0.003976,74.125.200.0-255,4320,217294,13,363805
15142,0.00398,172.31.36.0-255,66,217360,13,363805
15143,0.005964,74.125.200.0-255,5738,223098,13,363805
15144,0.005968,172.31.36.0-255,66,223164,13,363805
15145,0.007946,74.125.200.0-255,5738,228902,13,363805
15146,0.007953,172.31.36.0-255,66,228968,13,363805
15147,0.009928,74.125.200.0-255,5738,234706,13,363805
15148,0.00996,172.31.36.0-255,66,234772,13,363805
15149,0.011953,74.125.200.0-255,5738,240510,13,363805
15150,0.011961,172.31.36.0-255,66,240576,13,363805
15151,0.013998,74.125.200.0-255,5738,246314,13,363805
15152,0.014008,172.31.36.0-255,66,246380,13,363805
15153,0.015984,74.125.200.0-255,5738,252118,13,363805
15154,0.015992,172.31.36.0-255,66,252184,13,363805
15155,0.017978,74.125.200.0-255,5738,257922,13,363805
15156,0.017988,172.31.36.0-255,66,257988,13,363805
15157,0.019954,74.125.200.0-255,5738,263726,13,363805
15158,0.019959,172.31.36.0-255,66,263792,13,363805
15159,0.02192,74.125.200.0-255,5738,269530,13,363805
15160,0.021927,172.31.36.0-255,66,269596,13,363805
15161,0.023904,74.125.200.0-255,5738,275334,13,363805
15162,0.023911,172.31.36.0-255,66,275400,13,363805
15163,0.025885,74.125.200.0-255,5738,281138,13,363805
15164,0.025892,172.31.36.0-255,66,281204,13,363805
15165,0.027223,172.31.36.0-255,172,281376,13,363805
15166,0.027278,172.31.36.0-255,1106,282482,13,363805
15167,0.027346,172.31.36.0-255,1514,283996,13,363805
15168,0.027348,172.31.36.0-255,1299,285295,13,363805
15169,0.027865,74.125.200.0-255,5738,291033,13,363805
15170,0.027871,172.31.36.0-255,66,291099,13,363805
15171,0.02877,104.244.42.0-255,66,291165,13,363805
15172,0.028809,104.244.42.0-255,66,291231,13,363805
15173,0.028919,104.244.42.0-255,66,291297,13,363805
15174,0.029837,74.125.200.0-255,5738,297035,13,363805
15175,0.029842,172.31.36.0-255,66,297101,13,363805
15176,0.031816,74.125.200.0-255,5738,302839,13,363805
15177,0.031822,172.31.36.0-255,66,302905,13,363805
15178,0.0338,74.125.200.0-255,2902,305807,13,363805
15179,0.033805,172.31.36.0-255,66,305873,13,363805
15180,0.033837,74.125.200.0-255,2902,308775,13,363805
15181,0.03384,172.31.36.0-255,66,308841,13,363805
15182,0.035778,74.125.200.0-255,2902,311743,13,363805
15183,0.035785,172.31.36.0-255,66,311809,13,363805
15184,0.03582,74.125.200.0-255,2902,314711,13,363805
15185,0.035823,172.31.36.0-255,66,314777,13,363805
15186,0.037748,74.125.200.0-255,2902,317679,13,363805
15187,0.037754,172.31.36.0-255,66,317745,13,363805
15188,0.037798,74.125.200.0-255,2902,320647,13,363805
15189,0.037802,172.31.36.0-255,66,320713,13,363805
15190,0.039719,74.125.200.0-255,2902,323615,13,363805
15191,0.039724,172.31.36.0-255,66,323681,13,363805
15192,0.039756,74.125.200.0-255,2902,326583,13,363805
15193,0.03976,172.31.36.0-255,66,326649,13,363805
15194,0.041697,74.125.200.0-255,2902,329551,13,363805
15195,0.041704,172.31.36.0-255,66,329617,13,363805
15196,0.041735,74.125.200.0-255,2902,332519,13,363805
15197,0.041738,172.31.36.0-255,66,332585,13,363805
15198,0.043676,74.125.200.0-255,2902,335487,13,363805
15199,0.043695,172.31.36.0-255,66,335553,13,363805
15200,0.043721,74.125.200.0-255,2902,338455,13,363805
15201,0.043726,172.31.36.0-255,66,338521,13,363805
15202,0.045655,74.125.200.0-255,2902,341423,13,363805
15203,0.045661,172.31.36.0-255,66,341489,13,363805
15204,0.045697,74.125.200.0-255,2902,344391,13,363805
15205,0.0457,172.31.36.0-255,66,344457,13,363805
15206,0.047628,74.125.200.0-255,2902,347359,13,363805
15207,0.047635,172.31.36.0-255,66,347425,13,363805
15208,0.047668,74.125.200.0-255,2902,350327,13,363805
15209,0.047671,172.31.36.0-255,66,350393,13,363805
15210,0.049616,74.125.200.0-255,2902,353295,13,363805
15211,0.049622,172.31.36.0-255,66,353361,13,363805
15212,0.049653,74.125.200.0-255,2902,356263,13,363805
15213,0.049656,172.31.36.0-255,66,356329,13,363805
15214,0.051589,74.125.200.0-255,2902,359231,13,363805
15215,0.051594,172.31.36.0-255,66,359297,13,363805
15216,0.051631,74.125.200.0-255,2902,362199,13,363805
15217,0.051635,172.31.36.0-255,66,362265,13,363805
15218,0.053551,74.125.200.0-255,1303,363568,13,363805
15219,0.053724,172.31.36.0-255,66,363634,13,363805
15220,0.053751,172.31.36.0-255,105,363739,13,363805
15221,0.055698,74.125.200.0-255,66,363805,13,363805
15222,0.0,172.217.194.0-255,153,153,13,181785
15223,1.3e-05,172.217.194.0-255,1484,1637,13,181785
15224,2e-05,172.31.36.0-255,66,1703,13,181785
15225,2.9e-05,172.217.194.0-255,2902,4605,13,181785
15226,3.3e-05,172.31.36.0-255,66,4671,13,181785
15227,5.1e-05,172.217.194.0-255,7156,11827,13,181785
15228,5.4e-05,172.31.36.0-255,66,11893,13,181785
15229,6.9e-05,172.31.36.0-255,66,11959,13,181785
15230,0.000109,172.217.194.0-255,6797,18756,13,181785
15231,0.000113,172.31.36.0-255,66,18822,13,181785
15232,0.000813,172.217.194.0-255,1484,20306,13,181785
15233,0.000824,172.217.194.0-255,2902,23208,13,181785
15234,0.000829,172.31.36.0-255,66,23274,13,181785
15235,0.000838,172.217.194.0-255,5738,29012,13,181785
15236,0.00084,172.31.36.0-255,66,29078,13,181785
15237,0.000854,172.217.194.0-255,6797,35875,13,181785
15238,0.000857,172.31.36.0-255,66,35941,13,181785
15239,0.000864,172.217.194.0-255,7156,43097,13,181785
15240,0.000866,172.31.36.0-255,66,43163,13,181785
15241,0.000902,172.217.194.0-255,9923,53086,13,181785
15242,0.000905,172.31.36.0-255,66,53152,13,181785
15243,0.00103,172.217.194.0-255,364,53516,13,181785
15244,0.00116,172.217.194.0-255,1484,55000,13,181785
15245,0.001166,172.31.36.0-255,66,55066,13,181785
15246,0.001173,172.217.194.0-255,2902,57968,13,181785
15247,0.001177,172.31.36.0-255,66,58034,13,181785
15248,0.001186,172.217.194.0-255,2902,60936,13,181785
15249,0.001189,172.31.36.0-255,66,61002,13,181785
15250,0.001218,172.217.194.0-255,2902,63904,13,181785
15251,0.001221,172.31.36.0-255,66,63970,13,181785
15252,0.001224,172.217.194.0-255,1484,65454,13,181785
15253,0.001275,172.31.36.0-255,66,65520,13,181785
15254,0.001285,172.217.194.0-255,9633,75153,13,181785
15255,0.001293,172.31.36.0-255,66,75219,13,181785
15256,0.001527,172.217.194.0-255,1484,76703,13,181785
15257,0.001535,172.217.194.0-255,2902,79605,13,181785
15258,0.00154,172.31.36.0-255,66,79671,13,181785
15259,0.001547,172.217.194.0-255,4320,83991,13,181785
15260,0.00155,172.31.36.0-255,66,84057,13,181785
15261,0.001573,172.217.194.0-255,1484,85541,13,181785
15262,0.001582,172.217.194.0-255,7156,92697,13,181785
15263,0.001585,172.31.36.0-255,66,92763,13,181785
15264,0.001599,172.217.194.0-255,1484,94247,13,181785
15265,0.001631,172.217.194.0-255,1484,95731,13,181785
15266,0.001634,172.31.36.0-255,66,95797,13,181785
15267,0.001676,172.31.36.0-255,66,95863,13,181785
15268,0.001783,172.217.194.0-255,1484,97347,13,181785
15269,0.001788,172.217.194.0-255,2902,100249,13,181785
15270,0.00179,172.31.36.0-255,66,100315,13,181785
15271,0.001794,172.217.194.0-255,1484,101799,13,181785
15272,0.001819,172.217.194.0-255,4320,106119,13,181785
15273,0.001821,172.31.36.0-255,66,106185,13,181785
15274,0.001827,172.217.194.0-255,4320,110505,13,181785
15275,0.00183,172.31.36.0-255,66,110571,13,181785
15276,0.001858,172.217.194.0-255,5738,116309,13,181785
15277,0.00186,172.31.36.0-255,66,116375,13,181785
15278,0.001865,172.217.194.0-255,2902,119277,13,181785
15279,0.001867,172.31.36.0-255,66,119343,13,181785
15280,0.001906,172.31.36.0-255,66,119409,13,181785
15281,0.001934,172.31.36.0-255,66,119475,13,181785
15282,0.001943,172.217.194.0-255,8574,128049,13,181785
15283,0.001946,172.31.36.0-255,66,128115,13,181785
15284,0.001983,172.217.194.0-255,9274,137389,13,181785
15285,0.001986,172.31.36.0-255,66,137455,13,181785
15286,0.002,172.31.36.0-255,66,137521,13,181785
15287,0.002032,172.217.194.0-255,2902,140423,13,181785
15288,0.002034,172.31.36.0-255,66,140489,13,181785
15289,0.00205,172.31.36.0-255,66,140555,13,181785
15290,0.002059,172.217.194.0-255,10692,151247,13,181785
15291,0.002062,172.31.36.0-255,66,151313,13,181785
15292,0.002075,172.31.36.0-255,66,151379,13,181785
15293,0.002158,172.31.36.0-255,66,151445,13,181785
15294,0.002173,172.31.36.0-255,66,151511,13,181785
15295,0.002191,172.31.36.0-255,66,151577,13,181785
15296,0.002198,172.217.194.0-255,7156,158733,13,181785
15297,0.0022,172.31.36.0-255,66,158799,13,181785
15298,0.00225,172.31.36.0-255,66,158865,13,181785
15299,0.002257,172.217.194.0-255,7156,166021,13,181785
15300,0.002259,172.31.36.0-255,66,166087,13,181785
15301,0.0023,172.31.36.0-255,66,166153,13,181785
15302,0.002319,172.31.36.0-255,66,166219,13,181785
15303,0.002342,172.217.194.0-255,5020,171239,13,181785
15304,0.002344,172.31.36.0-255,66,171305,13,181785
15305,0.002348,172.217.194.0-255,943,172248,13,181785
15306,0.002351,172.217.194.0-255,105,172353,13,181785
15307,0.007928,172.31.36.0-255,66,172419,13,181785
15308,0.007966,172.31.36.0-255,105,172524,13,181785
15309,0.010257,172.217.194.0-255,66,172590,13,181785
15310,0.032368,172.31.36.0-255,172,172762,13,181785
15311,0.032403,172.31.36.0-255,1109,173871,13,181785
15312,0.032468,172.31.36.0-255,1514,175385,13,181785
15313,0.03247,172.31.36.0-255,1514,176899,13,181785
15314,0.032472,172.31.36.0-255,1514,178413,13,181785
15315,0.032478,172.31.36.0-255,1514,179927,13,181785
15316,0.032479,172.31.36.0-255,1514,181441,13,181785
15317,0.03248,172.31.36.0-255,80,181521,13,181785
15318,0.033935,104.244.42.0-255,66,181587,13,181785
15319,0.033971,104.244.42.0-255,66,181653,13,181785
15320,0.034038,104.244.42.0-255,66,181719,13,181785
15321,0.034061,104.244.42.0-255,66,181785,13,181785
15322,0.0,172.31.36.0-255,130,130,13,1687
15323,0.000498,172.31.36.0-255,236,366,13,1687
15324,0.000526,172.31.36.0-255,365,731,13,1687
15325,0.002563,74.125.24.0-255,630,1361,13,1687
15326,0.002733,172.31.36.0-255,97,1458,13,1687
15327,0.002816,74.125.24.0-255,97,1555,13,1687
15328,0.005224,74.125.24.0-255,66,1621,13,1687
15329,0.042434,172.31.36.0-255,66,1687,13,1687
15330,0.0,172.217.194.0-255,153,153,13,339819
15331,1.6e-05,172.217.194.0-255,1484,1637,13,339819
15332,2.5e-05,172.31.36.0-255,66,1703,13,339819
15333,3.3e-05,172.217.194.0-255,2902,4605,13,339819
15334,3.7e-05,172.31.36.0-255,66,4671,13,339819
15335,4.3e-05,172.217.194.0-255,5738,10409,13,339819
15336,4.7e-05,172.31.36.0-255,66,10475,13,339819
15337,7e-05,172.217.194.0-255,3455,13930,13,339819
15338,7.3e-05,172.31.36.0-255,66,13996,13,339819
15339,7.8e-05,172.217.194.0-255,2902,16898,13,339819
15340,8e-05,172.31.36.0-255,66,16964,13,339819
15341,0.000107,172.217.194.0-255,1484,18448,13,339819
15342,0.000117,172.217.194.0-255,9992,28440,13,339819
15343,0.000119,172.31.36.0-255,66,28506,13,339819
15344,0.000124,172.217.194.0-255,2543,31049,13,339819
15345,0.000126,172.31.36.0-255,66,31115,13,339819
15346,0.000188,172.217.194.0-255,1484,32599,13,339819
15347,0.000191,172.217.194.0-255,1484,34083,13,339819
15348,0.000194,172.31.36.0-255,66,34149,13,339819
15349,0.000208,172.217.194.0-255,1484,35633,13,339819
15350,0.00023,172.217.194.0-255,5738,41371,13,339819
15351,0.000233,172.31.36.0-255,66,41437,13,339819
15352,0.000265,172.31.36.0-255,66,41503,13,339819
15353,0.000271,172.217.194.0-255,5738,47241,13,339819
15354,0.000274,172.31.36.0-255,66,47307,13,339819
15355,0.000302,172.217.194.0-255,4215,51522,13,339819
15356,0.000305,172.31.36.0-255,66,51588,13,339819
15357,0.000308,172.217.194.0-255,431,52019,13,339819
15358,0.000774,172.217.194.0-255,1484,53503,13,339819
15359,0.000779,172.31.36.0-255,66,53569,13,339819
15360,0.000785,172.217.194.0-255,2902,56471,13,339819
15361,0.000788,172.31.36.0-255,66,56537,13,339819
15362,0.000794,172.217.194.0-255,4320,60857,13,339819
15363,0.000797,172.31.36.0-255,66,60923,13,339819
15364,0.000811,172.217.194.0-255,1484,62407,13,339819
15365,0.000829,172.217.194.0-255,4320,66727,13,339819
15366,0.000832,172.31.36.0-255,66,66793,13,339819
15367,0.000856,172.217.194.0-255,8574,75367,13,339819
15368,0.00086,172.31.36.0-255,66,75433,13,339819
15369,0.000886,172.217.194.0-255,8574,84007,13,339819
15370,0.000889,172.31.36.0-255,66,84073,13,339819
15371,0.000908,172.217.194.0-255,2184,86257,13,339819
15372,0.000911,172.31.36.0-255,66,86323,13,339819
15373,0.001111,172.217.194.0-255,1484,87807,13,339819
15374,0.001118,172.217.194.0-255,2902,90709,13,339819
15375,0.001121,172.31.36.0-255,66,90775,13,339819
15376,0.001144,172.217.194.0-255,5738,96513,13,339819
15377,0.001147,172.31.36.0-255,66,96579,13,339819
15378,0.001162,172.217.194.0-255,4320,100899,13,339819
15379,0.001164,172.31.36.0-255,66,100965,13,339819
15380,0.001188,172.217.194.0-255,8574,109539,13,339819
15381,0.001191,172.31.36.0-255,66,109605,13,339819
15382,0.001201,172.217.194.0-255,10692,120297,13,339819
15383,0.001203,172.31.36.0-255,66,120363,13,339819
15384,0.001285,172.217.194.0-255,1484,121847,13,339819
15385,0.00129,172.217.194.0-255,2902,124749,13,339819
15386,0.001295,172.31.36.0-255,66,124815,13,339819
15387,0.001306,172.217.194.0-255,4320,129135,13,339819
15388,0.00131,172.31.36.0-255,66,129201,13,339819
15389,0.001334,172.217.194.0-255,1484,130685,13,339819
15390,0.001344,172.217.194.0-255,7156,137841,13,339819
15391,0.001347,172.31.36.0-255,66,137907,13,339819
15392,0.001367,172.217.194.0-255,5738,143645,13,339819
15393,0.00137,172.31.36.0-255,66,143711,13,339819
15394,0.001396,172.217.194.0-255,9992,153703,13,339819
15395,0.001399,172.31.36.0-255,66,153769,13,339819
15396,0.001417,172.217.194.0-255,766,154535,13,339819
15397,0.001439,172.217.194.0-255,1484,156019,13,339819
15398,0.001442,172.31.36.0-255,66,156085,13,339819
15399,0.001447,172.217.194.0-255,2902,158987,13,339819
15400,0.001449,172.31.36.0-255,66,159053,13,339819
15401,0.001453,172.217.194.0-255,1484,160537,13,339819
15402,0.001477,172.217.194.0-255,4320,164857,13,339819
15403,0.00148,172.31.36.0-255,66,164923,13,339819
15404,0.001494,172.31.36.0-255,66,164989,13,339819
15405,0.001499,172.217.194.0-255,4320,169309,13,339819
15406,0.001501,172.31.36.0-255,66,169375,13,339819
15407,0.001545,172.217.194.0-255,6438,175813,13,339819
15408,0.001548,172.31.36.0-255,66,175879,13,339819
15409,0.001835,172.217.194.0-255,1484,177363,13,339819
15410,0.001841,172.217.194.0-255,2902,180265,13,339819
15411,0.001844,172.31.36.0-255,66,180331,13,339819
15412,0.001851,172.217.194.0-255,5738,186069,13,339819
15413,0.001854,172.31.36.0-255,66,186135,13,339819
15414,0.001874,172.217.194.0-255,2902,189037,13,339819
15415,0.001876,172.31.36.0-255,66,189103,13,339819
15416,0.001896,172.217.194.0-255,9992,199095,13,339819
15417,0.001899,172.31.36.0-255,66,199161,13,339819
15418,0.001909,172.217.194.0-255,10692,209853,13,339819
15419,0.001911,172.31.36.0-255,66,209919,13,339819
15420,0.001955,172.217.194.0-255,5738,215657,13,339819
15421,0.001957,172.31.36.0-255,66,215723,13,339819
15422,0.001982,172.217.194.0-255,5738,221461,13,339819
15423,0.001984,172.31.36.0-255,66,221527,13,339819
15424,0.002017,172.31.36.0-255,66,221593,13,339819
15425,0.002026,172.217.194.0-255,9274,230867,13,339819
15426,0.002029,172.31.36.0-255,66,230933,13,339819
15427,0.002076,172.217.194.0-255,1484,232417,13,339819
15428,0.002082,172.217.194.0-255,2902,235319,13,339819
15429,0.002085,172.31.36.0-255,66,235385,13,339819
15430,0.002091,172.217.194.0-255,5738,241123,13,339819
15431,0.002094,172.31.36.0-255,66,241189,13,339819
15432,0.002108,172.31.36.0-255,66,241255,13,339819
15433,0.002114,172.217.194.0-255,5738,246993,13,339819
15434,0.002117,172.31.36.0-255,66,247059,13,339819
15435,0.002143,172.217.194.0-255,2902,249961,13,339819
15436,0.002147,172.31.36.0-255,66,250027,13,339819
15437,0.002152,172.217.194.0-255,2184,252211,13,339819
15438,0.002155,172.31.36.0-255,66,252277,13,339819
15439,0.002173,172.217.194.0-255,2902,255179,13,339819
15440,0.002176,172.31.36.0-255,66,255245,13,339819
15441,0.002182,172.217.194.0-255,4320,259565,13,339819
15442,0.002185,172.31.36.0-255,66,259631,13,339819
15443,0.002203,172.217.194.0-255,2902,262533,13,339819
15444,0.002206,172.31.36.0-255,66,262599,13,339819
15445,0.002212,172.217.194.0-255,4320,266919,13,339819
15446,0.002214,172.31.36.0-255,66,266985,13,339819
15447,0.00224,172.217.194.0-255,9992,276977,13,339819
15448,0.002244,172.31.36.0-255,66,277043,13,339819
15449,0.002268,172.217.194.0-255,9274,286317,13,339819
15450,0.002273,172.31.36.0-255,66,286383,13,339819
15451,0.002325,172.217.194.0-255,1484,287867,13,339819
15452,0.002349,172.217.194.0-255,2902,290769,13,339819
15453,0.002355,172.217.194.0-255,5738,296507,13,339819
15454,0.002357,172.217.194.0-255,1484,297991,13,339819
15455,0.002359,172.217.194.0-255,1484,299475,13,339819
15456,0.002365,172.217.194.0-255,4320,303795,13,339819
15457,0.00237,172.31.36.0-255,66,303861,13,339819
15458,0.002374,172.31.36.0-255,66,303927,13,339819
15459,0.002377,172.31.36.0-255,66,303993,13,339819
15460,0.00238,172.31.36.0-255,66,304059,13,339819
15461,0.002398,172.217.194.0-255,9992,314051,13,339819
15462,0.002401,172.31.36.0-255,66,314117,13,339819
15463,0.002406,172.217.194.0-255,4320,318437,13,339819
15464,0.002409,172.31.36.0-255,66,318503,13,339819
15465,0.002414,172.217.194.0-255,3602,322105,13,339819
15466,0.002417,172.31.36.0-255,66,322171,13,339819
15467,0.002421,172.217.194.0-255,1484,323655,13,339819
15468,0.002424,172.217.194.0-255,1484,325139,13,339819
15469,0.002426,172.31.36.0-255,66,325205,13,339819
15470,0.002453,172.217.194.0-255,5077,330282,13,339819
15471,0.002455,172.31.36.0-255,66,330348,13,339819
15472,0.002483,172.217.194.0-255,105,330453,13,339819
15473,0.009892,172.31.36.0-255,105,330558,13,339819
15474,0.012168,172.217.194.0-255,66,330624,13,339819
15475,0.034524,172.31.36.0-255,172,330796,13,339819
15476,0.03456,172.31.36.0-255,1109,331905,13,339819
15477,0.034643,172.31.36.0-255,1514,333419,13,339819
15478,0.034645,172.31.36.0-255,1514,334933,13,339819
15479,0.034647,172.31.36.0-255,1514,336447,13,339819
15480,0.034648,172.31.36.0-255,1514,337961,13,339819
15481,0.034676,172.31.36.0-255,1514,339475,13,339819
15482,0.034681,172.31.36.0-255,80,339555,13,339819
15483,0.036058,104.244.42.0-255,66,339621,13,339819
15484,0.036096,104.244.42.0-255,66,339687,13,339819
15485,0.036249,104.244.42.0-255,66,339753,13,339819
15486,0.036278,104.244.42.0-255,66,339819,13,339819
15487,0.0,172.217.194.0-255,153,153,13,295516
15488,2.3e-05,172.31.36.0-255,66,219,13,295516
15489,3.1e-05,172.217.194.0-255,1484,1703,13,295516
15490,3.6e-05,172.31.36.0-255,66,1769,13,295516
15491,4.2e-05,172.217.194.0-255,2902,4671,13,295516
15492,5.4e-05,172.31.36.0-255,66,4737,13,295516
15493,6.3e-05,172.217.194.0-255,7156,11893,13,295516
15494,6.6e-05,172.31.36.0-255,66,11959,13,295516
15495,0.000117,172.217.194.0-255,4922,16881,13,295516
15496,0.000121,172.31.36.0-255,66,16947,13,295516
15497,0.000146,172.217.194.0-255,1484,18431,13,295516
15498,0.000148,172.31.36.0-255,66,18497,13,295516
15499,0.000178,172.217.194.0-255,4320,22817,13,295516
15500,0.000181,172.31.36.0-255,66,22883,13,295516
15501,0.000213,172.217.194.0-255,5738,28621,13,295516
15502,0.000215,172.31.36.0-255,66,28687,13,295516
15503,0.000281,172.217.194.0-255,4320,33007,13,295516
15504,0.000285,172.31.36.0-255,66,33073,13,295516
15505,0.000318,172.217.194.0-255,8574,41647,13,295516
15506,0.000321,172.31.36.0-255,66,41713,13,295516
15507,0.000401,172.217.194.0-255,1484,43197,13,295516
15508,0.000405,172.31.36.0-255,66,43263,13,295516
15509,0.00041,172.217.194.0-255,2902,46165,13,295516
15510,0.000412,172.31.36.0-255,66,46231,13,295516
15511,0.000442,172.217.194.0-255,2184,48415,13,295516
15512,0.000445,172.31.36.0-255,66,48481,13,295516
15513,0.003019,172.217.194.0-255,1484,49965,13,295516
15514,0.003035,172.31.36.0-255,66,50031,13,295516
15515,0.003046,172.217.194.0-255,2902,52933,13,295516
15516,0.003056,172.31.36.0-255,66,52999,13,295516
15517,0.003061,172.217.194.0-255,1484,54483,13,295516
15518,0.003063,172.31.36.0-255,66,54549,13,295516
15519,0.005,172.217.194.0-255,1484,56033,13,295516
15520,0.005045,172.217.194.0-255,2902,58935,13,295516
15521,0.005052,172.31.36.0-255,66,59001,13,295516
15522,0.005079,172.217.194.0-255,1484,60485,13,295516
15523,0.007043,172.217.194.0-255,4320,64805,13,295516
15524,0.007074,172.31.36.0-255,66,64871,13,295516
15525,0.009076,172.217.194.0-255,5738,70609,13,295516
15526,0.009139,172.31.36.0-255,66,70675,13,295516
15527,0.011171,172.217.194.0-255,5738,76413,13,295516
15528,0.011187,172.31.36.0-255,66,76479,13,295516
15529,0.013218,172.217.194.0-255,5738,82217,13,295516
15530,0.013234,172.31.36.0-255,66,82283,13,295516
15531,0.015216,172.217.194.0-255,5738,88021,13,295516
15532,0.015227,172.31.36.0-255,66,88087,13,295516
15533,0.017197,172.217.194.0-255,5738,93825,13,295516
15534,0.017207,172.31.36.0-255,66,93891,13,295516
15535,0.019214,172.217.194.0-255,5738,99629,13,295516
15536,0.019225,172.31.36.0-255,66,99695,13,295516
15537,0.021205,172.217.194.0-255,5738,105433,13,295516
15538,0.021218,172.31.36.0-255,66,105499,13,295516
15539,0.023242,172.217.194.0-255,5738,111237,13,295516
15540,0.023255,172.31.36.0-255,66,111303,13,295516
15541,0.02526,172.217.194.0-255,5738,117041,13,295516
15542,0.025272,172.31.36.0-255,66,117107,13,295516
15543,0.027273,172.217.194.0-255,5738,122845,13,295516
15544,0.027285,172.31.36.0-255,66,122911,13,295516
15545,0.029307,172.217.194.0-255,5738,128649,13,295516
15546,0.029315,172.31.36.0-255,66,128715,13,295516
15547,0.029905,172.31.36.0-255,172,128887,13,295516
15548,0.02994,172.31.36.0-255,1110,129997,13,295516
15549,0.029998,172.31.36.0-255,1514,131511,13,295516
15550,0.030001,172.31.36.0-255,1295,132806,13,295516
15551,0.031284,172.217.194.0-255,5738,138544,13,295516
15552,0.031312,172.31.36.0-255,66,138610,13,295516
15553,0.031415,104.244.42.0-255,66,138676,13,295516
15554,0.031467,104.244.42.0-255,66,138742,13,295516
15555,0.03156,104.244.42.0-255,66,138808,13,295516
15556,0.033313,172.217.194.0-255,5738,144546,13,295516
15557,0.033325,172.31.36.0-255,66,144612,13,295516
15558,0.035355,172.217.194.0-255,5738,150350,13,295516
15559,0.035369,172.31.36.0-255,66,150416,13,295516
15560,0.037411,172.217.194.0-255,5738,156154,13,295516
15561,0.037419,172.31.36.0-255,66,156220,13,295516
15562,0.03942,172.217.194.0-255,5738,161958,13,295516
15563,0.039427,172.31.36.0-255,66,162024,13,295516
15564,0.041422,172.217.194.0-255,5738,167762,13,295516
15565,0.041429,172.31.36.0-255,66,167828,13,295516
15566,0.043424,172.217.194.0-255,5738,173566,13,295516
15567,0.043432,172.31.36.0-255,66,173632,13,295516
15568,0.045453,172.217.194.0-255,5738,179370,13,295516
15569,0.04546,172.31.36.0-255,66,179436,13,295516
15570,0.04749,172.217.194.0-255,5738,185174,13,295516
15571,0.0475,172.31.36.0-255,66,185240,13,295516
15572,0.049512,172.217.194.0-255,5738,190978,13,295516
15573,0.049521,172.31.36.0-255,66,191044,13,295516
15574,0.051506,172.217.194.0-255,5738,196782,13,295516
15575,0.051513,172.31.36.0-255,66,196848,13,295516
15576,0.053515,172.217.194.0-255,5738,202586,13,295516
15577,0.053523,172.31.36.0-255,66,202652,13,295516
15578,0.055536,172.217.194.0-255,5738,208390,13,295516
15579,0.055545,172.31.36.0-255,66,208456,13,295516
15580,0.057543,172.217.194.0-255,5738,214194,13,295516
15581,0.057551,172.31.36.0-255,66,214260,13,295516
15582,0.059546,172.217.194.0-255,5738,219998,13,295516
15583,0.059556,172.31.36.0-255,66,220064,13,295516
15584,0.061551,172.217.194.0-255,5738,225802,13,295516
15585,0.061561,172.31.36.0-255,66,225868,13,295516
15586,0.063555,172.217.194.0-255,5738,231606,13,295516
15587,0.063562,172.31.36.0-255,66,231672,13,295516
15588,0.06556,172.217.194.0-255,5738,237410,13,295516
15589,0.06557,172.31.36.0-255,66,237476,13,295516
15590,0.06758,172.217.194.0-255,5738,243214,13,295516
15591,0.06759,172.31.36.0-255,66,243280,13,295516
15592,0.069626,172.217.194.0-255,5738,249018,13,295516
15593,0.069635,172.31.36.0-255,66,249084,13,295516
15594,0.071635,172.217.194.0-255,5738,254822,13,295516
15595,0.071642,172.31.36.0-255,66,254888,13,295516
15596,0.073688,172.217.194.0-255,5738,260626,13,295516
15597,0.076812,172.31.36.0-255,66,260692,13,295516
15598,0.07889,172.217.194.0-255,5738,266430,13,295516
15599,0.078902,172.31.36.0-255,66,266496,13,295516
15600,0.080914,172.217.194.0-255,5738,272234,13,295516
15601,0.080922,172.31.36.0-255,66,272300,13,295516
15602,0.082929,172.217.194.0-255,5738,278038,13,295516
15603,0.082937,172.31.36.0-255,66,278104,13,295516
15604,0.084949,172.217.194.0-255,5738,283842,13,295516
15605,0.084957,172.31.36.0-255,66,283908,13,295516
15606,0.086934,172.217.194.0-255,5738,289646,13,295516
15607,0.086942,172.31.36.0-255,66,289712,13,295516
15608,0.088949,172.217.194.0-255,5738,295450,13,295516
15609,0.088958,172.31.36.0-255,66,295516,13,295516
15610,0.0,74.125.68.0-255,298,298,13,380938
15611,2.8e-05,172.31.36.0-255,66,364,13,380938
15612,3.4e-05,74.125.68.0-255,1484,1848,13,380938
15613,3.8e-05,172.31.36.0-255,66,1914,13,380938
15614,4.4e-05,74.125.68.0-255,4320,6234,13,380938
15615,4.6e-05,172.31.36.0-255,66,6300,13,380938
15616,9e-05,74.125.68.0-255,5738,12038,13,380938
15617,9.3e-05,172.31.36.0-255,66,12104,13,380938
15618,9.8e-05,74.125.68.0-255,1814,13918,13,380938
15619,9.9e-05,172.31.36.0-255,66,13984,13,380938
15620,0.000104,74.125.68.0-255,2902,16886,13,380938
15621,0.000105,172.31.36.0-255,66,16952,13,380938
15622,0.000148,74.125.68.0-255,7156,24108,13,380938
15623,0.000151,172.31.36.0-255,66,24174,13,380938
15624,0.000156,74.125.68.0-255,2902,27076,13,380938
15625,0.000157,172.31.36.0-255,66,27142,13,380938
15626,0.000168,74.125.68.0-255,3961,31103,13,380938
15627,0.00017,172.31.36.0-255,66,31169,13,380938
15628,0.000246,74.125.68.0-255,1484,32653,13,380938
15629,0.000249,172.31.36.0-255,66,32719,13,380938
15630,0.000253,74.125.68.0-255,1484,34203,13,380938
15631,0.000255,172.31.36.0-255,66,34269,13,380938
15632,0.000281,74.125.68.0-255,1484,35753,13,380938
15633,0.000284,172.31.36.0-255,66,35819,13,380938
15634,0.000291,74.125.68.0-255,5738,41557,13,380938
15635,0.000299,172.31.36.0-255,66,41623,13,380938
15636,0.000306,74.125.68.0-255,6797,48420,13,380938
15637,0.000309,172.31.36.0-255,66,48486,13,380938
15638,0.000744,74.125.68.0-255,1484,49970,13,380938
15639,0.000749,172.31.36.0-255,66,50036,13,380938
15640,0.000757,74.125.68.0-255,1484,51520,13,380938
15641,0.000759,172.31.36.0-255,66,51586,13,380938
15642,0.000763,74.125.68.0-255,2902,54488,13,380938
15643,0.000788,172.31.36.0-255,66,54554,13,380938
15644,0.000796,74.125.68.0-255,5738,60292,13,380938
15645,0.000799,172.31.36.0-255,66,60358,13,380938
15646,0.000803,74.125.68.0-255,2902,63260,13,380938
15647,0.000805,172.31.36.0-255,66,63326,13,380938
15648,0.000834,74.125.68.0-255,2543,65869,13,380938
15649,0.000843,172.31.36.0-255,66,65935,13,380938
15650,0.000847,74.125.68.0-255,412,66347,13,380938
15651,0.00105,172.31.36.0-255,66,66413,13,380938
15652,0.001231,74.125.68.0-255,1484,67897,13,380938
15653,0.00124,74.125.68.0-255,2902,70799,13,380938
15654,0.001244,172.31.36.0-255,66,70865,13,380938
15655,0.00128,74.125.68.0-255,4320,75185,13,380938
15656,0.001283,172.31.36.0-255,66,75251,13,380938
15657,0.001289,74.125.68.0-255,5738,80989,13,380938
15658,0.001291,172.31.36.0-255,66,81055,13,380938
15659,0.001323,74.125.68.0-255,9992,91047,13,380938
15660,0.001325,172.31.36.0-255,66,91113,13,380938
15661,0.001352,74.125.68.0-255,1484,92597,13,380938
15662,0.001379,74.125.68.0-255,8121,100718,13,380938
15663,0.001383,172.31.36.0-255,66,100784,13,380938
15664,0.001579,172.31.36.0-255,101,100885,13,380938
15665,0.001896,74.125.68.0-255,1484,102369,13,380938
15666,0.001906,74.125.68.0-255,2902,105271,13,380938
15667,0.001909,172.31.36.0-255,66,105337,13,380938
15668,0.001942,74.125.68.0-255,4320,109657,13,380938
15669,0.001944,172.31.36.0-255,66,109723,13,380938
15670,0.001974,74.125.68.0-255,8574,118297,13,380938
15671,0.001976,172.31.36.0-255,66,118363,13,380938
15672,0.002002,74.125.68.0-255,2902,121265,13,380938
15673,0.002004,172.31.36.0-255,66,121331,13,380938
15674,0.002033,74.125.68.0-255,7156,128487,13,380938
15675,0.002036,172.31.36.0-255,66,128553,13,380938
15676,0.002039,74.125.68.0-255,1484,130037,13,380938
15677,0.002072,74.125.68.0-255,2902,132939,13,380938
15678,0.002075,172.31.36.0-255,66,133005,13,380938
15679,0.00209,74.125.68.0-255,2184,135189,13,380938
15680,0.002092,172.31.36.0-255,66,135255,13,380938
15681,0.002263,74.125.68.0-255,1484,136739,13,380938
15682,0.002266,74.125.68.0-255,1484,138223,13,380938
15683,0.002271,172.31.36.0-255,66,138289,13,380938
15684,0.002298,74.125.68.0-255,2902,141191,13,380938
15685,0.0023,172.31.36.0-255,66,141257,13,380938
15686,0.002331,74.125.68.0-255,5738,146995,13,380938
15687,0.002334,172.31.36.0-255,66,147061,13,380938
15688,0.002366,74.125.68.0-255,7156,154217,13,380938
15689,0.002369,172.31.36.0-255,66,154283,13,380938
15690,0.002374,74.125.68.0-255,4320,158603,13,380938
15691,0.002375,172.31.36.0-255,66,158669,13,380938
15692,0.002419,74.125.68.0-255,5738,164407,13,380938
15693,0.002421,172.31.36.0-255,66,164473,13,380938
15694,0.002425,74.125.68.0-255,1484,165957,13,380938
15695,0.002428,74.125.68.0-255,1484,167441,13,380938
15696,0.00243,172.31.36.0-255,66,167507,13,380938
15697,0.002453,74.125.68.0-255,1484,168991,13,380938
15698,0.002457,74.125.68.0-255,766,169757,13,380938
15699,0.002458,172.31.36.0-255,66,169823,13,380938
15700,0.002661,74.125.68.0-255,1484,171307,13,380938
15701,0.002679,74.125.68.0-255,1484,172791,13,380938
15702,0.002682,172.31.36.0-255,66,172857,13,380938
15703,0.00271,74.125.68.0-255,2902,175759,13,380938
15704,0.002713,172.31.36.0-255,66,175825,13,380938
15705,0.002745,74.125.68.0-255,5738,181563,13,380938
15706,0.002747,172.31.36.0-255,66,181629,13,380938
15707,0.002751,74.125.68.0-255,1484,183113,13,380938
15708,0.002777,74.125.68.0-255,5738,188851,13,380938
15709,0.00278,172.31.36.0-255,66,188917,13,380938
15710,0.002784,74.125.68.0-255,2902,191819,13,380938
15711,0.002786,172.31.36.0-255,66,191885,13,380938
15712,0.002807,74.125.68.0-255,4320,196205,13,380938
15713,0.002811,172.31.36.0-255,66,196271,13,380938
15714,0.002846,74.125.68.0-255,7156,203427,13,380938
15715,0.00285,172.31.36.0-255,66,203493,13,380938
15716,0.002876,74.125.68.0-255,1484,204977,13,380938
15717,0.002893,74.125.68.0-255,3602,208579,13,380938
15718,0.002895,172.31.36.0-255,66,208645,13,380938
15719,0.002898,74.125.68.0-255,1484,210129,13,380938
15720,0.002922,74.125.68.0-255,4320,214449,13,380938
15721,0.002924,172.31.36.0-255,66,214515,13,380938
15722,0.002955,74.125.68.0-255,2902,217417,13,380938
15723,0.002957,172.31.36.0-255,66,217483,13,380938
15724,0.00299,74.125.68.0-255,2902,220385,13,380938
15725,0.002993,172.31.36.0-255,66,220451,13,380938
15726,0.002999,74.125.68.0-255,7156,227607,13,380938
15727,0.003001,172.31.36.0-255,66,227673,13,380938
15728,0.003009,74.125.68.0-255,2902,230575,13,380938
15729,0.003011,172.31.36.0-255,66,230641,13,380938
15730,0.003016,74.125.68.0-255,4320,234961,13,380938
15731,0.003018,172.31.36.0-255,66,235027,13,380938
15732,0.003045,74.125.68.0-255,3602,238629,13,380938
15733,0.003052,172.31.36.0-255,66,238695,13,380938
15734,0.003409,74.125.68.0-255,1484,240179,13,380938
15735,0.003441,74.125.68.0-255,2902,243081,13,380938
15736,0.003444,172.31.36.0-255,66,243147,13,380938
15737,0.003451,74.125.68.0-255,5738,248885,13,380938
15738,0.003452,172.31.36.0-255,66,248951,13,380938
15739,0.003468,74.125.68.0-255,4320,253271,13,380938
15740,0.003471,172.31.36.0-255,66,253337,13,380938
15741,0.003476,74.125.68.0-255,4320,257657,13,380938
15742,0.003478,172.31.36.0-255,66,257723,13,380938
15743,0.003504,74.125.68.0-255,1484,259207,13,380938
15744,0.00351,74.125.68.0-255,5738,264945,13,380938
15745,0.003512,172.31.36.0-255,66,265011,13,380938
15746,0.003535,74.125.68.0-255,2902,267913,13,380938
15747,0.003537,172.31.36.0-255,66,267979,13,380938
15748,0.003574,74.125.68.0-255,5020,272999,13,380938
15749,0.003576,172.31.36.0-255,66,273065,13,380938
15750,0.003658,74.125.68.0-255,1484,274549,13,380938
15751,0.00368,74.125.68.0-255,2902,277451,13,380938
15752,0.003683,172.31.36.0-255,66,277517,13,380938
15753,0.003724,74.125.68.0-255,5738,283255,13,380938
15754,0.003726,172.31.36.0-255,66,283321,13,380938
15755,0.003731,74.125.68.0-255,2902,286223,13,380938
15756,0.003733,172.31.36.0-255,66,286289,13,380938
15757,0.00376,74.125.68.0-255,2902,289191,13,380938
15758,0.003764,172.31.36.0-255,66,289257,13,380938
15759,0.003768,74.125.68.0-255,2902,292159,13,380938
15760,0.00377,172.31.36.0-255,66,292225,13,380938
15761,0.003798,74.125.68.0-255,4320,296545,13,380938
15762,0.003801,172.31.36.0-255,66,296611,13,380938
15763,0.003808,74.125.68.0-255,8574,305185,13,380938
15764,0.003811,172.31.36.0-255,66,305251,13,380938
15765,0.003831,74.125.68.0-255,1484,306735,13,380938
15766,0.00386,74.125.68.0-255,5020,311755,13,380938
15767,0.003863,172.31.36.0-255,66,311821,13,380938
15768,0.003869,74.125.68.0-255,7156,318977,13,380938
15769,0.003872,172.31.36.0-255,66,319043,13,380938
15770,0.003874,74.125.68.0-255,1484,320527,13,380938
15771,0.003916,172.31.36.0-255,66,320593,13,380938
15772,0.003943,74.125.68.0-255,1484,322077,13,380938
15773,0.003961,74.125.68.0-255,7856,329933,13,380938
15774,0.003965,172.31.36.0-255,66,329999,13,380938
15775,0.003968,74.125.68.0-255,66,330065,13,380938
15776,0.003999,74.125.68.0-255,8574,338639,13,380938
15777,0.004001,172.31.36.0-255,66,338705,13,380938
15778,0.00402,74.125.68.0-255,1484,340189,13,380938
15779,0.004036,74.125.68.0-255,2902,343091,13,380938
15780,0.004039,172.31.36.0-255,66,343157,13,380938
15781,0.004069,74.125.68.0-255,8574,351731,13,380938
15782,0.004072,172.31.36.0-255,66,351797,13,380938
15783,0.004078,74.125.68.0-255,5738,357535,13,380938
15784,0.004081,172.31.36.0-255,66,357601,13,380938
15785,0.004099,74.125.68.0-255,2902,360503,13,380938
15786,0.004101,172.31.36.0-255,66,360569,13,380938
15787,0.004111,74.125.68.0-255,3602,364171,13,380938
15788,0.004113,172.31.36.0-255,66,364237,13,380938
15789,0.004118,74.125.68.0-255,4320,368557,13,380938
15790,0.004121,172.31.36.0-255,66,368623,13,380938
15791,0.004151,74.125.68.0-255,2902,371525,13,380938
15792,0.004154,172.31.36.0-255,66,371591,13,380938
15793,0.00418,74.125.68.0-255,2902,374493,13,380938
15794,0.004183,172.31.36.0-255,66,374559,13,380938
15795,0.004187,74.125.68.0-255,1748,376307,13,380938
15796,0.004189,172.31.36.0-255,66,376373,13,380938
15797,0.004237,74.125.68.0-255,105,376478,13,380938
15798,0.013425,172.31.36.0-255,105,376583,13,380938
15799,0.020369,74.125.68.0-255,66,376649,13,380938
15800,0.030563,172.31.36.0-255,172,376821,13,380938
15801,0.030618,172.31.36.0-255,1106,377927,13,380938
15802,0.030695,172.31.36.0-255,1514,379441,13,380938
15803,0.030697,172.31.36.0-255,1299,380740,13,380938
15804,0.032109,104.244.42.0-255,66,380806,13,380938
15805,0.032148,104.244.42.0-255,66,380872,13,380938
15806,0.032242,104.244.42.0-255,66,380938,13,380938
15807,0.0,172.217.194.0-255,226,226,13,105062
15808,2.9e-05,172.217.194.0-255,1484,1710,13,105062
15809,3.6e-05,172.31.36.0-255,66,1776,13,105062
15810,7.7e-05,172.217.194.0-255,4320,6096,13,105062
15811,8.1e-05,172.31.36.0-255,66,6162,13,105062
15812,0.000243,172.217.194.0-255,5738,11900,13,105062
15813,0.000248,172.31.36.0-255,66,11966,13,105062
15814,0.000501,172.217.194.0-255,8574,20540,13,105062
15815,0.000507,172.31.36.0-255,66,20606,13,105062
15816,0.000539,172.217.194.0-255,3457,24063,13,105062
15817,0.001026,172.217.194.0-255,6797,30860,13,105062
15818,0.001328,172.217.194.0-255,8574,39434,13,105062
15819,0.00227,172.217.194.0-255,9992,49426,13,105062
15820,0.002775,172.217.194.0-255,9992,59418,13,105062
15821,0.003416,172.31.36.0-255,66,59484,13,105062
15822,0.003923,172.31.36.0-255,66,59550,13,105062
15823,0.005783,172.217.194.0-255,4320,63870,13,105062
15824,0.005839,172.217.194.0-255,1696,65566,13,105062
15825,0.006254,172.217.194.0-255,6944,72510,13,105062
15826,0.006361,172.217.194.0-255,5738,78248,13,105062
15827,0.007466,172.31.36.0-255,66,78314,13,105062
15828,0.009792,172.31.36.0-255,66,78380,13,105062
15829,0.009857,172.217.194.0-255,4320,82700,13,105062
15830,0.00986,172.31.36.0-255,66,82766,13,105062
15831,0.009902,172.31.36.0-255,66,82832,13,105062
15832,0.010367,172.31.36.0-255,66,82898,13,105062
15833,0.010439,172.31.36.0-255,66,82964,13,105062
15834,0.010871,172.217.194.0-255,7156,90120,13,105062
15835,0.010876,172.31.36.0-255,66,90186,13,105062
15836,0.010909,172.217.194.0-255,5046,95232,13,105062
15837,0.010912,172.31.36.0-255,66,95298,13,105062
15838,0.012111,172.31.36.0-255,66,95364,13,105062
15839,0.012158,172.31.36.0-255,66,95430,13,105062
15840,0.012336,172.31.36.0-255,66,95496,13,105062
15841,0.012384,172.31.36.0-255,66,95562,13,105062
15842,0.01287,172.31.36.0-255,66,95628,13,105062
15843,0.013698,172.31.36.0-255,105,95733,13,105062
15844,0.015916,172.217.194.0-255,66,95799,13,105062
15845,0.038283,172.31.36.0-255,172,95971,13,105062
15846,0.038312,172.31.36.0-255,1109,97080,13,105062
15847,0.038371,172.31.36.0-255,1514,98594,13,105062
15848,0.038373,172.31.36.0-255,1514,100108,13,105062
15849,0.038378,172.31.36.0-255,1514,101622,13,105062
15850,0.038379,172.31.36.0-255,1514,103136,13,105062
15851,0.038401,172.31.36.0-255,1514,104650,13,105062
15852,0.038402,172.31.36.0-255,82,104732,13,105062
15853,0.039817,104.244.42.0-255,66,104798,13,105062
15854,0.039827,104.244.42.0-255,66,104864,13,105062
15855,0.039928,104.244.42.0-255,66,104930,13,105062
15856,0.039933,104.244.42.0-255,66,104996,13,105062
15857,0.039936,104.244.42.0-255,66,105062,13,105062
15858,0.0,172.217.194.0-255,153,153,13,253880
15859,3.1e-05,172.217.194.0-255,1484,1637,13,253880
15860,4.3e-05,172.31.36.0-255,66,1703,13,253880
15861,5.2e-05,172.217.194.0-255,2902,4605,13,253880
15862,5.9e-05,172.217.194.0-255,5738,10343,13,253880
15863,7.8e-05,172.217.194.0-255,10546,20889,13,253880
15864,8.7e-05,172.217.194.0-255,9633,30522,13,253880
15865,0.000119,172.217.194.0-255,5738,36260,13,253880
15866,0.000141,172.217.194.0-255,4320,40580,13,253880
15867,0.000144,172.217.194.0-255,1484,42064,13,253880
15868,0.000182,172.217.194.0-255,5379,47443,13,253880
15869,0.000206,172.217.194.0-255,5738,53181,13,253880
15870,0.000242,172.217.194.0-255,7156,60337,13,253880
15871,0.000259,172.217.194.0-255,3961,64298,13,253880
15872,0.000328,172.217.194.0-255,646,64944,13,253880
15873,0.000662,172.217.194.0-255,1484,66428,13,253880
15874,0.000669,172.217.194.0-255,2902,69330,13,253880
15875,0.000673,172.217.194.0-255,2902,72232,13,253880
15876,0.000688,172.31.36.0-255,66,72298,13,253880
15877,0.000698,172.217.194.0-255,2902,75200,13,253880
15878,0.000705,172.217.194.0-255,7156,82356,13,253880
15879,0.000713,172.217.194.0-255,2902,85258,13,253880
15880,0.000722,172.31.36.0-255,66,85324,13,253880
15881,0.000745,172.217.194.0-255,2184,87508,13,253880
15882,0.000876,172.217.194.0-255,1484,88992,13,253880
15883,0.000882,172.217.194.0-255,2902,91894,13,253880
15884,0.000887,172.217.194.0-255,2902,94796,13,253880
15885,0.000898,172.217.194.0-255,2902,97698,13,253880
15886,0.000915,172.217.194.0-255,5738,103436,13,253880
15887,0.000931,172.217.194.0-255,7156,110592,13,253880
15888,0.000949,172.217.194.0-255,7156,117748,13,253880
15889,0.000963,172.217.194.0-255,3602,121350,13,253880
15890,0.001004,172.217.194.0-255,9992,131342,13,253880
15891,0.001028,172.217.194.0-255,1484,132826,13,253880
15892,0.001061,172.217.194.0-255,2902,135728,13,253880
15893,0.001079,172.217.194.0-255,6438,142166,13,253880
15894,0.001091,172.31.36.0-255,66,142232,13,253880
15895,0.001147,172.217.194.0-255,5738,147970,13,253880
15896,0.001154,172.31.36.0-255,66,148036,13,253880
15897,0.001183,172.217.194.0-255,4320,152356,13,253880
15898,0.001255,172.217.194.0-255,5020,157376,13,253880
15899,0.001265,172.31.36.0-255,66,157442,13,253880
15900,0.001517,172.217.194.0-255,1484,158926,13,253880
15901,0.001524,172.217.194.0-255,2902,161828,13,253880
15902,0.001527,172.217.194.0-255,1484,163312,13,253880
15903,0.001539,172.217.194.0-255,4320,167632,13,253880
15904,0.001544,172.31.36.0-255,66,167698,13,253880
15905,0.001549,172.31.36.0-255,66,167764,13,253880
15906,0.001633,172.217.194.0-255,9992,177756,13,253880
15907,0.001645,172.217.194.0-255,2184,179940,13,253880
15908,0.001649,172.31.36.0-255,66,180006,13,253880
15909,0.001656,172.31.36.0-255,66,180072,13,253880
15910,0.001663,172.217.194.0-255,1484,181556,13,253880
15911,0.001672,172.217.194.0-255,2902,184458,13,253880
15912,0.001676,172.217.194.0-255,1484,185942,13,253880
15913,0.001704,172.217.194.0-255,4320,190262,13,253880
15914,0.001734,172.31.36.0-255,66,190328,13,253880
15915,0.001766,172.31.36.0-255,66,190394,13,253880
15916,0.001777,172.217.194.0-255,1484,191878,13,253880
15917,0.001787,172.217.194.0-255,2902,194780,13,253880
15918,0.001809,172.217.194.0-255,5738,200518,13,253880
15919,0.001815,172.217.194.0-255,2902,203420,13,253880
15920,0.001839,172.31.36.0-255,66,203486,13,253880
15921,0.001846,172.217.194.0-255,4320,207806,13,253880
15922,0.001895,172.217.194.0-255,9992,217798,13,253880
15923,0.001903,172.217.194.0-255,6438,224236,13,253880
15924,0.001906,172.31.36.0-255,66,224302,13,253880
15925,0.001966,172.217.194.0-255,10692,234994,13,253880
15926,0.002029,172.217.194.0-255,9346,244340,13,253880
15927,0.002033,172.217.194.0-255,105,244445,13,253880
15928,0.002049,172.31.36.0-255,66,244511,13,253880
15929,0.00901,172.31.36.0-255,105,244616,13,253880
15930,0.011563,172.217.194.0-255,66,244682,13,253880
15931,0.038185,172.31.36.0-255,172,244854,13,253880
15932,0.03822,172.31.36.0-255,1109,245963,13,253880
15933,0.038285,172.31.36.0-255,1514,247477,13,253880
15934,0.038287,172.31.36.0-255,1514,248991,13,253880
15935,0.038293,172.31.36.0-255,1514,250505,13,253880
15936,0.038295,172.31.36.0-255,1514,252019,13,253880
15937,0.038314,172.31.36.0-255,1514,253533,13,253880
15938,0.038315,172.31.36.0-255,83,253616,13,253880
15939,0.039726,104.244.42.0-255,66,253682,13,253880
15940,0.039762,104.244.42.0-255,66,253748,13,253880
15941,0.039864,104.244.42.0-255,66,253814,13,253880
15942,0.039893,104.244.42.0-255,66,253880,13,253880
15943,0.0,172.217.194.0-255,156,156,13,354583
15944,2.3e-05,172.31.36.0-255,66,222,13,354583
15945,3e-05,172.217.194.0-255,1484,1706,13,354583
15946,3.4e-05,172.31.36.0-255,66,1772,13,354583
15947,4.9e-05,172.217.194.0-255,2902,4674,13,354583
15948,5.3e-05,172.31.36.0-255,66,4740,13,354583
15949,6.1e-05,172.217.194.0-255,7156,11896,13,354583
15950,6.5e-05,172.31.36.0-255,66,11962,13,354583
15951,6.9e-05,172.217.194.0-255,2046,14008,13,354583
15952,7.2e-05,172.31.36.0-255,66,14074,13,354583
15953,0.000133,172.217.194.0-255,1484,15558,13,354583
15954,0.000136,172.31.36.0-255,66,15624,13,354583
15955,0.000141,172.217.194.0-255,2902,18526,13,354583
15956,0.000144,172.31.36.0-255,66,18592,13,354583
15957,0.00015,172.217.194.0-255,4320,22912,13,354583
15958,0.000157,172.31.36.0-255,66,22978,13,354583
15959,0.000189,172.217.194.0-255,1484,24462,13,354583
15960,0.000192,172.31.36.0-255,66,24528,13,354583
15961,0.000201,172.217.194.0-255,8215,32743,13,354583
15962,0.000209,172.31.36.0-255,66,32809,13,354583
15963,0.000218,172.217.194.0-255,8574,41383,13,354583
15964,0.00022,172.31.36.0-255,66,41449,13,354583
15965,0.000258,172.217.194.0-255,6797,48246,13,354583
15966,0.000261,172.31.36.0-255,66,48312,13,354583
15967,0.000287,172.217.194.0-255,1484,49796,13,354583
15968,0.000289,172.31.36.0-255,66,49862,13,354583
15969,0.000294,172.217.194.0-255,2902,52764,13,354583
15970,0.000296,172.31.36.0-255,66,52830,13,354583
15971,0.000303,172.217.194.0-255,5738,58568,13,354583
15972,0.00031,172.31.36.0-255,66,58634,13,354583
15973,0.000342,172.217.194.0-255,6797,65431,13,354583
15974,0.000344,172.31.36.0-255,66,65497,13,354583
15975,0.000367,172.217.194.0-255,366,65863,13,354583
15976,0.000419,172.217.194.0-255,377,66240,13,354583
15977,0.000838,172.217.194.0-255,1484,67724,13,354583
15978,0.000844,172.31.36.0-255,66,67790,13,354583
15979,0.000851,172.217.194.0-255,2902,70692,13,354583
15980,0.000853,172.31.36.0-255,66,70758,13,354583
15981,0.000872,172.217.194.0-255,4320,75078,13,354583
15982,0.000875,172.31.36.0-255,66,75144,13,354583
15983,0.000886,172.217.194.0-255,1484,76628,13,354583
15984,0.000905,172.31.36.0-255,66,76694,13,354583
15985,0.000916,172.217.194.0-255,10692,87386,13,354583
15986,0.000919,172.31.36.0-255,66,87452,13,354583
15987,0.001682,172.217.194.0-255,1484,88936,13,354583
15988,0.001693,172.217.194.0-255,2902,91838,13,354583
15989,0.001698,172.31.36.0-255,66,91904,13,354583
15990,0.001706,172.217.194.0-255,5738,97642,13,354583
15991,0.001708,172.31.36.0-255,66,97708,13,354583
15992,0.001718,172.217.194.0-255,4320,102028,13,354583
15993,0.001721,172.31.36.0-255,66,102094,13,354583
15994,0.001727,172.217.194.0-255,4320,106414,13,354583
15995,0.00173,172.31.36.0-255,66,106480,13,354583
15996,0.001763,172.217.194.0-255,7156,113636,13,354583
15997,0.00177,172.31.36.0-255,66,113702,13,354583
15998,0.00178,172.217.194.0-255,7856,121558,13,354583
15999,0.001782,172.31.36.0-255,66,121624,13,354583
16000,0.002311,172.217.194.0-255,1484,123108,13,354583
16001,0.002331,172.217.194.0-255,1484,124592,13,354583
16002,0.002336,172.31.36.0-255,66,124658,13,354583
16003,0.004052,172.217.194.0-255,2902,127560,13,354583
16004,0.004059,172.31.36.0-255,66,127626,13,354583
16005,0.004614,172.217.194.0-255,2902,130528,13,354583
16006,0.004616,172.31.36.0-255,66,130594,13,354583
16007,0.006348,172.217.194.0-255,2902,133496,13,354583
16008,0.006356,172.31.36.0-255,66,133562,13,354583
16009,0.006895,172.217.194.0-255,2902,136464,13,354583
16010,0.006901,172.31.36.0-255,66,136530,13,354583
16011,0.008628,172.217.194.0-255,2902,139432,13,354583
16012,0.008634,172.31.36.0-255,66,139498,13,354583
16013,0.009186,172.217.194.0-255,2902,142400,13,354583
16014,0.009193,172.31.36.0-255,66,142466,13,354583
16015,0.010904,172.217.194.0-255,2902,145368,13,354583
16016,0.010913,172.31.36.0-255,66,145434,13,354583
16017,0.011477,172.217.194.0-255,2902,148336,13,354583
16018,0.011484,172.31.36.0-255,66,148402,13,354583
16019,0.013173,172.217.194.0-255,2902,151304,13,354583
16020,0.013181,172.31.36.0-255,66,151370,13,354583
16021,0.013769,172.217.194.0-255,2902,154272,13,354583
16022,0.013776,172.31.36.0-255,66,154338,13,354583
16023,0.015433,172.217.194.0-255,2902,157240,13,354583
16024,0.015441,172.31.36.0-255,66,157306,13,354583
16025,0.016061,172.217.194.0-255,2902,160208,13,354583
16026,0.016068,172.31.36.0-255,66,160274,13,354583
16027,0.017732,172.217.194.0-255,2902,163176,13,354583
16028,0.01774,172.31.36.0-255,66,163242,13,354583
16029,0.018321,172.217.194.0-255,2902,166144,13,354583
16030,0.018327,172.31.36.0-255,66,166210,13,354583
16031,0.020035,172.217.194.0-255,2902,169112,13,354583
16032,0.020043,172.31.36.0-255,66,169178,13,354583
16033,0.020601,172.217.194.0-255,2902,172080,13,354583
16034,0.020608,172.31.36.0-255,66,172146,13,354583
16035,0.022332,172.217.194.0-255,2902,175048,13,354583
16036,0.022341,172.31.36.0-255,66,175114,13,354583
16037,0.022869,172.217.194.0-255,2902,178016,13,354583
16038,0.022876,172.31.36.0-255,66,178082,13,354583
16039,0.024654,172.217.194.0-255,2902,180984,13,354583
16040,0.024665,172.31.36.0-255,66,181050,13,354583
16041,0.025139,172.217.194.0-255,2902,183952,13,354583
16042,0.025145,172.31.36.0-255,66,184018,13,354583
16043,0.026963,172.217.194.0-255,2902,186920,13,354583
16044,0.026974,172.31.36.0-255,66,186986,13,354583
16045,0.027436,172.217.194.0-255,2902,189888,13,354583
16046,0.027443,172.31.36.0-255,66,189954,13,354583
16047,0.029269,172.217.194.0-255,2902,192856,13,354583
16048,0.029277,172.31.36.0-255,66,192922,13,354583
16049,0.029707,172.217.194.0-255,2902,195824,13,354583
16050,0.029715,172.31.36.0-255,66,195890,13,354583
16051,0.03157,172.217.194.0-255,2902,198792,13,354583
16052,0.031578,172.31.36.0-255,66,198858,13,354583
16053,0.031969,172.217.194.0-255,2902,201760,13,354583
16054,0.031976,172.31.36.0-255,66,201826,13,354583
16055,0.033859,172.217.194.0-255,2902,204728,13,354583
16056,0.033866,172.31.36.0-255,66,204794,13,354583
16057,0.034115,172.31.36.0-255,172,204966,13,354583
16058,0.034145,172.31.36.0-255,1106,206072,13,354583
16059,0.034205,172.31.36.0-255,1514,207586,13,354583
16060,0.034207,172.31.36.0-255,1301,208887,13,354583
16061,0.034263,172.217.194.0-255,2902,211789,13,354583
16062,0.03427,172.31.36.0-255,66,211855,13,354583
16063,0.035643,104.244.42.0-255,66,211921,13,354583
16064,0.035814,104.244.42.0-255,66,211987,13,354583
16065,0.03582,104.244.42.0-255,66,212053,13,354583
16066,0.036148,172.217.194.0-255,2902,214955,13,354583
16067,0.036155,172.31.36.0-255,66,215021,13,354583
16068,0.036554,172.217.194.0-255,2902,217923,13,354583
16069,0.036561,172.31.36.0-255,66,217989,13,354583
16070,0.038438,172.217.194.0-255,2902,220891,13,354583
16071,0.038444,172.31.36.0-255,66,220957,13,354583
16072,0.038846,172.217.194.0-255,2902,223859,13,354583
16073,0.038853,172.31.36.0-255,66,223925,13,354583
16074,0.040745,172.217.194.0-255,2902,226827,13,354583
16075,0.040755,172.31.36.0-255,66,226893,13,354583
16076,0.041146,172.217.194.0-255,2902,229795,13,354583
16077,0.041153,172.31.36.0-255,66,229861,13,354583
16078,0.043044,172.217.194.0-255,2902,232763,13,354583
16079,0.04305,172.31.36.0-255,66,232829,13,354583
16080,0.04345,172.217.194.0-255,2902,235731,13,354583
16081,0.043456,172.31.36.0-255,66,235797,13,354583
16082,0.045338,172.217.194.0-255,2902,238699,13,354583
16083,0.045345,172.31.36.0-255,66,238765,13,354583
16084,0.045739,172.217.194.0-255,2902,241667,13,354583
16085,0.045745,172.31.36.0-255,66,241733,13,354583
16086,0.047632,172.217.194.0-255,2902,244635,13,354583
16087,0.047638,172.31.36.0-255,66,244701,13,354583
16088,0.04803,172.217.194.0-255,2902,247603,13,354583
16089,0.048036,172.31.36.0-255,66,247669,13,354583
16090,0.049921,172.217.194.0-255,2902,250571,13,354583
16091,0.049929,172.31.36.0-255,66,250637,13,354583
16092,0.050299,172.217.194.0-255,2902,253539,13,354583
16093,0.050306,172.31.36.0-255,66,253605,13,354583
16094,0.05222,172.217.194.0-255,2902,256507,13,354583
16095,0.052227,172.31.36.0-255,66,256573,13,354583
16096,0.052572,172.217.194.0-255,2902,259475,13,354583
16097,0.052579,172.31.36.0-255,66,259541,13,354583
16098,0.054524,172.217.194.0-255,2902,262443,13,354583
16099,0.054531,172.31.36.0-255,66,262509,13,354583
16100,0.054876,172.217.194.0-255,2902,265411,13,354583
16101,0.054883,172.31.36.0-255,66,265477,13,354583
16102,0.056833,172.217.194.0-255,2902,268379,13,354583
16103,0.05684,172.31.36.0-255,66,268445,13,354583
16104,0.057161,172.217.194.0-255,2902,271347,13,354583
16105,0.057167,172.31.36.0-255,66,271413,13,354583
16106,0.059125,172.217.194.0-255,2902,274315,13,354583
16107,0.059131,172.31.36.0-255,66,274381,13,354583
16108,0.05943,172.217.194.0-255,2902,277283,13,354583
16109,0.059436,172.31.36.0-255,66,277349,13,354583
16110,0.061421,172.217.194.0-255,2902,280251,13,354583
16111,0.061428,172.31.36.0-255,66,280317,13,354583
16112,0.061716,172.217.194.0-255,2902,283219,13,354583
16113,0.061722,172.31.36.0-255,66,283285,13,354583
16114,0.06373,172.217.194.0-255,2902,286187,13,354583
16115,0.063738,172.31.36.0-255,66,286253,13,354583
16116,0.063987,172.217.194.0-255,2902,289155,13,354583
16117,0.063994,172.31.36.0-255,66,289221,13,354583
16118,0.066045,172.217.194.0-255,2902,292123,13,354583
16119,0.066052,172.31.36.0-255,66,292189,13,354583
16120,0.066289,172.217.194.0-255,2902,295091,13,354583
16121,0.066296,172.31.36.0-255,66,295157,13,354583
16122,0.068336,172.217.194.0-255,2902,298059,13,354583
16123,0.068343,172.31.36.0-255,66,298125,13,354583
16124,0.068565,172.217.194.0-255,2902,301027,13,354583
16125,0.068571,172.31.36.0-255,66,301093,13,354583
16126,0.070646,172.217.194.0-255,2902,303995,13,354583
16127,0.070653,172.31.36.0-255,66,304061,13,354583
16128,0.070849,172.217.194.0-255,2902,306963,13,354583
16129,0.070855,172.31.36.0-255,66,307029,13,354583
16130,0.072953,172.217.194.0-255,2902,309931,13,354583
16131,0.072961,172.31.36.0-255,66,309997,13,354583
16132,0.073144,172.217.194.0-255,2902,312899,13,354583
16133,0.07315,172.31.36.0-255,66,312965,13,354583
16134,0.075241,172.217.194.0-255,2902,315867,13,354583
16135,0.075248,172.31.36.0-255,66,315933,13,354583
16136,0.075432,172.217.194.0-255,2902,318835,13,354583
16137,0.075436,172.31.36.0-255,66,318901,13,354583
16138,0.077542,172.217.194.0-255,2902,321803,13,354583
16139,0.077549,172.31.36.0-255,66,321869,13,354583
16140,0.077696,172.217.194.0-255,2902,324771,13,354583
16141,0.077702,172.31.36.0-255,66,324837,13,354583
16142,0.079852,172.217.194.0-255,2902,327739,13,354583
16143,0.079858,172.31.36.0-255,66,327805,13,354583
16144,0.079985,172.217.194.0-255,2902,330707,13,354583
16145,0.07999,172.31.36.0-255,66,330773,13,354583
16146,0.082145,172.217.194.0-255,2902,333675,13,354583
16147,0.082152,172.31.36.0-255,66,333741,13,354583
16148,0.082261,172.217.194.0-255,1484,335225,13,354583
16149,0.082275,172.217.194.0-255,1484,336709,13,354583
16150,0.082279,172.31.36.0-255,66,336775,13,354583
16151,0.084463,172.217.194.0-255,2902,339677,13,354583
16152,0.08447,172.31.36.0-255,66,339743,13,354583
16153,0.084562,172.217.194.0-255,2902,342645,13,354583
16154,0.084567,172.31.36.0-255,66,342711,13,354583
16155,0.086752,172.217.194.0-255,2902,345613,13,354583
16156,0.086758,172.31.36.0-255,66,345679,13,354583
16157,0.086824,172.217.194.0-255,2902,348581,13,354583
16158,0.086828,172.31.36.0-255,66,348647,13,354583
16159,0.089049,172.217.194.0-255,2902,351549,13,354583
16160,0.089056,172.31.36.0-255,66,351615,13,354583
16161,0.089085,172.217.194.0-255,2902,354517,13,354583
16162,0.089088,172.31.36.0-255,66,354583,13,354583
16163,0.0,216.58.221.0-255,66,66,13,66
16164,0.0,74.125.24.0-255,293,293,13,280531
16165,2.6e-05,172.31.36.0-255,66,359,13,280531
16166,3.2e-05,74.125.24.0-255,1484,1843,13,280531
16167,3.5e-05,172.31.36.0-255,66,1909,13,280531
16168,4e-05,74.125.24.0-255,2902,4811,13,280531
16169,4.9e-05,172.31.36.0-255,66,4877,13,280531
16170,7.9e-05,74.125.24.0-255,5738,10615,13,280531
16171,8.3e-05,172.31.36.0-255,66,10681,13,280531
16172,8.9e-05,74.125.24.0-255,3504,14185,13,280531
16173,9.2e-05,172.31.36.0-255,66,14251,13,280531
16174,0.000117,74.125.24.0-255,4320,18571,13,280531
16175,0.00012,172.31.36.0-255,66,18637,13,280531
16176,0.000123,74.125.24.0-255,1484,20121,13,280531
16177,0.000125,172.31.36.0-255,66,20187,13,280531
16178,0.00016,74.125.24.0-255,8574,28761,13,280531
16179,0.000165,172.31.36.0-255,66,28827,13,280531
16180,0.000169,74.125.24.0-255,2543,31370,13,280531
16181,0.000171,172.31.36.0-255,66,31436,13,280531
16182,0.000398,74.125.24.0-255,1484,32920,13,280531
16183,0.000405,172.31.36.0-255,66,32986,13,280531
16184,0.000411,74.125.24.0-255,2902,35888,13,280531
16185,0.000414,172.31.36.0-255,66,35954,13,280531
16186,0.000417,74.125.24.0-255,1484,37438,13,280531
16187,0.000426,172.31.36.0-255,66,37504,13,280531
16188,0.000464,74.125.24.0-255,4320,41824,13,280531
16189,0.000469,172.31.36.0-255,66,41890,13,280531
16190,0.000484,172.31.36.0-255,66,41956,13,280531
16191,0.000487,74.125.24.0-255,1484,43440,13,280531
16192,0.000489,172.31.36.0-255,66,43506,13,280531
16193,0.000526,74.125.24.0-255,8215,51721,13,280531
16194,0.000532,172.31.36.0-255,66,51787,13,280531
16195,0.001068,74.125.24.0-255,647,52434,13,280531
16196,0.001136,172.31.36.0-255,66,52500,13,280531
16197,0.001167,74.125.24.0-255,1484,53984,13,280531
16198,0.001174,74.125.24.0-255,2902,56886,13,280531
16199,0.001178,172.31.36.0-255,66,56952,13,280531
16200,0.001184,74.125.24.0-255,4320,61272,13,280531
16201,0.001185,172.31.36.0-255,66,61338,13,280531
16202,0.001221,74.125.24.0-255,1484,62822,13,280531
16203,0.001229,74.125.24.0-255,6797,69619,13,280531
16204,0.001234,74.125.24.0-255,4320,73939,13,280531
16205,0.001234,172.31.36.0-255,66,74005,13,280531
16206,0.001238,172.31.36.0-255,66,74071,13,280531
16207,0.001272,74.125.24.0-255,9992,84063,13,280531
16208,0.001276,172.31.36.0-255,66,84129,13,280531
16209,0.00128,74.125.24.0-255,2543,86672,13,280531
16210,0.001282,172.31.36.0-255,66,86738,13,280531
16211,0.001553,74.125.24.0-255,1484,88222,13,280531
16212,0.001572,74.125.24.0-255,2902,91124,13,280531
16213,0.001577,172.31.36.0-255,66,91190,13,280531
16214,0.001581,74.125.24.0-255,1484,92674,13,280531
16215,0.00161,74.125.24.0-255,4320,96994,13,280531
16216,0.001613,172.31.36.0-255,66,97060,13,280531
16217,0.001633,172.31.36.0-255,66,97126,13,280531
16218,0.001636,74.125.24.0-255,1484,98610,13,280531
16219,0.00166,74.125.24.0-255,2902,101512,13,280531
16220,0.001663,172.31.36.0-255,66,101578,13,280531
16221,0.001686,74.125.24.0-255,6438,108016,13,280531
16222,0.00169,172.31.36.0-255,66,108082,13,280531
16223,0.002029,74.125.24.0-255,1484,109566,13,280531
16224,0.002036,74.125.24.0-255,2902,112468,13,280531
16225,0.002039,172.31.36.0-255,66,112534,13,280531
16226,0.002043,74.125.24.0-255,1484,114018,13,280531
16227,0.002066,74.125.24.0-255,4320,118338,13,280531
16228,0.002068,172.31.36.0-255,66,118404,13,280531
16229,0.002073,74.125.24.0-255,5738,124142,13,280531
16230,0.002075,172.31.36.0-255,66,124208,13,280531
16231,0.002104,74.125.24.0-255,8574,132782,13,280531
16232,0.002106,172.31.36.0-255,66,132848,13,280531
16233,0.00213,74.125.24.0-255,4320,137168,13,280531
16234,0.002132,172.31.36.0-255,66,137234,13,280531
16235,0.002137,74.125.24.0-255,5020,142254,13,280531
16236,0.002138,172.31.36.0-255,66,142320,13,280531
16237,0.002151,74.125.24.0-255,1484,143804,13,280531
16238,0.002169,74.125.24.0-255,4320,148124,13,280531
16239,0.002172,172.31.36.0-255,66,148190,13,280531
16240,0.002178,74.125.24.0-255,8574,156764,13,280531
16241,0.00218,172.31.36.0-255,66,156830,13,280531
16242,0.002218,74.125.24.0-255,4320,161150,13,280531
16243,0.00222,172.31.36.0-255,66,161216,13,280531
16244,0.002232,172.31.36.0-255,66,161282,13,280531
16245,0.002238,74.125.24.0-255,766,162048,13,280531
16246,0.002241,74.125.24.0-255,1484,163532,13,280531
16247,0.002242,172.31.36.0-255,66,163598,13,280531
16248,0.002247,74.125.24.0-255,4320,167918,13,280531
16249,0.002249,172.31.36.0-255,66,167984,13,280531
16250,0.00226,74.125.24.0-255,2902,170886,13,280531
16251,0.002261,172.31.36.0-255,66,170952,13,280531
16252,0.002295,74.125.24.0-255,7156,178108,13,280531
16253,0.002297,172.31.36.0-255,66,178174,13,280531
16254,0.002302,74.125.24.0-255,4320,182494,13,280531
16255,0.002305,172.31.36.0-255,66,182560,13,280531
16256,0.002345,172.31.36.0-255,66,182626,13,280531
16257,0.002347,74.125.24.0-255,1484,184110,13,280531
16258,0.002382,172.31.36.0-255,66,184176,13,280531
16259,0.002441,172.31.36.0-255,66,184242,13,280531
16260,0.002454,74.125.24.0-255,2902,187144,13,280531
16261,0.00246,172.31.36.0-255,66,187210,13,280531
16262,0.002465,74.125.24.0-255,5020,192230,13,280531
16263,0.002468,172.31.36.0-255,66,192296,13,280531
16264,0.002473,74.125.24.0-255,5738,198034,13,280531
16265,0.002476,172.31.36.0-255,66,198100,13,280531
16266,0.002487,172.31.36.0-255,66,198166,13,280531
16267,0.002534,172.31.36.0-255,66,198232,13,280531
16268,0.002562,74.125.24.0-255,3602,201834,13,280531
16269,0.002564,172.31.36.0-255,66,201900,13,280531
16270,0.002569,74.125.24.0-255,4320,206220,13,280531
16271,0.002571,172.31.36.0-255,66,206286,13,280531
16272,0.002574,74.125.24.0-255,1484,207770,13,280531
16273,0.002605,74.125.24.0-255,8574,216344,13,280531
16274,0.002608,172.31.36.0-255,66,216410,13,280531
16275,0.002614,74.125.24.0-255,5738,222148,13,280531
16276,0.002616,172.31.36.0-255,66,222214,13,280531
16277,0.002649,74.125.24.0-255,4320,226534,13,280531
16278,0.002651,172.31.36.0-255,66,226600,13,280531
16279,0.002676,74.125.24.0-255,9274,235874,13,280531
16280,0.002678,172.31.36.0-255,66,235940,13,280531
16281,0.005297,74.125.24.0-255,5738,241678,13,280531
16282,0.005307,172.31.36.0-255,66,241744,13,280531
16283,0.007916,74.125.24.0-255,5738,247482,13,280531
16284,0.007929,172.31.36.0-255,66,247548,13,280531
16285,0.010524,74.125.24.0-255,5738,253286,13,280531
16286,0.010532,172.31.36.0-255,66,253352,13,280531
16287,0.013138,74.125.24.0-255,5738,259090,13,280531
16288,0.013145,172.31.36.0-255,66,259156,13,280531
16289,0.015748,74.125.24.0-255,5738,264894,13,280531
16290,0.015756,172.31.36.0-255,66,264960,13,280531
16291,0.018357,74.125.24.0-255,5738,270698,13,280531
16292,0.018365,172.31.36.0-255,66,270764,13,280531
16293,0.020958,74.125.24.0-255,5738,276502,13,280531
16294,0.020969,172.31.36.0-255,66,276568,13,280531
16295,0.023545,74.125.24.0-255,406,276974,13,280531
16296,0.023699,172.31.36.0-255,66,277040,13,280531
16297,0.023732,172.31.36.0-255,105,277145,13,280531
16298,0.026284,74.125.24.0-255,66,277211,13,280531
16299,0.030365,172.31.36.0-255,167,277378,13,280531
16300,0.030395,172.31.36.0-255,1108,278486,13,280531
16301,0.030437,172.31.36.0-255,1514,280000,13,280531
16302,0.030439,172.31.36.0-255,333,280333,13,280531
16303,0.031907,104.244.42.0-255,66,280399,13,280531
16304,0.03196,104.244.42.0-255,66,280465,13,280531
16305,0.032023,104.244.42.0-255,66,280531,13,280531
16306,0.0,74.125.24.0-255,153,153,13,363617
16307,1.7e-05,172.31.36.0-255,66,219,13,363617
16308,2.4e-05,74.125.24.0-255,1484,1703,13,363617
16309,2.9e-05,172.31.36.0-255,66,1769,13,363617
16310,3.5e-05,74.125.24.0-255,2902,4671,13,363617
16311,4.5e-05,172.31.36.0-255,66,4737,13,363617
16312,5.3e-05,74.125.24.0-255,7156,11893,13,363617
16313,5.6e-05,172.31.36.0-255,66,11959,13,363617
16314,6.6e-05,74.125.24.0-255,8574,20533,13,363617
16315,6.8e-05,172.31.36.0-255,66,20599,13,363617
16316,0.000103,74.125.24.0-255,3495,24094,13,363617
16317,0.000107,172.31.36.0-255,66,24160,13,363617
16318,0.000115,74.125.24.0-255,6797,30957,13,363617
16319,0.000122,172.31.36.0-255,66,31023,13,363617
16320,0.000196,74.125.24.0-255,1484,32507,13,363617
16321,0.000199,172.31.36.0-255,66,32573,13,363617
16322,0.000217,74.125.24.0-255,2902,35475,13,363617
16323,0.00022,172.31.36.0-255,66,35541,13,363617
16324,0.000223,74.125.24.0-255,1484,37025,13,363617
16325,0.000225,172.31.36.0-255,66,37091,13,363617
16326,0.000259,74.125.24.0-255,2902,39993,13,363617
16327,0.000262,172.31.36.0-255,66,40059,13,363617
16328,0.000269,74.125.24.0-255,5738,45797,13,363617
16329,0.000271,172.31.36.0-255,66,45863,13,363617
16330,0.000299,74.125.24.0-255,3961,49824,13,363617
16331,0.000301,172.31.36.0-255,66,49890,13,363617
16332,0.000307,74.125.24.0-255,4320,54210,13,363617
16333,0.00031,172.31.36.0-255,66,54276,13,363617
16334,0.000314,74.125.24.0-255,2902,57178,13,363617
16335,0.000316,172.31.36.0-255,66,57244,13,363617
16336,0.000349,74.125.24.0-255,7156,64400,13,363617
16337,0.000352,172.31.36.0-255,66,64466,13,363617
16338,0.000355,74.125.24.0-255,1398,65864,13,363617
16339,0.000763,74.125.24.0-255,130,65994,13,363617
16340,0.001045,172.31.36.0-255,66,66060,13,363617
16341,0.001199,74.125.24.0-255,1484,67544,13,363617
16342,0.001218,74.125.24.0-255,2902,70446,13,363617
16343,0.001221,172.31.36.0-255,66,70512,13,363617
16344,0.001229,74.125.24.0-255,5738,76250,13,363617
16345,0.001231,172.31.36.0-255,66,76316,13,363617
16346,0.001268,74.125.24.0-255,8574,84890,13,363617
16347,0.001271,172.31.36.0-255,66,84956,13,363617
16348,0.001311,74.125.24.0-255,4320,89276,13,363617
16349,0.001314,172.31.36.0-255,66,89342,13,363617
16350,0.001356,74.125.24.0-255,10692,100034,13,363617
16351,0.001358,172.31.36.0-255,66,100100,13,363617
16352,0.001365,74.125.24.0-255,5738,105838,13,363617
16353,0.001368,172.31.36.0-255,66,105904,13,363617
16354,0.001392,74.125.24.0-255,4320,110224,13,363617
16355,0.001395,172.31.36.0-255,66,110290,13,363617
16356,0.001411,172.31.36.0-255,66,110356,13,363617
16357,0.001425,172.31.36.0-255,66,110422,13,363617
16358,0.003516,74.125.24.0-255,5738,116160,13,363617
16359,0.003525,172.31.36.0-255,66,116226,13,363617
16360,0.005588,74.125.24.0-255,5738,121964,13,363617
16361,0.005594,172.31.36.0-255,66,122030,13,363617
16362,0.007674,74.125.24.0-255,5738,127768,13,363617
16363,0.007682,172.31.36.0-255,66,127834,13,363617
16364,0.009746,74.125.24.0-255,5738,133572,13,363617
16365,0.009755,172.31.36.0-255,66,133638,13,363617
16366,0.011846,74.125.24.0-255,5738,139376,13,363617
16367,0.011854,172.31.36.0-255,66,139442,13,363617
16368,0.013922,74.125.24.0-255,5738,145180,13,363617
16369,0.013929,172.31.36.0-255,66,145246,13,363617
16370,0.016021,74.125.24.0-255,5738,150984,13,363617
16371,0.016032,172.31.36.0-255,66,151050,13,363617
16372,0.018121,74.125.24.0-255,5738,156788,13,363617
16373,0.01813,172.31.36.0-255,66,156854,13,363617
16374,0.02021,74.125.24.0-255,5738,162592,13,363617
16375,0.020219,172.31.36.0-255,66,162658,13,363617
16376,0.022336,74.125.24.0-255,5738,168396,13,363617
16377,0.022343,172.31.36.0-255,66,168462,13,363617
16378,0.02444,74.125.24.0-255,5738,174200,13,363617
16379,0.024448,172.31.36.0-255,66,174266,13,363617
16380,0.026523,74.125.24.0-255,5738,180004,13,363617
16381,0.026531,172.31.36.0-255,66,180070,13,363617
16382,0.028596,74.125.24.0-255,5738,185808,13,363617
16383,0.028603,172.31.36.0-255,66,185874,13,363617
16384,0.03067,74.125.24.0-255,5738,191612,13,363617
16385,0.030679,172.31.36.0-255,66,191678,13,363617
16386,0.03274,172.31.36.0-255,172,191850,13,363617
16387,0.032767,74.125.24.0-255,5738,197588,13,363617
16388,0.032771,172.31.36.0-255,66,197654,13,363617
16389,0.03281,172.31.36.0-255,1111,198765,13,363617
16390,0.032882,172.31.36.0-255,1514,200279,13,363617
16391,0.032903,172.31.36.0-255,1514,201793,13,363617
16392,0.032905,172.31.36.0-255,1514,203307,13,363617
16393,0.032925,172.31.36.0-255,1514,204821,13,363617
16394,0.032933,172.31.36.0-255,1514,206335,13,363617
16395,0.032935,172.31.36.0-255,70,206405,13,363617
16396,0.034307,104.244.42.0-255,66,206471,13,363617
16397,0.034357,104.244.42.0-255,66,206537,13,363617
16398,0.034479,104.244.42.0-255,66,206603,13,363617
16399,0.034485,104.244.42.0-255,66,206669,13,363617
16400,0.034488,104.244.42.0-255,66,206735,13,363617
16401,0.034819,74.125.24.0-255,5738,212473,13,363617
16402,0.034826,172.31.36.0-255,66,212539,13,363617
16403,0.035082,104.244.42.0-255,108,212647,13,363617
16404,0.03509,172.31.36.0-255,66,212713,13,363617
16405,0.036908,74.125.24.0-255,5738,218451,13,363617
16406,0.036914,172.31.36.0-255,66,218517,13,363617
16407,0.039018,74.125.24.0-255,5738,224255,13,363617
16408,0.039027,172.31.36.0-255,66,224321,13,363617
16409,0.041116,74.125.24.0-255,5738,230059,13,363617
16410,0.041123,172.31.36.0-255,66,230125,13,363617
16411,0.043196,74.125.24.0-255,5738,235863,13,363617
16412,0.043203,172.31.36.0-255,66,235929,13,363617
16413,0.045297,74.125.24.0-255,5738,241667,13,363617
16414,0.045304,172.31.36.0-255,66,241733,13,363617
16415,0.047391,74.125.24.0-255,5738,247471,13,363617
16416,0.047397,172.31.36.0-255,66,247537,13,363617
16417,0.049491,74.125.24.0-255,5738,253275,13,363617
16418,0.049497,172.31.36.0-255,66,253341,13,363617
16419,0.05158,74.125.24.0-255,5738,259079,13,363617
16420,0.051586,172.31.36.0-255,66,259145,13,363617
16421,0.053678,74.125.24.0-255,5738,264883,13,363617
16422,0.053683,172.31.36.0-255,66,264949,13,363617
16423,0.055754,74.125.24.0-255,5738,270687,13,363617
16424,0.055759,172.31.36.0-255,66,270753,13,363617
16425,0.057846,74.125.24.0-255,5738,276491,13,363617
16426,0.057853,172.31.36.0-255,66,276557,13,363617
16427,0.059932,74.125.24.0-255,5738,282295,13,363617
16428,0.059938,172.31.36.0-255,66,282361,13,363617
16429,0.062025,74.125.24.0-255,5738,288099,13,363617
16430,0.062031,172.31.36.0-255,66,288165,13,363617
16431,0.064111,74.125.24.0-255,5738,293903,13,363617
16432,0.064116,172.31.36.0-255,66,293969,13,363617
16433,0.066256,74.125.24.0-255,5738,299707,13,363617
16434,0.066264,172.31.36.0-255,66,299773,13,363617
16435,0.068371,74.125.24.0-255,5738,305511,13,363617
16436,0.068377,172.31.36.0-255,66,305577,13,363617
16437,0.070476,74.125.24.0-255,5738,311315,13,363617
16438,0.070483,172.31.36.0-255,66,311381,13,363617
16439,0.072563,74.125.24.0-255,5738,317119,13,363617
16440,0.072569,172.31.36.0-255,66,317185,13,363617
16441,0.074638,74.125.24.0-255,5738,322923,13,363617
16442,0.074645,172.31.36.0-255,66,322989,13,363617
16443,0.076726,74.125.24.0-255,5738,328727,13,363617
16444,0.076733,172.31.36.0-255,66,328793,13,363617
16445,0.078798,74.125.24.0-255,5738,334531,13,363617
16446,0.078804,172.31.36.0-255,66,334597,13,363617
16447,0.080913,74.125.24.0-255,5738,340335,13,363617
16448,0.080919,172.31.36.0-255,66,340401,13,363617
16449,0.082987,74.125.24.0-255,5738,346139,13,363617
16450,0.082994,172.31.36.0-255,66,346205,13,363617
16451,0.08508,74.125.24.0-255,5738,351943,13,363617
16452,0.085086,172.31.36.0-255,66,352009,13,363617
16453,0.087169,74.125.24.0-255,5738,357747,13,363617
16454,0.087176,172.31.36.0-255,66,357813,13,363617
16455,0.089274,74.125.24.0-255,5738,363551,13,363617
16456,0.089281,172.31.36.0-255,66,363617,13,363617
16457,0.0,172.217.194.0-255,153,153,13,243276
16458,2.6e-05,172.217.194.0-255,1484,1637,13,243276
16459,3.5e-05,172.31.36.0-255,66,1703,13,243276
16460,4.2e-05,172.217.194.0-255,2902,4605,13,243276
16461,4.5e-05,172.31.36.0-255,66,4671,13,243276
16462,5.2e-05,172.217.194.0-255,5738,10409,13,243276
16463,6.4e-05,172.31.36.0-255,66,10475,13,243276
16464,9.1e-05,172.217.194.0-255,4320,14795,13,243276
16465,9.5e-05,172.31.36.0-255,66,14861,13,243276
16466,0.000133,172.217.194.0-255,9090,23951,13,243276
16467,0.000137,172.31.36.0-255,66,24017,13,243276
16468,0.00014,172.217.194.0-255,1484,25501,13,243276
16469,0.000144,172.217.194.0-255,2902,28403,13,243276
16470,0.000148,172.31.36.0-255,66,28469,13,243276
16471,0.00018,172.217.194.0-255,2543,31012,13,243276
16472,0.000184,172.31.36.0-255,66,31078,13,243276
16473,0.00019,172.217.194.0-255,5738,36816,13,243276
16474,0.000193,172.31.36.0-255,66,36882,13,243276
16475,0.000196,172.217.194.0-255,1484,38366,13,243276
16476,0.000223,172.217.194.0-255,5738,44104,13,243276
16477,0.000226,172.31.36.0-255,66,44170,13,243276
16478,0.000235,172.217.194.0-255,9992,54162,13,243276
16479,0.000237,172.31.36.0-255,66,54228,13,243276
16480,0.000269,172.217.194.0-255,5379,59607,13,243276
16481,0.000273,172.31.36.0-255,66,59673,13,243276
16482,0.000281,172.217.194.0-255,5669,65342,13,243276
16483,0.000284,172.31.36.0-255,66,65408,13,243276
16484,0.000472,172.217.194.0-255,101,65509,13,243276
16485,0.000521,172.217.194.0-255,1484,66993,13,243276
16486,0.000526,172.31.36.0-255,66,67059,13,243276
16487,0.000531,172.217.194.0-255,2902,69961,13,243276
16488,0.000533,172.31.36.0-255,66,70027,13,243276
16489,0.000565,172.217.194.0-255,7156,77183,13,243276
16490,0.000584,172.31.36.0-255,66,77249,13,243276
16491,0.000593,172.217.194.0-255,8574,85823,13,243276
16492,0.000596,172.31.36.0-255,66,85889,13,243276
16493,0.000664,172.31.36.0-255,66,85955,13,243276
16494,0.000767,172.217.194.0-255,1484,87439,13,243276
16495,0.000786,172.217.194.0-255,2902,90341,13,243276
16496,0.000789,172.31.36.0-255,66,90407,13,243276
16497,0.000796,172.217.194.0-255,5738,96145,13,243276
16498,0.000799,172.31.36.0-255,66,96211,13,243276
16499,0.000808,172.217.194.0-255,1484,97695,13,243276
16500,0.000812,172.217.194.0-255,2902,100597,13,243276
16501,0.000815,172.31.36.0-255,66,100663,13,243276
16502,0.000821,172.217.194.0-255,4320,104983,13,243276
16503,0.000823,172.31.36.0-255,66,105049,13,243276
16504,0.000852,172.217.194.0-255,1484,106533,13,243276
16505,0.000867,172.31.36.0-255,66,106599,13,243276
16506,0.000871,172.217.194.0-255,481,107080,13,243276
16507,0.000906,172.31.36.0-255,66,107146,13,243276
16508,0.000933,172.217.194.0-255,1484,108630,13,243276
16509,0.000946,172.31.36.0-255,66,108696,13,243276
16510,0.000957,172.217.194.0-255,1484,110180,13,243276
16511,0.000974,172.217.194.0-255,3602,113782,13,243276
16512,0.000977,172.31.36.0-255,66,113848,13,243276
16513,0.0011,172.217.194.0-255,1484,115332,13,243276
16514,0.001113,172.217.194.0-255,2902,118234,13,243276
16515,0.001119,172.31.36.0-255,66,118300,13,243276
16516,0.001125,172.217.194.0-255,5738,124038,13,243276
16517,0.001128,172.31.36.0-255,66,124104,13,243276
16518,0.001168,172.31.36.0-255,66,124170,13,243276
16519,0.001178,172.217.194.0-255,10692,134862,13,243276
16520,0.00118,172.31.36.0-255,66,134928,13,243276
16521,0.001215,172.217.194.0-255,1484,136412,13,243276
16522,0.001219,172.217.194.0-255,2902,139314,13,243276
16523,0.001221,172.31.36.0-255,66,139380,13,243276
16524,0.00125,172.217.194.0-255,5738,145118,13,243276
16525,0.001252,172.31.36.0-255,66,145184,13,243276
16526,0.001264,172.31.36.0-255,66,145250,13,243276
16527,0.001277,172.217.194.0-255,10692,155942,13,243276
16528,0.00128,172.31.36.0-255,66,156008,13,243276
16529,0.001326,172.217.194.0-255,5738,161746,13,243276
16530,0.001329,172.31.36.0-255,66,161812,13,243276
16531,0.00138,172.31.36.0-255,66,161878,13,243276
16532,0.001389,172.217.194.0-255,9274,171152,13,243276
16533,0.001391,172.31.36.0-255,66,171218,13,243276
16534,0.001436,172.217.194.0-255,2902,174120,13,243276
16535,0.001438,172.31.36.0-255,66,174186,13,243276
16536,0.001485,172.31.36.0-255,66,174252,13,243276
16537,0.001732,172.217.194.0-255,1484,175736,13,243276
16538,0.001744,172.217.194.0-255,2902,178638,13,243276
16539,0.001746,172.31.36.0-255,66,178704,13,243276
16540,0.001749,172.217.194.0-255,1484,180188,13,243276
16541,0.001771,172.217.194.0-255,4320,184508,13,243276
16542,0.001774,172.31.36.0-255,66,184574,13,243276
16543,0.001779,172.217.194.0-255,4320,188894,13,243276
16544,0.001781,172.31.36.0-255,66,188960,13,243276
16545,0.001819,172.217.194.0-255,8574,197534,13,243276
16546,0.001821,172.31.36.0-255,66,197600,13,243276
16547,0.00183,172.217.194.0-255,10692,208292,13,243276
16548,0.001837,172.31.36.0-255,66,208358,13,243276
16549,0.001841,172.217.194.0-255,2902,211260,13,243276
16550,0.001844,172.31.36.0-255,66,211326,13,243276
16551,0.001885,172.31.36.0-255,66,211392,13,243276
16552,0.001915,172.217.194.0-255,4320,215712,13,243276
16553,0.001917,172.31.36.0-255,66,215778,13,243276
16554,0.001926,172.217.194.0-255,9274,225052,13,243276
16555,0.001932,172.31.36.0-255,66,225118,13,243276
16556,0.001939,172.217.194.0-255,8555,233673,13,243276
16557,0.001941,172.31.36.0-255,66,233739,13,243276
16558,0.001944,172.217.194.0-255,105,233844,13,243276
16559,0.007603,172.31.36.0-255,105,233949,13,243276
16560,0.009846,172.217.194.0-255,66,234015,13,243276
16561,0.03507,172.31.36.0-255,172,234187,13,243276
16562,0.035102,172.31.36.0-255,1109,235296,13,243276
16563,0.035146,172.31.36.0-255,1514,236810,13,243276
16564,0.035166,172.31.36.0-255,1514,238324,13,243276
16565,0.035167,172.31.36.0-255,1514,239838,13,243276
16566,0.03519,172.31.36.0-255,1514,241352,13,243276
16567,0.035191,172.31.36.0-255,1514,242866,13,243276
16568,0.035192,172.31.36.0-255,80,242946,13,243276
16569,0.036612,104.244.42.0-255,66,243012,13,243276
16570,0.036658,104.244.42.0-255,66,243078,13,243276
16571,0.036748,104.244.42.0-255,66,243144,13,243276
16572,0.036752,104.244.42.0-255,66,243210,13,243276
16573,0.036754,104.244.42.0-255,66,243276,13,243276
