,TIME,SRC,PACKET_SIZE,CUMULATIVE_PACKET_SIZE,PAGE_NUMBER,TOTAL_PACKET_SIZE
0,0.0,74.125.200.0-255,295,295,9,155736
1,2.6e-05,172.31.36.0-255,66,361,9,155736
2,3.3e-05,74.125.200.0-255,1484,1845,9,155736
3,3.7e-05,172.31.36.0-255,66,1911,9,155736
4,4.1e-05,74.125.200.0-255,2902,4813,9,155736
5,4.5e-05,172.31.36.0-255,66,4879,9,155736
6,5e-05,74.125.200.0-255,4320,9199,9,155736
7,5.2e-05,172.31.36.0-255,66,9265,9,155736
8,7.9e-05,74.125.200.0-255,2902,12167,9,155736
9,8.4e-05,172.31.36.0-255,66,12233,9,155736
10,0.000102,74.125.200.0-255,1838,14071,9,155736
11,0.000105,172.31.36.0-255,66,14137,9,155736
12,0.000191,74.125.200.0-255,1484,15621,9,155736
13,0.000195,172.31.36.0-255,66,15687,9,155736
14,0.000213,74.125.200.0-255,2902,18589,9,155736
15,0.000216,172.31.36.0-255,66,18655,9,155736
16,0.000235,74.125.200.0-255,2902,21557,9,155736
17,0.000237,172.31.36.0-255,66,21623,9,155736
18,0.000257,74.125.200.0-255,4320,25943,9,155736
19,0.000259,172.31.36.0-255,66,26009,9,155736
20,0.000287,74.125.200.0-255,2902,28911,9,155736
21,0.00029,172.31.36.0-255,66,28977,9,155736
22,0.00031,74.125.200.0-255,2543,31520,9,155736
23,0.000312,172.31.36.0-255,66,31586,9,155736
24,0.000319,74.125.200.0-255,5738,37324,9,155736
25,0.000321,172.31.36.0-255,66,37390,9,155736
26,0.000367,172.31.36.0-255,66,37456,9,155736
27,0.000875,74.125.200.0-255,1484,38940,9,155736
28,0.000881,172.31.36.0-255,66,39006,9,155736
29,0.00089,74.125.200.0-255,2902,41908,9,155736
30,0.000893,172.31.36.0-255,66,41974,9,155736
31,0.000899,74.125.200.0-255,2902,44876,9,155736
32,0.0009,172.31.36.0-255,66,44942,9,155736
33,0.000918,74.125.200.0-255,1484,46426,9,155736
34,0.000947,172.31.36.0-255,66,46492,9,155736
35,0.001048,74.125.200.0-255,1484,47976,9,155736
36,0.001053,74.125.200.0-255,1484,49460,9,155736
37,0.001056,172.31.36.0-255,66,49526,9,155736
38,0.001078,74.125.200.0-255,1484,51010,9,155736
39,0.001086,74.125.200.0-255,5738,56748,9,155736
40,0.001088,172.31.36.0-255,66,56814,9,155736
41,0.001092,74.125.200.0-255,1484,58298,9,155736
42,0.001108,74.125.200.0-255,2902,61200,9,155736
43,0.001111,172.31.36.0-255,66,61266,9,155736
44,0.00113,74.125.200.0-255,5379,66645,9,155736
45,0.001132,172.31.36.0-255,66,66711,9,155736
46,0.001153,74.125.200.0-255,5738,72449,9,155736
47,0.001155,172.31.36.0-255,66,72515,9,155736
48,0.001177,74.125.200.0-255,4320,76835,9,155736
49,0.00118,172.31.36.0-255,66,76901,9,155736
50,0.001185,74.125.200.0-255,3961,80862,9,155736
51,0.001187,172.31.36.0-255,66,80928,9,155736
52,0.001595,74.125.200.0-255,1484,82412,9,155736
53,0.001615,74.125.200.0-255,2902,85314,9,155736
54,0.001619,172.31.36.0-255,66,85380,9,155736
55,0.001634,74.125.200.0-255,4320,89700,9,155736
56,0.001636,172.31.36.0-255,66,89766,9,155736
57,0.001652,74.125.200.0-255,1484,91250,9,155736
58,0.001656,74.125.200.0-255,2902,94152,9,155736
59,0.001657,172.31.36.0-255,66,94218,9,155736
60,0.00167,74.125.200.0-255,1484,95702,9,155736
61,0.001685,74.125.200.0-255,4320,100022,9,155736
62,0.001687,172.31.36.0-255,66,100088,9,155736
63,0.001707,74.125.200.0-255,4320,104408,9,155736
64,0.001709,172.31.36.0-255,66,104474,9,155736
65,0.001714,74.125.200.0-255,4320,108794,9,155736
66,0.001716,172.31.36.0-255,66,108860,9,155736
67,0.00173,74.125.200.0-255,2902,111762,9,155736
68,0.001731,172.31.36.0-255,66,111828,9,155736
69,0.001734,74.125.200.0-255,1484,113312,9,155736
70,0.001747,74.125.200.0-255,2184,115496,9,155736
71,0.00175,172.31.36.0-255,66,115562,9,155736
72,0.002035,74.125.200.0-255,1484,117046,9,155736
73,0.002049,74.125.200.0-255,2902,119948,9,155736
74,0.002052,172.31.36.0-255,66,120014,9,155736
75,0.002073,74.125.200.0-255,5738,125752,9,155736
76,0.002075,172.31.36.0-255,66,125818,9,155736
77,0.002122,74.125.200.0-255,1484,127302,9,155736
78,0.002148,172.31.36.0-255,66,127368,9,155736
79,0.002154,74.125.200.0-255,5738,133106,9,155736
80,0.002156,172.31.36.0-255,66,133172,9,155736
81,0.002161,74.125.200.0-255,5020,138192,9,155736
82,0.002163,172.31.36.0-255,66,138258,9,155736
83,0.004284,74.125.200.0-255,5738,143996,9,155736
84,0.004291,172.31.36.0-255,66,144062,9,155736
85,0.006414,74.125.200.0-255,5738,149800,9,155736
86,0.006419,172.31.36.0-255,66,149866,9,155736
87,0.008555,74.125.200.0-255,4320,154186,9,155736
88,0.00856,172.31.36.0-255,66,154252,9,155736
89,0.00859,74.125.200.0-255,1484,155736,9,155736
90,0.0,172.31.36.0-255,105,105,9,459
91,0.00036,172.31.36.0-255,90,195,9,459
92,0.000371,172.31.36.0-255,66,261,9,459
93,0.00263,74.125.200.0-255,66,327,9,459
94,0.002662,74.125.200.0-255,66,393,9,459
95,0.002686,172.31.36.0-255,66,459,9,459
96,0.0,74.125.24.0-255,262,262,9,189842
97,3e-05,74.125.24.0-255,1484,1746,9,189842
98,3.8e-05,74.125.24.0-255,4320,6066,9,189842
99,5e-05,74.125.24.0-255,1484,7550,9,189842
100,6.9e-05,74.125.24.0-255,6284,13834,9,189842
101,0.000105,172.31.36.0-255,66,13900,9,189842
102,0.000121,74.125.24.0-255,4320,18220,9,189842
103,0.000151,74.125.24.0-255,4320,22540,9,189842
104,0.000154,74.125.24.0-255,1484,24024,9,189842
105,0.000177,74.125.24.0-255,6797,30821,9,189842
106,0.000255,74.125.24.0-255,1484,32305,9,189842
107,0.000261,74.125.24.0-255,1484,33789,9,189842
108,0.000273,74.125.24.0-255,1484,35273,9,189842
109,0.000276,74.125.24.0-255,1484,36757,9,189842
110,0.000293,74.125.24.0-255,4320,41077,9,189842
111,0.000307,74.125.24.0-255,2902,43979,9,189842
112,0.000323,74.125.24.0-255,3961,47940,9,189842
113,0.000354,74.125.24.0-255,5738,53678,9,189842
114,0.000363,172.31.36.0-255,66,53744,9,189842
115,0.000374,74.125.24.0-255,1484,55228,9,189842
116,0.000385,74.125.24.0-255,4320,59548,9,189842
117,0.000391,172.31.36.0-255,66,59614,9,189842
118,0.000422,74.125.24.0-255,5670,65284,9,189842
119,0.000428,172.31.36.0-255,66,65350,9,189842
120,0.000435,74.125.24.0-255,386,65736,9,189842
121,0.000737,74.125.24.0-255,1484,67220,9,189842
122,0.000744,74.125.24.0-255,2902,70122,9,189842
123,0.000748,74.125.24.0-255,2902,73024,9,189842
124,0.00075,172.31.36.0-255,66,73090,9,189842
125,0.000759,172.31.36.0-255,66,73156,9,189842
126,0.000762,74.125.24.0-255,2902,76058,9,189842
127,0.000771,74.125.24.0-255,2902,78960,9,189842
128,0.000777,172.31.36.0-255,66,79026,9,189842
129,0.000811,74.125.24.0-255,4320,83346,9,189842
130,0.000821,172.31.36.0-255,66,83412,9,189842
131,0.000828,74.125.24.0-255,2184,85596,9,189842
132,0.000838,172.31.36.0-255,66,85662,9,189842
133,0.001221,74.125.24.0-255,1484,87146,9,189842
134,0.001228,74.125.24.0-255,2902,90048,9,189842
135,0.001233,172.31.36.0-255,66,90114,9,189842
136,0.001238,74.125.24.0-255,2902,93016,9,189842
137,0.00125,172.31.36.0-255,66,93082,9,189842
138,0.001265,74.125.24.0-255,2902,95984,9,189842
139,0.001273,172.31.36.0-255,66,96050,9,189842
140,0.001297,172.31.36.0-255,66,96116,9,189842
141,0.001315,74.125.24.0-255,4320,100436,9,189842
142,0.001325,172.31.36.0-255,66,100502,9,189842
143,0.001327,74.125.24.0-255,2184,102686,9,189842
144,0.001334,172.31.36.0-255,66,102752,9,189842
145,0.002628,74.125.24.0-255,1484,104236,9,189842
146,0.002653,74.125.24.0-255,2902,107138,9,189842
147,0.002658,172.31.36.0-255,66,107204,9,189842
148,0.002665,74.125.24.0-255,4320,111524,9,189842
149,0.002682,172.31.36.0-255,66,111590,9,189842
150,0.002688,172.31.36.0-255,66,111656,9,189842
151,0.002722,172.31.36.0-255,66,111722,9,189842
152,0.002739,74.125.24.0-255,5020,116742,9,189842
153,0.002748,74.125.24.0-255,1484,118226,9,189842
154,0.002752,172.31.36.0-255,66,118292,9,189842
155,0.002773,74.125.24.0-255,2902,121194,9,189842
156,0.002779,74.125.24.0-255,5738,126932,9,189842
157,0.00278,172.31.36.0-255,66,126998,9,189842
158,0.002785,172.31.36.0-255,66,127064,9,189842
159,0.002832,74.125.24.0-255,7156,134220,9,189842
160,0.002836,172.31.36.0-255,66,134286,9,189842
161,0.002871,74.125.24.0-255,3602,137888,9,189842
162,0.002876,172.31.36.0-255,66,137954,9,189842
163,0.002933,74.125.24.0-255,1484,139438,9,189842
164,0.002938,74.125.24.0-255,2902,142340,9,189842
165,0.002953,74.125.24.0-255,5738,148078,9,189842
166,0.002954,172.31.36.0-255,66,148144,9,189842
167,0.002959,172.31.36.0-255,66,148210,9,189842
168,0.003005,74.125.24.0-255,2902,151112,9,189842
169,0.003012,172.31.36.0-255,66,151178,9,189842
170,0.003051,172.31.36.0-255,66,151244,9,189842
171,0.003143,74.125.24.0-255,1484,152728,9,189842
172,0.003149,74.125.24.0-255,2902,155630,9,189842
173,0.003152,172.31.36.0-255,66,155696,9,189842
174,0.003158,74.125.24.0-255,5738,161434,9,189842
175,0.003168,172.31.36.0-255,66,161500,9,189842
176,0.003212,172.31.36.0-255,66,161566,9,189842
177,0.003234,74.125.24.0-255,4320,165886,9,189842
178,0.003238,172.31.36.0-255,66,165952,9,189842
179,0.003244,74.125.24.0-255,5738,171690,9,189842
180,0.003256,172.31.36.0-255,66,171756,9,189842
181,0.003267,74.125.24.0-255,2902,174658,9,189842
182,0.00327,172.31.36.0-255,66,174724,9,189842
183,0.003326,172.31.36.0-255,66,174790,9,189842
184,0.00334,172.31.36.0-255,66,174856,9,189842
185,0.003376,74.125.24.0-255,2902,177758,9,189842
186,0.003388,172.31.36.0-255,66,177824,9,189842
187,0.003393,172.31.36.0-255,66,177890,9,189842
188,0.003407,172.31.36.0-255,66,177956,9,189842
189,0.00346,172.31.36.0-255,66,178022,9,189842
190,0.003485,172.31.36.0-255,66,178088,9,189842
191,0.003503,172.31.36.0-255,66,178154,9,189842
192,0.003538,74.125.24.0-255,5738,183892,9,189842
193,0.003543,172.31.36.0-255,66,183958,9,189842
194,0.003569,74.125.24.0-255,5542,189500,9,189842
195,0.003573,74.125.24.0-255,105,189605,9,189842
196,0.00358,172.31.36.0-255,66,189671,9,189842
197,0.005302,172.31.36.0-255,105,189776,9,189842
198,0.00764,74.125.24.0-255,66,189842,9,189842
199,0.0,74.125.24.0-255,160,160,9,195879
200,3.6e-05,172.31.36.0-255,66,226,9,195879
201,4.4e-05,74.125.24.0-255,1484,1710,9,195879
202,4.8e-05,172.31.36.0-255,66,1776,9,195879
203,5.3e-05,74.125.24.0-255,2902,4678,9,195879
204,6.3e-05,172.31.36.0-255,66,4744,9,195879
205,7.1e-05,74.125.24.0-255,7156,11900,9,195879
206,7.3e-05,172.31.36.0-255,66,11966,9,195879
207,0.000113,74.125.24.0-255,2072,14038,9,195879
208,0.000116,172.31.36.0-255,66,14104,9,195879
209,0.000182,74.125.24.0-255,1484,15588,9,195879
210,0.000185,172.31.36.0-255,66,15654,9,195879
211,0.000191,74.125.24.0-255,2902,18556,9,195879
212,0.000194,172.31.36.0-255,66,18622,9,195879
213,0.000229,74.125.24.0-255,2902,21524,9,195879
214,0.000232,172.31.36.0-255,66,21590,9,195879
215,0.00028,74.125.24.0-255,4320,25910,9,195879
216,0.000284,172.31.36.0-255,66,25976,9,195879
217,0.000291,74.125.24.0-255,5379,31355,9,195879
218,0.000293,172.31.36.0-255,66,31421,9,195879
219,0.000343,74.125.24.0-255,1484,32905,9,195879
220,0.000347,172.31.36.0-255,66,32971,9,195879
221,0.000352,74.125.24.0-255,2902,35873,9,195879
222,0.000354,172.31.36.0-255,66,35939,9,195879
223,0.000366,74.125.24.0-255,5738,41677,9,195879
224,0.000369,172.31.36.0-255,66,41743,9,195879
225,0.000377,74.125.24.0-255,6797,48540,9,195879
226,0.00038,172.31.36.0-255,66,48606,9,195879
227,0.000454,74.125.24.0-255,1484,50090,9,195879
228,0.000458,172.31.36.0-255,66,50156,9,195879
229,0.000463,74.125.24.0-255,2902,53058,9,195879
230,0.000465,172.31.36.0-255,66,53124,9,195879
231,0.000495,74.125.24.0-255,5738,58862,9,195879
232,0.000498,172.31.36.0-255,66,58928,9,195879
233,0.00053,74.125.24.0-255,6797,65725,9,195879
234,0.000533,172.31.36.0-255,66,65791,9,195879
235,0.000897,74.125.24.0-255,645,66436,9,195879
236,0.000919,74.125.24.0-255,1484,67920,9,195879
237,0.000922,172.31.36.0-255,66,67986,9,195879
238,0.000943,74.125.24.0-255,4320,72306,9,195879
239,0.000946,172.31.36.0-255,66,72372,9,195879
240,0.000951,74.125.24.0-255,2902,75274,9,195879
241,0.000954,172.31.36.0-255,66,75340,9,195879
242,0.00099,74.125.24.0-255,7156,82496,9,195879
243,0.000999,172.31.36.0-255,66,82562,9,195879
244,0.001011,172.31.36.0-255,66,82628,9,195879
245,0.001051,172.31.36.0-255,66,82694,9,195879
246,0.001139,74.125.24.0-255,1484,84178,9,195879
247,0.001154,74.125.24.0-255,2902,87080,9,195879
248,0.001157,172.31.36.0-255,66,87146,9,195879
249,0.001185,74.125.24.0-255,4320,91466,9,195879
250,0.001188,172.31.36.0-255,66,91532,9,195879
251,0.001213,74.125.24.0-255,1484,93016,9,195879
252,0.001239,74.125.24.0-255,6249,99265,9,195879
253,0.001243,172.31.36.0-255,66,99331,9,195879
254,0.001379,74.125.24.0-255,1484,100815,9,195879
255,0.001397,74.125.24.0-255,2902,103717,9,195879
256,0.0014,74.125.24.0-255,1484,105201,9,195879
257,0.001401,172.31.36.0-255,66,105267,9,195879
258,0.00143,74.125.24.0-255,4320,109587,9,195879
259,0.001434,172.31.36.0-255,66,109653,9,195879
260,0.001435,74.125.24.0-255,4320,113973,9,195879
261,0.001437,172.31.36.0-255,66,114039,9,195879
262,0.001463,74.125.24.0-255,5738,119777,9,195879
263,0.001467,172.31.36.0-255,66,119843,9,195879
264,0.0015,74.125.24.0-255,5738,125581,9,195879
265,0.001503,172.31.36.0-255,66,125647,9,195879
266,0.001514,172.31.36.0-255,66,125713,9,195879
267,0.001637,74.125.24.0-255,1484,127197,9,195879
268,0.001654,74.125.24.0-255,2902,130099,9,195879
269,0.001657,172.31.36.0-255,66,130165,9,195879
270,0.001662,74.125.24.0-255,2902,133067,9,195879
271,0.001664,172.31.36.0-255,66,133133,9,195879
272,0.001687,74.125.24.0-255,2902,136035,9,195879
273,0.001694,172.31.36.0-255,66,136101,9,195879
274,0.001733,172.31.36.0-255,66,136167,9,195879
275,0.001746,172.31.36.0-255,66,136233,9,195879
276,0.001777,74.125.24.0-255,3602,139835,9,195879
277,0.001782,172.31.36.0-255,66,139901,9,195879
278,0.001788,172.31.36.0-255,66,139967,9,195879
279,0.001832,74.125.24.0-255,5738,145705,9,195879
280,0.001836,172.31.36.0-255,66,145771,9,195879
281,0.001857,172.31.36.0-255,66,145837,9,195879
282,0.001943,74.125.24.0-255,1484,147321,9,195879
283,0.001955,74.125.24.0-255,2902,150223,9,195879
284,0.001958,172.31.36.0-255,66,150289,9,195879
285,0.001986,74.125.24.0-255,5738,156027,9,195879
286,0.001989,172.31.36.0-255,66,156093,9,195879
287,0.002025,172.31.36.0-255,66,156159,9,195879
288,0.002028,74.125.24.0-255,1484,157643,9,195879
289,0.002062,172.31.36.0-255,66,157709,9,195879
290,0.002111,74.125.24.0-255,2184,159893,9,195879
291,0.002115,172.31.36.0-255,66,159959,9,195879
292,0.002262,74.125.24.0-255,1484,161443,9,195879
293,0.002279,74.125.24.0-255,2902,164345,9,195879
294,0.002284,172.31.36.0-255,66,164411,9,195879
295,0.002291,74.125.24.0-255,4320,168731,9,195879
296,0.002293,172.31.36.0-255,66,168797,9,195879
297,0.002313,74.125.24.0-255,1484,170281,9,195879
298,0.002323,74.125.24.0-255,2902,173183,9,195879
299,0.002326,172.31.36.0-255,66,173249,9,195879
300,0.002364,172.31.36.0-255,66,173315,9,195879
301,0.00237,74.125.24.0-255,4320,177635,9,195879
302,0.002372,172.31.36.0-255,66,177701,9,195879
303,0.002375,74.125.24.0-255,1484,179185,9,195879
304,0.00241,74.125.24.0-255,5020,184205,9,195879
305,0.002414,172.31.36.0-255,66,184271,9,195879
306,0.005064,74.125.24.0-255,5738,190009,9,195879
307,0.005085,172.31.36.0-255,66,190075,9,195879
308,0.007732,74.125.24.0-255,5738,195813,9,195879
309,0.007743,172.31.36.0-255,66,195879,9,195879
310,0.0,172.217.27.0-255,152,152,9,116235
311,3e-05,172.31.36.0-255,66,218,9,116235
312,3.7e-05,172.217.27.0-255,1484,1702,9,116235
313,4.2e-05,172.31.36.0-255,66,1768,9,116235
314,4.7e-05,172.217.27.0-255,2902,4670,9,116235
315,5e-05,172.31.36.0-255,66,4736,9,116235
316,5.7e-05,172.217.27.0-255,7156,11892,9,116235
317,6e-05,172.31.36.0-255,66,11958,9,116235
318,8e-05,172.217.27.0-255,2079,14037,9,116235
319,8.3e-05,172.31.36.0-255,66,14103,9,116235
320,0.000215,172.217.27.0-255,1484,15587,9,116235
321,0.00022,172.31.36.0-255,66,15653,9,116235
322,0.000226,172.217.27.0-255,2902,18555,9,116235
323,0.000229,172.31.36.0-255,66,18621,9,116235
324,0.000233,172.217.27.0-255,1484,20105,9,116235
325,0.000235,172.31.36.0-255,66,20171,9,116235
326,0.000261,172.217.27.0-255,4320,24491,9,116235
327,0.000265,172.31.36.0-255,66,24557,9,116235
328,0.000271,172.217.27.0-255,6797,31354,9,116235
329,0.000274,172.31.36.0-255,66,31420,9,116235
330,0.000311,172.217.27.0-255,1484,32904,9,116235
331,0.000314,172.31.36.0-255,66,32970,9,116235
332,0.000338,172.217.27.0-255,2902,35872,9,116235
333,0.000341,172.31.36.0-255,66,35938,9,116235
334,0.000348,172.217.27.0-255,5738,41676,9,116235
335,0.000351,172.31.36.0-255,66,41742,9,116235
336,0.000405,172.217.27.0-255,6797,48539,9,116235
337,0.000409,172.31.36.0-255,66,48605,9,116235
338,0.000498,172.217.27.0-255,1484,50089,9,116235
339,0.000501,172.31.36.0-255,66,50155,9,116235
340,0.000515,172.217.27.0-255,2902,53057,9,116235
341,0.000518,172.31.36.0-255,66,53123,9,116235
342,0.000544,172.217.27.0-255,4320,57443,9,116235
343,0.000547,172.31.36.0-255,66,57509,9,116235
344,0.000552,172.217.27.0-255,2902,60411,9,116235
345,0.000554,172.31.36.0-255,66,60477,9,116235
346,0.000571,172.217.27.0-255,5674,66151,9,116235
347,0.000575,172.31.36.0-255,66,66217,9,116235
348,0.00101,172.217.27.0-255,136,66353,9,116235
349,0.001019,172.217.27.0-255,342,66695,9,116235
350,0.001408,172.217.27.0-255,1484,68179,9,116235
351,0.001414,172.31.36.0-255,66,68245,9,116235
352,0.001421,172.217.27.0-255,2902,71147,9,116235
353,0.001423,172.31.36.0-255,66,71213,9,116235
354,0.001429,172.217.27.0-255,5738,76951,9,116235
355,0.001432,172.31.36.0-255,66,77017,9,116235
356,0.001437,172.217.27.0-255,4320,81337,9,116235
357,0.001439,172.31.36.0-255,66,81403,9,116235
358,0.001457,172.217.27.0-255,2902,84305,9,116235
359,0.001459,172.31.36.0-255,66,84371,9,116235
360,0.001491,172.31.36.0-255,66,84437,9,116235
361,0.001497,172.217.27.0-255,5738,90175,9,116235
362,0.001499,172.31.36.0-255,66,90241,9,116235
363,0.001514,172.217.27.0-255,2184,92425,9,116235
364,0.001516,172.31.36.0-255,66,92491,9,116235
365,0.003249,172.217.27.0-255,2902,95393,9,116235
366,0.003252,172.31.36.0-255,66,95459,9,116235
367,0.003277,172.217.27.0-255,2902,98361,9,116235
368,0.00328,172.31.36.0-255,66,98427,9,116235
369,0.005004,172.217.27.0-255,2902,101329,9,116235
370,0.005007,172.31.36.0-255,66,101395,9,116235
371,0.005025,172.217.27.0-255,2902,104297,9,116235
372,0.005027,172.31.36.0-255,66,104363,9,116235
373,0.006764,172.217.27.0-255,2902,107265,9,116235
374,0.006769,172.31.36.0-255,66,107331,9,116235
375,0.006788,172.217.27.0-255,2902,110233,9,116235
376,0.006791,172.31.36.0-255,66,110299,9,116235
377,0.008522,172.217.27.0-255,2902,113201,9,116235
378,0.008531,172.31.36.0-255,66,113267,9,116235
379,0.008552,172.217.27.0-255,2902,116169,9,116235
380,0.008555,172.31.36.0-255,66,116235,9,116235
381,0.0,74.125.24.0-255,153,153,9,228537
382,2.9e-05,172.31.36.0-255,66,219,9,228537
383,3.5e-05,74.125.24.0-255,1484,1703,9,228537
384,3.9e-05,172.31.36.0-255,66,1769,9,228537
385,4.4e-05,74.125.24.0-255,2902,4671,9,228537
386,4.6e-05,172.31.36.0-255,66,4737,9,228537
387,6.1e-05,74.125.24.0-255,7156,11893,9,228537
388,6.3e-05,172.31.36.0-255,66,11959,9,228537
389,9.8e-05,74.125.24.0-255,2011,13970,9,228537
390,0.000101,172.31.36.0-255,66,14036,9,228537
391,0.000126,74.125.24.0-255,2902,16938,9,228537
392,0.000129,172.31.36.0-255,66,17004,9,228537
393,0.000134,74.125.24.0-255,4320,21324,9,228537
394,0.000136,172.31.36.0-255,66,21390,9,228537
395,0.000141,74.125.24.0-255,2902,24292,9,228537
396,0.000142,172.31.36.0-255,66,24358,9,228537
397,0.000164,74.125.24.0-255,5738,30096,9,228537
398,0.000173,172.31.36.0-255,66,30162,9,228537
399,0.000176,74.125.24.0-255,1125,31287,9,228537
400,0.000178,172.31.36.0-255,66,31353,9,228537
401,0.000494,74.125.24.0-255,1484,32837,9,228537
402,0.000497,74.125.24.0-255,1484,34321,9,228537
403,0.0005,172.31.36.0-255,66,34387,9,228537
404,0.000504,172.31.36.0-255,66,34453,9,228537
405,0.000534,74.125.24.0-255,1484,35937,9,228537
406,0.000541,172.31.36.0-255,66,36003,9,228537
407,0.000547,74.125.24.0-255,5738,41741,9,228537
408,0.000549,172.31.36.0-255,66,41807,9,228537
409,0.000556,74.125.24.0-255,6797,48604,9,228537
410,0.000558,172.31.36.0-255,66,48670,9,228537
411,0.000587,74.125.24.0-255,5738,54408,9,228537
412,0.00059,172.31.36.0-255,66,54474,9,228537
413,0.000632,74.125.24.0-255,2854,57328,9,228537
414,0.000633,172.31.36.0-255,66,57394,9,228537
415,0.000639,172.31.36.0-255,66,57460,9,228537
416,0.000658,74.125.24.0-255,111,57571,9,228537
417,0.000807,74.125.24.0-255,1484,59055,9,228537
418,0.000811,172.31.36.0-255,66,59121,9,228537
419,0.000817,74.125.24.0-255,2902,62023,9,228537
420,0.00082,74.125.24.0-255,1484,63507,9,228537
421,0.000835,172.31.36.0-255,66,63573,9,228537
422,0.000839,74.125.24.0-255,4320,67893,9,228537
423,0.000852,172.31.36.0-255,66,67959,9,228537
424,0.000863,74.125.24.0-255,7156,75115,9,228537
425,0.000869,172.31.36.0-255,66,75181,9,228537
426,0.000892,74.125.24.0-255,3961,79142,9,228537
427,0.000903,172.31.36.0-255,66,79208,9,228537
428,0.000918,172.31.36.0-255,66,79274,9,228537
429,0.000926,74.125.24.0-255,1125,80399,9,228537
430,0.001119,172.31.36.0-255,66,80465,9,228537
431,0.001223,74.125.24.0-255,330,80795,9,228537
432,0.001475,74.125.24.0-255,1484,82279,9,228537
433,0.001483,74.125.24.0-255,2902,85181,9,228537
434,0.001505,74.125.24.0-255,5738,90919,9,228537
435,0.001524,74.125.24.0-255,5738,96657,9,228537
436,0.001541,74.125.24.0-255,7156,103813,9,228537
437,0.001547,74.125.24.0-255,7156,110969,9,228537
438,0.001565,74.125.24.0-255,3602,114571,9,228537
439,0.001666,74.125.24.0-255,1484,116055,9,228537
440,0.001672,74.125.24.0-255,2902,118957,9,228537
441,0.001688,74.125.24.0-255,5738,124695,9,228537
442,0.001741,74.125.24.0-255,2902,127597,9,228537
443,0.001757,74.125.24.0-255,7156,134753,9,228537
444,0.001797,74.125.24.0-255,2902,137655,9,228537
445,0.001814,74.125.24.0-255,766,138421,9,228537
446,0.001819,74.125.24.0-255,4320,142741,9,228537
447,0.00183,74.125.24.0-255,1484,144225,9,228537
448,0.001855,74.125.24.0-255,4320,148545,9,228537
449,0.001874,74.125.24.0-255,5738,154283,9,228537
450,0.001901,74.125.24.0-255,4320,158603,9,228537
451,0.001915,74.125.24.0-255,5020,163623,9,228537
452,0.001942,74.125.24.0-255,7156,170779,9,228537
453,0.001955,74.125.24.0-255,2902,173681,9,228537
454,0.00196,74.125.24.0-255,5738,179419,9,228537
455,0.001975,74.125.24.0-255,2902,182321,9,228537
456,0.00206,74.125.24.0-255,2902,185223,9,228537
457,0.002094,74.125.24.0-255,3602,188825,9,228537
458,0.002157,74.125.24.0-255,1484,190309,9,228537
459,0.002161,74.125.24.0-255,2902,193211,9,228537
460,0.002166,74.125.24.0-255,5738,198949,9,228537
461,0.002173,74.125.24.0-255,7156,206105,9,228537
462,0.002195,74.125.24.0-255,2902,209007,9,228537
463,0.002217,74.125.24.0-255,5738,214745,9,228537
464,0.002221,74.125.24.0-255,2902,217647,9,228537
465,0.002243,74.125.24.0-255,5020,222667,9,228537
466,0.005325,172.31.36.0-255,66,222733,9,228537
467,0.007681,74.125.24.0-255,5738,228471,9,228537
468,0.007689,172.31.36.0-255,66,228537,9,228537
469,0.0,172.31.36.0-255,105,105,9,459
470,0.000371,172.31.36.0-255,90,195,9,459
471,0.000379,172.31.36.0-255,66,261,9,459
472,0.003026,74.125.24.0-255,66,327,9,459
473,0.003059,74.125.24.0-255,66,393,9,459
474,0.003081,172.31.36.0-255,66,459,9,459
475,0.0,172.31.36.0-255,105,105,9,105
476,0.0,172.31.36.0-255,105,105,9,105
477,0.0,74.125.24.0-255,153,153,9,280379
478,2.3e-05,172.31.36.0-255,66,219,9,280379
479,3e-05,74.125.24.0-255,1484,1703,9,280379
480,3.4e-05,172.31.36.0-255,66,1769,9,280379
481,4e-05,74.125.24.0-255,2902,4671,9,280379
482,4.3e-05,172.31.36.0-255,66,4737,9,280379
483,6e-05,74.125.24.0-255,7156,11893,9,280379
484,6.3e-05,172.31.36.0-255,66,11959,9,280379
485,6.7e-05,74.125.24.0-255,2085,14044,9,280379
486,7e-05,172.31.36.0-255,66,14110,9,280379
487,7.6e-05,74.125.24.0-255,2902,17012,9,280379
488,7.9e-05,172.31.36.0-255,66,17078,9,280379
489,0.000123,172.31.36.0-255,66,17144,9,280379
490,0.00013,74.125.24.0-255,5379,22523,9,280379
491,0.000133,172.31.36.0-255,66,22589,9,280379
492,0.000603,74.125.24.0-255,1484,24073,9,280379
493,0.000608,172.31.36.0-255,66,24139,9,280379
494,0.000613,74.125.24.0-255,2902,27041,9,280379
495,0.000615,172.31.36.0-255,66,27107,9,280379
496,0.000642,74.125.24.0-255,5738,32845,9,280379
497,0.000644,172.31.36.0-255,66,32911,9,280379
498,0.000695,172.31.36.0-255,66,32977,9,280379
499,0.000717,74.125.24.0-255,1484,34461,9,280379
500,0.000719,172.31.36.0-255,66,34527,9,280379
501,0.000726,74.125.24.0-255,7156,41683,9,280379
502,0.000727,172.31.36.0-255,66,41749,9,280379
503,0.000746,74.125.24.0-255,2902,44651,9,280379
504,0.000751,172.31.36.0-255,66,44717,9,280379
505,0.000754,74.125.24.0-255,766,45483,9,280379
506,0.000756,172.31.36.0-255,66,45549,9,280379
507,0.000792,74.125.24.0-255,425,45974,9,280379
508,0.000894,74.125.24.0-255,1484,47458,9,280379
509,0.000907,172.31.36.0-255,66,47524,9,280379
510,0.000935,74.125.24.0-255,2902,50426,9,280379
511,0.000949,74.125.24.0-255,1484,51910,9,280379
512,0.000954,172.31.36.0-255,66,51976,9,280379
513,0.000964,74.125.24.0-255,4320,56296,9,280379
514,0.000972,74.125.24.0-255,2902,59198,9,280379
515,0.000983,74.125.24.0-255,1484,60682,9,280379
516,0.001012,172.31.36.0-255,66,60748,9,280379
517,0.001022,74.125.24.0-255,7156,67904,9,280379
518,0.001027,172.31.36.0-255,66,67970,9,280379
519,0.001046,74.125.24.0-255,3602,71572,9,280379
520,0.001064,172.31.36.0-255,66,71638,9,280379
521,0.001089,74.125.24.0-255,348,71986,9,280379
522,0.001124,74.125.24.0-255,1484,73470,9,280379
523,0.001127,74.125.24.0-255,1484,74954,9,280379
524,0.001141,172.31.36.0-255,66,75020,9,280379
525,0.001153,74.125.24.0-255,2902,77922,9,280379
526,0.001169,172.31.36.0-255,66,77988,9,280379
527,0.001189,74.125.24.0-255,2902,80890,9,280379
528,0.001194,172.31.36.0-255,66,80956,9,280379
529,0.00122,74.125.24.0-255,1484,82440,9,280379
530,0.001236,74.125.24.0-255,5738,88178,9,280379
531,0.001245,172.31.36.0-255,66,88244,9,280379
532,0.001252,74.125.24.0-255,2902,91146,9,280379
533,0.001257,172.31.36.0-255,66,91212,9,280379
534,0.001284,74.125.24.0-255,5020,96232,9,280379
535,0.001291,172.31.36.0-255,66,96298,9,280379
536,0.001464,74.125.24.0-255,1484,97782,9,280379
537,0.001492,74.125.24.0-255,2902,100684,9,280379
538,0.001495,172.31.36.0-255,66,100750,9,280379
539,0.001526,74.125.24.0-255,5738,106488,9,280379
540,0.001538,74.125.24.0-255,4320,110808,9,280379
541,0.001543,172.31.36.0-255,66,110874,9,280379
542,0.001564,74.125.24.0-255,1484,112358,9,280379
543,0.001569,74.125.24.0-255,4320,116678,9,280379
544,0.001574,172.31.36.0-255,66,116744,9,280379
545,0.001614,74.125.24.0-255,5020,121764,9,280379
546,0.001619,172.31.36.0-255,66,121830,9,280379
547,0.002263,74.125.24.0-255,1484,123314,9,280379
548,0.002284,74.125.24.0-255,2902,126216,9,280379
549,0.002288,172.31.36.0-255,66,126282,9,280379
550,0.002292,74.125.24.0-255,1484,127766,9,280379
551,0.002319,74.125.24.0-255,4320,132086,9,280379
552,0.002333,74.125.24.0-255,1484,133570,9,280379
553,0.002391,74.125.24.0-255,4320,137890,9,280379
554,0.002406,74.125.24.0-255,5738,143628,9,280379
555,0.002432,74.125.24.0-255,2184,145812,9,280379
556,0.002611,74.125.24.0-255,1484,147296,9,280379
557,0.002632,74.125.24.0-255,1484,148780,9,280379
558,0.002665,74.125.24.0-255,2902,151682,9,280379
559,0.002676,74.125.24.0-255,1484,153166,9,280379
560,0.002697,74.125.24.0-255,5738,158904,9,280379
561,0.002721,74.125.24.0-255,2902,161806,9,280379
562,0.002738,74.125.24.0-255,1484,163290,9,280379
563,0.002764,74.125.24.0-255,4320,167610,9,280379
564,0.00278,74.125.24.0-255,2902,170512,9,280379
565,0.002782,74.125.24.0-255,766,171278,9,280379
566,0.002817,74.125.24.0-255,1484,172762,9,280379
567,0.002829,74.125.24.0-255,2902,175664,9,280379
568,0.002843,74.125.24.0-255,1484,177148,9,280379
569,0.002849,74.125.24.0-255,5738,182886,9,280379
570,0.002873,74.125.24.0-255,2902,185788,9,280379
571,0.002898,74.125.24.0-255,4320,190108,9,280379
572,0.002963,74.125.24.0-255,1484,191592,9,280379
573,0.002977,74.125.24.0-255,5020,196612,9,280379
574,0.003124,74.125.24.0-255,1484,198096,9,280379
575,0.003139,74.125.24.0-255,2902,200998,9,280379
576,0.003153,74.125.24.0-255,4320,205318,9,280379
577,0.003163,74.125.24.0-255,1484,206802,9,280379
578,0.003186,74.125.24.0-255,5738,212540,9,280379
579,0.003206,74.125.24.0-255,5738,218278,9,280379
580,0.003211,74.125.24.0-255,5738,224016,9,280379
581,0.003246,74.125.24.0-255,6438,230454,9,280379
582,0.003342,74.125.24.0-255,1484,231938,9,280379
583,0.003357,74.125.24.0-255,2902,234840,9,280379
584,0.003361,74.125.24.0-255,2902,237742,9,280379
585,0.003377,74.125.24.0-255,2902,240644,9,280379
586,0.003379,74.125.24.0-255,1484,242128,9,280379
587,0.003418,74.125.24.0-255,5738,247866,9,280379
588,0.00345,74.125.24.0-255,4320,252186,9,280379
589,0.003488,74.125.24.0-255,1484,253670,9,280379
590,0.003529,74.125.24.0-255,766,254436,9,280379
591,0.003534,74.125.24.0-255,5738,260174,9,280379
592,0.003537,74.125.24.0-255,1484,261658,9,280379
593,0.00354,74.125.24.0-255,2902,264560,9,280379
594,0.003559,74.125.24.0-255,2902,267462,9,280379
595,0.003588,74.125.24.0-255,4320,271782,9,280379
596,0.003606,74.125.24.0-255,7156,278938,9,280379
597,0.003608,74.125.24.0-255,1270,280208,9,280379
598,0.00365,74.125.24.0-255,105,280313,9,280379
599,0.00935,172.31.36.0-255,66,280379,9,280379
600,0.0,74.125.24.0-255,143,143,9,208408
601,2.6e-05,172.31.36.0-255,66,209,9,208408
602,3.4e-05,74.125.24.0-255,1484,1693,9,208408
603,3.9e-05,172.31.36.0-255,66,1759,9,208408
604,4.6e-05,74.125.24.0-255,2902,4661,9,208408
605,5e-05,172.31.36.0-255,66,4727,9,208408
606,5.7e-05,74.125.24.0-255,7156,11883,9,208408
607,6.1e-05,172.31.36.0-255,66,11949,9,208408
608,6.5e-05,74.125.24.0-255,2070,14019,9,208408
609,6.7e-05,172.31.36.0-255,66,14085,9,208408
610,0.000125,74.125.24.0-255,1484,15569,9,208408
611,0.000128,172.31.36.0-255,66,15635,9,208408
612,0.000132,74.125.24.0-255,2902,18537,9,208408
613,0.000135,172.31.36.0-255,66,18603,9,208408
614,0.000155,74.125.24.0-255,5738,24341,9,208408
615,0.000158,172.31.36.0-255,66,24407,9,208408
616,0.000163,74.125.24.0-255,2902,27309,9,208408
617,0.000164,172.31.36.0-255,66,27375,9,208408
618,0.000185,74.125.24.0-255,3961,31336,9,208408
619,0.000187,172.31.36.0-255,66,31402,9,208408
620,0.0002,172.31.36.0-255,66,31468,9,208408
621,0.00022,74.125.24.0-255,4320,35788,9,208408
622,0.000222,172.31.36.0-255,66,35854,9,208408
623,0.000234,172.31.36.0-255,66,35920,9,208408
624,0.000253,74.125.24.0-255,4320,40240,9,208408
625,0.000256,172.31.36.0-255,66,40306,9,208408
626,0.000262,74.125.24.0-255,3895,44201,9,208408
627,0.000264,172.31.36.0-255,66,44267,9,208408
628,0.000526,74.125.24.0-255,139,44406,9,208408
629,0.000532,172.31.36.0-255,66,44472,9,208408
630,0.000553,74.125.24.0-255,1484,45956,9,208408
631,0.000576,74.125.24.0-255,2902,48858,9,208408
632,0.000579,172.31.36.0-255,66,48924,9,208408
633,0.000586,74.125.24.0-255,5738,54662,9,208408
634,0.000589,172.31.36.0-255,66,54728,9,208408
635,0.000634,172.31.36.0-255,66,54794,9,208408
636,0.000644,172.31.36.0-255,66,54860,9,208408
637,0.000659,74.125.24.0-255,2184,57044,9,208408
638,0.000661,172.31.36.0-255,66,57110,9,208408
639,0.000665,74.125.24.0-255,2902,60012,9,208408
640,0.000667,172.31.36.0-255,66,60078,9,208408
641,0.000697,74.125.24.0-255,7156,67234,9,208408
642,0.0007,172.31.36.0-255,66,67300,9,208408
643,0.000719,74.125.24.0-255,4320,71620,9,208408
644,0.000722,172.31.36.0-255,66,71686,9,208408
645,0.000753,74.125.24.0-255,5738,77424,9,208408
646,0.000756,172.31.36.0-255,66,77490,9,208408
647,0.000769,172.31.36.0-255,66,77556,9,208408
648,0.000812,172.31.36.0-255,66,77622,9,208408
649,0.000829,74.125.24.0-255,2184,79806,9,208408
650,0.000831,172.31.36.0-255,66,79872,9,208408
651,0.000845,172.31.36.0-255,66,79938,9,208408
652,0.000858,172.31.36.0-255,66,80004,9,208408
653,0.001066,74.125.24.0-255,1484,81488,9,208408
654,0.001072,74.125.24.0-255,2902,84390,9,208408
655,0.001075,172.31.36.0-255,66,84456,9,208408
656,0.001083,74.125.24.0-255,5738,90194,9,208408
657,0.001085,172.31.36.0-255,66,90260,9,208408
658,0.001124,74.125.24.0-255,6797,97057,9,208408
659,0.001127,172.31.36.0-255,66,97123,9,208408
660,0.001266,74.125.24.0-255,1484,98607,9,208408
661,0.001272,74.125.24.0-255,2902,101509,9,208408
662,0.001275,172.31.36.0-255,66,101575,9,208408
663,0.001304,74.125.24.0-255,4320,105895,9,208408
664,0.001307,172.31.36.0-255,66,105961,9,208408
665,0.001329,74.125.24.0-255,1484,107445,9,208408
666,0.001344,172.31.36.0-255,66,107511,9,208408
667,0.001366,74.125.24.0-255,7156,114667,9,208408
668,0.001369,172.31.36.0-255,66,114733,9,208408
669,0.001383,74.125.24.0-255,3602,118335,9,208408
670,0.001386,172.31.36.0-255,66,118401,9,208408
671,0.001459,74.125.24.0-255,1484,119885,9,208408
672,0.001466,74.125.24.0-255,2902,122787,9,208408
673,0.001469,172.31.36.0-255,66,122853,9,208408
674,0.001472,74.125.24.0-255,1484,124337,9,208408
675,0.001493,74.125.24.0-255,4320,128657,9,208408
676,0.001496,172.31.36.0-255,66,128723,9,208408
677,0.001499,74.125.24.0-255,1484,130207,9,208408
678,0.00154,74.125.24.0-255,5379,135586,9,208408
679,0.001543,172.31.36.0-255,66,135652,9,208408
680,0.001625,74.125.24.0-255,1484,137136,9,208408
681,0.001649,74.125.24.0-255,2902,140038,9,208408
682,0.001653,172.31.36.0-255,66,140104,9,208408
683,0.00166,74.125.24.0-255,5738,145842,9,208408
684,0.001662,172.31.36.0-255,66,145908,9,208408
685,0.001666,74.125.24.0-255,1484,147392,9,208408
686,0.001711,172.31.36.0-255,66,147458,9,208408
687,0.001715,74.125.24.0-255,2902,150360,9,208408
688,0.001718,172.31.36.0-255,66,150426,9,208408
689,0.001738,74.125.24.0-255,5738,156164,9,208408
690,0.001741,172.31.36.0-255,66,156230,9,208408
691,0.001762,74.125.24.0-255,2184,158414,9,208408
692,0.001765,172.31.36.0-255,66,158480,9,208408
693,0.001824,74.125.24.0-255,1484,159964,9,208408
694,0.00183,74.125.24.0-255,2902,162866,9,208408
695,0.001833,172.31.36.0-255,66,162932,9,208408
696,0.001838,74.125.24.0-255,2902,165834,9,208408
697,0.001841,172.31.36.0-255,66,165900,9,208408
698,0.001854,74.125.24.0-255,2902,168802,9,208408
699,0.001857,172.31.36.0-255,66,168868,9,208408
700,0.001865,74.125.24.0-255,7156,176024,9,208408
701,0.001868,172.31.36.0-255,66,176090,9,208408
702,0.001894,74.125.24.0-255,5738,181828,9,208408
703,0.001897,172.31.36.0-255,66,181894,9,208408
704,0.0019,74.125.24.0-255,1484,183378,9,208408
705,0.001904,74.125.24.0-255,2902,186280,9,208408
706,0.001907,172.31.36.0-255,66,186346,9,208408
707,0.001913,74.125.24.0-255,4320,190666,9,208408
708,0.001915,172.31.36.0-255,66,190732,9,208408
709,0.001929,74.125.24.0-255,1484,192216,9,208408
710,0.001949,172.31.36.0-255,66,192282,9,208408
711,0.001974,74.125.24.0-255,5020,197302,9,208408
712,0.001978,172.31.36.0-255,66,197368,9,208408
713,0.001992,172.31.36.0-255,66,197434,9,208408
714,0.00203,74.125.24.0-255,4320,201754,9,208408
715,0.002032,172.31.36.0-255,66,201820,9,208408
716,0.002077,172.31.36.0-255,66,201886,9,208408
717,0.002094,172.31.36.0-255,66,201952,9,208408
718,0.002106,172.31.36.0-255,66,202018,9,208408
719,0.002134,172.31.36.0-255,66,202084,9,208408
720,0.002147,172.31.36.0-255,66,202150,9,208408
721,0.002153,74.125.24.0-255,5196,207346,9,208408
722,0.002156,172.31.36.0-255,66,207412,9,208408
723,0.002187,74.125.24.0-255,105,207517,9,208408
724,0.00436,74.125.24.0-255,129,207646,9,208408
725,0.004942,172.31.36.0-255,105,207751,9,208408
726,0.004993,172.31.36.0-255,105,207856,9,208408
727,0.005224,172.31.36.0-255,90,207946,9,208408
728,0.005235,172.31.36.0-255,66,208012,9,208408
729,0.007142,74.125.24.0-255,66,208078,9,208408
730,0.00716,74.125.24.0-255,66,208144,9,208408
731,0.007371,74.125.24.0-255,66,208210,9,208408
732,0.007401,74.125.24.0-255,66,208276,9,208408
733,0.007415,172.31.36.0-255,66,208342,9,208408
734,0.00742,74.125.24.0-255,66,208408,9,208408
735,0.0,74.125.24.0-255,152,152,9,137533
736,1.3e-05,172.31.36.0-255,66,218,9,137533
737,2.6e-05,74.125.24.0-255,1484,1702,9,137533
738,3.1e-05,172.31.36.0-255,66,1768,9,137533
739,4.9e-05,74.125.24.0-255,2902,4670,9,137533
740,5.2e-05,172.31.36.0-255,66,4736,9,137533
741,8.3e-05,74.125.24.0-255,7156,11892,9,137533
742,8.6e-05,172.31.36.0-255,66,11958,9,137533
743,0.000124,172.31.36.0-255,66,12024,9,137533
744,0.000189,74.125.24.0-255,7156,19180,9,137533
745,0.000192,172.31.36.0-255,66,19246,9,137533
746,0.000217,74.125.24.0-255,3961,23207,9,137533
747,0.00022,172.31.36.0-255,66,23273,9,137533
748,0.000545,74.125.24.0-255,1484,24757,9,137533
749,0.00055,172.31.36.0-255,66,24823,9,137533
750,0.000557,74.125.24.0-255,2902,27725,9,137533
751,0.000559,172.31.36.0-255,66,27791,9,137533
752,0.000581,74.125.24.0-255,5738,33529,9,137533
753,0.000584,172.31.36.0-255,66,33595,9,137533
754,0.00062,74.125.24.0-255,5738,39333,9,137533
755,0.000624,172.31.36.0-255,66,39399,9,137533
756,0.00068,74.125.24.0-255,5738,45137,9,137533
757,0.000683,172.31.36.0-255,66,45203,9,137533
758,0.000708,172.31.36.0-255,66,45269,9,137533
759,0.000797,74.125.24.0-255,4229,49498,9,137533
760,0.000801,172.31.36.0-255,66,49564,9,137533
761,0.000823,74.125.24.0-255,417,49981,9,137533
762,0.000826,172.31.36.0-255,66,50047,9,137533
763,0.000918,74.125.24.0-255,1484,51531,9,137533
764,0.000922,172.31.36.0-255,66,51597,9,137533
765,0.000928,74.125.24.0-255,2902,54499,9,137533
766,0.000948,74.125.24.0-255,5738,60237,9,137533
767,0.000953,172.31.36.0-255,66,60303,9,137533
768,0.001008,172.31.36.0-255,66,60369,9,137533
769,0.00102,74.125.24.0-255,1484,61853,9,137533
770,0.001112,74.125.24.0-255,7156,69009,9,137533
771,0.001124,74.125.24.0-255,3602,72611,9,137533
772,0.001128,172.31.36.0-255,66,72677,9,137533
773,0.001159,172.31.36.0-255,66,72743,9,137533
774,0.001453,74.125.24.0-255,1484,74227,9,137533
775,0.001467,74.125.24.0-255,2902,77129,9,137533
776,0.001471,172.31.36.0-255,66,77195,9,137533
777,0.001477,74.125.24.0-255,5738,82933,9,137533
778,0.001479,172.31.36.0-255,66,82999,9,137533
779,0.001541,74.125.24.0-255,4320,87319,9,137533
780,0.001544,172.31.36.0-255,66,87385,9,137533
781,0.001562,74.125.24.0-255,5738,93123,9,137533
782,0.001565,172.31.36.0-255,66,93189,9,137533
783,0.001614,74.125.24.0-255,7156,100345,9,137533
784,0.001617,172.31.36.0-255,66,100411,9,137533
785,0.001638,74.125.24.0-255,4320,104731,9,137533
786,0.00164,172.31.36.0-255,66,104797,9,137533
787,0.001721,74.125.24.0-255,2184,106981,9,137533
788,0.001724,172.31.36.0-255,66,107047,9,137533
789,0.001746,74.125.24.0-255,5738,112785,9,137533
790,0.001753,172.31.36.0-255,66,112851,9,137533
791,0.001786,74.125.24.0-255,2902,115753,9,137533
792,0.001791,172.31.36.0-255,66,115819,9,137533
793,0.001811,74.125.24.0-255,7156,122975,9,137533
794,0.001819,172.31.36.0-255,66,123041,9,137533
795,0.001894,172.31.36.0-255,66,123107,9,137533
796,0.00191,74.125.24.0-255,6438,129545,9,137533
797,0.00193,172.31.36.0-255,66,129611,9,137533
798,0.00206,74.125.24.0-255,2902,132513,9,137533
799,0.002884,74.125.24.0-255,5020,137533,9,137533
800,0.0,172.31.36.0-255,66,66,9,66
801,0.0,172.31.36.0-255,66,66,9,66
802,0.0,74.125.24.0-255,149,149,9,242277
803,3.6e-05,172.31.36.0-255,66,215,9,242277
804,4.4e-05,74.125.24.0-255,1484,1699,9,242277
805,4.8e-05,172.31.36.0-255,66,1765,9,242277
806,5.3e-05,74.125.24.0-255,2902,4667,9,242277
807,5.5e-05,172.31.36.0-255,66,4733,9,242277
808,7.2e-05,74.125.24.0-255,2902,7635,9,242277
809,7.5e-05,172.31.36.0-255,66,7701,9,242277
810,9.9e-05,74.125.24.0-255,1484,9185,9,242277
811,0.000104,74.125.24.0-255,4913,14098,9,242277
812,0.000104,172.31.36.0-255,66,14164,9,242277
813,0.000108,172.31.36.0-255,66,14230,9,242277
814,0.000149,74.125.24.0-255,1484,15714,9,242277
815,0.000152,172.31.36.0-255,66,15780,9,242277
816,0.000175,74.125.24.0-255,2902,18682,9,242277
817,0.000178,172.31.36.0-255,66,18748,9,242277
818,0.000183,74.125.24.0-255,5738,24486,9,242277
819,0.000186,172.31.36.0-255,66,24552,9,242277
820,0.000223,74.125.24.0-255,2902,27454,9,242277
821,0.000226,172.31.36.0-255,66,27520,9,242277
822,0.000243,74.125.24.0-255,3961,31481,9,242277
823,0.000246,172.31.36.0-255,66,31547,9,242277
824,0.000313,74.125.24.0-255,1484,33031,9,242277
825,0.000316,172.31.36.0-255,66,33097,9,242277
826,0.000333,74.125.24.0-255,2902,35999,9,242277
827,0.000336,172.31.36.0-255,66,36065,9,242277
828,0.000341,74.125.24.0-255,2902,38967,9,242277
829,0.000343,172.31.36.0-255,66,39033,9,242277
830,0.000359,74.125.24.0-255,2902,41935,9,242277
831,0.000362,172.31.36.0-255,66,42001,9,242277
832,0.000386,74.125.24.0-255,1484,43485,9,242277
833,0.000389,172.31.36.0-255,66,43551,9,242277
834,0.000412,74.125.24.0-255,5738,49289,9,242277
835,0.000415,172.31.36.0-255,66,49355,9,242277
836,0.00044,74.125.24.0-255,6797,56152,9,242277
837,0.000443,172.31.36.0-255,66,56218,9,242277
838,0.00051,74.125.24.0-255,1484,57702,9,242277
839,0.000518,74.125.24.0-255,4320,62022,9,242277
840,0.000522,172.31.36.0-255,66,62088,9,242277
841,0.000537,74.125.24.0-255,4253,66341,9,242277
842,0.000541,172.31.36.0-255,66,66407,9,242277
843,0.000583,74.125.24.0-255,415,66822,9,242277
844,0.000757,74.125.24.0-255,1484,68306,9,242277
845,0.000762,172.31.36.0-255,66,68372,9,242277
846,0.000777,74.125.24.0-255,2902,71274,9,242277
847,0.000779,172.31.36.0-255,66,71340,9,242277
848,0.000795,74.125.24.0-255,4320,75660,9,242277
849,0.000798,172.31.36.0-255,66,75726,9,242277
850,0.000806,74.125.24.0-255,1484,77210,9,242277
851,0.000834,74.125.24.0-255,4320,81530,9,242277
852,0.000837,172.31.36.0-255,66,81596,9,242277
853,0.000862,172.31.36.0-255,66,81662,9,242277
854,0.00095,74.125.24.0-255,4320,85982,9,242277
855,0.000954,172.31.36.0-255,66,86048,9,242277
856,0.000971,74.125.24.0-255,6438,92486,9,242277
857,0.000974,172.31.36.0-255,66,92552,9,242277
858,0.001044,74.125.24.0-255,7156,99708,9,242277
859,0.001047,172.31.36.0-255,66,99774,9,242277
860,0.001068,74.125.24.0-255,4320,104094,9,242277
861,0.001071,172.31.36.0-255,66,104160,9,242277
862,0.001129,74.125.24.0-255,2902,107062,9,242277
863,0.001132,172.31.36.0-255,66,107128,9,242277
864,0.001173,172.31.36.0-255,66,107194,9,242277
865,0.001328,74.125.24.0-255,7156,114350,9,242277
866,0.001333,172.31.36.0-255,66,114416,9,242277
867,0.001393,74.125.24.0-255,2902,117318,9,242277
868,0.001398,172.31.36.0-255,66,117384,9,242277
869,0.00143,172.31.36.0-255,66,117450,9,242277
870,0.001458,172.31.36.0-255,66,117516,9,242277
871,0.001639,74.125.24.0-255,2902,120418,9,242277
872,0.001643,172.31.36.0-255,66,120484,9,242277
873,0.001674,172.31.36.0-255,66,120550,9,242277
874,0.001688,74.125.24.0-255,2902,123452,9,242277
875,0.001691,172.31.36.0-255,66,123518,9,242277
876,0.001746,74.125.24.0-255,4320,127838,9,242277
877,0.00175,172.31.36.0-255,66,127904,9,242277
878,0.001779,172.31.36.0-255,66,127970,9,242277
879,0.001964,74.125.24.0-255,1484,129454,9,242277
880,0.001974,74.125.24.0-255,2902,132356,9,242277
881,0.001977,172.31.36.0-255,66,132422,9,242277
882,0.001981,74.125.24.0-255,1484,133906,9,242277
883,0.002001,74.125.24.0-255,4320,138226,9,242277
884,0.002004,172.31.36.0-255,66,138292,9,242277
885,0.002021,74.125.24.0-255,4320,142612,9,242277
886,0.002024,172.31.36.0-255,66,142678,9,242277
887,0.00206,172.31.36.0-255,66,142744,9,242277
888,0.002123,74.125.24.0-255,5738,148482,9,242277
889,0.002128,172.31.36.0-255,66,148548,9,242277
890,0.002158,172.31.36.0-255,66,148614,9,242277
891,0.002177,74.125.24.0-255,5738,154352,9,242277
892,0.002181,172.31.36.0-255,66,154418,9,242277
893,0.002203,74.125.24.0-255,2184,156602,9,242277
894,0.002207,172.31.36.0-255,66,156668,9,242277
895,0.002383,172.31.36.0-255,66,156734,9,242277
896,0.002407,74.125.24.0-255,6438,163172,9,242277
897,0.00241,172.31.36.0-255,66,163238,9,242277
898,0.002558,74.125.24.0-255,1484,164722,9,242277
899,0.002563,74.125.24.0-255,1484,166206,9,242277
900,0.002567,172.31.36.0-255,66,166272,9,242277
901,0.002588,74.125.24.0-255,1484,167756,9,242277
902,0.002593,74.125.24.0-255,4320,172076,9,242277
903,0.002597,172.31.36.0-255,66,172142,9,242277
904,0.002611,74.125.24.0-255,1484,173626,9,242277
905,0.002627,74.125.24.0-255,1484,175110,9,242277
906,0.00263,172.31.36.0-255,66,175176,9,242277
907,0.002662,172.31.36.0-255,66,175242,9,242277
908,0.00274,74.125.24.0-255,1484,176726,9,242277
909,0.002755,74.125.24.0-255,1484,178210,9,242277
910,0.002759,172.31.36.0-255,66,178276,9,242277
911,0.002764,74.125.24.0-255,2902,181178,9,242277
912,0.002767,172.31.36.0-255,66,181244,9,242277
913,0.002789,74.125.24.0-255,5020,186264,9,242277
914,0.002792,172.31.36.0-255,66,186330,9,242277
915,0.002829,74.125.24.0-255,2902,189232,9,242277
916,0.002833,172.31.36.0-255,66,189298,9,242277
917,0.002852,74.125.24.0-255,7156,196454,9,242277
918,0.002855,172.31.36.0-255,66,196520,9,242277
919,0.002879,74.125.24.0-255,4320,200840,9,242277
920,0.002883,172.31.36.0-255,66,200906,9,242277
921,0.002965,172.31.36.0-255,66,200972,9,242277
922,0.003007,172.31.36.0-255,66,201038,9,242277
923,0.003217,74.125.24.0-255,7156,208194,9,242277
924,0.003223,172.31.36.0-255,66,208260,9,242277
925,0.00329,172.31.36.0-255,66,208326,9,242277
926,0.003316,172.31.36.0-255,66,208392,9,242277
927,0.003544,74.125.24.0-255,1484,209876,9,242277
928,0.003567,74.125.24.0-255,7156,217032,9,242277
929,0.00357,172.31.36.0-255,66,217098,9,242277
930,0.003587,74.125.24.0-255,2902,220000,9,242277
931,0.00359,172.31.36.0-255,66,220066,9,242277
932,0.003646,74.125.24.0-255,4320,224386,9,242277
933,0.00365,172.31.36.0-255,66,224452,9,242277
934,0.003669,74.125.24.0-255,3602,228054,9,242277
935,0.003672,172.31.36.0-255,66,228120,9,242277
936,0.003713,74.125.24.0-255,2902,231022,9,242277
937,0.003716,172.31.36.0-255,66,231088,9,242277
938,0.003741,74.125.24.0-255,7156,238244,9,242277
939,0.003744,172.31.36.0-255,66,238310,9,242277
940,0.003761,74.125.24.0-255,3559,241869,9,242277
941,0.003763,172.31.36.0-255,66,241935,9,242277
942,0.0038,74.125.24.0-255,105,242040,9,242277
943,0.004489,172.31.36.0-255,66,242106,9,242277
944,0.004524,172.31.36.0-255,105,242211,9,242277
945,0.006642,74.125.24.0-255,66,242277,9,242277
946,0.0,74.125.68.0-255,153,153,9,256025
947,2.9e-05,172.31.36.0-255,66,219,9,256025
948,3.6e-05,74.125.68.0-255,1484,1703,9,256025
949,4.1e-05,172.31.36.0-255,66,1769,9,256025
950,5.3e-05,74.125.68.0-255,2902,4671,9,256025
951,5.6e-05,172.31.36.0-255,66,4737,9,256025
952,6e-05,74.125.68.0-255,2902,7639,9,256025
953,6.3e-05,172.31.36.0-255,66,7705,9,256025
954,6.6e-05,74.125.68.0-255,1484,9189,9,256025
955,6.8e-05,172.31.36.0-255,66,9255,9,256025
956,0.0001,74.125.68.0-255,2902,12157,9,256025
957,0.000103,172.31.36.0-255,66,12223,9,256025
958,0.000114,74.125.68.0-255,1484,13707,9,256025
959,0.000121,172.31.36.0-255,66,13773,9,256025
960,0.000148,172.31.36.0-255,66,13839,9,256025
961,0.00016,172.31.36.0-255,66,13905,9,256025
962,0.000237,74.125.68.0-255,1484,15389,9,256025
963,0.00024,172.31.36.0-255,66,15455,9,256025
964,0.000245,74.125.68.0-255,2902,18357,9,256025
965,0.000247,74.125.68.0-255,1484,19841,9,256025
966,0.000248,172.31.36.0-255,66,19907,9,256025
967,0.000253,172.31.36.0-255,66,19973,9,256025
968,0.000269,74.125.68.0-255,2902,22875,9,256025
969,0.000276,172.31.36.0-255,66,22941,9,256025
970,0.000283,74.125.68.0-255,4320,27261,9,256025
971,0.000286,172.31.36.0-255,66,27327,9,256025
972,0.000316,74.125.68.0-255,1484,28811,9,256025
973,0.000318,172.31.36.0-255,66,28877,9,256025
974,0.000325,74.125.68.0-255,5379,34256,9,256025
975,0.000327,172.31.36.0-255,66,34322,9,256025
976,0.000339,74.125.68.0-255,5738,40060,9,256025
977,0.000342,172.31.36.0-255,66,40126,9,256025
978,0.000376,74.125.68.0-255,7156,47282,9,256025
979,0.00038,172.31.36.0-255,66,47348,9,256025
980,0.000404,74.125.68.0-255,1402,48750,9,256025
981,0.000408,74.125.68.0-255,131,48881,9,256025
982,0.000469,74.125.68.0-255,1484,50365,9,256025
983,0.000473,172.31.36.0-255,66,50431,9,256025
984,0.000479,74.125.68.0-255,2902,53333,9,256025
985,0.000481,172.31.36.0-255,66,53399,9,256025
986,0.000514,74.125.68.0-255,5738,59137,9,256025
987,0.000518,172.31.36.0-255,66,59203,9,256025
988,0.000524,74.125.68.0-255,4320,63523,9,256025
989,0.000527,172.31.36.0-255,66,63589,9,256025
990,0.000537,74.125.68.0-255,2902,66491,9,256025
991,0.000541,172.31.36.0-255,66,66557,9,256025
992,0.000566,74.125.68.0-255,2902,69459,9,256025
993,0.000573,172.31.36.0-255,66,69525,9,256025
994,0.000586,172.31.36.0-255,66,69591,9,256025
995,0.00059,74.125.68.0-255,2184,71775,9,256025
996,0.000593,172.31.36.0-255,66,71841,9,256025
997,0.000797,74.125.68.0-255,1484,73325,9,256025
998,0.000812,74.125.68.0-255,1484,74809,9,256025
999,0.000816,172.31.36.0-255,66,74875,9,256025
1000,0.000843,74.125.68.0-255,1484,76359,9,256025
1001,0.000849,74.125.68.0-255,5738,82097,9,256025
1002,0.000852,172.31.36.0-255,66,82163,9,256025
1003,0.000856,74.125.68.0-255,1484,83647,9,256025
1004,0.000887,172.31.36.0-255,66,83713,9,256025
1005,0.000893,74.125.68.0-255,5738,89451,9,256025
1006,0.000896,172.31.36.0-255,66,89517,9,256025
1007,0.000919,74.125.68.0-255,5738,95255,9,256025
1008,0.000923,172.31.36.0-255,66,95321,9,256025
1009,0.000927,74.125.68.0-255,2184,97505,9,256025
1010,0.000929,172.31.36.0-255,66,97571,9,256025
1011,0.000959,74.125.68.0-255,1484,99055,9,256025
1012,0.000978,74.125.68.0-255,2902,101957,9,256025
1013,0.000981,172.31.36.0-255,66,102023,9,256025
1014,0.000988,74.125.68.0-255,4320,106343,9,256025
1015,0.00099,172.31.36.0-255,66,106409,9,256025
1016,0.001009,74.125.68.0-255,1484,107893,9,256025
1017,0.001016,74.125.68.0-255,4320,112213,9,256025
1018,0.001018,172.31.36.0-255,66,112279,9,256025
1019,0.001031,74.125.68.0-255,5738,118017,9,256025
1020,0.001033,172.31.36.0-255,66,118083,9,256025
1021,0.001075,74.125.68.0-255,5738,123821,9,256025
1022,0.001079,172.31.36.0-255,66,123887,9,256025
1023,0.001108,74.125.68.0-255,5738,129625,9,256025
1024,0.001111,172.31.36.0-255,66,129691,9,256025
1025,0.001115,74.125.68.0-255,2184,131875,9,256025
1026,0.001117,172.31.36.0-255,66,131941,9,256025
1027,0.001214,74.125.68.0-255,1484,133425,9,256025
1028,0.001219,74.125.68.0-255,2902,136327,9,256025
1029,0.001222,172.31.36.0-255,66,136393,9,256025
1030,0.001256,74.125.68.0-255,5738,142131,9,256025
1031,0.001259,172.31.36.0-255,66,142197,9,256025
1032,0.001278,74.125.68.0-255,2902,145099,9,256025
1033,0.001281,172.31.36.0-255,66,145165,9,256025
1034,0.001319,172.31.36.0-255,66,145231,9,256025
1035,0.001325,74.125.68.0-255,4320,149551,9,256025
1036,0.001328,172.31.36.0-255,66,149617,9,256025
1037,0.00136,74.125.68.0-255,6438,156055,9,256025
1038,0.001364,172.31.36.0-255,66,156121,9,256025
1039,0.001572,74.125.68.0-255,1484,157605,9,256025
1040,0.001605,74.125.68.0-255,2902,160507,9,256025
1041,0.001609,172.31.36.0-255,66,160573,9,256025
1042,0.001613,74.125.68.0-255,1484,162057,9,256025
1043,0.001637,74.125.68.0-255,4320,166377,9,256025
1044,0.00164,172.31.36.0-255,66,166443,9,256025
1045,0.001664,74.125.68.0-255,7156,173599,9,256025
1046,0.001667,172.31.36.0-255,66,173665,9,256025
1047,0.001673,74.125.68.0-255,4320,177985,9,256025
1048,0.001675,172.31.36.0-255,66,178051,9,256025
1049,0.001736,74.125.68.0-255,5738,183789,9,256025
1050,0.001741,74.125.68.0-255,4320,188109,9,256025
1051,0.001742,172.31.36.0-255,66,188175,9,256025
1052,0.001746,172.31.36.0-255,66,188241,9,256025
1053,0.001775,74.125.68.0-255,2184,190425,9,256025
1054,0.001778,172.31.36.0-255,66,190491,9,256025
1055,0.001856,74.125.68.0-255,1484,191975,9,256025
1056,0.001869,74.125.68.0-255,1484,193459,9,256025
1057,0.001872,172.31.36.0-255,66,193525,9,256025
1058,0.001876,74.125.68.0-255,1484,195009,9,256025
1059,0.001897,74.125.68.0-255,1484,196493,9,256025
1060,0.0019,172.31.36.0-255,66,196559,9,256025
1061,0.001907,74.125.68.0-255,5738,202297,9,256025
1062,0.00191,172.31.36.0-255,66,202363,9,256025
1063,0.001948,172.31.36.0-255,66,202429,9,256025
1064,0.001977,74.125.68.0-255,5738,208167,9,256025
1065,0.00198,172.31.36.0-255,66,208233,9,256025
1066,0.001999,74.125.68.0-255,4320,212553,9,256025
1067,0.002002,172.31.36.0-255,66,212619,9,256025
1068,0.002025,74.125.68.0-255,1484,214103,9,256025
1069,0.002039,74.125.68.0-255,1484,215587,9,256025
1070,0.002042,172.31.36.0-255,66,215653,9,256025
1071,0.00206,74.125.68.0-255,3602,219255,9,256025
1072,0.002063,172.31.36.0-255,66,219321,9,256025
1073,0.00207,74.125.68.0-255,5738,225059,9,256025
1074,0.002073,172.31.36.0-255,66,225125,9,256025
1075,0.002086,74.125.68.0-255,1484,226609,9,256025
1076,0.002091,74.125.68.0-255,2902,229511,9,256025
1077,0.002098,172.31.36.0-255,66,229577,9,256025
1078,0.002104,74.125.68.0-255,4320,233897,9,256025
1079,0.002107,172.31.36.0-255,66,233963,9,256025
1080,0.002145,74.125.68.0-255,1484,235447,9,256025
1081,0.00216,74.125.68.0-255,2902,238349,9,256025
1082,0.002162,172.31.36.0-255,66,238415,9,256025
1083,0.002166,74.125.68.0-255,1484,239899,9,256025
1084,0.004279,74.125.68.0-255,4320,244219,9,256025
1085,0.004285,172.31.36.0-255,66,244285,9,256025
1086,0.006391,74.125.68.0-255,5738,250023,9,256025
1087,0.006397,172.31.36.0-255,66,250089,9,256025
1088,0.008507,74.125.68.0-255,2902,252991,9,256025
1089,0.00851,172.31.36.0-255,66,253057,9,256025
1090,0.008538,74.125.68.0-255,2902,255959,9,256025
1091,0.00854,172.31.36.0-255,66,256025,9,256025
1092,0.0,74.125.24.0-255,226,226,9,49332
1093,2.4e-05,172.31.36.0-255,66,292,9,49332
1094,3.1e-05,74.125.24.0-255,1484,1776,9,49332
1095,3.6e-05,172.31.36.0-255,66,1842,9,49332
1096,4.3e-05,74.125.24.0-255,4320,6162,9,49332
1097,5.5e-05,172.31.36.0-255,66,6228,9,49332
1098,0.00026,74.125.24.0-255,7156,13384,9,49332
1099,0.000267,172.31.36.0-255,66,13450,9,49332
1100,0.000595,74.125.24.0-255,622,14072,9,49332
1101,0.000601,172.31.36.0-255,66,14138,9,49332
1102,0.000648,74.125.24.0-255,5738,19876,9,49332
1103,0.000651,172.31.36.0-255,66,19942,9,49332
1104,0.00068,74.125.24.0-255,4320,24262,9,49332
1105,0.000683,172.31.36.0-255,66,24328,9,49332
1106,0.001137,74.125.24.0-255,5738,30066,9,49332
1107,0.001144,172.31.36.0-255,66,30132,9,49332
1108,0.001173,74.125.24.0-255,1326,31458,9,49332
1109,0.001177,172.31.36.0-255,66,31524,9,49332
1110,0.003489,74.125.24.0-255,4320,35844,9,49332
1111,0.003499,172.31.36.0-255,66,35910,9,49332
1112,0.003564,74.125.24.0-255,1484,37394,9,49332
1113,0.003568,172.31.36.0-255,66,37460,9,49332
1114,0.005819,74.125.24.0-255,4320,41780,9,49332
1115,0.005827,172.31.36.0-255,66,41846,9,49332
1116,0.005898,74.125.24.0-255,1484,43330,9,49332
1117,0.005901,172.31.36.0-255,66,43396,9,49332
1118,0.008214,74.125.24.0-255,2902,46298,9,49332
1119,0.008227,172.31.36.0-255,66,46364,9,49332
1120,0.008261,74.125.24.0-255,2902,49266,9,49332
1121,0.008264,172.31.36.0-255,66,49332,9,49332
1122,0.0,74.125.24.0-255,150,150,9,226522
1123,1.4e-05,172.31.36.0-255,66,216,9,226522
1124,2e-05,74.125.24.0-255,1484,1700,9,226522
1125,2.4e-05,172.31.36.0-255,66,1766,9,226522
1126,4.3e-05,74.125.24.0-255,2902,4668,9,226522
1127,4.6e-05,172.31.36.0-255,66,4734,9,226522
1128,5.2e-05,74.125.24.0-255,4320,9054,9,226522
1129,5.4e-05,172.31.36.0-255,66,9120,9,226522
1130,7.6e-05,74.125.24.0-255,2902,12022,9,226522
1131,7.8e-05,172.31.36.0-255,66,12088,9,226522
1132,8.3e-05,74.125.24.0-255,2031,14119,9,226522
1133,8.6e-05,172.31.36.0-255,66,14185,9,226522
1134,8.9e-05,74.125.24.0-255,1484,15669,9,226522
1135,9.2e-05,172.31.36.0-255,66,15735,9,226522
1136,0.000127,172.31.36.0-255,66,15801,9,226522
1137,0.000139,172.31.36.0-255,66,15867,9,226522
1138,0.000159,74.125.24.0-255,2902,18769,9,226522
1139,0.000161,172.31.36.0-255,66,18835,9,226522
1140,0.000199,74.125.24.0-255,2902,21737,9,226522
1141,0.000201,172.31.36.0-255,66,21803,9,226522
1142,0.00022,74.125.24.0-255,6438,28241,9,226522
1143,0.000223,172.31.36.0-255,66,28307,9,226522
1144,0.000283,74.125.24.0-255,1484,29791,9,226522
1145,0.000287,172.31.36.0-255,66,29857,9,226522
1146,0.000294,74.125.24.0-255,2902,32759,9,226522
1147,0.000296,172.31.36.0-255,66,32825,9,226522
1148,0.000299,74.125.24.0-255,1484,34309,9,226522
1149,0.000302,172.31.36.0-255,66,34375,9,226522
1150,0.000325,74.125.24.0-255,4320,38695,9,226522
1151,0.000327,172.31.36.0-255,66,38761,9,226522
1152,0.000335,74.125.24.0-255,7107,45868,9,226522
1153,0.000338,172.31.36.0-255,66,45934,9,226522
1154,0.000341,74.125.24.0-255,110,46044,9,226522
1155,0.000396,74.125.24.0-255,1484,47528,9,226522
1156,0.000399,172.31.36.0-255,66,47594,9,226522
1157,0.000404,74.125.24.0-255,2902,50496,9,226522
1158,0.000406,172.31.36.0-255,66,50562,9,226522
1159,0.000434,74.125.24.0-255,2902,53464,9,226522
1160,0.000437,172.31.36.0-255,66,53530,9,226522
1161,0.000456,74.125.24.0-255,4320,57850,9,226522
1162,0.000458,172.31.36.0-255,66,57916,9,226522
1163,0.000463,74.125.24.0-255,2902,60818,9,226522
1164,0.000465,172.31.36.0-255,66,60884,9,226522
1165,0.000483,74.125.24.0-255,2902,63786,9,226522
1166,0.000486,172.31.36.0-255,66,63852,9,226522
1167,0.000492,74.125.24.0-255,4320,68172,9,226522
1168,0.000494,172.31.36.0-255,66,68238,9,226522
1169,0.000523,172.31.36.0-255,66,68304,9,226522
1170,0.000568,74.125.24.0-255,2184,70488,9,226522
1171,0.000571,172.31.36.0-255,66,70554,9,226522
1172,0.000582,74.125.24.0-255,1484,72038,9,226522
1173,0.000593,74.125.24.0-255,1484,73522,9,226522
1174,0.000595,172.31.36.0-255,66,73588,9,226522
1175,0.000613,74.125.24.0-255,1484,75072,9,226522
1176,0.000618,74.125.24.0-255,2902,77974,9,226522
1177,0.00062,172.31.36.0-255,66,78040,9,226522
1178,0.000638,74.125.24.0-255,2902,80942,9,226522
1179,0.000641,172.31.36.0-255,66,81008,9,226522
1180,0.000658,74.125.24.0-255,4320,85328,9,226522
1181,0.000661,172.31.36.0-255,66,85394,9,226522
1182,0.000693,74.125.24.0-255,5738,91132,9,226522
1183,0.000696,172.31.36.0-255,66,91198,9,226522
1184,0.000711,172.31.36.0-255,66,91264,9,226522
1185,0.000754,74.125.24.0-255,1484,92748,9,226522
1186,0.000759,74.125.24.0-255,2902,95650,9,226522
1187,0.000762,172.31.36.0-255,66,95716,9,226522
1188,0.000779,74.125.24.0-255,5738,101454,9,226522
1189,0.000782,172.31.36.0-255,66,101520,9,226522
1190,0.000803,74.125.24.0-255,5738,107258,9,226522
1191,0.000806,172.31.36.0-255,66,107324,9,226522
1192,0.000833,74.125.24.0-255,7156,114480,9,226522
1193,0.000836,172.31.36.0-255,66,114546,9,226522
1194,0.000847,172.31.36.0-255,66,114612,9,226522
1195,0.000871,74.125.24.0-255,2184,116796,9,226522
1196,0.000875,172.31.36.0-255,66,116862,9,226522
1197,0.000929,74.125.24.0-255,1484,118346,9,226522
1198,0.000934,74.125.24.0-255,2902,121248,9,226522
1199,0.000937,172.31.36.0-255,66,121314,9,226522
1200,0.000959,74.125.24.0-255,5738,127052,9,226522
1201,0.000961,172.31.36.0-255,66,127118,9,226522
1202,0.000982,74.125.24.0-255,5738,132856,9,226522
1203,0.000985,172.31.36.0-255,66,132922,9,226522
1204,0.00101,74.125.24.0-255,4320,137242,9,226522
1205,0.001013,172.31.36.0-255,66,137308,9,226522
1206,0.001026,172.31.36.0-255,66,137374,9,226522
1207,0.00103,74.125.24.0-255,2184,139558,9,226522
1208,0.001032,172.31.36.0-255,66,139624,9,226522
1209,0.001036,74.125.24.0-255,2902,142526,9,226522
1210,0.001038,172.31.36.0-255,66,142592,9,226522
1211,0.001041,74.125.24.0-255,1484,144076,9,226522
1212,0.001065,74.125.24.0-255,5738,149814,9,226522
1213,0.001067,172.31.36.0-255,66,149880,9,226522
1214,0.001072,74.125.24.0-255,2902,152782,9,226522
1215,0.001074,172.31.36.0-255,66,152848,9,226522
1216,0.001106,172.31.36.0-255,66,152914,9,226522
1217,0.00111,74.125.24.0-255,2902,155816,9,226522
1218,0.001112,172.31.36.0-255,66,155882,9,226522
1219,0.001147,172.31.36.0-255,66,155948,9,226522
1220,0.001172,74.125.24.0-255,766,156714,9,226522
1221,0.00119,172.31.36.0-255,66,156780,9,226522
1222,0.001205,172.31.36.0-255,66,156846,9,226522
1223,0.001239,74.125.24.0-255,1484,158330,9,226522
1224,0.001244,74.125.24.0-255,2902,161232,9,226522
1225,0.001248,172.31.36.0-255,66,161298,9,226522
1226,0.001267,74.125.24.0-255,5738,167036,9,226522
1227,0.001269,172.31.36.0-255,66,167102,9,226522
1228,0.001326,74.125.24.0-255,6483,173585,9,226522
1229,0.001338,172.31.36.0-255,66,173651,9,226522
1230,0.001341,172.31.36.0-255,66,173717,9,226522
1231,0.001359,74.125.24.0-255,5738,179455,9,226522
1232,0.001362,172.31.36.0-255,66,179521,9,226522
1233,0.001366,74.125.24.0-255,2902,182423,9,226522
1234,0.001369,172.31.36.0-255,66,182489,9,226522
1235,0.001395,74.125.24.0-255,4320,186809,9,226522
1236,0.001398,172.31.36.0-255,66,186875,9,226522
1237,0.001415,74.125.24.0-255,2902,189777,9,226522
1238,0.001417,172.31.36.0-255,66,189843,9,226522
1239,0.001442,172.31.36.0-255,66,189909,9,226522
1240,0.001526,74.125.24.0-255,1484,191393,9,226522
1241,0.001532,74.125.24.0-255,2902,194295,9,226522
1242,0.001535,172.31.36.0-255,66,194361,9,226522
1243,0.001554,74.125.24.0-255,5738,200099,9,226522
1244,0.001557,172.31.36.0-255,66,200165,9,226522
1245,0.001578,74.125.24.0-255,5738,205903,9,226522
1246,0.001581,172.31.36.0-255,66,205969,9,226522
1247,0.001616,74.125.24.0-255,7156,213125,9,226522
1248,0.001619,172.31.36.0-255,66,213191,9,226522
1249,0.001631,172.31.36.0-255,66,213257,9,226522
1250,0.001652,74.125.24.0-255,4320,217577,9,226522
1251,0.001656,172.31.36.0-255,66,217643,9,226522
1252,0.001673,172.31.36.0-255,66,217709,9,226522
1253,0.001694,74.125.24.0-255,6438,224147,9,226522
1254,0.001697,172.31.36.0-255,66,224213,9,226522
1255,0.0017,74.125.24.0-255,1484,225697,9,226522
1256,0.001725,172.31.36.0-255,66,225763,9,226522
1257,0.001774,172.31.36.0-255,66,225829,9,226522
1258,0.001796,172.31.36.0-255,66,225895,9,226522
1259,0.001798,74.125.24.0-255,456,226351,9,226522
1260,0.001819,74.125.24.0-255,105,226456,9,226522
1261,0.008785,172.31.36.0-255,66,226522,9,226522
1262,0.0,74.125.24.0-255,153,153,9,109367
1263,1.6e-05,172.31.36.0-255,66,219,9,109367
1264,2.3e-05,74.125.24.0-255,1484,1703,9,109367
1265,2.8e-05,172.31.36.0-255,66,1769,9,109367
1266,3.4e-05,74.125.24.0-255,2902,4671,9,109367
1267,3.8e-05,172.31.36.0-255,66,4737,9,109367
1268,4.7e-05,74.125.24.0-255,7156,11893,9,109367
1269,5.1e-05,172.31.36.0-255,66,11959,9,109367
1270,7.7e-05,74.125.24.0-255,2035,13994,9,109367
1271,7.9e-05,172.31.36.0-255,66,14060,9,109367
1272,0.000354,74.125.24.0-255,1484,15544,9,109367
1273,0.000359,172.31.36.0-255,66,15610,9,109367
1274,0.000366,74.125.24.0-255,2902,18512,9,109367
1275,0.000369,172.31.36.0-255,66,18578,9,109367
1276,0.000395,74.125.24.0-255,5738,24316,9,109367
1277,0.000398,172.31.36.0-255,66,24382,9,109367
1278,0.000405,74.125.24.0-255,5738,30120,9,109367
1279,0.000407,172.31.36.0-255,66,30186,9,109367
1280,0.00043,74.125.24.0-255,1125,31311,9,109367
1281,0.000432,172.31.36.0-255,66,31377,9,109367
1282,0.000533,74.125.24.0-255,1484,32861,9,109367
1283,0.000537,172.31.36.0-255,66,32927,9,109367
1284,0.000566,74.125.24.0-255,2902,35829,9,109367
1285,0.00057,172.31.36.0-255,66,35895,9,109367
1286,0.000608,74.125.24.0-255,5738,41633,9,109367
1287,0.000612,172.31.36.0-255,66,41699,9,109367
1288,0.000615,74.125.24.0-255,1484,43183,9,109367
1289,0.000617,172.31.36.0-255,66,43249,9,109367
1290,0.000626,74.125.24.0-255,7156,50405,9,109367
1291,0.000629,172.31.36.0-255,66,50471,9,109367
1292,0.000643,74.125.24.0-255,2543,53014,9,109367
1293,0.00065,74.125.24.0-255,7156,60170,9,109367
1294,0.000658,172.31.36.0-255,66,60236,9,109367
1295,0.000667,74.125.24.0-255,5379,65615,9,109367
1296,0.000672,172.31.36.0-255,66,65681,9,109367
1297,0.000941,74.125.24.0-255,412,66093,9,109367
1298,0.00098,74.125.24.0-255,330,66423,9,109367
1299,0.0011,172.31.36.0-255,66,66489,9,109367
1300,0.00154,74.125.24.0-255,1484,67973,9,109367
1301,0.001551,74.125.24.0-255,2902,70875,9,109367
1302,0.001556,172.31.36.0-255,66,70941,9,109367
1303,0.001565,74.125.24.0-255,5738,76679,9,109367
1304,0.001567,172.31.36.0-255,66,76745,9,109367
1305,0.00157,74.125.24.0-255,1484,78229,9,109367
1306,0.001615,74.125.24.0-255,5738,83967,9,109367
1307,0.001626,74.125.24.0-255,1484,85451,9,109367
1308,0.001644,74.125.24.0-255,6438,91889,9,109367
1309,0.002903,172.31.36.0-255,66,91955,9,109367
1310,0.005155,74.125.24.0-255,5738,97693,9,109367
1311,0.005168,172.31.36.0-255,66,97759,9,109367
1312,0.007437,74.125.24.0-255,5738,103497,9,109367
1313,0.007444,172.31.36.0-255,66,103563,9,109367
1314,0.009732,74.125.24.0-255,5738,109301,9,109367
1315,0.009739,172.31.36.0-255,66,109367,9,109367
1316,0.0,74.125.24.0-255,153,153,9,86789
1317,1.6e-05,172.31.36.0-255,66,219,9,86789
1318,2.2e-05,74.125.24.0-255,1484,1703,9,86789
1319,2.6e-05,172.31.36.0-255,66,1769,9,86789
1320,3.3e-05,74.125.24.0-255,2902,4671,9,86789
1321,4.4e-05,172.31.36.0-255,66,4737,9,86789
1322,5.2e-05,74.125.24.0-255,7156,11893,9,86789
1323,5.5e-05,172.31.36.0-255,66,11959,9,86789
1324,5.9e-05,74.125.24.0-255,2029,13988,9,86789
1325,6.2e-05,172.31.36.0-255,66,14054,9,86789
1326,9.7e-05,74.125.24.0-255,2902,16956,9,86789
1327,0.000101,172.31.36.0-255,66,17022,9,86789
1328,0.000107,74.125.24.0-255,4320,21342,9,86789
1329,0.00011,172.31.36.0-255,66,21408,9,86789
1330,0.000135,74.125.24.0-255,5738,27146,9,86789
1331,0.000138,172.31.36.0-255,66,27212,9,86789
1332,0.000167,74.125.24.0-255,3961,31173,9,86789
1333,0.000169,172.31.36.0-255,66,31239,9,86789
1334,0.000303,74.125.24.0-255,1484,32723,9,86789
1335,0.000308,172.31.36.0-255,66,32789,9,86789
1336,0.000314,74.125.24.0-255,2902,35691,9,86789
1337,0.000316,172.31.36.0-255,66,35757,9,86789
1338,0.000352,74.125.24.0-255,5738,41495,9,86789
1339,0.000355,172.31.36.0-255,66,41561,9,86789
1340,0.000383,74.125.24.0-255,6797,48358,9,86789
1341,0.000386,172.31.36.0-255,66,48424,9,86789
1342,0.00039,74.125.24.0-255,2902,51326,9,86789
1343,0.000392,172.31.36.0-255,66,51392,9,86789
1344,0.000416,74.125.24.0-255,4320,55712,9,86789
1345,0.000419,172.31.36.0-255,66,55778,9,86789
1346,0.000431,172.31.36.0-255,66,55844,9,86789
1347,0.001087,74.125.24.0-255,108,55952,9,86789
1348,0.001148,74.125.24.0-255,333,56285,9,86789
1349,0.001332,74.125.24.0-255,1484,57769,9,86789
1350,0.001338,172.31.36.0-255,66,57835,9,86789
1351,0.001344,74.125.24.0-255,2902,60737,9,86789
1352,0.001369,74.125.24.0-255,5738,66475,9,86789
1353,0.001386,74.125.24.0-255,4320,70795,9,86789
1354,0.001406,74.125.24.0-255,5738,76533,9,86789
1355,0.001423,74.125.24.0-255,2902,79435,9,86789
1356,0.001446,74.125.24.0-255,1484,80919,9,86789
1357,0.005686,172.31.36.0-255,66,80985,9,86789
1358,0.008211,74.125.24.0-255,5738,86723,9,86789
1359,0.008219,172.31.36.0-255,66,86789,9,86789
1360,0.0,172.31.36.0-255,105,105,9,459
1361,0.000182,172.31.36.0-255,90,195,9,459
1362,0.000191,172.31.36.0-255,66,261,9,459
1363,0.002155,74.125.130.0-255,66,327,9,459
1364,0.002171,74.125.130.0-255,66,393,9,459
1365,0.002182,172.31.36.0-255,66,459,9,459
1366,0.0,74.125.24.0-255,150,150,9,201137
1367,2.3e-05,172.31.36.0-255,66,216,9,201137
1368,3.1e-05,74.125.24.0-255,1484,1700,9,201137
1369,3.6e-05,172.31.36.0-255,66,1766,9,201137
1370,4.2e-05,74.125.24.0-255,2902,4668,9,201137
1371,4.6e-05,172.31.36.0-255,66,4734,9,201137
1372,5.3e-05,74.125.24.0-255,5738,10472,9,201137
1373,5.6e-05,172.31.36.0-255,66,10538,9,201137
1374,0.000101,172.31.36.0-255,66,10604,9,201137
1375,0.000108,74.125.24.0-255,6797,17401,9,201137
1376,0.000111,172.31.36.0-255,66,17467,9,201137
1377,0.000161,74.125.24.0-255,1484,18951,9,201137
1378,0.000163,172.31.36.0-255,66,19017,9,201137
1379,0.000169,74.125.24.0-255,2902,21919,9,201137
1380,0.00017,172.31.36.0-255,66,21985,9,201137
1381,0.000193,74.125.24.0-255,2902,24887,9,201137
1382,0.000195,172.31.36.0-255,66,24953,9,201137
1383,0.0002,74.125.24.0-255,4320,29273,9,201137
1384,0.000203,172.31.36.0-255,66,29339,9,201137
1385,0.000207,74.125.24.0-255,1484,30823,9,201137
1386,0.000208,172.31.36.0-255,66,30889,9,201137
1387,0.000243,74.125.24.0-255,7156,38045,9,201137
1388,0.000246,172.31.36.0-255,66,38111,9,201137
1389,0.000257,172.31.36.0-255,66,38177,9,201137
1390,0.000295,74.125.24.0-255,5323,43500,9,201137
1391,0.000299,172.31.36.0-255,66,43566,9,201137
1392,0.000316,74.125.24.0-255,374,43940,9,201137
1393,0.000318,172.31.36.0-255,66,44006,9,201137
1394,0.000595,74.125.24.0-255,1484,45490,9,201137
1395,0.0006,172.31.36.0-255,66,45556,9,201137
1396,0.000607,74.125.24.0-255,2902,48458,9,201137
1397,0.00061,172.31.36.0-255,66,48524,9,201137
1398,0.00063,74.125.24.0-255,4320,52844,9,201137
1399,0.000635,172.31.36.0-255,66,52910,9,201137
1400,0.000654,74.125.24.0-255,1484,54394,9,201137
1401,0.000663,74.125.24.0-255,5738,60132,9,201137
1402,0.000666,172.31.36.0-255,66,60198,9,201137
1403,0.000669,74.125.24.0-255,1484,61682,9,201137
1404,0.000695,172.31.36.0-255,66,61748,9,201137
1405,0.000718,74.125.24.0-255,5020,66768,9,201137
1406,0.000721,172.31.36.0-255,66,66834,9,201137
1407,0.000806,74.125.24.0-255,1484,68318,9,201137
1408,0.000823,74.125.24.0-255,2902,71220,9,201137
1409,0.000826,172.31.36.0-255,66,71286,9,201137
1410,0.00083,74.125.24.0-255,1484,72770,9,201137
1411,0.000846,74.125.24.0-255,4320,77090,9,201137
1412,0.00085,172.31.36.0-255,66,77156,9,201137
1413,0.000866,74.125.24.0-255,2902,80058,9,201137
1414,0.000869,172.31.36.0-255,66,80124,9,201137
1415,0.000893,74.125.24.0-255,3412,83536,9,201137
1416,0.000896,172.31.36.0-255,66,83602,9,201137
1417,0.000917,74.125.24.0-255,2902,86504,9,201137
1418,0.00092,172.31.36.0-255,66,86570,9,201137
1419,0.000937,74.125.24.0-255,1484,88054,9,201137
1420,0.00094,74.125.24.0-255,1484,89538,9,201137
1421,0.000942,172.31.36.0-255,66,89604,9,201137
1422,0.000976,172.31.36.0-255,66,89670,9,201137
1423,0.000981,74.125.24.0-255,4320,93990,9,201137
1424,0.000983,172.31.36.0-255,66,94056,9,201137
1425,0.001028,74.125.24.0-255,4320,98376,9,201137
1426,0.001031,172.31.36.0-255,66,98442,9,201137
1427,0.001063,172.31.36.0-255,66,98508,9,201137
1428,0.001243,74.125.24.0-255,1484,99992,9,201137
1429,0.001281,74.125.24.0-255,1484,101476,9,201137
1430,0.001284,172.31.36.0-255,66,101542,9,201137
1431,0.00129,74.125.24.0-255,2902,104444,9,201137
1432,0.001292,172.31.36.0-255,66,104510,9,201137
1433,0.001328,74.125.24.0-255,1484,105994,9,201137
1434,0.001342,74.125.24.0-255,2902,108896,9,201137
1435,0.001345,172.31.36.0-255,66,108962,9,201137
1436,0.001384,74.125.24.0-255,1484,110446,9,201137
1437,0.001397,74.125.24.0-255,2902,113348,9,201137
1438,0.001399,172.31.36.0-255,66,113414,9,201137
1439,0.001403,74.125.24.0-255,1484,114898,9,201137
1440,0.001438,74.125.24.0-255,2902,117800,9,201137
1441,0.001441,172.31.36.0-255,66,117866,9,201137
1442,0.001461,74.125.24.0-255,2902,120768,9,201137
1443,0.001463,172.31.36.0-255,66,120834,9,201137
1444,0.001469,74.125.24.0-255,4320,125154,9,201137
1445,0.001471,172.31.36.0-255,66,125220,9,201137
1446,0.001485,74.125.24.0-255,4320,129540,9,201137
1447,0.001488,172.31.36.0-255,66,129606,9,201137
1448,0.001507,74.125.24.0-255,1484,131090,9,201137
1449,0.00152,74.125.24.0-255,2184,133274,9,201137
1450,0.001522,172.31.36.0-255,66,133340,9,201137
1451,0.001789,74.125.24.0-255,1484,134824,9,201137
1452,0.001806,74.125.24.0-255,2902,137726,9,201137
1453,0.001808,74.125.24.0-255,1484,139210,9,201137
1454,0.001813,172.31.36.0-255,66,139276,9,201137
1455,0.001827,74.125.24.0-255,2902,142178,9,201137
1456,0.001829,172.31.36.0-255,66,142244,9,201137
1457,0.001835,74.125.24.0-255,5738,147982,9,201137
1458,0.001837,172.31.36.0-255,66,148048,9,201137
1459,0.001862,74.125.24.0-255,1484,149532,9,201137
1460,0.001883,74.125.24.0-255,7156,156688,9,201137
1461,0.001886,172.31.36.0-255,66,156754,9,201137
1462,0.001901,74.125.24.0-255,2902,159656,9,201137
1463,0.001904,172.31.36.0-255,66,159722,9,201137
1464,0.001917,172.31.36.0-255,66,159788,9,201137
1465,0.001925,74.125.24.0-255,7156,166944,9,201137
1466,0.001928,172.31.36.0-255,66,167010,9,201137
1467,0.001954,74.125.24.0-255,5738,172748,9,201137
1468,0.001957,172.31.36.0-255,66,172814,9,201137
1469,0.001979,74.125.24.0-255,5738,178552,9,201137
1470,0.001982,172.31.36.0-255,66,178618,9,201137
1471,0.002097,172.31.36.0-255,66,178684,9,201137
1472,0.002111,74.125.24.0-255,2184,180868,9,201137
1473,0.002185,74.125.24.0-255,4320,185188,9,201137
1474,0.002289,74.125.24.0-255,7156,192344,9,201137
1475,0.002341,74.125.24.0-255,4320,196664,9,201137
1476,0.002388,74.125.24.0-255,3351,200015,9,201137
1477,0.008317,172.31.36.0-255,66,200081,9,201137
1478,0.008324,172.31.36.0-255,66,200147,9,201137
1479,0.008328,172.31.36.0-255,66,200213,9,201137
1480,0.00833,172.31.36.0-255,66,200279,9,201137
1481,0.008343,172.31.36.0-255,66,200345,9,201137
1482,0.008347,172.31.36.0-255,66,200411,9,201137
1483,0.00835,172.31.36.0-255,66,200477,9,201137
1484,0.008354,172.31.36.0-255,66,200543,9,201137
1485,0.008357,172.31.36.0-255,66,200609,9,201137
1486,0.00836,172.31.36.0-255,66,200675,9,201137
1487,0.008363,172.31.36.0-255,66,200741,9,201137
1488,0.008367,172.31.36.0-255,66,200807,9,201137
1489,0.00837,172.31.36.0-255,66,200873,9,201137
1490,0.008373,172.31.36.0-255,66,200939,9,201137
1491,0.008377,172.31.36.0-255,66,201005,9,201137
1492,0.00838,172.31.36.0-255,66,201071,9,201137
1493,0.008383,172.31.36.0-255,66,201137,9,201137
1494,0.0,74.125.130.0-255,153,153,9,186990
1495,3.3e-05,172.31.36.0-255,66,219,9,186990
1496,4e-05,74.125.130.0-255,1484,1703,9,186990
1497,4.4e-05,172.31.36.0-255,66,1769,9,186990
1498,5e-05,74.125.130.0-255,2902,4671,9,186990
1499,5.3e-05,172.31.36.0-255,66,4737,9,186990
1500,5.9e-05,74.125.130.0-255,4320,9057,9,186990
1501,6.2e-05,172.31.36.0-255,66,9123,9,186990
1502,7.9e-05,74.125.130.0-255,1484,10607,9,186990
1503,8.2e-05,172.31.36.0-255,66,10673,9,186990
1504,8.5e-05,74.125.130.0-255,1484,12157,9,186990
1505,8.7e-05,172.31.36.0-255,66,12223,9,186990
1506,0.000123,74.125.130.0-255,2036,14259,9,186990
1507,0.000126,172.31.36.0-255,66,14325,9,186990
1508,0.000394,74.125.130.0-255,1484,15809,9,186990
1509,0.000398,172.31.36.0-255,66,15875,9,186990
1510,0.000405,74.125.130.0-255,2902,18777,9,186990
1511,0.000407,172.31.36.0-255,66,18843,9,186990
1512,0.000437,74.125.130.0-255,5738,24581,9,186990
1513,0.00044,74.125.130.0-255,1484,26065,9,186990
1514,0.000442,172.31.36.0-255,66,26131,9,186990
1515,0.000445,172.31.36.0-255,66,26197,9,186990
1516,0.000454,74.125.130.0-255,5379,31576,9,186990
1517,0.000457,172.31.36.0-255,66,31642,9,186990
1518,0.000472,74.125.130.0-255,1484,33126,9,186990
1519,0.000475,172.31.36.0-255,66,33192,9,186990
1520,0.000495,74.125.130.0-255,2902,36094,9,186990
1521,0.000498,172.31.36.0-255,66,36160,9,186990
1522,0.000532,74.125.130.0-255,5738,41898,9,186990
1523,0.000536,172.31.36.0-255,66,41964,9,186990
1524,0.000542,74.125.130.0-255,4320,46284,9,186990
1525,0.000545,172.31.36.0-255,66,46350,9,186990
1526,0.000576,74.125.130.0-255,2543,48893,9,186990
1527,0.00058,172.31.36.0-255,66,48959,9,186990
1528,0.000789,74.125.130.0-255,1484,50443,9,186990
1529,0.000799,74.125.130.0-255,2902,53345,9,186990
1530,0.000802,172.31.36.0-255,66,53411,9,186990
1531,0.000829,74.125.130.0-255,5738,59149,9,186990
1532,0.000834,74.125.130.0-255,2902,62051,9,186990
1533,0.000838,74.125.130.0-255,3961,66012,9,186990
1534,0.000859,172.31.36.0-255,66,66078,9,186990
1535,0.001,74.125.130.0-255,1484,67562,9,186990
1536,0.001007,74.125.130.0-255,2902,70464,9,186990
1537,0.001021,74.125.130.0-255,1484,71948,9,186990
1538,0.001045,74.125.130.0-255,4320,76268,9,186990
1539,0.001062,74.125.130.0-255,4320,80588,9,186990
1540,0.001075,172.31.36.0-255,66,80654,9,186990
1541,0.00108,74.125.130.0-255,2833,83487,9,186990
1542,0.001084,74.125.130.0-255,2902,86389,9,186990
1543,0.001096,74.125.130.0-255,1484,87873,9,186990
1544,0.001102,172.31.36.0-255,66,87939,9,186990
1545,0.001114,74.125.130.0-255,2902,90841,9,186990
1546,0.00113,74.125.130.0-255,2902,93743,9,186990
1547,0.001138,74.125.130.0-255,6797,100540,9,186990
1548,0.001163,172.31.36.0-255,66,100606,9,186990
1549,0.001224,74.125.130.0-255,1484,102090,9,186990
1550,0.001229,74.125.130.0-255,1484,103574,9,186990
1551,0.001235,172.31.36.0-255,66,103640,9,186990
1552,0.001252,74.125.130.0-255,1484,105124,9,186990
1553,0.001258,74.125.130.0-255,5738,110862,9,186990
1554,0.001279,74.125.130.0-255,1484,112346,9,186990
1555,0.001298,172.31.36.0-255,66,112412,9,186990
1556,0.001305,74.125.130.0-255,5738,118150,9,186990
1557,0.00131,74.125.130.0-255,2902,121052,9,186990
1558,0.001316,172.31.36.0-255,66,121118,9,186990
1559,0.001329,74.125.130.0-255,5738,126856,9,186990
1560,0.001333,74.125.130.0-255,4320,131176,9,186990
1561,0.001382,74.125.130.0-255,3602,134778,9,186990
1562,0.001387,172.31.36.0-255,66,134844,9,186990
1563,0.001399,172.31.36.0-255,66,134910,9,186990
1564,0.001492,74.125.130.0-255,1484,136394,9,186990
1565,0.001496,74.125.130.0-255,1484,137878,9,186990
1566,0.001508,74.125.130.0-255,1484,139362,9,186990
1567,0.001512,172.31.36.0-255,66,139428,9,186990
1568,0.001535,74.125.130.0-255,5738,145166,9,186990
1569,0.001537,74.125.130.0-255,1484,146650,9,186990
1570,0.001552,74.125.130.0-255,5738,152388,9,186990
1571,0.001571,74.125.130.0-255,2902,155290,9,186990
1572,0.001575,74.125.130.0-255,2902,158192,9,186990
1573,0.001578,172.31.36.0-255,66,158258,9,186990
1574,0.001584,172.31.36.0-255,66,158324,9,186990
1575,0.0016,74.125.130.0-255,5738,164062,9,186990
1576,0.001628,172.31.36.0-255,66,164128,9,186990
1577,0.001639,74.125.130.0-255,5318,169446,9,186990
1578,0.001651,172.31.36.0-255,66,169512,9,186990
1579,0.00379,74.125.130.0-255,5738,175250,9,186990
1580,0.003796,172.31.36.0-255,66,175316,9,186990
1581,0.005947,74.125.130.0-255,1484,176800,9,186990
1582,0.005969,74.125.130.0-255,4320,181120,9,186990
1583,0.005973,172.31.36.0-255,66,181186,9,186990
1584,0.008129,74.125.130.0-255,5738,186924,9,186990
1585,0.008134,172.31.36.0-255,66,186990,9,186990
1586,0.0,172.31.36.0-255,105,105,9,105
1587,0.0,74.125.24.0-255,153,153,9,261665
1588,2.6e-05,74.125.24.0-255,1484,1637,9,261665
1589,3.3e-05,172.31.36.0-255,66,1703,9,261665
1590,4.1e-05,74.125.24.0-255,2902,4605,9,261665
1591,4.4e-05,172.31.36.0-255,66,4671,9,261665
1592,4.9e-05,74.125.24.0-255,2902,7573,9,261665
1593,5.1e-05,172.31.36.0-255,66,7639,9,261665
1594,7.3e-05,74.125.24.0-255,4320,11959,9,261665
1595,7.5e-05,172.31.36.0-255,66,12025,9,261665
1596,8e-05,74.125.24.0-255,2035,14060,9,261665
1597,8.4e-05,172.31.36.0-255,66,14126,9,261665
1598,0.000207,74.125.24.0-255,1484,15610,9,261665
1599,0.000213,74.125.24.0-255,2902,18512,9,261665
1600,0.000217,172.31.36.0-255,66,18578,9,261665
1601,0.000242,74.125.24.0-255,5738,24316,9,261665
1602,0.000245,172.31.36.0-255,66,24382,9,261665
1603,0.000275,74.125.24.0-255,4320,28702,9,261665
1604,0.000278,172.31.36.0-255,66,28768,9,261665
1605,0.000291,74.125.24.0-255,2543,31311,9,261665
1606,0.000295,172.31.36.0-255,66,31377,9,261665
1607,0.000705,74.125.24.0-255,1484,32861,9,261665
1608,0.000715,74.125.24.0-255,2902,35763,9,261665
1609,0.000719,172.31.36.0-255,66,35829,9,261665
1610,0.000743,74.125.24.0-255,4320,40149,9,261665
1611,0.000747,172.31.36.0-255,66,40215,9,261665
1612,0.000763,74.125.24.0-255,1484,41699,9,261665
1613,0.000771,74.125.24.0-255,6797,48496,9,261665
1614,0.000774,172.31.36.0-255,66,48562,9,261665
1615,0.000811,74.125.24.0-255,7156,55718,9,261665
1616,0.000815,172.31.36.0-255,66,55784,9,261665
1617,0.000838,74.125.24.0-255,7156,62940,9,261665
1618,0.00084,172.31.36.0-255,66,63006,9,261665
1619,0.000845,74.125.24.0-255,2819,65825,9,261665
1620,0.000848,172.31.36.0-255,66,65891,9,261665
1621,0.00085,74.125.24.0-255,378,66269,9,261665
1622,0.00113,74.125.24.0-255,1484,67753,9,261665
1623,0.001136,172.31.36.0-255,66,67819,9,261665
1624,0.001142,74.125.24.0-255,2902,70721,9,261665
1625,0.001145,172.31.36.0-255,66,70787,9,261665
1626,0.001173,74.125.24.0-255,5738,76525,9,261665
1627,0.001176,172.31.36.0-255,66,76591,9,261665
1628,0.00118,74.125.24.0-255,4320,80911,9,261665
1629,0.001182,172.31.36.0-255,66,80977,9,261665
1630,0.001221,74.125.24.0-255,1484,82461,9,261665
1631,0.001239,74.125.24.0-255,5379,87840,9,261665
1632,0.001241,172.31.36.0-255,66,87906,9,261665
1633,0.001245,74.125.24.0-255,2902,90808,9,261665
1634,0.001247,172.31.36.0-255,66,90874,9,261665
1635,0.001262,74.125.24.0-255,4320,95194,9,261665
1636,0.001265,172.31.36.0-255,66,95260,9,261665
1637,0.001288,74.125.24.0-255,5379,100639,9,261665
1638,0.00129,172.31.36.0-255,66,100705,9,261665
1639,0.002099,74.125.24.0-255,1484,102189,9,261665
1640,0.002119,74.125.24.0-255,2902,105091,9,261665
1641,0.002122,172.31.36.0-255,66,105157,9,261665
1642,0.00214,74.125.24.0-255,5738,110895,9,261665
1643,0.002143,172.31.36.0-255,66,110961,9,261665
1644,0.002174,74.125.24.0-255,1484,112445,9,261665
1645,0.002199,74.125.24.0-255,4320,116765,9,261665
1646,0.002202,172.31.36.0-255,66,116831,9,261665
1647,0.002215,172.31.36.0-255,66,116897,9,261665
1648,0.002221,74.125.24.0-255,5020,121917,9,261665
1649,0.002223,172.31.36.0-255,66,121983,9,261665
1650,0.002511,74.125.24.0-255,1484,123467,9,261665
1651,0.002528,74.125.24.0-255,2902,126369,9,261665
1652,0.00253,172.31.36.0-255,66,126435,9,261665
1653,0.002533,74.125.24.0-255,1484,127919,9,261665
1654,0.002551,74.125.24.0-255,1484,129403,9,261665
1655,0.002553,172.31.36.0-255,66,129469,9,261665
1656,0.002557,74.125.24.0-255,2902,132371,9,261665
1657,0.002559,172.31.36.0-255,66,132437,9,261665
1658,0.002588,74.125.24.0-255,5738,138175,9,261665
1659,0.00259,172.31.36.0-255,66,138241,9,261665
1660,0.002602,172.31.36.0-255,66,138307,9,261665
1661,0.002605,74.125.24.0-255,1484,139791,9,261665
1662,0.002609,74.125.24.0-255,3602,143393,9,261665
1663,0.002611,172.31.36.0-255,66,143459,9,261665
1664,0.002649,74.125.24.0-255,5738,149197,9,261665
1665,0.002651,172.31.36.0-255,66,149263,9,261665
1666,0.002654,74.125.24.0-255,1484,150747,9,261665
1667,0.002656,74.125.24.0-255,1484,152231,9,261665
1668,0.002658,172.31.36.0-255,66,152297,9,261665
1669,0.002683,74.125.24.0-255,2902,155199,9,261665
1670,0.002685,172.31.36.0-255,66,155265,9,261665
1671,0.002708,172.31.36.0-255,66,155331,9,261665
1672,0.002712,74.125.24.0-255,2902,158233,9,261665
1673,0.002714,172.31.36.0-255,66,158299,9,261665
1674,0.002731,74.125.24.0-255,4320,162619,9,261665
1675,0.002733,172.31.36.0-255,66,162685,9,261665
1676,0.002775,74.125.24.0-255,6438,169123,9,261665
1677,0.002778,172.31.36.0-255,66,169189,9,261665
1678,0.002785,74.125.24.0-255,7156,176345,9,261665
1679,0.002787,172.31.36.0-255,66,176411,9,261665
1680,0.002825,172.31.36.0-255,66,176477,9,261665
1681,0.002859,172.31.36.0-255,66,176543,9,261665
1682,0.00288,74.125.24.0-255,1484,178027,9,261665
1683,0.00289,172.31.36.0-255,66,178093,9,261665
1684,0.002924,74.125.24.0-255,5738,183831,9,261665
1685,0.002927,172.31.36.0-255,66,183897,9,261665
1686,0.002968,172.31.36.0-255,66,183963,9,261665
1687,0.002985,172.31.36.0-255,66,184029,9,261665
1688,0.002988,74.125.24.0-255,2184,186213,9,261665
1689,0.002991,172.31.36.0-255,66,186279,9,261665
1690,0.003013,74.125.24.0-255,5738,192017,9,261665
1691,0.003016,172.31.36.0-255,66,192083,9,261665
1692,0.00306,172.31.36.0-255,66,192149,9,261665
1693,0.003066,74.125.24.0-255,5738,197887,9,261665
1694,0.003068,172.31.36.0-255,66,197953,9,261665
1695,0.003139,172.31.36.0-255,66,198019,9,261665
1696,0.003154,172.31.36.0-255,66,198085,9,261665
1697,0.003165,172.31.36.0-255,66,198151,9,261665
1698,0.003167,74.125.24.0-255,766,198917,9,261665
1699,0.00317,74.125.24.0-255,1484,200401,9,261665
1700,0.003173,172.31.36.0-255,66,200467,9,261665
1701,0.003189,74.125.24.0-255,2902,203369,9,261665
1702,0.003192,172.31.36.0-255,66,203435,9,261665
1703,0.003209,74.125.24.0-255,7156,210591,9,261665
1704,0.003212,172.31.36.0-255,66,210657,9,261665
1705,0.003219,74.125.24.0-255,7156,217813,9,261665
1706,0.003221,172.31.36.0-255,66,217879,9,261665
1707,0.003242,74.125.24.0-255,4320,222199,9,261665
1708,0.003244,172.31.36.0-255,66,222265,9,261665
1709,0.003251,74.125.24.0-255,7156,229421,9,261665
1710,0.003254,172.31.36.0-255,66,229487,9,261665
1711,0.003261,74.125.24.0-255,7156,236643,9,261665
1712,0.003264,172.31.36.0-255,66,236709,9,261665
1713,0.003289,74.125.24.0-255,766,237475,9,261665
1714,0.003297,74.125.24.0-255,7156,244631,9,261665
1715,0.003299,172.31.36.0-255,66,244697,9,261665
1716,0.00331,172.31.36.0-255,66,244763,9,261665
1717,0.003338,74.125.24.0-255,7156,251919,9,261665
1718,0.003341,172.31.36.0-255,66,251985,9,261665
1719,0.003364,74.125.24.0-255,6438,258423,9,261665
1720,0.003366,172.31.36.0-255,66,258489,9,261665
1721,0.003412,172.31.36.0-255,66,258555,9,261665
1722,0.003431,74.125.24.0-255,2768,261323,9,261665
1723,0.003434,172.31.36.0-255,66,261389,9,261665
1724,0.003451,74.125.24.0-255,105,261494,9,261665
1725,0.006188,172.31.36.0-255,105,261599,9,261665
1726,0.008502,74.125.24.0-255,66,261665,9,261665
1727,0.0,74.125.24.0-255,153,153,9,142336
1728,1.4e-05,172.31.36.0-255,66,219,9,142336
1729,2.1e-05,74.125.24.0-255,1484,1703,9,142336
1730,2.6e-05,172.31.36.0-255,66,1769,9,142336
1731,4e-05,74.125.24.0-255,2902,4671,9,142336
1732,4.4e-05,172.31.36.0-255,66,4737,9,142336
1733,5.2e-05,74.125.24.0-255,7156,11893,9,142336
1734,5.6e-05,172.31.36.0-255,66,11959,9,142336
1735,6.2e-05,74.125.24.0-255,4320,16279,9,142336
1736,6.4e-05,172.31.36.0-255,66,16345,9,142336
1737,9.6e-05,74.125.24.0-255,2020,18365,9,142336
1738,9.9e-05,172.31.36.0-255,66,18431,9,142336
1739,0.000102,74.125.24.0-255,1484,19915,9,142336
1740,0.000105,172.31.36.0-255,66,19981,9,142336
1741,0.000136,172.31.36.0-255,66,20047,9,142336
1742,0.000175,74.125.24.0-255,2902,22949,9,142336
1743,0.000178,172.31.36.0-255,66,23015,9,142336
1744,0.000188,74.125.24.0-255,4320,27335,9,142336
1745,0.000191,172.31.36.0-255,66,27401,9,142336
1746,0.000201,172.31.36.0-255,66,27467,9,142336
1747,0.000228,74.125.24.0-255,4320,31787,9,142336
1748,0.00023,172.31.36.0-255,66,31853,9,142336
1749,0.000272,172.31.36.0-255,66,31919,9,142336
1750,0.000368,74.125.24.0-255,645,32564,9,142336
1751,0.000371,172.31.36.0-255,66,32630,9,142336
1752,0.001004,74.125.24.0-255,1484,34114,9,142336
1753,0.001011,172.31.36.0-255,66,34180,9,142336
1754,0.001017,74.125.24.0-255,2902,37082,9,142336
1755,0.001019,172.31.36.0-255,66,37148,9,142336
1756,0.001022,74.125.24.0-255,1484,38632,9,142336
1757,0.001052,74.125.24.0-255,4320,42952,9,142336
1758,0.001055,172.31.36.0-255,66,43018,9,142336
1759,0.001069,172.31.36.0-255,66,43084,9,142336
1760,0.001104,172.31.36.0-255,66,43150,9,142336
1761,0.001574,74.125.24.0-255,1484,44634,9,142336
1762,0.001583,74.125.24.0-255,2902,47536,9,142336
1763,0.001587,172.31.36.0-255,66,47602,9,142336
1764,0.001595,74.125.24.0-255,5738,53340,9,142336
1765,0.001598,172.31.36.0-255,66,53406,9,142336
1766,0.00165,172.31.36.0-255,66,53472,9,142336
1767,0.001663,172.31.36.0-255,66,53538,9,142336
1768,0.001693,74.125.24.0-255,766,54304,9,142336
1769,0.001777,74.125.24.0-255,1484,55788,9,142336
1770,0.001781,172.31.36.0-255,66,55854,9,142336
1771,0.001788,74.125.24.0-255,2902,58756,9,142336
1772,0.00179,172.31.36.0-255,66,58822,9,142336
1773,0.0018,74.125.24.0-255,2902,61724,9,142336
1774,0.001802,172.31.36.0-255,66,61790,9,142336
1775,0.001817,74.125.24.0-255,2902,64692,9,142336
1776,0.001819,172.31.36.0-255,66,64758,9,142336
1777,0.001839,172.31.36.0-255,66,64824,9,142336
1778,0.001866,74.125.24.0-255,1484,66308,9,142336
1779,0.00188,172.31.36.0-255,66,66374,9,142336
1780,0.001883,74.125.24.0-255,766,67140,9,142336
1781,0.002124,74.125.24.0-255,1484,68624,9,142336
1782,0.002131,172.31.36.0-255,66,68690,9,142336
1783,0.002139,74.125.24.0-255,2902,71592,9,142336
1784,0.002142,172.31.36.0-255,66,71658,9,142336
1785,0.002152,74.125.24.0-255,5738,77396,9,142336
1786,0.002155,172.31.36.0-255,66,77462,9,142336
1787,0.002161,74.125.24.0-255,4320,81782,9,142336
1788,0.002164,172.31.36.0-255,66,81848,9,142336
1789,0.00219,74.125.24.0-255,1484,83332,9,142336
1790,0.002198,74.125.24.0-255,7156,90488,9,142336
1791,0.002201,172.31.36.0-255,66,90554,9,142336
1792,0.002208,74.125.24.0-255,4320,94874,9,142336
1793,0.002211,172.31.36.0-255,66,94940,9,142336
1794,0.002249,74.125.24.0-255,6438,101378,9,142336
1795,0.002252,172.31.36.0-255,66,101444,9,142336
1796,0.002275,74.125.24.0-255,1484,102928,9,142336
1797,0.00228,74.125.24.0-255,2902,105830,9,142336
1798,0.002282,172.31.36.0-255,66,105896,9,142336
1799,0.002311,74.125.24.0-255,5738,111634,9,142336
1800,0.002314,172.31.36.0-255,66,111700,9,142336
1801,0.002352,74.125.24.0-255,5738,117438,9,142336
1802,0.002354,172.31.36.0-255,66,117504,9,142336
1803,0.00239,74.125.24.0-255,7156,124660,9,142336
1804,0.002393,172.31.36.0-255,66,124726,9,142336
1805,0.002406,172.31.36.0-255,66,124792,9,142336
1806,0.004723,74.125.24.0-255,5738,130530,9,142336
1807,0.004729,172.31.36.0-255,66,130596,9,142336
1808,0.007047,74.125.24.0-255,5738,136334,9,142336
1809,0.007052,172.31.36.0-255,66,136400,9,142336
1810,0.009351,74.125.24.0-255,2902,139302,9,142336
1811,0.009356,172.31.36.0-255,66,139368,9,142336
1812,0.009388,74.125.24.0-255,2902,142270,9,142336
1813,0.00939,172.31.36.0-255,66,142336,9,142336
1814,0.0,74.125.24.0-255,153,153,9,238079
1815,2.9e-05,172.31.36.0-255,66,219,9,238079
1816,3.6e-05,74.125.24.0-255,1484,1703,9,238079
1817,4.1e-05,172.31.36.0-255,66,1769,9,238079
1818,4.7e-05,74.125.24.0-255,2902,4671,9,238079
1819,5e-05,172.31.36.0-255,66,4737,9,238079
1820,5.8e-05,74.125.24.0-255,7156,11893,9,238079
1821,6.1e-05,172.31.36.0-255,66,11959,9,238079
1822,6.6e-05,74.125.24.0-255,3468,15427,9,238079
1823,6.9e-05,172.31.36.0-255,66,15493,9,238079
1824,7.6e-05,74.125.24.0-255,5738,21231,9,238079
1825,7.9e-05,172.31.36.0-255,66,21297,9,238079
1826,0.000108,74.125.24.0-255,7156,28453,9,238079
1827,0.000111,172.31.36.0-255,66,28519,9,238079
1828,0.000115,74.125.24.0-255,2543,31062,9,238079
1829,0.000117,172.31.36.0-255,66,31128,9,238079
1830,0.000187,74.125.24.0-255,1484,32612,9,238079
1831,0.000191,172.31.36.0-255,66,32678,9,238079
1832,0.000207,74.125.24.0-255,2902,35580,9,238079
1833,0.000209,172.31.36.0-255,66,35646,9,238079
1834,0.000229,74.125.24.0-255,5738,41384,9,238079
1835,0.000231,172.31.36.0-255,66,41450,9,238079
1836,0.000259,74.125.24.0-255,5738,47188,9,238079
1837,0.000261,172.31.36.0-255,66,47254,9,238079
1838,0.000284,74.125.24.0-255,3961,51215,9,238079
1839,0.000287,172.31.36.0-255,66,51281,9,238079
1840,0.000299,172.31.36.0-255,66,51347,9,238079
1841,0.000302,74.125.24.0-255,1484,52831,9,238079
1842,0.000304,172.31.36.0-255,66,52897,9,238079
1843,0.000331,74.125.24.0-255,2817,55714,9,238079
1844,0.000333,172.31.36.0-255,66,55780,9,238079
1845,0.000336,74.125.24.0-255,381,56161,9,238079
1846,0.000408,74.125.24.0-255,1484,57645,9,238079
1847,0.000411,172.31.36.0-255,66,57711,9,238079
1848,0.000416,74.125.24.0-255,2902,60613,9,238079
1849,0.000418,172.31.36.0-255,66,60679,9,238079
1850,0.000443,74.125.24.0-255,5738,66417,9,238079
1851,0.000446,172.31.36.0-255,66,66483,9,238079
1852,0.000474,74.125.24.0-255,4320,70803,9,238079
1853,0.000477,172.31.36.0-255,66,70869,9,238079
1854,0.000503,74.125.24.0-255,5379,76248,9,238079
1855,0.000506,172.31.36.0-255,66,76314,9,238079
1856,0.000518,172.31.36.0-255,66,76380,9,238079
1857,0.000538,74.125.24.0-255,3412,79792,9,238079
1858,0.000541,172.31.36.0-255,66,79858,9,238079
1859,0.000719,74.125.24.0-255,1484,81342,9,238079
1860,0.000764,74.125.24.0-255,1484,82826,9,238079
1861,0.000768,172.31.36.0-255,66,82892,9,238079
1862,0.000774,74.125.24.0-255,2902,85794,9,238079
1863,0.000777,172.31.36.0-255,66,85860,9,238079
1864,0.000832,74.125.24.0-255,4320,90180,9,238079
1865,0.000836,172.31.36.0-255,66,90246,9,238079
1866,0.000855,74.125.24.0-255,1484,91730,9,238079
1867,0.000858,74.125.24.0-255,1484,93214,9,238079
1868,0.000861,172.31.36.0-255,66,93280,9,238079
1869,0.000866,74.125.24.0-255,2902,96182,9,238079
1870,0.000867,172.31.36.0-255,66,96248,9,238079
1871,0.000872,74.125.24.0-255,2902,99150,9,238079
1872,0.000874,172.31.36.0-255,66,99216,9,238079
1873,0.000879,74.125.24.0-255,4320,103536,9,238079
1874,0.000882,172.31.36.0-255,66,103602,9,238079
1875,0.000885,74.125.24.0-255,1484,105086,9,238079
1876,0.000908,74.125.24.0-255,7156,112242,9,238079
1877,0.00091,172.31.36.0-255,66,112308,9,238079
1878,0.000914,74.125.24.0-255,2184,114492,9,238079
1879,0.000916,172.31.36.0-255,66,114558,9,238079
1880,0.001254,74.125.24.0-255,1484,116042,9,238079
1881,0.001272,74.125.24.0-255,2902,118944,9,238079
1882,0.001276,172.31.36.0-255,66,119010,9,238079
1883,0.001282,74.125.24.0-255,4320,123330,9,238079
1884,0.001284,172.31.36.0-255,66,123396,9,238079
1885,0.001305,74.125.24.0-255,1484,124880,9,238079
1886,0.00132,172.31.36.0-255,66,124946,9,238079
1887,0.001323,74.125.24.0-255,1484,126430,9,238079
1888,0.001359,172.31.36.0-255,66,126496,9,238079
1889,0.001733,74.125.24.0-255,1484,127980,9,238079
1890,0.001738,74.125.24.0-255,2902,130882,9,238079
1891,0.001744,172.31.36.0-255,66,130948,9,238079
1892,0.001757,74.125.24.0-255,2902,133850,9,238079
1893,0.00176,172.31.36.0-255,66,133916,9,238079
1894,0.001787,74.125.24.0-255,2902,136818,9,238079
1895,0.00179,172.31.36.0-255,66,136884,9,238079
1896,0.001797,74.125.24.0-255,7156,144040,9,238079
1897,0.001799,172.31.36.0-255,66,144106,9,238079
1898,0.001815,74.125.24.0-255,5738,149844,9,238079
1899,0.001818,172.31.36.0-255,66,149910,9,238079
1900,0.001841,74.125.24.0-255,2902,152812,9,238079
1901,0.001843,172.31.36.0-255,66,152878,9,238079
1902,0.001872,172.31.36.0-255,66,152944,9,238079
1903,0.002092,74.125.24.0-255,1484,154428,9,238079
1904,0.002098,74.125.24.0-255,2902,157330,9,238079
1905,0.002101,172.31.36.0-255,66,157396,9,238079
1906,0.002106,74.125.24.0-255,1484,158880,9,238079
1907,0.002122,74.125.24.0-255,4320,163200,9,238079
1908,0.002125,172.31.36.0-255,66,163266,9,238079
1909,0.002137,74.125.24.0-255,1484,164750,9,238079
1910,0.002159,74.125.24.0-255,7156,171906,9,238079
1911,0.002162,172.31.36.0-255,66,171972,9,238079
1912,0.002198,74.125.24.0-255,2902,174874,9,238079
1913,0.0022,172.31.36.0-255,66,174940,9,238079
1914,0.002227,74.125.24.0-255,4320,179260,9,238079
1915,0.002238,172.31.36.0-255,66,179326,9,238079
1916,0.002246,172.31.36.0-255,66,179392,9,238079
1917,0.00225,74.125.24.0-255,1484,180876,9,238079
1918,0.00227,74.125.24.0-255,7156,188032,9,238079
1919,0.002274,172.31.36.0-255,66,188098,9,238079
1920,0.002317,172.31.36.0-255,66,188164,9,238079
1921,0.002338,74.125.24.0-255,5738,193902,9,238079
1922,0.002341,172.31.36.0-255,66,193968,9,238079
1923,0.002364,172.31.36.0-255,66,194034,9,238079
1924,0.002372,74.125.24.0-255,7156,201190,9,238079
1925,0.002375,172.31.36.0-255,66,201256,9,238079
1926,0.002392,74.125.24.0-255,2902,204158,9,238079
1927,0.002394,172.31.36.0-255,66,204224,9,238079
1928,0.002398,74.125.24.0-255,2902,207126,9,238079
1929,0.0024,172.31.36.0-255,66,207192,9,238079
1930,0.002436,172.31.36.0-255,66,207258,9,238079
1931,0.002496,172.31.36.0-255,66,207324,9,238079
1932,0.0025,74.125.24.0-255,2902,210226,9,238079
1933,0.002502,172.31.36.0-255,66,210292,9,238079
1934,0.002532,172.31.36.0-255,66,210358,9,238079
1935,0.002552,74.125.24.0-255,7156,217514,9,238079
1936,0.002555,172.31.36.0-255,66,217580,9,238079
1937,0.00259,172.31.36.0-255,66,217646,9,238079
1938,0.002596,74.125.24.0-255,5738,223384,9,238079
1939,0.002599,172.31.36.0-255,66,223450,9,238079
1940,0.002624,172.31.36.0-255,66,223516,9,238079
1941,0.002636,172.31.36.0-255,66,223582,9,238079
1942,0.002661,74.125.24.0-255,4320,227902,9,238079
1943,0.002664,172.31.36.0-255,66,227968,9,238079
1944,0.002676,172.31.36.0-255,66,228034,9,238079
1945,0.002679,74.125.24.0-255,1484,229518,9,238079
1946,0.00269,172.31.36.0-255,66,229584,9,238079
1947,0.002711,74.125.24.0-255,5020,234604,9,238079
1948,0.002714,172.31.36.0-255,66,234670,9,238079
1949,0.002718,74.125.24.0-255,3141,237811,9,238079
1950,0.002721,172.31.36.0-255,66,237877,9,238079
1951,0.002725,74.125.24.0-255,97,237974,9,238079
1952,0.002777,74.125.24.0-255,105,238079,9,238079
1953,0.0,172.217.194.0-255,153,153,9,214444
1954,1.4e-05,172.217.194.0-255,1484,1637,9,214444
1955,2.1e-05,172.31.36.0-255,66,1703,9,214444
1956,3.2e-05,172.217.194.0-255,2902,4605,9,214444
1957,3.6e-05,172.31.36.0-255,66,4671,9,214444
1958,5e-05,172.217.194.0-255,4320,8991,9,214444
1959,5.4e-05,172.31.36.0-255,66,9057,9,214444
1960,6.1e-05,172.217.194.0-255,4866,13923,9,214444
1961,6.4e-05,172.31.36.0-255,66,13989,9,214444
1962,0.00012,172.217.194.0-255,1484,15473,9,214444
1963,0.000123,172.217.194.0-255,1484,16957,9,214444
1964,0.000126,172.31.36.0-255,66,17023,9,214444
1965,0.000151,172.217.194.0-255,1484,18507,9,214444
1966,0.000158,172.217.194.0-255,5738,24245,9,214444
1967,0.000161,172.31.36.0-255,66,24311,9,214444
1968,0.000169,172.217.194.0-255,6797,31108,9,214444
1969,0.000172,172.31.36.0-255,66,31174,9,214444
1970,0.000223,172.217.194.0-255,1484,32658,9,214444
1971,0.000264,172.217.194.0-255,2902,35560,9,214444
1972,0.000266,172.31.36.0-255,66,35626,9,214444
1973,0.000273,172.217.194.0-255,5738,41364,9,214444
1974,0.000276,172.31.36.0-255,66,41430,9,214444
1975,0.000305,172.217.194.0-255,2902,44332,9,214444
1976,0.000308,172.31.36.0-255,66,44398,9,214444
1977,0.000343,172.31.36.0-255,66,44464,9,214444
1978,0.00036,172.31.36.0-255,66,44530,9,214444
1979,0.000363,172.217.194.0-255,1125,45655,9,214444
1980,0.000772,172.217.194.0-255,645,46300,9,214444
1981,0.000778,172.31.36.0-255,66,46366,9,214444
1982,0.001184,172.217.194.0-255,1484,47850,9,214444
1983,0.001193,172.217.194.0-255,2902,50752,9,214444
1984,0.001198,172.31.36.0-255,66,50818,9,214444
1985,0.001205,172.217.194.0-255,5738,56556,9,214444
1986,0.001207,172.31.36.0-255,66,56622,9,214444
1987,0.001217,172.217.194.0-255,2902,59524,9,214444
1988,0.00122,172.31.36.0-255,66,59590,9,214444
1989,0.001252,172.217.194.0-255,5738,65328,9,214444
1990,0.001254,172.31.36.0-255,66,65394,9,214444
1991,0.001284,172.217.194.0-255,5738,71132,9,214444
1992,0.001286,172.31.36.0-255,66,71198,9,214444
1993,0.001326,172.31.36.0-255,66,71264,9,214444
1994,0.001453,172.217.194.0-255,1484,72748,9,214444
1995,0.00146,172.217.194.0-255,2902,75650,9,214444
1996,0.001464,172.31.36.0-255,66,75716,9,214444
1997,0.00151,172.217.194.0-255,5738,81454,9,214444
1998,0.001513,172.31.36.0-255,66,81520,9,214444
1999,0.001527,172.31.36.0-255,66,81586,9,214444
2000,0.001544,172.31.36.0-255,66,81652,9,214444
2001,0.001568,172.217.194.0-255,766,82418,9,214444
2002,0.002329,172.217.194.0-255,1484,83902,9,214444
2003,0.002336,172.31.36.0-255,66,83968,9,214444
2004,0.002343,172.217.194.0-255,2902,86870,9,214444
2005,0.002347,172.31.36.0-255,66,86936,9,214444
2006,0.002359,172.217.194.0-255,5738,92674,9,214444
2007,0.002362,172.31.36.0-255,66,92740,9,214444
2008,0.002369,172.217.194.0-255,7156,99896,9,214444
2009,0.002373,172.31.36.0-255,66,99962,9,214444
2010,0.002378,172.217.194.0-255,4320,104282,9,214444
2011,0.002381,172.31.36.0-255,66,104348,9,214444
2012,0.002427,172.31.36.0-255,66,104414,9,214444
2013,0.002431,172.217.194.0-255,2184,106598,9,214444
2014,0.002433,172.31.36.0-255,66,106664,9,214444
2015,0.002614,172.217.194.0-255,1484,108148,9,214444
2016,0.002638,172.217.194.0-255,2902,111050,9,214444
2017,0.002641,172.31.36.0-255,66,111116,9,214444
2018,0.002668,172.217.194.0-255,4320,115436,9,214444
2019,0.002671,172.31.36.0-255,66,115502,9,214444
2020,0.002677,172.217.194.0-255,5738,121240,9,214444
2021,0.00268,172.31.36.0-255,66,121306,9,214444
2022,0.00271,172.217.194.0-255,2902,124208,9,214444
2023,0.002712,172.31.36.0-255,66,124274,9,214444
2024,0.002718,172.217.194.0-255,4320,128594,9,214444
2025,0.002721,172.31.36.0-255,66,128660,9,214444
2026,0.002728,172.217.194.0-255,1484,130144,9,214444
2027,0.002733,172.217.194.0-255,2902,133046,9,214444
2028,0.002735,172.31.36.0-255,66,133112,9,214444
2029,0.002741,172.217.194.0-255,5738,138850,9,214444
2030,0.002744,172.31.36.0-255,66,138916,9,214444
2031,0.002748,172.217.194.0-255,2184,141100,9,214444
2032,0.002751,172.31.36.0-255,66,141166,9,214444
2033,0.003196,172.217.194.0-255,1484,142650,9,214444
2034,0.003218,172.217.194.0-255,2902,145552,9,214444
2035,0.003221,172.31.36.0-255,66,145618,9,214444
2036,0.003225,172.217.194.0-255,2902,148520,9,214444
2037,0.003228,172.31.36.0-255,66,148586,9,214444
2038,0.003257,172.217.194.0-255,2902,151488,9,214444
2039,0.00326,172.31.36.0-255,66,151554,9,214444
2040,0.003311,172.31.36.0-255,66,151620,9,214444
2041,0.003342,172.217.194.0-255,2902,154522,9,214444
2042,0.003345,172.31.36.0-255,66,154588,9,214444
2043,0.003363,172.31.36.0-255,66,154654,9,214444
2044,0.003391,172.31.36.0-255,66,154720,9,214444
2045,0.003394,172.217.194.0-255,1484,156204,9,214444
2046,0.003401,172.217.194.0-255,6438,162642,9,214444
2047,0.003404,172.31.36.0-255,66,162708,9,214444
2048,0.003459,172.217.194.0-255,1484,164192,9,214444
2049,0.003477,172.217.194.0-255,2902,167094,9,214444
2050,0.00348,172.31.36.0-255,66,167160,9,214444
2051,0.003524,172.217.194.0-255,5738,172898,9,214444
2052,0.003527,172.31.36.0-255,66,172964,9,214444
2053,0.00355,172.31.36.0-255,66,173030,9,214444
2054,0.003583,172.217.194.0-255,1484,174514,9,214444
2055,0.003611,172.31.36.0-255,66,174580,9,214444
2056,0.00366,172.217.194.0-255,1484,176064,9,214444
2057,0.003665,172.217.194.0-255,2902,178966,9,214444
2058,0.003669,172.31.36.0-255,66,179032,9,214444
2059,0.003674,172.217.194.0-255,2902,181934,9,214444
2060,0.003676,172.31.36.0-255,66,182000,9,214444
2061,0.003709,172.217.194.0-255,2902,184902,9,214444
2062,0.003712,172.31.36.0-255,66,184968,9,214444
2063,0.003726,172.31.36.0-255,66,185034,9,214444
2064,0.003744,172.31.36.0-255,66,185100,9,214444
2065,0.003748,172.217.194.0-255,2902,188002,9,214444
2066,0.003751,172.31.36.0-255,66,188068,9,214444
2067,0.003801,172.31.36.0-255,66,188134,9,214444
2068,0.003809,172.217.194.0-255,7156,195290,9,214444
2069,0.003811,172.31.36.0-255,66,195356,9,214444
2070,0.00387,172.31.36.0-255,66,195422,9,214444
2071,0.003881,172.31.36.0-255,66,195488,9,214444
2072,0.003918,172.217.194.0-255,7156,202644,9,214444
2073,0.003921,172.31.36.0-255,66,202710,9,214444
2074,0.003924,172.217.194.0-255,1484,204194,9,214444
2075,0.003929,172.217.194.0-255,4320,208514,9,214444
2076,0.003931,172.31.36.0-255,66,208580,9,214444
2077,0.00397,172.31.36.0-255,66,208646,9,214444
2078,0.003973,172.217.194.0-255,1484,210130,9,214444
2079,0.003979,172.217.194.0-255,4143,214273,9,214444
2080,0.003981,172.31.36.0-255,66,214339,9,214444
2081,0.004047,172.217.194.0-255,105,214444,9,214444
2082,0.0,172.217.27.0-255,298,298,9,103182
2083,1.7e-05,172.31.36.0-255,66,364,9,103182
2084,2.2e-05,172.217.27.0-255,1484,1848,9,103182
2085,2.6e-05,172.31.36.0-255,66,1914,9,103182
2086,3.4e-05,172.217.27.0-255,4320,6234,9,103182
2087,4.5e-05,172.31.36.0-255,66,6300,9,103182
2088,5e-05,172.217.27.0-255,2902,9202,9,103182
2089,5.3e-05,172.31.36.0-255,66,9268,9,103182
2090,7.8e-05,172.217.27.0-255,6069,15337,9,103182
2091,8.1e-05,172.31.36.0-255,66,15403,9,103182
2092,9.3e-05,172.217.27.0-255,7156,22559,9,103182
2093,9.6e-05,172.31.36.0-255,66,22625,9,103182
2094,0.000107,172.31.36.0-255,66,22691,9,103182
2095,0.000149,172.217.27.0-255,1484,24175,9,103182
2096,0.000152,172.31.36.0-255,66,24241,9,103182
2097,0.000157,172.217.27.0-255,2902,27143,9,103182
2098,0.000159,172.31.36.0-255,66,27209,9,103182
2099,0.000164,172.217.27.0-255,4320,31529,9,103182
2100,0.000173,172.31.36.0-255,66,31595,9,103182
2101,0.000179,172.217.27.0-255,5738,37333,9,103182
2102,0.000182,172.31.36.0-255,66,37399,9,103182
2103,0.000211,172.217.27.0-255,2543,39942,9,103182
2104,0.000213,172.31.36.0-255,66,40008,9,103182
2105,0.000266,172.217.27.0-255,1484,41492,9,103182
2106,0.00027,172.31.36.0-255,66,41558,9,103182
2107,0.000275,172.217.27.0-255,2902,44460,9,103182
2108,0.000277,172.31.36.0-255,66,44526,9,103182
2109,0.000309,172.217.27.0-255,5738,50264,9,103182
2110,0.000312,172.31.36.0-255,66,50330,9,103182
2111,0.000341,172.217.27.0-255,6797,57127,9,103182
2112,0.000344,172.31.36.0-255,66,57193,9,103182
2113,0.001248,172.217.27.0-255,645,57838,9,103182
2114,0.001613,172.217.27.0-255,1484,59322,9,103182
2115,0.001622,172.31.36.0-255,66,59388,9,103182
2116,0.00163,172.217.27.0-255,2902,62290,9,103182
2117,0.001633,172.31.36.0-255,66,62356,9,103182
2118,0.001645,172.217.27.0-255,5738,68094,9,103182
2119,0.001647,172.31.36.0-255,66,68160,9,103182
2120,0.001653,172.217.27.0-255,4320,72480,9,103182
2121,0.001655,172.31.36.0-255,66,72546,9,103182
2122,0.001662,172.217.27.0-255,5738,78284,9,103182
2123,0.001665,172.31.36.0-255,66,78350,9,103182
2124,0.001668,172.217.27.0-255,1484,79834,9,103182
2125,0.001714,172.31.36.0-255,66,79900,9,103182
2126,0.001717,172.217.27.0-255,1484,81384,9,103182
2127,0.003368,172.217.27.0-255,4320,85704,9,103182
2128,0.003376,172.31.36.0-255,66,85770,9,103182
2129,0.005046,172.217.27.0-255,5738,91508,9,103182
2130,0.005053,172.31.36.0-255,66,91574,9,103182
2131,0.006712,172.217.27.0-255,5738,97312,9,103182
2132,0.006719,172.31.36.0-255,66,97378,9,103182
2133,0.008382,172.217.27.0-255,5738,103116,9,103182
2134,0.008387,172.31.36.0-255,66,103182,9,103182
2135,0.0,74.125.130.0-255,150,150,9,366385
2136,3e-05,172.31.36.0-255,66,216,9,366385
2137,5.2e-05,74.125.130.0-255,1484,1700,9,366385
2138,5.7e-05,172.31.36.0-255,66,1766,9,366385
2139,6.1e-05,74.125.130.0-255,1484,3250,9,366385
2140,6.4e-05,172.31.36.0-255,66,3316,9,366385
2141,8.9e-05,74.125.130.0-255,2902,6218,9,366385
2142,9.2e-05,172.31.36.0-255,66,6284,9,366385
2143,0.000109,74.125.130.0-255,4320,10604,9,366385
2144,0.000113,172.31.36.0-255,66,10670,9,366385
2145,0.000128,74.125.130.0-255,1484,12154,9,366385
2146,0.000131,172.31.36.0-255,66,12220,9,366385
2147,0.000165,74.125.130.0-255,2048,14268,9,366385
2148,0.000168,172.31.36.0-255,66,14334,9,366385
2149,0.000237,74.125.130.0-255,1484,15818,9,366385
2150,0.000241,172.31.36.0-255,66,15884,9,366385
2151,0.000254,74.125.130.0-255,1484,17368,9,366385
2152,0.000256,172.31.36.0-255,66,17434,9,366385
2153,0.000273,74.125.130.0-255,2902,20336,9,366385
2154,0.000276,172.31.36.0-255,66,20402,9,366385
2155,0.000298,74.125.130.0-255,4320,24722,9,366385
2156,0.000301,172.31.36.0-255,66,24788,9,366385
2157,0.000316,74.125.130.0-255,1484,26272,9,366385
2158,0.000319,172.31.36.0-255,66,26338,9,366385
2159,0.000324,74.125.130.0-255,2902,29240,9,366385
2160,0.000326,172.31.36.0-255,66,29306,9,366385
2161,0.000361,74.125.130.0-255,2543,31849,9,366385
2162,0.000365,172.31.36.0-255,66,31915,9,366385
2163,0.000494,74.125.130.0-255,1484,33399,9,366385
2164,0.000501,172.31.36.0-255,66,33465,9,366385
2165,0.000514,74.125.130.0-255,2902,36367,9,366385
2166,0.000517,172.31.36.0-255,66,36433,9,366385
2167,0.000536,74.125.130.0-255,4320,40753,9,366385
2168,0.000538,172.31.36.0-255,66,40819,9,366385
2169,0.000557,74.125.130.0-255,1484,42303,9,366385
2170,0.000564,74.125.130.0-255,4320,46623,9,366385
2171,0.000567,172.31.36.0-255,66,46689,9,366385
2172,0.000583,74.125.130.0-255,2543,49232,9,366385
2173,0.000586,172.31.36.0-255,66,49298,9,366385
2174,0.000726,74.125.130.0-255,1484,50782,9,366385
2175,0.000748,74.125.130.0-255,2902,53684,9,366385
2176,0.000752,172.31.36.0-255,66,53750,9,366385
2177,0.000775,74.125.130.0-255,2902,56652,9,366385
2178,0.000778,172.31.36.0-255,66,56718,9,366385
2179,0.000785,74.125.130.0-255,4320,61038,9,366385
2180,0.000786,172.31.36.0-255,66,61104,9,366385
2181,0.000817,74.125.130.0-255,1484,62588,9,366385
2182,0.000836,74.125.130.0-255,5379,67967,9,366385
2183,0.000841,172.31.36.0-255,66,68033,9,366385
2184,0.000843,74.125.130.0-255,5738,73771,9,366385
2185,0.000845,172.31.36.0-255,66,73837,9,366385
2186,0.000856,74.125.130.0-255,1484,75321,9,366385
2187,0.000859,74.125.130.0-255,1484,76805,9,366385
2188,0.000861,172.31.36.0-255,66,76871,9,366385
2189,0.00089,74.125.130.0-255,6797,83668,9,366385
2190,0.000893,172.31.36.0-255,66,83734,9,366385
2191,0.001007,74.125.130.0-255,1484,85218,9,366385
2192,0.001029,74.125.130.0-255,2902,88120,9,366385
2193,0.001033,172.31.36.0-255,66,88186,9,366385
2194,0.001064,74.125.130.0-255,1484,89670,9,366385
2195,0.001075,74.125.130.0-255,2902,92572,9,366385
2196,0.001078,172.31.36.0-255,66,92638,9,366385
2197,0.001096,74.125.130.0-255,4320,96958,9,366385
2198,0.001099,172.31.36.0-255,66,97024,9,366385
2199,0.001118,74.125.130.0-255,1484,98508,9,366385
2200,0.001123,74.125.130.0-255,4320,102828,9,366385
2201,0.001126,172.31.36.0-255,66,102894,9,366385
2202,0.001143,74.125.130.0-255,1484,104378,9,366385
2203,0.001161,74.125.130.0-255,4320,108698,9,366385
2204,0.001164,172.31.36.0-255,66,108764,9,366385
2205,0.001189,74.125.130.0-255,2902,111666,9,366385
2206,0.001192,172.31.36.0-255,66,111732,9,366385
2207,0.00121,74.125.130.0-255,2902,114634,9,366385
2208,0.001213,172.31.36.0-255,66,114700,9,366385
2209,0.001226,74.125.130.0-255,1484,116184,9,366385
2210,0.001241,74.125.130.0-255,2069,118253,9,366385
2211,0.001243,172.31.36.0-255,66,118319,9,366385
2212,0.00481,74.125.130.0-255,1484,119803,9,366385
2213,0.004831,74.125.130.0-255,1484,121287,9,366385
2214,0.004841,172.31.36.0-255,66,121353,9,366385
2215,0.004851,74.125.130.0-255,2902,124255,9,366385
2216,0.004855,172.31.36.0-255,66,124321,9,366385
2217,0.004864,74.125.130.0-255,5738,130059,9,366385
2218,0.004868,172.31.36.0-255,66,130125,9,366385
2219,0.004873,74.125.130.0-255,2902,133027,9,366385
2220,0.004875,172.31.36.0-255,66,133093,9,366385
2221,0.004881,74.125.130.0-255,4320,137413,9,366385
2222,0.004884,172.31.36.0-255,66,137479,9,366385
2223,0.004914,74.125.130.0-255,2902,140381,9,366385
2224,0.004917,172.31.36.0-255,66,140447,9,366385
2225,0.004944,74.125.130.0-255,5738,146185,9,366385
2226,0.004948,172.31.36.0-255,66,146251,9,366385
2227,0.004989,74.125.130.0-255,1484,147735,9,366385
2228,0.00501,74.125.130.0-255,5020,152755,9,366385
2229,0.005013,172.31.36.0-255,66,152821,9,366385
2230,0.005165,74.125.130.0-255,1484,154305,9,366385
2231,0.005187,74.125.130.0-255,2902,157207,9,366385
2232,0.005191,172.31.36.0-255,66,157273,9,366385
2233,0.00521,74.125.130.0-255,5738,163011,9,366385
2234,0.005214,172.31.36.0-255,66,163077,9,366385
2235,0.005245,74.125.130.0-255,7156,170233,9,366385
2236,0.005248,172.31.36.0-255,66,170299,9,366385
2237,0.005272,74.125.130.0-255,5738,176037,9,366385
2238,0.005277,172.31.36.0-255,66,176103,9,366385
2239,0.005283,74.125.130.0-255,4320,180423,9,366385
2240,0.005285,172.31.36.0-255,66,180489,9,366385
2241,0.005301,74.125.130.0-255,2902,183391,9,366385
2242,0.005304,172.31.36.0-255,66,183457,9,366385
2243,0.005308,74.125.130.0-255,2902,186359,9,366385
2244,0.005311,172.31.36.0-255,66,186425,9,366385
2245,0.005322,74.125.130.0-255,766,187191,9,366385
2246,0.005346,74.125.130.0-255,4320,191511,9,366385
2247,0.005349,172.31.36.0-255,66,191577,9,366385
2248,0.005363,74.125.130.0-255,2902,194479,9,366385
2249,0.005365,172.31.36.0-255,66,194545,9,366385
2250,0.005391,74.125.130.0-255,4320,198865,9,366385
2251,0.005394,172.31.36.0-255,66,198931,9,366385
2252,0.005398,74.125.130.0-255,2902,201833,9,366385
2253,0.0054,172.31.36.0-255,66,201899,9,366385
2254,0.00542,74.125.130.0-255,5738,207637,9,366385
2255,0.005423,172.31.36.0-255,66,207703,9,366385
2256,0.005443,74.125.130.0-255,2902,210605,9,366385
2257,0.005445,172.31.36.0-255,66,210671,9,366385
2258,0.005467,74.125.130.0-255,7156,217827,9,366385
2259,0.005469,172.31.36.0-255,66,217893,9,366385
2260,0.005474,74.125.130.0-255,3602,221495,9,366385
2261,0.005476,172.31.36.0-255,66,221561,9,366385
2262,0.005493,74.125.130.0-255,1484,223045,9,366385
2263,0.005504,74.125.130.0-255,2902,225947,9,366385
2264,0.005506,172.31.36.0-255,66,226013,9,366385
2265,0.00551,74.125.130.0-255,1484,227497,9,366385
2266,0.005526,74.125.130.0-255,2902,230399,9,366385
2267,0.005528,172.31.36.0-255,66,230465,9,366385
2268,0.005548,74.125.130.0-255,4320,234785,9,366385
2269,0.00555,172.31.36.0-255,66,234851,9,366385
2270,0.005569,74.125.130.0-255,1484,236335,9,366385
2271,0.005574,74.125.130.0-255,2902,239237,9,366385
2272,0.005576,172.31.36.0-255,66,239303,9,366385
2273,0.005582,74.125.130.0-255,4320,243623,9,366385
2274,0.005586,172.31.36.0-255,66,243689,9,366385
2275,0.005641,172.31.36.0-255,66,243755,9,366385
2276,0.005668,74.125.130.0-255,1484,245239,9,366385
2277,0.005681,74.125.130.0-255,2184,247423,9,366385
2278,0.005683,172.31.36.0-255,66,247489,9,366385
2279,0.005688,74.125.130.0-255,4320,251809,9,366385
2280,0.005691,172.31.36.0-255,66,251875,9,366385
2281,0.00572,74.125.130.0-255,4320,256195,9,366385
2282,0.005723,172.31.36.0-255,66,256261,9,366385
2283,0.005742,74.125.130.0-255,4320,260581,9,366385
2284,0.005744,172.31.36.0-255,66,260647,9,366385
2285,0.005749,74.125.130.0-255,4320,264967,9,366385
2286,0.005751,172.31.36.0-255,66,265033,9,366385
2287,0.005775,74.125.130.0-255,5738,270771,9,366385
2288,0.005777,172.31.36.0-255,66,270837,9,366385
2289,0.005781,74.125.130.0-255,1484,272321,9,366385
2290,0.005813,74.125.130.0-255,1484,273805,9,366385
2291,0.005816,172.31.36.0-255,66,273871,9,366385
2292,0.005845,172.31.36.0-255,66,273937,9,366385
2293,0.005876,74.125.130.0-255,1484,275421,9,366385
2294,0.00588,172.31.36.0-255,66,275487,9,366385
2295,0.005925,74.125.130.0-255,7156,282643,9,366385
2296,0.005929,172.31.36.0-255,66,282709,9,366385
2297,0.005953,74.125.130.0-255,5738,288447,9,366385
2298,0.005956,172.31.36.0-255,66,288513,9,366385
2299,0.005963,74.125.130.0-255,2902,291415,9,366385
2300,0.005965,172.31.36.0-255,66,291481,9,366385
2301,0.006013,74.125.130.0-255,5738,297219,9,366385
2302,0.006016,172.31.36.0-255,66,297285,9,366385
2303,0.006037,74.125.130.0-255,2184,299469,9,366385
2304,0.00604,172.31.36.0-255,66,299535,9,366385
2305,0.006052,172.31.36.0-255,66,299601,9,366385
2306,0.0061,74.125.130.0-255,4320,303921,9,366385
2307,0.006103,172.31.36.0-255,66,303987,9,366385
2308,0.006129,74.125.130.0-255,5738,309725,9,366385
2309,0.006133,172.31.36.0-255,66,309791,9,366385
2310,0.006147,172.31.36.0-255,66,309857,9,366385
2311,0.006154,74.125.130.0-255,7156,317013,9,366385
2312,0.006157,172.31.36.0-255,66,317079,9,366385
2313,0.00618,74.125.130.0-255,2902,319981,9,366385
2314,0.006183,172.31.36.0-255,66,320047,9,366385
2315,0.006194,172.31.36.0-255,66,320113,9,366385
2316,0.006214,74.125.130.0-255,2902,323015,9,366385
2317,0.006216,172.31.36.0-255,66,323081,9,366385
2318,0.006222,74.125.130.0-255,5738,328819,9,366385
2319,0.006225,172.31.36.0-255,66,328885,9,366385
2320,0.006231,74.125.130.0-255,6438,335323,9,366385
2321,0.006234,172.31.36.0-255,66,335389,9,366385
2322,0.006251,74.125.130.0-255,2902,338291,9,366385
2323,0.006253,172.31.36.0-255,66,338357,9,366385
2324,0.006278,74.125.130.0-255,1484,339841,9,366385
2325,0.006285,74.125.130.0-255,5738,345579,9,366385
2326,0.006289,172.31.36.0-255,66,345645,9,366385
2327,0.006294,74.125.130.0-255,4320,349965,9,366385
2328,0.006296,172.31.36.0-255,66,350031,9,366385
2329,0.006315,74.125.130.0-255,7156,357187,9,366385
2330,0.006318,172.31.36.0-255,66,357253,9,366385
2331,0.006323,74.125.130.0-255,4320,361573,9,366385
2332,0.006325,172.31.36.0-255,66,361639,9,366385
2333,0.006358,74.125.130.0-255,4404,366043,9,366385
2334,0.00637,172.31.36.0-255,66,366109,9,366385
2335,0.006381,74.125.130.0-255,105,366214,9,366385
2336,0.008174,172.31.36.0-255,66,366280,9,366385
2337,0.008202,172.31.36.0-255,105,366385,9,366385
2338,0.0,74.125.24.0-255,146,146,9,224664
2339,3.1e-05,172.31.36.0-255,66,212,9,224664
2340,3.7e-05,74.125.24.0-255,1484,1696,9,224664
2341,4.1e-05,172.31.36.0-255,66,1762,9,224664
2342,4.6e-05,74.125.24.0-255,2902,4664,9,224664
2343,5e-05,172.31.36.0-255,66,4730,9,224664
2344,5.8e-05,74.125.24.0-255,7156,11886,9,224664
2345,6e-05,172.31.36.0-255,66,11952,9,224664
2346,7.6e-05,172.31.36.0-255,66,12018,9,224664
2347,8.3e-05,74.125.24.0-255,5738,17756,9,224664
2348,8.5e-05,172.31.36.0-255,66,17822,9,224664
2349,0.000111,74.125.24.0-255,4320,22142,9,224664
2350,0.000114,172.31.36.0-255,66,22208,9,224664
2351,0.000139,74.125.24.0-255,7156,29364,9,224664
2352,0.000141,172.31.36.0-255,66,29430,9,224664
2353,0.000165,74.125.24.0-255,6438,35868,9,224664
2354,0.000168,172.31.36.0-255,66,35934,9,224664
2355,0.000241,74.125.24.0-255,1484,37418,9,224664
2356,0.000244,172.31.36.0-255,66,37484,9,224664
2357,0.000249,74.125.24.0-255,2902,40386,9,224664
2358,0.000252,172.31.36.0-255,66,40452,9,224664
2359,0.000273,74.125.24.0-255,5738,46190,9,224664
2360,0.000278,172.31.36.0-255,66,46256,9,224664
2361,0.000282,74.125.24.0-255,2902,49158,9,224664
2362,0.000285,172.31.36.0-255,66,49224,9,224664
2363,0.000301,74.125.24.0-255,4229,53453,9,224664
2364,0.000305,172.31.36.0-255,66,53519,9,224664
2365,0.000308,74.125.24.0-255,135,53654,9,224664
2366,0.000311,172.31.36.0-255,66,53720,9,224664
2367,0.000356,74.125.24.0-255,1484,55204,9,224664
2368,0.000359,172.31.36.0-255,66,55270,9,224664
2369,0.000375,74.125.24.0-255,2902,58172,9,224664
2370,0.000378,172.31.36.0-255,66,58238,9,224664
2371,0.000384,74.125.24.0-255,5738,63976,9,224664
2372,0.000387,172.31.36.0-255,66,64042,9,224664
2373,0.000391,74.125.24.0-255,2902,66944,9,224664
2374,0.000393,172.31.36.0-255,66,67010,9,224664
2375,0.000415,74.125.24.0-255,4320,71330,9,224664
2376,0.000419,172.31.36.0-255,66,71396,9,224664
2377,0.000457,172.31.36.0-255,66,71462,9,224664
2378,0.000479,74.125.24.0-255,2902,74364,9,224664
2379,0.000482,172.31.36.0-255,66,74430,9,224664
2380,0.000486,74.125.24.0-255,1887,76317,9,224664
2381,0.000489,172.31.36.0-255,66,76383,9,224664
2382,0.000536,74.125.24.0-255,1484,77867,9,224664
2383,0.000553,74.125.24.0-255,2902,80769,9,224664
2384,0.000556,172.31.36.0-255,66,80835,9,224664
2385,0.000562,74.125.24.0-255,5738,86573,9,224664
2386,0.000565,172.31.36.0-255,66,86639,9,224664
2387,0.00058,74.125.24.0-255,4320,90959,9,224664
2388,0.000583,172.31.36.0-255,66,91025,9,224664
2389,0.000606,172.31.36.0-255,66,91091,9,224664
2390,0.000613,74.125.24.0-255,5738,96829,9,224664
2391,0.000615,172.31.36.0-255,66,96895,9,224664
2392,0.000646,74.125.24.0-255,5020,101915,9,224664
2393,0.00065,172.31.36.0-255,66,101981,9,224664
2394,0.000962,74.125.24.0-255,1484,103465,9,224664
2395,0.000969,74.125.24.0-255,2902,106367,9,224664
2396,0.000972,172.31.36.0-255,66,106433,9,224664
2397,0.000977,74.125.24.0-255,2902,109335,9,224664
2398,0.000979,172.31.36.0-255,66,109401,9,224664
2399,0.001001,74.125.24.0-255,5738,115139,9,224664
2400,0.001004,172.31.36.0-255,66,115205,9,224664
2401,0.001019,74.125.24.0-255,1484,116689,9,224664
2402,0.001023,74.125.24.0-255,1484,118173,9,224664
2403,0.001025,172.31.36.0-255,66,118239,9,224664
2404,0.001054,172.31.36.0-255,66,118305,9,224664
2405,0.001076,74.125.24.0-255,2902,121207,9,224664
2406,0.001079,172.31.36.0-255,66,121273,9,224664
2407,0.001084,74.125.24.0-255,3602,124875,9,224664
2408,0.001091,172.31.36.0-255,66,124941,9,224664
2409,0.001119,74.125.24.0-255,1484,126425,9,224664
2410,0.001124,74.125.24.0-255,2902,129327,9,224664
2411,0.001127,172.31.36.0-255,66,129393,9,224664
2412,0.001134,74.125.24.0-255,5738,135131,9,224664
2413,0.001136,172.31.36.0-255,66,135197,9,224664
2414,0.001141,74.125.24.0-255,4320,139517,9,224664
2415,0.001145,172.31.36.0-255,66,139583,9,224664
2416,0.001148,74.125.24.0-255,1484,141067,9,224664
2417,0.001183,172.31.36.0-255,66,141133,9,224664
2418,0.00119,74.125.24.0-255,5738,146871,9,224664
2419,0.001192,172.31.36.0-255,66,146937,9,224664
2420,0.001208,74.125.24.0-255,2184,149121,9,224664
2421,0.001211,172.31.36.0-255,66,149187,9,224664
2422,0.001263,74.125.24.0-255,1484,150671,9,224664
2423,0.001268,74.125.24.0-255,2902,153573,9,224664
2424,0.001271,172.31.36.0-255,66,153639,9,224664
2425,0.001287,74.125.24.0-255,5738,159377,9,224664
2426,0.00129,172.31.36.0-255,66,159443,9,224664
2427,0.001324,172.31.36.0-255,66,159509,9,224664
2428,0.001368,172.31.36.0-255,66,159575,9,224664
2429,0.001386,74.125.24.0-255,5020,164595,9,224664
2430,0.001391,172.31.36.0-255,66,164661,9,224664
2431,0.001428,74.125.24.0-255,1484,166145,9,224664
2432,0.001442,74.125.24.0-255,2902,169047,9,224664
2433,0.001446,172.31.36.0-255,66,169113,9,224664
2434,0.001451,74.125.24.0-255,2902,172015,9,224664
2435,0.001454,172.31.36.0-255,66,172081,9,224664
2436,0.001468,74.125.24.0-255,2902,174983,9,224664
2437,0.001471,172.31.36.0-255,66,175049,9,224664
2438,0.001474,74.125.24.0-255,1484,176533,9,224664
2439,0.001519,172.31.36.0-255,66,176599,9,224664
2440,0.001531,172.31.36.0-255,66,176665,9,224664
2441,0.001552,74.125.24.0-255,7156,183821,9,224664
2442,0.001556,172.31.36.0-255,66,183887,9,224664
2443,0.001582,172.31.36.0-255,66,183953,9,224664
2444,0.001594,172.31.36.0-255,66,184019,9,224664
2445,0.001675,172.31.36.0-255,66,184085,9,224664
2446,0.001687,172.31.36.0-255,66,184151,9,224664
2447,0.001729,172.31.36.0-255,101,184252,9,224664
2448,0.001889,74.125.24.0-255,1484,185736,9,224664
2449,0.001895,74.125.24.0-255,2902,188638,9,224664
2450,0.001899,172.31.36.0-255,66,188704,9,224664
2451,0.001921,74.125.24.0-255,5738,194442,9,224664
2452,0.001924,172.31.36.0-255,66,194508,9,224664
2453,0.001949,172.31.36.0-255,66,194574,9,224664
2454,0.001972,74.125.24.0-255,2902,197476,9,224664
2455,0.001975,172.31.36.0-255,66,197542,9,224664
2456,0.001987,172.31.36.0-255,66,197608,9,224664
2457,0.002019,74.125.24.0-255,7156,204764,9,224664
2458,0.002023,172.31.36.0-255,66,204830,9,224664
2459,0.002046,74.125.24.0-255,4320,209150,9,224664
2460,0.002049,172.31.36.0-255,66,209216,9,224664
2461,0.002062,172.31.36.0-255,66,209282,9,224664
2462,0.002066,74.125.24.0-255,1484,210766,9,224664
2463,0.002096,172.31.36.0-255,66,210832,9,224664
2464,0.002114,74.125.24.0-255,6438,217270,9,224664
2465,0.002118,172.31.36.0-255,66,217336,9,224664
2466,0.002125,74.125.24.0-255,6986,224322,9,224664
2467,0.002127,172.31.36.0-255,66,224388,9,224664
2468,0.002131,74.125.24.0-255,105,224493,9,224664
2469,0.004025,74.125.24.0-255,66,224559,9,224664
2470,0.007925,172.31.36.0-255,105,224664,9,224664
2471,0.0,172.217.194.0-255,293,293,9,228446
2472,2.6e-05,172.31.36.0-255,66,359,9,228446
2473,3.3e-05,172.217.194.0-255,1484,1843,9,228446
2474,3.6e-05,172.31.36.0-255,66,1909,9,228446
2475,6.1e-05,172.217.194.0-255,1484,3393,9,228446
2476,6.4e-05,172.31.36.0-255,66,3459,9,228446
2477,7e-05,172.217.194.0-255,2902,6361,9,228446
2478,7.2e-05,172.31.36.0-255,66,6427,9,228446
2479,7.8e-05,172.217.194.0-255,5738,12165,9,228446
2480,8.1e-05,172.31.36.0-255,66,12231,9,228446
2481,0.000112,172.217.194.0-255,4320,16551,9,228446
2482,0.000115,172.31.36.0-255,66,16617,9,228446
2483,0.000154,172.31.36.0-255,66,16683,9,228446
2484,0.00016,172.217.194.0-255,5379,22062,9,228446
2485,0.000162,172.31.36.0-255,66,22128,9,228446
2486,0.000191,172.217.194.0-255,1484,23612,9,228446
2487,0.000194,172.31.36.0-255,66,23678,9,228446
2488,0.0002,172.217.194.0-255,2902,26580,9,228446
2489,0.000202,172.31.36.0-255,66,26646,9,228446
2490,0.000205,172.217.194.0-255,1484,28130,9,228446
2491,0.000213,172.31.36.0-255,66,28196,9,228446
2492,0.000239,172.217.194.0-255,4320,32516,9,228446
2493,0.000242,172.31.36.0-255,66,32582,9,228446
2494,0.000248,172.217.194.0-255,5738,38320,9,228446
2495,0.00025,172.31.36.0-255,66,38386,9,228446
2496,0.000255,172.217.194.0-255,2902,41288,9,228446
2497,0.000257,172.31.36.0-255,66,41354,9,228446
2498,0.000306,172.31.36.0-255,66,41420,9,228446
2499,0.000311,172.217.194.0-255,4210,45630,9,228446
2500,0.000314,172.31.36.0-255,66,45696,9,228446
2501,0.000342,172.217.194.0-255,121,45817,9,228446
2502,0.000391,172.217.194.0-255,1484,47301,9,228446
2503,0.000394,172.31.36.0-255,66,47367,9,228446
2504,0.000421,172.217.194.0-255,2902,50269,9,228446
2505,0.000424,172.31.36.0-255,66,50335,9,228446
2506,0.000431,172.217.194.0-255,7156,57491,9,228446
2507,0.000434,172.31.36.0-255,66,57557,9,228446
2508,0.000497,172.217.194.0-255,1484,59041,9,228446
2509,0.000508,172.217.194.0-255,1484,60525,9,228446
2510,0.00051,172.31.36.0-255,66,60591,9,228446
2511,0.000547,172.31.36.0-255,66,60657,9,228446
2512,0.000551,172.217.194.0-255,2902,63559,9,228446
2513,0.000554,172.31.36.0-255,66,63625,9,228446
2514,0.000591,172.217.194.0-255,7113,70738,9,228446
2515,0.000595,172.31.36.0-255,66,70804,9,228446
2516,0.000883,172.217.194.0-255,1484,72288,9,228446
2517,0.000888,172.217.194.0-255,2902,75190,9,228446
2518,0.000891,172.31.36.0-255,66,75256,9,228446
2519,0.000919,172.217.194.0-255,5738,80994,9,228446
2520,0.000923,172.31.36.0-255,66,81060,9,228446
2521,0.000934,172.217.194.0-255,1484,82544,9,228446
2522,0.00095,172.217.194.0-255,4320,86864,9,228446
2523,0.000953,172.31.36.0-255,66,86930,9,228446
2524,0.000987,172.217.194.0-255,7156,94086,9,228446
2525,0.00099,172.31.36.0-255,66,94152,9,228446
2526,0.001001,172.31.36.0-255,66,94218,9,228446
2527,0.001025,172.217.194.0-255,2184,96402,9,228446
2528,0.001028,172.31.36.0-255,66,96468,9,228446
2529,0.001071,172.217.194.0-255,1484,97952,9,228446
2530,0.001076,172.217.194.0-255,2902,100854,9,228446
2531,0.00108,172.31.36.0-255,66,100920,9,228446
2532,0.001081,172.217.194.0-255,5738,106658,9,228446
2533,0.001083,172.31.36.0-255,66,106724,9,228446
2534,0.001146,172.217.194.0-255,5738,112462,9,228446
2535,0.00115,172.31.36.0-255,66,112528,9,228446
2536,0.001179,172.217.194.0-255,7156,119684,9,228446
2537,0.001183,172.31.36.0-255,66,119750,9,228446
2538,0.001188,172.217.194.0-255,2902,122652,9,228446
2539,0.00119,172.31.36.0-255,66,122718,9,228446
2540,0.001206,172.217.194.0-255,1484,124202,9,228446
2541,0.00123,172.217.194.0-255,2902,127104,9,228446
2542,0.001233,172.31.36.0-255,66,127170,9,228446
2543,0.001262,172.217.194.0-255,3602,130772,9,228446
2544,0.001264,172.31.36.0-255,66,130838,9,228446
2545,0.001267,172.217.194.0-255,1484,132322,9,228446
2546,0.001271,172.217.194.0-255,2902,135224,9,228446
2547,0.001273,172.31.36.0-255,66,135290,9,228446
2548,0.001282,172.217.194.0-255,1484,136774,9,228446
2549,0.001308,172.217.194.0-255,4320,141094,9,228446
2550,0.001312,172.31.36.0-255,66,141160,9,228446
2551,0.001317,172.217.194.0-255,4320,145480,9,228446
2552,0.001319,172.31.36.0-255,66,145546,9,228446
2553,0.001349,172.31.36.0-255,66,145612,9,228446
2554,0.001356,172.217.194.0-255,7156,152768,9,228446
2555,0.001358,172.31.36.0-255,66,152834,9,228446
2556,0.00138,172.217.194.0-255,1484,154318,9,228446
2557,0.001406,172.217.194.0-255,2184,156502,9,228446
2558,0.001409,172.31.36.0-255,66,156568,9,228446
2559,0.001508,172.217.194.0-255,1484,158052,9,228446
2560,0.001534,172.217.194.0-255,2902,160954,9,228446
2561,0.001538,172.31.36.0-255,66,161020,9,228446
2562,0.001541,172.217.194.0-255,1484,162504,9,228446
2563,0.001578,172.217.194.0-255,4320,166824,9,228446
2564,0.001581,172.31.36.0-255,66,166890,9,228446
2565,0.001588,172.217.194.0-255,7156,174046,9,228446
2566,0.00159,172.31.36.0-255,66,174112,9,228446
2567,0.001625,172.217.194.0-255,5738,179850,9,228446
2568,0.001628,172.31.36.0-255,66,179916,9,228446
2569,0.001638,172.31.36.0-255,66,179982,9,228446
2570,0.001686,172.217.194.0-255,2184,182166,9,228446
2571,0.001689,172.31.36.0-255,66,182232,9,228446
2572,0.00174,172.217.194.0-255,2902,185134,9,228446
2573,0.001744,172.31.36.0-255,66,185200,9,228446
2574,0.00175,172.217.194.0-255,5738,190938,9,228446
2575,0.001752,172.31.36.0-255,66,191004,9,228446
2576,0.001762,172.217.194.0-255,2902,193906,9,228446
2577,0.001765,172.31.36.0-255,66,193972,9,228446
2578,0.001798,172.217.194.0-255,7156,201128,9,228446
2579,0.001801,172.31.36.0-255,66,201194,9,228446
2580,0.001817,172.31.36.0-255,66,201260,9,228446
2581,0.00182,172.217.194.0-255,1484,202744,9,228446
2582,0.001824,172.217.194.0-255,2902,205646,9,228446
2583,0.001826,172.31.36.0-255,66,205712,9,228446
2584,0.001855,172.217.194.0-255,5738,211450,9,228446
2585,0.001858,172.31.36.0-255,66,211516,9,228446
2586,0.001872,172.31.36.0-255,66,211582,9,228446
2587,0.001878,172.217.194.0-255,4320,215902,9,228446
2588,0.001879,172.31.36.0-255,66,215968,9,228446
2589,0.001902,172.217.194.0-255,2902,218870,9,228446
2590,0.001906,172.31.36.0-255,66,218936,9,228446
2591,0.001911,172.217.194.0-255,4320,223256,9,228446
2592,0.001913,172.31.36.0-255,66,223322,9,228446
2593,0.001963,172.31.36.0-255,66,223388,9,228446
2594,0.001978,172.31.36.0-255,66,223454,9,228446
2595,0.002019,172.217.194.0-255,4320,227774,9,228446
2596,0.002023,172.31.36.0-255,66,227840,9,228446
2597,0.00208,172.31.36.0-255,66,227906,9,228446
2598,0.002092,172.31.36.0-255,66,227972,9,228446
2599,0.002111,172.31.36.0-255,66,228038,9,228446
2600,0.002123,172.31.36.0-255,66,228104,9,228446
2601,0.002126,172.217.194.0-255,105,228209,9,228446
2602,0.003669,172.31.36.0-255,66,228275,9,228446
2603,0.003696,172.31.36.0-255,105,228380,9,228446
2604,0.006039,172.217.194.0-255,66,228446,9,228446
2605,0.0,172.217.194.0-255,153,153,9,161650
2606,1.7e-05,172.31.36.0-255,66,219,9,161650
2607,2.3e-05,172.217.194.0-255,1484,1703,9,161650
2608,2.7e-05,172.31.36.0-255,66,1769,9,161650
2609,3.4e-05,172.217.194.0-255,2902,4671,9,161650
2610,4.6e-05,172.31.36.0-255,66,4737,9,161650
2611,5.4e-05,172.217.194.0-255,7156,11893,9,161650
2612,5.7e-05,172.31.36.0-255,66,11959,9,161650
2613,6.1e-05,172.217.194.0-255,2048,14007,9,161650
2614,6.3e-05,172.31.36.0-255,66,14073,9,161650
2615,7.7e-05,172.31.36.0-255,66,14139,9,161650
2616,0.0001,172.217.194.0-255,1484,15623,9,161650
2617,0.000103,172.31.36.0-255,66,15689,9,161650
2618,0.000144,172.217.194.0-255,3961,19650,9,161650
2619,0.000153,172.31.36.0-255,66,19716,9,161650
2620,0.000181,172.217.194.0-255,1484,21200,9,161650
2621,0.000184,172.31.36.0-255,66,21266,9,161650
2622,0.000189,172.217.194.0-255,2902,24168,9,161650
2623,0.000192,172.31.36.0-255,66,24234,9,161650
2624,0.000204,172.217.194.0-255,5738,29972,9,161650
2625,0.000206,172.31.36.0-255,66,30038,9,161650
2626,0.000209,172.217.194.0-255,1484,31522,9,161650
2627,0.000211,172.31.36.0-255,66,31588,9,161650
2628,0.000273,172.31.36.0-255,66,31654,9,161650
2629,0.000279,172.217.194.0-255,4320,35974,9,161650
2630,0.000281,172.31.36.0-255,66,36040,9,161650
2631,0.000288,172.217.194.0-255,1484,37524,9,161650
2632,0.000291,172.31.36.0-255,66,37590,9,161650
2633,0.000329,172.217.194.0-255,7053,44643,9,161650
2634,0.000331,172.31.36.0-255,66,44709,9,161650
2635,0.000334,172.217.194.0-255,116,44825,9,161650
2636,0.00038,172.217.194.0-255,1484,46309,9,161650
2637,0.000383,172.31.36.0-255,66,46375,9,161650
2638,0.000388,172.217.194.0-255,2902,49277,9,161650
2639,0.00039,172.31.36.0-255,66,49343,9,161650
2640,0.000431,172.217.194.0-255,5738,55081,9,161650
2641,0.000434,172.31.36.0-255,66,55147,9,161650
2642,0.000448,172.31.36.0-255,66,55213,9,161650
2643,0.000461,172.217.194.0-255,7156,62369,9,161650
2644,0.000463,172.31.36.0-255,66,62435,9,161650
2645,0.000506,172.217.194.0-255,3602,66037,9,161650
2646,0.000509,172.31.36.0-255,66,66103,9,161650
2647,0.000512,172.217.194.0-255,1484,67587,9,161650
2648,0.000538,172.217.194.0-255,2902,70489,9,161650
2649,0.00054,172.31.36.0-255,66,70555,9,161650
2650,0.000545,172.217.194.0-255,2902,73457,9,161650
2651,0.000547,172.31.36.0-255,66,73523,9,161650
2652,0.000565,172.217.194.0-255,1484,75007,9,161650
2653,0.000575,172.217.194.0-255,5738,80745,9,161650
2654,0.000578,172.31.36.0-255,66,80811,9,161650
2655,0.000612,172.31.36.0-255,66,80877,9,161650
2656,0.000618,172.217.194.0-255,5738,86615,9,161650
2657,0.000621,172.31.36.0-255,66,86681,9,161650
2658,0.000628,172.217.194.0-255,6438,93119,9,161650
2659,0.00063,172.31.36.0-255,66,93185,9,161650
2660,0.000689,172.31.36.0-255,66,93251,9,161650
2661,0.000701,172.31.36.0-255,66,93317,9,161650
2662,0.000732,172.217.194.0-255,6438,99755,9,161650
2663,0.000735,172.31.36.0-255,66,99821,9,161650
2664,0.000792,172.217.194.0-255,1484,101305,9,161650
2665,0.000811,172.217.194.0-255,2902,104207,9,161650
2666,0.000814,172.31.36.0-255,66,104273,9,161650
2667,0.000847,172.217.194.0-255,5738,110011,9,161650
2668,0.00085,172.31.36.0-255,66,110077,9,161650
2669,0.000869,172.31.36.0-255,66,110143,9,161650
2670,0.000875,172.217.194.0-255,4320,114463,9,161650
2671,0.000877,172.31.36.0-255,66,114529,9,161650
2672,0.000882,172.217.194.0-255,2902,117431,9,161650
2673,0.000884,172.31.36.0-255,66,117497,9,161650
2674,0.000917,172.217.194.0-255,2902,120399,9,161650
2675,0.00092,172.31.36.0-255,66,120465,9,161650
2676,0.000923,172.217.194.0-255,766,121231,9,161650
2677,0.001025,172.217.194.0-255,1484,122715,9,161650
2678,0.001029,172.31.36.0-255,66,122781,9,161650
2679,0.001035,172.217.194.0-255,2902,125683,9,161650
2680,0.001039,172.31.36.0-255,66,125749,9,161650
2681,0.00105,172.217.194.0-255,5738,131487,9,161650
2682,0.001052,172.31.36.0-255,66,131553,9,161650
2683,0.0011,172.217.194.0-255,1484,133037,9,161650
2684,0.001133,172.31.36.0-255,66,133103,9,161650
2685,0.001145,172.31.36.0-255,66,133169,9,161650
2686,0.001154,172.217.194.0-255,2184,135353,9,161650
2687,0.001156,172.31.36.0-255,66,135419,9,161650
2688,0.00116,172.217.194.0-255,2902,138321,9,161650
2689,0.001162,172.31.36.0-255,66,138387,9,161650
2690,0.001169,172.217.194.0-255,7156,145543,9,161650
2691,0.001173,172.31.36.0-255,66,145609,9,161650
2692,0.001177,172.217.194.0-255,2902,148511,9,161650
2693,0.001179,172.31.36.0-255,66,148577,9,161650
2694,0.00123,172.31.36.0-255,66,148643,9,161650
2695,0.001246,172.31.36.0-255,66,148709,9,161650
2696,0.001267,172.31.36.0-255,66,148775,9,161650
2697,0.001294,172.217.194.0-255,5738,154513,9,161650
2698,0.001297,172.31.36.0-255,66,154579,9,161650
2699,0.001348,172.31.36.0-255,66,154645,9,161650
2700,0.001363,172.31.36.0-255,66,154711,9,161650
2701,0.001403,172.31.36.0-255,66,154777,9,161650
2702,0.001425,172.31.36.0-255,66,154843,9,161650
2703,0.001461,172.31.36.0-255,66,154909,9,161650
2704,0.00152,172.31.36.0-255,66,154975,9,161650
2705,0.001554,172.217.194.0-255,6438,161413,9,161650
2706,0.001557,172.31.36.0-255,66,161479,9,161650
2707,0.001576,172.31.36.0-255,66,161545,9,161650
2708,0.001579,172.217.194.0-255,105,161650,9,161650
2709,0.0,172.217.194.0-255,153,153,9,207897
2710,3.6e-05,172.31.36.0-255,66,219,9,207897
2711,4.3e-05,172.217.194.0-255,1484,1703,9,207897
2712,4.7e-05,172.31.36.0-255,66,1769,9,207897
2713,5.2e-05,172.217.194.0-255,2902,4671,9,207897
2714,5.5e-05,172.31.36.0-255,66,4737,9,207897
2715,6.9e-05,172.217.194.0-255,7156,11893,9,207897
2716,7.3e-05,172.31.36.0-255,66,11959,9,207897
2717,7.7e-05,172.217.194.0-255,2048,14007,9,207897
2718,7.9e-05,172.31.36.0-255,66,14073,9,207897
2719,8.3e-05,172.217.194.0-255,2902,16975,9,207897
2720,8.5e-05,172.31.36.0-255,66,17041,9,207897
2721,0.000119,172.217.194.0-255,7156,24197,9,207897
2722,0.000122,172.31.36.0-255,66,24263,9,207897
2723,0.00014,172.217.194.0-255,5738,30001,9,207897
2724,0.000147,172.31.36.0-255,66,30067,9,207897
2725,0.000172,172.217.194.0-255,1125,31192,9,207897
2726,0.000176,172.31.36.0-255,66,31258,9,207897
2727,0.000271,172.217.194.0-255,1484,32742,9,207897
2728,0.000274,172.31.36.0-255,66,32808,9,207897
2729,0.000279,172.217.194.0-255,2902,35710,9,207897
2730,0.000281,172.31.36.0-255,66,35776,9,207897
2731,0.000288,172.217.194.0-255,5738,41514,9,207897
2732,0.000291,172.31.36.0-255,66,41580,9,207897
2733,0.000304,172.217.194.0-255,6797,48377,9,207897
2734,0.000306,172.31.36.0-255,66,48443,9,207897
2735,0.000354,172.217.194.0-255,1484,49927,9,207897
2736,0.000357,172.31.36.0-255,66,49993,9,207897
2737,0.000362,172.217.194.0-255,2902,52895,9,207897
2738,0.000364,172.31.36.0-255,66,52961,9,207897
2739,0.000371,172.217.194.0-255,5738,58699,9,207897
2740,0.000373,172.31.36.0-255,66,58765,9,207897
2741,0.000384,172.217.194.0-255,4320,63085,9,207897
2742,0.000387,172.31.36.0-255,66,63151,9,207897
2743,0.000412,172.217.194.0-255,2543,65694,9,207897
2744,0.000416,172.31.36.0-255,66,65760,9,207897
2745,0.000524,172.217.194.0-255,645,66405,9,207897
2746,0.000653,172.217.194.0-255,1484,67889,9,207897
2747,0.000657,172.31.36.0-255,66,67955,9,207897
2748,0.000663,172.217.194.0-255,2902,70857,9,207897
2749,0.000665,172.31.36.0-255,66,70923,9,207897
2750,0.000677,172.217.194.0-255,5738,76661,9,207897
2751,0.000679,172.31.36.0-255,66,76727,9,207897
2752,0.000684,172.217.194.0-255,2902,79629,9,207897
2753,0.000686,172.31.36.0-255,66,79695,9,207897
2754,0.000711,172.217.194.0-255,3961,83656,9,207897
2755,0.000714,172.31.36.0-255,66,83722,9,207897
2756,0.000721,172.217.194.0-255,7156,90878,9,207897
2757,0.000724,172.217.194.0-255,1484,92362,9,207897
2758,0.000726,172.31.36.0-255,66,92428,9,207897
2759,0.00077,172.31.36.0-255,66,92494,9,207897
2760,0.001106,172.217.194.0-255,1484,93978,9,207897
2761,0.001113,172.217.194.0-255,2902,96880,9,207897
2762,0.001118,172.31.36.0-255,66,96946,9,207897
2763,0.001157,172.217.194.0-255,4320,101266,9,207897
2764,0.00116,172.31.36.0-255,66,101332,9,207897
2765,0.001198,172.217.194.0-255,1484,102816,9,207897
2766,0.001212,172.31.36.0-255,66,102882,9,207897
2767,0.00123,172.31.36.0-255,66,102948,9,207897
2768,0.001234,172.217.194.0-255,2184,105132,9,207897
2769,0.001236,172.31.36.0-255,66,105198,9,207897
2770,0.001804,172.217.194.0-255,1484,106682,9,207897
2771,0.001814,172.217.194.0-255,2902,109584,9,207897
2772,0.001817,172.31.36.0-255,66,109650,9,207897
2773,0.001825,172.217.194.0-255,5738,115388,9,207897
2774,0.001827,172.31.36.0-255,66,115454,9,207897
2775,0.001888,172.31.36.0-255,66,115520,9,207897
2776,0.001901,172.31.36.0-255,66,115586,9,207897
2777,0.002105,172.217.194.0-255,1484,117070,9,207897
2778,0.002112,172.217.194.0-255,2902,119972,9,207897
2779,0.002116,172.31.36.0-255,66,120038,9,207897
2780,0.002119,172.217.194.0-255,1484,121522,9,207897
2781,0.002146,172.217.194.0-255,4320,125842,9,207897
2782,0.002148,172.31.36.0-255,66,125908,9,207897
2783,0.002153,172.217.194.0-255,2902,128810,9,207897
2784,0.002154,172.31.36.0-255,66,128876,9,207897
2785,0.00219,172.31.36.0-255,66,128942,9,207897
2786,0.0022,172.31.36.0-255,66,129008,9,207897
2787,0.002211,172.217.194.0-255,1484,130492,9,207897
2788,0.002239,172.217.194.0-255,766,131258,9,207897
2789,0.002242,172.31.36.0-255,66,131324,9,207897
2790,0.002279,172.217.194.0-255,1484,132808,9,207897
2791,0.002306,172.217.194.0-255,2902,135710,9,207897
2792,0.002309,172.31.36.0-255,66,135776,9,207897
2793,0.002311,172.217.194.0-255,1484,137260,9,207897
2794,0.002337,172.217.194.0-255,4320,141580,9,207897
2795,0.00234,172.31.36.0-255,66,141646,9,207897
2796,0.002346,172.217.194.0-255,5738,147384,9,207897
2797,0.002348,172.31.36.0-255,66,147450,9,207897
2798,0.00238,172.31.36.0-255,66,147516,9,207897
2799,0.002386,172.217.194.0-255,5020,152536,9,207897
2800,0.002388,172.31.36.0-255,66,152602,9,207897
2801,0.002832,172.217.194.0-255,1484,154086,9,207897
2802,0.002851,172.217.194.0-255,2902,156988,9,207897
2803,0.002854,172.31.36.0-255,66,157054,9,207897
2804,0.002857,172.217.194.0-255,1484,158538,9,207897
2805,0.002875,172.217.194.0-255,4320,162858,9,207897
2806,0.002878,172.31.36.0-255,66,162924,9,207897
2807,0.002908,172.217.194.0-255,7156,170080,9,207897
2808,0.00291,172.31.36.0-255,66,170146,9,207897
2809,0.00293,172.217.194.0-255,2902,173048,9,207897
2810,0.002933,172.31.36.0-255,66,173114,9,207897
2811,0.002944,172.31.36.0-255,66,173180,9,207897
2812,0.002948,172.217.194.0-255,2184,175364,9,207897
2813,0.002949,172.31.36.0-255,66,175430,9,207897
2814,0.004207,172.217.194.0-255,1484,176914,9,207897
2815,0.004214,172.217.194.0-255,2902,179816,9,207897
2816,0.004217,172.31.36.0-255,66,179882,9,207897
2817,0.004222,172.217.194.0-255,2902,182784,9,207897
2818,0.004224,172.31.36.0-255,66,182850,9,207897
2819,0.004248,172.217.194.0-255,1484,184334,9,207897
2820,0.004276,172.31.36.0-255,66,184400,9,207897
2821,0.004286,172.31.36.0-255,66,184466,9,207897
2822,0.004369,172.31.36.0-255,66,184532,9,207897
2823,0.004412,172.31.36.0-255,66,184598,9,207897
2824,0.004662,172.217.194.0-255,1484,186082,9,207897
2825,0.004675,172.217.194.0-255,2902,188984,9,207897
2826,0.004677,172.31.36.0-255,66,189050,9,207897
2827,0.00468,172.217.194.0-255,1484,190534,9,207897
2828,0.004723,172.31.36.0-255,66,190600,9,207897
2829,0.004726,172.217.194.0-255,1484,192084,9,207897
2830,0.004772,172.31.36.0-255,66,192150,9,207897
2831,0.004775,172.217.194.0-255,766,192916,9,207897
2832,0.004923,172.217.194.0-255,1484,194400,9,207897
2833,0.004925,172.31.36.0-255,66,194466,9,207897
2834,0.004942,172.217.194.0-255,2902,197368,9,207897
2835,0.004945,172.31.36.0-255,66,197434,9,207897
2836,0.004948,172.217.194.0-255,1484,198918,9,207897
2837,0.004975,172.217.194.0-255,4320,203238,9,207897
2838,0.004978,172.31.36.0-255,66,203304,9,207897
2839,0.004994,172.31.36.0-255,66,203370,9,207897
2840,0.004997,172.217.194.0-255,1484,204854,9,207897
2841,0.005036,172.31.36.0-255,66,204920,9,207897
2842,0.005048,172.31.36.0-255,66,204986,9,207897
2843,0.005056,172.217.194.0-255,2740,207726,9,207897
2844,0.005058,172.31.36.0-255,66,207792,9,207897
2845,0.005081,172.217.194.0-255,105,207897,9,207897
2846,0.0,74.125.68.0-255,150,150,9,132525
2847,2.4e-05,172.31.36.0-255,66,216,9,132525
2848,3.1e-05,74.125.68.0-255,1484,1700,9,132525
2849,3.6e-05,172.31.36.0-255,66,1766,9,132525
2850,5.1e-05,74.125.68.0-255,2902,4668,9,132525
2851,5.4e-05,172.31.36.0-255,66,4734,9,132525
2852,6e-05,74.125.68.0-255,2902,7636,9,132525
2853,6.2e-05,172.31.36.0-255,66,7702,9,132525
2854,0.000102,74.125.68.0-255,4320,12022,9,132525
2855,0.000107,172.31.36.0-255,66,12088,9,132525
2856,0.000111,74.125.68.0-255,2045,14133,9,132525
2857,0.000113,172.31.36.0-255,66,14199,9,132525
2858,0.000279,74.125.68.0-255,1484,15683,9,132525
2859,0.000284,172.31.36.0-255,66,15749,9,132525
2860,0.000313,74.125.68.0-255,2902,18651,9,132525
2861,0.000317,172.31.36.0-255,66,18717,9,132525
2862,0.000321,74.125.68.0-255,2902,21619,9,132525
2863,0.000323,172.31.36.0-255,66,21685,9,132525
2864,0.000348,74.125.68.0-255,2902,24587,9,132525
2865,0.000351,172.31.36.0-255,66,24653,9,132525
2866,0.000364,74.125.68.0-255,6797,31450,9,132525
2867,0.000366,172.31.36.0-255,66,31516,9,132525
2868,0.000394,74.125.68.0-255,1484,33000,9,132525
2869,0.000397,172.31.36.0-255,66,33066,9,132525
2870,0.000401,74.125.68.0-255,2902,35968,9,132525
2871,0.000404,172.31.36.0-255,66,36034,9,132525
2872,0.000414,74.125.68.0-255,5738,41772,9,132525
2873,0.000417,172.31.36.0-255,66,41838,9,132525
2874,0.000453,74.125.68.0-255,6797,48635,9,132525
2875,0.000457,172.31.36.0-255,66,48701,9,132525
2876,0.000533,74.125.68.0-255,1484,50185,9,132525
2877,0.000537,172.31.36.0-255,66,50251,9,132525
2878,0.000541,74.125.68.0-255,1484,51735,9,132525
2879,0.000565,74.125.68.0-255,1484,53219,9,132525
2880,0.000571,74.125.68.0-255,5738,58957,9,132525
2881,0.000572,172.31.36.0-255,66,59023,9,132525
2882,0.000578,172.31.36.0-255,66,59089,9,132525
2883,0.000596,74.125.68.0-255,5738,64827,9,132525
2884,0.000607,172.31.36.0-255,66,64893,9,132525
2885,0.00062,74.125.68.0-255,1125,66018,9,132525
2886,0.000665,74.125.68.0-255,397,66415,9,132525
2887,0.000762,74.125.68.0-255,111,66526,9,132525
2888,0.000767,172.31.36.0-255,66,66592,9,132525
2889,0.000967,74.125.68.0-255,1484,68076,9,132525
2890,0.000981,74.125.68.0-255,2902,70978,9,132525
2891,0.000984,172.31.36.0-255,66,71044,9,132525
2892,0.000991,74.125.68.0-255,5738,76782,9,132525
2893,0.000994,74.125.68.0-255,1484,78266,9,132525
2894,0.001002,172.31.36.0-255,66,78332,9,132525
2895,0.00101,74.125.68.0-255,1484,79816,9,132525
2896,0.001036,74.125.68.0-255,1484,81300,9,132525
2897,0.001044,172.31.36.0-255,66,81366,9,132525
2898,0.001052,74.125.68.0-255,5738,87104,9,132525
2899,0.001059,172.31.36.0-255,66,87170,9,132525
2900,0.001094,74.125.68.0-255,5379,92549,9,132525
2901,0.001099,172.31.36.0-255,66,92615,9,132525
2902,0.002294,74.125.68.0-255,1484,94099,9,132525
2903,0.002329,74.125.68.0-255,2902,97001,9,132525
2904,0.002333,172.31.36.0-255,66,97067,9,132525
2905,0.002376,74.125.68.0-255,4320,101387,9,132525
2906,0.002386,74.125.68.0-255,1484,102871,9,132525
2907,0.002395,74.125.68.0-255,1484,104355,9,132525
2908,0.00241,74.125.68.0-255,5738,110093,9,132525
2909,0.002422,74.125.68.0-255,1484,111577,9,132525
2910,0.002447,74.125.68.0-255,7156,118733,9,132525
2911,0.002466,74.125.68.0-255,7156,125889,9,132525
2912,0.002469,74.125.68.0-255,766,126655,9,132525
2913,0.00725,172.31.36.0-255,66,126721,9,132525
2914,0.00974,74.125.68.0-255,5738,132459,9,132525
2915,0.009759,172.31.36.0-255,66,132525,9,132525
2916,0.0,172.217.194.0-255,209,209,9,130842
2917,1.9e-05,172.217.194.0-255,1484,1693,9,130842
2918,3e-05,172.31.36.0-255,66,1759,9,130842
2919,3.9e-05,172.217.194.0-255,4320,6079,9,130842
2920,4.4e-05,172.31.36.0-255,66,6145,9,130842
2921,8.5e-05,172.31.36.0-255,66,6211,9,130842
2922,9.6e-05,172.31.36.0-255,66,6277,9,130842
2923,0.00014,172.31.36.0-255,66,6343,9,130842
2924,0.000212,172.217.194.0-255,1484,7827,9,130842
2925,0.000218,172.217.194.0-255,2902,10729,9,130842
2926,0.000221,172.31.36.0-255,66,10795,9,130842
2927,0.00025,172.217.194.0-255,5738,16533,9,130842
2928,0.000254,172.31.36.0-255,66,16599,9,130842
2929,0.000266,172.31.36.0-255,66,16665,9,130842
2930,0.000301,172.217.194.0-255,3961,20626,9,130842
2931,0.000303,172.31.36.0-255,66,20692,9,130842
2932,0.000312,172.217.194.0-255,7156,27848,9,130842
2933,0.000319,172.31.36.0-255,66,27914,9,130842
2934,0.000383,172.217.194.0-255,2818,30732,9,130842
2935,0.000386,172.31.36.0-255,66,30798,9,130842
2936,0.000451,172.217.194.0-255,119,30917,9,130842
2937,0.000486,172.217.194.0-255,380,31297,9,130842
2938,0.000659,172.217.194.0-255,1484,32781,9,130842
2939,0.000664,172.31.36.0-255,66,32847,9,130842
2940,0.00067,172.217.194.0-255,2902,35749,9,130842
2941,0.000673,172.31.36.0-255,66,35815,9,130842
2942,0.000676,172.217.194.0-255,1484,37299,9,130842
2943,0.000705,172.217.194.0-255,4320,41619,9,130842
2944,0.000708,172.31.36.0-255,66,41685,9,130842
2945,0.000727,172.31.36.0-255,66,41751,9,130842
2946,0.00073,172.217.194.0-255,1484,43235,9,130842
2947,0.000764,172.31.36.0-255,66,43301,9,130842
2948,0.000782,172.217.194.0-255,2902,46203,9,130842
2949,0.000784,172.31.36.0-255,66,46269,9,130842
2950,0.00079,172.217.194.0-255,4320,50589,9,130842
2951,0.000793,172.31.36.0-255,66,50655,9,130842
2952,0.000797,172.217.194.0-255,2902,53557,9,130842
2953,0.0008,172.31.36.0-255,66,53623,9,130842
2954,0.00084,172.217.194.0-255,5738,59361,9,130842
2955,0.000843,172.31.36.0-255,66,59427,9,130842
2956,0.000864,172.31.36.0-255,66,59493,9,130842
2957,0.000891,172.217.194.0-255,2184,61677,9,130842
2958,0.000894,172.31.36.0-255,66,61743,9,130842
2959,0.001023,172.217.194.0-255,1484,63227,9,130842
2960,0.001045,172.217.194.0-255,2902,66129,9,130842
2961,0.001048,172.31.36.0-255,66,66195,9,130842
2962,0.001056,172.217.194.0-255,5738,71933,9,130842
2963,0.001058,172.31.36.0-255,66,71999,9,130842
2964,0.001077,172.31.36.0-255,66,72065,9,130842
2965,0.001083,172.217.194.0-255,2902,74967,9,130842
2966,0.001086,172.31.36.0-255,66,75033,9,130842
2967,0.00113,172.31.36.0-255,66,75099,9,130842
2968,0.001288,172.217.194.0-255,1484,76583,9,130842
2969,0.001292,172.217.194.0-255,1484,78067,9,130842
2970,0.001298,172.31.36.0-255,66,78133,9,130842
2971,0.001316,172.217.194.0-255,1484,79617,9,130842
2972,0.001323,172.217.194.0-255,5738,85355,9,130842
2973,0.001326,172.31.36.0-255,66,85421,9,130842
2974,0.001334,172.217.194.0-255,7156,92577,9,130842
2975,0.001336,172.31.36.0-255,66,92643,9,130842
2976,0.001379,172.31.36.0-255,66,92709,9,130842
2977,0.001383,172.217.194.0-255,2184,94893,9,130842
2978,0.001385,172.31.36.0-255,66,94959,9,130842
2979,0.001839,172.217.194.0-255,1484,96443,9,130842
2980,0.001844,172.217.194.0-255,2902,99345,9,130842
2981,0.001848,172.31.36.0-255,66,99411,9,130842
2982,0.001852,172.217.194.0-255,1484,100895,9,130842
2983,0.001884,172.217.194.0-255,4320,105215,9,130842
2984,0.001887,172.31.36.0-255,66,105281,9,130842
2985,0.001906,172.31.36.0-255,66,105347,9,130842
2986,0.001934,172.217.194.0-255,4320,109667,9,130842
2987,0.001936,172.31.36.0-255,66,109733,9,130842
2988,0.001969,172.217.194.0-255,6438,116171,9,130842
2989,0.001971,172.31.36.0-255,66,116237,9,130842
2990,0.002053,172.217.194.0-255,1484,117721,9,130842
2991,0.002059,172.217.194.0-255,2902,120623,9,130842
2992,0.002063,172.31.36.0-255,66,120689,9,130842
2993,0.002071,172.217.194.0-255,5738,126427,9,130842
2994,0.002073,172.31.36.0-255,66,126493,9,130842
2995,0.002098,172.31.36.0-255,66,126559,9,130842
2996,0.002191,172.31.36.0-255,66,126625,9,130842
2997,0.002211,172.31.36.0-255,66,126691,9,130842
2998,0.002227,172.31.36.0-255,66,126757,9,130842
2999,0.00228,172.31.36.0-255,66,126823,9,130842
3000,0.002301,172.31.36.0-255,66,126889,9,130842
3001,0.002336,172.31.36.0-255,66,126955,9,130842
3002,0.002411,172.217.194.0-255,2184,129139,9,130842
3003,0.002414,172.217.194.0-255,1427,130566,9,130842
3004,0.002416,172.217.194.0-255,105,130671,9,130842
3005,0.0064,172.31.36.0-255,66,130737,9,130842
3006,0.008833,172.31.36.0-255,105,130842,9,130842
3007,0.0,172.31.36.0-255,105,105,9,459
3008,0.00017,172.31.36.0-255,90,195,9,459
3009,0.000177,172.31.36.0-255,66,261,9,459
3010,0.002886,74.125.200.0-255,66,327,9,459
3011,0.0029,74.125.200.0-255,66,393,9,459
3012,0.002911,172.31.36.0-255,66,459,9,459
3013,0.0,74.125.24.0-255,152,152,9,122266
3014,4.2e-05,172.31.36.0-255,66,218,9,122266
3015,4.9e-05,74.125.24.0-255,1484,1702,9,122266
3016,5.4e-05,172.31.36.0-255,66,1768,9,122266
3017,5.8e-05,74.125.24.0-255,2902,4670,9,122266
3018,6.9e-05,172.31.36.0-255,66,4736,9,122266
3019,7.6e-05,74.125.24.0-255,7156,11892,9,122266
3020,7.8e-05,172.31.36.0-255,66,11958,9,122266
3021,8.9e-05,172.31.36.0-255,66,12024,9,122266
3022,9.9e-05,172.31.36.0-255,66,12090,9,122266
3023,0.000132,74.125.24.0-255,2543,14633,9,122266
3024,0.000136,172.31.36.0-255,66,14699,9,122266
3025,0.000197,74.125.24.0-255,1484,16183,9,122266
3026,0.000201,172.31.36.0-255,66,16249,9,122266
3027,0.000233,74.125.24.0-255,2902,19151,9,122266
3028,0.000235,172.31.36.0-255,66,19217,9,122266
3029,0.000242,74.125.24.0-255,5738,24955,9,122266
3030,0.000244,172.31.36.0-255,66,25021,9,122266
3031,0.00028,172.31.36.0-255,66,25087,9,122266
3032,0.000292,172.31.36.0-255,66,25153,9,122266
3033,0.000345,74.125.24.0-255,375,25528,9,122266
3034,0.000348,172.31.36.0-255,66,25594,9,122266
3035,0.000441,74.125.24.0-255,1484,27078,9,122266
3036,0.000445,172.31.36.0-255,66,27144,9,122266
3037,0.00045,74.125.24.0-255,2902,30046,9,122266
3038,0.000452,172.31.36.0-255,66,30112,9,122266
3039,0.000455,74.125.24.0-255,1484,31596,9,122266
3040,0.000464,172.31.36.0-255,66,31662,9,122266
3041,0.0005,74.125.24.0-255,4320,35982,9,122266
3042,0.000506,74.125.24.0-255,5738,41720,9,122266
3043,0.000506,172.31.36.0-255,66,41786,9,122266
3044,0.000512,172.31.36.0-255,66,41852,9,122266
3045,0.000525,74.125.24.0-255,1125,42977,9,122266
3046,0.000573,74.125.24.0-255,1484,44461,9,122266
3047,0.000586,172.31.36.0-255,66,44527,9,122266
3048,0.000588,74.125.24.0-255,2902,47429,9,122266
3049,0.000591,74.125.24.0-255,1484,48913,9,122266
3050,0.000591,172.31.36.0-255,66,48979,9,122266
3051,0.000625,74.125.24.0-255,4320,53299,9,122266
3052,0.000638,172.31.36.0-255,66,53365,9,122266
3053,0.000639,74.125.24.0-255,2902,56267,9,122266
3054,0.000643,172.31.36.0-255,66,56333,9,122266
3055,0.000677,74.125.24.0-255,3961,60294,9,122266
3056,0.000681,172.31.36.0-255,66,60360,9,122266
3057,0.001577,74.125.24.0-255,1484,61844,9,122266
3058,0.001588,74.125.24.0-255,2902,64746,9,122266
3059,0.001592,172.31.36.0-255,66,64812,9,122266
3060,0.001596,74.125.24.0-255,1484,66296,9,122266
3061,0.0016,74.125.24.0-255,1484,67780,9,122266
3062,0.001623,74.125.24.0-255,4320,72100,9,122266
3063,0.001627,74.125.24.0-255,2902,75002,9,122266
3064,0.001648,74.125.24.0-255,1484,76486,9,122266
3065,0.001705,74.125.24.0-255,5738,82224,9,122266
3066,0.001723,74.125.24.0-255,2184,84408,9,122266
3067,0.00181,74.125.24.0-255,1484,85892,9,122266
3068,0.00183,74.125.24.0-255,2902,88794,9,122266
3069,0.001865,74.125.24.0-255,2902,91696,9,122266
3070,0.001881,74.125.24.0-255,2902,94598,9,122266
3071,0.001908,74.125.24.0-255,5738,100336,9,122266
3072,0.001999,74.125.24.0-255,1484,101820,9,122266
3073,0.002008,74.125.24.0-255,1484,103304,9,122266
3074,0.002018,74.125.24.0-255,1484,104788,9,122266
3075,0.002033,74.125.24.0-255,2902,107690,9,122266
3076,0.002048,74.125.24.0-255,2902,110592,9,122266
3077,0.004073,172.31.36.0-255,66,110658,9,122266
3078,0.006071,74.125.24.0-255,5738,116396,9,122266
3079,0.006076,172.31.36.0-255,66,116462,9,122266
3080,0.008066,74.125.24.0-255,5738,122200,9,122266
3081,0.008073,172.31.36.0-255,66,122266,9,122266
3082,0.0,172.217.24.0-255,146,146,9,280973
3083,2.2e-05,172.217.24.0-255,1484,1630,9,280973
3084,3e-05,172.31.36.0-255,66,1696,9,280973
3085,3.7e-05,172.217.24.0-255,2902,4598,9,280973
3086,4e-05,172.31.36.0-255,66,4664,9,280973
3087,4.8e-05,172.217.24.0-255,5738,10402,9,280973
3088,5.9e-05,172.31.36.0-255,66,10468,9,280973
3089,8.6e-05,172.217.24.0-255,1484,11952,9,280973
3090,9.1e-05,172.217.24.0-255,1993,13945,9,280973
3091,9.4e-05,172.31.36.0-255,66,14011,9,280973
3092,0.000185,172.217.24.0-255,1484,15495,9,280973
3093,0.00019,172.217.24.0-255,1484,16979,9,280973
3094,0.000193,172.31.36.0-255,66,17045,9,280973
3095,0.00022,172.217.24.0-255,1484,18529,9,280973
3096,0.000225,172.217.24.0-255,2902,21431,9,280973
3097,0.000227,172.31.36.0-255,66,21497,9,280973
3098,0.000232,172.217.24.0-255,4320,25817,9,280973
3099,0.000235,172.31.36.0-255,66,25883,9,280973
3100,0.000269,172.217.24.0-255,2902,28785,9,280973
3101,0.000272,172.31.36.0-255,66,28851,9,280973
3102,0.000301,172.217.24.0-255,2543,31394,9,280973
3103,0.000305,172.31.36.0-255,66,31460,9,280973
3104,0.000308,172.217.24.0-255,1484,32944,9,280973
3105,0.000311,172.217.24.0-255,1484,34428,9,280973
3106,0.000313,172.31.36.0-255,66,34494,9,280973
3107,0.00034,172.217.24.0-255,1484,35978,9,280973
3108,0.000348,172.217.24.0-255,5738,41716,9,280973
3109,0.000351,172.31.36.0-255,66,41782,9,280973
3110,0.000357,172.217.24.0-255,6797,48579,9,280973
3111,0.00036,172.31.36.0-255,66,48645,9,280973
3112,0.001299,172.217.24.0-255,1484,50129,9,280973
3113,0.001309,172.217.24.0-255,1484,51613,9,280973
3114,0.001313,172.31.36.0-255,66,51679,9,280973
3115,0.001319,172.217.24.0-255,2902,54581,9,280973
3116,0.001321,172.31.36.0-255,66,54647,9,280973
3117,0.001336,172.217.24.0-255,5738,60385,9,280973
3118,0.001338,172.31.36.0-255,66,60451,9,280973
3119,0.001368,172.217.24.0-255,5959,66410,9,280973
3120,0.001372,172.31.36.0-255,66,66476,9,280973
3121,0.001502,172.217.24.0-255,1484,67960,9,280973
3122,0.001509,172.217.24.0-255,2902,70862,9,280973
3123,0.001512,172.31.36.0-255,66,70928,9,280973
3124,0.001518,172.217.24.0-255,2902,73830,9,280973
3125,0.00152,172.31.36.0-255,66,73896,9,280973
3126,0.001537,172.217.24.0-255,2902,76798,9,280973
3127,0.001539,172.31.36.0-255,66,76864,9,280973
3128,0.001572,172.217.24.0-255,6797,83661,9,280973
3129,0.001575,172.31.36.0-255,66,83727,9,280973
3130,0.001596,172.217.24.0-255,1484,85211,9,280973
3131,0.001608,172.217.24.0-255,1484,86695,9,280973
3132,0.00161,172.31.36.0-255,66,86761,9,280973
3133,0.001613,172.217.24.0-255,1484,88245,9,280973
3134,0.001641,172.217.24.0-255,2902,91147,9,280973
3135,0.001643,172.31.36.0-255,66,91213,9,280973
3136,0.001652,172.31.36.0-255,66,91279,9,280973
3137,0.001657,172.217.24.0-255,4320,95599,9,280973
3138,0.001665,172.31.36.0-255,66,95665,9,280973
3139,0.001695,172.31.36.0-255,66,95731,9,280973
3140,0.001713,172.217.24.0-255,3294,99025,9,280973
3141,0.001715,172.31.36.0-255,66,99091,9,280973
3142,0.002503,172.217.24.0-255,1484,100575,9,280973
3143,0.002507,172.217.24.0-255,1484,102059,9,280973
3144,0.00251,172.31.36.0-255,66,102125,9,280973
3145,0.002536,172.217.24.0-255,1484,103609,9,280973
3146,0.002542,172.217.24.0-255,5738,109347,9,280973
3147,0.002545,172.31.36.0-255,66,109413,9,280973
3148,0.002575,172.31.36.0-255,66,109479,9,280973
3149,0.002611,172.217.24.0-255,4320,113799,9,280973
3150,0.002614,172.31.36.0-255,66,113865,9,280973
3151,0.002618,172.217.24.0-255,1484,115349,9,280973
3152,0.002639,172.217.24.0-255,4320,119669,9,280973
3153,0.002642,172.31.36.0-255,66,119735,9,280973
3154,0.002646,172.217.24.0-255,2902,122637,9,280973
3155,0.002649,172.31.36.0-255,66,122703,9,280973
3156,0.002693,172.31.36.0-255,66,122769,9,280973
3157,0.002705,172.31.36.0-255,66,122835,9,280973
3158,0.003466,172.217.24.0-255,1484,124319,9,280973
3159,0.00348,172.217.24.0-255,2902,127221,9,280973
3160,0.003482,172.31.36.0-255,66,127287,9,280973
3161,0.003514,172.217.24.0-255,5738,133025,9,280973
3162,0.003517,172.31.36.0-255,66,133091,9,280973
3163,0.003527,172.31.36.0-255,66,133157,9,280973
3164,0.003556,172.217.24.0-255,4320,137477,9,280973
3165,0.003559,172.31.36.0-255,66,137543,9,280973
3166,0.003568,172.31.36.0-255,66,137609,9,280973
3167,0.00358,172.217.24.0-255,1484,139093,9,280973
3168,0.003583,172.217.24.0-255,766,139859,9,280973
3169,0.003585,172.31.36.0-255,66,139925,9,280973
3170,0.003588,172.217.24.0-255,1484,141409,9,280973
3171,0.003599,172.217.24.0-255,2902,144311,9,280973
3172,0.003602,172.31.36.0-255,66,144377,9,280973
3173,0.00363,172.217.24.0-255,5738,150115,9,280973
3174,0.003632,172.31.36.0-255,66,150181,9,280973
3175,0.003636,172.217.24.0-255,1484,151665,9,280973
3176,0.003638,172.217.24.0-255,1484,153149,9,280973
3177,0.003641,172.31.36.0-255,78,153227,9,280973
3178,0.00365,172.217.24.0-255,4320,157547,9,280973
3179,0.003653,172.31.36.0-255,66,157613,9,280973
3180,0.003701,172.217.24.0-255,5738,163351,9,280973
3181,0.003706,172.31.36.0-255,66,163417,9,280973
3182,0.003729,172.217.24.0-255,2902,166319,9,280973
3183,0.003732,172.31.36.0-255,66,166385,9,280973
3184,0.003736,172.217.24.0-255,4320,170705,9,280973
3185,0.003738,172.31.36.0-255,66,170771,9,280973
3186,0.003741,172.217.24.0-255,1484,172255,9,280973
3187,0.003745,172.217.24.0-255,2184,174439,9,280973
3188,0.003747,172.31.36.0-255,66,174505,9,280973
3189,0.00375,172.217.24.0-255,1484,175989,9,280973
3190,0.003754,172.217.24.0-255,2902,178891,9,280973
3191,0.003757,172.31.36.0-255,66,178957,9,280973
3192,0.003763,172.217.24.0-255,5738,184695,9,280973
3193,0.003766,172.31.36.0-255,66,184761,9,280973
3194,0.003807,172.31.36.0-255,66,184827,9,280973
3195,0.003833,172.217.24.0-255,4320,189147,9,280973
3196,0.003836,172.31.36.0-255,66,189213,9,280973
3197,0.00384,172.217.24.0-255,2902,192115,9,280973
3198,0.003843,172.31.36.0-255,66,192181,9,280973
3199,0.003883,172.31.36.0-255,66,192247,9,280973
3200,0.003902,172.217.24.0-255,2902,195149,9,280973
3201,0.003905,172.31.36.0-255,66,195215,9,280973
3202,0.003942,172.31.36.0-255,66,195281,9,280973
3203,0.00395,172.217.24.0-255,7156,202437,9,280973
3204,0.003952,172.31.36.0-255,66,202503,9,280973
3205,0.003956,172.217.24.0-255,2902,205405,9,280973
3206,0.003958,172.31.36.0-255,66,205471,9,280973
3207,0.004001,172.31.36.0-255,66,205537,9,280973
3208,0.004024,172.217.24.0-255,1484,207021,9,280973
3209,0.004045,172.217.24.0-255,2902,209923,9,280973
3210,0.004049,172.31.36.0-255,66,209989,9,280973
3211,0.004055,172.217.24.0-255,5738,215727,9,280973
3212,0.004058,172.31.36.0-255,66,215793,9,280973
3213,0.004062,172.217.24.0-255,4320,220113,9,280973
3214,0.004064,172.31.36.0-255,66,220179,9,280973
3215,0.004095,172.217.24.0-255,2902,223081,9,280973
3216,0.004098,172.31.36.0-255,66,223147,9,280973
3217,0.004103,172.217.24.0-255,4320,227467,9,280973
3218,0.004106,172.31.36.0-255,66,227533,9,280973
3219,0.004145,172.31.36.0-255,66,227599,9,280973
3220,0.004148,172.217.24.0-255,2184,229783,9,280973
3221,0.00415,172.31.36.0-255,66,229849,9,280973
3222,0.004298,172.217.24.0-255,1484,231333,9,280973
3223,0.004302,172.217.24.0-255,1484,232817,9,280973
3224,0.004305,172.31.36.0-255,66,232883,9,280973
3225,0.004319,172.217.24.0-255,1484,234367,9,280973
3226,0.004331,172.217.24.0-255,5738,240105,9,280973
3227,0.004333,172.31.36.0-255,66,240171,9,280973
3228,0.004362,172.217.24.0-255,7156,247327,9,280973
3229,0.004365,172.31.36.0-255,66,247393,9,280973
3230,0.004385,172.217.24.0-255,5738,253131,9,280973
3231,0.004388,172.31.36.0-255,66,253197,9,280973
3232,0.004391,172.217.24.0-255,1484,254681,9,280973
3233,0.004429,172.217.24.0-255,7156,261837,9,280973
3234,0.004448,172.217.24.0-255,4320,266157,9,280973
3235,0.004479,172.217.24.0-255,7156,273313,9,280973
3236,0.004485,172.217.24.0-255,4320,277633,9,280973
3237,0.00452,172.217.24.0-255,3064,280697,9,280973
3238,0.004569,172.217.24.0-255,105,280802,9,280973
3239,0.006753,172.31.36.0-255,66,280868,9,280973
3240,0.009747,172.31.36.0-255,105,280973,9,280973
3241,0.0,172.31.36.0-255,105,105,9,105
3242,0.0,172.217.194.0-255,150,150,9,267643
3243,1.7e-05,172.31.36.0-255,66,216,9,267643
3244,2.4e-05,172.217.194.0-255,1484,1700,9,267643
3245,2.8e-05,172.31.36.0-255,66,1766,9,267643
3246,3.4e-05,172.217.194.0-255,2902,4668,9,267643
3247,3.8e-05,172.31.36.0-255,66,4734,9,267643
3248,5.6e-05,172.217.194.0-255,4320,9054,9,267643
3249,6e-05,172.31.36.0-255,66,9120,9,267643
3250,0.000111,172.217.194.0-255,4909,14029,9,267643
3251,0.000114,172.31.36.0-255,66,14095,9,267643
3252,0.000144,172.217.194.0-255,1484,15579,9,267643
3253,0.000146,172.31.36.0-255,66,15645,9,267643
3254,0.000161,172.217.194.0-255,4320,19965,9,267643
3255,0.000163,172.31.36.0-255,66,20031,9,267643
3256,0.00019,172.217.194.0-255,7156,27187,9,267643
3257,0.000192,172.31.36.0-255,66,27253,9,267643
3258,0.000196,172.217.194.0-255,1484,28737,9,267643
3259,0.000198,172.31.36.0-255,66,28803,9,267643
3260,0.000233,172.31.36.0-255,66,28869,9,267643
3261,0.000252,172.217.194.0-255,5738,34607,9,267643
3262,0.000254,172.31.36.0-255,66,34673,9,267643
3263,0.000275,172.217.194.0-255,2543,37216,9,267643
3264,0.000277,172.31.36.0-255,66,37282,9,267643
3265,0.000282,172.217.194.0-255,2902,40184,9,267643
3266,0.000284,172.31.36.0-255,66,40250,9,267643
3267,0.000307,172.217.194.0-255,5738,45988,9,267643
3268,0.00031,172.31.36.0-255,66,46054,9,267643
3269,0.000317,172.217.194.0-255,7156,53210,9,267643
3270,0.000319,172.31.36.0-255,66,53276,9,267643
3271,0.00034,172.217.194.0-255,1422,54698,9,267643
3272,0.000343,172.31.36.0-255,66,54764,9,267643
3273,0.000377,172.217.194.0-255,379,55143,9,267643
3274,0.000565,172.217.194.0-255,1484,56627,9,267643
3275,0.000571,172.217.194.0-255,2902,59529,9,267643
3276,0.000582,172.31.36.0-255,66,59595,9,267643
3277,0.000586,172.31.36.0-255,66,59661,9,267643
3278,0.000602,172.217.194.0-255,2902,62563,9,267643
3279,0.000605,172.31.36.0-255,66,62629,9,267643
3280,0.00061,172.217.194.0-255,2902,65531,9,267643
3281,0.000612,172.31.36.0-255,66,65597,9,267643
3282,0.000637,172.217.194.0-255,1484,67081,9,267643
3283,0.000651,172.31.36.0-255,66,67147,9,267643
3284,0.000668,172.31.36.0-255,66,67213,9,267643
3285,0.000684,172.217.194.0-255,3054,70267,9,267643
3286,0.000686,172.31.36.0-255,66,70333,9,267643
3287,0.000718,172.217.194.0-255,4320,74653,9,267643
3288,0.000722,172.217.194.0-255,2543,77196,9,267643
3289,0.000726,172.31.36.0-255,66,77262,9,267643
3290,0.000732,172.31.36.0-255,66,77328,9,267643
3291,0.001055,172.217.194.0-255,1484,78812,9,267643
3292,0.001061,172.217.194.0-255,1484,80296,9,267643
3293,0.001064,172.31.36.0-255,66,80362,9,267643
3294,0.00108,172.217.194.0-255,1484,81846,9,267643
3295,0.001087,172.217.194.0-255,5738,87584,9,267643
3296,0.001089,172.31.36.0-255,66,87650,9,267643
3297,0.001095,172.217.194.0-255,4320,91970,9,267643
3298,0.001098,172.31.36.0-255,66,92036,9,267643
3299,0.001118,172.31.36.0-255,66,92102,9,267643
3300,0.001125,172.217.194.0-255,7156,99258,9,267643
3301,0.001127,172.31.36.0-255,66,99324,9,267643
3302,0.001149,172.217.194.0-255,2902,102226,9,267643
3303,0.001152,172.217.194.0-255,766,102992,9,267643
3304,0.001161,172.31.36.0-255,66,103058,9,267643
3305,0.001381,172.217.194.0-255,1484,104542,9,267643
3306,0.001388,172.217.194.0-255,2902,107444,9,267643
3307,0.001392,172.31.36.0-255,66,107510,9,267643
3308,0.001396,172.217.194.0-255,1484,108994,9,267643
3309,0.001419,172.217.194.0-255,4320,113314,9,267643
3310,0.001421,172.31.36.0-255,66,113380,9,267643
3311,0.001427,172.217.194.0-255,4320,117700,9,267643
3312,0.001429,172.31.36.0-255,66,117766,9,267643
3313,0.001443,172.217.194.0-255,2543,120309,9,267643
3314,0.001445,172.31.36.0-255,66,120375,9,267643
3315,0.001562,172.217.194.0-255,1484,121859,9,267643
3316,0.001568,172.217.194.0-255,2902,124761,9,267643
3317,0.001571,172.31.36.0-255,66,124827,9,267643
3318,0.001631,172.217.194.0-255,5738,130565,9,267643
3319,0.001634,172.31.36.0-255,66,130631,9,267643
3320,0.001645,172.31.36.0-255,66,130697,9,267643
3321,0.00165,172.217.194.0-255,4320,135017,9,267643
3322,0.001653,172.31.36.0-255,66,135083,9,267643
3323,0.001669,172.217.194.0-255,7156,142239,9,267643
3324,0.001674,172.217.194.0-255,2184,144423,9,267643
3325,0.001679,172.31.36.0-255,66,144489,9,267643
3326,0.001818,172.217.194.0-255,1484,145973,9,267643
3327,0.001825,172.217.194.0-255,2902,148875,9,267643
3328,0.001828,172.31.36.0-255,66,148941,9,267643
3329,0.001833,172.217.194.0-255,2902,151843,9,267643
3330,0.001834,172.31.36.0-255,66,151909,9,267643
3331,0.00186,172.217.194.0-255,2902,154811,9,267643
3332,0.001862,172.31.36.0-255,66,154877,9,267643
3333,0.00187,172.217.194.0-255,5738,160615,9,267643
3334,0.001878,172.31.36.0-255,66,160681,9,267643
3335,0.001909,172.217.194.0-255,7156,167837,9,267643
3336,0.001941,172.31.36.0-255,66,167903,9,267643
3337,0.002316,172.217.194.0-255,1484,169387,9,267643
3338,0.002323,172.217.194.0-255,2902,172289,9,267643
3339,0.002327,172.31.36.0-255,66,172355,9,267643
3340,0.002333,172.217.194.0-255,2902,175257,9,267643
3341,0.002335,172.31.36.0-255,66,175323,9,267643
3342,0.002349,172.217.194.0-255,2902,178225,9,267643
3343,0.002352,172.31.36.0-255,66,178291,9,267643
3344,0.002355,172.217.194.0-255,1484,179775,9,267643
3345,0.002394,172.31.36.0-255,66,179841,9,267643
3346,0.002402,172.217.194.0-255,7156,186997,9,267643
3347,0.002437,172.217.194.0-255,3602,190599,9,267643
3348,0.00244,172.217.194.0-255,1484,192083,9,267643
3349,0.002453,172.217.194.0-255,2902,194985,9,267643
3350,0.002501,172.217.194.0-255,1484,196469,9,267643
3351,0.002565,172.217.194.0-255,2184,198653,9,267643
3352,0.002629,172.217.194.0-255,1484,200137,9,267643
3353,0.002633,172.217.194.0-255,1484,201621,9,267643
3354,0.002653,172.217.194.0-255,1484,203105,9,267643
3355,0.00266,172.217.194.0-255,5738,208843,9,267643
3356,0.002674,172.217.194.0-255,1484,210327,9,267643
3357,0.002712,172.217.194.0-255,4320,214647,9,267643
3358,0.002737,172.217.194.0-255,6438,221085,9,267643
3359,0.002775,172.217.194.0-255,4320,225405,9,267643
3360,0.002793,172.217.194.0-255,7156,232561,9,267643
3361,0.002797,172.217.194.0-255,1484,234045,9,267643
3362,0.0028,172.217.194.0-255,1484,235529,9,267643
3363,0.002848,172.217.194.0-255,4320,239849,9,267643
3364,0.002877,172.217.194.0-255,2184,242033,9,267643
3365,0.002879,172.217.194.0-255,1484,243517,9,267643
3366,0.002884,172.217.194.0-255,4320,247837,9,267643
3367,0.002902,172.217.194.0-255,5738,253575,9,267643
3368,0.002904,172.217.194.0-255,1484,255059,9,267643
3369,0.00291,172.217.194.0-255,4320,259379,9,267643
3370,0.002925,172.217.194.0-255,5020,264399,9,267643
3371,0.002928,172.217.194.0-255,1484,265883,9,267643
3372,0.002952,172.217.194.0-255,1484,267367,9,267643
3373,0.002995,172.217.194.0-255,105,267472,9,267643
3374,0.007362,172.31.36.0-255,66,267538,9,267643
3375,0.00917,172.31.36.0-255,105,267643,9,267643
3376,0.0,172.31.36.0-255,105,105,9,459
3377,0.000233,172.31.36.0-255,90,195,9,459
3378,0.000243,172.31.36.0-255,66,261,9,459
3379,0.002827,74.125.24.0-255,66,327,9,459
3380,0.002857,74.125.24.0-255,66,393,9,459
3381,0.002881,172.31.36.0-255,66,459,9,459
3382,0.0,74.125.24.0-255,152,152,9,180295
3383,2.3e-05,172.31.36.0-255,66,218,9,180295
3384,3e-05,74.125.24.0-255,1484,1702,9,180295
3385,3.5e-05,172.31.36.0-255,66,1768,9,180295
3386,4.1e-05,74.125.24.0-255,2902,4670,9,180295
3387,5.2e-05,172.31.36.0-255,66,4736,9,180295
3388,6e-05,74.125.24.0-255,7156,11892,9,180295
3389,6.3e-05,172.31.36.0-255,66,11958,9,180295
3390,6.8e-05,74.125.24.0-255,2080,14038,9,180295
3391,7e-05,172.31.36.0-255,66,14104,9,180295
3392,0.000108,74.125.24.0-255,1484,15588,9,180295
3393,0.00011,172.31.36.0-255,66,15654,9,180295
3394,0.000115,74.125.24.0-255,2902,18556,9,180295
3395,0.000117,172.31.36.0-255,66,18622,9,180295
3396,0.00013,74.125.24.0-255,5738,24360,9,180295
3397,0.000133,172.31.36.0-255,66,24426,9,180295
3398,0.00014,74.125.24.0-255,6797,31223,9,180295
3399,0.000142,172.31.36.0-255,66,31289,9,180295
3400,0.000176,74.125.24.0-255,7156,38445,9,180295
3401,0.000179,172.31.36.0-255,66,38511,9,180295
3402,0.000185,74.125.24.0-255,5738,44249,9,180295
3403,0.000187,172.31.36.0-255,66,44315,9,180295
3404,0.000219,74.125.24.0-255,3961,48276,9,180295
3405,0.000221,172.31.36.0-255,66,48342,9,180295
3406,0.000239,74.125.24.0-255,1484,49826,9,180295
3407,0.000241,172.31.36.0-255,66,49892,9,180295
3408,0.000246,74.125.24.0-255,2902,52794,9,180295
3409,0.000248,172.31.36.0-255,66,52860,9,180295
3410,0.000255,74.125.24.0-255,5738,58598,9,180295
3411,0.00026,172.31.36.0-255,66,58664,9,180295
3412,0.000292,74.125.24.0-255,6797,65461,9,180295
3413,0.000294,172.31.36.0-255,66,65527,9,180295
3414,0.000321,74.125.24.0-255,401,65928,9,180295
3415,0.000352,74.125.24.0-255,341,66269,9,180295
3416,0.000741,74.125.24.0-255,1484,67753,9,180295
3417,0.000746,172.31.36.0-255,66,67819,9,180295
3418,0.000752,74.125.24.0-255,2902,70721,9,180295
3419,0.000754,172.31.36.0-255,66,70787,9,180295
3420,0.000766,74.125.24.0-255,5738,76525,9,180295
3421,0.000768,172.31.36.0-255,66,76591,9,180295
3422,0.000822,172.31.36.0-255,66,76657,9,180295
3423,0.000835,172.31.36.0-255,66,76723,9,180295
3424,0.000838,74.125.24.0-255,766,77489,9,180295
3425,0.001095,74.125.24.0-255,1484,78973,9,180295
3426,0.001099,172.31.36.0-255,66,79039,9,180295
3427,0.001104,74.125.24.0-255,2902,81941,9,180295
3428,0.001106,172.31.36.0-255,66,82007,9,180295
3429,0.001117,74.125.24.0-255,5738,87745,9,180295
3430,0.001119,172.31.36.0-255,66,87811,9,180295
3431,0.001125,74.125.24.0-255,5738,93549,9,180295
3432,0.001127,172.31.36.0-255,66,93615,9,180295
3433,0.001165,74.125.24.0-255,7156,100771,9,180295
3434,0.001168,172.31.36.0-255,66,100837,9,180295
3435,0.001181,172.31.36.0-255,66,100903,9,180295
3436,0.001287,74.125.24.0-255,1484,102387,9,180295
3437,0.001292,74.125.24.0-255,2902,105289,9,180295
3438,0.001295,172.31.36.0-255,66,105355,9,180295
3439,0.0013,74.125.24.0-255,2902,108257,9,180295
3440,0.001303,172.31.36.0-255,66,108323,9,180295
3441,0.001335,74.125.24.0-255,2902,111225,9,180295
3442,0.001338,172.31.36.0-255,66,111291,9,180295
3443,0.001351,172.31.36.0-255,66,111357,9,180295
3444,0.001381,172.31.36.0-255,66,111423,9,180295
3445,0.001971,74.125.24.0-255,1484,112907,9,180295
3446,0.001977,74.125.24.0-255,2902,115809,9,180295
3447,0.001983,172.31.36.0-255,66,115875,9,180295
3448,0.002006,74.125.24.0-255,5738,121613,9,180295
3449,0.002008,172.31.36.0-255,66,121679,9,180295
3450,0.002015,74.125.24.0-255,5738,127417,9,180295
3451,0.002017,172.31.36.0-255,66,127483,9,180295
3452,0.00202,74.125.24.0-255,1484,128967,9,180295
3453,0.002065,172.31.36.0-255,66,129033,9,180295
3454,0.002072,74.125.24.0-255,5020,134053,9,180295
3455,0.002074,172.31.36.0-255,66,134119,9,180295
3456,0.002437,74.125.24.0-255,1484,135603,9,180295
3457,0.002454,74.125.24.0-255,2902,138505,9,180295
3458,0.002458,172.31.36.0-255,66,138571,9,180295
3459,0.002478,74.125.24.0-255,5738,144309,9,180295
3460,0.002481,172.31.36.0-255,66,144375,9,180295
3461,0.002507,74.125.24.0-255,2902,147277,9,180295
3462,0.00251,172.31.36.0-255,66,147343,9,180295
3463,0.002528,74.125.24.0-255,2902,150245,9,180295
3464,0.002531,172.31.36.0-255,66,150311,9,180295
3465,0.002536,74.125.24.0-255,2902,153213,9,180295
3466,0.002538,172.31.36.0-255,66,153279,9,180295
3467,0.002569,74.125.24.0-255,4320,157599,9,180295
3468,0.002572,172.31.36.0-255,66,157665,9,180295
3469,0.002596,74.125.24.0-255,2902,160567,9,180295
3470,0.002599,172.31.36.0-255,66,160633,9,180295
3471,0.002626,74.125.24.0-255,2902,163535,9,180295
3472,0.002629,172.31.36.0-255,66,163601,9,180295
3473,0.002635,74.125.24.0-255,5020,168621,9,180295
3474,0.002637,172.31.36.0-255,66,168687,9,180295
3475,0.005214,74.125.24.0-255,5738,174425,9,180295
3476,0.005221,172.31.36.0-255,66,174491,9,180295
3477,0.007813,74.125.24.0-255,5738,180229,9,180295
3478,0.007822,172.31.36.0-255,66,180295,9,180295
3479,0.0,172.31.36.0-255,66,66,9,66
3480,0.0,172.31.36.0-255,105,105,9,105
3481,0.0,172.217.27.0-255,153,153,9,100592
3482,2e-05,172.31.36.0-255,66,219,9,100592
3483,2.7e-05,172.217.27.0-255,1484,1703,9,100592
3484,3.1e-05,172.31.36.0-255,66,1769,9,100592
3485,3.5e-05,172.217.27.0-255,2902,4671,9,100592
3486,3.8e-05,172.31.36.0-255,66,4737,9,100592
3487,5.3e-05,172.217.27.0-255,7156,11893,9,100592
3488,5.6e-05,172.31.36.0-255,66,11959,9,100592
3489,5.9e-05,172.217.27.0-255,2012,13971,9,100592
3490,6.2e-05,172.31.36.0-255,66,14037,9,100592
3491,0.000113,172.217.27.0-255,1484,15521,9,100592
3492,0.000115,172.31.36.0-255,66,15587,9,100592
3493,0.00012,172.217.27.0-255,2902,18489,9,100592
3494,0.000122,172.31.36.0-255,66,18555,9,100592
3495,0.000153,172.217.27.0-255,5738,24293,9,100592
3496,0.000156,172.31.36.0-255,66,24359,9,100592
3497,0.000161,172.217.27.0-255,4320,28679,9,100592
3498,0.000163,172.31.36.0-255,66,28745,9,100592
3499,0.000203,172.217.27.0-255,2543,31288,9,100592
3500,0.000205,172.31.36.0-255,66,31354,9,100592
3501,0.000346,172.217.27.0-255,1484,32838,9,100592
3502,0.00035,172.31.36.0-255,66,32904,9,100592
3503,0.000355,172.217.27.0-255,2902,35806,9,100592
3504,0.000358,172.31.36.0-255,66,35872,9,100592
3505,0.00036,172.217.27.0-255,1484,37356,9,100592
3506,0.000362,172.31.36.0-255,66,37422,9,100592
3507,0.000389,172.217.27.0-255,4320,41742,9,100592
3508,0.000391,172.31.36.0-255,66,41808,9,100592
3509,0.000399,172.217.27.0-255,2902,44710,9,100592
3510,0.000401,172.31.36.0-255,66,44776,9,100592
3511,0.000442,172.31.36.0-255,66,44842,9,100592
3512,0.000452,172.31.36.0-255,66,44908,9,100592
3513,0.000459,172.217.27.0-255,394,45302,9,100592
3514,0.001083,172.31.36.0-255,66,45368,9,100592
3515,0.001155,172.217.27.0-255,115,45483,9,100592
3516,0.00118,172.31.36.0-255,66,45549,9,100592
3517,0.001296,172.217.27.0-255,1484,47033,9,100592
3518,0.001304,172.217.27.0-255,2902,49935,9,100592
3519,0.001308,172.31.36.0-255,66,50001,9,100592
3520,0.001315,172.217.27.0-255,5738,55739,9,100592
3521,0.001316,172.31.36.0-255,66,55805,9,100592
3522,0.001321,172.217.27.0-255,4320,60125,9,100592
3523,0.001328,172.31.36.0-255,66,60191,9,100592
3524,0.001372,172.217.27.0-255,4320,64511,9,100592
3525,0.001374,172.31.36.0-255,66,64577,9,100592
3526,0.001398,172.217.27.0-255,1125,65702,9,100592
3527,0.001404,172.217.27.0-255,5738,71440,9,100592
3528,0.001405,172.31.36.0-255,66,71506,9,100592
3529,0.001434,172.31.36.0-255,66,71572,9,100592
3530,0.003064,172.217.27.0-255,5738,77310,9,100592
3531,0.003071,172.31.36.0-255,66,77376,9,100592
3532,0.004705,172.217.27.0-255,5738,83114,9,100592
3533,0.004714,172.31.36.0-255,66,83180,9,100592
3534,0.00637,172.217.27.0-255,5738,88918,9,100592
3535,0.006374,172.31.36.0-255,66,88984,9,100592
3536,0.008014,172.217.27.0-255,5738,94722,9,100592
3537,0.008021,172.31.36.0-255,66,94788,9,100592
3538,0.009862,172.217.27.0-255,5738,100526,9,100592
3539,0.009923,172.31.36.0-255,66,100592,9,100592
3540,0.0,172.217.194.0-255,146,146,9,202264
3541,3.4e-05,172.31.36.0-255,66,212,9,202264
3542,4.1e-05,172.217.194.0-255,1484,1696,9,202264
3543,4.6e-05,172.31.36.0-255,66,1762,9,202264
3544,5.2e-05,172.217.194.0-255,2902,4664,9,202264
3545,5.5e-05,172.31.36.0-255,66,4730,9,202264
3546,5.9e-05,172.217.194.0-255,2902,7632,9,202264
3547,6.2e-05,172.31.36.0-255,66,7698,9,202264
3548,6.8e-05,172.217.194.0-255,4320,12018,9,202264
3549,7e-05,172.31.36.0-255,66,12084,9,202264
3550,9.2e-05,172.217.194.0-255,3453,15537,9,202264
3551,9.5e-05,172.217.194.0-255,2902,18439,9,202264
3552,9.7e-05,172.31.36.0-255,66,18505,9,202264
3553,0.0001,172.31.36.0-255,66,18571,9,202264
3554,0.000119,172.217.194.0-255,7156,25727,9,202264
3555,0.000121,172.31.36.0-255,66,25793,9,202264
3556,0.000148,172.217.194.0-255,5379,31172,9,202264
3557,0.000151,172.31.36.0-255,66,31238,9,202264
3558,0.000183,172.217.194.0-255,1484,32722,9,202264
3559,0.000186,172.31.36.0-255,66,32788,9,202264
3560,0.000193,172.217.194.0-255,2902,35690,9,202264
3561,0.000195,172.31.36.0-255,66,35756,9,202264
3562,0.0002,172.217.194.0-255,4320,40076,9,202264
3563,0.000202,172.31.36.0-255,66,40142,9,202264
3564,0.000232,172.31.36.0-255,66,40208,9,202264
3565,0.000241,172.217.194.0-255,1125,41333,9,202264
3566,0.000244,172.31.36.0-255,66,41399,9,202264
3567,0.000285,172.31.36.0-255,66,41465,9,202264
3568,0.00035,172.217.194.0-255,377,41842,9,202264
3569,0.000353,172.31.36.0-255,66,41908,9,202264
3570,0.000457,172.217.194.0-255,1484,43392,9,202264
3571,0.000461,172.31.36.0-255,66,43458,9,202264
3572,0.000466,172.217.194.0-255,2902,46360,9,202264
3573,0.000469,172.31.36.0-255,66,46426,9,202264
3574,0.000473,172.217.194.0-255,1484,47910,9,202264
3575,0.000475,172.31.36.0-255,66,47976,9,202264
3576,0.000507,172.217.194.0-255,4320,52296,9,202264
3577,0.00051,172.31.36.0-255,66,52362,9,202264
3578,0.000521,172.31.36.0-255,66,52428,9,202264
3579,0.000528,172.217.194.0-255,5738,58166,9,202264
3580,0.000532,172.31.36.0-255,66,58232,9,202264
3581,0.000551,172.217.194.0-255,2902,61134,9,202264
3582,0.000554,172.31.36.0-255,66,61200,9,202264
3583,0.000561,172.217.194.0-255,6517,67717,9,202264
3584,0.000574,172.31.36.0-255,66,67783,9,202264
3585,0.00062,172.217.194.0-255,1484,69267,9,202264
3586,0.000625,172.217.194.0-255,2902,72169,9,202264
3587,0.000627,172.217.194.0-255,1484,73653,9,202264
3588,0.000629,172.31.36.0-255,66,73719,9,202264
3589,0.000649,172.217.194.0-255,4320,78039,9,202264
3590,0.000652,172.217.194.0-255,1484,79523,9,202264
3591,0.000657,172.31.36.0-255,66,79589,9,202264
3592,0.000683,172.217.194.0-255,1484,81073,9,202264
3593,0.000685,172.31.36.0-255,66,81139,9,202264
3594,0.000708,172.217.194.0-255,2902,84041,9,202264
3595,0.000723,172.31.36.0-255,66,84107,9,202264
3596,0.000735,172.217.194.0-255,6438,90545,9,202264
3597,0.000744,172.31.36.0-255,66,90611,9,202264
3598,0.000772,172.217.194.0-255,1484,92095,9,202264
3599,0.000808,172.31.36.0-255,66,92161,9,202264
3600,0.000824,172.31.36.0-255,66,92227,9,202264
3601,0.000864,172.31.36.0-255,66,92293,9,202264
3602,0.000883,172.217.194.0-255,2543,94836,9,202264
3603,0.000894,172.31.36.0-255,66,94902,9,202264
3604,0.00105,172.217.194.0-255,1484,96386,9,202264
3605,0.001056,172.217.194.0-255,2902,99288,9,202264
3606,0.001059,172.31.36.0-255,66,99354,9,202264
3607,0.001083,172.217.194.0-255,5738,105092,9,202264
3608,0.001089,172.31.36.0-255,66,105158,9,202264
3609,0.001115,172.31.36.0-255,66,105224,9,202264
3610,0.001133,172.217.194.0-255,7156,112380,9,202264
3611,0.001139,172.31.36.0-255,66,112446,9,202264
3612,0.001147,172.217.194.0-255,3602,116048,9,202264
3613,0.001155,172.31.36.0-255,66,116114,9,202264
3614,0.001255,172.217.194.0-255,1484,117598,9,202264
3615,0.00126,172.217.194.0-255,2902,120500,9,202264
3616,0.001263,172.31.36.0-255,66,120566,9,202264
3617,0.001269,172.217.194.0-255,2902,123468,9,202264
3618,0.001281,172.31.36.0-255,66,123534,9,202264
3619,0.001285,172.217.194.0-255,2902,126436,9,202264
3620,0.001288,172.217.194.0-255,1484,127920,9,202264
3621,0.001294,172.31.36.0-255,66,127986,9,202264
3622,0.001336,172.31.36.0-255,66,128052,9,202264
3623,0.00135,172.31.36.0-255,66,128118,9,202264
3624,0.001831,172.217.194.0-255,1484,129602,9,202264
3625,0.001837,172.217.194.0-255,2902,132504,9,202264
3626,0.001841,172.31.36.0-255,66,132570,9,202264
3627,0.001847,172.217.194.0-255,4320,136890,9,202264
3628,0.001858,172.31.36.0-255,66,136956,9,202264
3629,0.001863,172.217.194.0-255,1484,138440,9,202264
3630,0.00187,172.217.194.0-255,5738,144178,9,202264
3631,0.001879,172.31.36.0-255,66,144244,9,202264
3632,0.001888,172.217.194.0-255,7156,151400,9,202264
3633,0.001892,172.217.194.0-255,2902,154302,9,202264
3634,0.001898,172.31.36.0-255,66,154368,9,202264
3635,0.001923,172.31.36.0-255,66,154434,9,202264
3636,0.002469,172.217.194.0-255,1484,155918,9,202264
3637,0.002475,172.31.36.0-255,66,155984,9,202264
3638,0.00248,172.217.194.0-255,2902,158886,9,202264
3639,0.002483,172.31.36.0-255,66,158952,9,202264
3640,0.002487,172.217.194.0-255,2902,161854,9,202264
3641,0.002491,172.31.36.0-255,66,161920,9,202264
3642,0.002502,172.217.194.0-255,2902,164822,9,202264
3643,0.002518,172.217.194.0-255,4320,169142,9,202264
3644,0.002524,172.31.36.0-255,66,169208,9,202264
3645,0.002548,172.31.36.0-255,66,169274,9,202264
3646,0.002563,172.31.36.0-255,66,169340,9,202264
3647,0.002603,172.217.194.0-255,1484,170824,9,202264
3648,0.002622,172.217.194.0-255,2902,173726,9,202264
3649,0.002626,172.31.36.0-255,66,173792,9,202264
3650,0.002632,172.217.194.0-255,5738,179530,9,202264
3651,0.002641,172.31.36.0-255,66,179596,9,202264
3652,0.002656,172.31.36.0-255,66,179662,9,202264
3653,0.002666,172.217.194.0-255,2902,182564,9,202264
3654,0.002672,172.31.36.0-255,66,182630,9,202264
3655,0.002686,172.31.36.0-255,66,182696,9,202264
3656,0.002722,172.31.36.0-255,66,182762,9,202264
3657,0.002734,172.217.194.0-255,2902,185664,9,202264
3658,0.00275,172.31.36.0-255,66,185730,9,202264
3659,0.00275,172.217.194.0-255,4320,190050,9,202264
3660,0.002754,172.31.36.0-255,66,190116,9,202264
3661,0.002793,172.217.194.0-255,4320,194436,9,202264
3662,0.002793,172.31.36.0-255,66,194502,9,202264
3663,0.002798,172.31.36.0-255,66,194568,9,202264
3664,0.002808,172.217.194.0-255,4320,198888,9,202264
3665,0.002811,172.31.36.0-255,66,198954,9,202264
3666,0.002821,172.217.194.0-255,2902,201856,9,202264
3667,0.002826,172.31.36.0-255,66,201922,9,202264
3668,0.002845,172.217.194.0-255,105,202027,9,202264
3669,0.002849,172.31.36.0-255,66,202093,9,202264
3670,0.003758,172.31.36.0-255,105,202198,9,202264
3671,0.00628,172.217.194.0-255,66,202264,9,202264
3672,0.0,172.31.36.0-255,105,105,9,459
3673,0.000261,172.31.36.0-255,90,195,9,459
3674,0.000271,172.31.36.0-255,66,261,9,459
3675,0.002553,74.125.200.0-255,66,327,9,459
3676,0.002584,74.125.200.0-255,66,393,9,459
3677,0.002608,172.31.36.0-255,66,459,9,459
3678,0.0,172.31.36.0-255,105,105,9,105
3679,0.0,172.31.36.0-255,105,105,9,105
3680,0.0,172.31.36.0-255,66,66,9,66
3681,0.0,74.125.24.0-255,296,296,9,138487
3682,1.4e-05,172.31.36.0-255,66,362,9,138487
3683,2.1e-05,74.125.24.0-255,1484,1846,9,138487
3684,2.5e-05,172.31.36.0-255,66,1912,9,138487
3685,3.2e-05,74.125.24.0-255,4320,6232,9,138487
3686,4.4e-05,172.31.36.0-255,66,6298,9,138487
3687,5.2e-05,74.125.24.0-255,7156,13454,9,138487
3688,5.5e-05,172.31.36.0-255,66,13520,9,138487
3689,5.8e-05,74.125.24.0-255,395,13915,9,138487
3690,6e-05,172.31.36.0-255,66,13981,9,138487
3691,0.0001,74.125.24.0-255,1484,15465,9,138487
3692,0.000103,172.31.36.0-255,66,15531,9,138487
3693,0.000109,74.125.24.0-255,4320,19851,9,138487
3694,0.000111,172.31.36.0-255,66,19917,9,138487
3695,0.000128,172.31.36.0-255,66,19983,9,138487
3696,0.000155,74.125.24.0-255,1484,21467,9,138487
3697,0.000157,172.31.36.0-255,66,21533,9,138487
3698,0.000161,74.125.24.0-255,1125,22658,9,138487
3699,0.000163,172.31.36.0-255,66,22724,9,138487
3700,0.000182,172.31.36.0-255,66,22790,9,138487
3701,0.000209,74.125.24.0-255,1484,24274,9,138487
3702,0.000211,172.31.36.0-255,66,24340,9,138487
3703,0.000217,74.125.24.0-255,3961,28301,9,138487
3704,0.00022,172.31.36.0-255,66,28367,9,138487
3705,0.000264,172.31.36.0-255,66,28433,9,138487
3706,0.000291,74.125.24.0-255,3961,32394,9,138487
3707,0.000293,172.31.36.0-255,66,32460,9,138487
3708,0.000296,74.125.24.0-255,396,32856,9,138487
3709,0.000298,172.31.36.0-255,66,32922,9,138487
3710,0.000329,74.125.24.0-255,113,33035,9,138487
3711,0.000474,74.125.24.0-255,1484,34519,9,138487
3712,0.000479,172.31.36.0-255,66,34585,9,138487
3713,0.000483,74.125.24.0-255,1484,36069,9,138487
3714,0.000508,74.125.24.0-255,1484,37553,9,138487
3715,0.00051,172.31.36.0-255,66,37619,9,138487
3716,0.000518,74.125.24.0-255,5738,43357,9,138487
3717,0.00052,172.31.36.0-255,66,43423,9,138487
3718,0.000529,74.125.24.0-255,2902,46325,9,138487
3719,0.000532,172.31.36.0-255,66,46391,9,138487
3720,0.000583,172.31.36.0-255,66,46457,9,138487
3721,0.000595,172.31.36.0-255,66,46523,9,138487
3722,0.000602,74.125.24.0-255,330,46853,9,138487
3723,0.000771,74.125.24.0-255,1484,48337,9,138487
3724,0.000776,172.31.36.0-255,66,48403,9,138487
3725,0.000782,74.125.24.0-255,2902,51305,9,138487
3726,0.000785,172.31.36.0-255,66,51371,9,138487
3727,0.000797,74.125.24.0-255,5738,57109,9,138487
3728,0.000799,172.31.36.0-255,66,57175,9,138487
3729,0.000812,172.31.36.0-255,66,57241,9,138487
3730,0.000823,74.125.24.0-255,1484,58725,9,138487
3731,0.00086,74.125.24.0-255,5738,64463,9,138487
3732,0.000864,172.31.36.0-255,66,64529,9,138487
3733,0.000895,74.125.24.0-255,5020,69549,9,138487
3734,0.000899,172.31.36.0-255,66,69615,9,138487
3735,0.00098,74.125.24.0-255,1484,71099,9,138487
3736,0.000984,74.125.24.0-255,1484,72583,9,138487
3737,0.000987,172.31.36.0-255,66,72649,9,138487
3738,0.001015,74.125.24.0-255,1484,74133,9,138487
3739,0.001022,74.125.24.0-255,5738,79871,9,138487
3740,0.001025,172.31.36.0-255,66,79937,9,138487
3741,0.001032,74.125.24.0-255,7156,87093,9,138487
3742,0.001034,172.31.36.0-255,66,87159,9,138487
3743,0.001041,74.125.24.0-255,5738,92897,9,138487
3744,0.001048,172.31.36.0-255,66,92963,9,138487
3745,0.00109,172.31.36.0-255,66,93029,9,138487
3746,0.001095,74.125.24.0-255,2184,95213,9,138487
3747,0.001097,172.31.36.0-255,66,95279,9,138487
3748,0.001455,74.125.24.0-255,1484,96763,9,138487
3749,0.001462,74.125.24.0-255,2902,99665,9,138487
3750,0.001465,172.31.36.0-255,66,99731,9,138487
3751,0.001496,74.125.24.0-255,2902,102633,9,138487
3752,0.001499,172.31.36.0-255,66,102699,9,138487
3753,0.001508,74.125.24.0-255,7156,109855,9,138487
3754,0.00151,172.31.36.0-255,66,109921,9,138487
3755,0.001536,74.125.24.0-255,1484,111405,9,138487
3756,0.001564,172.31.36.0-255,66,111471,9,138487
3757,0.001627,74.125.24.0-255,5020,116491,9,138487
3758,0.001629,172.31.36.0-255,66,116557,9,138487
3759,0.00257,74.125.24.0-255,1484,118041,9,138487
3760,0.002577,74.125.24.0-255,2902,120943,9,138487
3761,0.002581,172.31.36.0-255,66,121009,9,138487
3762,0.002615,74.125.24.0-255,5738,126747,9,138487
3763,0.002618,172.31.36.0-255,66,126813,9,138487
3764,0.002637,172.31.36.0-255,66,126879,9,138487
3765,0.005234,74.125.24.0-255,5738,132617,9,138487
3766,0.005243,172.31.36.0-255,66,132683,9,138487
3767,0.007868,74.125.24.0-255,5738,138421,9,138487
3768,0.007876,172.31.36.0-255,66,138487,9,138487
3769,0.0,74.125.24.0-255,149,149,9,101984
3770,2.4e-05,172.31.36.0-255,66,215,9,101984
3771,3.2e-05,74.125.24.0-255,1484,1699,9,101984
3772,3.7e-05,172.31.36.0-255,66,1765,9,101984
3773,5.1e-05,74.125.24.0-255,2902,4667,9,101984
3774,5.4e-05,172.31.36.0-255,66,4733,9,101984
3775,5.7e-05,74.125.24.0-255,1484,6217,9,101984
3776,6e-05,172.31.36.0-255,66,6283,9,101984
3777,6.6e-05,74.125.24.0-255,2902,9185,9,101984
3778,7e-05,172.31.36.0-255,66,9251,9,101984
3779,7.8e-05,74.125.24.0-255,6310,15561,9,101984
3780,8.1e-05,172.31.36.0-255,66,15627,9,101984
3781,8.4e-05,74.125.24.0-255,1484,17111,9,101984
3782,8.6e-05,172.31.36.0-255,66,17177,9,101984
3783,0.00013,74.125.24.0-255,5738,22915,9,101984
3784,0.000133,172.31.36.0-255,66,22981,9,101984
3785,0.000144,172.31.36.0-255,66,23047,9,101984
3786,0.000153,74.125.24.0-255,1484,24531,9,101984
3787,0.000155,172.31.36.0-255,66,24597,9,101984
3788,0.00016,74.125.24.0-255,2902,27499,9,101984
3789,0.000162,172.31.36.0-255,66,27565,9,101984
3790,0.000188,74.125.24.0-255,1484,29049,9,101984
3791,0.00019,172.31.36.0-255,66,29115,9,101984
3792,0.000195,74.125.24.0-255,2902,32017,9,101984
3793,0.000198,172.31.36.0-255,66,32083,9,101984
3794,0.00021,74.125.24.0-255,5738,37821,9,101984
3795,0.000212,172.31.36.0-255,66,37887,9,101984
3796,0.000243,74.125.24.0-255,2543,40430,9,101984
3797,0.000249,172.31.36.0-255,66,40496,9,101984
3798,0.000385,74.125.24.0-255,1484,41980,9,101984
3799,0.00039,172.31.36.0-255,66,42046,9,101984
3800,0.00041,74.125.24.0-255,2902,44948,9,101984
3801,0.000416,74.125.24.0-255,2902,47850,9,101984
3802,0.00044,74.125.24.0-255,2902,50752,9,101984
3803,0.000446,74.125.24.0-255,5738,56490,9,101984
3804,0.000478,74.125.24.0-255,1416,57906,9,101984
3805,0.000549,74.125.24.0-255,135,58041,9,101984
3806,0.000568,172.31.36.0-255,66,58107,9,101984
3807,0.000631,74.125.24.0-255,347,58454,9,101984
3808,0.001119,172.31.36.0-255,66,58520,9,101984
3809,0.001606,74.125.24.0-255,1484,60004,9,101984
3810,0.001617,74.125.24.0-255,2902,62906,9,101984
3811,0.001643,74.125.24.0-255,5738,68644,9,101984
3812,0.001646,74.125.24.0-255,1484,70128,9,101984
3813,0.001673,74.125.24.0-255,5738,75866,9,101984
3814,0.001698,74.125.24.0-255,7156,83022,9,101984
3815,0.002302,74.125.24.0-255,1484,84506,9,101984
3816,0.002895,172.31.36.0-255,66,84572,9,101984
3817,0.005189,74.125.24.0-255,5738,90310,9,101984
3818,0.005195,172.31.36.0-255,66,90376,9,101984
3819,0.007504,74.125.24.0-255,5738,96114,9,101984
3820,0.007512,172.31.36.0-255,66,96180,9,101984
3821,0.009766,74.125.24.0-255,5738,101918,9,101984
3822,0.009774,172.31.36.0-255,66,101984,9,101984
3823,0.0,74.125.24.0-255,153,153,9,227759
3824,1.5e-05,172.31.36.0-255,66,219,9,227759
3825,2.2e-05,74.125.24.0-255,1484,1703,9,227759
3826,2.7e-05,172.31.36.0-255,66,1769,9,227759
3827,3.3e-05,74.125.24.0-255,2902,4671,9,227759
3828,3.7e-05,172.31.36.0-255,66,4737,9,227759
3829,4.6e-05,74.125.24.0-255,7156,11893,9,227759
3830,5e-05,172.31.36.0-255,66,11959,9,227759
3831,5.4e-05,74.125.24.0-255,2080,14039,9,227759
3832,5.6e-05,172.31.36.0-255,66,14105,9,227759
3833,0.000103,74.125.24.0-255,1484,15589,9,227759
3834,0.000105,172.31.36.0-255,66,15655,9,227759
3835,0.00011,74.125.24.0-255,2902,18557,9,227759
3836,0.000112,172.31.36.0-255,66,18623,9,227759
3837,0.000138,74.125.24.0-255,5738,24361,9,227759
3838,0.00014,172.31.36.0-255,66,24427,9,227759
3839,0.000178,74.125.24.0-255,6797,31224,9,227759
3840,0.00018,172.31.36.0-255,66,31290,9,227759
3841,0.000187,74.125.24.0-255,7156,38446,9,227759
3842,0.000189,172.31.36.0-255,66,38512,9,227759
3843,0.000213,172.31.36.0-255,66,38578,9,227759
3844,0.000436,74.125.24.0-255,1484,40062,9,227759
3845,0.000441,172.31.36.0-255,66,40128,9,227759
3846,0.000447,74.125.24.0-255,2902,43030,9,227759
3847,0.000449,172.31.36.0-255,66,43096,9,227759
3848,0.000457,74.125.24.0-255,5738,48834,9,227759
3849,0.00046,172.31.36.0-255,66,48900,9,227759
3850,0.000514,172.31.36.0-255,66,48966,9,227759
3851,0.000541,172.31.36.0-255,66,49032,9,227759
3852,0.000561,74.125.24.0-255,5738,54770,9,227759
3853,0.000563,172.31.36.0-255,66,54836,9,227759
3854,0.000588,74.125.24.0-255,3961,58797,9,227759
3855,0.000591,172.31.36.0-255,66,58863,9,227759
3856,0.000617,74.125.24.0-255,4320,63183,9,227759
3857,0.000621,172.31.36.0-255,66,63249,9,227759
3858,0.00065,172.31.36.0-255,66,63315,9,227759
3859,0.000783,74.125.24.0-255,1484,64799,9,227759
3860,0.000789,74.125.24.0-255,2902,67701,9,227759
3861,0.000792,172.31.36.0-255,66,67767,9,227759
3862,0.000799,74.125.24.0-255,5738,73505,9,227759
3863,0.000801,172.31.36.0-255,66,73571,9,227759
3864,0.000807,74.125.24.0-255,4320,77891,9,227759
3865,0.00081,172.31.36.0-255,66,77957,9,227759
3866,0.00083,74.125.24.0-255,2902,80859,9,227759
3867,0.000833,172.31.36.0-255,66,80925,9,227759
3868,0.000869,74.125.24.0-255,1138,82063,9,227759
3869,0.000881,172.31.36.0-255,66,82129,9,227759
3870,0.000955,74.125.24.0-255,1484,83613,9,227759
3871,0.000961,74.125.24.0-255,2902,86515,9,227759
3872,0.000964,172.31.36.0-255,66,86581,9,227759
3873,0.000988,74.125.24.0-255,5738,92319,9,227759
3874,0.000991,172.31.36.0-255,66,92385,9,227759
3875,0.000995,74.125.24.0-255,2902,95287,9,227759
3876,0.000997,172.31.36.0-255,66,95353,9,227759
3877,0.001021,74.125.24.0-255,1484,96837,9,227759
3878,0.001026,172.31.36.0-255,66,96903,9,227759
3879,0.001068,172.31.36.0-255,66,96969,9,227759
3880,0.001136,74.125.24.0-255,1484,98453,9,227759
3881,0.001157,74.125.24.0-255,2902,101355,9,227759
3882,0.001163,74.125.24.0-255,5738,107093,9,227759
3883,0.001169,172.31.36.0-255,66,107159,9,227759
3884,0.001178,74.125.24.0-255,2902,110061,9,227759
3885,0.001183,172.31.36.0-255,66,110127,9,227759
3886,0.001194,74.125.24.0-255,4320,114447,9,227759
3887,0.00121,74.125.24.0-255,5738,120185,9,227759
3888,0.001217,74.125.24.0-255,7156,127341,9,227759
3889,0.001236,74.125.24.0-255,3602,130943,9,227759
3890,0.001239,172.31.36.0-255,66,131009,9,227759
3891,0.001244,172.31.36.0-255,66,131075,9,227759
3892,0.001311,74.125.24.0-255,1484,132559,9,227759
3893,0.001316,74.125.24.0-255,2902,135461,9,227759
3894,0.001321,172.31.36.0-255,66,135527,9,227759
3895,0.001365,74.125.24.0-255,4320,139847,9,227759
3896,0.00137,172.31.36.0-255,66,139913,9,227759
3897,0.001389,74.125.24.0-255,1484,141397,9,227759
3898,0.001414,74.125.24.0-255,2184,143581,9,227759
3899,0.001419,172.31.36.0-255,66,143647,9,227759
3900,0.001461,74.125.24.0-255,2902,146549,9,227759
3901,0.001464,74.125.24.0-255,1484,148033,9,227759
3902,0.001468,74.125.24.0-255,1484,149517,9,227759
3903,0.001482,74.125.24.0-255,4320,153837,9,227759
3904,0.001498,74.125.24.0-255,4320,158157,9,227759
3905,0.001506,172.31.36.0-255,66,158223,9,227759
3906,0.001561,172.31.36.0-255,66,158289,9,227759
3907,0.001609,74.125.24.0-255,1484,159773,9,227759
3908,0.001612,74.125.24.0-255,1484,161257,9,227759
3909,0.001626,74.125.24.0-255,1484,162741,9,227759
3910,0.001634,74.125.24.0-255,5738,168479,9,227759
3911,0.001637,172.31.36.0-255,66,168545,9,227759
3912,0.001647,74.125.24.0-255,1484,170029,9,227759
3913,0.001654,172.31.36.0-255,66,170095,9,227759
3914,0.001676,74.125.24.0-255,2902,172997,9,227759
3915,0.001709,172.31.36.0-255,66,173063,9,227759
3916,0.001728,74.125.24.0-255,4320,177383,9,227759
3917,0.001761,172.31.36.0-255,66,177449,9,227759
3918,0.001768,74.125.24.0-255,7156,184605,9,227759
3919,0.001773,74.125.24.0-255,4320,188925,9,227759
3920,0.001779,172.31.36.0-255,66,188991,9,227759
3921,0.00179,74.125.24.0-255,3602,192593,9,227759
3922,0.001809,74.125.24.0-255,2902,195495,9,227759
3923,0.001815,172.31.36.0-255,66,195561,9,227759
3924,0.001825,74.125.24.0-255,5738,201299,9,227759
3925,0.001831,74.125.24.0-255,4320,205619,9,227759
3926,0.001835,172.31.36.0-255,66,205685,9,227759
3927,0.001843,74.125.24.0-255,1484,207169,9,227759
3928,0.001881,172.31.36.0-255,66,207235,9,227759
3929,0.0019,74.125.24.0-255,1484,208719,9,227759
3930,0.001921,172.31.36.0-255,66,208785,9,227759
3931,0.00193,74.125.24.0-255,7156,215941,9,227759
3932,0.001943,172.31.36.0-255,66,216007,9,227759
3933,0.001956,74.125.24.0-255,7156,223163,9,227759
3934,0.001994,74.125.24.0-255,4320,227483,9,227759
3935,0.002041,74.125.24.0-255,105,227588,9,227759
3936,0.006914,172.31.36.0-255,66,227654,9,227759
3937,0.00975,172.31.36.0-255,105,227759,9,227759
3938,0.0,172.31.36.0-255,66,66,9,66
3939,0.0,172.31.36.0-255,66,66,9,66
3940,0.0,172.31.36.0-255,66,66,9,66
3941,0.0,172.217.194.0-255,153,153,9,54607
3942,2.6e-05,172.31.36.0-255,66,219,9,54607
3943,3.3e-05,172.217.194.0-255,1484,1703,9,54607
3944,3.6e-05,172.31.36.0-255,66,1769,9,54607
3945,4.1e-05,172.217.194.0-255,2902,4671,9,54607
3946,5.2e-05,172.31.36.0-255,66,4737,9,54607
3947,5.9e-05,172.217.194.0-255,7156,11893,9,54607
3948,6.2e-05,172.31.36.0-255,66,11959,9,54607
3949,6.6e-05,172.217.194.0-255,2049,14008,9,54607
3950,6.9e-05,172.31.36.0-255,66,14074,9,54607
3951,0.00133,172.217.194.0-255,1484,15558,9,54607
3952,0.001337,172.31.36.0-255,66,15624,9,54607
3953,0.001346,172.217.194.0-255,2902,18526,9,54607
3954,0.001348,172.31.36.0-255,66,18592,9,54607
3955,0.001361,172.217.194.0-255,5738,24330,9,54607
3956,0.001363,172.31.36.0-255,66,24396,9,54607
3957,0.00138,172.217.194.0-255,1484,25880,9,54607
3958,0.001383,172.31.36.0-255,66,25946,9,54607
3959,0.001412,172.217.194.0-255,5379,31325,9,54607
3960,0.001416,172.31.36.0-255,66,31391,9,54607
3961,0.003425,172.217.194.0-255,5738,37129,9,54607
3962,0.003431,172.31.36.0-255,66,37195,9,54607
3963,0.005441,172.217.194.0-255,5738,42933,9,54607
3964,0.005448,172.31.36.0-255,66,42999,9,54607
3965,0.007458,172.217.194.0-255,5738,48737,9,54607
3966,0.007466,172.31.36.0-255,66,48803,9,54607
3967,0.009452,172.217.194.0-255,5738,54541,9,54607
3968,0.009461,172.31.36.0-255,66,54607,9,54607
3969,0.0,172.217.194.0-255,152,152,9,105491
3970,2.5e-05,172.31.36.0-255,66,218,9,105491
3971,3.2e-05,172.217.194.0-255,1484,1702,9,105491
3972,3.6e-05,172.31.36.0-255,66,1768,9,105491
3973,4.1e-05,172.217.194.0-255,2902,4670,9,105491
3974,4.4e-05,172.31.36.0-255,66,4736,9,105491
3975,5.2e-05,172.217.194.0-255,7156,11892,9,105491
3976,5.4e-05,172.31.36.0-255,66,11958,9,105491
3977,8e-05,172.217.194.0-255,2046,14004,9,105491
3978,8.3e-05,172.31.36.0-255,66,14070,9,105491
3979,8.6e-05,172.217.194.0-255,1484,15554,9,105491
3980,8.9e-05,172.31.36.0-255,66,15620,9,105491
3981,0.000102,172.217.194.0-255,1484,17104,9,105491
3982,0.000104,172.31.36.0-255,66,17170,9,105491
3983,0.000109,172.217.194.0-255,2902,20072,9,105491
3984,0.000111,172.31.36.0-255,66,20138,9,105491
3985,0.000134,172.217.194.0-255,4320,24458,9,105491
3986,0.000137,172.31.36.0-255,66,24524,9,105491
3987,0.000139,172.217.194.0-255,1484,26008,9,105491
3988,0.000141,172.31.36.0-255,66,26074,9,105491
3989,0.000169,172.217.194.0-255,4320,30394,9,105491
3990,0.000172,172.31.36.0-255,66,30460,9,105491
3991,0.00019,172.217.194.0-255,1125,31585,9,105491
3992,0.000192,172.31.36.0-255,66,31651,9,105491
3993,0.000196,172.217.194.0-255,1484,33135,9,105491
3994,0.000198,172.31.36.0-255,66,33201,9,105491
3995,0.000212,172.217.194.0-255,4320,37521,9,105491
3996,0.000215,172.31.36.0-255,66,37587,9,105491
3997,0.000238,172.217.194.0-255,4320,41907,9,105491
3998,0.00024,172.31.36.0-255,66,41973,9,105491
3999,0.000275,172.31.36.0-255,66,42039,9,105491
4000,0.000279,172.217.194.0-255,2902,44941,9,105491
4001,0.000281,172.31.36.0-255,66,45007,9,105491
4002,0.000316,172.31.36.0-255,66,45073,9,105491
4003,0.000319,172.217.194.0-255,366,45439,9,105491
4004,0.000521,172.217.194.0-255,1484,46923,9,105491
4005,0.000525,172.31.36.0-255,66,46989,9,105491
4006,0.000531,172.217.194.0-255,2902,49891,9,105491
4007,0.000532,172.31.36.0-255,66,49957,9,105491
4008,0.000535,172.217.194.0-255,1484,51441,9,105491
4009,0.000557,172.217.194.0-255,4320,55761,9,105491
4010,0.000559,172.31.36.0-255,66,55827,9,105491
4011,0.000582,172.217.194.0-255,5738,61565,9,105491
4012,0.000584,172.31.36.0-255,66,61631,9,105491
4013,0.000613,172.217.194.0-255,7156,68787,9,105491
4014,0.000617,172.31.36.0-255,66,68853,9,105491
4015,0.000675,172.31.36.0-255,66,68919,9,105491
4016,0.000764,172.217.194.0-255,1484,70403,9,105491
4017,0.00077,172.217.194.0-255,2902,73305,9,105491
4018,0.000772,172.31.36.0-255,66,73371,9,105491
4019,0.000798,172.217.194.0-255,5738,79109,9,105491
4020,0.000801,172.31.36.0-255,66,79175,9,105491
4021,0.000805,172.217.194.0-255,2902,82077,9,105491
4022,0.000807,172.31.36.0-255,66,82143,9,105491
4023,0.000837,172.31.36.0-255,66,82209,9,105491
4024,0.00085,172.31.36.0-255,66,82275,9,105491
4025,0.002991,172.217.194.0-255,5738,88013,9,105491
4026,0.002997,172.31.36.0-255,66,88079,9,105491
4027,0.005111,172.217.194.0-255,5738,93817,9,105491
4028,0.005118,172.31.36.0-255,66,93883,9,105491
4029,0.007243,172.217.194.0-255,5738,99621,9,105491
4030,0.007249,172.31.36.0-255,66,99687,9,105491
4031,0.009418,172.217.194.0-255,5738,105425,9,105491
4032,0.009425,172.31.36.0-255,66,105491,9,105491
4033,0.0,74.125.24.0-255,189,189,9,256978
4034,1.5e-05,74.125.24.0-255,1484,1673,9,256978
4035,2.3e-05,172.31.36.0-255,66,1739,9,256978
4036,3.3e-05,74.125.24.0-255,2902,4641,9,256978
4037,3.8e-05,172.31.36.0-255,66,4707,9,256978
4038,4.6e-05,74.125.24.0-255,7156,11863,9,256978
4039,4.9e-05,172.31.36.0-255,66,11929,9,256978
4040,6.7e-05,74.125.24.0-255,2902,14831,9,256978
4041,7e-05,172.31.36.0-255,66,14897,9,256978
4042,9.3e-05,74.125.24.0-255,4878,19775,9,256978
4043,9.6e-05,172.31.36.0-255,66,19841,9,256978
4044,0.000104,74.125.24.0-255,7156,26997,9,256978
4045,0.000106,172.31.36.0-255,66,27063,9,256978
4046,0.000178,74.125.24.0-255,1484,28547,9,256978
4047,0.000198,74.125.24.0-255,766,29313,9,256978
4048,0.000219,172.31.36.0-255,66,29379,9,256978
4049,0.000383,74.125.24.0-255,1484,30863,9,256978
4050,0.000403,74.125.24.0-255,2902,33765,9,256978
4051,0.000409,74.125.24.0-255,4320,38085,9,256978
4052,0.000441,74.125.24.0-255,131,38216,9,256978
4053,0.000465,172.31.36.0-255,66,38282,9,256978
4054,0.000475,74.125.24.0-255,1484,39766,9,256978
4055,0.000493,74.125.24.0-255,2902,42668,9,256978
4056,0.000497,74.125.24.0-255,2902,45570,9,256978
4057,0.000513,74.125.24.0-255,2902,48472,9,256978
4058,0.000566,74.125.24.0-255,1484,49956,9,256978
4059,0.000573,74.125.24.0-255,5738,55694,9,256978
4060,0.000578,172.31.36.0-255,66,55760,9,256978
4061,0.00061,74.125.24.0-255,2902,58662,9,256978
4062,0.000616,172.31.36.0-255,66,58728,9,256978
4063,0.000627,74.125.24.0-255,2467,61195,9,256978
4064,0.000652,172.31.36.0-255,66,61261,9,256978
4065,0.000701,74.125.24.0-255,1484,62745,9,256978
4066,0.000705,74.125.24.0-255,1484,64229,9,256978
4067,0.000717,172.31.36.0-255,66,64295,9,256978
4068,0.00073,74.125.24.0-255,1484,65779,9,256978
4069,0.000738,74.125.24.0-255,5738,71517,9,256978
4070,0.000749,74.125.24.0-255,1484,73001,9,256978
4071,0.000756,172.31.36.0-255,66,73067,9,256978
4072,0.000804,172.31.36.0-255,66,73133,9,256978
4073,0.00141,74.125.24.0-255,1484,74617,9,256978
4074,0.001417,74.125.24.0-255,2902,77519,9,256978
4075,0.001421,172.31.36.0-255,66,77585,9,256978
4076,0.001443,74.125.24.0-255,5738,83323,9,256978
4077,0.001459,172.31.36.0-255,66,83389,9,256978
4078,0.001477,74.125.24.0-255,1484,84873,9,256978
4079,0.001507,74.125.24.0-255,5738,90611,9,256978
4080,0.001515,172.31.36.0-255,66,90677,9,256978
4081,0.001526,74.125.24.0-255,5020,95697,9,256978
4082,0.001531,172.31.36.0-255,66,95763,9,256978
4083,0.00181,74.125.24.0-255,1484,97247,9,256978
4084,0.001816,74.125.24.0-255,2902,100149,9,256978
4085,0.00182,172.31.36.0-255,66,100215,9,256978
4086,0.001849,74.125.24.0-255,5738,105953,9,256978
4087,0.001855,74.125.24.0-255,4320,110273,9,256978
4088,0.001862,172.31.36.0-255,66,110339,9,256978
4089,0.001872,74.125.24.0-255,4320,114659,9,256978
4090,0.001877,172.31.36.0-255,66,114725,9,256978
4091,0.001888,74.125.24.0-255,5738,120463,9,256978
4092,0.001914,74.125.24.0-255,7156,127619,9,256978
4093,0.001928,74.125.24.0-255,4320,131939,9,256978
4094,0.001941,172.31.36.0-255,66,132005,9,256978
4095,0.001963,74.125.24.0-255,4320,136325,9,256978
4096,0.001976,172.31.36.0-255,66,136391,9,256978
4097,0.002015,74.125.24.0-255,4320,140711,9,256978
4098,0.002029,74.125.24.0-255,5738,146449,9,256978
4099,0.002042,74.125.24.0-255,5738,152187,9,256978
4100,0.002058,74.125.24.0-255,1484,153671,9,256978
4101,0.00206,172.31.36.0-255,66,153737,9,256978
4102,0.002136,74.125.24.0-255,6438,160175,9,256978
4103,0.002226,74.125.24.0-255,1484,161659,9,256978
4104,0.002232,74.125.24.0-255,2902,164561,9,256978
4105,0.002235,74.125.24.0-255,1484,166045,9,256978
4106,0.002247,74.125.24.0-255,4320,170365,9,256978
4107,0.002253,74.125.24.0-255,4320,174685,9,256978
4108,0.002269,74.125.24.0-255,2902,177587,9,256978
4109,0.002274,74.125.24.0-255,2902,180489,9,256978
4110,0.00229,74.125.24.0-255,5738,186227,9,256978
4111,0.002314,74.125.24.0-255,5738,191965,9,256978
4112,0.002319,74.125.24.0-255,2902,194867,9,256978
4113,0.002346,74.125.24.0-255,6438,201305,9,256978
4114,0.002372,74.125.24.0-255,1484,202789,9,256978
4115,0.002379,74.125.24.0-255,7156,209945,9,256978
4116,0.002407,74.125.24.0-255,1484,211429,9,256978
4117,0.002433,74.125.24.0-255,7156,218585,9,256978
4118,0.002436,74.125.24.0-255,1484,220069,9,256978
4119,0.002486,74.125.24.0-255,3602,223671,9,256978
4120,0.002491,74.125.24.0-255,4320,227991,9,256978
4121,0.002494,74.125.24.0-255,1484,229475,9,256978
4122,0.002504,74.125.24.0-255,1484,230959,9,256978
4123,0.002531,74.125.24.0-255,5738,236697,9,256978
4124,0.002534,74.125.24.0-255,1484,238181,9,256978
4125,0.002537,74.125.24.0-255,1484,239665,9,256978
4126,0.002543,74.125.24.0-255,5738,245403,9,256978
4127,0.002584,74.125.24.0-255,7156,252559,9,256978
4128,0.002618,74.125.24.0-255,1484,254043,9,256978
4129,0.002622,74.125.24.0-255,2659,256702,9,256978
4130,0.002624,74.125.24.0-255,105,256807,9,256978
4131,0.005982,172.31.36.0-255,66,256873,9,256978
4132,0.008084,172.31.36.0-255,105,256978,9,256978
4133,0.0,74.125.68.0-255,146,146,9,369060
4134,5.1e-05,74.125.68.0-255,1484,1630,9,369060
4135,6e-05,172.31.36.0-255,66,1696,9,369060
4136,6.7e-05,74.125.68.0-255,2902,4598,9,369060
4137,7e-05,172.31.36.0-255,66,4664,9,369060
4138,9.4e-05,74.125.68.0-255,1484,6148,9,369060
4139,0.000111,74.125.68.0-255,2902,9050,9,369060
4140,0.000117,172.31.36.0-255,66,9116,9,369060
4141,0.000124,74.125.68.0-255,4871,13987,9,369060
4142,0.000126,172.31.36.0-255,66,14053,9,369060
4143,0.000327,74.125.68.0-255,1484,15537,9,369060
4144,0.000356,74.125.68.0-255,2902,18439,9,369060
4145,0.00036,172.31.36.0-255,66,18505,9,369060
4146,0.000381,74.125.68.0-255,1484,19989,9,369060
4147,0.000385,74.125.68.0-255,1484,21473,9,369060
4148,0.000387,172.31.36.0-255,66,21539,9,369060
4149,0.0004,74.125.68.0-255,1484,23023,9,369060
4150,0.000404,74.125.68.0-255,1484,24507,9,369060
4151,0.000406,172.31.36.0-255,66,24573,9,369060
4152,0.000433,74.125.68.0-255,4320,28893,9,369060
4153,0.000437,172.31.36.0-255,66,28959,9,369060
4154,0.000442,74.125.68.0-255,2543,31502,9,369060
4155,0.000444,172.31.36.0-255,66,31568,9,369060
4156,0.000558,74.125.68.0-255,1484,33052,9,369060
4157,0.000571,74.125.68.0-255,1484,34536,9,369060
4158,0.000574,172.31.36.0-255,66,34602,9,369060
4159,0.000579,74.125.68.0-255,1484,36086,9,369060
4160,0.000593,74.125.68.0-255,1484,37570,9,369060
4161,0.000595,172.31.36.0-255,66,37636,9,369060
4162,0.000598,74.125.68.0-255,1484,39120,9,369060
4163,0.000622,74.125.68.0-255,4320,43440,9,369060
4164,0.000624,172.31.36.0-255,66,43506,9,369060
4165,0.000631,74.125.68.0-255,5379,48885,9,369060
4166,0.000633,172.31.36.0-255,66,48951,9,369060
4167,0.000671,74.125.68.0-255,5738,54689,9,369060
4168,0.000675,172.31.36.0-255,66,54755,9,369060
4169,0.000679,74.125.68.0-255,2902,57657,9,369060
4170,0.000682,172.31.36.0-255,66,57723,9,369060
4171,0.000694,74.125.68.0-255,1484,59207,9,369060
4172,0.000711,74.125.68.0-255,2902,62109,9,369060
4173,0.000714,172.31.36.0-255,66,62175,9,369060
4174,0.00073,74.125.68.0-255,2902,65077,9,369060
4175,0.000732,172.31.36.0-255,66,65143,9,369060
4176,0.000735,74.125.68.0-255,1402,66545,9,369060
4177,0.000863,74.125.68.0-255,126,66671,9,369060
4178,0.000882,172.31.36.0-255,66,66737,9,369060
4179,0.001213,74.125.68.0-255,1484,68221,9,369060
4180,0.001222,74.125.68.0-255,2902,71123,9,369060
4181,0.001227,172.31.36.0-255,66,71189,9,369060
4182,0.001232,74.125.68.0-255,1484,72673,9,369060
4183,0.001237,74.125.68.0-255,2902,75575,9,369060
4184,0.001239,172.31.36.0-255,66,75641,9,369060
4185,0.001258,74.125.68.0-255,4320,79961,9,369060
4186,0.001262,172.31.36.0-255,66,80027,9,369060
4187,0.001278,74.125.68.0-255,1484,81511,9,369060
4188,0.001283,74.125.68.0-255,2902,84413,9,369060
4189,0.001286,172.31.36.0-255,66,84479,9,369060
4190,0.001313,74.125.68.0-255,7156,91635,9,369060
4191,0.001316,172.31.36.0-255,66,91701,9,369060
4192,0.001348,74.125.68.0-255,5738,97439,9,369060
4193,0.001351,172.31.36.0-255,66,97505,9,369060
4194,0.001365,74.125.68.0-255,5020,102525,9,369060
4195,0.00137,172.31.36.0-255,66,102591,9,369060
4196,0.001377,74.125.68.0-255,7156,109747,9,369060
4197,0.00138,172.31.36.0-255,66,109813,9,369060
4198,0.001408,74.125.68.0-255,4320,114133,9,369060
4199,0.001411,172.31.36.0-255,66,114199,9,369060
4200,0.001418,74.125.68.0-255,7156,121355,9,369060
4201,0.00142,172.31.36.0-255,66,121421,9,369060
4202,0.00143,172.31.36.0-255,66,121487,9,369060
4203,0.001436,74.125.68.0-255,5020,126507,9,369060
4204,0.001438,172.31.36.0-255,66,126573,9,369060
4205,0.001456,74.125.68.0-255,4320,130893,9,369060
4206,0.001459,172.31.36.0-255,66,130959,9,369060
4207,0.001477,74.125.68.0-255,1484,132443,9,369060
4208,0.001494,74.125.68.0-255,4320,136763,9,369060
4209,0.001497,172.31.36.0-255,66,136829,9,369060
4210,0.001519,74.125.68.0-255,5738,142567,9,369060
4211,0.001522,172.31.36.0-255,66,142633,9,369060
4212,0.001525,74.125.68.0-255,1484,144117,9,369060
4213,0.001546,74.125.68.0-255,7156,151273,9,369060
4214,0.00155,172.31.36.0-255,66,151339,9,369060
4215,0.001568,74.125.68.0-255,2902,154241,9,369060
4216,0.001571,172.31.36.0-255,66,154307,9,369060
4217,0.001578,74.125.68.0-255,4320,158627,9,369060
4218,0.001582,172.31.36.0-255,66,158693,9,369060
4219,0.001619,74.125.68.0-255,2184,160877,9,369060
4220,0.001622,172.31.36.0-255,66,160943,9,369060
4221,0.002236,74.125.68.0-255,1484,162427,9,369060
4222,0.002239,74.125.68.0-255,1484,163911,9,369060
4223,0.002241,172.31.36.0-255,66,163977,9,369060
4224,0.002255,74.125.68.0-255,1484,165461,9,369060
4225,0.002266,74.125.68.0-255,2902,168363,9,369060
4226,0.002268,172.31.36.0-255,66,168429,9,369060
4227,0.002286,74.125.68.0-255,2902,171331,9,369060
4228,0.002289,172.31.36.0-255,66,171397,9,369060
4229,0.002292,74.125.68.0-255,1484,172881,9,369060
4230,0.002309,74.125.68.0-255,7156,180037,9,369060
4231,0.002311,172.31.36.0-255,66,180103,9,369060
4232,0.002331,74.125.68.0-255,1484,181587,9,369060
4233,0.002344,172.31.36.0-255,66,181653,9,369060
4234,0.002347,74.125.68.0-255,2184,183837,9,369060
4235,0.002349,172.31.36.0-255,66,183903,9,369060
4236,0.002393,74.125.68.0-255,1484,185387,9,369060
4237,0.002413,74.125.68.0-255,2902,188289,9,369060
4238,0.002416,172.31.36.0-255,66,188355,9,369060
4239,0.002438,74.125.68.0-255,5738,194093,9,369060
4240,0.00244,172.31.36.0-255,66,194159,9,369060
4241,0.002443,74.125.68.0-255,1484,195643,9,369060
4242,0.002446,74.125.68.0-255,1484,197127,9,369060
4243,0.002447,172.31.36.0-255,66,197193,9,369060
4244,0.002462,74.125.68.0-255,2902,200095,9,369060
4245,0.002464,172.31.36.0-255,66,200161,9,369060
4246,0.00249,74.125.68.0-255,5738,205899,9,369060
4247,0.002492,172.31.36.0-255,66,205965,9,369060
4248,0.002497,74.125.68.0-255,5738,211703,9,369060
4249,0.002499,172.31.36.0-255,66,211769,9,369060
4250,0.002523,74.125.68.0-255,6438,218207,9,369060
4251,0.002525,172.31.36.0-255,66,218273,9,369060
4252,0.002579,74.125.68.0-255,1484,219757,9,369060
4253,0.002583,74.125.68.0-255,2902,222659,9,369060
4254,0.002585,172.31.36.0-255,66,222725,9,369060
4255,0.002591,74.125.68.0-255,5738,228463,9,369060
4256,0.002593,172.31.36.0-255,66,228529,9,369060
4257,0.002616,74.125.68.0-255,7156,235685,9,369060
4258,0.002619,172.31.36.0-255,66,235751,9,369060
4259,0.00263,172.31.36.0-255,66,235817,9,369060
4260,0.002659,172.31.36.0-255,66,235883,9,369060
4261,0.002691,74.125.68.0-255,4320,240203,9,369060
4262,0.002694,172.31.36.0-255,66,240269,9,369060
4263,0.002706,74.125.68.0-255,2902,243171,9,369060
4264,0.002709,172.31.36.0-255,66,243237,9,369060
4265,0.002712,74.125.68.0-255,1484,244721,9,369060
4266,0.002716,74.125.68.0-255,2902,247623,9,369060
4267,0.002719,172.31.36.0-255,66,247689,9,369060
4268,0.002721,74.125.68.0-255,1484,249173,9,369060
4269,0.002739,74.125.68.0-255,1484,250657,9,369060
4270,0.002742,172.31.36.0-255,66,250723,9,369060
4271,0.002767,74.125.68.0-255,7156,257879,9,369060
4272,0.00277,172.31.36.0-255,66,257945,9,369060
4273,0.002773,74.125.68.0-255,1484,259429,9,369060
4274,0.0028,74.125.68.0-255,4320,263749,9,369060
4275,0.002803,172.31.36.0-255,66,263815,9,369060
4276,0.002827,74.125.68.0-255,6438,270253,9,369060
4277,0.00283,172.31.36.0-255,66,270319,9,369060
4278,0.002836,74.125.68.0-255,4320,274639,9,369060
4279,0.002838,172.31.36.0-255,66,274705,9,369060
4280,0.002855,74.125.68.0-255,7156,281861,9,369060
4281,0.002861,74.125.68.0-255,4320,286181,9,369060
4282,0.002898,74.125.68.0-255,4320,290501,9,369060
4283,0.002917,74.125.68.0-255,4320,294821,9,369060
4284,0.002936,74.125.68.0-255,5738,300559,9,369060
4285,0.002949,74.125.68.0-255,3602,304161,9,369060
4286,0.002965,74.125.68.0-255,2902,307063,9,369060
4287,0.002983,74.125.68.0-255,1484,308547,9,369060
4288,0.002999,74.125.68.0-255,2902,311449,9,369060
4289,0.003001,74.125.68.0-255,1484,312933,9,369060
4290,0.003003,74.125.68.0-255,1484,314417,9,369060
4291,0.003004,172.31.36.0-255,66,314483,9,369060
4292,0.003012,172.31.36.0-255,66,314549,9,369060
4293,0.003033,74.125.68.0-255,2902,317451,9,369060
4294,0.003044,172.31.36.0-255,66,317517,9,369060
4295,0.003047,74.125.68.0-255,5738,323255,9,369060
4296,0.00305,74.125.68.0-255,1484,324739,9,369060
4297,0.003052,74.125.68.0-255,1484,326223,9,369060
4298,0.003054,74.125.68.0-255,1484,327707,9,369060
4299,0.003061,172.31.36.0-255,66,327773,9,369060
4300,0.003077,74.125.68.0-255,2902,330675,9,369060
4301,0.003081,74.125.68.0-255,1484,332159,9,369060
4302,0.003087,172.31.36.0-255,66,332225,9,369060
4303,0.003101,74.125.68.0-255,4320,336545,9,369060
4304,0.003105,74.125.68.0-255,2184,338729,9,369060
4305,0.00311,172.31.36.0-255,66,338795,9,369060
4306,0.003147,74.125.68.0-255,1484,340279,9,369060
4307,0.003161,74.125.68.0-255,1484,341763,9,369060
4308,0.003164,74.125.68.0-255,1484,343247,9,369060
4309,0.003169,172.31.36.0-255,66,343313,9,369060
4310,0.003182,74.125.68.0-255,2902,346215,9,369060
4311,0.003186,172.31.36.0-255,66,346281,9,369060
4312,0.003189,74.125.68.0-255,5738,352019,9,369060
4313,0.003207,172.31.36.0-255,66,352085,9,369060
4314,0.003214,74.125.68.0-255,2902,354987,9,369060
4315,0.003217,74.125.68.0-255,1484,356471,9,369060
4316,0.003221,172.31.36.0-255,66,356537,9,369060
4317,0.003237,74.125.68.0-255,5738,362275,9,369060
4318,0.003242,172.31.36.0-255,66,362341,9,369060
4319,0.00326,74.125.68.0-255,1484,363825,9,369060
4320,0.003291,172.31.36.0-255,66,363891,9,369060
4321,0.003308,74.125.68.0-255,1484,365375,9,369060
4322,0.003338,172.31.36.0-255,66,365441,9,369060
4323,0.003375,74.125.68.0-255,3277,368718,9,369060
4324,0.003388,172.31.36.0-255,66,368784,9,369060
4325,0.003424,74.125.68.0-255,105,368889,9,369060
4326,0.005779,172.31.36.0-255,105,368994,9,369060
4327,0.008058,74.125.68.0-255,66,369060,9,369060
4328,0.0,74.125.68.0-255,153,153,9,302735
4329,3.3e-05,172.31.36.0-255,66,219,9,302735
4330,6.3e-05,74.125.68.0-255,1484,1703,9,302735
4331,6.8e-05,172.31.36.0-255,66,1769,9,302735
4332,7.3e-05,74.125.68.0-255,2902,4671,9,302735
4333,7.6e-05,172.31.36.0-255,66,4737,9,302735
4334,8.1e-05,74.125.68.0-255,4320,9057,9,302735
4335,8.4e-05,172.31.36.0-255,66,9123,9,302735
4336,0.00011,74.125.68.0-255,1484,10607,9,302735
4337,0.000113,172.31.36.0-255,66,10673,9,302735
4338,0.000119,74.125.68.0-255,3464,14137,9,302735
4339,0.000122,172.31.36.0-255,66,14203,9,302735
4340,0.000127,74.125.68.0-255,4320,18523,9,302735
4341,0.000129,172.31.36.0-255,66,18589,9,302735
4342,0.000173,172.31.36.0-255,66,18655,9,302735
4343,0.000179,74.125.68.0-255,2543,21198,9,302735
4344,0.000181,172.31.36.0-255,66,21264,9,302735
4345,0.000249,74.125.68.0-255,1484,22748,9,302735
4346,0.000253,172.31.36.0-255,66,22814,9,302735
4347,0.000283,74.125.68.0-255,2902,25716,9,302735
4348,0.000287,172.31.36.0-255,66,25782,9,302735
4349,0.000293,74.125.68.0-255,5738,31520,9,302735
4350,0.000296,172.31.36.0-255,66,31586,9,302735
4351,0.00032,74.125.68.0-255,2902,34488,9,302735
4352,0.000323,172.31.36.0-255,66,34554,9,302735
4353,0.000328,74.125.68.0-255,3961,38515,9,302735
4354,0.000331,172.31.36.0-255,66,38581,9,302735
4355,0.000372,74.125.68.0-255,1484,40065,9,302735
4356,0.000375,172.31.36.0-255,66,40131,9,302735
4357,0.00038,74.125.68.0-255,2902,43033,9,302735
4358,0.000382,172.31.36.0-255,66,43099,9,302735
4359,0.000417,74.125.68.0-255,5738,48837,9,302735
4360,0.000422,74.125.68.0-255,2902,51739,9,302735
4361,0.000423,172.31.36.0-255,66,51805,9,302735
4362,0.000427,74.125.68.0-255,4268,56073,9,302735
4363,0.00043,74.125.68.0-255,114,56187,9,302735
4364,0.000432,172.31.36.0-255,66,56253,9,302735
4365,0.00056,74.125.68.0-255,1484,57737,9,302735
4366,0.000567,74.125.68.0-255,2902,60639,9,302735
4367,0.000573,172.31.36.0-255,66,60705,9,302735
4368,0.000601,74.125.68.0-255,5738,66443,9,302735
4369,0.000609,172.31.36.0-255,66,66509,9,302735
4370,0.000619,74.125.68.0-255,1484,67993,9,302735
4371,0.000638,74.125.68.0-255,2902,70895,9,302735
4372,0.000641,172.31.36.0-255,66,70961,9,302735
4373,0.000671,74.125.68.0-255,5738,76699,9,302735
4374,0.000676,74.125.68.0-255,2902,79601,9,302735
4375,0.00068,172.31.36.0-255,66,79667,9,302735
4376,0.000714,74.125.68.0-255,1484,81151,9,302735
4377,0.000737,74.125.68.0-255,2902,84053,9,302735
4378,0.000741,172.31.36.0-255,66,84119,9,302735
4379,0.000748,74.125.68.0-255,1484,85603,9,302735
4380,0.000776,74.125.68.0-255,4320,89923,9,302735
4381,0.00078,74.125.68.0-255,766,90689,9,302735
4382,0.00079,172.31.36.0-255,66,90755,9,302735
4383,0.000906,74.125.68.0-255,1484,92239,9,302735
4384,0.00091,74.125.68.0-255,1484,93723,9,302735
4385,0.000913,172.31.36.0-255,66,93789,9,302735
4386,0.000941,74.125.68.0-255,2902,96691,9,302735
4387,0.000947,74.125.68.0-255,5738,102429,9,302735
4388,0.000953,172.31.36.0-255,66,102495,9,302735
4389,0.00097,74.125.68.0-255,2902,105397,9,302735
4390,0.00098,172.31.36.0-255,66,105463,9,302735
4391,0.000986,74.125.68.0-255,5738,111201,9,302735
4392,0.000989,74.125.68.0-255,1484,112685,9,302735
4393,0.000994,172.31.36.0-255,66,112751,9,302735
4394,0.001036,74.125.68.0-255,3602,116353,9,302735
4395,0.001036,172.31.36.0-255,66,116419,9,302735
4396,0.001041,172.31.36.0-255,66,116485,9,302735
4397,0.001116,74.125.68.0-255,1484,117969,9,302735
4398,0.001143,74.125.68.0-255,2902,120871,9,302735
4399,0.001147,172.31.36.0-255,66,120937,9,302735
4400,0.001179,74.125.68.0-255,1484,122421,9,302735
4401,0.001192,74.125.68.0-255,2902,125323,9,302735
4402,0.001203,172.31.36.0-255,66,125389,9,302735
4403,0.001235,74.125.68.0-255,1484,126873,9,302735
4404,0.001278,74.125.68.0-255,1484,128357,9,302735
4405,0.001284,172.31.36.0-255,66,128423,9,302735
4406,0.001322,74.125.68.0-255,1484,129907,9,302735
4407,0.001335,74.125.68.0-255,1484,131391,9,302735
4408,0.001338,172.31.36.0-255,66,131457,9,302735
4409,0.001345,74.125.68.0-255,5738,137195,9,302735
4410,0.001349,172.31.36.0-255,66,137261,9,302735
4411,0.00135,74.125.68.0-255,4320,141581,9,302735
4412,0.001353,172.31.36.0-255,66,141647,9,302735
4413,0.001361,74.125.68.0-255,5738,147385,9,302735
4414,0.001365,172.31.36.0-255,66,147451,9,302735
4415,0.001391,74.125.68.0-255,3602,151053,9,302735
4416,0.001403,172.31.36.0-255,66,151119,9,302735
4417,0.001519,74.125.68.0-255,1484,152603,9,302735
4418,0.001524,74.125.68.0-255,2902,155505,9,302735
4419,0.001527,172.31.36.0-255,66,155571,9,302735
4420,0.001531,74.125.68.0-255,1484,157055,9,302735
4421,0.00156,74.125.68.0-255,4320,161375,9,302735
4422,0.001564,172.31.36.0-255,66,161441,9,302735
4423,0.001587,74.125.68.0-255,7156,168597,9,302735
4424,0.00159,172.31.36.0-255,66,168663,9,302735
4425,0.00161,74.125.68.0-255,4320,172983,9,302735
4426,0.001621,172.31.36.0-255,66,173049,9,302735
4427,0.001626,172.31.36.0-255,66,173115,9,302735
4428,0.001635,74.125.68.0-255,2184,175299,9,302735
4429,0.001642,74.125.68.0-255,1484,176783,9,302735
4430,0.001642,172.31.36.0-255,66,176849,9,302735
4431,0.001645,74.125.68.0-255,2902,179751,9,302735
4432,0.001648,74.125.68.0-255,1484,181235,9,302735
4433,0.001657,172.31.36.0-255,66,181301,9,302735
4434,0.001677,74.125.68.0-255,4320,185621,9,302735
4435,0.001679,172.31.36.0-255,66,185687,9,302735
4436,0.001687,74.125.68.0-255,7156,192843,9,302735
4437,0.00169,172.31.36.0-255,66,192909,9,302735
4438,0.001728,74.125.68.0-255,5738,198647,9,302735
4439,0.001733,172.31.36.0-255,66,198713,9,302735
4440,0.001766,74.125.68.0-255,6438,205151,9,302735
4441,0.001771,74.125.68.0-255,2902,208053,9,302735
4442,0.001781,172.31.36.0-255,66,208119,9,302735
4443,0.00181,74.125.68.0-255,5738,213857,9,302735
4444,0.001815,172.31.36.0-255,66,213923,9,302735
4445,0.00185,74.125.68.0-255,5738,219661,9,302735
4446,0.001855,172.31.36.0-255,66,219727,9,302735
4447,0.001867,74.125.68.0-255,2902,222629,9,302735
4448,0.001871,172.31.36.0-255,66,222695,9,302735
4449,0.001899,74.125.68.0-255,6438,229133,9,302735
4450,0.001904,74.125.68.0-255,2902,232035,9,302735
4451,0.001908,172.31.36.0-255,66,232101,9,302735
4452,0.001918,74.125.68.0-255,4320,236421,9,302735
4453,0.001927,172.31.36.0-255,66,236487,9,302735
4454,0.001969,74.125.68.0-255,5738,242225,9,302735
4455,0.001971,172.31.36.0-255,66,242291,9,302735
4456,0.001975,172.31.36.0-255,66,242357,9,302735
4457,0.00201,172.31.36.0-255,66,242423,9,302735
4458,0.002038,74.125.68.0-255,5020,247443,9,302735
4459,0.002048,172.31.36.0-255,66,247509,9,302735
4460,0.002065,172.31.36.0-255,66,247575,9,302735
4461,0.002081,74.125.68.0-255,1484,249059,9,302735
4462,0.002088,74.125.68.0-255,5738,254797,9,302735
4463,0.002098,172.31.36.0-255,66,254863,9,302735
4464,0.002169,172.31.36.0-255,66,254929,9,302735
4465,0.002177,74.125.68.0-255,5738,260667,9,302735
4466,0.002184,172.31.36.0-255,66,260733,9,302735
4467,0.002206,74.125.68.0-255,6438,267171,9,302735
4468,0.002222,172.31.36.0-255,66,267237,9,302735
4469,0.002225,74.125.68.0-255,1484,268721,9,302735
4470,0.002253,74.125.68.0-255,5738,274459,9,302735
4471,0.002259,74.125.68.0-255,4320,278779,9,302735
4472,0.002263,74.125.68.0-255,4320,283099,9,302735
4473,0.002266,172.31.36.0-255,66,283165,9,302735
4474,0.002271,172.31.36.0-255,66,283231,9,302735
4475,0.002274,74.125.68.0-255,1484,284715,9,302735
4476,0.002302,74.125.68.0-255,7156,291871,9,302735
4477,0.002313,172.31.36.0-255,66,291937,9,302735
4478,0.002329,74.125.68.0-255,4320,296257,9,302735
4479,0.002332,74.125.68.0-255,766,297023,9,302735
4480,0.002334,172.31.36.0-255,66,297089,9,302735
4481,0.002359,74.125.68.0-255,4320,301409,9,302735
4482,0.002371,172.31.36.0-255,66,301475,9,302735
4483,0.002392,74.125.68.0-255,97,301572,9,302735
4484,0.002406,172.31.36.0-255,66,301638,9,302735
4485,0.002407,74.125.68.0-255,105,301743,9,302735
4486,0.002436,74.125.68.0-255,129,301872,9,302735
4487,0.003019,172.31.36.0-255,101,301973,9,302735
4488,0.003845,172.31.36.0-255,105,302078,9,302735
4489,0.00387,172.31.36.0-255,105,302183,9,302735
4490,0.00408,172.31.36.0-255,90,302273,9,302735
4491,0.00409,172.31.36.0-255,66,302339,9,302735
4492,0.005627,74.125.68.0-255,66,302405,9,302735
4493,0.006434,74.125.68.0-255,66,302471,9,302735
4494,0.006449,74.125.68.0-255,66,302537,9,302735
4495,0.006661,74.125.68.0-255,66,302603,9,302735
4496,0.006698,74.125.68.0-255,66,302669,9,302735
4497,0.006703,172.31.36.0-255,66,302735,9,302735
4498,0.0,172.31.36.0-255,105,105,9,105
4499,0.0,172.31.36.0-255,105,105,9,105
4500,0.0,74.125.200.0-255,153,153,9,352017
4501,1.5e-05,172.31.36.0-255,66,219,9,352017
4502,2.3e-05,74.125.200.0-255,1484,1703,9,352017
4503,2.7e-05,172.31.36.0-255,66,1769,9,352017
4504,3.2e-05,74.125.200.0-255,2902,4671,9,352017
4505,3.5e-05,172.31.36.0-255,66,4737,9,352017
4506,3.8e-05,74.125.200.0-255,1484,6221,9,352017
4507,4.1e-05,172.31.36.0-255,66,6287,9,352017
4508,4.8e-05,74.125.200.0-255,2902,9189,9,352017
4509,5e-05,172.31.36.0-255,66,9255,9,352017
4510,9.2e-05,74.125.200.0-255,4886,14141,9,352017
4511,9.6e-05,172.31.36.0-255,66,14207,9,352017
4512,0.000266,74.125.200.0-255,1484,15691,9,352017
4513,0.000271,172.31.36.0-255,66,15757,9,352017
4514,0.000277,74.125.200.0-255,2902,18659,9,352017
4515,0.00028,172.31.36.0-255,66,18725,9,352017
4516,0.000305,74.125.200.0-255,1484,20209,9,352017
4517,0.000308,172.31.36.0-255,66,20275,9,352017
4518,0.000313,74.125.200.0-255,2902,23177,9,352017
4519,0.000315,172.31.36.0-255,66,23243,9,352017
4520,0.000322,74.125.200.0-255,5738,28981,9,352017
4521,0.000324,172.31.36.0-255,66,29047,9,352017
4522,0.000346,74.125.200.0-255,2543,31590,9,352017
4523,0.000348,172.31.36.0-255,66,31656,9,352017
4524,0.000479,74.125.200.0-255,1484,33140,9,352017
4525,0.000484,172.31.36.0-255,66,33206,9,352017
4526,0.00049,74.125.200.0-255,2902,36108,9,352017
4527,0.000492,172.31.36.0-255,66,36174,9,352017
4528,0.000511,74.125.200.0-255,5738,41912,9,352017
4529,0.000513,172.31.36.0-255,66,41978,9,352017
4530,0.000535,74.125.200.0-255,5738,47716,9,352017
4531,0.000538,172.31.36.0-255,66,47782,9,352017
4532,0.00056,74.125.200.0-255,3961,51743,9,352017
4533,0.000566,74.125.200.0-255,7156,58899,9,352017
4534,0.000571,172.31.36.0-255,66,58965,9,352017
4535,0.000574,172.31.36.0-255,66,59031,9,352017
4536,0.000585,74.125.200.0-255,2902,61933,9,352017
4537,0.000587,172.31.36.0-255,66,61999,9,352017
4538,0.000621,74.125.200.0-255,3961,65960,9,352017
4539,0.000623,172.31.36.0-255,66,66026,9,352017
4540,0.001138,74.125.200.0-255,646,66672,9,352017
4541,0.00128,74.125.200.0-255,1484,68156,9,352017
4542,0.001286,172.31.36.0-255,66,68222,9,352017
4543,0.001292,74.125.200.0-255,2902,71124,9,352017
4544,0.001295,172.31.36.0-255,66,71190,9,352017
4545,0.001299,74.125.200.0-255,2902,74092,9,352017
4546,0.001301,172.31.36.0-255,66,74158,9,352017
4547,0.001307,74.125.200.0-255,4320,78478,9,352017
4548,0.001309,172.31.36.0-255,66,78544,9,352017
4549,0.001343,172.31.36.0-255,66,78610,9,352017
4550,0.001368,74.125.200.0-255,7156,85766,9,352017
4551,0.001371,172.31.36.0-255,66,85832,9,352017
4552,0.001405,74.125.200.0-255,4320,90152,9,352017
4553,0.001407,172.31.36.0-255,66,90218,9,352017
4554,0.001425,74.125.200.0-255,2184,92402,9,352017
4555,0.001428,172.31.36.0-255,66,92468,9,352017
4556,0.001474,74.125.200.0-255,1484,93952,9,352017
4557,0.001478,74.125.200.0-255,1484,95436,9,352017
4558,0.00148,172.31.36.0-255,66,95502,9,352017
4559,0.0015,74.125.200.0-255,1484,96986,9,352017
4560,0.001507,74.125.200.0-255,4320,101306,9,352017
4561,0.001509,172.31.36.0-255,66,101372,9,352017
4562,0.001533,74.125.200.0-255,5738,107110,9,352017
4563,0.001535,172.31.36.0-255,66,107176,9,352017
4564,0.001557,74.125.200.0-255,5738,112914,9,352017
4565,0.001559,172.31.36.0-255,66,112980,9,352017
4566,0.001577,74.125.200.0-255,5738,118718,9,352017
4567,0.001579,172.31.36.0-255,66,118784,9,352017
4568,0.001616,74.125.200.0-255,5738,124522,9,352017
4569,0.001619,172.31.36.0-255,66,124588,9,352017
4570,0.001637,74.125.200.0-255,2184,126772,9,352017
4571,0.001639,172.31.36.0-255,66,126838,9,352017
4572,0.001645,74.125.200.0-255,2902,129740,9,352017
4573,0.001646,172.31.36.0-255,66,129806,9,352017
4574,0.001671,74.125.200.0-255,5738,135544,9,352017
4575,0.001674,172.31.36.0-255,66,135610,9,352017
4576,0.001678,74.125.200.0-255,2902,138512,9,352017
4577,0.00168,172.31.36.0-255,66,138578,9,352017
4578,0.001696,74.125.200.0-255,1484,140062,9,352017
4579,0.001711,74.125.200.0-255,5738,145800,9,352017
4580,0.001714,172.31.36.0-255,66,145866,9,352017
4581,0.001738,74.125.200.0-255,5738,151604,9,352017
4582,0.001741,172.31.36.0-255,66,151670,9,352017
4583,0.001747,74.125.200.0-255,5738,157408,9,352017
4584,0.001749,172.31.36.0-255,66,157474,9,352017
4585,0.001774,74.125.200.0-255,3602,161076,9,352017
4586,0.001777,172.31.36.0-255,66,161142,9,352017
4587,0.001885,74.125.200.0-255,1484,162626,9,352017
4588,0.001892,74.125.200.0-255,2902,165528,9,352017
4589,0.001896,172.31.36.0-255,66,165594,9,352017
4590,0.00192,74.125.200.0-255,5738,171332,9,352017
4591,0.001923,172.31.36.0-255,66,171398,9,352017
4592,0.00193,74.125.200.0-255,5738,177136,9,352017
4593,0.001932,172.31.36.0-255,66,177202,9,352017
4594,0.001947,74.125.200.0-255,1484,178686,9,352017
4595,0.001963,74.125.200.0-255,7156,185842,9,352017
4596,0.001965,172.31.36.0-255,66,185908,9,352017
4597,0.001991,74.125.200.0-255,7156,193064,9,352017
4598,0.001993,172.31.36.0-255,66,193130,9,352017
4599,0.001997,74.125.200.0-255,2184,195314,9,352017
4600,0.001999,172.31.36.0-255,66,195380,9,352017
4601,0.002135,74.125.200.0-255,1484,196864,9,352017
4602,0.002147,74.125.200.0-255,1484,198348,9,352017
4603,0.00215,172.31.36.0-255,66,198414,9,352017
4604,0.002166,74.125.200.0-255,1484,199898,9,352017
4605,0.002169,74.125.200.0-255,1484,201382,9,352017
4606,0.002171,172.31.36.0-255,66,201448,9,352017
4607,0.002195,74.125.200.0-255,4320,205768,9,352017
4608,0.002197,172.31.36.0-255,66,205834,9,352017
4609,0.002204,74.125.200.0-255,7156,212990,9,352017
4610,0.002206,172.31.36.0-255,66,213056,9,352017
4611,0.002218,74.125.200.0-255,1484,214540,9,352017
4612,0.002244,172.31.36.0-255,66,214606,9,352017
4613,0.00228,74.125.200.0-255,5020,219626,9,352017
4614,0.002283,172.31.36.0-255,66,219692,9,352017
4615,0.002311,74.125.200.0-255,5738,225430,9,352017
4616,0.002314,172.31.36.0-255,66,225496,9,352017
4617,0.002334,74.125.200.0-255,2902,228398,9,352017
4618,0.002338,172.31.36.0-255,66,228464,9,352017
4619,0.002397,74.125.200.0-255,4320,232784,9,352017
4620,0.002405,172.31.36.0-255,66,232850,9,352017
4621,0.002409,74.125.200.0-255,2902,235752,9,352017
4622,0.002412,172.31.36.0-255,66,235818,9,352017
4623,0.002415,74.125.200.0-255,1484,237302,9,352017
4624,0.002489,74.125.200.0-255,2902,240204,9,352017
4625,0.002492,172.31.36.0-255,66,240270,9,352017
4626,0.002498,74.125.200.0-255,4320,244590,9,352017
4627,0.0025,172.31.36.0-255,66,244656,9,352017
4628,0.002517,74.125.200.0-255,4320,248976,9,352017
4629,0.002519,172.31.36.0-255,66,249042,9,352017
4630,0.002523,74.125.200.0-255,2902,251944,9,352017
4631,0.002525,172.31.36.0-255,66,252010,9,352017
4632,0.002569,74.125.200.0-255,5738,257748,9,352017
4633,0.002572,172.31.36.0-255,66,257814,9,352017
4634,0.002593,74.125.200.0-255,3602,261416,9,352017
4635,0.002595,172.31.36.0-255,66,261482,9,352017
4636,0.002598,74.125.200.0-255,1484,262966,9,352017
4637,0.002603,74.125.200.0-255,4320,267286,9,352017
4638,0.002605,172.31.36.0-255,66,267352,9,352017
4639,0.002643,172.31.36.0-255,66,267418,9,352017
4640,0.002661,74.125.200.0-255,2902,270320,9,352017
4641,0.002663,172.31.36.0-255,66,270386,9,352017
4642,0.00267,74.125.200.0-255,5020,275406,9,352017
4643,0.002672,172.31.36.0-255,66,275472,9,352017
4644,0.002691,74.125.200.0-255,2902,278374,9,352017
4645,0.002693,172.31.36.0-255,66,278440,9,352017
4646,0.002709,74.125.200.0-255,7156,285596,9,352017
4647,0.002712,172.31.36.0-255,66,285662,9,352017
4648,0.002716,74.125.200.0-255,2902,288564,9,352017
4649,0.002718,172.31.36.0-255,66,288630,9,352017
4650,0.002747,172.31.36.0-255,66,288696,9,352017
4651,0.00275,74.125.200.0-255,1484,290180,9,352017
4652,0.00277,172.31.36.0-255,66,290246,9,352017
4653,0.002775,74.125.200.0-255,2184,292430,9,352017
4654,0.002777,172.31.36.0-255,66,292496,9,352017
4655,0.00278,74.125.200.0-255,1484,293980,9,352017
4656,0.002792,74.125.200.0-255,1484,295464,9,352017
4657,0.002795,172.31.36.0-255,66,295530,9,352017
4658,0.002815,74.125.200.0-255,1484,297014,9,352017
4659,0.00282,74.125.200.0-255,2902,299916,9,352017
4660,0.002822,172.31.36.0-255,66,299982,9,352017
4661,0.002839,74.125.200.0-255,1484,301466,9,352017
4662,0.002846,74.125.200.0-255,5738,307204,9,352017
4663,0.002848,172.31.36.0-255,66,307270,9,352017
4664,0.002856,74.125.200.0-255,7156,314426,9,352017
4665,0.002858,172.31.36.0-255,66,314492,9,352017
4666,0.002901,172.31.36.0-255,66,314558,9,352017
4667,0.00295,74.125.200.0-255,2902,317460,9,352017
4668,0.002952,172.31.36.0-255,66,317526,9,352017
4669,0.002982,172.31.36.0-255,66,317592,9,352017
4670,0.002986,74.125.200.0-255,2902,320494,9,352017
4671,0.002988,172.31.36.0-255,66,320560,9,352017
4672,0.002991,74.125.200.0-255,1484,322044,9,352017
4673,0.002998,74.125.200.0-255,5738,327782,9,352017
4674,0.003,172.31.36.0-255,66,327848,9,352017
4675,0.003021,74.125.200.0-255,2902,330750,9,352017
4676,0.003023,172.31.36.0-255,66,330816,9,352017
4677,0.003026,74.125.200.0-255,1484,332300,9,352017
4678,0.003051,74.125.200.0-255,2902,335202,9,352017
4679,0.003053,172.31.36.0-255,66,335268,9,352017
4680,0.003072,74.125.200.0-255,3602,338870,9,352017
4681,0.003075,172.31.36.0-255,66,338936,9,352017
4682,0.003095,74.125.200.0-255,4320,343256,9,352017
4683,0.003097,172.31.36.0-255,66,343322,9,352017
4684,0.003101,74.125.200.0-255,1484,344806,9,352017
4685,0.003104,74.125.200.0-255,1484,346290,9,352017
4686,0.003106,172.31.36.0-255,66,346356,9,352017
4687,0.003112,74.125.200.0-255,4320,350676,9,352017
4688,0.003114,172.31.36.0-255,66,350742,9,352017
4689,0.003132,74.125.200.0-255,999,351741,9,352017
4690,0.003174,74.125.200.0-255,105,351846,9,352017
4691,0.008814,172.31.36.0-255,66,351912,9,352017
4692,0.008853,172.31.36.0-255,105,352017,9,352017
4693,0.0,172.31.36.0-255,105,105,9,105
4694,0.0,172.217.194.0-255,153,153,9,205153
4695,2.6e-05,172.31.36.0-255,66,219,9,205153
4696,3.2e-05,172.217.194.0-255,1484,1703,9,205153
4697,3.6e-05,172.31.36.0-255,66,1769,9,205153
4698,4.2e-05,172.217.194.0-255,2902,4671,9,205153
4699,4.5e-05,172.31.36.0-255,66,4737,9,205153
4700,5.2e-05,172.217.194.0-255,7156,11893,9,205153
4701,5.4e-05,172.31.36.0-255,66,11959,9,205153
4702,7.9e-05,172.217.194.0-255,2011,13970,9,205153
4703,8.1e-05,172.31.36.0-255,66,14036,9,205153
4704,0.000148,172.217.194.0-255,1484,15520,9,205153
4705,0.000153,172.31.36.0-255,66,15586,9,205153
4706,0.000159,172.217.194.0-255,2902,18488,9,205153
4707,0.000161,172.31.36.0-255,66,18554,9,205153
4708,0.000167,172.217.194.0-255,4320,22874,9,205153
4709,0.000169,172.31.36.0-255,66,22940,9,205153
4710,0.000196,172.217.194.0-255,1484,24424,9,205153
4711,0.000199,172.31.36.0-255,66,24490,9,205153
4712,0.000206,172.217.194.0-255,6797,31287,9,205153
4713,0.000208,172.31.36.0-255,66,31353,9,205153
4714,0.000223,172.217.194.0-255,1484,32837,9,205153
4715,0.000226,172.31.36.0-255,66,32903,9,205153
4716,0.000252,172.31.36.0-255,66,32969,9,205153
4717,0.000269,172.217.194.0-255,1484,34453,9,205153
4718,0.000272,172.31.36.0-255,66,34519,9,205153
4719,0.000276,172.217.194.0-255,2543,37062,9,205153
4720,0.000279,172.31.36.0-255,66,37128,9,205153
4721,0.000715,172.217.194.0-255,1484,38612,9,205153
4722,0.00072,172.31.36.0-255,66,38678,9,205153
4723,0.00073,172.217.194.0-255,2902,41580,9,205153
4724,0.000732,172.31.36.0-255,66,41646,9,205153
4725,0.00074,172.217.194.0-255,5738,47384,9,205153
4726,0.000743,172.31.36.0-255,66,47450,9,205153
4727,0.000792,172.217.194.0-255,4320,51770,9,205153
4728,0.000796,172.31.36.0-255,66,51836,9,205153
4729,0.000818,172.217.194.0-255,3122,54958,9,205153
4730,0.000821,172.31.36.0-255,66,55024,9,205153
4731,0.000832,172.31.36.0-255,66,55090,9,205153
4732,0.000838,172.217.194.0-255,5738,60828,9,205153
4733,0.000841,172.31.36.0-255,66,60894,9,205153
4734,0.000892,172.31.36.0-255,66,60960,9,205153
4735,0.000928,172.31.36.0-255,66,61026,9,205153
4736,0.000932,172.217.194.0-255,2543,63569,9,205153
4737,0.000935,172.31.36.0-255,66,63635,9,205153
4738,0.001355,172.217.194.0-255,1484,65119,9,205153
4739,0.001363,172.217.194.0-255,2902,68021,9,205153
4740,0.001367,172.31.36.0-255,66,68087,9,205153
4741,0.001373,172.217.194.0-255,5738,73825,9,205153
4742,0.001375,172.31.36.0-255,66,73891,9,205153
4743,0.001393,172.217.194.0-255,4320,78211,9,205153
4744,0.001395,172.31.36.0-255,66,78277,9,205153
4745,0.001414,172.31.36.0-255,66,78343,9,205153
4746,0.001417,172.217.194.0-255,1484,79827,9,205153
4747,0.001465,172.217.194.0-255,7156,86983,9,205153
4748,0.001468,172.31.36.0-255,66,87049,9,205153
4749,0.001488,172.217.194.0-255,2184,89233,9,205153
4750,0.00149,172.31.36.0-255,66,89299,9,205153
4751,0.001493,172.217.194.0-255,1484,90783,9,205153
4752,0.001509,172.217.194.0-255,2902,93685,9,205153
4753,0.001511,172.31.36.0-255,66,93751,9,205153
4754,0.001535,172.217.194.0-255,5738,99489,9,205153
4755,0.001537,172.31.36.0-255,66,99555,9,205153
4756,0.001555,172.217.194.0-255,5738,105293,9,205153
4757,0.001558,172.31.36.0-255,66,105359,9,205153
4758,0.001578,172.217.194.0-255,5738,111097,9,205153
4759,0.001581,172.31.36.0-255,66,111163,9,205153
4760,0.001599,172.217.194.0-255,1484,112647,9,205153
4761,0.001622,172.31.36.0-255,66,112713,9,205153
4762,0.00164,172.217.194.0-255,2184,114897,9,205153
4763,0.001642,172.31.36.0-255,66,114963,9,205153
4764,0.001658,172.217.194.0-255,1484,116447,9,205153
4765,0.001662,172.217.194.0-255,2902,119349,9,205153
4766,0.001664,172.31.36.0-255,66,119415,9,205153
4767,0.001683,172.217.194.0-255,4320,123735,9,205153
4768,0.001686,172.31.36.0-255,66,123801,9,205153
4769,0.001696,172.217.194.0-255,1484,125285,9,205153
4770,0.001722,172.217.194.0-255,4320,129605,9,205153
4771,0.001727,172.31.36.0-255,66,129671,9,205153
4772,0.001744,172.217.194.0-255,4320,133991,9,205153
4773,0.001746,172.31.36.0-255,66,134057,9,205153
4774,0.001771,172.217.194.0-255,4320,138377,9,205153
4775,0.001773,172.31.36.0-255,66,138443,9,205153
4776,0.001789,172.217.194.0-255,2902,141345,9,205153
4777,0.00179,172.31.36.0-255,66,141411,9,205153
4778,0.001821,172.31.36.0-255,66,141477,9,205153
4779,0.001864,172.217.194.0-255,1484,142961,9,205153
4780,0.001869,172.217.194.0-255,2902,145863,9,205153
4781,0.001871,172.31.36.0-255,66,145929,9,205153
4782,0.001877,172.217.194.0-255,5738,151667,9,205153
4783,0.001879,172.31.36.0-255,66,151733,9,205153
4784,0.00189,172.217.194.0-255,1484,153217,9,205153
4785,0.001911,172.217.194.0-255,2902,156119,9,205153
4786,0.001914,172.31.36.0-255,66,156185,9,205153
4787,0.00194,172.31.36.0-255,66,156251,9,205153
4788,0.001951,172.31.36.0-255,66,156317,9,205153
4789,0.001957,172.217.194.0-255,5738,162055,9,205153
4790,0.001959,172.31.36.0-255,66,162121,9,205153
4791,0.002008,172.31.36.0-255,66,162187,9,205153
4792,0.00202,172.31.36.0-255,66,162253,9,205153
4793,0.002055,172.31.36.0-255,66,162319,9,205153
4794,0.002068,172.31.36.0-255,66,162385,9,205153
4795,0.002073,172.217.194.0-255,5738,168123,9,205153
4796,0.002076,172.31.36.0-255,66,168189,9,205153
4797,0.002108,172.217.194.0-255,3602,171791,9,205153
4798,0.002111,172.31.36.0-255,66,171857,9,205153
4799,0.002122,172.31.36.0-255,66,171923,9,205153
4800,0.002164,172.217.194.0-255,4320,176243,9,205153
4801,0.002166,172.31.36.0-255,66,176309,9,205153
4802,0.002198,172.31.36.0-255,66,176375,9,205153
4803,0.002208,172.31.36.0-255,66,176441,9,205153
4804,0.002242,172.31.36.0-255,66,176507,9,205153
4805,0.002255,172.217.194.0-255,2184,178691,9,205153
4806,0.002258,172.31.36.0-255,66,178757,9,205153
4807,0.002262,172.217.194.0-255,2902,181659,9,205153
4808,0.002265,172.31.36.0-255,66,181725,9,205153
4809,0.002319,172.217.194.0-255,766,182491,9,205153
4810,0.002352,172.217.194.0-255,4320,186811,9,205153
4811,0.002356,172.217.194.0-255,3602,190413,9,205153
4812,0.002376,172.217.194.0-255,4320,194733,9,205153
4813,0.002395,172.217.194.0-255,7156,201889,9,205153
4814,0.002415,172.217.194.0-255,3093,204982,9,205153
4815,0.002622,172.31.36.0-255,66,205048,9,205153
4816,0.004855,172.217.194.0-255,105,205153,9,205153
4817,0.0,172.217.27.0-255,150,150,9,110944
4818,2.2e-05,172.31.36.0-255,66,216,9,110944
4819,2.9e-05,172.217.27.0-255,1484,1700,9,110944
4820,3.5e-05,172.31.36.0-255,66,1766,9,110944
4821,4e-05,172.217.27.0-255,2902,4668,9,110944
4822,4.4e-05,172.31.36.0-255,66,4734,9,110944
4823,5.1e-05,172.217.27.0-255,5738,10472,9,110944
4824,5.4e-05,172.31.36.0-255,66,10538,9,110944
4825,7.8e-05,172.217.27.0-255,6302,16840,9,110944
4826,8.1e-05,172.31.36.0-255,66,16906,9,110944
4827,8.4e-05,172.217.27.0-255,1484,18390,9,110944
4828,8.7e-05,172.31.36.0-255,66,18456,9,110944
4829,0.000119,172.217.27.0-255,4320,22776,9,110944
4830,0.000122,172.31.36.0-255,66,22842,9,110944
4831,0.00013,172.217.27.0-255,7156,29998,9,110944
4832,0.000133,172.31.36.0-255,66,30064,9,110944
4833,0.000135,172.217.27.0-255,1125,31189,9,110944
4834,0.000137,172.31.36.0-255,66,31255,9,110944
4835,0.000253,172.217.27.0-255,1484,32739,9,110944
4836,0.000258,172.31.36.0-255,66,32805,9,110944
4837,0.000263,172.217.27.0-255,2902,35707,9,110944
4838,0.000266,172.31.36.0-255,66,35773,9,110944
4839,0.000269,172.217.27.0-255,1484,37257,9,110944
4840,0.000272,172.31.36.0-255,66,37323,9,110944
4841,0.000295,172.217.27.0-255,4320,41643,9,110944
4842,0.000298,172.31.36.0-255,66,41709,9,110944
4843,0.000309,172.31.36.0-255,66,41775,9,110944
4844,0.000314,172.217.27.0-255,4320,46095,9,110944
4845,0.000316,172.31.36.0-255,66,46161,9,110944
4846,0.000331,172.217.27.0-255,4320,50481,9,110944
4847,0.000334,172.31.36.0-255,66,50547,9,110944
4848,0.000353,172.217.27.0-255,7065,57612,9,110944
4849,0.000472,172.31.36.0-255,66,57678,9,110944
4850,0.000636,172.217.27.0-255,132,57810,9,110944
4851,0.000806,172.217.27.0-255,1484,59294,9,110944
4852,0.000813,172.217.27.0-255,2902,62196,9,110944
4853,0.000817,172.217.27.0-255,2902,65098,9,110944
4854,0.000832,172.217.27.0-255,2902,68000,9,110944
4855,0.000839,172.31.36.0-255,66,68066,9,110944
4856,0.000853,172.217.27.0-255,5738,73804,9,110944
4857,0.00092,172.31.36.0-255,66,73870,9,110944
4858,0.000928,172.31.36.0-255,66,73936,9,110944
4859,0.001577,172.217.27.0-255,1484,75420,9,110944
4860,0.001585,172.217.27.0-255,2902,78322,9,110944
4861,0.00159,172.31.36.0-255,66,78388,9,110944
4862,0.001597,172.217.27.0-255,4320,82708,9,110944
4863,0.001641,172.217.27.0-255,7156,89864,9,110944
4864,0.001657,172.217.27.0-255,4320,94184,9,110944
4865,0.00166,172.217.27.0-255,1484,95668,9,110944
4866,0.00168,172.217.27.0-255,3602,99270,9,110944
4867,0.005462,172.31.36.0-255,66,99336,9,110944
4868,0.00713,172.217.27.0-255,5738,105074,9,110944
4869,0.007136,172.31.36.0-255,66,105140,9,110944
4870,0.008792,172.217.27.0-255,5738,110878,9,110944
4871,0.008799,172.31.36.0-255,66,110944,9,110944
4872,0.0,74.125.24.0-255,151,151,9,129545
4873,2.5e-05,172.31.36.0-255,66,217,9,129545
4874,3.2e-05,74.125.24.0-255,1484,1701,9,129545
4875,3.8e-05,172.31.36.0-255,66,1767,9,129545
4876,4.4e-05,74.125.24.0-255,2902,4669,9,129545
4877,4.8e-05,172.31.36.0-255,66,4735,9,129545
4878,5.6e-05,74.125.24.0-255,7156,11891,9,129545
4879,6e-05,172.31.36.0-255,66,11957,9,129545
4880,6.4e-05,74.125.24.0-255,2038,13995,9,129545
4881,6.7e-05,172.31.36.0-255,66,14061,9,129545
4882,9.7e-05,74.125.24.0-255,4320,18381,9,129545
4883,0.0001,172.31.36.0-255,66,18447,9,129545
4884,0.00012,74.125.24.0-255,7156,25603,9,129545
4885,0.000123,172.31.36.0-255,66,25669,9,129545
4886,0.000139,74.125.24.0-255,1484,27153,9,129545
4887,0.000141,172.31.36.0-255,66,27219,9,129545
4888,0.000162,74.125.24.0-255,3961,31180,9,129545
4889,0.000165,172.31.36.0-255,66,31246,9,129545
4890,0.000203,74.125.24.0-255,1484,32730,9,129545
4891,0.000206,172.31.36.0-255,66,32796,9,129545
4892,0.00021,74.125.24.0-255,2902,35698,9,129545
4893,0.000212,172.31.36.0-255,66,35764,9,129545
4894,0.000239,74.125.24.0-255,5738,41502,9,129545
4895,0.000242,172.31.36.0-255,66,41568,9,129545
4896,0.00025,74.125.24.0-255,6797,48365,9,129545
4897,0.000252,172.31.36.0-255,66,48431,9,129545
4898,0.000342,74.125.24.0-255,1484,49915,9,129545
4899,0.000346,172.31.36.0-255,66,49981,9,129545
4900,0.000351,74.125.24.0-255,2902,52883,9,129545
4901,0.000353,172.31.36.0-255,66,52949,9,129545
4902,0.00036,74.125.24.0-255,5738,58687,9,129545
4903,0.000363,172.31.36.0-255,66,58753,9,129545
4904,0.000401,74.125.24.0-255,6797,65550,9,129545
4905,0.000404,172.31.36.0-255,66,65616,9,129545
4906,0.000681,74.125.24.0-255,645,66261,9,129545
4907,0.00109,172.31.36.0-255,66,66327,9,129545
4908,0.001544,74.125.24.0-255,1484,67811,9,129545
4909,0.001555,74.125.24.0-255,2902,70713,9,129545
4910,0.001559,172.31.36.0-255,66,70779,9,129545
4911,0.001568,74.125.24.0-255,5738,76517,9,129545
4912,0.00157,172.31.36.0-255,66,76583,9,129545
4913,0.001577,74.125.24.0-255,5738,82321,9,129545
4914,0.00158,172.31.36.0-255,66,82387,9,129545
4915,0.001599,74.125.24.0-255,2902,85289,9,129545
4916,0.001601,172.31.36.0-255,66,85355,9,129545
4917,0.001635,74.125.24.0-255,5738,91093,9,129545
4918,0.001638,172.31.36.0-255,66,91159,9,129545
4919,0.001666,172.31.36.0-255,66,91225,9,129545
4920,0.001905,74.125.24.0-255,1484,92709,9,129545
4921,0.001913,74.125.24.0-255,2902,95611,9,129545
4922,0.001917,172.31.36.0-255,66,95677,9,129545
4923,0.001925,74.125.24.0-255,5738,101415,9,129545
4924,0.001928,172.31.36.0-255,66,101481,9,129545
4925,0.001932,74.125.24.0-255,2902,104383,9,129545
4926,0.001934,172.31.36.0-255,66,104449,9,129545
4927,0.001957,74.125.24.0-255,5738,110187,9,129545
4928,0.00196,172.31.36.0-255,66,110253,9,129545
4929,0.001976,74.125.24.0-255,1484,111737,9,129545
4930,0.002014,172.31.36.0-255,66,111803,9,129545
4931,0.004373,74.125.24.0-255,2902,114705,9,129545
4932,0.004377,172.31.36.0-255,66,114771,9,129545
4933,0.004395,74.125.24.0-255,2902,117673,9,129545
4934,0.004398,172.31.36.0-255,66,117739,9,129545
4935,0.006732,74.125.24.0-255,2902,120641,9,129545
4936,0.006739,172.31.36.0-255,66,120707,9,129545
4937,0.006761,74.125.24.0-255,2902,123609,9,129545
4938,0.006764,172.31.36.0-255,66,123675,9,129545
4939,0.009119,74.125.24.0-255,4320,127995,9,129545
4940,0.009126,172.31.36.0-255,66,128061,9,129545
4941,0.009145,74.125.24.0-255,1484,129545,9,129545
4942,0.0,172.31.36.0-255,105,105,9,105
4943,0.0,104.244.42.0-255,66,66,9,66
4944,0.0,216.58.221.0-255,152,152,9,138208
4945,2.8e-05,172.31.36.0-255,66,218,9,138208
4946,3.5e-05,216.58.221.0-255,1484,1702,9,138208
4947,3.9e-05,172.31.36.0-255,66,1768,9,138208
4948,4.4e-05,216.58.221.0-255,2902,4670,9,138208
4949,4.7e-05,172.31.36.0-255,66,4736,9,138208
4950,5.1e-05,216.58.221.0-255,2902,7638,9,138208
4951,5.2e-05,172.31.36.0-255,66,7704,9,138208
4952,5.8e-05,216.58.221.0-255,4320,12024,9,138208
4953,6.1e-05,172.31.36.0-255,66,12090,9,138208
4954,7.9e-05,216.58.221.0-255,2021,14111,9,138208
4955,8.4e-05,172.31.36.0-255,66,14177,9,138208
4956,0.000132,216.58.221.0-255,1484,15661,9,138208
4957,0.000135,172.31.36.0-255,66,15727,9,138208
4958,0.00015,216.58.221.0-255,2902,18629,9,138208
4959,0.000152,172.31.36.0-255,66,18695,9,138208
4960,0.000178,216.58.221.0-255,5738,24433,9,138208
4961,0.000181,172.31.36.0-255,66,24499,9,138208
4962,0.000222,216.58.221.0-255,2902,27401,9,138208
4963,0.000224,172.31.36.0-255,66,27467,9,138208
4964,0.000243,216.58.221.0-255,3961,31428,9,138208
4965,0.000245,172.31.36.0-255,66,31494,9,138208
4966,0.000622,216.58.221.0-255,1484,32978,9,138208
4967,0.000628,172.31.36.0-255,66,33044,9,138208
4968,0.000638,216.58.221.0-255,2902,35946,9,138208
4969,0.000641,172.31.36.0-255,66,36012,9,138208
4970,0.000645,216.58.221.0-255,2902,38914,9,138208
4971,0.000647,172.31.36.0-255,66,38980,9,138208
4972,0.000652,216.58.221.0-255,2902,41882,9,138208
4973,0.000654,172.31.36.0-255,66,41948,9,138208
4974,0.000679,216.58.221.0-255,1484,43432,9,138208
4975,0.000682,172.31.36.0-255,66,43498,9,138208
4976,0.000719,216.58.221.0-255,5379,48877,9,138208
4977,0.000723,172.31.36.0-255,66,48943,9,138208
4978,0.000763,216.58.221.0-255,1484,50427,9,138208
4979,0.000769,216.58.221.0-255,2902,53329,9,138208
4980,0.000773,172.31.36.0-255,66,53395,9,138208
4981,0.000777,216.58.221.0-255,1484,54879,9,138208
4982,0.000804,216.58.221.0-255,4320,59199,9,138208
4983,0.000808,172.31.36.0-255,66,59265,9,138208
4984,0.000814,216.58.221.0-255,4320,63585,9,138208
4985,0.000816,172.31.36.0-255,66,63651,9,138208
4986,0.000838,216.58.221.0-255,1484,65135,9,138208
4987,0.000849,216.58.221.0-255,1453,66588,9,138208
4988,0.000852,172.31.36.0-255,66,66654,9,138208
4989,0.001312,216.58.221.0-255,115,66769,9,138208
4990,0.001354,172.31.36.0-255,66,66835,9,138208
4991,0.001495,216.58.221.0-255,1484,68319,9,138208
4992,0.001518,216.58.221.0-255,2902,71221,9,138208
4993,0.001521,172.31.36.0-255,66,71287,9,138208
4994,0.001526,216.58.221.0-255,2902,74189,9,138208
4995,0.001528,172.31.36.0-255,66,74255,9,138208
4996,0.001549,216.58.221.0-255,2902,77157,9,138208
4997,0.001551,172.31.36.0-255,66,77223,9,138208
4998,0.00158,216.58.221.0-255,5738,82961,9,138208
4999,0.001583,172.31.36.0-255,66,83027,9,138208
5000,0.001589,216.58.221.0-255,6797,89824,9,138208
5001,0.001592,172.31.36.0-255,66,89890,9,138208
5002,0.001602,172.31.36.0-255,66,89956,9,138208
5003,0.001623,216.58.221.0-255,2543,92499,9,138208
5004,0.001626,172.31.36.0-255,66,92565,9,138208
5005,0.00175,216.58.221.0-255,1484,94049,9,138208
5006,0.001756,216.58.221.0-255,2902,96951,9,138208
5007,0.00176,172.31.36.0-255,66,97017,9,138208
5008,0.001763,216.58.221.0-255,1484,98501,9,138208
5009,0.001783,216.58.221.0-255,4320,102821,9,138208
5010,0.001785,172.31.36.0-255,66,102887,9,138208
5011,0.001788,216.58.221.0-255,1484,104371,9,138208
5012,0.00181,172.31.36.0-255,66,104437,9,138208
5013,0.001854,172.31.36.0-255,66,104503,9,138208
5014,0.001892,216.58.221.0-255,4320,108823,9,138208
5015,0.001895,172.31.36.0-255,66,108889,9,138208
5016,0.001917,216.58.221.0-255,5738,114627,9,138208
5017,0.001919,172.31.36.0-255,66,114693,9,138208
5018,0.00193,172.31.36.0-255,66,114759,9,138208
5019,0.001966,172.31.36.0-255,66,114825,9,138208
5020,0.002046,172.31.36.0-255,101,114926,9,138208
5021,0.003891,216.58.221.0-255,5738,120664,9,138208
5022,0.003898,172.31.36.0-255,66,120730,9,138208
5023,0.003931,216.58.221.0-255,66,120796,9,138208
5024,0.00583,216.58.221.0-255,5738,126534,9,138208
5025,0.005835,172.31.36.0-255,66,126600,9,138208
5026,0.007767,216.58.221.0-255,5738,132338,9,138208
5027,0.007774,172.31.36.0-255,66,132404,9,138208
5028,0.009708,216.58.221.0-255,5738,138142,9,138208
5029,0.009714,172.31.36.0-255,66,138208,9,138208
5030,0.0,104.244.42.0-255,66,66,9,66
5031,0.0,172.217.194.0-255,153,153,9,194789
5032,2.2e-05,172.31.36.0-255,66,219,9,194789
5033,2.9e-05,172.217.194.0-255,1484,1703,9,194789
5034,3.5e-05,172.31.36.0-255,66,1769,9,194789
5035,4.1e-05,172.217.194.0-255,2902,4671,9,194789
5036,4.5e-05,172.31.36.0-255,66,4737,9,194789
5037,5.2e-05,172.217.194.0-255,7156,11893,9,194789
5038,5.5e-05,172.31.36.0-255,66,11959,9,194789
5039,0.000109,172.31.36.0-255,66,12025,9,194789
5040,0.000121,172.217.194.0-255,619,12644,9,194789
5041,0.000123,172.31.36.0-255,66,12710,9,194789
5042,0.000128,172.217.194.0-255,1484,14194,9,194789
5043,0.00013,172.31.36.0-255,66,14260,9,194789
5044,0.000158,172.31.36.0-255,66,14326,9,194789
5045,0.00018,172.217.194.0-255,6438,20764,9,194789
5046,0.000183,172.31.36.0-255,66,20830,9,194789
5047,0.000197,172.31.36.0-255,66,20896,9,194789
5048,0.000212,172.217.194.0-255,4549,25445,9,194789
5049,0.000214,172.31.36.0-255,66,25511,9,194789
5050,0.00025,172.217.194.0-255,1484,26995,9,194789
5051,0.000252,172.31.36.0-255,66,27061,9,194789
5052,0.000257,172.217.194.0-255,2902,29963,9,194789
5053,0.000259,172.31.36.0-255,66,30029,9,194789
5054,0.000265,172.217.194.0-255,5738,35767,9,194789
5055,0.000268,172.31.36.0-255,66,35833,9,194789
5056,0.000275,172.217.194.0-255,7156,42989,9,194789
5057,0.000278,172.31.36.0-255,66,43055,9,194789
5058,0.000314,172.31.36.0-255,66,43121,9,194789
5059,0.000318,172.217.194.0-255,2184,45305,9,194789
5060,0.000369,172.217.194.0-255,1484,46789,9,194789
5061,0.000385,172.217.194.0-255,2902,49691,9,194789
5062,0.000391,172.217.194.0-255,4320,54011,9,194789
5063,0.000407,172.217.194.0-255,1484,55495,9,194789
5064,0.00041,172.217.194.0-255,1484,56979,9,194789
5065,0.000441,172.217.194.0-255,2902,59881,9,194789
5066,0.000487,172.217.194.0-255,2902,62783,9,194789
5067,0.000507,172.217.194.0-255,4472,67255,9,194789
5068,0.000516,172.217.194.0-255,7156,74411,9,194789
5069,0.000526,172.217.194.0-255,1484,75895,9,194789
5070,0.000533,172.217.194.0-255,5738,81633,9,194789
5071,0.00055,172.217.194.0-255,4320,85953,9,194789
5072,0.000584,172.217.194.0-255,4320,90273,9,194789
5073,0.000665,172.31.36.0-255,66,90339,9,194789
5074,0.000746,172.217.194.0-255,1484,91823,9,194789
5075,0.000761,172.217.194.0-255,2902,94725,9,194789
5076,0.000782,172.217.194.0-255,5738,100463,9,194789
5077,0.000789,172.217.194.0-255,5738,106201,9,194789
5078,0.000801,172.217.194.0-255,1484,107685,9,194789
5079,0.000805,172.31.36.0-255,66,107751,9,194789
5080,0.000848,172.217.194.0-255,1484,109235,9,194789
5081,0.000852,172.217.194.0-255,2184,111419,9,194789
5082,0.000855,172.31.36.0-255,66,111485,9,194789
5083,0.000861,172.31.36.0-255,66,111551,9,194789
5084,0.001481,172.217.194.0-255,1484,113035,9,194789
5085,0.001498,172.217.194.0-255,2902,115937,9,194789
5086,0.001503,172.31.36.0-255,66,116003,9,194789
5087,0.00151,172.217.194.0-255,5738,121741,9,194789
5088,0.001545,172.217.194.0-255,1484,123225,9,194789
5089,0.001585,172.217.194.0-255,4320,127545,9,194789
5090,0.001588,172.31.36.0-255,66,127611,9,194789
5091,0.001594,172.31.36.0-255,66,127677,9,194789
5092,0.001647,172.31.36.0-255,66,127743,9,194789
5093,0.001659,172.217.194.0-255,2902,130645,9,194789
5094,0.001688,172.31.36.0-255,66,130711,9,194789
5095,0.001702,172.217.194.0-255,7156,137867,9,194789
5096,0.001707,172.31.36.0-255,66,137933,9,194789
5097,0.00174,172.217.194.0-255,5020,142953,9,194789
5098,0.001757,172.217.194.0-255,1484,144437,9,194789
5099,0.001761,172.217.194.0-255,2902,147339,9,194789
5100,0.001767,172.217.194.0-255,5738,153077,9,194789
5101,0.001781,172.217.194.0-255,1484,154561,9,194789
5102,0.001784,172.31.36.0-255,66,154627,9,194789
5103,0.001829,172.31.36.0-255,66,154693,9,194789
5104,0.001848,172.217.194.0-255,2902,157595,9,194789
5105,0.001868,172.217.194.0-255,7156,164751,9,194789
5106,0.00187,172.217.194.0-255,1484,166235,9,194789
5107,0.001891,172.217.194.0-255,7156,173391,9,194789
5108,0.001894,172.31.36.0-255,66,173457,9,194789
5109,0.0019,172.31.36.0-255,66,173523,9,194789
5110,0.001912,172.217.194.0-255,2902,176425,9,194789
5111,0.001918,172.217.194.0-255,5738,182163,9,194789
5112,0.001947,172.217.194.0-255,7156,189319,9,194789
5113,0.001956,172.31.36.0-255,66,189385,9,194789
5114,0.002046,172.217.194.0-255,1484,190869,9,194789
5115,0.002071,172.217.194.0-255,3644,194513,9,194789
5116,0.002073,172.217.194.0-255,105,194618,9,194789
5117,0.004609,172.31.36.0-255,66,194684,9,194789
5118,0.008939,172.31.36.0-255,105,194789,9,194789
5119,0.0,74.125.24.0-255,153,153,9,237294
5120,2.1e-05,172.31.36.0-255,66,219,9,237294
5121,2.7e-05,74.125.24.0-255,1484,1703,9,237294
5122,3.1e-05,172.31.36.0-255,66,1769,9,237294
5123,3.7e-05,74.125.24.0-255,2902,4671,9,237294
5124,3.9e-05,172.31.36.0-255,66,4737,9,237294
5125,4.5e-05,74.125.24.0-255,5738,10475,9,237294
5126,4.8e-05,172.31.36.0-255,66,10541,9,237294
5127,5.3e-05,74.125.24.0-255,4320,14861,9,237294
5128,5.5e-05,172.31.36.0-255,66,14927,9,237294
5129,7.4e-05,74.125.24.0-255,6283,21210,9,237294
5130,7.7e-05,172.31.36.0-255,66,21276,9,237294
5131,8.9e-05,172.31.36.0-255,66,21342,9,237294
5132,0.000118,74.125.24.0-255,2902,24244,9,237294
5133,0.00012,172.31.36.0-255,66,24310,9,237294
5134,0.000135,74.125.24.0-255,4320,28630,9,237294
5135,0.000137,172.31.36.0-255,66,28696,9,237294
5136,0.00014,74.125.24.0-255,1484,30180,9,237294
5137,0.000142,172.31.36.0-255,66,30246,9,237294
5138,0.000173,74.125.24.0-255,7156,37402,9,237294
5139,0.000177,172.31.36.0-255,66,37468,9,237294
5140,0.000181,74.125.24.0-255,1125,38593,9,237294
5141,0.000183,172.31.36.0-255,66,38659,9,237294
5142,0.000186,74.125.24.0-255,1484,40143,9,237294
5143,0.000188,172.31.36.0-255,66,40209,9,237294
5144,0.000229,74.125.24.0-255,4320,44529,9,237294
5145,0.000233,172.31.36.0-255,66,44595,9,237294
5146,0.000243,172.31.36.0-255,66,44661,9,237294
5147,0.000265,74.125.24.0-255,1484,46145,9,237294
5148,0.000268,172.31.36.0-255,66,46211,9,237294
5149,0.000271,74.125.24.0-255,1454,47665,9,237294
5150,0.000303,74.125.24.0-255,348,48013,9,237294
5151,0.000397,74.125.24.0-255,1484,49497,9,237294
5152,0.000404,74.125.24.0-255,2902,52399,9,237294
5153,0.00041,74.125.24.0-255,5738,58137,9,237294
5154,0.000439,74.125.24.0-255,6797,64934,9,237294
5155,0.000503,74.125.24.0-255,4320,69254,9,237294
5156,0.000532,74.125.24.0-255,1994,71248,9,237294
5157,0.000535,74.125.24.0-255,2902,74150,9,237294
5158,0.000589,74.125.24.0-255,1484,75634,9,237294
5159,0.000609,74.125.24.0-255,5738,81372,9,237294
5160,0.000617,172.31.36.0-255,66,81438,9,237294
5161,0.000664,172.31.36.0-255,66,81504,9,237294
5162,0.000927,74.125.24.0-255,1484,82988,9,237294
5163,0.000945,74.125.24.0-255,2902,85890,9,237294
5164,0.00096,74.125.24.0-255,1484,87374,9,237294
5165,0.000964,172.31.36.0-255,66,87440,9,237294
5166,0.000984,74.125.24.0-255,2902,90342,9,237294
5167,0.000986,172.31.36.0-255,66,90408,9,237294
5168,0.001013,74.125.24.0-255,2902,93310,9,237294
5169,0.001029,172.31.36.0-255,66,93376,9,237294
5170,0.001035,74.125.24.0-255,5738,99114,9,237294
5171,0.00104,172.31.36.0-255,66,99180,9,237294
5172,0.001051,74.125.24.0-255,4320,103500,9,237294
5173,0.001067,74.125.24.0-255,1484,104984,9,237294
5174,0.001077,172.31.36.0-255,66,105050,9,237294
5175,0.00109,74.125.24.0-255,7156,112206,9,237294
5176,0.001095,172.31.36.0-255,66,112272,9,237294
5177,0.001106,74.125.24.0-255,3602,115874,9,237294
5178,0.001108,74.125.24.0-255,1484,117358,9,237294
5179,0.001125,74.125.24.0-255,2902,120260,9,237294
5180,0.001142,74.125.24.0-255,2902,123162,9,237294
5181,0.001146,172.31.36.0-255,66,123228,9,237294
5182,0.001155,74.125.24.0-255,2902,126130,9,237294
5183,0.001175,74.125.24.0-255,1484,127614,9,237294
5184,0.001187,74.125.24.0-255,2902,130516,9,237294
5185,0.001192,172.31.36.0-255,66,130582,9,237294
5186,0.001214,74.125.24.0-255,5738,136320,9,237294
5187,0.001218,74.125.24.0-255,2902,139222,9,237294
5188,0.001223,172.31.36.0-255,66,139288,9,237294
5189,0.001244,74.125.24.0-255,2184,141472,9,237294
5190,0.001264,172.31.36.0-255,66,141538,9,237294
5191,0.001362,74.125.24.0-255,1484,143022,9,237294
5192,0.001367,74.125.24.0-255,2902,145924,9,237294
5193,0.001369,74.125.24.0-255,1484,147408,9,237294
5194,0.001376,172.31.36.0-255,66,147474,9,237294
5195,0.001383,74.125.24.0-255,1484,148958,9,237294
5196,0.001387,74.125.24.0-255,4320,153278,9,237294
5197,0.001402,74.125.24.0-255,2902,156180,9,237294
5198,0.001412,172.31.36.0-255,66,156246,9,237294
5199,0.001422,74.125.24.0-255,5738,161984,9,237294
5200,0.001428,172.31.36.0-255,66,162050,9,237294
5201,0.001437,74.125.24.0-255,2902,164952,9,237294
5202,0.001451,74.125.24.0-255,2902,167854,9,237294
5203,0.001469,74.125.24.0-255,7156,175010,9,237294
5204,0.001471,74.125.24.0-255,766,175776,9,237294
5205,0.001474,172.31.36.0-255,66,175842,9,237294
5206,0.001478,172.31.36.0-255,66,175908,9,237294
5207,0.001656,74.125.24.0-255,1484,177392,9,237294
5208,0.001704,74.125.24.0-255,2902,180294,9,237294
5209,0.001708,172.31.36.0-255,66,180360,9,237294
5210,0.001712,74.125.24.0-255,1484,181844,9,237294
5211,0.001732,74.125.24.0-255,2902,184746,9,237294
5212,0.001739,74.125.24.0-255,7156,191902,9,237294
5213,0.001752,74.125.24.0-255,1484,193386,9,237294
5214,0.001757,172.31.36.0-255,66,193452,9,237294
5215,0.001777,74.125.24.0-255,4320,197772,9,237294
5216,0.001805,172.31.36.0-255,66,197838,9,237294
5217,0.001809,172.31.36.0-255,66,197904,9,237294
5218,0.001874,74.125.24.0-255,3602,201506,9,237294
5219,0.001939,172.31.36.0-255,66,201572,9,237294
5220,0.001949,74.125.24.0-255,1484,203056,9,237294
5221,0.001953,74.125.24.0-255,2902,205958,9,237294
5222,0.001965,74.125.24.0-255,2902,208860,9,237294
5223,0.001969,172.31.36.0-255,66,208926,9,237294
5224,0.001977,74.125.24.0-255,2902,211828,9,237294
5225,0.002009,74.125.24.0-255,5738,217566,9,237294
5226,0.002016,74.125.24.0-255,4320,221886,9,237294
5227,0.002032,74.125.24.0-255,2902,224788,9,237294
5228,0.002038,172.31.36.0-255,66,224854,9,237294
5229,0.002072,74.125.24.0-255,766,225620,9,237294
5230,0.002091,172.31.36.0-255,66,225686,9,237294
5231,0.00431,74.125.24.0-255,5738,231424,9,237294
5232,0.004324,172.31.36.0-255,66,231490,9,237294
5233,0.006521,74.125.24.0-255,5738,237228,9,237294
5234,0.008852,172.31.36.0-255,66,237294,9,237294
5235,0.0,172.217.194.0-255,232,232,9,206602
5236,3.1e-05,172.217.194.0-255,1484,1716,9,206602
5237,4.2e-05,172.31.36.0-255,66,1782,9,206602
5238,5e-05,172.217.194.0-255,4320,6102,9,206602
5239,5.4e-05,172.31.36.0-255,66,6168,9,206602
5240,5.9e-05,172.217.194.0-255,2902,9070,9,206602
5241,6.2e-05,172.31.36.0-255,66,9136,9,206602
5242,8.7e-05,172.217.194.0-255,4837,13973,9,206602
5243,9.2e-05,172.31.36.0-255,66,14039,9,206602
5244,0.000109,172.217.194.0-255,1484,15523,9,206602
5245,0.00013,172.217.194.0-255,2902,18425,9,206602
5246,0.000134,172.31.36.0-255,66,18491,9,206602
5247,0.00014,172.217.194.0-255,5738,24229,9,206602
5248,0.000142,172.31.36.0-255,66,24295,9,206602
5249,0.000172,172.217.194.0-255,6797,31092,9,206602
5250,0.000175,172.31.36.0-255,66,31158,9,206602
5251,0.000281,172.217.194.0-255,1484,32642,9,206602
5252,0.000299,172.217.194.0-255,2902,35544,9,206602
5253,0.000302,172.31.36.0-255,66,35610,9,206602
5254,0.000307,172.217.194.0-255,2902,38512,9,206602
5255,0.000309,172.31.36.0-255,66,38578,9,206602
5256,0.000323,172.217.194.0-255,2902,41480,9,206602
5257,0.000326,172.31.36.0-255,66,41546,9,206602
5258,0.000333,172.217.194.0-255,5738,47284,9,206602
5259,0.000335,172.31.36.0-255,66,47350,9,206602
5260,0.000357,172.217.194.0-255,1125,48475,9,206602
5261,0.000374,172.31.36.0-255,66,48541,9,206602
5262,0.000378,172.217.194.0-255,2855,51396,9,206602
5263,0.00038,172.31.36.0-255,66,51462,9,206602
5264,0.000516,172.217.194.0-255,365,51827,9,206602
5265,0.000628,172.217.194.0-255,1484,53311,9,206602
5266,0.000632,172.31.36.0-255,66,53377,9,206602
5267,0.000639,172.217.194.0-255,2902,56279,9,206602
5268,0.000641,172.31.36.0-255,66,56345,9,206602
5269,0.000645,172.217.194.0-255,1484,57829,9,206602
5270,0.000666,172.217.194.0-255,4320,62149,9,206602
5271,0.00067,172.31.36.0-255,66,62215,9,206602
5272,0.000702,172.31.36.0-255,66,62281,9,206602
5273,0.000759,172.31.36.0-255,66,62347,9,206602
5274,0.000868,172.217.194.0-255,1484,63831,9,206602
5275,0.000873,172.217.194.0-255,2902,66733,9,206602
5276,0.000876,172.31.36.0-255,66,66799,9,206602
5277,0.000883,172.217.194.0-255,4320,71119,9,206602
5278,0.000887,172.31.36.0-255,66,71185,9,206602
5279,0.000897,172.217.194.0-255,1484,72669,9,206602
5280,0.00091,172.217.194.0-255,4320,76989,9,206602
5281,0.000913,172.31.36.0-255,66,77055,9,206602
5282,0.000928,172.217.194.0-255,4320,81375,9,206602
5283,0.00093,172.31.36.0-255,66,81441,9,206602
5284,0.00096,172.217.194.0-255,1484,82925,9,206602
5285,0.000974,172.31.36.0-255,66,82991,9,206602
5286,0.001158,172.31.36.0-255,101,83092,9,206602
5287,0.001476,172.217.194.0-255,1484,84576,9,206602
5288,0.001485,172.217.194.0-255,2902,87478,9,206602
5289,0.001489,172.31.36.0-255,66,87544,9,206602
5290,0.001513,172.217.194.0-255,5738,93282,9,206602
5291,0.001516,172.31.36.0-255,66,93348,9,206602
5292,0.00154,172.217.194.0-255,7156,100504,9,206602
5293,0.001542,172.31.36.0-255,66,100570,9,206602
5294,0.001567,172.217.194.0-255,5738,106308,9,206602
5295,0.001571,172.31.36.0-255,66,106374,9,206602
5296,0.001585,172.31.36.0-255,66,106440,9,206602
5297,0.001756,172.217.194.0-255,1484,107924,9,206602
5298,0.001761,172.217.194.0-255,2902,110826,9,206602
5299,0.001773,172.31.36.0-255,66,110892,9,206602
5300,0.001781,172.217.194.0-255,5738,116630,9,206602
5301,0.001784,172.31.36.0-255,66,116696,9,206602
5302,0.001805,172.217.194.0-255,5738,122434,9,206602
5303,0.00181,172.31.36.0-255,66,122500,9,206602
5304,0.001837,172.217.194.0-255,4320,126820,9,206602
5305,0.001841,172.31.36.0-255,66,126886,9,206602
5306,0.001853,172.31.36.0-255,66,126952,9,206602
5307,0.001859,172.217.194.0-255,4320,131272,9,206602
5308,0.00188,172.31.36.0-255,66,131338,9,206602
5309,0.00191,172.217.194.0-255,2184,133522,9,206602
5310,0.001914,172.31.36.0-255,66,133588,9,206602
5311,0.001922,172.217.194.0-255,7156,140744,9,206602
5312,0.001925,172.31.36.0-255,66,140810,9,206602
5313,0.001939,172.31.36.0-255,66,140876,9,206602
5314,0.001947,172.217.194.0-255,6438,147314,9,206602
5315,0.001951,172.31.36.0-255,66,147380,9,206602
5316,0.001968,172.217.194.0-255,5738,153118,9,206602
5317,0.001972,172.31.36.0-255,66,153184,9,206602
5318,0.002026,172.31.36.0-255,66,153250,9,206602
5319,0.00204,172.31.36.0-255,66,153316,9,206602
5320,0.002063,172.217.194.0-255,1484,154800,9,206602
5321,0.002106,172.217.194.0-255,1484,156284,9,206602
5322,0.00211,172.31.36.0-255,66,156350,9,206602
5323,0.00213,172.217.194.0-255,1484,157834,9,206602
5324,0.002138,172.217.194.0-255,5738,163572,9,206602
5325,0.002142,172.31.36.0-255,66,163638,9,206602
5326,0.002146,172.217.194.0-255,2902,166540,9,206602
5327,0.002149,172.31.36.0-255,66,166606,9,206602
5328,0.002161,172.31.36.0-255,66,166672,9,206602
5329,0.002166,172.217.194.0-255,4320,170992,9,206602
5330,0.002169,172.31.36.0-255,66,171058,9,206602
5331,0.002205,172.217.194.0-255,6438,177496,9,206602
5332,0.002209,172.31.36.0-255,66,177562,9,206602
5333,0.002222,172.31.36.0-255,66,177628,9,206602
5334,0.002239,172.31.36.0-255,66,177694,9,206602
5335,0.002275,172.217.194.0-255,7156,184850,9,206602
5336,0.002279,172.31.36.0-255,66,184916,9,206602
5337,0.002313,172.31.36.0-255,66,184982,9,206602
5338,0.002319,172.217.194.0-255,5738,190720,9,206602
5339,0.002322,172.31.36.0-255,66,190786,9,206602
5340,0.002347,172.31.36.0-255,66,190852,9,206602
5341,0.002362,172.217.194.0-255,3602,194454,9,206602
5342,0.002365,172.31.36.0-255,66,194520,9,206602
5343,0.002373,172.217.194.0-255,7156,201676,9,206602
5344,0.002376,172.31.36.0-255,66,201742,9,206602
5345,0.002419,172.31.36.0-255,66,201808,9,206602
5346,0.002424,172.217.194.0-255,4320,206128,9,206602
5347,0.002427,172.31.36.0-255,66,206194,9,206602
5348,0.00247,172.31.36.0-255,66,206260,9,206602
5349,0.002473,172.217.194.0-255,105,206365,9,206602
5350,0.00347,172.217.194.0-255,66,206431,9,206602
5351,0.004417,172.31.36.0-255,105,206536,9,206602
5352,0.006723,172.217.194.0-255,66,206602,9,206602
5353,0.0,74.125.68.0-255,153,153,9,288319
5354,1.6e-05,172.31.36.0-255,66,219,9,288319
5355,2.2e-05,74.125.68.0-255,1484,1703,9,288319
5356,2.5e-05,172.31.36.0-255,66,1769,9,288319
5357,5.4e-05,74.125.68.0-255,2902,4671,9,288319
5358,5.7e-05,172.31.36.0-255,66,4737,9,288319
5359,6.4e-05,74.125.68.0-255,5738,10475,9,288319
5360,6.6e-05,172.31.36.0-255,66,10541,9,288319
5361,8.9e-05,74.125.68.0-255,3464,14005,9,288319
5362,9.2e-05,172.31.36.0-255,66,14071,9,288319
5363,0.000143,74.125.68.0-255,1484,15555,9,288319
5364,0.000147,172.31.36.0-255,66,15621,9,288319
5365,0.000151,74.125.68.0-255,2902,18523,9,288319
5366,0.000153,172.31.36.0-255,66,18589,9,288319
5367,0.000198,74.125.68.0-255,5738,24327,9,288319
5368,0.000201,172.31.36.0-255,66,24393,9,288319
5369,0.000221,74.125.68.0-255,5738,30131,9,288319
5370,0.000224,172.31.36.0-255,66,30197,9,288319
5371,0.000242,74.125.68.0-255,1125,31322,9,288319
5372,0.000245,172.31.36.0-255,66,31388,9,288319
5373,0.000278,74.125.68.0-255,7156,38544,9,288319
5374,0.000282,172.31.36.0-255,66,38610,9,288319
5375,0.000289,74.125.68.0-255,5738,44348,9,288319
5376,0.000291,172.31.36.0-255,66,44414,9,288319
5377,0.000335,74.125.68.0-255,3961,48375,9,288319
5378,0.000339,172.31.36.0-255,66,48441,9,288319
5379,0.000373,74.125.68.0-255,4320,52761,9,288319
5380,0.000376,172.31.36.0-255,66,52827,9,288319
5381,0.00038,74.125.68.0-255,1484,54311,9,288319
5382,0.000381,172.31.36.0-255,66,54377,9,288319
5383,0.000401,74.125.68.0-255,4320,58697,9,288319
5384,0.000404,172.31.36.0-255,66,58763,9,288319
5385,0.000411,74.125.68.0-255,6797,65560,9,288319
5386,0.000417,172.31.36.0-255,66,65626,9,288319
5387,0.00043,74.125.68.0-255,401,66027,9,288319
5388,0.000457,74.125.68.0-255,342,66369,9,288319
5389,0.00054,74.125.68.0-255,1484,67853,9,288319
5390,0.000544,172.31.36.0-255,66,67919,9,288319
5391,0.00056,74.125.68.0-255,2902,70821,9,288319
5392,0.000563,172.31.36.0-255,66,70887,9,288319
5393,0.000569,74.125.68.0-255,4320,75207,9,288319
5394,0.000571,172.31.36.0-255,66,75273,9,288319
5395,0.000583,74.125.68.0-255,1484,76757,9,288319
5396,0.000588,74.125.68.0-255,2902,79659,9,288319
5397,0.00059,172.31.36.0-255,66,79725,9,288319
5398,0.000602,74.125.68.0-255,2902,82627,9,288319
5399,0.000604,172.31.36.0-255,66,82693,9,288319
5400,0.000632,74.125.68.0-255,6797,89490,9,288319
5401,0.000639,172.31.36.0-255,66,89556,9,288319
5402,0.000658,172.31.36.0-255,66,89622,9,288319
5403,0.000681,74.125.68.0-255,2543,92165,9,288319
5404,0.000684,172.31.36.0-255,66,92231,9,288319
5405,0.000854,74.125.68.0-255,1484,93715,9,288319
5406,0.000872,74.125.68.0-255,2902,96617,9,288319
5407,0.000876,172.31.36.0-255,66,96683,9,288319
5408,0.000881,74.125.68.0-255,2902,99585,9,288319
5409,0.000883,172.31.36.0-255,66,99651,9,288319
5410,0.000898,74.125.68.0-255,2902,102553,9,288319
5411,0.0009,172.31.36.0-255,66,102619,9,288319
5412,0.000905,74.125.68.0-255,2902,105521,9,288319
5413,0.000907,172.31.36.0-255,66,105587,9,288319
5414,0.000912,74.125.68.0-255,4320,109907,9,288319
5415,0.000915,172.31.36.0-255,66,109973,9,288319
5416,0.000958,172.31.36.0-255,66,110039,9,288319
5417,0.000963,74.125.68.0-255,2902,112941,9,288319
5418,0.000965,172.31.36.0-255,66,113007,9,288319
5419,0.000999,74.125.68.0-255,2902,115909,9,288319
5420,0.001002,172.31.36.0-255,66,115975,9,288319
5421,0.001019,74.125.68.0-255,2184,118159,9,288319
5422,0.001022,172.31.36.0-255,66,118225,9,288319
5423,0.001451,74.125.68.0-255,1484,119709,9,288319
5424,0.00146,74.125.68.0-255,2902,122611,9,288319
5425,0.001464,172.31.36.0-255,66,122677,9,288319
5426,0.001468,74.125.68.0-255,1484,124161,9,288319
5427,0.001486,74.125.68.0-255,2902,127063,9,288319
5428,0.001488,172.31.36.0-255,66,127129,9,288319
5429,0.001509,74.125.68.0-255,5738,132867,9,288319
5430,0.001511,172.31.36.0-255,66,132933,9,288319
5431,0.00153,74.125.68.0-255,2902,135835,9,288319
5432,0.001533,172.31.36.0-255,66,135901,9,288319
5433,0.001556,74.125.68.0-255,7156,143057,9,288319
5434,0.001559,172.31.36.0-255,66,143123,9,288319
5435,0.001576,74.125.68.0-255,1484,144607,9,288319
5436,0.001605,172.31.36.0-255,66,144673,9,288319
5437,0.001672,74.125.68.0-255,1484,146157,9,288319
5438,0.001679,74.125.68.0-255,2902,149059,9,288319
5439,0.001681,172.31.36.0-255,66,149125,9,288319
5440,0.001702,74.125.68.0-255,5738,154863,9,288319
5441,0.001705,172.31.36.0-255,66,154929,9,288319
5442,0.001734,74.125.68.0-255,5738,160667,9,288319
5443,0.001737,172.31.36.0-255,66,160733,9,288319
5444,0.001758,74.125.68.0-255,4320,165053,9,288319
5445,0.001761,172.31.36.0-255,66,165119,9,288319
5446,0.001775,74.125.68.0-255,2184,167303,9,288319
5447,0.001897,74.125.68.0-255,1484,168787,9,288319
5448,0.001919,74.125.68.0-255,2902,171689,9,288319
5449,0.001941,74.125.68.0-255,5738,177427,9,288319
5450,0.001953,74.125.68.0-255,2902,180329,9,288319
5451,0.001967,74.125.68.0-255,4320,184649,9,288319
5452,0.001984,74.125.68.0-255,4320,188969,9,288319
5453,0.002001,74.125.68.0-255,7156,196125,9,288319
5454,0.002058,74.125.68.0-255,5020,201145,9,288319
5455,0.00216,74.125.68.0-255,1484,202629,9,288319
5456,0.002167,74.125.68.0-255,2902,205531,9,288319
5457,0.002186,74.125.68.0-255,2902,208433,9,288319
5458,0.002199,74.125.68.0-255,2902,211335,9,288319
5459,0.002216,74.125.68.0-255,1484,212819,9,288319
5460,0.002228,74.125.68.0-255,5738,218557,9,288319
5461,0.002247,74.125.68.0-255,2902,221459,9,288319
5462,0.002253,74.125.68.0-255,4320,225779,9,288319
5463,0.002274,74.125.68.0-255,1484,227263,9,288319
5464,0.002281,74.125.68.0-255,7156,234419,9,288319
5465,0.002284,74.125.68.0-255,766,235185,9,288319
5466,0.002286,74.125.68.0-255,1484,236669,9,288319
5467,0.002303,74.125.68.0-255,4320,240989,9,288319
5468,0.002334,74.125.68.0-255,1484,242473,9,288319
5469,0.002352,74.125.68.0-255,7156,249629,9,288319
5470,0.002374,74.125.68.0-255,1484,251113,9,288319
5471,0.002395,74.125.68.0-255,1484,252597,9,288319
5472,0.002398,74.125.68.0-255,2902,255499,9,288319
5473,0.002438,74.125.68.0-255,1484,256983,9,288319
5474,0.002457,74.125.68.0-255,3602,260585,9,288319
5475,0.002488,74.125.68.0-255,2902,263487,9,288319
5476,0.0025,74.125.68.0-255,1484,264971,9,288319
5477,0.002515,74.125.68.0-255,1484,266455,9,288319
5478,0.002528,74.125.68.0-255,4320,270775,9,288319
5479,0.002539,74.125.68.0-255,2902,273677,9,288319
5480,0.00255,74.125.68.0-255,1484,275161,9,288319
5481,0.002552,74.125.68.0-255,1484,276645,9,288319
5482,0.003383,172.31.36.0-255,66,276711,9,288319
5483,0.00593,74.125.68.0-255,5738,282449,9,288319
5484,0.005937,172.31.36.0-255,66,282515,9,288319
5485,0.00847,74.125.68.0-255,5738,288253,9,288319
5486,0.008475,172.31.36.0-255,66,288319,9,288319
5487,0.0,74.125.68.0-255,152,152,9,201117
5488,1.8e-05,172.31.36.0-255,66,218,9,201117
5489,2.5e-05,74.125.68.0-255,1484,1702,9,201117
5490,3e-05,172.31.36.0-255,66,1768,9,201117
5491,3.5e-05,74.125.68.0-255,2902,4670,9,201117
5492,3.9e-05,172.31.36.0-255,66,4736,9,201117
5493,4.5e-05,74.125.68.0-255,5738,10474,9,201117
5494,4.9e-05,172.31.36.0-255,66,10540,9,201117
5495,5.5e-05,74.125.68.0-255,3428,13968,9,201117
5496,5.8e-05,172.31.36.0-255,66,14034,9,201117
5497,0.000175,74.125.68.0-255,1484,15518,9,201117
5498,0.000179,172.31.36.0-255,66,15584,9,201117
5499,0.000184,74.125.68.0-255,2902,18486,9,201117
5500,0.000187,172.31.36.0-255,66,18552,9,201117
5501,0.000217,74.125.68.0-255,5738,24290,9,201117
5502,0.000221,172.31.36.0-255,66,24356,9,201117
5503,0.000229,74.125.68.0-255,6797,31153,9,201117
5504,0.000231,172.31.36.0-255,66,31219,9,201117
5505,0.00025,74.125.68.0-255,1484,32703,9,201117
5506,0.000252,172.31.36.0-255,66,32769,9,201117
5507,0.000276,74.125.68.0-255,2902,35671,9,201117
5508,0.000278,172.31.36.0-255,66,35737,9,201117
5509,0.000285,74.125.68.0-255,5738,41475,9,201117
5510,0.000287,172.31.36.0-255,66,41541,9,201117
5511,0.000309,74.125.68.0-255,6797,48338,9,201117
5512,0.000311,172.31.36.0-255,66,48404,9,201117
5513,0.000401,74.125.68.0-255,1484,49888,9,201117
5514,0.000404,172.31.36.0-255,66,49954,9,201117
5515,0.000409,74.125.68.0-255,2902,52856,9,201117
5516,0.000412,172.31.36.0-255,66,52922,9,201117
5517,0.000433,74.125.68.0-255,2902,55824,9,201117
5518,0.000436,172.31.36.0-255,66,55890,9,201117
5519,0.000456,74.125.68.0-255,2902,58792,9,201117
5520,0.000459,172.31.36.0-255,66,58858,9,201117
5521,0.000466,74.125.68.0-255,5738,64596,9,201117
5522,0.000468,172.31.36.0-255,66,64662,9,201117
5523,0.0005,74.125.68.0-255,1435,66097,9,201117
5524,0.000531,74.125.68.0-255,113,66210,9,201117
5525,0.000713,74.125.68.0-255,329,66539,9,201117
5526,0.000718,172.31.36.0-255,66,66605,9,201117
5527,0.000985,74.125.68.0-255,1484,68089,9,201117
5528,0.000991,74.125.68.0-255,2902,70991,9,201117
5529,0.000995,172.31.36.0-255,66,71057,9,201117
5530,0.001018,74.125.68.0-255,5738,76795,9,201117
5531,0.001021,172.31.36.0-255,66,76861,9,201117
5532,0.001025,74.125.68.0-255,1484,78345,9,201117
5533,0.001042,74.125.68.0-255,5738,84083,9,201117
5534,0.001045,172.31.36.0-255,66,84149,9,201117
5535,0.001069,74.125.68.0-255,5738,89887,9,201117
5536,0.001071,172.31.36.0-255,66,89953,9,201117
5537,0.001098,172.31.36.0-255,66,90019,9,201117
5538,0.001111,74.125.68.0-255,2184,92203,9,201117
5539,0.001114,172.31.36.0-255,66,92269,9,201117
5540,0.001363,74.125.68.0-255,1484,93753,9,201117
5541,0.001369,74.125.68.0-255,2902,96655,9,201117
5542,0.001373,172.31.36.0-255,66,96721,9,201117
5543,0.001377,74.125.68.0-255,1484,98205,9,201117
5544,0.001396,74.125.68.0-255,4320,102525,9,201117
5545,0.001399,172.31.36.0-255,66,102591,9,201117
5546,0.001416,74.125.68.0-255,5738,108329,9,201117
5547,0.001418,172.31.36.0-255,66,108395,9,201117
5548,0.001451,74.125.68.0-255,7156,115551,9,201117
5549,0.001454,172.31.36.0-255,66,115617,9,201117
5550,0.00146,74.125.68.0-255,4320,119937,9,201117
5551,0.001462,172.31.36.0-255,66,120003,9,201117
5552,0.00148,74.125.68.0-255,6438,126441,9,201117
5553,0.001482,172.31.36.0-255,66,126507,9,201117
5554,0.001692,74.125.68.0-255,1484,127991,9,201117
5555,0.001698,74.125.68.0-255,2902,130893,9,201117
5556,0.001702,172.31.36.0-255,66,130959,9,201117
5557,0.001726,74.125.68.0-255,5738,136697,9,201117
5558,0.001729,74.125.68.0-255,1484,138181,9,201117
5559,0.001733,172.31.36.0-255,66,138247,9,201117
5560,0.001743,74.125.68.0-255,2902,141149,9,201117
5561,0.001745,172.31.36.0-255,66,141215,9,201117
5562,0.001765,74.125.68.0-255,5738,146953,9,201117
5563,0.001767,172.31.36.0-255,66,147019,9,201117
5564,0.00178,74.125.68.0-255,1484,148503,9,201117
5565,0.001797,74.125.68.0-255,7156,155659,9,201117
5566,0.0018,172.31.36.0-255,66,155725,9,201117
5567,0.001821,74.125.68.0-255,5020,160745,9,201117
5568,0.001824,172.31.36.0-255,66,160811,9,201117
5569,0.001851,74.125.68.0-255,1484,162295,9,201117
5570,0.001867,74.125.68.0-255,2902,165197,9,201117
5571,0.00187,172.31.36.0-255,66,165263,9,201117
5572,0.001875,74.125.68.0-255,2902,168165,9,201117
5573,0.001878,172.31.36.0-255,66,168231,9,201117
5574,0.001891,74.125.68.0-255,1484,169715,9,201117
5575,0.00191,74.125.68.0-255,5738,175453,9,201117
5576,0.001914,172.31.36.0-255,66,175519,9,201117
5577,0.001954,172.31.36.0-255,66,175585,9,201117
5578,0.001959,74.125.68.0-255,4320,179905,9,201117
5579,0.001962,172.31.36.0-255,66,179971,9,201117
5580,0.001985,74.125.68.0-255,3602,183573,9,201117
5581,0.001987,172.31.36.0-255,66,183639,9,201117
5582,0.003948,74.125.68.0-255,1484,185123,9,201117
5583,0.003977,74.125.68.0-255,4320,189443,9,201117
5584,0.003982,172.31.36.0-255,66,189509,9,201117
5585,0.00599,74.125.68.0-255,5738,195247,9,201117
5586,0.005994,172.31.36.0-255,66,195313,9,201117
5587,0.007989,74.125.68.0-255,5738,201051,9,201117
5588,0.007995,172.31.36.0-255,66,201117,9,201117
5589,0.0,74.125.68.0-255,147,147,9,228559
5590,2.9e-05,172.31.36.0-255,66,213,9,228559
5591,3.6e-05,74.125.68.0-255,1484,1697,9,228559
5592,4.1e-05,172.31.36.0-255,66,1763,9,228559
5593,4.6e-05,74.125.68.0-255,2902,4665,9,228559
5594,4.8e-05,172.31.36.0-255,66,4731,9,228559
5595,7.3e-05,74.125.68.0-255,5738,10469,9,228559
5596,7.6e-05,172.31.36.0-255,66,10535,9,228559
5597,7.8e-05,74.125.68.0-255,1484,12019,9,228559
5598,8e-05,172.31.36.0-255,66,12085,9,228559
5599,0.000109,74.125.68.0-255,3493,15578,9,228559
5600,0.000112,172.31.36.0-255,66,15644,9,228559
5601,0.000118,74.125.68.0-255,5738,21382,9,228559
5602,0.00012,172.31.36.0-255,66,21448,9,228559
5603,0.000134,74.125.68.0-255,1484,22932,9,228559
5604,0.000137,172.31.36.0-255,66,22998,9,228559
5605,0.000153,74.125.68.0-255,7156,30154,9,228559
5606,0.000155,172.31.36.0-255,66,30220,9,228559
5607,0.000175,74.125.68.0-255,1125,31345,9,228559
5608,0.000177,172.31.36.0-255,66,31411,9,228559
5609,0.000218,74.125.68.0-255,1484,32895,9,228559
5610,0.000221,172.31.36.0-255,66,32961,9,228559
5611,0.000236,74.125.68.0-255,2902,35863,9,228559
5612,0.000238,172.31.36.0-255,66,35929,9,228559
5613,0.000262,74.125.68.0-255,4320,40249,9,228559
5614,0.000266,172.31.36.0-255,66,40315,9,228559
5615,0.000284,74.125.68.0-255,1484,41799,9,228559
5616,0.000286,172.31.36.0-255,66,41865,9,228559
5617,0.000292,74.125.68.0-255,4320,46185,9,228559
5618,0.000294,172.31.36.0-255,66,46251,9,228559
5619,0.000309,74.125.68.0-255,2543,48794,9,228559
5620,0.000313,172.31.36.0-255,66,48860,9,228559
5621,0.00032,74.125.68.0-255,7156,56016,9,228559
5622,0.000322,172.31.36.0-255,66,56082,9,228559
5623,0.000325,74.125.68.0-255,1484,57566,9,228559
5624,0.000346,74.125.68.0-255,2902,60468,9,228559
5625,0.000349,172.31.36.0-255,66,60534,9,228559
5626,0.000356,74.125.68.0-255,5379,65913,9,228559
5627,0.000359,172.31.36.0-255,66,65979,9,228559
5628,0.000361,74.125.68.0-255,359,66338,9,228559
5629,0.000399,74.125.68.0-255,384,66722,9,228559
5630,0.000723,74.125.68.0-255,1484,68206,9,228559
5631,0.000727,172.31.36.0-255,66,68272,9,228559
5632,0.000732,74.125.68.0-255,1484,69756,9,228559
5633,0.00075,74.125.68.0-255,1484,71240,9,228559
5634,0.000753,172.31.36.0-255,66,71306,9,228559
5635,0.000758,74.125.68.0-255,4320,75626,9,228559
5636,0.00076,172.31.36.0-255,66,75692,9,228559
5637,0.000767,74.125.68.0-255,5738,81430,9,228559
5638,0.000769,172.31.36.0-255,66,81496,9,228559
5639,0.000793,74.125.68.0-255,2902,84398,9,228559
5640,0.000796,172.31.36.0-255,66,84464,9,228559
5641,0.000807,172.31.36.0-255,66,84530,9,228559
5642,0.000838,74.125.68.0-255,2902,87432,9,228559
5643,0.000841,172.31.36.0-255,66,87498,9,228559
5644,0.000863,74.125.68.0-255,4471,91969,9,228559
5645,0.000866,172.31.36.0-255,66,92035,9,228559
5646,0.00111,74.125.68.0-255,1484,93519,9,228559
5647,0.001119,74.125.68.0-255,2902,96421,9,228559
5648,0.001122,172.31.36.0-255,66,96487,9,228559
5649,0.001141,74.125.68.0-255,5738,102225,9,228559
5650,0.001144,172.31.36.0-255,66,102291,9,228559
5651,0.00115,74.125.68.0-255,2902,105193,9,228559
5652,0.001151,172.31.36.0-255,66,105259,9,228559
5653,0.001168,74.125.68.0-255,1484,106743,9,228559
5654,0.001174,74.125.68.0-255,5738,112481,9,228559
5655,0.001177,172.31.36.0-255,66,112547,9,228559
5656,0.001202,74.125.68.0-255,2902,115449,9,228559
5657,0.001205,172.31.36.0-255,66,115515,9,228559
5658,0.001237,172.31.36.0-255,66,115581,9,228559
5659,0.001241,74.125.68.0-255,2184,117765,9,228559
5660,0.001244,172.31.36.0-255,66,117831,9,228559
5661,0.001807,74.125.68.0-255,1484,119315,9,228559
5662,0.001814,74.125.68.0-255,2902,122217,9,228559
5663,0.001818,172.31.36.0-255,66,122283,9,228559
5664,0.001823,74.125.68.0-255,2902,125185,9,228559
5665,0.001825,172.31.36.0-255,66,125251,9,228559
5666,0.00184,74.125.68.0-255,2902,128153,9,228559
5667,0.001843,172.31.36.0-255,66,128219,9,228559
5668,0.001861,74.125.68.0-255,2902,131121,9,228559
5669,0.001863,172.31.36.0-255,66,131187,9,228559
5670,0.001882,74.125.68.0-255,7156,138343,9,228559
5671,0.001884,172.31.36.0-255,66,138409,9,228559
5672,0.00189,74.125.68.0-255,5738,144147,9,228559
5673,0.001892,172.31.36.0-255,66,144213,9,228559
5674,0.001918,74.125.68.0-255,5738,149951,9,228559
5675,0.00192,172.31.36.0-255,66,150017,9,228559
5676,0.001925,74.125.68.0-255,2184,152201,9,228559
5677,0.001927,172.31.36.0-255,66,152267,9,228559
5678,0.001993,74.125.68.0-255,1484,153751,9,228559
5679,0.002012,74.125.68.0-255,1484,155235,9,228559
5680,0.002015,172.31.36.0-255,66,155301,9,228559
5681,0.002033,74.125.68.0-255,1484,156785,9,228559
5682,0.002038,74.125.68.0-255,4320,161105,9,228559
5683,0.002041,172.31.36.0-255,66,161171,9,228559
5684,0.002098,172.31.36.0-255,66,161237,9,228559
5685,0.002103,74.125.68.0-255,4320,165557,9,228559
5686,0.002105,172.31.36.0-255,66,165623,9,228559
5687,0.00211,74.125.68.0-255,5738,171361,9,228559
5688,0.002112,172.31.36.0-255,66,171427,9,228559
5689,0.002124,74.125.68.0-255,2902,174329,9,228559
5690,0.002126,172.31.36.0-255,66,174395,9,228559
5691,0.002139,74.125.68.0-255,3602,177997,9,228559
5692,0.002141,172.31.36.0-255,66,178063,9,228559
5693,0.002217,74.125.68.0-255,1484,179547,9,228559
5694,0.002231,74.125.68.0-255,2902,182449,9,228559
5695,0.002234,172.31.36.0-255,66,182515,9,228559
5696,0.002238,74.125.68.0-255,2902,185417,9,228559
5697,0.00224,172.31.36.0-255,66,185483,9,228559
5698,0.002251,74.125.68.0-255,2902,188385,9,228559
5699,0.002254,172.31.36.0-255,66,188451,9,228559
5700,0.002269,74.125.68.0-255,1484,189935,9,228559
5701,0.002287,74.125.68.0-255,5738,195673,9,228559
5702,0.00229,172.31.36.0-255,66,195739,9,228559
5703,0.002303,74.125.68.0-255,1484,197223,9,228559
5704,0.002309,74.125.68.0-255,5738,202961,9,228559
5705,0.002312,172.31.36.0-255,66,203027,9,228559
5706,0.002332,74.125.68.0-255,4320,207347,9,228559
5707,0.002334,172.31.36.0-255,66,207413,9,228559
5708,0.002339,74.125.68.0-255,5020,212433,9,228559
5709,0.002341,172.31.36.0-255,66,212499,9,228559
5710,0.004785,74.125.68.0-255,4320,216819,9,228559
5711,0.004789,172.31.36.0-255,66,216885,9,228559
5712,0.004806,74.125.68.0-255,1484,218369,9,228559
5713,0.007232,74.125.68.0-255,4320,222689,9,228559
5714,0.007238,172.31.36.0-255,66,222755,9,228559
5715,0.009908,74.125.68.0-255,5738,228493,9,228559
5716,0.009918,172.31.36.0-255,66,228559,9,228559
5717,0.0,74.125.24.0-255,153,153,9,237036
5718,3e-05,172.31.36.0-255,66,219,9,237036
5719,3.6e-05,74.125.24.0-255,1484,1703,9,237036
5720,4.1e-05,172.31.36.0-255,66,1769,9,237036
5721,4.6e-05,74.125.24.0-255,2902,4671,9,237036
5722,4.9e-05,172.31.36.0-255,66,4737,9,237036
5723,6.4e-05,74.125.24.0-255,7156,11893,9,237036
5724,6.8e-05,172.31.36.0-255,66,11959,9,237036
5725,7.1e-05,74.125.24.0-255,2070,14029,9,237036
5726,7.4e-05,172.31.36.0-255,66,14095,9,237036
5727,0.000226,74.125.24.0-255,1484,15579,9,237036
5728,0.000231,172.31.36.0-255,66,15645,9,237036
5729,0.000236,74.125.24.0-255,2902,18547,9,237036
5730,0.000239,172.31.36.0-255,66,18613,9,237036
5731,0.000243,74.125.24.0-255,2902,21515,9,237036
5732,0.000246,172.31.36.0-255,66,21581,9,237036
5733,0.000286,74.125.24.0-255,2902,24483,9,237036
5734,0.000289,172.31.36.0-255,66,24549,9,237036
5735,0.000296,74.125.24.0-255,6797,31346,9,237036
5736,0.000299,172.31.36.0-255,66,31412,9,237036
5737,0.00049,74.125.24.0-255,1484,32896,9,237036
5738,0.000496,172.31.36.0-255,66,32962,9,237036
5739,0.000501,74.125.24.0-255,2902,35864,9,237036
5740,0.000503,172.31.36.0-255,66,35930,9,237036
5741,0.000538,74.125.24.0-255,5738,41668,9,237036
5742,0.000541,172.31.36.0-255,66,41734,9,237036
5743,0.000549,74.125.24.0-255,7156,48890,9,237036
5744,0.000554,172.31.36.0-255,66,48956,9,237036
5745,0.000575,74.125.24.0-255,3961,52917,9,237036
5746,0.000579,172.31.36.0-255,66,52983,9,237036
5747,0.000592,172.31.36.0-255,66,53049,9,237036
5748,0.000624,74.125.24.0-255,2543,55592,9,237036
5749,0.000627,172.31.36.0-255,66,55658,9,237036
5750,0.000799,74.125.24.0-255,645,56303,9,237036
5751,0.000807,172.31.36.0-255,66,56369,9,237036
5752,0.000953,74.125.24.0-255,1484,57853,9,237036
5753,0.000963,74.125.24.0-255,2902,60755,9,237036
5754,0.000967,172.31.36.0-255,66,60821,9,237036
5755,0.000974,74.125.24.0-255,5738,66559,9,237036
5756,0.000977,172.31.36.0-255,66,66625,9,237036
5757,0.001037,172.31.36.0-255,66,66691,9,237036
5758,0.001043,74.125.24.0-255,4320,71011,9,237036
5759,0.001045,172.31.36.0-255,66,71077,9,237036
5760,0.001077,74.125.24.0-255,6438,77515,9,237036
5761,0.001081,172.31.36.0-255,66,77581,9,237036
5762,0.001424,74.125.24.0-255,1484,79065,9,237036
5763,0.001431,74.125.24.0-255,2902,81967,9,237036
5764,0.001435,172.31.36.0-255,66,82033,9,237036
5765,0.001461,74.125.24.0-255,5738,87771,9,237036
5766,0.001463,172.31.36.0-255,66,87837,9,237036
5767,0.001498,74.125.24.0-255,4320,92157,9,237036
5768,0.001501,172.31.36.0-255,66,92223,9,237036
5769,0.001547,172.31.36.0-255,66,92289,9,237036
5770,0.001556,172.31.36.0-255,66,92355,9,237036
5771,0.00156,74.125.24.0-255,2184,94539,9,237036
5772,0.001563,172.31.36.0-255,66,94605,9,237036
5773,0.002104,74.125.24.0-255,1484,96089,9,237036
5774,0.002118,74.125.24.0-255,2902,98991,9,237036
5775,0.002121,172.31.36.0-255,66,99057,9,237036
5776,0.002134,74.125.24.0-255,4320,103377,9,237036
5777,0.002142,172.31.36.0-255,66,103443,9,237036
5778,0.002174,172.31.36.0-255,66,103509,9,237036
5779,0.00221,74.125.24.0-255,5738,109247,9,237036
5780,0.002212,172.31.36.0-255,66,109313,9,237036
5781,0.002254,172.31.36.0-255,66,109379,9,237036
5782,0.002436,74.125.24.0-255,1484,110863,9,237036
5783,0.00244,74.125.24.0-255,1484,112347,9,237036
5784,0.002442,172.31.36.0-255,66,112413,9,237036
5785,0.002467,74.125.24.0-255,1484,113897,9,237036
5786,0.002474,74.125.24.0-255,5738,119635,9,237036
5787,0.002477,172.31.36.0-255,66,119701,9,237036
5788,0.002482,74.125.24.0-255,5738,125439,9,237036
5789,0.002485,172.31.36.0-255,66,125505,9,237036
5790,0.002523,74.125.24.0-255,7156,132661,9,237036
5791,0.002526,172.31.36.0-255,66,132727,9,237036
5792,0.002542,172.31.36.0-255,66,132793,9,237036
5793,0.002583,172.31.36.0-255,66,132859,9,237036
5794,0.002612,74.125.24.0-255,7156,140015,9,237036
5795,0.002615,172.31.36.0-255,66,140081,9,237036
5796,0.002626,172.31.36.0-255,66,140147,9,237036
5797,0.002628,74.125.24.0-255,1484,141631,9,237036
5798,0.002649,74.125.24.0-255,2902,144533,9,237036
5799,0.002652,172.31.36.0-255,66,144599,9,237036
5800,0.002679,74.125.24.0-255,5738,150337,9,237036
5801,0.002682,172.31.36.0-255,66,150403,9,237036
5802,0.002703,172.31.36.0-255,66,150469,9,237036
5803,0.002728,74.125.24.0-255,1484,151953,9,237036
5804,0.002741,172.31.36.0-255,66,152019,9,237036
5805,0.002807,172.31.36.0-255,66,152085,9,237036
5806,0.002822,172.31.36.0-255,66,152151,9,237036
5807,0.002826,74.125.24.0-255,2902,155053,9,237036
5808,0.002828,172.31.36.0-255,66,155119,9,237036
5809,0.002831,74.125.24.0-255,1484,156603,9,237036
5810,0.002836,74.125.24.0-255,4320,160923,9,237036
5811,0.002838,172.31.36.0-255,66,160989,9,237036
5812,0.002867,74.125.24.0-255,6438,167427,9,237036
5813,0.00287,172.31.36.0-255,66,167493,9,237036
5814,0.002874,74.125.24.0-255,2902,170395,9,237036
5815,0.002876,172.31.36.0-255,66,170461,9,237036
5816,0.002879,74.125.24.0-255,1484,171945,9,237036
5817,0.002903,74.125.24.0-255,1484,173429,9,237036
5818,0.002905,172.31.36.0-255,66,173495,9,237036
5819,0.002937,172.31.36.0-255,66,173561,9,237036
5820,0.002968,172.31.36.0-255,66,173627,9,237036
5821,0.003,172.31.36.0-255,66,173693,9,237036
5822,0.003004,74.125.24.0-255,2902,176595,9,237036
5823,0.003006,172.31.36.0-255,66,176661,9,237036
5824,0.003024,74.125.24.0-255,7156,183817,9,237036
5825,0.003026,172.31.36.0-255,66,183883,9,237036
5826,0.003057,172.31.36.0-255,66,183949,9,237036
5827,0.00306,74.125.24.0-255,1484,185433,9,237036
5828,0.003083,74.125.24.0-255,3602,189035,9,237036
5829,0.003085,172.31.36.0-255,66,189101,9,237036
5830,0.003166,74.125.24.0-255,1484,190585,9,237036
5831,0.003199,74.125.24.0-255,1484,192069,9,237036
5832,0.003201,172.31.36.0-255,66,192135,9,237036
5833,0.003205,74.125.24.0-255,1484,193619,9,237036
5834,0.003223,74.125.24.0-255,1484,195103,9,237036
5835,0.003225,172.31.36.0-255,66,195169,9,237036
5836,0.003256,74.125.24.0-255,2902,198071,9,237036
5837,0.003259,172.31.36.0-255,66,198137,9,237036
5838,0.003286,74.125.24.0-255,4320,202457,9,237036
5839,0.003289,172.31.36.0-255,66,202523,9,237036
5840,0.003292,74.125.24.0-255,1484,204007,9,237036
5841,0.003312,74.125.24.0-255,2902,206909,9,237036
5842,0.003314,172.31.36.0-255,66,206975,9,237036
5843,0.003342,74.125.24.0-255,2902,209877,9,237036
5844,0.003344,172.31.36.0-255,66,209943,9,237036
5845,0.003348,74.125.24.0-255,2902,212845,9,237036
5846,0.00335,172.31.36.0-255,66,212911,9,237036
5847,0.003355,74.125.24.0-255,4320,217231,9,237036
5848,0.003361,172.31.36.0-255,66,217297,9,237036
5849,0.003372,74.125.24.0-255,2902,220199,9,237036
5850,0.003375,172.31.36.0-255,66,220265,9,237036
5851,0.003404,74.125.24.0-255,5020,225285,9,237036
5852,0.00341,172.31.36.0-255,66,225351,9,237036
5853,0.003416,74.125.24.0-255,5738,231089,9,237036
5854,0.003418,172.31.36.0-255,66,231155,9,237036
5855,0.003424,74.125.24.0-255,5710,236865,9,237036
5856,0.003426,172.31.36.0-255,66,236931,9,237036
5857,0.003429,74.125.24.0-255,105,237036,9,237036
5858,0.0,104.244.42.0-255,66,66,9,66
5859,0.0,172.31.36.0-255,105,105,9,459
5860,0.000201,172.31.36.0-255,90,195,9,459
5861,0.000214,172.31.36.0-255,66,261,9,459
5862,0.002541,74.125.130.0-255,66,327,9,459
5863,0.002558,74.125.130.0-255,66,393,9,459
5864,0.002571,172.31.36.0-255,66,459,9,459
5865,0.0,172.217.194.0-255,150,150,9,86465
5866,2.8e-05,172.31.36.0-255,66,216,9,86465
5867,3.5e-05,172.217.194.0-255,1484,1700,9,86465
5868,3.9e-05,172.31.36.0-255,66,1766,9,86465
5869,4.4e-05,172.217.194.0-255,2902,4668,9,86465
5870,4.7e-05,172.31.36.0-255,66,4734,9,86465
5871,5.8e-05,172.217.194.0-255,1484,6218,9,86465
5872,6e-05,172.31.36.0-255,66,6284,9,86465
5873,9.4e-05,172.217.194.0-255,5738,12022,9,86465
5874,9.7e-05,172.31.36.0-255,66,12088,9,86465
5875,0.000101,172.217.194.0-255,2019,14107,9,86465
5876,0.000103,172.31.36.0-255,66,14173,9,86465
5877,0.000142,172.31.36.0-255,66,14239,9,86465
5878,0.000149,172.217.194.0-255,7156,21395,9,86465
5879,0.000152,172.31.36.0-255,66,21461,9,86465
5880,0.000207,172.217.194.0-255,5738,27199,9,86465
5881,0.000211,172.31.36.0-255,66,27265,9,86465
5882,0.000243,172.31.36.0-255,66,27331,9,86465
5883,0.001979,172.217.194.0-255,1484,28815,9,86465
5884,0.001985,172.31.36.0-255,66,28881,9,86465
5885,0.001996,172.217.194.0-255,2902,31783,9,86465
5886,0.002003,172.31.36.0-255,66,31849,9,86465
5887,0.00201,172.217.194.0-255,5738,37587,9,86465
5888,0.002012,172.31.36.0-255,66,37653,9,86465
5889,0.002036,172.217.194.0-255,4320,41973,9,86465
5890,0.002038,172.31.36.0-255,66,42039,9,86465
5891,0.002066,172.217.194.0-255,2834,44873,9,86465
5892,0.002068,172.31.36.0-255,66,44939,9,86465
5893,0.002075,172.217.194.0-255,7156,52095,9,86465
5894,0.002076,172.31.36.0-255,66,52161,9,86465
5895,0.002111,172.217.194.0-255,7156,59317,9,86465
5896,0.002114,172.31.36.0-255,66,59383,9,86465
5897,0.002188,172.31.36.0-255,66,59449,9,86465
5898,0.002216,172.217.194.0-255,5738,65187,9,86465
5899,0.002218,172.31.36.0-255,66,65253,9,86465
5900,0.002221,172.217.194.0-255,1484,66737,9,86465
5901,0.002225,172.217.194.0-255,2184,68921,9,86465
5902,0.002227,172.31.36.0-255,66,68987,9,86465
5903,0.004731,172.217.194.0-255,1484,70471,9,86465
5904,0.004748,172.217.194.0-255,4320,74791,9,86465
5905,0.004752,172.31.36.0-255,66,74857,9,86465
5906,0.007289,172.217.194.0-255,5738,80595,9,86465
5907,0.007295,172.31.36.0-255,66,80661,9,86465
5908,0.009824,172.217.194.0-255,5738,86399,9,86465
5909,0.009831,172.31.36.0-255,66,86465,9,86465
5910,0.0,172.31.36.0-255,105,105,9,105
5911,0.0,172.217.194.0-255,153,153,9,208652
5912,3.6e-05,172.31.36.0-255,66,219,9,208652
5913,4.4e-05,172.217.194.0-255,1484,1703,9,208652
5914,4.8e-05,172.31.36.0-255,66,1769,9,208652
5915,5.3e-05,172.217.194.0-255,2902,4671,9,208652
5916,5.6e-05,172.31.36.0-255,66,4737,9,208652
5917,6.3e-05,172.217.194.0-255,7156,11893,9,208652
5918,6.6e-05,172.31.36.0-255,66,11959,9,208652
5919,7e-05,172.217.194.0-255,2902,14861,9,208652
5920,7.2e-05,172.31.36.0-255,66,14927,9,208652
5921,9.9e-05,172.217.194.0-255,4890,19817,9,208652
5922,0.000101,172.31.36.0-255,66,19883,9,208652
5923,0.000109,172.217.194.0-255,5738,25621,9,208652
5924,0.000112,172.31.36.0-255,66,25687,9,208652
5925,0.000126,172.217.194.0-255,5379,31066,9,208652
5926,0.000128,172.31.36.0-255,66,31132,9,208652
5927,0.00018,172.217.194.0-255,1484,32616,9,208652
5928,0.000183,172.31.36.0-255,66,32682,9,208652
5929,0.000188,172.217.194.0-255,1484,34166,9,208652
5930,0.00019,172.31.36.0-255,66,34232,9,208652
5931,0.000202,172.217.194.0-255,1484,35716,9,208652
5932,0.000204,172.31.36.0-255,66,35782,9,208652
5933,0.000212,172.217.194.0-255,5738,41520,9,208652
5934,0.000214,172.31.36.0-255,66,41586,9,208652
5935,0.000253,172.31.36.0-255,66,41652,9,208652
5936,0.000259,172.217.194.0-255,4320,45972,9,208652
5937,0.000261,172.31.36.0-255,66,46038,9,208652
5938,0.000287,172.217.194.0-255,5637,51675,9,208652
5939,0.00029,172.31.36.0-255,66,51741,9,208652
5940,0.000416,172.217.194.0-255,114,51855,9,208652
5941,0.00042,172.31.36.0-255,66,51921,9,208652
5942,0.000423,172.217.194.0-255,380,52301,9,208652
5943,0.000628,172.217.194.0-255,1484,53785,9,208652
5944,0.000632,172.31.36.0-255,66,53851,9,208652
5945,0.000637,172.217.194.0-255,2902,56753,9,208652
5946,0.000639,172.31.36.0-255,66,56819,9,208652
5947,0.000674,172.217.194.0-255,5738,62557,9,208652
5948,0.000677,172.31.36.0-255,66,62623,9,208652
5949,0.000682,172.217.194.0-255,4320,66943,9,208652
5950,0.000684,172.31.36.0-255,66,67009,9,208652
5951,0.000703,172.217.194.0-255,2543,69552,9,208652
5952,0.000705,172.31.36.0-255,66,69618,9,208652
5953,0.000743,172.217.194.0-255,1484,71102,9,208652
5954,0.000751,172.217.194.0-255,2902,74004,9,208652
5955,0.000758,172.31.36.0-255,66,74070,9,208652
5956,0.000765,172.217.194.0-255,5738,79808,9,208652
5957,0.000768,172.31.36.0-255,66,79874,9,208652
5958,0.000772,172.217.194.0-255,2902,82776,9,208652
5959,0.000775,172.31.36.0-255,66,82842,9,208652
5960,0.0008,172.217.194.0-255,3961,86803,9,208652
5961,0.000803,172.31.36.0-255,66,86869,9,208652
5962,0.000958,172.217.194.0-255,1484,88353,9,208652
5963,0.000962,172.217.194.0-255,1484,89837,9,208652
5964,0.000965,172.31.36.0-255,66,89903,9,208652
5965,0.000985,172.217.194.0-255,1484,91387,9,208652
5966,0.000991,172.217.194.0-255,5738,97125,9,208652
5967,0.000994,172.31.36.0-255,66,97191,9,208652
5968,0.001,172.217.194.0-255,7156,104347,9,208652
5969,0.001003,172.31.36.0-255,66,104413,9,208652
5970,0.001021,172.31.36.0-255,66,104479,9,208652
5971,0.001038,172.217.194.0-255,5738,110217,9,208652
5972,0.001041,172.31.36.0-255,66,110283,9,208652
5973,0.001046,172.217.194.0-255,2184,112467,9,208652
5974,0.001049,172.31.36.0-255,66,112533,9,208652
5975,0.00114,172.31.36.0-255,101,112634,9,208652
5976,0.001193,172.217.194.0-255,1484,114118,9,208652
5977,0.001199,172.217.194.0-255,2902,117020,9,208652
5978,0.001203,172.31.36.0-255,66,117086,9,208652
5979,0.001225,172.217.194.0-255,5738,122824,9,208652
5980,0.001228,172.31.36.0-255,66,122890,9,208652
5981,0.001232,172.217.194.0-255,1484,124374,9,208652
5982,0.001252,172.217.194.0-255,5738,130112,9,208652
5983,0.001255,172.31.36.0-255,66,130178,9,208652
5984,0.001279,172.217.194.0-255,5738,135916,9,208652
5985,0.001281,172.31.36.0-255,66,135982,9,208652
5986,0.001293,172.31.36.0-255,66,136048,9,208652
5987,0.001297,172.217.194.0-255,1484,137532,9,208652
5988,0.001326,172.217.194.0-255,6438,143970,9,208652
5989,0.001329,172.31.36.0-255,66,144036,9,208652
5990,0.001341,172.31.36.0-255,66,144102,9,208652
5991,0.001353,172.31.36.0-255,66,144168,9,208652
5992,0.001387,172.31.36.0-255,66,144234,9,208652
5993,0.001431,172.217.194.0-255,1484,145718,9,208652
5994,0.001447,172.217.194.0-255,2902,148620,9,208652
5995,0.00145,172.31.36.0-255,66,148686,9,208652
5996,0.001454,172.217.194.0-255,1484,150170,9,208652
5997,0.001476,172.217.194.0-255,2902,153072,9,208652
5998,0.001479,172.31.36.0-255,66,153138,9,208652
5999,0.001485,172.217.194.0-255,5738,158876,9,208652
6000,0.001487,172.31.36.0-255,66,158942,9,208652
6001,0.001507,172.217.194.0-255,2902,161844,9,208652
6002,0.001509,172.31.36.0-255,66,161910,9,208652
6003,0.001544,172.217.194.0-255,4320,166230,9,208652
6004,0.001548,172.31.36.0-255,66,166296,9,208652
6005,0.001581,172.31.36.0-255,66,166362,9,208652
6006,0.001626,172.217.194.0-255,4320,170682,9,208652
6007,0.001631,172.31.36.0-255,66,170748,9,208652
6008,0.001672,172.31.36.0-255,66,170814,9,208652
6009,0.0017,172.31.36.0-255,66,170880,9,208652
6010,0.001728,172.31.36.0-255,66,170946,9,208652
6011,0.001734,172.217.194.0-255,4320,175266,9,208652
6012,0.001738,172.31.36.0-255,66,175332,9,208652
6013,0.001768,172.217.194.0-255,5738,181070,9,208652
6014,0.001772,172.31.36.0-255,66,181136,9,208652
6015,0.001784,172.31.36.0-255,66,181202,9,208652
6016,0.001828,172.217.194.0-255,1484,182686,9,208652
6017,0.001857,172.31.36.0-255,66,182752,9,208652
6018,0.00186,172.217.194.0-255,1484,184236,9,208652
6019,0.001864,172.217.194.0-255,2902,187138,9,208652
6020,0.001867,172.31.36.0-255,66,187204,9,208652
6021,0.001871,172.217.194.0-255,2902,190106,9,208652
6022,0.001875,172.31.36.0-255,66,190172,9,208652
6023,0.001894,172.217.194.0-255,2902,193074,9,208652
6024,0.001897,172.31.36.0-255,66,193140,9,208652
6025,0.001908,172.31.36.0-255,66,193206,9,208652
6026,0.001922,172.217.194.0-255,1484,194690,9,208652
6027,0.00195,172.217.194.0-255,2902,197592,9,208652
6028,0.001954,172.31.36.0-255,66,197658,9,208652
6029,0.001989,172.31.36.0-255,66,197724,9,208652
6030,0.002003,172.31.36.0-255,66,197790,9,208652
6031,0.002044,172.217.194.0-255,1484,199274,9,208652
6032,0.002063,172.31.36.0-255,66,199340,9,208652
6033,0.002082,172.31.36.0-255,66,199406,9,208652
6034,0.002089,172.31.36.0-255,66,199472,9,208652
6035,0.002116,172.217.194.0-255,2902,202374,9,208652
6036,0.002121,172.31.36.0-255,66,202440,9,208652
6037,0.002127,172.217.194.0-255,5738,208178,9,208652
6038,0.00213,172.31.36.0-255,66,208244,9,208652
6039,0.002171,172.31.36.0-255,66,208310,9,208652
6040,0.002174,172.217.194.0-255,105,208415,9,208652
6041,0.003391,172.217.194.0-255,66,208481,9,208652
6042,0.003654,172.31.36.0-255,105,208586,9,208652
6043,0.005863,172.217.194.0-255,66,208652,9,208652
6044,0.0,74.125.130.0-255,155,155,9,189655
6045,2.6e-05,172.31.36.0-255,66,221,9,189655
6046,3.3e-05,74.125.130.0-255,1484,1705,9,189655
6047,3.7e-05,172.31.36.0-255,66,1771,9,189655
6048,5.3e-05,74.125.130.0-255,2902,4673,9,189655
6049,5.6e-05,172.31.36.0-255,66,4739,9,189655
6050,5.9e-05,74.125.130.0-255,1484,6223,9,189655
6051,6.2e-05,172.31.36.0-255,66,6289,9,189655
6052,8.8e-05,74.125.130.0-255,2902,9191,9,189655
6053,9.2e-05,172.31.36.0-255,66,9257,9,189655
6054,9.7e-05,74.125.130.0-255,4320,13577,9,189655
6055,9.9e-05,172.31.36.0-255,66,13643,9,189655
6056,0.000116,74.125.130.0-255,4917,18560,9,189655
6057,0.000119,172.31.36.0-255,66,18626,9,189655
6058,0.000125,74.125.130.0-255,4320,22946,9,189655
6059,0.000127,172.31.36.0-255,66,23012,9,189655
6060,0.000169,74.125.130.0-255,1484,24496,9,189655
6061,0.000172,172.31.36.0-255,66,24562,9,189655
6062,0.000197,74.125.130.0-255,6797,31359,9,189655
6063,0.0002,172.31.36.0-255,66,31425,9,189655
6064,0.000271,74.125.130.0-255,1484,32909,9,189655
6065,0.000275,172.31.36.0-255,66,32975,9,189655
6066,0.00028,74.125.130.0-255,2902,35877,9,189655
6067,0.000283,172.31.36.0-255,66,35943,9,189655
6068,0.000303,74.125.130.0-255,1484,37427,9,189655
6069,0.000306,172.31.36.0-255,66,37493,9,189655
6070,0.000334,74.125.130.0-255,4320,41813,9,189655
6071,0.000338,172.31.36.0-255,66,41879,9,189655
6072,0.000342,74.125.130.0-255,2902,44781,9,189655
6073,0.000344,172.31.36.0-255,66,44847,9,189655
6074,0.00035,74.125.130.0-255,3961,48808,9,189655
6075,0.000352,172.31.36.0-255,66,48874,9,189655
6076,0.000357,74.125.130.0-255,5738,54612,9,189655
6077,0.000361,172.31.36.0-255,66,54678,9,189655
6078,0.000382,74.125.130.0-255,2902,57580,9,189655
6079,0.000386,74.125.130.0-255,2902,60482,9,189655
6080,0.000387,172.31.36.0-255,66,60548,9,189655
6081,0.000391,172.31.36.0-255,66,60614,9,189655
6082,0.00043,74.125.130.0-255,5635,66249,9,189655
6083,0.000434,172.31.36.0-255,66,66315,9,189655
6084,0.000437,74.125.130.0-255,117,66432,9,189655
6085,0.000799,172.31.36.0-255,66,66498,9,189655
6086,0.001857,74.125.130.0-255,1484,67982,9,189655
6087,0.001867,74.125.130.0-255,2902,70884,9,189655
6088,0.001871,172.31.36.0-255,66,70950,9,189655
6089,0.001876,74.125.130.0-255,1484,72434,9,189655
6090,0.00188,74.125.130.0-255,2902,75336,9,189655
6091,0.001883,172.31.36.0-255,66,75402,9,189655
6092,0.001898,74.125.130.0-255,1484,76886,9,189655
6093,0.001912,74.125.130.0-255,4320,81206,9,189655
6094,0.001914,172.31.36.0-255,66,81272,9,189655
6095,0.001917,74.125.130.0-255,1484,82756,9,189655
6096,0.001932,74.125.130.0-255,2543,85299,9,189655
6097,0.001934,172.31.36.0-255,66,85365,9,189655
6098,0.001937,74.125.130.0-255,1484,86849,9,189655
6099,0.001955,74.125.130.0-255,2902,89751,9,189655
6100,0.001956,172.31.36.0-255,66,89817,9,189655
6101,0.001984,172.31.36.0-255,66,89883,9,189655
6102,0.001989,74.125.130.0-255,4320,94203,9,189655
6103,0.001991,172.31.36.0-255,66,94269,9,189655
6104,0.002042,74.125.130.0-255,4320,98589,9,189655
6105,0.002046,172.31.36.0-255,66,98655,9,189655
6106,0.002072,172.31.36.0-255,66,98721,9,189655
6107,0.002247,74.125.130.0-255,1484,100205,9,189655
6108,0.002261,74.125.130.0-255,1484,101689,9,189655
6109,0.002265,172.31.36.0-255,66,101755,9,189655
6110,0.00228,74.125.130.0-255,1484,103239,9,189655
6111,0.002285,74.125.130.0-255,2902,106141,9,189655
6112,0.002288,172.31.36.0-255,66,106207,9,189655
6113,0.002292,74.125.130.0-255,2902,109109,9,189655
6114,0.002294,172.31.36.0-255,66,109175,9,189655
6115,0.002316,74.125.130.0-255,1484,110659,9,189655
6116,0.002321,74.125.130.0-255,2902,113561,9,189655
6117,0.002323,172.31.36.0-255,66,113627,9,189655
6118,0.002349,74.125.130.0-255,5738,119365,9,189655
6119,0.002351,172.31.36.0-255,66,119431,9,189655
6120,0.002357,74.125.130.0-255,5738,125169,9,189655
6121,0.002359,172.31.36.0-255,66,125235,9,189655
6122,0.002365,74.125.130.0-255,7156,132391,9,189655
6123,0.002368,172.31.36.0-255,66,132457,9,189655
6124,0.002392,74.125.130.0-255,5020,137477,9,189655
6125,0.002395,172.31.36.0-255,66,137543,9,189655
6126,0.002402,74.125.130.0-255,5738,143281,9,189655
6127,0.002404,172.31.36.0-255,66,143347,9,189655
6128,0.002437,74.125.130.0-255,2902,146249,9,189655
6129,0.00244,172.31.36.0-255,66,146315,9,189655
6130,0.002467,172.31.36.0-255,66,146381,9,189655
6131,0.002496,74.125.130.0-255,4320,150701,9,189655
6132,0.002499,172.31.36.0-255,66,150767,9,189655
6133,0.002515,74.125.130.0-255,6438,157205,9,189655
6134,0.002517,172.31.36.0-255,66,157271,9,189655
6135,0.002636,74.125.130.0-255,1484,158755,9,189655
6136,0.002648,74.125.130.0-255,2902,161657,9,189655
6137,0.002651,172.31.36.0-255,66,161723,9,189655
6138,0.002671,74.125.130.0-255,5738,167461,9,189655
6139,0.002673,172.31.36.0-255,66,167527,9,189655
6140,0.002711,172.31.36.0-255,66,167593,9,189655
6141,0.002718,74.125.130.0-255,7156,174749,9,189655
6142,0.00272,172.31.36.0-255,66,174815,9,189655
6143,0.002744,74.125.130.0-255,2902,177717,9,189655
6144,0.002747,172.31.36.0-255,66,177783,9,189655
6145,0.005396,74.125.130.0-255,2902,180685,9,189655
6146,0.005402,172.31.36.0-255,66,180751,9,189655
6147,0.005445,74.125.130.0-255,2902,183653,9,189655
6148,0.005448,172.31.36.0-255,66,183719,9,189655
6149,0.008088,74.125.130.0-255,2902,186621,9,189655
6150,0.008095,172.31.36.0-255,66,186687,9,189655
6151,0.008128,74.125.130.0-255,2902,189589,9,189655
6152,0.008133,172.31.36.0-255,66,189655,9,189655
6153,0.0,172.31.36.0-255,235,235,9,301
6154,0.006336,172.217.194.0-255,66,301,9,301
6155,0.0,74.125.24.0-255,122,122,9,629
6156,1.5e-05,74.125.24.0-255,66,188,9,629
6157,0.000161,172.31.36.0-255,105,293,9,629
6158,0.000259,172.31.36.0-255,90,383,9,629
6159,0.000269,172.31.36.0-255,66,449,9,629
6160,0.002548,74.125.24.0-255,60,509,9,629
6161,0.002559,74.125.24.0-255,60,569,9,629
6162,0.002778,74.125.24.0-255,60,629,9,629
6163,0.0,74.125.200.0-255,153,153,9,233320
6164,2.9e-05,172.31.36.0-255,66,219,9,233320
6165,3.7e-05,74.125.200.0-255,1484,1703,9,233320
6166,4.2e-05,172.31.36.0-255,66,1769,9,233320
6167,4.5e-05,74.125.200.0-255,1484,3253,9,233320
6168,4.8e-05,172.31.36.0-255,66,3319,9,233320
6169,6.9e-05,74.125.200.0-255,1484,4803,9,233320
6170,7.2e-05,172.31.36.0-255,66,4869,9,233320
6171,7.8e-05,74.125.200.0-255,4320,9189,9,233320
6172,8e-05,172.31.36.0-255,66,9255,9,233320
6173,0.000106,74.125.200.0-255,4872,14127,9,233320
6174,0.000109,172.31.36.0-255,66,14193,9,233320
6175,0.00013,74.125.200.0-255,5738,19931,9,233320
6176,0.000133,172.31.36.0-255,66,19997,9,233320
6177,0.000153,74.125.200.0-255,4320,24317,9,233320
6178,0.000155,172.31.36.0-255,66,24383,9,233320
6179,0.000176,74.125.200.0-255,2902,27285,9,233320
6180,0.000179,172.31.36.0-255,66,27351,9,233320
6181,0.000195,74.125.200.0-255,1484,28835,9,233320
6182,0.000197,172.31.36.0-255,66,28901,9,233320
6183,0.000215,74.125.200.0-255,2543,31444,9,233320
6184,0.000218,172.31.36.0-255,66,31510,9,233320
6185,0.000314,74.125.200.0-255,1484,32994,9,233320
6186,0.000318,172.31.36.0-255,66,33060,9,233320
6187,0.000335,74.125.200.0-255,2902,35962,9,233320
6188,0.000342,172.31.36.0-255,66,36028,9,233320
6189,0.000346,74.125.200.0-255,1484,37512,9,233320
6190,0.000349,172.31.36.0-255,66,37578,9,233320
6191,0.000363,74.125.200.0-255,2902,40480,9,233320
6192,0.000366,172.31.36.0-255,66,40546,9,233320
6193,0.000384,74.125.200.0-255,4320,44866,9,233320
6194,0.000387,172.31.36.0-255,66,44932,9,233320
6195,0.000411,74.125.200.0-255,1484,46416,9,233320
6196,0.000414,172.31.36.0-255,66,46482,9,233320
6197,0.000419,74.125.200.0-255,4320,50802,9,233320
6198,0.000423,74.125.200.0-255,1484,52286,9,233320
6199,0.000432,172.31.36.0-255,66,52352,9,233320
6200,0.000445,74.125.200.0-255,4320,56672,9,233320
6201,0.00046,172.31.36.0-255,66,56738,9,233320
6202,0.000461,74.125.200.0-255,1484,58222,9,233320
6203,0.00048,74.125.200.0-255,2902,61124,9,233320
6204,0.000483,172.31.36.0-255,66,61190,9,233320
6205,0.000501,74.125.200.0-255,1484,62674,9,233320
6206,0.000506,74.125.200.0-255,2902,65576,9,233320
6207,0.000512,172.31.36.0-255,66,65642,9,233320
6208,0.000529,74.125.200.0-255,766,66408,9,233320
6209,0.000568,74.125.200.0-255,400,66808,9,233320
6210,0.00061,74.125.200.0-255,110,66918,9,233320
6211,0.00068,74.125.200.0-255,1484,68402,9,233320
6212,0.000684,172.31.36.0-255,66,68468,9,233320
6213,0.000706,74.125.200.0-255,2902,71370,9,233320
6214,0.00071,74.125.200.0-255,1484,72854,9,233320
6215,0.000711,172.31.36.0-255,66,72920,9,233320
6216,0.000722,74.125.200.0-255,1484,74404,9,233320
6217,0.000727,172.31.36.0-255,66,74470,9,233320
6218,0.000736,74.125.200.0-255,4320,78790,9,233320
6219,0.00074,172.31.36.0-255,66,78856,9,233320
6220,0.000758,74.125.200.0-255,1484,80340,9,233320
6221,0.000774,74.125.200.0-255,5738,86078,9,233320
6222,0.000787,172.31.36.0-255,66,86144,9,233320
6223,0.000791,74.125.200.0-255,1484,87628,9,233320
6224,0.000809,74.125.200.0-255,5738,93366,9,233320
6225,0.000821,172.31.36.0-255,66,93432,9,233320
6226,0.000821,74.125.200.0-255,1484,94916,9,233320
6227,0.000829,74.125.200.0-255,4320,99236,9,233320
6228,0.000836,172.31.36.0-255,66,99302,9,233320
6229,0.000863,74.125.200.0-255,2448,101750,9,233320
6230,0.000867,172.31.36.0-255,66,101816,9,233320
6231,0.001024,74.125.200.0-255,1484,103300,9,233320
6232,0.00104,74.125.200.0-255,2902,106202,9,233320
6233,0.001051,172.31.36.0-255,66,106268,9,233320
6234,0.00106,74.125.200.0-255,2902,109170,9,233320
6235,0.001065,172.31.36.0-255,66,109236,9,233320
6236,0.001071,74.125.200.0-255,1484,110720,9,233320
6237,0.001074,74.125.200.0-255,1484,112204,9,233320
6238,0.001078,172.31.36.0-255,66,112270,9,233320
6239,0.001094,74.125.200.0-255,4320,116590,9,233320
6240,0.001103,172.31.36.0-255,66,116656,9,233320
6241,0.001108,74.125.200.0-255,1484,118140,9,233320
6242,0.001126,74.125.200.0-255,5738,123878,9,233320
6243,0.00113,172.31.36.0-255,66,123944,9,233320
6244,0.001145,74.125.200.0-255,1484,125428,9,233320
6245,0.001162,74.125.200.0-255,7156,132584,9,233320
6246,0.001167,74.125.200.0-255,3602,136186,9,233320
6247,0.001167,172.31.36.0-255,66,136252,9,233320
6248,0.001172,172.31.36.0-255,66,136318,9,233320
6249,0.001256,74.125.200.0-255,1484,137802,9,233320
6250,0.001271,74.125.200.0-255,1484,139286,9,233320
6251,0.001275,172.31.36.0-255,66,139352,9,233320
6252,0.001291,74.125.200.0-255,1484,140836,9,233320
6253,0.001295,74.125.200.0-255,1484,142320,9,233320
6254,0.0013,172.31.36.0-255,66,142386,9,233320
6255,0.00132,74.125.200.0-255,4320,146706,9,233320
6256,0.001323,74.125.200.0-255,1484,148190,9,233320
6257,0.001327,172.31.36.0-255,66,148256,9,233320
6258,0.001377,74.125.200.0-255,2902,151158,9,233320
6259,0.001387,172.31.36.0-255,66,151224,9,233320
6260,0.001396,74.125.200.0-255,4320,155544,9,233320
6261,0.0014,172.31.36.0-255,66,155610,9,233320
6262,0.00142,74.125.200.0-255,1484,157094,9,233320
6263,0.00144,74.125.200.0-255,5738,162832,9,233320
6264,0.001447,172.31.36.0-255,66,162898,9,233320
6265,0.001465,74.125.200.0-255,1484,164382,9,233320
6266,0.001479,74.125.200.0-255,4320,168702,9,233320
6267,0.001486,172.31.36.0-255,66,168768,9,233320
6268,0.001517,74.125.200.0-255,2184,170952,9,233320
6269,0.001528,172.31.36.0-255,66,171018,9,233320
6270,0.001609,74.125.200.0-255,1484,172502,9,233320
6271,0.001615,74.125.200.0-255,2902,175404,9,233320
6272,0.001627,172.31.36.0-255,66,175470,9,233320
6273,0.001643,74.125.200.0-255,5738,181208,9,233320
6274,0.00165,172.31.36.0-255,66,181274,9,233320
6275,0.001659,74.125.200.0-255,1484,182758,9,233320
6276,0.001679,74.125.200.0-255,5738,188496,9,233320
6277,0.001682,172.31.36.0-255,66,188562,9,233320
6278,0.001702,74.125.200.0-255,4320,192882,9,233320
6279,0.001713,172.31.36.0-255,66,192948,9,233320
6280,0.001723,74.125.200.0-255,4320,197268,9,233320
6281,0.001727,74.125.200.0-255,4320,201588,9,233320
6282,0.001728,172.31.36.0-255,66,201654,9,233320
6283,0.001744,172.31.36.0-255,66,201720,9,233320
6284,0.001773,74.125.200.0-255,2902,204622,9,233320
6285,0.001788,74.125.200.0-255,766,205388,9,233320
6286,0.001789,172.31.36.0-255,66,205454,9,233320
6287,0.002008,172.31.36.0-255,66,205520,9,233320
6288,0.002118,74.125.200.0-255,1484,207004,9,233320
6289,0.002123,172.31.36.0-255,66,207070,9,233320
6290,0.00213,74.125.200.0-255,1484,208554,9,233320
6291,0.002135,74.125.200.0-255,2902,211456,9,233320
6292,0.002164,74.125.200.0-255,1484,212940,9,233320
6293,0.002185,74.125.200.0-255,4320,217260,9,233320
6294,0.002189,74.125.200.0-255,1484,218744,9,233320
6295,0.002193,74.125.200.0-255,2902,221646,9,233320
6296,0.002196,74.125.200.0-255,1484,223130,9,233320
6297,0.002215,74.125.200.0-255,4320,227450,9,233320
6298,0.007577,172.31.36.0-255,66,227516,9,233320
6299,0.009785,74.125.200.0-255,5738,233254,9,233320
6300,0.009792,172.31.36.0-255,66,233320,9,233320
6301,0.0,172.31.36.0-255,105,105,9,105
6302,0.0,74.125.24.0-255,153,153,9,90440
6303,1.2e-05,172.31.36.0-255,66,219,9,90440
6304,1.7e-05,74.125.24.0-255,1484,1703,9,90440
6305,2.1e-05,172.31.36.0-255,66,1769,9,90440
6306,5e-05,74.125.24.0-255,2902,4671,9,90440
6307,5.3e-05,172.31.36.0-255,66,4737,9,90440
6308,8.8e-05,74.125.24.0-255,5738,10475,9,90440
6309,9.1e-05,172.31.36.0-255,66,10541,9,90440
6310,0.000107,172.31.36.0-255,66,10607,9,90440
6311,0.000127,74.125.24.0-255,593,11200,9,90440
6312,0.00013,172.31.36.0-255,66,11266,9,90440
6313,0.000135,74.125.24.0-255,2902,14168,9,90440
6314,0.000138,172.31.36.0-255,66,14234,9,90440
6315,0.000169,74.125.24.0-255,3961,18195,9,90440
6316,0.000172,172.31.36.0-255,66,18261,9,90440
6317,0.000256,74.125.24.0-255,1484,19745,9,90440
6318,0.00026,172.31.36.0-255,66,19811,9,90440
6319,0.000267,74.125.24.0-255,2902,22713,9,90440
6320,0.00027,172.31.36.0-255,66,22779,9,90440
6321,0.000281,74.125.24.0-255,4320,27099,9,90440
6322,0.000283,172.31.36.0-255,66,27165,9,90440
6323,0.000311,74.125.24.0-255,1484,28649,9,90440
6324,0.000314,172.31.36.0-255,66,28715,9,90440
6325,0.000317,74.125.24.0-255,1484,30199,9,90440
6326,0.000319,172.31.36.0-255,66,30265,9,90440
6327,0.000333,172.31.36.0-255,66,30331,9,90440
6328,0.000336,74.125.24.0-255,1484,31815,9,90440
6329,0.000338,172.31.36.0-255,66,31881,9,90440
6330,0.00039,172.31.36.0-255,66,31947,9,90440
6331,0.000393,74.125.24.0-255,114,32061,9,90440
6332,0.000544,74.125.24.0-255,331,32392,9,90440
6333,0.000771,74.125.24.0-255,1484,33876,9,90440
6334,0.000776,172.31.36.0-255,66,33942,9,90440
6335,0.000783,74.125.24.0-255,2902,36844,9,90440
6336,0.000786,172.31.36.0-255,66,36910,9,90440
6337,0.000798,74.125.24.0-255,5738,42648,9,90440
6338,0.0008,172.31.36.0-255,66,42714,9,90440
6339,0.000855,172.31.36.0-255,66,42780,9,90440
6340,0.000868,172.31.36.0-255,66,42846,9,90440
6341,0.00091,74.125.24.0-255,1484,44330,9,90440
6342,0.000916,74.125.24.0-255,2902,47232,9,90440
6343,0.000918,172.31.36.0-255,66,47298,9,90440
6344,0.000923,74.125.24.0-255,2902,50200,9,90440
6345,0.000925,172.31.36.0-255,66,50266,9,90440
6346,0.000968,74.125.24.0-255,2902,53168,9,90440
6347,0.000972,172.31.36.0-255,66,53234,9,90440
6348,0.000983,172.31.36.0-255,66,53300,9,90440
6349,0.000988,74.125.24.0-255,4320,57620,9,90440
6350,0.000991,172.31.36.0-255,66,57686,9,90440
6351,0.001028,74.125.24.0-255,7156,64842,9,90440
6352,0.001031,172.31.36.0-255,66,64908,9,90440
6353,0.001035,74.125.24.0-255,2184,67092,9,90440
6354,0.001037,172.31.36.0-255,66,67158,9,90440
6355,0.003025,74.125.24.0-255,5738,72896,9,90440
6356,0.003033,172.31.36.0-255,66,72962,9,90440
6357,0.005044,74.125.24.0-255,5738,78700,9,90440
6358,0.005048,172.31.36.0-255,66,78766,9,90440
6359,0.007069,74.125.24.0-255,5738,84504,9,90440
6360,0.007075,172.31.36.0-255,66,84570,9,90440
6361,0.009097,74.125.24.0-255,4320,88890,9,90440
6362,0.009104,172.31.36.0-255,66,88956,9,90440
6363,0.009129,74.125.24.0-255,1484,90440,9,90440
6364,0.0,74.125.24.0-255,153,153,9,257819
6365,1.5e-05,74.125.24.0-255,1484,1637,9,257819
6366,2.3e-05,172.31.36.0-255,66,1703,9,257819
6367,3e-05,74.125.24.0-255,2902,4605,9,257819
6368,3.4e-05,172.31.36.0-255,66,4671,9,257819
6369,4.2e-05,74.125.24.0-255,7156,11827,9,257819
6370,4.5e-05,172.31.36.0-255,66,11893,9,257819
6371,4.9e-05,74.125.24.0-255,1993,13886,9,257819
6372,5.2e-05,172.31.36.0-255,66,13952,9,257819
6373,0.000345,74.125.24.0-255,1484,15436,9,257819
6374,0.000354,74.125.24.0-255,2902,18338,9,257819
6375,0.000358,172.31.36.0-255,66,18404,9,257819
6376,0.000364,74.125.24.0-255,2902,21306,9,257819
6377,0.000366,172.31.36.0-255,66,21372,9,257819
6378,0.000382,74.125.24.0-255,2902,24274,9,257819
6379,0.000384,172.31.36.0-255,66,24340,9,257819
6380,0.000409,74.125.24.0-255,6797,31137,9,257819
6381,0.000412,172.31.36.0-255,66,31203,9,257819
6382,0.000579,74.125.24.0-255,1484,32687,9,257819
6383,0.000583,74.125.24.0-255,1484,34171,9,257819
6384,0.000587,172.31.36.0-255,66,34237,9,257819
6385,0.000609,74.125.24.0-255,1484,35721,9,257819
6386,0.000616,74.125.24.0-255,5738,41459,9,257819
6387,0.000618,172.31.36.0-255,66,41525,9,257819
6388,0.000621,74.125.24.0-255,1484,43009,9,257819
6389,0.000662,74.125.24.0-255,5379,48388,9,257819
6390,0.000671,172.31.36.0-255,66,48454,9,257819
6391,0.000691,74.125.24.0-255,2902,51356,9,257819
6392,0.000693,172.31.36.0-255,66,51422,9,257819
6393,0.000716,74.125.24.0-255,2902,54324,9,257819
6394,0.000719,172.31.36.0-255,66,54390,9,257819
6395,0.000726,74.125.24.0-255,7156,61546,9,257819
6396,0.000729,172.31.36.0-255,66,61612,9,257819
6397,0.000763,74.125.24.0-255,1484,63096,9,257819
6398,0.000802,74.125.24.0-255,2543,65639,9,257819
6399,0.000805,172.31.36.0-255,66,65705,9,257819
6400,0.000922,74.125.24.0-255,646,66351,9,257819
6401,0.001326,74.125.24.0-255,1484,67835,9,257819
6402,0.001332,172.31.36.0-255,66,67901,9,257819
6403,0.001339,74.125.24.0-255,2902,70803,9,257819
6404,0.001341,172.31.36.0-255,66,70869,9,257819
6405,0.001349,74.125.24.0-255,5738,76607,9,257819
6406,0.001352,172.31.36.0-255,66,76673,9,257819
6407,0.001394,172.31.36.0-255,66,76739,9,257819
6408,0.001439,172.31.36.0-255,66,76805,9,257819
6409,0.001726,74.125.24.0-255,1484,78289,9,257819
6410,0.001734,74.125.24.0-255,2902,81191,9,257819
6411,0.001738,172.31.36.0-255,66,81257,9,257819
6412,0.001746,74.125.24.0-255,5738,86995,9,257819
6413,0.001748,172.31.36.0-255,66,87061,9,257819
6414,0.001769,74.125.24.0-255,4320,91381,9,257819
6415,0.001772,172.31.36.0-255,66,91447,9,257819
6416,0.0018,172.31.36.0-255,66,91513,9,257819
6417,0.001814,172.31.36.0-255,66,91579,9,257819
6418,0.001875,74.125.24.0-255,1484,93063,9,257819
6419,0.001879,74.125.24.0-255,1484,94547,9,257819
6420,0.001882,172.31.36.0-255,66,94613,9,257819
6421,0.001899,74.125.24.0-255,1484,96097,9,257819
6422,0.001906,74.125.24.0-255,5738,101835,9,257819
6423,0.001908,172.31.36.0-255,66,101901,9,257819
6424,0.001943,74.125.24.0-255,4320,106221,9,257819
6425,0.001946,172.31.36.0-255,66,106287,9,257819
6426,0.001971,172.31.36.0-255,66,106353,9,257819
6427,0.001988,74.125.24.0-255,1484,107837,9,257819
6428,0.002009,172.31.36.0-255,66,107903,9,257819
6429,0.002041,74.125.24.0-255,7156,115059,9,257819
6430,0.002044,172.31.36.0-255,66,115125,9,257819
6431,0.00205,74.125.24.0-255,5738,120863,9,257819
6432,0.002053,172.31.36.0-255,66,120929,9,257819
6433,0.002065,74.125.24.0-255,2902,123831,9,257819
6434,0.002068,172.31.36.0-255,66,123897,9,257819
6435,0.002104,172.31.36.0-255,66,123963,9,257819
6436,0.002121,74.125.24.0-255,2902,126865,9,257819
6437,0.002123,172.31.36.0-255,66,126931,9,257819
6438,0.002126,74.125.24.0-255,766,127697,9,257819
6439,0.002139,74.125.24.0-255,1484,129181,9,257819
6440,0.002141,172.31.36.0-255,66,129247,9,257819
6441,0.002163,74.125.24.0-255,2902,132149,9,257819
6442,0.002165,172.31.36.0-255,66,132215,9,257819
6443,0.002171,74.125.24.0-255,5738,137953,9,257819
6444,0.002174,172.31.36.0-255,66,138019,9,257819
6445,0.002189,74.125.24.0-255,5738,143757,9,257819
6446,0.002192,172.31.36.0-255,66,143823,9,257819
6447,0.002208,74.125.24.0-255,7156,150979,9,257819
6448,0.002211,172.31.36.0-255,66,151045,9,257819
6449,0.002226,74.125.24.0-255,1484,152529,9,257819
6450,0.002238,74.125.24.0-255,2902,155431,9,257819
6451,0.00224,172.31.36.0-255,66,155497,9,257819
6452,0.002257,74.125.24.0-255,6438,161935,9,257819
6453,0.00226,172.31.36.0-255,66,162001,9,257819
6454,0.002431,74.125.24.0-255,1484,163485,9,257819
6455,0.002457,74.125.24.0-255,2902,166387,9,257819
6456,0.00246,172.31.36.0-255,66,166453,9,257819
6457,0.002463,74.125.24.0-255,1484,167937,9,257819
6458,0.002475,74.125.24.0-255,1484,169421,9,257819
6459,0.002477,172.31.36.0-255,66,169487,9,257819
6460,0.00248,74.125.24.0-255,1484,170971,9,257819
6461,0.00255,172.31.36.0-255,66,171037,9,257819
6462,0.002556,74.125.24.0-255,4320,175357,9,257819
6463,0.002558,172.31.36.0-255,66,175423,9,257819
6464,0.002569,172.31.36.0-255,66,175489,9,257819
6465,0.002585,74.125.24.0-255,766,176255,9,257819
6466,0.003422,74.125.24.0-255,1484,177739,9,257819
6467,0.003425,172.31.36.0-255,66,177805,9,257819
6468,0.00343,74.125.24.0-255,2902,180707,9,257819
6469,0.003433,172.31.36.0-255,66,180773,9,257819
6470,0.003445,74.125.24.0-255,1484,182257,9,257819
6471,0.00346,74.125.24.0-255,4320,186577,9,257819
6472,0.003462,172.31.36.0-255,66,186643,9,257819
6473,0.003479,74.125.24.0-255,2902,189545,9,257819
6474,0.003481,172.31.36.0-255,66,189611,9,257819
6475,0.003496,74.125.24.0-255,2902,192513,9,257819
6476,0.003498,172.31.36.0-255,66,192579,9,257819
6477,0.003504,74.125.24.0-255,5738,198317,9,257819
6478,0.003506,172.31.36.0-255,66,198383,9,257819
6479,0.003538,74.125.24.0-255,7156,205539,9,257819
6480,0.003541,172.31.36.0-255,66,205605,9,257819
6481,0.003547,74.125.24.0-255,5020,210625,9,257819
6482,0.003549,172.31.36.0-255,66,210691,9,257819
6483,0.003716,74.125.24.0-255,1484,212175,9,257819
6484,0.003723,74.125.24.0-255,2902,215077,9,257819
6485,0.003726,172.31.36.0-255,66,215143,9,257819
6486,0.003732,74.125.24.0-255,2902,218045,9,257819
6487,0.003735,172.31.36.0-255,66,218111,9,257819
6488,0.00375,74.125.24.0-255,2902,221013,9,257819
6489,0.003752,172.31.36.0-255,66,221079,9,257819
6490,0.003755,74.125.24.0-255,1484,222563,9,257819
6491,0.003768,74.125.24.0-255,1484,224047,9,257819
6492,0.003771,172.31.36.0-255,66,224113,9,257819
6493,0.003795,172.31.36.0-255,66,224179,9,257819
6494,0.003816,74.125.24.0-255,1484,225663,9,257819
6495,0.003819,172.31.36.0-255,78,225741,9,257819
6496,0.003826,74.125.24.0-255,4320,230061,9,257819
6497,0.003829,172.31.36.0-255,78,230139,9,257819
6498,0.003853,172.31.36.0-255,66,230205,9,257819
6499,0.00386,74.125.24.0-255,7156,237361,9,257819
6500,0.003863,172.31.36.0-255,66,237427,9,257819
6501,0.0039,172.31.36.0-255,66,237493,9,257819
6502,0.003935,172.31.36.0-255,66,237559,9,257819
6503,0.003945,172.31.36.0-255,66,237625,9,257819
6504,0.003952,74.125.24.0-255,5738,243363,9,257819
6505,0.003954,172.31.36.0-255,66,243429,9,257819
6506,0.003975,74.125.24.0-255,4320,247749,9,257819
6507,0.003979,172.31.36.0-255,66,247815,9,257819
6508,0.004028,172.31.36.0-255,66,247881,9,257819
6509,0.004034,74.125.24.0-255,4320,252201,9,257819
6510,0.004036,172.31.36.0-255,66,252267,9,257819
6511,0.00406,74.125.24.0-255,5144,257411,9,257819
6512,0.004063,172.31.36.0-255,66,257477,9,257819
6513,0.004067,74.125.24.0-255,105,257582,9,257819
6514,0.007218,172.31.36.0-255,66,257648,9,257819
6515,0.007256,172.31.36.0-255,105,257753,9,257819
6516,0.009559,74.125.24.0-255,66,257819,9,257819
6517,0.0,172.217.194.0-255,162,162,9,146981
6518,2.4e-05,172.217.194.0-255,1484,1646,9,146981
6519,3.1e-05,172.31.36.0-255,66,1712,9,146981
6520,3.9e-05,172.217.194.0-255,2902,4614,9,146981
6521,4.2e-05,172.31.36.0-255,66,4680,9,146981
6522,4.7e-05,172.217.194.0-255,4320,9000,9,146981
6523,5e-05,172.31.36.0-255,66,9066,9,146981
6524,8.3e-05,172.217.194.0-255,2902,11968,9,146981
6525,8.6e-05,172.31.36.0-255,66,12034,9,146981
6526,9.9e-05,172.31.36.0-255,66,12100,9,146981
6527,0.000133,172.217.194.0-255,6254,18354,9,146981
6528,0.000137,172.31.36.0-255,66,18420,9,146981
6529,0.000141,172.217.194.0-255,2543,20963,9,146981
6530,0.000143,172.31.36.0-255,66,21029,9,146981
6531,0.000426,172.217.194.0-255,1484,22513,9,146981
6532,0.000432,172.217.194.0-255,2902,25415,9,146981
6533,0.000435,172.31.36.0-255,66,25481,9,146981
6534,0.000466,172.217.194.0-255,5738,31219,9,146981
6535,0.00047,172.31.36.0-255,66,31285,9,146981
6536,0.000473,172.217.194.0-255,1484,32769,9,146981
6537,0.000518,172.31.36.0-255,66,32835,9,146981
6538,0.000537,172.31.36.0-255,66,32901,9,146981
6539,0.000541,172.217.194.0-255,363,33264,9,146981
6540,0.000634,172.217.194.0-255,1484,34748,9,146981
6541,0.000637,172.31.36.0-255,66,34814,9,146981
6542,0.000642,172.217.194.0-255,2902,37716,9,146981
6543,0.000645,172.31.36.0-255,66,37782,9,146981
6544,0.000657,172.217.194.0-255,5738,43520,9,146981
6545,0.000659,172.31.36.0-255,66,43586,9,146981
6546,0.000663,172.217.194.0-255,1484,45070,9,146981
6547,0.000701,172.31.36.0-255,66,45136,9,146981
6548,0.000708,172.217.194.0-255,4320,49456,9,146981
6549,0.00071,172.31.36.0-255,66,49522,9,146981
6550,0.00074,172.217.194.0-255,6438,55960,9,146981
6551,0.000743,172.31.36.0-255,66,56026,9,146981
6552,0.000784,172.217.194.0-255,1484,57510,9,146981
6553,0.000788,172.217.194.0-255,2902,60412,9,146981
6554,0.000791,172.31.36.0-255,66,60478,9,146981
6555,0.000825,172.217.194.0-255,5738,66216,9,146981
6556,0.000829,172.31.36.0-255,66,66282,9,146981
6557,0.00085,172.31.36.0-255,66,66348,9,146981
6558,0.000885,172.31.36.0-255,66,66414,9,146981
6559,0.000919,172.217.194.0-255,3053,69467,9,146981
6560,0.000922,172.31.36.0-255,66,69533,9,146981
6561,0.000942,172.31.36.0-255,66,69599,9,146981
6562,0.000959,172.31.36.0-255,66,69665,9,146981
6563,0.001007,172.217.194.0-255,1484,71149,9,146981
6564,0.001024,172.217.194.0-255,2902,74051,9,146981
6565,0.001027,172.31.36.0-255,66,74117,9,146981
6566,0.001034,172.217.194.0-255,5738,79855,9,146981
6567,0.001036,172.31.36.0-255,66,79921,9,146981
6568,0.001108,172.217.194.0-255,5738,85659,9,146981
6569,0.001112,172.31.36.0-255,66,85725,9,146981
6570,0.001142,172.217.194.0-255,7156,92881,9,146981
6571,0.001145,172.31.36.0-255,66,92947,9,146981
6572,0.001163,172.31.36.0-255,66,93013,9,146981
6573,0.001166,172.217.194.0-255,1484,94497,9,146981
6574,0.00117,172.217.194.0-255,2902,97399,9,146981
6575,0.001173,172.31.36.0-255,66,97465,9,146981
6576,0.001179,172.217.194.0-255,5738,103203,9,146981
6577,0.001182,172.31.36.0-255,66,103269,9,146981
6578,0.001209,172.31.36.0-255,66,103335,9,146981
6579,0.001216,172.217.194.0-255,5738,109073,9,146981
6580,0.001219,172.31.36.0-255,66,109139,9,146981
6581,0.001239,172.31.36.0-255,66,109205,9,146981
6582,0.001244,172.217.194.0-255,4320,113525,9,146981
6583,0.001246,172.31.36.0-255,66,113591,9,146981
6584,0.001296,172.31.36.0-255,66,113657,9,146981
6585,0.001301,172.217.194.0-255,3602,117259,9,146981
6586,0.001303,172.31.36.0-255,66,117325,9,146981
6587,0.001324,172.217.194.0-255,4320,121645,9,146981
6588,0.001327,172.31.36.0-255,66,121711,9,146981
6589,0.001339,172.217.194.0-255,5738,127449,9,146981
6590,0.001342,172.31.36.0-255,66,127515,9,146981
6591,0.001393,172.31.36.0-255,66,127581,9,146981
6592,0.001408,172.31.36.0-255,66,127647,9,146981
6593,0.001436,172.217.194.0-255,5738,133385,9,146981
6594,0.001439,172.31.36.0-255,66,133451,9,146981
6595,0.001477,172.217.194.0-255,4320,137771,9,146981
6596,0.001481,172.31.36.0-255,66,137837,9,146981
6597,0.001494,172.31.36.0-255,66,137903,9,146981
6598,0.001516,172.31.36.0-255,66,137969,9,146981
6599,0.001549,172.217.194.0-255,5020,142989,9,146981
6600,0.001558,172.31.36.0-255,66,143055,9,146981
6601,0.001578,172.31.36.0-255,66,143121,9,146981
6602,0.001591,172.31.36.0-255,66,143187,9,146981
6603,0.001669,172.31.36.0-255,66,143253,9,146981
6604,0.001674,172.217.194.0-255,3452,146705,9,146981
6605,0.001677,172.31.36.0-255,66,146771,9,146981
6606,0.00168,172.217.194.0-255,105,146876,9,146981
6607,0.008386,172.31.36.0-255,105,146981,9,146981
6608,0.0,74.125.24.0-255,153,153,9,220159
6609,3.3e-05,172.31.36.0-255,66,219,9,220159
6610,4.1e-05,74.125.24.0-255,1484,1703,9,220159
6611,4.6e-05,172.31.36.0-255,66,1769,9,220159
6612,6e-05,74.125.24.0-255,2902,4671,9,220159
6613,6.3e-05,172.31.36.0-255,66,4737,9,220159
6614,7e-05,74.125.24.0-255,7156,11893,9,220159
6615,7.3e-05,172.31.36.0-255,66,11959,9,220159
6616,0.000122,172.31.36.0-255,66,12025,9,220159
6617,0.000125,74.125.24.0-255,1484,13509,9,220159
6618,0.000127,172.31.36.0-255,66,13575,9,220159
6619,0.00013,74.125.24.0-255,1125,14700,9,220159
6620,0.000132,172.31.36.0-255,66,14766,9,220159
6621,0.000211,74.125.24.0-255,1484,16250,9,220159
6622,0.000215,172.31.36.0-255,66,16316,9,220159
6623,0.00022,74.125.24.0-255,2902,19218,9,220159
6624,0.000223,172.31.36.0-255,66,19284,9,220159
6625,0.000236,74.125.24.0-255,5738,25022,9,220159
6626,0.000238,172.31.36.0-255,66,25088,9,220159
6627,0.000278,172.31.36.0-255,66,25154,9,220159
6628,0.000282,74.125.24.0-255,2902,28056,9,220159
6629,0.000284,172.31.36.0-255,66,28122,9,220159
6630,0.000329,172.31.36.0-255,66,28188,9,220159
6631,0.00091,74.125.24.0-255,391,28579,9,220159
6632,0.000915,172.31.36.0-255,66,28645,9,220159
6633,0.001026,74.125.24.0-255,1484,30129,9,220159
6634,0.001031,172.31.36.0-255,66,30195,9,220159
6635,0.00104,74.125.24.0-255,2902,33097,9,220159
6636,0.001042,172.31.36.0-255,66,33163,9,220159
6637,0.001055,74.125.24.0-255,4320,37483,9,220159
6638,0.001108,74.125.24.0-255,4320,41803,9,220159
6639,0.001116,172.31.36.0-255,66,41869,9,220159
6640,0.001138,74.125.24.0-255,7156,49025,9,220159
6641,0.001142,74.125.24.0-255,1484,50509,9,220159
6642,0.001162,74.125.24.0-255,3602,54111,9,220159
6643,0.001218,74.125.24.0-255,1484,55595,9,220159
6644,0.001224,74.125.24.0-255,2902,58497,9,220159
6645,0.001226,74.125.24.0-255,1484,59981,9,220159
6646,0.001237,172.31.36.0-255,66,60047,9,220159
6647,0.001249,74.125.24.0-255,4320,64367,9,220159
6648,0.001255,74.125.24.0-255,5738,70105,9,220159
6649,0.001261,74.125.24.0-255,1484,71589,9,220159
6650,0.001269,172.31.36.0-255,66,71655,9,220159
6651,0.001306,74.125.24.0-255,1484,73139,9,220159
6652,0.001311,74.125.24.0-255,4726,77865,9,220159
6653,0.001337,172.31.36.0-255,66,77931,9,220159
6654,0.001364,74.125.24.0-255,5738,83669,9,220159
6655,0.001372,74.125.24.0-255,7156,90825,9,220159
6656,0.001416,74.125.24.0-255,7156,97981,9,220159
6657,0.001432,74.125.24.0-255,5020,103001,9,220159
6658,0.001456,172.31.36.0-255,66,103067,9,220159
6659,0.001474,74.125.24.0-255,1484,104551,9,220159
6660,0.00148,74.125.24.0-255,2902,107453,9,220159
6661,0.001487,74.125.24.0-255,5738,113191,9,220159
6662,0.001504,74.125.24.0-255,4320,117511,9,220159
6663,0.00152,74.125.24.0-255,5738,123249,9,220159
6664,0.001539,172.31.36.0-255,66,123315,9,220159
6665,0.00159,172.31.36.0-255,66,123381,9,220159
6666,0.002004,74.125.24.0-255,1484,124865,9,220159
6667,0.002009,74.125.24.0-255,1484,126349,9,220159
6668,0.002022,172.31.36.0-255,66,126415,9,220159
6669,0.00203,74.125.24.0-255,1484,127899,9,220159
6670,0.002035,74.125.24.0-255,5738,133637,9,220159
6671,0.002046,172.31.36.0-255,66,133703,9,220159
6672,0.002055,74.125.24.0-255,5738,139441,9,220159
6673,0.002076,74.125.24.0-255,7156,146597,9,220159
6674,0.002079,74.125.24.0-255,1484,148081,9,220159
6675,0.002104,74.125.24.0-255,5738,153819,9,220159
6676,0.00211,172.31.36.0-255,66,153885,9,220159
6677,0.002125,74.125.24.0-255,3602,157487,9,220159
6678,0.00213,172.31.36.0-255,66,157553,9,220159
6679,0.002156,74.125.24.0-255,4320,161873,9,220159
6680,0.00216,74.125.24.0-255,2902,164775,9,220159
6681,0.002174,74.125.24.0-255,2902,167677,9,220159
6682,0.002178,74.125.24.0-255,4320,171997,9,220159
6683,0.002181,172.31.36.0-255,66,172063,9,220159
6684,0.002186,172.31.36.0-255,66,172129,9,220159
6685,0.002217,74.125.24.0-255,7156,179285,9,220159
6686,0.002234,74.125.24.0-255,766,180051,9,220159
6687,0.002275,74.125.24.0-255,1484,181535,9,220159
6688,0.002279,74.125.24.0-255,1484,183019,9,220159
6689,0.002291,74.125.24.0-255,2902,185921,9,220159
6690,0.002302,74.125.24.0-255,1484,187405,9,220159
6691,0.00232,74.125.24.0-255,4320,191725,9,220159
6692,0.002326,74.125.24.0-255,7156,198881,9,220159
6693,0.002386,74.125.24.0-255,766,199647,9,220159
6694,0.002457,74.125.24.0-255,1484,201131,9,220159
6695,0.002462,74.125.24.0-255,2902,204033,9,220159
6696,0.002466,74.125.24.0-255,2902,206935,9,220159
6697,0.002483,74.125.24.0-255,2902,209837,9,220159
6698,0.002734,172.31.36.0-255,66,209903,9,220159
6699,0.005269,74.125.24.0-255,4320,214223,9,220159
6700,0.005275,172.31.36.0-255,66,214289,9,220159
6701,0.005307,74.125.24.0-255,1484,215773,9,220159
6702,0.007731,74.125.24.0-255,4320,220093,9,220159
6703,0.007738,172.31.36.0-255,66,220159,9,220159
6704,0.0,172.217.24.0-255,153,153,9,218975
6705,2.5e-05,172.217.24.0-255,1484,1637,9,218975
6706,3.1e-05,172.31.36.0-255,66,1703,9,218975
6707,3.7e-05,172.217.24.0-255,2902,4605,9,218975
6708,4e-05,172.31.36.0-255,66,4671,9,218975
6709,5.7e-05,172.217.24.0-255,4320,8991,9,218975
6710,5.9e-05,172.31.36.0-255,66,9057,9,218975
6711,7.1e-05,172.217.24.0-255,2902,11959,9,218975
6712,7.4e-05,172.31.36.0-255,66,12025,9,218975
6713,7.8e-05,172.217.24.0-255,1991,14016,9,218975
6714,8.1e-05,172.31.36.0-255,66,14082,9,218975
6715,0.000127,172.217.24.0-255,2902,16984,9,218975
6716,0.00013,172.31.36.0-255,66,17050,9,218975
6717,0.000138,172.217.24.0-255,4320,21370,9,218975
6718,0.000142,172.31.36.0-255,66,21436,9,218975
6719,0.000159,172.217.24.0-255,1484,22920,9,218975
6720,0.000167,172.217.24.0-255,7156,30076,9,218975
6721,0.000169,172.31.36.0-255,66,30142,9,218975
6722,0.000172,172.217.24.0-255,1125,31267,9,218975
6723,0.000254,172.217.24.0-255,1484,32751,9,218975
6724,0.000258,172.31.36.0-255,66,32817,9,218975
6725,0.000261,172.217.24.0-255,1484,34301,9,218975
6726,0.000279,172.217.24.0-255,1484,35785,9,218975
6727,0.000284,172.217.24.0-255,4320,40105,9,218975
6728,0.000285,172.31.36.0-255,66,40171,9,218975
6729,0.000286,172.217.24.0-255,1484,41655,9,218975
6730,0.000289,172.31.36.0-255,66,41721,9,218975
6731,0.0003,172.217.24.0-255,4320,46041,9,218975
6732,0.000303,172.31.36.0-255,66,46107,9,218975
6733,0.000347,172.31.36.0-255,66,46173,9,218975
6734,0.000354,172.217.24.0-255,7099,53272,9,218975
6735,0.000357,172.31.36.0-255,66,53338,9,218975
6736,0.001216,172.217.24.0-255,121,53459,9,218975
6737,0.001349,172.217.24.0-255,1484,54943,9,218975
6738,0.001354,172.31.36.0-255,66,55009,9,218975
6739,0.001363,172.217.24.0-255,2902,57911,9,218975
6740,0.001365,172.31.36.0-255,66,57977,9,218975
6741,0.001371,172.217.24.0-255,5738,63715,9,218975
6742,0.001374,172.31.36.0-255,66,63781,9,218975
6743,0.001381,172.217.24.0-255,6797,70578,9,218975
6744,0.001383,172.31.36.0-255,66,70644,9,218975
6745,0.001423,172.31.36.0-255,66,70710,9,218975
6746,0.001442,172.217.24.0-255,2543,73253,9,218975
6747,0.001444,172.31.36.0-255,66,73319,9,218975
6748,0.002111,172.217.24.0-255,1484,74803,9,218975
6749,0.002117,172.217.24.0-255,1484,76287,9,218975
6750,0.002121,172.31.36.0-255,66,76353,9,218975
6751,0.002137,172.217.24.0-255,1484,77837,9,218975
6752,0.002139,172.217.24.0-255,1484,79321,9,218975
6753,0.002141,172.31.36.0-255,66,79387,9,218975
6754,0.002146,172.217.24.0-255,2902,82289,9,218975
6755,0.002148,172.31.36.0-255,66,82355,9,218975
6756,0.002177,172.217.24.0-255,5738,88093,9,218975
6757,0.002179,172.31.36.0-255,66,88159,9,218975
6758,0.002185,172.217.24.0-255,5738,93897,9,218975
6759,0.002187,172.31.36.0-255,66,93963,9,218975
6760,0.002194,172.217.24.0-255,7156,101119,9,218975
6761,0.002196,172.31.36.0-255,66,101185,9,218975
6762,0.002201,172.217.24.0-255,4320,105505,9,218975
6763,0.002202,172.31.36.0-255,66,105571,9,218975
6764,0.002205,172.217.24.0-255,1484,107055,9,218975
6765,0.002208,172.217.24.0-255,766,107821,9,218975
6766,0.00221,172.31.36.0-255,66,107887,9,218975
6767,0.002474,172.217.24.0-255,1484,109371,9,218975
6768,0.002481,172.217.24.0-255,2902,112273,9,218975
6769,0.002485,172.31.36.0-255,66,112339,9,218975
6770,0.002506,172.217.24.0-255,5738,118077,9,218975
6771,0.002508,172.31.36.0-255,66,118143,9,218975
6772,0.002529,172.217.24.0-255,4320,122463,9,218975
6773,0.002531,172.31.36.0-255,66,122529,9,218975
6774,0.002548,172.217.24.0-255,1484,124013,9,218975
6775,0.002555,172.217.24.0-255,7156,131169,9,218975
6776,0.002557,172.31.36.0-255,66,131235,9,218975
6777,0.00256,172.217.24.0-255,1484,132719,9,218975
6778,0.002589,172.217.24.0-255,7156,139875,9,218975
6779,0.002592,172.31.36.0-255,66,139941,9,218975
6780,0.002599,172.31.36.0-255,66,140007,9,218975
6781,0.002604,172.217.24.0-255,4320,144327,9,218975
6782,0.002606,172.31.36.0-255,66,144393,9,218975
6783,0.002621,172.31.36.0-255,66,144459,9,218975
6784,0.002649,172.217.24.0-255,6438,150897,9,218975
6785,0.002652,172.31.36.0-255,66,150963,9,218975
6786,0.002655,172.217.24.0-255,1484,152447,9,218975
6787,0.002659,172.217.24.0-255,2902,155349,9,218975
6788,0.002661,172.31.36.0-255,66,155415,9,218975
6789,0.002684,172.217.24.0-255,5738,161153,9,218975
6790,0.002687,172.31.36.0-255,66,161219,9,218975
6791,0.002721,172.217.24.0-255,1484,162703,9,218975
6792,0.002742,172.31.36.0-255,66,162769,9,218975
6793,0.002753,172.31.36.0-255,66,162835,9,218975
6794,0.002783,172.217.24.0-255,1484,164319,9,218975
6795,0.0028,172.217.24.0-255,2902,167221,9,218975
6796,0.002803,172.31.36.0-255,66,167287,9,218975
6797,0.002809,172.217.24.0-255,5738,173025,9,218975
6798,0.002811,172.31.36.0-255,66,173091,9,218975
6799,0.002833,172.217.24.0-255,7156,180247,9,218975
6800,0.002836,172.31.36.0-255,66,180313,9,218975
6801,0.002866,172.217.24.0-255,5738,186051,9,218975
6802,0.002869,172.31.36.0-255,66,186117,9,218975
6803,0.002881,172.31.36.0-255,66,186183,9,218975
6804,0.002893,172.31.36.0-255,66,186249,9,218975
6805,0.002898,172.217.24.0-255,5738,191987,9,218975
6806,0.002901,172.31.36.0-255,66,192053,9,218975
6807,0.002939,172.31.36.0-255,66,192119,9,218975
6808,0.002945,172.217.24.0-255,5738,197857,9,218975
6809,0.002947,172.31.36.0-255,66,197923,9,218975
6810,0.00297,172.31.36.0-255,66,197989,9,218975
6811,0.002977,172.217.24.0-255,7156,205145,9,218975
6812,0.002979,172.31.36.0-255,66,205211,9,218975
6813,0.003002,172.217.24.0-255,2902,208113,9,218975
6814,0.003004,172.31.36.0-255,66,208179,9,218975
6815,0.003019,172.217.24.0-255,4320,212499,9,218975
6816,0.003022,172.31.36.0-255,66,212565,9,218975
6817,0.00306,172.31.36.0-255,66,212631,9,218975
6818,0.003066,172.217.24.0-255,5738,218369,9,218975
6819,0.003068,172.31.36.0-255,66,218435,9,218975
6820,0.003095,172.31.36.0-255,66,218501,9,218975
6821,0.003108,172.31.36.0-255,66,218567,9,218975
6822,0.003149,172.31.36.0-255,66,218633,9,218975
6823,0.003216,172.31.36.0-255,66,218699,9,218975
6824,0.003219,172.217.24.0-255,105,218804,9,218975
6825,0.005436,172.31.36.0-255,105,218909,9,218975
6826,0.007348,172.217.24.0-255,66,218975,9,218975
6827,0.0,74.125.130.0-255,153,153,9,355053
6828,2.9e-05,172.31.36.0-255,66,219,9,355053
6829,3.7e-05,74.125.130.0-255,1484,1703,9,355053
6830,4.1e-05,172.31.36.0-255,66,1769,9,355053
6831,6.3e-05,74.125.130.0-255,2902,4671,9,355053
6832,6.5e-05,172.31.36.0-255,66,4737,9,355053
6833,7.1e-05,74.125.130.0-255,4320,9057,9,355053
6834,7.3e-05,172.31.36.0-255,66,9123,9,355053
6835,0.000105,74.125.130.0-255,4920,14043,9,355053
6836,0.00011,172.31.36.0-255,66,14109,9,355053
6837,0.000137,74.125.130.0-255,4320,18429,9,355053
6838,0.00014,172.31.36.0-255,66,18495,9,355053
6839,0.000155,74.125.130.0-255,1484,19979,9,355053
6840,0.000158,172.31.36.0-255,66,20045,9,355053
6841,0.000162,74.125.130.0-255,1484,21529,9,355053
6842,0.000164,172.31.36.0-255,66,21595,9,355053
6843,0.000168,74.125.130.0-255,2902,24497,9,355053
6844,0.00017,172.31.36.0-255,66,24563,9,355053
6845,0.000192,74.125.130.0-255,2902,27465,9,355053
6846,0.000194,172.31.36.0-255,66,27531,9,355053
6847,0.00021,74.125.130.0-255,2902,30433,9,355053
6848,0.000213,172.31.36.0-255,66,30499,9,355053
6849,0.000251,74.125.130.0-255,1125,31624,9,355053
6850,0.000254,172.31.36.0-255,66,31690,9,355053
6851,0.000405,74.125.130.0-255,1484,33174,9,355053
6852,0.00041,172.31.36.0-255,66,33240,9,355053
6853,0.000414,74.125.130.0-255,1484,34724,9,355053
6854,0.000416,172.31.36.0-255,66,34790,9,355053
6855,0.000438,74.125.130.0-255,1484,36274,9,355053
6856,0.000441,172.31.36.0-255,66,36340,9,355053
6857,0.000459,74.125.130.0-255,1484,37824,9,355053
6858,0.000463,172.31.36.0-255,66,37890,9,355053
6859,0.000484,74.125.130.0-255,4320,42210,9,355053
6860,0.000492,74.125.130.0-255,5738,47948,9,355053
6861,0.000491,172.31.36.0-255,66,48014,9,355053
6862,0.000497,172.31.36.0-255,66,48080,9,355053
6863,0.000518,74.125.130.0-255,5379,53459,9,355053
6864,0.000523,172.31.36.0-255,66,53525,9,355053
6865,0.000524,74.125.130.0-255,5738,59263,9,355053
6866,0.000528,172.31.36.0-255,66,59329,9,355053
6867,0.00057,74.125.130.0-255,6797,66126,9,355053
6868,0.000583,172.31.36.0-255,66,66192,9,355053
6869,0.000828,74.125.130.0-255,646,66838,9,355053
6870,0.000886,172.31.36.0-255,66,66904,9,355053
6871,0.001005,74.125.130.0-255,1484,68388,9,355053
6872,0.001025,74.125.130.0-255,2902,71290,9,355053
6873,0.001052,74.125.130.0-255,1484,72774,9,355053
6874,0.001071,74.125.130.0-255,4320,77094,9,355053
6875,0.001074,74.125.130.0-255,1484,78578,9,355053
6876,0.00109,74.125.130.0-255,2902,81480,9,355053
6877,0.001127,74.125.130.0-255,1484,82964,9,355053
6878,0.001146,74.125.130.0-255,2543,85507,9,355053
6879,0.001152,74.125.130.0-255,4320,89827,9,355053
6880,0.001179,74.125.130.0-255,4320,94147,9,355053
6881,0.001191,74.125.130.0-255,2902,97049,9,355053
6882,0.001223,74.125.130.0-255,3961,101010,9,355053
6883,0.001972,74.125.130.0-255,1484,102494,9,355053
6884,0.001991,74.125.130.0-255,2902,105396,9,355053
6885,0.002009,74.125.130.0-255,4320,109716,9,355053
6886,0.002022,74.125.130.0-255,1484,111200,9,355053
6887,0.002037,74.125.130.0-255,2902,114102,9,355053
6888,0.002051,74.125.130.0-255,2902,117004,9,355053
6889,0.002073,74.125.130.0-255,7156,124160,9,355053
6890,0.002095,74.125.130.0-255,7156,131316,9,355053
6891,0.002108,74.125.130.0-255,1484,132800,9,355053
6892,0.002136,74.125.130.0-255,2184,134984,9,355053
6893,0.002365,74.125.130.0-255,1484,136468,9,355053
6894,0.00238,74.125.130.0-255,2902,139370,9,355053
6895,0.002405,74.125.130.0-255,4320,143690,9,355053
6896,0.002421,74.125.130.0-255,1484,145174,9,355053
6897,0.002442,74.125.130.0-255,7156,152330,9,355053
6898,0.002459,74.125.130.0-255,2902,155232,9,355053
6899,0.002472,74.125.130.0-255,1484,156716,9,355053
6900,0.002475,74.125.130.0-255,1484,158200,9,355053
6901,0.002491,74.125.130.0-255,2902,161102,9,355053
6902,0.002511,74.125.130.0-255,4320,165422,9,355053
6903,0.002526,74.125.130.0-255,3602,169024,9,355053
6904,0.002663,74.125.130.0-255,1484,170508,9,355053
6905,0.002676,74.125.130.0-255,1484,171992,9,355053
6906,0.002687,74.125.130.0-255,2902,174894,9,355053
6907,0.002698,74.125.130.0-255,1484,176378,9,355053
6908,0.002716,74.125.130.0-255,4320,180698,9,355053
6909,0.002739,74.125.130.0-255,7156,187854,9,355053
6910,0.002755,74.125.130.0-255,2902,190756,9,355053
6911,0.002767,74.125.130.0-255,2902,193658,9,355053
6912,0.002785,74.125.130.0-255,4320,197978,9,355053
6913,0.002798,74.125.130.0-255,4320,202298,9,355053
6914,0.002801,74.125.130.0-255,766,203064,9,355053
6915,0.003025,74.125.130.0-255,1484,204548,9,355053
6916,0.003037,74.125.130.0-255,2902,207450,9,355053
6917,0.003041,74.125.130.0-255,2902,210352,9,355053
6918,0.003057,74.125.130.0-255,2902,213254,9,355053
6919,0.003084,74.125.130.0-255,2902,216156,9,355053
6920,0.003101,74.125.130.0-255,7156,223312,9,355053
6921,0.003117,74.125.130.0-255,2902,226214,9,355053
6922,0.003144,74.125.130.0-255,2902,229116,9,355053
6923,0.00336,74.125.130.0-255,1484,230600,9,355053
6924,0.003363,74.125.130.0-255,1484,232084,9,355053
6925,0.003384,74.125.130.0-255,1484,233568,9,355053
6926,0.003388,74.125.130.0-255,2902,236470,9,355053
6927,0.003427,74.125.130.0-255,2902,239372,9,355053
6928,0.003444,74.125.130.0-255,1484,240856,9,355053
6929,0.003463,74.125.130.0-255,5738,246594,9,355053
6930,0.003469,74.125.130.0-255,5738,252332,9,355053
6931,0.003493,74.125.130.0-255,1484,253816,9,355053
6932,0.003496,74.125.130.0-255,766,254582,9,355053
6933,0.00351,74.125.130.0-255,1484,256066,9,355053
6934,0.003533,74.125.130.0-255,4320,260386,9,355053
6935,0.00355,74.125.130.0-255,1484,261870,9,355053
6936,0.003571,74.125.130.0-255,5738,267608,9,355053
6937,0.003621,74.125.130.0-255,2184,269792,9,355053
6938,0.003671,74.125.130.0-255,2902,272694,9,355053
6939,0.003678,74.125.130.0-255,5738,278432,9,355053
6940,0.003725,74.125.130.0-255,4320,282752,9,355053
6941,0.003738,74.125.130.0-255,2184,284936,9,355053
6942,0.003752,74.125.130.0-255,1484,286420,9,355053
6943,0.003763,74.125.130.0-255,1484,287904,9,355053
6944,0.003779,172.31.36.0-255,66,287970,9,355053
6945,0.003793,74.125.130.0-255,1484,289454,9,355053
6946,0.003815,74.125.130.0-255,5738,295192,9,355053
6947,0.00382,74.125.130.0-255,2902,298094,9,355053
6948,0.003822,172.31.36.0-255,66,298160,9,355053
6949,0.003825,74.125.130.0-255,4320,302480,9,355053
6950,0.003829,172.31.36.0-255,66,302546,9,355053
6951,0.003843,74.125.130.0-255,1484,304030,9,355053
6952,0.003871,74.125.130.0-255,7156,311186,9,355053
6953,0.003876,172.31.36.0-255,66,311252,9,355053
6954,0.003879,74.125.130.0-255,7156,318408,9,355053
6955,0.003884,74.125.130.0-255,2902,321310,9,355053
6956,0.003892,172.31.36.0-255,66,321376,9,355053
6957,0.003905,74.125.130.0-255,5020,326396,9,355053
6958,0.003911,74.125.130.0-255,4320,330716,9,355053
6959,0.003913,172.31.36.0-255,66,330782,9,355053
6960,0.003917,74.125.130.0-255,5738,336520,9,355053
6961,0.003918,172.31.36.0-255,66,336586,9,355053
6962,0.003935,172.31.36.0-255,66,336652,9,355053
6963,0.003959,74.125.130.0-255,2902,339554,9,355053
6964,0.003966,172.31.36.0-255,66,339620,9,355053
6965,0.003973,74.125.130.0-255,1484,341104,9,355053
6966,0.004002,74.125.130.0-255,2184,343288,9,355053
6967,0.004007,172.31.36.0-255,66,343354,9,355053
6968,0.004019,74.125.130.0-255,2902,346256,9,355053
6969,0.004024,74.125.130.0-255,2902,349158,9,355053
6970,0.004027,172.31.36.0-255,66,349224,9,355053
6971,0.004033,172.31.36.0-255,66,349290,9,355053
6972,0.004049,74.125.130.0-255,4320,353610,9,355053
6973,0.004053,74.125.130.0-255,1272,354882,9,355053
6974,0.004054,172.31.36.0-255,66,354948,9,355053
6975,0.004103,74.125.130.0-255,105,355053,9,355053
6976,0.0,74.125.24.0-255,153,153,9,138394
6977,2.4e-05,172.31.36.0-255,66,219,9,138394
6978,3.1e-05,74.125.24.0-255,1484,1703,9,138394
6979,3.6e-05,172.31.36.0-255,66,1769,9,138394
6980,4.2e-05,74.125.24.0-255,2902,4671,9,138394
6981,4.5e-05,172.31.36.0-255,66,4737,9,138394
6982,5.9e-05,74.125.24.0-255,4320,9057,9,138394
6983,6.2e-05,172.31.36.0-255,66,9123,9,138394
6984,9.6e-05,74.125.24.0-255,2902,12025,9,138394
6985,9.9e-05,172.31.36.0-255,66,12091,9,138394
6986,0.000123,74.125.24.0-255,2084,14175,9,138394
6987,0.000126,172.31.36.0-255,66,14241,9,138394
6988,0.000179,74.125.24.0-255,1484,15725,9,138394
6989,0.000181,172.31.36.0-255,66,15791,9,138394
6990,0.000187,74.125.24.0-255,2902,18693,9,138394
6991,0.00019,172.31.36.0-255,66,18759,9,138394
6992,0.000219,74.125.24.0-255,5738,24497,9,138394
6993,0.000221,172.31.36.0-255,66,24563,9,138394
6994,0.000264,74.125.24.0-255,5738,30301,9,138394
6995,0.000268,172.31.36.0-255,66,30367,9,138394
6996,0.000282,74.125.24.0-255,3961,34328,9,138394
6997,0.000284,172.31.36.0-255,66,34394,9,138394
6998,0.000293,74.125.24.0-255,2902,37296,9,138394
6999,0.000295,172.31.36.0-255,66,37362,9,138394
7000,0.000326,74.125.24.0-255,7156,44518,9,138394
7001,0.000329,172.31.36.0-255,66,44584,9,138394
7002,0.000335,74.125.24.0-255,3961,48545,9,138394
7003,0.000337,172.31.36.0-255,66,48611,9,138394
7004,0.000361,74.125.24.0-255,1484,50095,9,138394
7005,0.000364,172.31.36.0-255,66,50161,9,138394
7006,0.000369,74.125.24.0-255,2902,53063,9,138394
7007,0.000371,172.31.36.0-255,66,53129,9,138394
7008,0.0004,74.125.24.0-255,5738,58867,9,138394
7009,0.000403,172.31.36.0-255,66,58933,9,138394
7010,0.000426,74.125.24.0-255,7069,66002,9,138394
7011,0.000429,172.31.36.0-255,66,66068,9,138394
7012,0.000454,74.125.24.0-255,127,66195,9,138394
7013,0.000577,74.125.24.0-255,1484,67679,9,138394
7014,0.000581,172.31.36.0-255,66,67745,9,138394
7015,0.000587,74.125.24.0-255,2902,70647,9,138394
7016,0.000589,172.31.36.0-255,66,70713,9,138394
7017,0.000617,74.125.24.0-255,5738,76451,9,138394
7018,0.000625,172.31.36.0-255,66,76517,9,138394
7019,0.000627,74.125.24.0-255,1484,78001,9,138394
7020,0.000666,74.125.24.0-255,7156,85157,9,138394
7021,0.000669,172.31.36.0-255,66,85223,9,138394
7022,0.000699,74.125.24.0-255,6797,92020,9,138394
7023,0.000702,172.31.36.0-255,66,92086,9,138394
7024,0.000732,172.31.36.0-255,66,92152,9,138394
7025,0.001395,74.125.24.0-255,1484,93636,9,138394
7026,0.001402,74.125.24.0-255,2902,96538,9,138394
7027,0.001406,172.31.36.0-255,66,96604,9,138394
7028,0.00143,74.125.24.0-255,1484,98088,9,138394
7029,0.001435,74.125.24.0-255,2902,100990,9,138394
7030,0.001437,172.31.36.0-255,66,101056,9,138394
7031,0.00144,74.125.24.0-255,1484,102540,9,138394
7032,0.001464,74.125.24.0-255,4320,106860,9,138394
7033,0.001466,172.31.36.0-255,66,106926,9,138394
7034,0.001469,74.125.24.0-255,1484,108410,9,138394
7035,0.001503,172.31.36.0-255,66,108476,9,138394
7036,0.001531,74.125.24.0-255,4320,112796,9,138394
7037,0.001533,172.31.36.0-255,66,112862,9,138394
7038,0.001554,74.125.24.0-255,3602,116464,9,138394
7039,0.001557,172.31.36.0-255,66,116530,9,138394
7040,0.003528,74.125.24.0-255,5738,122268,9,138394
7041,0.003535,172.31.36.0-255,66,122334,9,138394
7042,0.005524,74.125.24.0-255,5738,128072,9,138394
7043,0.005528,172.31.36.0-255,66,128138,9,138394
7044,0.007509,74.125.24.0-255,4320,132458,9,138394
7045,0.007516,172.31.36.0-255,66,132524,9,138394
7046,0.007544,74.125.24.0-255,1484,134008,9,138394
7047,0.009523,74.125.24.0-255,4320,138328,9,138394
7048,0.009532,172.31.36.0-255,66,138394,9,138394
7049,0.0,74.125.130.0-255,297,297,9,214268
7050,4e-05,172.31.36.0-255,66,363,9,214268
7051,4.7e-05,74.125.130.0-255,1484,1847,9,214268
7052,5.3e-05,172.31.36.0-255,66,1913,9,214268
7053,5.8e-05,74.125.130.0-255,2902,4815,9,214268
7054,6.1e-05,172.31.36.0-255,66,4881,9,214268
7055,7.5e-05,74.125.130.0-255,5738,10619,9,214268
7056,7.8e-05,172.31.36.0-255,66,10685,9,214268
7057,8.3e-05,74.125.130.0-255,3294,13979,9,214268
7058,8.6e-05,172.31.36.0-255,66,14045,9,214268
7059,9.2e-05,74.125.130.0-255,4320,18365,9,214268
7060,9.4e-05,172.31.36.0-255,66,18431,9,214268
7061,0.000134,74.125.130.0-255,7156,25587,9,214268
7062,0.000137,172.31.36.0-255,66,25653,9,214268
7063,0.000161,74.125.130.0-255,1484,27137,9,214268
7064,0.000163,172.31.36.0-255,66,27203,9,214268
7065,0.000195,74.125.130.0-255,3961,31164,9,214268
7066,0.000198,172.31.36.0-255,66,31230,9,214268
7067,0.000311,74.125.130.0-255,1484,32714,9,214268
7068,0.000315,172.31.36.0-255,66,32780,9,214268
7069,0.000345,74.125.130.0-255,2902,35682,9,214268
7070,0.000349,172.31.36.0-255,66,35748,9,214268
7071,0.000356,74.125.130.0-255,5738,41486,9,214268
7072,0.000359,172.31.36.0-255,66,41552,9,214268
7073,0.000396,74.125.130.0-255,6797,48349,9,214268
7074,0.000399,172.31.36.0-255,66,48415,9,214268
7075,0.000406,74.125.130.0-255,7156,55571,9,214268
7076,0.000409,172.31.36.0-255,66,55637,9,214268
7077,0.000414,74.125.130.0-255,2902,58539,9,214268
7078,0.000417,172.31.36.0-255,66,58605,9,214268
7079,0.000448,74.125.130.0-255,4320,62925,9,214268
7080,0.000451,172.31.36.0-255,66,62991,9,214268
7081,0.000487,74.125.130.0-255,2794,65785,9,214268
7082,0.000502,172.31.36.0-255,66,65851,9,214268
7083,0.00075,74.125.130.0-255,121,65972,9,214268
7084,0.000789,74.125.130.0-255,1484,67456,9,214268
7085,0.000794,172.31.36.0-255,66,67522,9,214268
7086,0.000801,74.125.130.0-255,2902,70424,9,214268
7087,0.000813,172.31.36.0-255,66,70490,9,214268
7088,0.000826,74.125.130.0-255,5738,76228,9,214268
7089,0.000835,74.125.130.0-255,1484,77712,9,214268
7090,0.000836,172.31.36.0-255,66,77778,9,214268
7091,0.000861,74.125.130.0-255,5379,83157,9,214268
7092,0.000866,172.31.36.0-255,66,83223,9,214268
7093,0.000903,74.125.130.0-255,1484,84707,9,214268
7094,0.000908,74.125.130.0-255,2902,87609,9,214268
7095,0.000912,172.31.36.0-255,66,87675,9,214268
7096,0.000938,74.125.130.0-255,5738,93413,9,214268
7097,0.000944,74.125.130.0-255,4320,97733,9,214268
7098,0.000956,172.31.36.0-255,66,97799,9,214268
7099,0.000958,74.125.130.0-255,2543,100342,9,214268
7100,0.000971,172.31.36.0-255,66,100408,9,214268
7101,0.00148,74.125.130.0-255,1484,101892,9,214268
7102,0.001491,74.125.130.0-255,2902,104794,9,214268
7103,0.001495,172.31.36.0-255,66,104860,9,214268
7104,0.001501,74.125.130.0-255,2902,107762,9,214268
7105,0.001526,74.125.130.0-255,4320,112082,9,214268
7106,0.00154,74.125.130.0-255,1484,113566,9,214268
7107,0.001557,74.125.130.0-255,7156,120722,9,214268
7108,0.00156,74.125.130.0-255,1484,122206,9,214268
7109,0.001579,74.125.130.0-255,5738,127944,9,214268
7110,0.001603,74.125.130.0-255,6438,134382,9,214268
7111,0.001624,74.125.130.0-255,1484,135866,9,214268
7112,0.001637,74.125.130.0-255,1484,137350,9,214268
7113,0.001675,74.125.130.0-255,1484,138834,9,214268
7114,0.001682,74.125.130.0-255,5738,144572,9,214268
7115,0.001686,74.125.130.0-255,2902,147474,9,214268
7116,0.00169,74.125.130.0-255,4320,151794,9,214268
7117,0.001701,74.125.130.0-255,1484,153278,9,214268
7118,0.001727,74.125.130.0-255,6438,159716,9,214268
7119,0.001826,74.125.130.0-255,1484,161200,9,214268
7120,0.001832,74.125.130.0-255,2902,164102,9,214268
7121,0.001847,74.125.130.0-255,2902,167004,9,214268
7122,0.001868,74.125.130.0-255,2902,169906,9,214268
7123,0.001873,74.125.130.0-255,2902,172808,9,214268
7124,0.001875,74.125.130.0-255,1484,174292,9,214268
7125,0.001895,74.125.130.0-255,2902,177194,9,214268
7126,0.001899,74.125.130.0-255,1484,178678,9,214268
7127,0.001914,74.125.130.0-255,4320,182998,9,214268
7128,0.001935,74.125.130.0-255,2902,185900,9,214268
7129,0.002,74.125.130.0-255,1484,187384,9,214268
7130,0.002008,74.125.130.0-255,2902,190286,9,214268
7131,0.002027,74.125.130.0-255,1484,191770,9,214268
7132,0.002043,74.125.130.0-255,4320,196090,9,214268
7133,0.002049,74.125.130.0-255,4320,200410,9,214268
7134,0.002053,74.125.130.0-255,4320,204730,9,214268
7135,0.002072,74.125.130.0-255,1484,206214,9,214268
7136,0.002084,74.125.130.0-255,2184,208398,9,214268
7137,0.006486,172.31.36.0-255,66,208464,9,214268
7138,0.008567,74.125.130.0-255,5738,214202,9,214268
7139,0.008579,172.31.36.0-255,66,214268,9,214268
7140,0.0,74.125.130.0-255,145,145,9,220389
7141,2.7e-05,172.31.36.0-255,66,211,9,220389
7142,3.5e-05,74.125.130.0-255,1484,1695,9,220389
7143,3.9e-05,172.31.36.0-255,66,1761,9,220389
7144,4.5e-05,74.125.130.0-255,2902,4663,9,220389
7145,4.8e-05,172.31.36.0-255,66,4729,9,220389
7146,5.3e-05,74.125.130.0-255,4320,9049,9,220389
7147,5.6e-05,172.31.36.0-255,66,9115,9,220389
7148,7.2e-05,74.125.130.0-255,1484,10599,9,220389
7149,7.4e-05,172.31.36.0-255,66,10665,9,220389
7150,0.000107,74.125.130.0-255,3489,14154,9,220389
7151,0.00011,172.31.36.0-255,66,14220,9,220389
7152,0.000178,74.125.130.0-255,1484,15704,9,220389
7153,0.000182,172.31.36.0-255,66,15770,9,220389
7154,0.000188,74.125.130.0-255,2902,18672,9,220389
7155,0.00019,172.31.36.0-255,66,18738,9,220389
7156,0.000214,74.125.130.0-255,4320,23058,9,220389
7157,0.000218,172.31.36.0-255,66,23124,9,220389
7158,0.000224,74.125.130.0-255,4320,27444,9,220389
7159,0.000227,172.31.36.0-255,66,27510,9,220389
7160,0.00024,74.125.130.0-255,1484,28994,9,220389
7161,0.000242,172.31.36.0-255,66,29060,9,220389
7162,0.000247,74.125.130.0-255,2543,31603,9,220389
7163,0.000249,172.31.36.0-255,66,31669,9,220389
7164,0.000272,74.125.130.0-255,2902,34571,9,220389
7165,0.000275,172.31.36.0-255,66,34637,9,220389
7166,0.000291,74.125.130.0-255,5738,40375,9,220389
7167,0.000295,172.31.36.0-255,66,40441,9,220389
7168,0.000309,74.125.130.0-255,1484,41925,9,220389
7169,0.000312,172.31.36.0-255,66,41991,9,220389
7170,0.000317,74.125.130.0-255,4320,46311,9,220389
7171,0.00032,172.31.36.0-255,66,46377,9,220389
7172,0.000355,74.125.130.0-255,2543,48920,9,220389
7173,0.000361,172.31.36.0-255,66,48986,9,220389
7174,0.000943,74.125.130.0-255,1484,50470,9,220389
7175,0.000954,74.125.130.0-255,2902,53372,9,220389
7176,0.000958,172.31.36.0-255,66,53438,9,220389
7177,0.000978,74.125.130.0-255,4320,57758,9,220389
7178,0.00098,172.31.36.0-255,66,57824,9,220389
7179,0.001004,74.125.130.0-255,5738,63562,9,220389
7180,0.001007,172.31.36.0-255,66,63628,9,220389
7181,0.001027,74.125.130.0-255,3961,67589,9,220389
7182,0.001029,172.31.36.0-255,66,67655,9,220389
7183,0.001034,74.125.130.0-255,2902,70557,9,220389
7184,0.001035,172.31.36.0-255,66,70623,9,220389
7185,0.001061,74.125.130.0-255,7156,77779,9,220389
7186,0.001063,172.31.36.0-255,66,77845,9,220389
7187,0.00107,74.125.130.0-255,5379,83224,9,220389
7188,0.001071,172.31.36.0-255,66,83290,9,220389
7189,0.001141,74.125.130.0-255,1484,84774,9,220389
7190,0.001157,74.125.130.0-255,1484,86258,9,220389
7191,0.00116,172.31.36.0-255,66,86324,9,220389
7192,0.001165,74.125.130.0-255,2902,89226,9,220389
7193,0.001167,172.31.36.0-255,66,89292,9,220389
7194,0.001196,74.125.130.0-255,5738,95030,9,220389
7195,0.001199,172.31.36.0-255,66,95096,9,220389
7196,0.00122,74.125.130.0-255,5379,100475,9,220389
7197,0.001247,74.125.130.0-255,646,101121,9,220389
7198,0.001484,74.125.130.0-255,1484,102605,9,220389
7199,0.001522,74.125.130.0-255,2902,105507,9,220389
7200,0.001539,74.125.130.0-255,4320,109827,9,220389
7201,0.001563,74.125.130.0-255,4320,114147,9,220389
7202,0.001577,74.125.130.0-255,4320,118467,9,220389
7203,0.001594,74.125.130.0-255,5738,124205,9,220389
7204,0.001608,74.125.130.0-255,4320,128525,9,220389
7205,0.001613,74.125.130.0-255,4320,132845,9,220389
7206,0.001627,74.125.130.0-255,2184,135029,9,220389
7207,0.001751,74.125.130.0-255,1484,136513,9,220389
7208,0.001767,74.125.130.0-255,2902,139415,9,220389
7209,0.00179,74.125.130.0-255,1484,140899,9,220389
7210,0.001809,74.125.130.0-255,4320,145219,9,220389
7211,0.001815,74.125.130.0-255,4320,149539,9,220389
7212,0.00183,74.125.130.0-255,2902,152441,9,220389
7213,0.001836,74.125.130.0-255,5738,158179,9,220389
7214,0.001852,74.125.130.0-255,2902,161081,9,220389
7215,0.001864,74.125.130.0-255,4320,165401,9,220389
7216,0.001881,74.125.130.0-255,3602,169003,9,220389
7217,0.002005,74.125.130.0-255,1484,170487,9,220389
7218,0.002059,74.125.130.0-255,1484,171971,9,220389
7219,0.002063,74.125.130.0-255,2902,174873,9,220389
7220,0.002069,74.125.130.0-255,5738,180611,9,220389
7221,0.002076,74.125.130.0-255,7156,187767,9,220389
7222,0.002095,74.125.130.0-255,5738,193505,9,220389
7223,0.002113,74.125.130.0-255,2902,196407,9,220389
7224,0.002117,74.125.130.0-255,2902,199309,9,220389
7225,0.002137,74.125.130.0-255,3602,202911,9,220389
7226,0.002692,172.31.36.0-255,66,202977,9,220389
7227,0.004974,74.125.130.0-255,5738,208715,9,220389
7228,0.00498,172.31.36.0-255,66,208781,9,220389
7229,0.007249,74.125.130.0-255,5738,214519,9,220389
7230,0.007255,172.31.36.0-255,66,214585,9,220389
7231,0.009525,74.125.130.0-255,5738,220323,9,220389
7232,0.009533,172.31.36.0-255,66,220389,9,220389
7233,0.0,172.217.24.0-255,148,148,9,115468
7234,2.4e-05,172.31.36.0-255,66,214,9,115468
7235,3.1e-05,172.217.24.0-255,1484,1698,9,115468
7236,3.6e-05,172.31.36.0-255,66,1764,9,115468
7237,4.2e-05,172.217.24.0-255,2902,4666,9,115468
7238,4.4e-05,172.31.36.0-255,66,4732,9,115468
7239,6.2e-05,172.217.24.0-255,7156,11888,9,115468
7240,6.5e-05,172.31.36.0-255,66,11954,9,115468
7241,7e-05,172.217.24.0-255,2036,13990,9,115468
7242,7.3e-05,172.31.36.0-255,66,14056,9,115468
7243,9.3e-05,172.217.24.0-255,2902,16958,9,115468
7244,0.0001,172.31.36.0-255,66,17024,9,115468
7245,0.000105,172.217.24.0-255,2902,19926,9,115468
7246,0.000107,172.31.36.0-255,66,19992,9,115468
7247,0.00015,172.217.24.0-255,1484,21476,9,115468
7248,0.000153,172.31.36.0-255,66,21542,9,115468
7249,0.000164,172.31.36.0-255,66,21608,9,115468
7250,0.000168,172.217.24.0-255,1125,22733,9,115468
7251,0.00017,172.31.36.0-255,66,22799,9,115468
7252,0.000332,172.217.24.0-255,1484,24283,9,115468
7253,0.000337,172.31.36.0-255,66,24349,9,115468
7254,0.000343,172.217.24.0-255,2902,27251,9,115468
7255,0.000345,172.31.36.0-255,66,27317,9,115468
7256,0.000354,172.217.24.0-255,2902,30219,9,115468
7257,0.000357,172.31.36.0-255,66,30285,9,115468
7258,0.000362,172.217.24.0-255,4320,34605,9,115468
7259,0.000365,172.31.36.0-255,66,34671,9,115468
7260,0.000403,172.217.24.0-255,1484,36155,9,115468
7261,0.000405,172.31.36.0-255,66,36221,9,115468
7262,0.000443,172.217.24.0-255,3961,40182,9,115468
7263,0.000446,172.31.36.0-255,66,40248,9,115468
7264,0.00058,172.217.24.0-255,1484,41732,9,115468
7265,0.000588,172.217.24.0-255,2902,44634,9,115468
7266,0.000591,172.31.36.0-255,66,44700,9,115468
7267,0.000597,172.217.24.0-255,4320,49020,9,115468
7268,0.000599,172.31.36.0-255,66,49086,9,115468
7269,0.000625,172.217.24.0-255,1484,50570,9,115468
7270,0.000632,172.217.24.0-255,6797,57367,9,115468
7271,0.000635,172.31.36.0-255,66,57433,9,115468
7272,0.000638,172.217.24.0-255,399,57832,9,115468
7273,0.001181,172.31.36.0-255,66,57898,9,115468
7274,0.00156,172.217.24.0-255,116,58014,9,115468
7275,0.001678,172.217.24.0-255,1484,59498,9,115468
7276,0.001683,172.31.36.0-255,66,59564,9,115468
7277,0.00169,172.217.24.0-255,2902,62466,9,115468
7278,0.001692,172.31.36.0-255,66,62532,9,115468
7279,0.001703,172.217.24.0-255,5738,68270,9,115468
7280,0.001705,172.31.36.0-255,66,68336,9,115468
7281,0.001736,172.217.24.0-255,6797,75133,9,115468
7282,0.001738,172.31.36.0-255,66,75199,9,115468
7283,0.001746,172.217.24.0-255,7156,82355,9,115468
7284,0.001748,172.31.36.0-255,66,82421,9,115468
7285,0.001772,172.217.24.0-255,4320,86741,9,115468
7286,0.001774,172.31.36.0-255,66,86807,9,115468
7287,0.001799,172.217.24.0-255,5379,92186,9,115468
7288,0.001802,172.31.36.0-255,66,92252,9,115468
7289,0.003782,172.217.24.0-255,5738,97990,9,115468
7290,0.003791,172.31.36.0-255,66,98056,9,115468
7291,0.005769,172.217.24.0-255,5738,103794,9,115468
7292,0.005772,172.31.36.0-255,66,103860,9,115468
7293,0.007739,172.217.24.0-255,5738,109598,9,115468
7294,0.007747,172.31.36.0-255,66,109664,9,115468
7295,0.00973,172.217.24.0-255,5738,115402,9,115468
7296,0.009742,172.31.36.0-255,66,115468,9,115468
7297,0.0,172.31.36.0-255,105,105,9,105
7298,0.0,74.125.68.0-255,220,220,9,307650
7299,1.9e-05,74.125.68.0-255,1484,1704,9,307650
7300,3e-05,172.31.36.0-255,66,1770,9,307650
7301,3.9e-05,74.125.68.0-255,2902,4672,9,307650
7302,4.3e-05,172.31.36.0-255,66,4738,9,307650
7303,4.9e-05,74.125.68.0-255,4320,9058,9,307650
7304,6.1e-05,172.31.36.0-255,66,9124,9,307650
7305,6.4e-05,74.125.68.0-255,1484,10608,9,307650
7306,9.7e-05,172.31.36.0-255,66,10674,9,307650
7307,0.0001,74.125.68.0-255,1484,12158,9,307650
7308,0.000134,172.31.36.0-255,66,12224,9,307650
7309,0.000159,74.125.68.0-255,2543,14767,9,307650
7310,0.000162,172.31.36.0-255,66,14833,9,307650
7311,0.000264,74.125.68.0-255,1484,16317,9,307650
7312,0.000269,74.125.68.0-255,1484,17801,9,307650
7313,0.000272,172.31.36.0-255,66,17867,9,307650
7314,0.000276,74.125.68.0-255,1484,19351,9,307650
7315,0.000314,74.125.68.0-255,1484,20835,9,307650
7316,0.000317,172.31.36.0-255,66,20901,9,307650
7317,0.000324,74.125.68.0-255,5738,26639,9,307650
7318,0.000327,172.31.36.0-255,66,26705,9,307650
7319,0.000338,74.125.68.0-255,5379,32084,9,307650
7320,0.000341,172.31.36.0-255,66,32150,9,307650
7321,0.000347,74.125.68.0-255,5738,37888,9,307650
7322,0.000349,172.31.36.0-255,66,37954,9,307650
7323,0.000386,74.125.68.0-255,5738,43692,9,307650
7324,0.000389,172.31.36.0-255,66,43758,9,307650
7325,0.000417,74.125.68.0-255,5379,49137,9,307650
7326,0.00042,172.31.36.0-255,66,49203,9,307650
7327,0.000904,74.125.68.0-255,645,49848,9,307650
7328,0.001061,74.125.68.0-255,1484,51332,9,307650
7329,0.001066,172.31.36.0-255,66,51398,9,307650
7330,0.001072,74.125.68.0-255,2902,54300,9,307650
7331,0.001074,172.31.36.0-255,66,54366,9,307650
7332,0.001103,74.125.68.0-255,2902,57268,9,307650
7333,0.001106,172.31.36.0-255,66,57334,9,307650
7334,0.001111,74.125.68.0-255,4320,61654,9,307650
7335,0.001114,172.31.36.0-255,66,61720,9,307650
7336,0.00112,74.125.68.0-255,4320,66040,9,307650
7337,0.001126,172.31.36.0-255,66,66106,9,307650
7338,0.001162,74.125.68.0-255,4320,70426,9,307650
7339,0.001165,172.31.36.0-255,66,70492,9,307650
7340,0.001168,74.125.68.0-255,1484,71976,9,307650
7341,0.001173,74.125.68.0-255,2902,74878,9,307650
7342,0.001175,172.31.36.0-255,66,74944,9,307650
7343,0.001187,74.125.68.0-255,5738,80682,9,307650
7344,0.001189,172.31.36.0-255,66,80748,9,307650
7345,0.001194,74.125.68.0-255,3602,84350,9,307650
7346,0.001197,172.31.36.0-255,66,84416,9,307650
7347,0.002785,74.125.68.0-255,1484,85900,9,307650
7348,0.002796,74.125.68.0-255,2902,88802,9,307650
7349,0.002802,172.31.36.0-255,66,88868,9,307650
7350,0.002807,74.125.68.0-255,1484,90352,9,307650
7351,0.00281,74.125.68.0-255,1484,91836,9,307650
7352,0.002812,172.31.36.0-255,66,91902,9,307650
7353,0.00283,74.125.68.0-255,1484,93386,9,307650
7354,0.002838,74.125.68.0-255,1484,94870,9,307650
7355,0.00284,172.31.36.0-255,66,94936,9,307650
7356,0.002844,74.125.68.0-255,1484,96420,9,307650
7357,0.002846,74.125.68.0-255,1484,97904,9,307650
7358,0.002848,172.31.36.0-255,66,97970,9,307650
7359,0.002852,74.125.68.0-255,1484,99454,9,307650
7360,0.002854,74.125.68.0-255,1484,100938,9,307650
7361,0.002856,172.31.36.0-255,66,101004,9,307650
7362,0.00286,74.125.68.0-255,1484,102488,9,307650
7363,0.002895,74.125.68.0-255,4320,106808,9,307650
7364,0.002897,172.31.36.0-255,66,106874,9,307650
7365,0.0029,74.125.68.0-255,1484,108358,9,307650
7366,0.002927,74.125.68.0-255,4320,112678,9,307650
7367,0.002929,172.31.36.0-255,66,112744,9,307650
7368,0.002932,74.125.68.0-255,1484,114228,9,307650
7369,0.002936,74.125.68.0-255,2902,117130,9,307650
7370,0.002938,172.31.36.0-255,66,117196,9,307650
7371,0.002967,74.125.68.0-255,2184,119380,9,307650
7372,0.00297,172.31.36.0-255,66,119446,9,307650
7373,0.003301,74.125.68.0-255,1484,120930,9,307650
7374,0.003305,74.125.68.0-255,1484,122414,9,307650
7375,0.003307,172.31.36.0-255,66,122480,9,307650
7376,0.003333,74.125.68.0-255,2902,125382,9,307650
7377,0.003335,172.31.36.0-255,66,125448,9,307650
7378,0.003361,74.125.68.0-255,4320,129768,9,307650
7379,0.003364,172.31.36.0-255,66,129834,9,307650
7380,0.003393,74.125.68.0-255,5738,135572,9,307650
7381,0.003395,172.31.36.0-255,66,135638,9,307650
7382,0.003422,74.125.68.0-255,7156,142794,9,307650
7383,0.003425,172.31.36.0-255,66,142860,9,307650
7384,0.003452,74.125.68.0-255,4320,147180,9,307650
7385,0.003454,172.31.36.0-255,66,147246,9,307650
7386,0.003461,74.125.68.0-255,6438,153684,9,307650
7387,0.003465,172.31.36.0-255,66,153750,9,307650
7388,0.003503,172.31.36.0-255,66,153816,9,307650
7389,0.003506,74.125.68.0-255,1484,155300,9,307650
7390,0.003544,172.31.36.0-255,66,155366,9,307650
7391,0.003551,74.125.68.0-255,5738,161104,9,307650
7392,0.003553,172.31.36.0-255,66,161170,9,307650
7393,0.00356,74.125.68.0-255,766,161936,9,307650
7394,0.003598,74.125.68.0-255,1484,163420,9,307650
7395,0.003601,172.31.36.0-255,66,163486,9,307650
7396,0.003631,74.125.68.0-255,4320,167806,9,307650
7397,0.003633,172.31.36.0-255,66,167872,9,307650
7398,0.003636,74.125.68.0-255,1484,169356,9,307650
7399,0.003639,74.125.68.0-255,1484,170840,9,307650
7400,0.003641,172.31.36.0-255,66,170906,9,307650
7401,0.003646,74.125.68.0-255,2902,173808,9,307650
7402,0.003653,172.31.36.0-255,66,173874,9,307650
7403,0.003656,74.125.68.0-255,1484,175358,9,307650
7404,0.00369,74.125.68.0-255,4320,179678,9,307650
7405,0.003692,172.31.36.0-255,66,179744,9,307650
7406,0.003696,74.125.68.0-255,2902,182646,9,307650
7407,0.003699,172.31.36.0-255,66,182712,9,307650
7408,0.003702,74.125.68.0-255,1484,184196,9,307650
7409,0.003736,74.125.68.0-255,5738,189934,9,307650
7410,0.003739,172.31.36.0-255,66,190000,9,307650
7411,0.003744,74.125.68.0-255,4320,194320,9,307650
7412,0.003746,172.31.36.0-255,66,194386,9,307650
7413,0.003778,74.125.68.0-255,2184,196570,9,307650
7414,0.00378,172.31.36.0-255,66,196636,9,307650
7415,0.003935,74.125.68.0-255,1484,198120,9,307650
7416,0.003958,74.125.68.0-255,2902,201022,9,307650
7417,0.00396,172.31.36.0-255,66,201088,9,307650
7418,0.003991,74.125.68.0-255,5738,206826,9,307650
7419,0.003993,172.31.36.0-255,66,206892,9,307650
7420,0.003996,74.125.68.0-255,1484,208376,9,307650
7421,0.004025,74.125.68.0-255,5738,214114,9,307650
7422,0.004028,172.31.36.0-255,66,214180,9,307650
7423,0.004033,74.125.68.0-255,2902,217082,9,307650
7424,0.004036,172.31.36.0-255,66,217148,9,307650
7425,0.004075,172.31.36.0-255,66,217214,9,307650
7426,0.004079,74.125.68.0-255,2902,220116,9,307650
7427,0.004081,172.31.36.0-255,66,220182,9,307650
7428,0.004101,74.125.68.0-255,5020,225202,9,307650
7429,0.004104,172.31.36.0-255,66,225268,9,307650
7430,0.00412,172.31.36.0-255,66,225334,9,307650
7431,0.004192,74.125.68.0-255,5738,231072,9,307650
7432,0.004195,172.31.36.0-255,66,231138,9,307650
7433,0.004202,74.125.68.0-255,7156,238294,9,307650
7434,0.004204,172.31.36.0-255,66,238360,9,307650
7435,0.004216,74.125.68.0-255,6438,244798,9,307650
7436,0.004219,172.31.36.0-255,66,244864,9,307650
7437,0.004308,74.125.68.0-255,1484,246348,9,307650
7438,0.004314,74.125.68.0-255,2902,249250,9,307650
7439,0.004317,172.31.36.0-255,66,249316,9,307650
7440,0.004325,74.125.68.0-255,5738,255054,9,307650
7441,0.004328,172.31.36.0-255,66,255120,9,307650
7442,0.004336,74.125.68.0-255,2902,258022,9,307650
7443,0.004338,172.31.36.0-255,66,258088,9,307650
7444,0.004361,74.125.68.0-255,2902,260990,9,307650
7445,0.004364,172.31.36.0-255,66,261056,9,307650
7446,0.004393,74.125.68.0-255,7156,268212,9,307650
7447,0.004396,172.31.36.0-255,66,268278,9,307650
7448,0.004413,172.31.36.0-255,66,268344,9,307650
7449,0.004438,74.125.68.0-255,1484,269828,9,307650
7450,0.004462,74.125.68.0-255,5020,274848,9,307650
7451,0.004465,172.31.36.0-255,66,274914,9,307650
7452,0.004472,74.125.68.0-255,7156,282070,9,307650
7453,0.004475,172.31.36.0-255,66,282136,9,307650
7454,0.004511,172.31.36.0-255,66,282202,9,307650
7455,0.004539,74.125.68.0-255,5738,287940,9,307650
7456,0.004542,172.31.36.0-255,66,288006,9,307650
7457,0.004575,74.125.68.0-255,6438,294444,9,307650
7458,0.004578,172.31.36.0-255,66,294510,9,307650
7459,0.004583,74.125.68.0-255,4320,298830,9,307650
7460,0.004586,172.31.36.0-255,66,298896,9,307650
7461,0.004639,172.31.36.0-255,66,298962,9,307650
7462,0.004676,172.31.36.0-255,66,299028,9,307650
7463,0.004699,74.125.68.0-255,766,299794,9,307650
7464,0.004706,74.125.68.0-255,4320,304114,9,307650
7465,0.004708,172.31.36.0-255,66,304180,9,307650
7466,0.004739,74.125.68.0-255,3299,307479,9,307650
7467,0.004742,172.31.36.0-255,66,307545,9,307650
7468,0.004746,74.125.68.0-255,105,307650,9,307650
7469,0.0,172.217.194.0-255,145,145,9,176623
7470,2.4e-05,172.31.36.0-255,66,211,9,176623
7471,3.2e-05,172.217.194.0-255,1484,1695,9,176623
7472,3.6e-05,172.31.36.0-255,66,1761,9,176623
7473,4.3e-05,172.217.194.0-255,2902,4663,9,176623
7474,4.7e-05,172.31.36.0-255,66,4729,9,176623
7475,5.3e-05,172.217.194.0-255,4320,9049,9,176623
7476,5.6e-05,172.31.36.0-255,66,9115,9,176623
7477,8.2e-05,172.217.194.0-255,4922,14037,9,176623
7478,8.5e-05,172.31.36.0-255,66,14103,9,176623
7479,9e-05,172.217.194.0-255,4320,18423,9,176623
7480,9.3e-05,172.31.36.0-255,66,18489,9,176623
7481,0.000108,172.217.194.0-255,1484,19973,9,176623
7482,0.00011,172.31.36.0-255,66,20039,9,176623
7483,0.000141,172.217.194.0-255,7156,27195,9,176623
7484,0.000143,172.31.36.0-255,66,27261,9,176623
7485,0.000167,172.217.194.0-255,2902,30163,9,176623
7486,0.000169,172.31.36.0-255,66,30229,9,176623
7487,0.000173,172.217.194.0-255,1125,31354,9,176623
7488,0.000175,172.31.36.0-255,66,31420,9,176623
7489,0.000179,172.217.194.0-255,1484,32904,9,176623
7490,0.00018,172.31.36.0-255,66,32970,9,176623
7491,0.000198,172.217.194.0-255,4320,37290,9,176623
7492,0.000201,172.31.36.0-255,66,37356,9,176623
7493,0.000228,172.31.36.0-255,66,37422,9,176623
7494,0.000252,172.217.194.0-255,1125,38547,9,176623
7495,0.000255,172.31.36.0-255,66,38613,9,176623
7496,0.000436,172.217.194.0-255,1484,40097,9,176623
7497,0.000441,172.31.36.0-255,66,40163,9,176623
7498,0.000448,172.217.194.0-255,2902,43065,9,176623
7499,0.00045,172.31.36.0-255,66,43131,9,176623
7500,0.000457,172.217.194.0-255,5738,48869,9,176623
7501,0.000459,172.31.36.0-255,66,48935,9,176623
7502,0.000462,172.217.194.0-255,1484,50419,9,176623
7503,0.000483,172.217.194.0-255,5379,55798,9,176623
7504,0.000488,172.31.36.0-255,66,55864,9,176623
7505,0.000523,172.217.194.0-255,5738,61602,9,176623
7506,0.000527,172.31.36.0-255,66,61668,9,176623
7507,0.000555,172.31.36.0-255,66,61734,9,176623
7508,0.000559,172.217.194.0-255,2543,64277,9,176623
7509,0.000561,172.31.36.0-255,66,64343,9,176623
7510,0.000729,172.217.194.0-255,1484,65827,9,176623
7511,0.000736,172.217.194.0-255,2902,68729,9,176623
7512,0.000739,172.31.36.0-255,66,68795,9,176623
7513,0.000746,172.217.194.0-255,5738,74533,9,176623
7514,0.000748,172.31.36.0-255,66,74599,9,176623
7515,0.000806,172.31.36.0-255,66,74665,9,176623
7516,0.000811,172.217.194.0-255,2902,77567,9,176623
7517,0.000813,172.31.36.0-255,66,77633,9,176623
7518,0.000828,172.217.194.0-255,5738,83371,9,176623
7519,0.000831,172.31.36.0-255,66,83437,9,176623
7520,0.000854,172.217.194.0-255,6683,90120,9,176623
7521,0.000858,172.31.36.0-255,66,90186,9,176623
7522,0.001215,172.217.194.0-255,211,90397,9,176623
7523,0.00148,172.217.194.0-255,1484,91881,9,176623
7524,0.001484,172.31.36.0-255,66,91947,9,176623
7525,0.001507,172.217.194.0-255,2902,94849,9,176623
7526,0.00151,172.31.36.0-255,66,94915,9,176623
7527,0.001516,172.217.194.0-255,5738,100653,9,176623
7528,0.001518,172.31.36.0-255,66,100719,9,176623
7529,0.00153,172.217.194.0-255,1484,102203,9,176623
7530,0.001557,172.31.36.0-255,66,102269,9,176623
7531,0.001569,172.31.36.0-255,66,102335,9,176623
7532,0.00159,172.217.194.0-255,766,103101,9,176623
7533,0.00192,172.31.36.0-255,66,103167,9,176623
7534,0.001942,172.217.194.0-255,1484,104651,9,176623
7535,0.001946,172.217.194.0-255,1484,106135,9,176623
7536,0.001949,172.31.36.0-255,66,106201,9,176623
7537,0.001967,172.217.194.0-255,1484,107685,9,176623
7538,0.001974,172.217.194.0-255,5738,113423,9,176623
7539,0.001976,172.31.36.0-255,66,113489,9,176623
7540,0.002006,172.217.194.0-255,1484,114973,9,176623
7541,0.002029,172.31.36.0-255,66,115039,9,176623
7542,0.002041,172.31.36.0-255,66,115105,9,176623
7543,0.002064,172.217.194.0-255,1484,116589,9,176623
7544,0.00208,172.217.194.0-255,4320,120909,9,176623
7545,0.002082,172.31.36.0-255,66,120975,9,176623
7546,0.00209,172.217.194.0-255,7156,128131,9,176623
7547,0.002092,172.31.36.0-255,66,128197,9,176623
7548,0.002129,172.31.36.0-255,66,128263,9,176623
7549,0.002136,172.217.194.0-255,6438,134701,9,176623
7550,0.002139,172.31.36.0-255,66,134767,9,176623
7551,0.002187,172.217.194.0-255,4320,139087,9,176623
7552,0.002192,172.31.36.0-255,66,139153,9,176623
7553,0.002222,172.217.194.0-255,2902,142055,9,176623
7554,0.002225,172.31.36.0-255,66,142121,9,176623
7555,0.002236,172.31.36.0-255,66,142187,9,176623
7556,0.002252,172.31.36.0-255,66,142253,9,176623
7557,0.002254,172.217.194.0-255,766,143019,9,176623
7558,0.002295,172.217.194.0-255,1484,144503,9,176623
7559,0.002299,172.31.36.0-255,66,144569,9,176623
7560,0.002304,172.217.194.0-255,2902,147471,9,176623
7561,0.002306,172.31.36.0-255,66,147537,9,176623
7562,0.002313,172.217.194.0-255,5738,153275,9,176623
7563,0.002315,172.31.36.0-255,66,153341,9,176623
7564,0.002353,172.31.36.0-255,66,153407,9,176623
7565,0.002359,172.217.194.0-255,5738,159145,9,176623
7566,0.002361,172.31.36.0-255,66,159211,9,176623
7567,0.004677,172.217.194.0-255,5738,164949,9,176623
7568,0.004696,172.31.36.0-255,66,165015,9,176623
7569,0.007006,172.217.194.0-255,5738,170753,9,176623
7570,0.007023,172.31.36.0-255,66,170819,9,176623
7571,0.009334,172.217.194.0-255,5738,176557,9,176623
7572,0.009346,172.31.36.0-255,66,176623,9,176623
7573,0.0,74.125.24.0-255,144,144,9,183125
7574,3.3e-05,74.125.24.0-255,1484,1628,9,183125
7575,4.6e-05,172.31.36.0-255,66,1694,9,183125
7576,5.3e-05,74.125.24.0-255,2902,4596,9,183125
7577,5.6e-05,74.125.24.0-255,1484,6080,9,183125
7578,7.5e-05,74.125.24.0-255,5738,11818,9,183125
7579,0.0001,172.31.36.0-255,66,11884,9,183125
7580,0.000107,172.31.36.0-255,66,11950,9,183125
7581,0.000141,74.125.24.0-255,1484,13434,9,183125
7582,0.000156,74.125.24.0-255,1125,14559,9,183125
7583,0.000205,74.125.24.0-255,1484,16043,9,183125
7584,0.00021,74.125.24.0-255,1484,17527,9,183125
7585,0.000241,74.125.24.0-255,4320,21847,9,183125
7586,0.000269,74.125.24.0-255,2902,24749,9,183125
7587,0.000292,74.125.24.0-255,6797,31546,9,183125
7588,0.000312,172.31.36.0-255,66,31612,9,183125
7589,0.000589,74.125.24.0-255,1484,33096,9,183125
7590,0.000594,74.125.24.0-255,1484,34580,9,183125
7591,0.000598,172.31.36.0-255,66,34646,9,183125
7592,0.000618,74.125.24.0-255,1484,36130,9,183125
7593,0.000625,74.125.24.0-255,5738,41868,9,183125
7594,0.00063,172.31.36.0-255,66,41934,9,183125
7595,0.000654,74.125.24.0-255,7156,49090,9,183125
7596,0.000664,172.31.36.0-255,66,49156,9,183125
7597,0.000672,74.125.24.0-255,5379,54535,9,183125
7598,0.000679,172.31.36.0-255,66,54601,9,183125
7599,0.000729,172.31.36.0-255,66,54667,9,183125
7600,0.000805,74.125.24.0-255,1484,56151,9,183125
7601,0.000823,74.125.24.0-255,2902,59053,9,183125
7602,0.000827,172.31.36.0-255,66,59119,9,183125
7603,0.000835,74.125.24.0-255,2902,62021,9,183125
7604,0.000841,172.31.36.0-255,66,62087,9,183125
7605,0.000857,74.125.24.0-255,2902,64989,9,183125
7606,0.000859,172.31.36.0-255,66,65055,9,183125
7607,0.000865,74.125.24.0-255,4320,69375,9,183125
7608,0.00087,172.31.36.0-255,66,69441,9,183125
7609,0.000883,74.125.24.0-255,1484,70925,9,183125
7610,0.000908,74.125.24.0-255,7156,78081,9,183125
7611,0.000912,172.31.36.0-255,66,78147,9,183125
7612,0.000924,74.125.24.0-255,2902,81049,9,183125
7613,0.000937,172.31.36.0-255,66,81115,9,183125
7614,0.001061,74.125.24.0-255,1484,82599,9,183125
7615,0.001081,74.125.24.0-255,2902,85501,9,183125
7616,0.001085,172.31.36.0-255,66,85567,9,183125
7617,0.001088,74.125.24.0-255,1484,87051,9,183125
7618,0.001103,74.125.24.0-255,4320,91371,9,183125
7619,0.001108,172.31.36.0-255,66,91437,9,183125
7620,0.001109,74.125.24.0-255,5738,97175,9,183125
7621,0.001112,172.31.36.0-255,66,97241,9,183125
7622,0.001135,74.125.24.0-255,1484,98725,9,183125
7623,0.00117,74.125.24.0-255,5738,104463,9,183125
7624,0.001178,172.31.36.0-255,66,104529,9,183125
7625,0.001197,74.125.24.0-255,5738,110267,9,183125
7626,0.001212,172.31.36.0-255,66,110333,9,183125
7627,0.001213,74.125.24.0-255,4320,114653,9,183125
7628,0.001216,172.31.36.0-255,66,114719,9,183125
7629,0.001234,74.125.24.0-255,5020,119739,9,183125
7630,0.001239,172.31.36.0-255,66,119805,9,183125
7631,0.001289,74.125.24.0-255,1484,121289,9,183125
7632,0.00131,74.125.24.0-255,2902,124191,9,183125
7633,0.001314,172.31.36.0-255,66,124257,9,183125
7634,0.001331,74.125.24.0-255,5738,129995,9,183125
7635,0.00134,172.31.36.0-255,66,130061,9,183125
7636,0.001375,172.31.36.0-255,66,130127,9,183125
7637,0.001381,74.125.24.0-255,4320,134447,9,183125
7638,0.001393,172.31.36.0-255,66,134513,9,183125
7639,0.001398,172.31.36.0-255,66,134579,9,183125
7640,0.001416,74.125.24.0-255,2184,136763,9,183125
7641,0.001421,172.31.36.0-255,66,136829,9,183125
7642,0.001562,74.125.24.0-255,1484,138313,9,183125
7643,0.001566,74.125.24.0-255,1484,139797,9,183125
7644,0.001569,172.31.36.0-255,66,139863,9,183125
7645,0.001588,74.125.24.0-255,1484,141347,9,183125
7646,0.001595,74.125.24.0-255,5738,147085,9,183125
7647,0.001598,74.125.24.0-255,1484,148569,9,183125
7648,0.001606,172.31.36.0-255,66,148635,9,183125
7649,0.001627,172.31.36.0-255,66,148701,9,183125
7650,0.001633,172.31.36.0-255,66,148767,9,183125
7651,0.001701,172.31.36.0-255,66,148833,9,183125
7652,0.001731,172.31.36.0-255,66,148899,9,183125
7653,0.001737,172.31.36.0-255,66,148965,9,183125
7654,0.001741,74.125.24.0-255,7156,156121,9,183125
7655,0.001749,172.31.36.0-255,66,156187,9,183125
7656,0.001777,74.125.24.0-255,4320,160507,9,183125
7657,0.001789,172.31.36.0-255,66,160573,9,183125
7658,0.001795,172.31.36.0-255,66,160639,9,183125
7659,0.001817,172.31.36.0-255,66,160705,9,183125
7660,0.001844,74.125.24.0-255,5738,166443,9,183125
7661,0.001844,172.31.36.0-255,66,166509,9,183125
7662,0.001848,172.31.36.0-255,66,166575,9,183125
7663,0.001866,74.125.24.0-255,1484,168059,9,183125
7664,0.00188,74.125.24.0-255,1484,169543,9,183125
7665,0.001892,172.31.36.0-255,66,169609,9,183125
7666,0.001931,172.31.36.0-255,66,169675,9,183125
7667,0.001936,172.31.36.0-255,66,169741,9,183125
7668,0.001956,74.125.24.0-255,2902,172643,9,183125
7669,0.001968,172.31.36.0-255,66,172709,9,183125
7670,0.001973,172.31.36.0-255,66,172775,9,183125
7671,0.001994,172.31.36.0-255,66,172841,9,183125
7672,0.001997,74.125.24.0-255,5738,178579,9,183125
7673,0.002007,172.31.36.0-255,66,178645,9,183125
7674,0.002044,172.31.36.0-255,66,178711,9,183125
7675,0.002049,172.31.36.0-255,66,178777,9,183125
7676,0.002073,74.125.24.0-255,1484,180261,9,183125
7677,0.002092,172.31.36.0-255,66,180327,9,183125
7678,0.002108,74.125.24.0-255,2456,182783,9,183125
7679,0.002112,74.125.24.0-255,105,182888,9,183125
7680,0.002118,172.31.36.0-255,66,182954,9,183125
7681,0.003803,172.31.36.0-255,105,183059,9,183125
7682,0.00634,74.125.24.0-255,66,183125,9,183125
7683,0.0,74.125.200.0-255,152,152,9,63680
7684,3.4e-05,172.31.36.0-255,66,218,9,63680
7685,4.1e-05,74.125.200.0-255,1484,1702,9,63680
7686,4.5e-05,172.31.36.0-255,66,1768,9,63680
7687,5e-05,74.125.200.0-255,2902,4670,9,63680
7688,5.3e-05,172.31.36.0-255,66,4736,9,63680
7689,0.000119,74.125.200.0-255,5738,10474,9,63680
7690,0.000124,172.31.36.0-255,66,10540,9,63680
7691,0.000253,74.125.200.0-255,2902,13442,9,63680
7692,0.000257,172.31.36.0-255,66,13508,9,63680
7693,0.000309,74.125.200.0-255,603,14111,9,63680
7694,0.000314,172.31.36.0-255,66,14177,9,63680
7695,0.000341,74.125.200.0-255,1484,15661,9,63680
7696,0.000345,172.31.36.0-255,66,15727,9,63680
7697,0.000381,74.125.200.0-255,4320,20047,9,63680
7698,0.000385,172.31.36.0-255,66,20113,9,63680
7699,0.000495,74.125.200.0-255,5738,25851,9,63680
7700,0.0005,172.31.36.0-255,66,25917,9,63680
7701,0.000525,74.125.200.0-255,4320,30237,9,63680
7702,0.000529,172.31.36.0-255,66,30303,9,63680
7703,0.000737,74.125.200.0-255,1125,31428,9,63680
7704,0.000741,172.31.36.0-255,66,31494,9,63680
7705,0.000777,74.125.200.0-255,7156,38650,9,63680
7706,0.000781,172.31.36.0-255,66,38716,9,63680
7707,0.000976,172.31.36.0-255,66,38782,9,63680
7708,0.001288,74.125.200.0-255,7156,45938,9,63680
7709,0.001294,172.31.36.0-255,66,46004,9,63680
7710,0.001332,172.31.36.0-255,66,46070,9,63680
7711,0.001668,172.31.36.0-255,66,46136,9,63680
7712,0.001727,172.31.36.0-255,66,46202,9,63680
7713,0.0024,172.31.36.0-255,66,46268,9,63680
7714,0.003258,74.125.200.0-255,5738,52006,9,63680
7715,0.004942,172.31.36.0-255,66,52072,9,63680
7716,0.007219,74.125.200.0-255,5738,57810,9,63680
7717,0.00723,172.31.36.0-255,66,57876,9,63680
7718,0.009502,74.125.200.0-255,5738,63614,9,63680
7719,0.009509,172.31.36.0-255,66,63680,9,63680
7720,0.0,74.125.24.0-255,66,66,9,66
7721,0.0,172.217.194.0-255,153,153,9,196956
7722,2.2e-05,172.31.36.0-255,66,219,9,196956
7723,2.9e-05,172.217.194.0-255,1484,1703,9,196956
7724,3.4e-05,172.31.36.0-255,66,1769,9,196956
7725,4e-05,172.217.194.0-255,2902,4671,9,196956
7726,5.1e-05,172.31.36.0-255,66,4737,9,196956
7727,6e-05,172.217.194.0-255,7156,11893,9,196956
7728,6.3e-05,172.31.36.0-255,66,11959,9,196956
7729,6.8e-05,172.217.194.0-255,2037,13996,9,196956
7730,7.1e-05,172.31.36.0-255,66,14062,9,196956
7731,0.000111,172.31.36.0-255,66,14128,9,196956
7732,0.000145,172.217.194.0-255,2902,17030,9,196956
7733,0.000147,172.31.36.0-255,66,17096,9,196956
7734,0.000154,172.217.194.0-255,5379,22475,9,196956
7735,0.000157,172.31.36.0-255,66,22541,9,196956
7736,0.000184,172.217.194.0-255,1484,24025,9,196956
7737,0.000186,172.31.36.0-255,66,24091,9,196956
7738,0.000191,172.217.194.0-255,2902,26993,9,196956
7739,0.000194,172.31.36.0-255,66,27059,9,196956
7740,0.0002,172.217.194.0-255,5738,32797,9,196956
7741,0.000208,172.31.36.0-255,66,32863,9,196956
7742,0.000246,172.31.36.0-255,66,32929,9,196956
7743,0.000279,172.217.194.0-255,2543,35472,9,196956
7744,0.000282,172.31.36.0-255,66,35538,9,196956
7745,0.000298,172.31.36.0-255,66,35604,9,196956
7746,0.000322,172.217.194.0-255,1447,37051,9,196956
7747,0.000324,172.31.36.0-255,66,37117,9,196956
7748,0.00038,172.217.194.0-255,1484,38601,9,196956
7749,0.000383,172.31.36.0-255,66,38667,9,196956
7750,0.000389,172.217.194.0-255,2902,41569,9,196956
7751,0.000392,172.31.36.0-255,66,41635,9,196956
7752,0.000404,172.217.194.0-255,5738,47373,9,196956
7753,0.000407,172.31.36.0-255,66,47439,9,196956
7754,0.000448,172.217.194.0-255,4320,51759,9,196956
7755,0.000452,172.31.36.0-255,66,51825,9,196956
7756,0.000475,172.217.194.0-255,2543,54368,9,196956
7757,0.000478,172.31.36.0-255,66,54434,9,196956
7758,0.000481,172.217.194.0-255,1484,55918,9,196956
7759,0.000504,172.217.194.0-255,5738,61656,9,196956
7760,0.000506,172.31.36.0-255,66,61722,9,196956
7761,0.000512,172.217.194.0-255,4320,66042,9,196956
7762,0.000514,172.31.36.0-255,66,66108,9,196956
7763,0.000526,172.217.194.0-255,1484,67592,9,196956
7764,0.000544,172.217.194.0-255,4258,71850,9,196956
7765,0.000547,172.31.36.0-255,66,71916,9,196956
7766,0.00059,172.217.194.0-255,2902,74818,9,196956
7767,0.000592,172.31.36.0-255,66,74884,9,196956
7768,0.000625,172.217.194.0-255,4320,79204,9,196956
7769,0.000628,172.31.36.0-255,66,79270,9,196956
7770,0.000662,172.31.36.0-255,66,79336,9,196956
7771,0.00073,172.31.36.0-255,66,79402,9,196956
7772,0.000737,172.217.194.0-255,5738,85140,9,196956
7773,0.000739,172.31.36.0-255,66,85206,9,196956
7774,0.000769,172.217.194.0-255,2184,87390,9,196956
7775,0.000771,172.31.36.0-255,66,87456,9,196956
7776,0.000808,172.217.194.0-255,1484,88940,9,196956
7777,0.000821,172.217.194.0-255,2902,91842,9,196956
7778,0.000823,172.31.36.0-255,66,91908,9,196956
7779,0.000848,172.217.194.0-255,5738,97646,9,196956
7780,0.000851,172.31.36.0-255,66,97712,9,196956
7781,0.000856,172.217.194.0-255,4320,102032,9,196956
7782,0.000858,172.31.36.0-255,66,102098,9,196956
7783,0.000899,172.217.194.0-255,1484,103582,9,196956
7784,0.000923,172.217.194.0-255,6438,110020,9,196956
7785,0.000977,172.217.194.0-255,1484,111504,9,196956
7786,0.000992,172.217.194.0-255,1484,112988,9,196956
7787,0.001005,172.217.194.0-255,1484,114472,9,196956
7788,0.001008,172.217.194.0-255,1484,115956,9,196956
7789,0.001028,172.217.194.0-255,4320,120276,9,196956
7790,0.001036,172.217.194.0-255,7156,127432,9,196956
7791,0.001052,172.217.194.0-255,5738,133170,9,196956
7792,0.00112,172.31.36.0-255,66,133236,9,196956
7793,0.002054,172.217.194.0-255,1484,134720,9,196956
7794,0.00206,172.217.194.0-255,2902,137622,9,196956
7795,0.002064,172.31.36.0-255,66,137688,9,196956
7796,0.002079,172.217.194.0-255,4320,142008,9,196956
7797,0.002092,172.31.36.0-255,66,142074,9,196956
7798,0.002123,172.217.194.0-255,1484,143558,9,196956
7799,0.002138,172.31.36.0-255,66,143624,9,196956
7800,0.002156,172.31.36.0-255,66,143690,9,196956
7801,0.00224,172.217.194.0-255,1484,145174,9,196956
7802,0.002258,172.217.194.0-255,2902,148076,9,196956
7803,0.002261,172.31.36.0-255,66,148142,9,196956
7804,0.002269,172.217.194.0-255,5738,153880,9,196956
7805,0.002271,172.31.36.0-255,66,153946,9,196956
7806,0.002282,172.217.194.0-255,5738,159684,9,196956
7807,0.002284,172.31.36.0-255,66,159750,9,196956
7808,0.002294,172.217.194.0-255,2902,162652,9,196956
7809,0.002296,172.31.36.0-255,66,162718,9,196956
7810,0.002337,172.31.36.0-255,66,162784,9,196956
7811,0.002345,172.217.194.0-255,7156,169940,9,196956
7812,0.002347,172.31.36.0-255,66,170006,9,196956
7813,0.00238,172.217.194.0-255,5020,175026,9,196956
7814,0.002383,172.31.36.0-255,66,175092,9,196956
7815,0.002452,172.217.194.0-255,1484,176576,9,196956
7816,0.002456,172.217.194.0-255,2902,179478,9,196956
7817,0.002469,172.31.36.0-255,66,179544,9,196956
7818,0.004911,172.217.194.0-255,5738,185282,9,196956
7819,0.004919,172.31.36.0-255,66,185348,9,196956
7820,0.007338,172.217.194.0-255,5738,191086,9,196956
7821,0.007342,172.31.36.0-255,66,191152,9,196956
7822,0.009787,172.217.194.0-255,5738,196890,9,196956
7823,0.009793,172.31.36.0-255,66,196956,9,196956
7824,0.0,74.125.24.0-255,152,152,9,83671
7825,1.6e-05,172.31.36.0-255,66,218,9,83671
7826,4.9e-05,74.125.24.0-255,1484,1702,9,83671
7827,5.4e-05,172.31.36.0-255,66,1768,9,83671
7828,5.8e-05,74.125.24.0-255,1484,3252,9,83671
7829,6.1e-05,172.31.36.0-255,66,3318,9,83671
7830,8.2e-05,74.125.24.0-255,1484,4802,9,83671
7831,8.5e-05,172.31.36.0-255,66,4868,9,83671
7832,9.7e-05,74.125.24.0-255,7156,12024,9,83671
7833,0.0001,172.31.36.0-255,66,12090,9,83671
7834,0.000105,74.125.24.0-255,2020,14110,9,83671
7835,0.000107,172.31.36.0-255,66,14176,9,83671
7836,0.000163,74.125.24.0-255,1484,15660,9,83671
7837,0.000168,172.31.36.0-255,66,15726,9,83671
7838,0.000174,74.125.24.0-255,2902,18628,9,83671
7839,0.000176,172.31.36.0-255,66,18694,9,83671
7840,0.00018,74.125.24.0-255,1484,20178,9,83671
7841,0.000182,172.31.36.0-255,66,20244,9,83671
7842,0.000215,74.125.24.0-255,4320,24564,9,83671
7843,0.000224,172.31.36.0-255,66,24630,9,83671
7844,0.00023,74.125.24.0-255,5738,30368,9,83671
7845,0.000233,172.31.36.0-255,66,30434,9,83671
7846,0.000272,74.125.24.0-255,3961,34395,9,83671
7847,0.000276,172.31.36.0-255,66,34461,9,83671
7848,0.000282,74.125.24.0-255,4320,38781,9,83671
7849,0.000285,172.31.36.0-255,66,38847,9,83671
7850,0.000302,172.31.36.0-255,66,38913,9,83671
7851,0.001255,74.125.24.0-255,1484,40397,9,83671
7852,0.001261,172.31.36.0-255,66,40463,9,83671
7853,0.001268,74.125.24.0-255,1484,41947,9,83671
7854,0.001271,172.31.36.0-255,66,42013,9,83671
7855,0.001276,74.125.24.0-255,2902,44915,9,83671
7856,0.001283,172.31.36.0-255,66,44981,9,83671
7857,0.001288,74.125.24.0-255,2902,47883,9,83671
7858,0.00129,172.31.36.0-255,66,47949,9,83671
7859,0.001319,74.125.24.0-255,2902,50851,9,83671
7860,0.001326,172.31.36.0-255,66,50917,9,83671
7861,0.001333,74.125.24.0-255,5379,56296,9,83671
7862,0.001334,172.31.36.0-255,66,56362,9,83671
7863,0.001371,172.31.36.0-255,66,56428,9,83671
7864,0.001376,74.125.24.0-255,3961,60389,9,83671
7865,0.001377,172.31.36.0-255,66,60455,9,83671
7866,0.003347,74.125.24.0-255,5738,66193,9,83671
7867,0.003352,172.31.36.0-255,66,66259,9,83671
7868,0.005309,74.125.24.0-255,5738,71997,9,83671
7869,0.005313,172.31.36.0-255,66,72063,9,83671
7870,0.007259,74.125.24.0-255,5738,77801,9,83671
7871,0.007265,172.31.36.0-255,66,77867,9,83671
7872,0.009236,74.125.24.0-255,5738,83605,9,83671
7873,0.009243,172.31.36.0-255,66,83671,9,83671
7874,0.0,172.31.36.0-255,105,105,9,105
7875,0.0,172.31.36.0-255,105,105,9,105
7876,0.0,74.125.200.0-255,153,153,9,130922
7877,2.4e-05,172.31.36.0-255,66,219,9,130922
7878,3.1e-05,74.125.200.0-255,1484,1703,9,130922
7879,3.7e-05,172.31.36.0-255,66,1769,9,130922
7880,5e-05,74.125.200.0-255,2902,4671,9,130922
7881,5.4e-05,172.31.36.0-255,66,4737,9,130922
7882,6.2e-05,74.125.200.0-255,5738,10475,9,130922
7883,6.5e-05,172.31.36.0-255,66,10541,9,130922
7884,6.9e-05,74.125.200.0-255,1484,12025,9,130922
7885,7.2e-05,172.31.36.0-255,66,12091,9,130922
7886,0.000117,172.31.36.0-255,66,12157,9,130922
7887,0.000169,172.31.36.0-255,66,12223,9,130922
7888,0.000196,74.125.200.0-255,1484,13707,9,130922
7889,0.000198,172.31.36.0-255,66,13773,9,130922
7890,0.000203,74.125.200.0-255,2902,16675,9,130922
7891,0.000205,172.31.36.0-255,66,16741,9,130922
7892,0.000235,74.125.200.0-255,5738,22479,9,130922
7893,0.000238,172.31.36.0-255,66,22545,9,130922
7894,0.000245,74.125.200.0-255,5738,28283,9,130922
7895,0.000247,172.31.36.0-255,66,28349,9,130922
7896,0.000275,74.125.200.0-255,1125,29474,9,130922
7897,0.000277,172.31.36.0-255,66,29540,9,130922
7898,0.00031,172.31.36.0-255,66,29606,9,130922
7899,0.000363,172.31.36.0-255,66,29672,9,130922
7900,0.000387,74.125.200.0-255,110,29782,9,130922
7901,0.000389,172.31.36.0-255,66,29848,9,130922
7902,0.000452,74.125.200.0-255,330,30178,9,130922
7903,0.000455,172.31.36.0-255,66,30244,9,130922
7904,0.000488,74.125.200.0-255,1484,31728,9,130922
7905,0.00049,172.31.36.0-255,66,31794,9,130922
7906,0.000517,74.125.200.0-255,2902,34696,9,130922
7907,0.000521,172.31.36.0-255,66,34762,9,130922
7908,0.000524,74.125.200.0-255,1484,36246,9,130922
7909,0.000526,172.31.36.0-255,66,36312,9,130922
7910,0.000531,74.125.200.0-255,2902,39214,9,130922
7911,0.000533,172.31.36.0-255,66,39280,9,130922
7912,0.00056,74.125.200.0-255,2902,42182,9,130922
7913,0.000562,172.31.36.0-255,66,42248,9,130922
7914,0.000573,74.125.200.0-255,4830,47078,9,130922
7915,0.000575,172.31.36.0-255,66,47144,9,130922
7916,0.001167,74.125.200.0-255,1484,48628,9,130922
7917,0.001172,172.31.36.0-255,66,48694,9,130922
7918,0.001179,74.125.200.0-255,2902,51596,9,130922
7919,0.001181,172.31.36.0-255,66,51662,9,130922
7920,0.001254,74.125.200.0-255,1484,53146,9,130922
7921,0.001258,172.31.36.0-255,66,53212,9,130922
7922,0.001288,74.125.200.0-255,4320,57532,9,130922
7923,0.001291,172.31.36.0-255,66,57598,9,130922
7924,0.001296,74.125.200.0-255,2902,60500,9,130922
7925,0.001298,172.31.36.0-255,66,60566,9,130922
7926,0.001308,74.125.200.0-255,4320,64886,9,130922
7927,0.00131,172.31.36.0-255,66,64952,9,130922
7928,0.001321,172.31.36.0-255,66,65018,9,130922
7929,0.001327,74.125.200.0-255,5738,70756,9,130922
7930,0.00133,172.31.36.0-255,66,70822,9,130922
7931,0.001333,74.125.200.0-255,2184,73006,9,130922
7932,0.001335,172.31.36.0-255,66,73072,9,130922
7933,0.001705,74.125.200.0-255,1484,74556,9,130922
7934,0.00171,172.31.36.0-255,66,74622,9,130922
7935,0.001717,74.125.200.0-255,2902,77524,9,130922
7936,0.001718,172.31.36.0-255,66,77590,9,130922
7937,0.001736,74.125.200.0-255,1484,79074,9,130922
7938,0.001738,172.31.36.0-255,66,79140,9,130922
7939,0.001772,74.125.200.0-255,2902,82042,9,130922
7940,0.001775,172.31.36.0-255,66,82108,9,130922
7941,0.001779,74.125.200.0-255,1484,83592,9,130922
7942,0.001781,172.31.36.0-255,66,83658,9,130922
7943,0.001808,74.125.200.0-255,2902,86560,9,130922
7944,0.00181,172.31.36.0-255,66,86626,9,130922
7945,0.001824,74.125.200.0-255,5738,92364,9,130922
7946,0.001826,172.31.36.0-255,66,92430,9,130922
7947,0.001889,74.125.200.0-255,4320,96750,9,130922
7948,0.001893,172.31.36.0-255,66,96816,9,130922
7949,0.0019,74.125.200.0-255,5738,102554,9,130922
7950,0.001902,172.31.36.0-255,66,102620,9,130922
7951,0.001942,74.125.200.0-255,5020,107640,9,130922
7952,0.001945,172.31.36.0-255,66,107706,9,130922
7953,0.00392,74.125.200.0-255,5738,113444,9,130922
7954,0.003927,172.31.36.0-255,66,113510,9,130922
7955,0.005894,74.125.200.0-255,5738,119248,9,130922
7956,0.005898,172.31.36.0-255,66,119314,9,130922
7957,0.007861,74.125.200.0-255,5738,125052,9,130922
7958,0.007868,172.31.36.0-255,66,125118,9,130922
7959,0.009838,74.125.200.0-255,5738,130856,9,130922
7960,0.009846,172.31.36.0-255,66,130922,9,130922
7961,0.0,172.217.194.0-255,153,153,9,268828
7962,3.1e-05,172.217.194.0-255,1484,1637,9,268828
7963,4.1e-05,172.31.36.0-255,66,1703,9,268828
7964,4.8e-05,172.217.194.0-255,2902,4605,9,268828
7965,5.2e-05,172.31.36.0-255,66,4671,9,268828
7966,6.8e-05,172.217.194.0-255,7156,11827,9,268828
7967,7.2e-05,172.31.36.0-255,66,11893,9,268828
7968,7.5e-05,172.217.194.0-255,2039,13932,9,268828
7969,7.8e-05,172.31.36.0-255,66,13998,9,268828
7970,9.4e-05,172.217.194.0-255,2902,16900,9,268828
7971,9.7e-05,172.31.36.0-255,66,16966,9,268828
7972,0.000152,172.31.36.0-255,66,17032,9,268828
7973,0.00016,172.217.194.0-255,5379,22411,9,268828
7974,0.000162,172.31.36.0-255,66,22477,9,268828
7975,0.000188,172.217.194.0-255,1484,23961,9,268828
7976,0.000214,172.217.194.0-255,2902,26863,9,268828
7977,0.000219,172.31.36.0-255,66,26929,9,268828
7978,0.000252,172.217.194.0-255,5738,32667,9,268828
7979,0.000256,172.31.36.0-255,66,32733,9,268828
7980,0.000262,172.217.194.0-255,4320,37053,9,268828
7981,0.000265,172.31.36.0-255,66,37119,9,268828
7982,0.000296,172.217.194.0-255,5379,42498,9,268828
7983,0.0003,172.31.36.0-255,66,42564,9,268828
7984,0.000306,172.217.194.0-255,2902,45466,9,268828
7985,0.000308,172.31.36.0-255,66,45532,9,268828
7986,0.000333,172.217.194.0-255,4320,49852,9,268828
7987,0.000337,172.31.36.0-255,66,49918,9,268828
7988,0.000344,172.217.194.0-255,6797,56715,9,268828
7989,0.000347,172.31.36.0-255,66,56781,9,268828
7990,0.000403,172.217.194.0-255,677,57458,9,268828
7991,0.000408,172.217.194.0-255,1484,58942,9,268828
7992,0.000411,172.31.36.0-255,66,59008,9,268828
7993,0.00044,172.217.194.0-255,4320,63328,9,268828
7994,0.000444,172.31.36.0-255,66,63394,9,268828
7995,0.000449,172.217.194.0-255,2902,66296,9,268828
7996,0.000451,172.31.36.0-255,66,66362,9,268828
7997,0.000488,172.217.194.0-255,5738,72100,9,268828
7998,0.000492,172.31.36.0-255,66,72166,9,268828
7999,0.000497,172.217.194.0-255,2543,74709,9,268828
8000,0.000499,172.31.36.0-255,66,74775,9,268828
8001,0.000503,172.217.194.0-255,2902,77677,9,268828
8002,0.000507,172.31.36.0-255,66,77743,9,268828
8003,0.000514,172.217.194.0-255,7156,84899,9,268828
8004,0.000518,172.31.36.0-255,66,84965,9,268828
8005,0.000555,172.217.194.0-255,6797,91762,9,268828
8006,0.00056,172.31.36.0-255,66,91828,9,268828
8007,0.001278,172.217.194.0-255,1484,93312,9,268828
8008,0.001289,172.217.194.0-255,2902,96214,9,268828
8009,0.001294,172.31.36.0-255,66,96280,9,268828
8010,0.001303,172.217.194.0-255,5738,102018,9,268828
8011,0.001306,172.31.36.0-255,66,102084,9,268828
8012,0.001325,172.31.36.0-255,66,102150,9,268828
8013,0.00139,172.217.194.0-255,7156,109306,9,268828
8014,0.001394,172.31.36.0-255,66,109372,9,268828
8015,0.001433,172.31.36.0-255,66,109438,9,268828
8016,0.00187,172.217.194.0-255,1484,110922,9,268828
8017,0.001877,172.217.194.0-255,2902,113824,9,268828
8018,0.001881,172.31.36.0-255,66,113890,9,268828
8019,0.001888,172.217.194.0-255,5738,119628,9,268828
8020,0.001891,172.31.36.0-255,66,119694,9,268828
8021,0.001936,172.31.36.0-255,66,119760,9,268828
8022,0.001954,172.217.194.0-255,2902,122662,9,268828
8023,0.001956,172.31.36.0-255,66,122728,9,268828
8024,0.00196,172.217.194.0-255,2902,125630,9,268828
8025,0.001962,172.31.36.0-255,66,125696,9,268828
8026,0.001997,172.31.36.0-255,66,125762,9,268828
8027,0.002031,172.217.194.0-255,1484,127246,9,268828
8028,0.002036,172.217.194.0-255,2902,130148,9,268828
8029,0.002038,172.31.36.0-255,66,130214,9,268828
8030,0.002065,172.217.194.0-255,5738,135952,9,268828
8031,0.002068,172.31.36.0-255,66,136018,9,268828
8032,0.00209,172.217.194.0-255,5738,141756,9,268828
8033,0.002092,172.31.36.0-255,66,141822,9,268828
8034,0.002104,172.31.36.0-255,66,141888,9,268828
8035,0.002139,172.217.194.0-255,2902,144790,9,268828
8036,0.002141,172.31.36.0-255,66,144856,9,268828
8037,0.002147,172.217.194.0-255,5020,149876,9,268828
8038,0.002151,172.31.36.0-255,66,149942,9,268828
8039,0.002281,172.217.194.0-255,1484,151426,9,268828
8040,0.002292,172.217.194.0-255,2902,154328,9,268828
8041,0.002295,172.31.36.0-255,66,154394,9,268828
8042,0.002297,172.217.194.0-255,1484,155878,9,268828
8043,0.002321,172.217.194.0-255,4320,160198,9,268828
8044,0.002324,172.31.36.0-255,66,160264,9,268828
8045,0.002335,172.31.36.0-255,66,160330,9,268828
8046,0.00238,172.31.36.0-255,66,160396,9,268828
8047,0.002407,172.217.194.0-255,5020,165416,9,268828
8048,0.002409,172.31.36.0-255,66,165482,9,268828
8049,0.002438,172.217.194.0-255,1484,166966,9,268828
8050,0.002442,172.217.194.0-255,2902,169868,9,268828
8051,0.002444,172.31.36.0-255,66,169934,9,268828
8052,0.002469,172.217.194.0-255,5738,175672,9,268828
8053,0.002472,172.31.36.0-255,66,175738,9,268828
8054,0.002518,172.217.194.0-255,2902,178640,9,268828
8055,0.00252,172.31.36.0-255,66,178706,9,268828
8056,0.002569,172.217.194.0-255,2902,181608,9,268828
8057,0.002573,172.31.36.0-255,66,181674,9,268828
8058,0.002576,172.217.194.0-255,1484,183158,9,268828
8059,0.00258,172.217.194.0-255,1484,184642,9,268828
8060,0.002581,172.31.36.0-255,66,184708,9,268828
8061,0.002586,172.217.194.0-255,2902,187610,9,268828
8062,0.002588,172.31.36.0-255,66,187676,9,268828
8063,0.002592,172.217.194.0-255,4320,191996,9,268828
8064,0.002624,172.31.36.0-255,66,192062,9,268828
8065,0.002626,172.31.36.0-255,66,192128,9,268828
8066,0.002662,172.217.194.0-255,1484,193612,9,268828
8067,0.002667,172.217.194.0-255,2902,196514,9,268828
8068,0.002671,172.31.36.0-255,66,196580,9,268828
8069,0.0027,172.217.194.0-255,5738,202318,9,268828
8070,0.002703,172.31.36.0-255,66,202384,9,268828
8071,0.002709,172.217.194.0-255,5738,208122,9,268828
8072,0.002711,172.31.36.0-255,66,208188,9,268828
8073,0.002714,172.217.194.0-255,1484,209672,9,268828
8074,0.002716,172.217.194.0-255,1484,211156,9,268828
8075,0.002718,172.31.36.0-255,66,211222,9,268828
8076,0.002773,172.31.36.0-255,66,211288,9,268828
8077,0.002776,172.217.194.0-255,1484,212772,9,268828
8078,0.002805,172.217.194.0-255,2184,214956,9,268828
8079,0.002807,172.31.36.0-255,66,215022,9,268828
8080,0.002846,172.217.194.0-255,1484,216506,9,268828
8081,0.002863,172.217.194.0-255,2902,219408,9,268828
8082,0.002866,172.31.36.0-255,66,219474,9,268828
8083,0.002891,172.217.194.0-255,5738,225212,9,268828
8084,0.002893,172.31.36.0-255,66,225278,9,268828
8085,0.002899,172.217.194.0-255,7156,232434,9,268828
8086,0.002901,172.31.36.0-255,66,232500,9,268828
8087,0.002906,172.217.194.0-255,4320,236820,9,268828
8088,0.002909,172.31.36.0-255,66,236886,9,268828
8089,0.002957,172.31.36.0-255,66,236952,9,268828
8090,0.00296,172.217.194.0-255,2184,239136,9,268828
8091,0.002962,172.31.36.0-255,66,239202,9,268828
8092,0.002965,172.217.194.0-255,1484,240686,9,268828
8093,0.002971,172.217.194.0-255,7156,247842,9,268828
8094,0.002974,172.31.36.0-255,66,247908,9,268828
8095,0.002985,172.31.36.0-255,66,247974,9,268828
8096,0.00302,172.217.194.0-255,4320,252294,9,268828
8097,0.003022,172.31.36.0-255,66,252360,9,268828
8098,0.003034,172.31.36.0-255,66,252426,9,268828
8099,0.003039,172.217.194.0-255,4320,256746,9,268828
8100,0.003041,172.31.36.0-255,66,256812,9,268828
8101,0.003052,172.31.36.0-255,66,256878,9,268828
8102,0.003082,172.217.194.0-255,7156,264034,9,268828
8103,0.003084,172.31.36.0-255,66,264100,9,268828
8104,0.003097,172.31.36.0-255,66,264166,9,268828
8105,0.003102,172.217.194.0-255,4320,268486,9,268828
8106,0.003104,172.31.36.0-255,66,268552,9,268828
8107,0.003114,172.31.36.0-255,66,268618,9,268828
8108,0.003117,172.217.194.0-255,105,268723,9,268828
8109,0.009012,172.31.36.0-255,105,268828,9,268828
8110,0.0,74.125.24.0-255,297,297,9,143533
8111,1.1e-05,172.31.36.0-255,66,363,9,143533
8112,3.2e-05,74.125.24.0-255,1484,1847,9,143533
8113,3.6e-05,172.31.36.0-255,66,1913,9,143533
8114,4.4e-05,74.125.24.0-255,4320,6233,9,143533
8115,4.8e-05,172.31.36.0-255,66,6299,9,143533
8116,9.6e-05,172.31.36.0-255,66,6365,9,143533
8117,0.000135,74.125.24.0-255,7156,13521,9,143533
8118,0.000138,172.31.36.0-255,66,13587,9,143533
8119,0.000163,74.125.24.0-255,2902,16489,9,143533
8120,0.000166,172.31.36.0-255,66,16555,9,143533
8121,0.000212,74.125.24.0-255,1484,18039,9,143533
8122,0.000215,172.31.36.0-255,66,18105,9,143533
8123,0.000243,74.125.24.0-255,3961,22066,9,143533
8124,0.000247,172.31.36.0-255,66,22132,9,143533
8125,0.000276,74.125.24.0-255,5738,27870,9,143533
8126,0.000279,172.31.36.0-255,66,27936,9,143533
8127,0.000329,172.31.36.0-255,66,28002,9,143533
8128,0.00036,74.125.24.0-255,3961,31963,9,143533
8129,0.000362,172.31.36.0-255,66,32029,9,143533
8130,0.000417,74.125.24.0-255,5738,37767,9,143533
8131,0.000421,172.31.36.0-255,66,37833,9,143533
8132,0.000437,74.125.24.0-255,1484,39317,9,143533
8133,0.00044,172.31.36.0-255,66,39383,9,143533
8134,0.000489,172.31.36.0-255,66,39449,9,143533
8135,0.000526,74.125.24.0-255,414,39863,9,143533
8136,0.000529,172.31.36.0-255,66,39929,9,143533
8137,0.000579,74.125.24.0-255,1484,41413,9,143533
8138,0.000582,172.31.36.0-255,66,41479,9,143533
8139,0.000587,74.125.24.0-255,2902,44381,9,143533
8140,0.000604,172.31.36.0-255,66,44447,9,143533
8141,0.000611,74.125.24.0-255,5738,50185,9,143533
8142,0.000621,172.31.36.0-255,66,50251,9,143533
8143,0.000649,74.125.24.0-255,2902,53153,9,143533
8144,0.000663,172.31.36.0-255,66,53219,9,143533
8145,0.000688,172.31.36.0-255,66,53285,9,143533
8146,0.000778,74.125.24.0-255,2184,55469,9,143533
8147,0.000783,172.31.36.0-255,66,55535,9,143533
8148,0.000789,172.31.36.0-255,66,55601,9,143533
8149,0.001742,74.125.24.0-255,1484,57085,9,143533
8150,0.001753,74.125.24.0-255,2902,59987,9,143533
8151,0.001758,172.31.36.0-255,66,60053,9,143533
8152,0.001766,74.125.24.0-255,5738,65791,9,143533
8153,0.001812,74.125.24.0-255,7156,72947,9,143533
8154,0.001828,74.125.24.0-255,5738,78685,9,143533
8155,0.002037,74.125.24.0-255,1484,80169,9,143533
8156,0.002045,74.125.24.0-255,2902,83071,9,143533
8157,0.002057,74.125.24.0-255,1484,84555,9,143533
8158,0.002073,74.125.24.0-255,4320,88875,9,143533
8159,0.002129,74.125.24.0-255,5738,94613,9,143533
8160,0.002159,74.125.24.0-255,7156,101769,9,143533
8161,0.00222,74.125.24.0-255,7156,108925,9,143533
8162,0.002239,74.125.24.0-255,3602,112527,9,143533
8163,0.002396,74.125.24.0-255,1484,114011,9,143533
8164,0.002416,74.125.24.0-255,7156,121167,9,143533
8165,0.002436,74.125.24.0-255,7156,128323,9,143533
8166,0.002533,74.125.24.0-255,7156,135479,9,143533
8167,0.002547,74.125.24.0-255,2184,137663,9,143533
8168,0.007596,172.31.36.0-255,66,137729,9,143533
8169,0.009961,74.125.24.0-255,5738,143467,9,143533
8170,0.009969,172.31.36.0-255,66,143533,9,143533
8171,0.0,172.217.194.0-255,153,153,9,196272
8172,1.6e-05,172.217.194.0-255,1484,1637,9,196272
8173,2.4e-05,172.31.36.0-255,66,1703,9,196272
8174,3.3e-05,172.217.194.0-255,2902,4605,9,196272
8175,3.7e-05,172.31.36.0-255,66,4671,9,196272
8176,4.5e-05,172.217.194.0-255,7156,11827,9,196272
8177,4.9e-05,172.31.36.0-255,66,11893,9,196272
8178,5.3e-05,172.217.194.0-255,2041,13934,9,196272
8179,5.6e-05,172.31.36.0-255,66,14000,9,196272
8180,0.00012,172.217.194.0-255,5738,19738,9,196272
8181,0.000124,172.31.36.0-255,66,19804,9,196272
8182,0.000132,172.217.194.0-255,7156,26960,9,196272
8183,0.000134,172.31.36.0-255,66,27026,9,196272
8184,0.000154,172.217.194.0-255,2902,29928,9,196272
8185,0.000156,172.31.36.0-255,66,29994,9,196272
8186,0.000178,172.217.194.0-255,1125,31119,9,196272
8187,0.000194,172.217.194.0-255,4320,35439,9,196272
8188,0.000203,172.31.36.0-255,66,35505,9,196272
8189,0.000207,172.217.194.0-255,1484,36989,9,196272
8190,0.000228,172.217.194.0-255,4320,41309,9,196272
8191,0.000231,172.31.36.0-255,66,41375,9,196272
8192,0.000242,172.31.36.0-255,66,41441,9,196272
8193,0.000259,172.217.194.0-255,3961,45402,9,196272
8194,0.000262,172.31.36.0-255,66,45468,9,196272
8195,0.000265,172.217.194.0-255,1484,46952,9,196272
8196,0.000299,172.31.36.0-255,66,47018,9,196272
8197,0.000324,172.217.194.0-255,117,47135,9,196272
8198,0.000352,172.217.194.0-255,382,47517,9,196272
8199,0.000539,172.217.194.0-255,1484,49001,9,196272
8200,0.000545,172.31.36.0-255,66,49067,9,196272
8201,0.000551,172.217.194.0-255,2902,51969,9,196272
8202,0.000554,172.31.36.0-255,66,52035,9,196272
8203,0.000561,172.217.194.0-255,5738,57773,9,196272
8204,0.000564,172.31.36.0-255,66,57839,9,196272
8205,0.000567,172.217.194.0-255,1484,59323,9,196272
8206,0.000591,172.217.194.0-255,4320,63643,9,196272
8207,0.000594,172.31.36.0-255,66,63709,9,196272
8208,0.000616,172.217.194.0-255,7156,70865,9,196272
8209,0.00062,172.31.36.0-255,66,70931,9,196272
8210,0.000641,172.31.36.0-255,66,70997,9,196272
8211,0.000643,172.217.194.0-255,766,71763,9,196272
8212,0.000707,172.217.194.0-255,1484,73247,9,196272
8213,0.000711,172.31.36.0-255,66,73313,9,196272
8214,0.000716,172.217.194.0-255,2902,76215,9,196272
8215,0.000719,172.31.36.0-255,66,76281,9,196272
8216,0.000725,172.217.194.0-255,5738,82019,9,196272
8217,0.000729,172.31.36.0-255,66,82085,9,196272
8218,0.000735,172.217.194.0-255,5738,87823,9,196272
8219,0.000737,172.31.36.0-255,66,87889,9,196272
8220,0.00074,172.217.194.0-255,1484,89373,9,196272
8221,0.000771,172.31.36.0-255,66,89439,9,196272
8222,0.000777,172.217.194.0-255,5020,94459,9,196272
8223,0.000779,172.31.36.0-255,66,94525,9,196272
8224,0.000786,172.217.194.0-255,5738,100263,9,196272
8225,0.000788,172.31.36.0-255,66,100329,9,196272
8226,0.000819,172.31.36.0-255,66,100395,9,196272
8227,0.000841,172.217.194.0-255,1484,101879,9,196272
8228,0.000855,172.31.36.0-255,66,101945,9,196272
8229,0.000876,172.217.194.0-255,3602,105547,9,196272
8230,0.000878,172.31.36.0-255,66,105613,9,196272
8231,0.001231,172.217.194.0-255,1484,107097,9,196272
8232,0.001237,172.217.194.0-255,2902,109999,9,196272
8233,0.001241,172.31.36.0-255,66,110065,9,196272
8234,0.001245,172.217.194.0-255,1484,111549,9,196272
8235,0.001264,172.217.194.0-255,4320,115869,9,196272
8236,0.001268,172.217.194.0-255,2902,118771,9,196272
8237,0.001272,172.31.36.0-255,66,118837,9,196272
8238,0.001275,172.31.36.0-255,66,118903,9,196272
8239,0.001303,172.31.36.0-255,66,118969,9,196272
8240,0.001314,172.31.36.0-255,66,119035,9,196272
8241,0.001317,172.217.194.0-255,766,119801,9,196272
8242,0.001378,172.217.194.0-255,1484,121285,9,196272
8243,0.001382,172.31.36.0-255,66,121351,9,196272
8244,0.001386,172.217.194.0-255,1484,122835,9,196272
8245,0.001401,172.217.194.0-255,1484,124319,9,196272
8246,0.001404,172.31.36.0-255,66,124385,9,196272
8247,0.001424,172.217.194.0-255,1484,125869,9,196272
8248,0.00144,172.217.194.0-255,4320,130189,9,196272
8249,0.001443,172.31.36.0-255,66,130255,9,196272
8250,0.001464,172.217.194.0-255,5738,135993,9,196272
8251,0.001467,172.31.36.0-255,66,136059,9,196272
8252,0.001502,172.217.194.0-255,7156,143215,9,196272
8253,0.001505,172.31.36.0-255,66,143281,9,196272
8254,0.001518,172.31.36.0-255,66,143347,9,196272
8255,0.001521,172.217.194.0-255,1484,144831,9,196272
8256,0.001543,172.217.194.0-255,2902,147733,9,196272
8257,0.001546,172.31.36.0-255,66,147799,9,196272
8258,0.001553,172.217.194.0-255,5738,153537,9,196272
8259,0.001555,172.31.36.0-255,66,153603,9,196272
8260,0.001591,172.31.36.0-255,66,153669,9,196272
8261,0.001613,172.217.194.0-255,4320,157989,9,196272
8262,0.001616,172.31.36.0-255,66,158055,9,196272
8263,0.001621,172.217.194.0-255,4320,162375,9,196272
8264,0.001623,172.31.36.0-255,66,162441,9,196272
8265,0.001641,172.217.194.0-255,6438,168879,9,196272
8266,0.001644,172.31.36.0-255,66,168945,9,196272
8267,0.001647,172.217.194.0-255,1484,170429,9,196272
8268,0.00165,172.217.194.0-255,1484,171913,9,196272
8269,0.001652,172.31.36.0-255,66,171979,9,196272
8270,0.001666,172.217.194.0-255,1484,173463,9,196272
8271,0.00169,172.217.194.0-255,2902,176365,9,196272
8272,0.001693,172.31.36.0-255,66,176431,9,196272
8273,0.001711,172.217.194.0-255,2902,179333,9,196272
8274,0.001714,172.31.36.0-255,66,179399,9,196272
8275,0.001736,172.217.194.0-255,4320,183719,9,196272
8276,0.001739,172.31.36.0-255,66,183785,9,196272
8277,0.001785,172.31.36.0-255,66,183851,9,196272
8278,0.001797,172.31.36.0-255,66,183917,9,196272
8279,0.001799,172.217.194.0-255,766,184683,9,196272
8280,0.001803,172.217.194.0-255,1484,186167,9,196272
8281,0.001805,172.31.36.0-255,66,186233,9,196272
8282,0.001811,172.217.194.0-255,4320,190553,9,196272
8283,0.001814,172.31.36.0-255,66,190619,9,196272
8284,0.001826,172.31.36.0-255,66,190685,9,196272
8285,0.001839,172.31.36.0-255,66,190751,9,196272
8286,0.001855,172.31.36.0-255,66,190817,9,196272
8287,0.001876,172.217.194.0-255,5020,195837,9,196272
8288,0.001878,172.31.36.0-255,66,195903,9,196272
8289,0.001923,172.31.36.0-255,66,195969,9,196272
8290,0.001964,172.31.36.0-255,66,196035,9,196272
8291,0.001981,172.31.36.0-255,66,196101,9,196272
8292,0.002005,172.31.36.0-255,66,196167,9,196272
8293,0.002008,172.217.194.0-255,105,196272,9,196272
8294,0.0,172.217.194.0-255,152,152,9,111246
8295,3.4e-05,172.31.36.0-255,66,218,9,111246
8296,4.1e-05,172.217.194.0-255,1484,1702,9,111246
8297,4.5e-05,172.31.36.0-255,66,1768,9,111246
8298,5e-05,172.217.194.0-255,2902,4670,9,111246
8299,6.2e-05,172.31.36.0-255,66,4736,9,111246
8300,6.8e-05,172.217.194.0-255,5738,10474,9,111246
8301,7e-05,172.31.36.0-255,66,10540,9,111246
8302,8.3e-05,172.217.194.0-255,1484,12024,9,111246
8303,8.5e-05,172.31.36.0-255,66,12090,9,111246
8304,0.000158,172.217.194.0-255,2048,14138,9,111246
8305,0.000163,172.31.36.0-255,66,14204,9,111246
8306,0.000193,172.217.194.0-255,2902,17106,9,111246
8307,0.000196,172.31.36.0-255,66,17172,9,111246
8308,0.000234,172.217.194.0-255,2902,20074,9,111246
8309,0.000237,172.31.36.0-255,66,20140,9,111246
8310,0.000263,172.217.194.0-255,4320,24460,9,111246
8311,0.000267,172.31.36.0-255,66,24526,9,111246
8312,0.000371,172.217.194.0-255,2902,27428,9,111246
8313,0.000375,172.31.36.0-255,66,27494,9,111246
8314,0.000396,172.217.194.0-255,3961,31455,9,111246
8315,0.000401,172.31.36.0-255,66,31521,9,111246
8316,0.000482,172.217.194.0-255,7156,38677,9,111246
8317,0.000486,172.31.36.0-255,66,38743,9,111246
8318,0.000549,172.217.194.0-255,4320,43063,9,111246
8319,0.000553,172.31.36.0-255,66,43129,9,111246
8320,0.000583,172.217.194.0-255,5379,48508,9,111246
8321,0.000587,172.31.36.0-255,66,48574,9,111246
8322,0.001123,172.217.194.0-255,1484,50058,9,111246
8323,0.001129,172.31.36.0-255,66,50124,9,111246
8324,0.001139,172.217.194.0-255,2902,53026,9,111246
8325,0.001141,172.31.36.0-255,66,53092,9,111246
8326,0.001152,172.217.194.0-255,1484,54576,9,111246
8327,0.00118,172.217.194.0-255,4320,58896,9,111246
8328,0.001265,172.217.194.0-255,3961,62857,9,111246
8329,0.001426,172.217.194.0-255,2902,65759,9,111246
8330,0.001436,172.217.194.0-255,2902,68661,9,111246
8331,0.001638,172.217.194.0-255,4320,72981,9,111246
8332,0.001655,172.217.194.0-255,4320,77301,9,111246
8333,0.001766,172.217.194.0-255,1484,78785,9,111246
8334,0.001787,172.217.194.0-255,2543,81328,9,111246
8335,0.001828,172.217.194.0-255,5738,87066,9,111246
8336,0.001886,172.217.194.0-255,2902,89968,9,111246
8337,0.002039,172.217.194.0-255,2902,92870,9,111246
8338,0.002443,172.217.194.0-255,766,93636,9,111246
8339,0.002456,172.31.36.0-255,66,93702,9,111246
8340,0.002762,172.31.36.0-255,66,93768,9,111246
8341,0.002817,172.31.36.0-255,66,93834,9,111246
8342,0.004854,172.217.194.0-255,5738,99572,9,111246
8343,0.004866,172.31.36.0-255,66,99638,9,111246
8344,0.006893,172.217.194.0-255,5738,105376,9,111246
8345,0.007847,172.31.36.0-255,66,105442,9,111246
8346,0.009876,172.217.194.0-255,5738,111180,9,111246
8347,0.009889,172.31.36.0-255,66,111246,9,111246
8348,0.0,74.125.68.0-255,150,150,9,349123
8349,1.7e-05,172.31.36.0-255,66,216,9,349123
8350,2.4e-05,74.125.68.0-255,1484,1700,9,349123
8351,2.8e-05,172.31.36.0-255,66,1766,9,349123
8352,3.2e-05,74.125.68.0-255,1484,3250,9,349123
8353,4.5e-05,172.31.36.0-255,66,3316,9,349123
8354,5.2e-05,74.125.68.0-255,2902,6218,9,349123
8355,5.5e-05,172.31.36.0-255,66,6284,9,349123
8356,6.1e-05,74.125.68.0-255,5738,12022,9,349123
8357,6.4e-05,172.31.36.0-255,66,12088,9,349123
8358,0.000107,74.125.68.0-255,2051,14139,9,349123
8359,0.00011,172.31.36.0-255,66,14205,9,349123
8360,0.000158,74.125.68.0-255,1484,15689,9,349123
8361,0.000162,172.31.36.0-255,66,15755,9,349123
8362,0.000167,74.125.68.0-255,2902,18657,9,349123
8363,0.00017,172.31.36.0-255,66,18723,9,349123
8364,0.000204,74.125.68.0-255,5738,24461,9,349123
8365,0.000206,172.31.36.0-255,66,24527,9,349123
8366,0.000239,74.125.68.0-255,6797,31324,9,349123
8367,0.000242,172.31.36.0-255,66,31390,9,349123
8368,0.000267,74.125.68.0-255,4320,35710,9,349123
8369,0.000269,172.31.36.0-255,66,35776,9,349123
8370,0.000296,74.125.68.0-255,2902,38678,9,349123
8371,0.000299,172.31.36.0-255,66,38744,9,349123
8372,0.000303,74.125.68.0-255,2902,41646,9,349123
8373,0.000305,172.31.36.0-255,66,41712,9,349123
8374,0.000314,74.125.68.0-255,4320,46032,9,349123
8375,0.000317,172.31.36.0-255,66,46098,9,349123
8376,0.000321,74.125.68.0-255,2543,48641,9,349123
8377,0.000324,172.31.36.0-255,66,48707,9,349123
8378,0.000378,74.125.68.0-255,1484,50191,9,349123
8379,0.000381,172.31.36.0-255,66,50257,9,349123
8380,0.000387,74.125.68.0-255,2902,53159,9,349123
8381,0.000389,172.31.36.0-255,66,53225,9,349123
8382,0.000419,74.125.68.0-255,5738,58963,9,349123
8383,0.000422,172.31.36.0-255,66,59029,9,349123
8384,0.000454,74.125.68.0-255,5738,64767,9,349123
8385,0.000457,172.31.36.0-255,66,64833,9,349123
8386,0.00048,74.125.68.0-255,1459,66292,9,349123
8387,0.000506,74.125.68.0-255,353,66645,9,349123
8388,0.000509,172.31.36.0-255,66,66711,9,349123
8389,0.000596,74.125.68.0-255,1484,68195,9,349123
8390,0.0006,74.125.68.0-255,1484,69679,9,349123
8391,0.000603,172.31.36.0-255,66,69745,9,349123
8392,0.00063,74.125.68.0-255,1484,71229,9,349123
8393,0.000637,74.125.68.0-255,5738,76967,9,349123
8394,0.00064,172.31.36.0-255,66,77033,9,349123
8395,0.000648,74.125.68.0-255,6797,83830,9,349123
8396,0.000651,172.31.36.0-255,66,83896,9,349123
8397,0.00072,74.125.68.0-255,4320,88216,9,349123
8398,0.000723,172.31.36.0-255,66,88282,9,349123
8399,0.00075,74.125.68.0-255,5738,94020,9,349123
8400,0.000752,172.31.36.0-255,66,94086,9,349123
8401,0.00076,74.125.68.0-255,6797,100883,9,349123
8402,0.000762,172.31.36.0-255,66,100949,9,349123
8403,0.000944,74.125.68.0-255,1484,102433,9,349123
8404,0.000963,74.125.68.0-255,2902,105335,9,349123
8405,0.000968,172.31.36.0-255,66,105401,9,349123
8406,0.000998,74.125.68.0-255,4320,109721,9,349123
8407,0.001001,172.31.36.0-255,66,109787,9,349123
8408,0.001008,74.125.68.0-255,5738,115525,9,349123
8409,0.00101,172.31.36.0-255,66,115591,9,349123
8410,0.001056,172.31.36.0-255,66,115657,9,349123
8411,0.001062,74.125.68.0-255,4320,119977,9,349123
8412,0.001065,172.31.36.0-255,66,120043,9,349123
8413,0.001103,74.125.68.0-255,3602,123645,9,349123
8414,0.001106,172.31.36.0-255,66,123711,9,349123
8415,0.00111,74.125.68.0-255,1484,125195,9,349123
8416,0.001126,74.125.68.0-255,2902,128097,9,349123
8417,0.001129,172.31.36.0-255,66,128163,9,349123
8418,0.001132,74.125.68.0-255,1484,129647,9,349123
8419,0.001151,74.125.68.0-255,4320,133967,9,349123
8420,0.001153,172.31.36.0-255,66,134033,9,349123
8421,0.001159,74.125.68.0-255,4320,138353,9,349123
8422,0.001161,172.31.36.0-255,66,138419,9,349123
8423,0.001185,74.125.68.0-255,2902,141321,9,349123
8424,0.001187,172.31.36.0-255,66,141387,9,349123
8425,0.001199,74.125.68.0-255,5738,147125,9,349123
8426,0.001202,172.31.36.0-255,66,147191,9,349123
8427,0.001232,74.125.68.0-255,7156,154347,9,349123
8428,0.001235,74.125.68.0-255,1484,155831,9,349123
8429,0.001241,172.31.36.0-255,66,155897,9,349123
8430,0.001267,74.125.68.0-255,2184,158081,9,349123
8431,0.00127,172.31.36.0-255,66,158147,9,349123
8432,0.001276,74.125.68.0-255,4320,162467,9,349123
8433,0.001278,172.31.36.0-255,66,162533,9,349123
8434,0.001308,74.125.68.0-255,7156,169689,9,349123
8435,0.001311,172.31.36.0-255,66,169755,9,349123
8436,0.001318,74.125.68.0-255,7156,176911,9,349123
8437,0.001321,172.31.36.0-255,66,176977,9,349123
8438,0.00135,74.125.68.0-255,1484,178461,9,349123
8439,0.001364,74.125.68.0-255,766,179227,9,349123
8440,0.001369,172.31.36.0-255,66,179293,9,349123
8441,0.001404,74.125.68.0-255,1484,180777,9,349123
8442,0.001406,172.31.36.0-255,66,180843,9,349123
8443,0.001426,74.125.68.0-255,4320,185163,9,349123
8444,0.001429,172.31.36.0-255,66,185229,9,349123
8445,0.001465,74.125.68.0-255,7156,192385,9,349123
8446,0.001469,172.31.36.0-255,66,192451,9,349123
8447,0.001473,74.125.68.0-255,1484,193935,9,349123
8448,0.001506,74.125.68.0-255,7156,201091,9,349123
8449,0.00151,172.31.36.0-255,66,201157,9,349123
8450,0.001528,172.31.36.0-255,66,201223,9,349123
8451,0.001688,74.125.68.0-255,1484,202707,9,349123
8452,0.001693,74.125.68.0-255,1484,204191,9,349123
8453,0.001696,172.31.36.0-255,66,204257,9,349123
8454,0.001723,74.125.68.0-255,1484,205741,9,349123
8455,0.001729,74.125.68.0-255,5738,211479,9,349123
8456,0.001733,172.31.36.0-255,66,211545,9,349123
8457,0.001761,74.125.68.0-255,2902,214447,9,349123
8458,0.001764,172.31.36.0-255,66,214513,9,349123
8459,0.001775,74.125.68.0-255,4320,218833,9,349123
8460,0.001795,74.125.68.0-255,2902,221735,9,349123
8461,0.001815,74.125.68.0-255,5738,227473,9,349123
8462,0.001833,74.125.68.0-255,2902,230375,9,349123
8463,0.001839,74.125.68.0-255,4320,234695,9,349123
8464,0.001841,74.125.68.0-255,766,235461,9,349123
8465,0.001977,74.125.68.0-255,1484,236945,9,349123
8466,0.001982,74.125.68.0-255,1484,238429,9,349123
8467,0.001992,74.125.68.0-255,1484,239913,9,349123
8468,0.001996,74.125.68.0-255,2902,242815,9,349123
8469,0.002014,74.125.68.0-255,4320,247135,9,349123
8470,0.002027,74.125.68.0-255,1484,248619,9,349123
8471,0.002052,74.125.68.0-255,7156,255775,9,349123
8472,0.002058,74.125.68.0-255,2902,258677,9,349123
8473,0.002072,74.125.68.0-255,2902,261579,9,349123
8474,0.002084,74.125.68.0-255,1484,263063,9,349123
8475,0.0021,74.125.68.0-255,5738,268801,9,349123
8476,0.002103,74.125.68.0-255,766,269567,9,349123
8477,0.002141,74.125.68.0-255,1484,271051,9,349123
8478,0.002144,74.125.68.0-255,1484,272535,9,349123
8479,0.002162,74.125.68.0-255,1484,274019,9,349123
8480,0.002176,74.125.68.0-255,1484,275503,9,349123
8481,0.00218,74.125.68.0-255,1484,276987,9,349123
8482,0.002202,74.125.68.0-255,4320,281307,9,349123
8483,0.002225,74.125.68.0-255,5738,287045,9,349123
8484,0.002242,74.125.68.0-255,4320,291365,9,349123
8485,0.002282,74.125.68.0-255,3602,294967,9,349123
8486,0.002287,74.125.68.0-255,4320,299287,9,349123
8487,0.002295,74.125.68.0-255,7156,306443,9,349123
8488,0.002308,74.125.68.0-255,2902,309345,9,349123
8489,0.002313,74.125.68.0-255,4320,313665,9,349123
8490,0.002317,74.125.68.0-255,2902,316567,9,349123
8491,0.002338,74.125.68.0-255,2902,319469,9,349123
8492,0.002357,74.125.68.0-255,4320,323789,9,349123
8493,0.002379,74.125.68.0-255,3602,327391,9,349123
8494,0.002386,74.125.68.0-255,5738,333129,9,349123
8495,0.002399,74.125.68.0-255,2902,336031,9,349123
8496,0.002405,74.125.68.0-255,5738,341769,9,349123
8497,0.002407,74.125.68.0-255,1484,343253,9,349123
8498,0.006331,172.31.36.0-255,66,343319,9,349123
8499,0.008727,74.125.68.0-255,5738,349057,9,349123
8500,0.008735,172.31.36.0-255,66,349123,9,349123
8501,0.0,74.125.68.0-255,146,146,9,296823
8502,2.5e-05,74.125.68.0-255,1484,1630,9,296823
8503,3.3e-05,172.31.36.0-255,66,1696,9,296823
8504,3.7e-05,74.125.68.0-255,1484,3180,9,296823
8505,5.1e-05,74.125.68.0-255,1484,4664,9,296823
8506,5.4e-05,172.31.36.0-255,66,4730,9,296823
8507,6e-05,74.125.68.0-255,4320,9050,9,296823
8508,6.4e-05,172.31.36.0-255,66,9116,9,296823
8509,8.9e-05,74.125.68.0-255,4876,13992,9,296823
8510,9.2e-05,172.31.36.0-255,66,14058,9,296823
8511,0.000114,74.125.68.0-255,2902,16960,9,296823
8512,0.000117,172.31.36.0-255,66,17026,9,296823
8513,0.000122,74.125.68.0-255,4320,21346,9,296823
8514,0.000125,172.31.36.0-255,66,21412,9,296823
8515,0.000149,74.125.68.0-255,2902,24314,9,296823
8516,0.000153,172.31.36.0-255,66,24380,9,296823
8517,0.000169,74.125.68.0-255,5738,30118,9,296823
8518,0.000171,172.31.36.0-255,66,30184,9,296823
8519,0.000174,74.125.68.0-255,1125,31309,9,296823
8520,0.000286,74.125.68.0-255,1484,32793,9,296823
8521,0.000292,172.31.36.0-255,66,32859,9,296823
8522,0.000297,74.125.68.0-255,2902,35761,9,296823
8523,0.0003,172.31.36.0-255,66,35827,9,296823
8524,0.000313,74.125.68.0-255,1484,37311,9,296823
8525,0.00033,74.125.68.0-255,4320,41631,9,296823
8526,0.000333,172.31.36.0-255,66,41697,9,296823
8527,0.00034,74.125.68.0-255,6797,48494,9,296823
8528,0.000343,172.31.36.0-255,66,48560,9,296823
8529,0.000363,74.125.68.0-255,5738,54298,9,296823
8530,0.000366,172.31.36.0-255,66,54364,9,296823
8531,0.000386,74.125.68.0-255,4320,58684,9,296823
8532,0.000389,172.31.36.0-255,66,58750,9,296823
8533,0.000409,74.125.68.0-255,2902,61652,9,296823
8534,0.000412,172.31.36.0-255,66,61718,9,296823
8535,0.000415,74.125.68.0-255,1484,63202,9,296823
8536,0.00043,74.125.68.0-255,2814,66016,9,296823
8537,0.000433,172.31.36.0-255,66,66082,9,296823
8538,0.000452,74.125.68.0-255,138,66220,9,296823
8539,0.000557,74.125.68.0-255,1484,67704,9,296823
8540,0.000561,172.31.36.0-255,66,67770,9,296823
8541,0.000576,74.125.68.0-255,1484,69254,9,296823
8542,0.000589,74.125.68.0-255,1484,70738,9,296823
8543,0.000592,172.31.36.0-255,66,70804,9,296823
8544,0.000614,74.125.68.0-255,5738,76542,9,296823
8545,0.000617,172.31.36.0-255,66,76608,9,296823
8546,0.000621,74.125.68.0-255,1484,78092,9,296823
8547,0.000653,172.31.36.0-255,66,78158,9,296823
8548,0.000681,74.125.68.0-255,7156,85314,9,296823
8549,0.000684,172.31.36.0-255,66,85380,9,296823
8550,0.000714,74.125.68.0-255,2902,88282,9,296823
8551,0.000717,172.31.36.0-255,66,88348,9,296823
8552,0.000737,74.125.68.0-255,3602,91950,9,296823
8553,0.00074,172.31.36.0-255,66,92016,9,296823
8554,0.000779,74.125.68.0-255,345,92361,9,296823
8555,0.000816,74.125.68.0-255,1484,93845,9,296823
8556,0.00082,172.31.36.0-255,66,93911,9,296823
8557,0.000824,74.125.68.0-255,2902,96813,9,296823
8558,0.000828,172.31.36.0-255,66,96879,9,296823
8559,0.000838,74.125.68.0-255,1484,98363,9,296823
8560,0.000854,74.125.68.0-255,4320,102683,9,296823
8561,0.000857,172.31.36.0-255,66,102749,9,296823
8562,0.000891,172.31.36.0-255,66,102815,9,296823
8563,0.000939,172.31.36.0-255,66,102881,9,296823
8564,0.000976,74.125.68.0-255,4320,107201,9,296823
8565,0.000981,172.31.36.0-255,66,107267,9,296823
8566,0.000998,74.125.68.0-255,4320,111587,9,296823
8567,0.001001,172.31.36.0-255,66,111653,9,296823
8568,0.001031,172.31.36.0-255,66,111719,9,296823
8569,0.00106,74.125.68.0-255,4320,116039,9,296823
8570,0.001063,172.31.36.0-255,66,116105,9,296823
8571,0.001093,74.125.68.0-255,7156,123261,9,296823
8572,0.001096,172.31.36.0-255,66,123327,9,296823
8573,0.001115,74.125.68.0-255,3602,126929,9,296823
8574,0.001119,172.31.36.0-255,66,126995,9,296823
8575,0.001137,74.125.68.0-255,2902,129897,9,296823
8576,0.001141,172.31.36.0-255,66,129963,9,296823
8577,0.001158,74.125.68.0-255,1484,131447,9,296823
8578,0.001169,74.125.68.0-255,1484,132931,9,296823
8579,0.001171,172.31.36.0-255,66,132997,9,296823
8580,0.001192,172.31.36.0-255,66,133063,9,296823
8581,0.001207,74.125.68.0-255,4320,137383,9,296823
8582,0.001211,172.31.36.0-255,66,137449,9,296823
8583,0.001255,172.31.36.0-255,66,137515,9,296823
8584,0.001353,74.125.68.0-255,1484,138999,9,296823
8585,0.001367,74.125.68.0-255,2902,141901,9,296823
8586,0.00137,172.31.36.0-255,66,141967,9,296823
8587,0.001374,74.125.68.0-255,1484,143451,9,296823
8588,0.001391,74.125.68.0-255,2902,146353,9,296823
8589,0.001394,172.31.36.0-255,66,146419,9,296823
8590,0.001398,74.125.68.0-255,2902,149321,9,296823
8591,0.001401,172.31.36.0-255,66,149387,9,296823
8592,0.001419,74.125.68.0-255,2902,152289,9,296823
8593,0.001422,172.31.36.0-255,66,152355,9,296823
8594,0.00144,74.125.68.0-255,7156,159511,9,296823
8595,0.001443,172.31.36.0-255,66,159577,9,296823
8596,0.001455,74.125.68.0-255,1484,161061,9,296823
8597,0.001467,172.31.36.0-255,66,161127,9,296823
8598,0.001483,74.125.68.0-255,1484,162611,9,296823
8599,0.001487,74.125.68.0-255,766,163377,9,296823
8600,0.001489,172.31.36.0-255,66,163443,9,296823
8601,0.001744,74.125.68.0-255,1484,164927,9,296823
8602,0.001759,74.125.68.0-255,2902,167829,9,296823
8603,0.001764,172.31.36.0-255,66,167895,9,296823
8604,0.001767,74.125.68.0-255,1484,169379,9,296823
8605,0.001789,74.125.68.0-255,4320,173699,9,296823
8606,0.001792,74.125.68.0-255,1484,175183,9,296823
8607,0.001793,172.31.36.0-255,66,175249,9,296823
8608,0.001801,74.125.68.0-255,2902,178151,9,296823
8609,0.001804,172.31.36.0-255,66,178217,9,296823
8610,0.001808,74.125.68.0-255,1484,179701,9,296823
8611,0.001828,74.125.68.0-255,4320,184021,9,296823
8612,0.001831,172.31.36.0-255,66,184087,9,296823
8613,0.001834,74.125.68.0-255,1484,185571,9,296823
8614,0.001867,172.31.36.0-255,66,185637,9,296823
8615,0.001883,74.125.68.0-255,1484,187121,9,296823
8616,0.001919,172.31.36.0-255,66,187187,9,296823
8617,0.001936,74.125.68.0-255,2902,190089,9,296823
8618,0.001939,172.31.36.0-255,66,190155,9,296823
8619,0.001969,172.31.36.0-255,66,190221,9,296823
8620,0.002044,172.31.36.0-255,66,190287,9,296823
8621,0.002068,74.125.68.0-255,5738,196025,9,296823
8622,0.002071,172.31.36.0-255,66,196091,9,296823
8623,0.002084,74.125.68.0-255,2902,198993,9,296823
8624,0.002087,172.31.36.0-255,66,199059,9,296823
8625,0.002107,74.125.68.0-255,2902,201961,9,296823
8626,0.00211,172.31.36.0-255,66,202027,9,296823
8627,0.002129,74.125.68.0-255,7156,209183,9,296823
8628,0.002133,172.31.36.0-255,66,209249,9,296823
8629,0.002173,74.125.68.0-255,2902,212151,9,296823
8630,0.002178,172.31.36.0-255,66,212217,9,296823
8631,0.002194,172.31.36.0-255,66,212283,9,296823
8632,0.002237,74.125.68.0-255,1484,213767,9,296823
8633,0.002243,74.125.68.0-255,2902,216669,9,296823
8634,0.002246,172.31.36.0-255,66,216735,9,296823
8635,0.002273,74.125.68.0-255,5738,222473,9,296823
8636,0.002277,172.31.36.0-255,66,222539,9,296823
8637,0.002302,74.125.68.0-255,7156,229695,9,296823
8638,0.002305,172.31.36.0-255,66,229761,9,296823
8639,0.00233,74.125.68.0-255,2902,232663,9,296823
8640,0.002335,172.31.36.0-255,66,232729,9,296823
8641,0.00235,74.125.68.0-255,4320,237049,9,296823
8642,0.002353,172.31.36.0-255,66,237115,9,296823
8643,0.002358,74.125.68.0-255,2902,240017,9,296823
8644,0.002361,74.125.68.0-255,1484,241501,9,296823
8645,0.002361,172.31.36.0-255,66,241567,9,296823
8646,0.002373,74.125.68.0-255,1484,243051,9,296823
8647,0.002376,172.31.36.0-255,66,243117,9,296823
8648,0.002402,74.125.68.0-255,3602,246719,9,296823
8649,0.002406,172.31.36.0-255,66,246785,9,296823
8650,0.002409,74.125.68.0-255,1484,248269,9,296823
8651,0.002443,74.125.68.0-255,7156,255425,9,296823
8652,0.002448,172.31.36.0-255,66,255491,9,296823
8653,0.00248,74.125.68.0-255,4320,259811,9,296823
8654,0.002483,172.31.36.0-255,66,259877,9,296823
8655,0.002502,74.125.68.0-255,4320,264197,9,296823
8656,0.002505,172.31.36.0-255,66,264263,9,296823
8657,0.002511,74.125.68.0-255,4320,268583,9,296823
8658,0.002513,172.31.36.0-255,66,268649,9,296823
8659,0.002541,74.125.68.0-255,2902,271551,9,296823
8660,0.002545,172.31.36.0-255,66,271617,9,296823
8661,0.002552,74.125.68.0-255,5738,277355,9,296823
8662,0.002555,172.31.36.0-255,66,277421,9,296823
8663,0.002559,74.125.68.0-255,2902,280323,9,296823
8664,0.002562,172.31.36.0-255,66,280389,9,296823
8665,0.002564,74.125.68.0-255,766,281155,9,296823
8666,0.002735,74.125.68.0-255,1484,282639,9,296823
8667,0.00274,172.31.36.0-255,66,282705,9,296823
8668,0.002762,74.125.68.0-255,2902,285607,9,296823
8669,0.002765,172.31.36.0-255,66,285673,9,296823
8670,0.002792,74.125.68.0-255,4320,289993,9,296823
8671,0.002794,74.125.68.0-255,1484,291477,9,296823
8672,0.002796,172.31.36.0-255,66,291543,9,296823
8673,0.002816,74.125.68.0-255,1484,293027,9,296823
8674,0.002819,172.31.36.0-255,66,293093,9,296823
8675,0.002838,74.125.68.0-255,2902,295995,9,296823
8676,0.002841,172.31.36.0-255,66,296061,9,296823
8677,0.002844,74.125.68.0-255,420,296481,9,296823
8678,0.002925,74.125.68.0-255,105,296586,9,296823
8679,0.00705,172.31.36.0-255,66,296652,9,296823
8680,0.007077,172.31.36.0-255,105,296757,9,296823
8681,0.009278,74.125.68.0-255,66,296823,9,296823
8682,0.0,172.217.194.0-255,220,220,9,163567
8683,1.4e-05,172.217.194.0-255,1484,1704,9,163567
8684,2.2e-05,172.31.36.0-255,66,1770,9,163567
8685,3e-05,172.217.194.0-255,4320,6090,9,163567
8686,3.4e-05,172.31.36.0-255,66,6156,9,163567
8687,4.6e-05,172.217.194.0-255,2902,9058,9,163567
8688,5e-05,172.31.36.0-255,66,9124,9,163567
8689,7.7e-05,172.217.194.0-255,4320,13444,9,163567
8690,8e-05,172.31.36.0-255,66,13510,9,163567
8691,0.000113,172.31.36.0-255,66,13576,9,163567
8692,0.000125,172.31.36.0-255,66,13642,9,163567
8693,0.000128,172.217.194.0-255,1125,14767,9,163567
8694,0.000249,172.217.194.0-255,1484,16251,9,163567
8695,0.000252,172.31.36.0-255,66,16317,9,163567
8696,0.000258,172.217.194.0-255,2902,19219,9,163567
8697,0.00026,172.31.36.0-255,66,19285,9,163567
8698,0.000282,172.217.194.0-255,5738,25023,9,163567
8699,0.000285,172.31.36.0-255,66,25089,9,163567
8700,0.000321,172.217.194.0-255,6797,31886,9,163567
8701,0.000325,172.31.36.0-255,66,31952,9,163567
8702,0.000354,172.217.194.0-255,7156,39108,9,163567
8703,0.000357,172.31.36.0-255,66,39174,9,163567
8704,0.00036,172.217.194.0-255,1484,40658,9,163567
8705,0.000405,172.217.194.0-255,5738,46396,9,163567
8706,0.000408,172.31.36.0-255,66,46462,9,163567
8707,0.000425,172.217.194.0-255,2543,49005,9,163567
8708,0.000428,172.31.36.0-255,66,49071,9,163567
8709,0.000837,172.217.194.0-255,648,49719,9,163567
8710,0.000923,172.217.194.0-255,1484,51203,9,163567
8711,0.000928,172.31.36.0-255,66,51269,9,163567
8712,0.000933,172.217.194.0-255,2902,54171,9,163567
8713,0.000936,172.31.36.0-255,66,54237,9,163567
8714,0.000967,172.217.194.0-255,5738,59975,9,163567
8715,0.00097,172.31.36.0-255,66,60041,9,163567
8716,0.000976,172.217.194.0-255,5738,65779,9,163567
8717,0.000978,172.31.36.0-255,66,65845,9,163567
8718,0.00099,172.217.194.0-255,5738,71583,9,163567
8719,0.000993,172.31.36.0-255,66,71649,9,163567
8720,0.00102,172.217.194.0-255,7156,78805,9,163567
8721,0.001023,172.31.36.0-255,66,78871,9,163567
8722,0.00103,172.217.194.0-255,5020,83891,9,163567
8723,0.001032,172.31.36.0-255,66,83957,9,163567
8724,0.001499,172.217.194.0-255,1484,85441,9,163567
8725,0.001508,172.217.194.0-255,2902,88343,9,163567
8726,0.001513,172.31.36.0-255,66,88409,9,163567
8727,0.001521,172.217.194.0-255,5738,94147,9,163567
8728,0.001523,172.31.36.0-255,66,94213,9,163567
8729,0.001556,172.31.36.0-255,66,94279,9,163567
8730,0.001592,172.31.36.0-255,66,94345,9,163567
8731,0.00164,172.217.194.0-255,5020,99365,9,163567
8732,0.001644,172.31.36.0-255,66,99431,9,163567
8733,0.001712,172.217.194.0-255,1484,100915,9,163567
8734,0.001717,172.217.194.0-255,1484,102399,9,163567
8735,0.00172,172.31.36.0-255,66,102465,9,163567
8736,0.001751,172.217.194.0-255,1484,103949,9,163567
8737,0.001759,172.217.194.0-255,5738,109687,9,163567
8738,0.001762,172.31.36.0-255,66,109753,9,163567
8739,0.001769,172.217.194.0-255,7156,116909,9,163567
8740,0.001772,172.31.36.0-255,66,116975,9,163567
8741,0.001809,172.217.194.0-255,5738,122713,9,163567
8742,0.001812,172.31.36.0-255,66,122779,9,163567
8743,0.001823,172.31.36.0-255,66,122845,9,163567
8744,0.001868,172.31.36.0-255,66,122911,9,163567
8745,0.00189,172.217.194.0-255,7156,130067,9,163567
8746,0.001893,172.31.36.0-255,66,130133,9,163567
8747,0.001925,172.217.194.0-255,6438,136571,9,163567
8748,0.001928,172.31.36.0-255,66,136637,9,163567
8749,0.001932,172.217.194.0-255,1484,138121,9,163567
8750,0.001936,172.217.194.0-255,2902,141023,9,163567
8751,0.001939,172.31.36.0-255,66,141089,9,163567
8752,0.001944,172.217.194.0-255,4320,145409,9,163567
8753,0.001948,172.31.36.0-255,66,145475,9,163567
8754,0.001991,172.217.194.0-255,1484,146959,9,163567
8755,0.002008,172.31.36.0-255,66,147025,9,163567
8756,0.002021,172.31.36.0-255,66,147091,9,163567
8757,0.002064,172.217.194.0-255,1484,148575,9,163567
8758,0.002084,172.217.194.0-255,1484,150059,9,163567
8759,0.002087,172.31.36.0-255,66,150125,9,163567
8760,0.002093,172.217.194.0-255,4320,154445,9,163567
8761,0.002095,172.31.36.0-255,66,154511,9,163567
8762,0.002106,172.31.36.0-255,66,154577,9,163567
8763,0.002127,172.31.36.0-255,66,154643,9,163567
8764,0.00214,172.31.36.0-255,66,154709,9,163567
8765,0.002172,172.31.36.0-255,66,154775,9,163567
8766,0.002184,172.31.36.0-255,66,154841,9,163567
8767,0.002221,172.217.194.0-255,3602,158443,9,163567
8768,0.002225,172.31.36.0-255,66,158509,9,163567
8769,0.002255,172.31.36.0-255,66,158575,9,163567
8770,0.002269,172.31.36.0-255,66,158641,9,163567
8771,0.002305,172.31.36.0-255,66,158707,9,163567
8772,0.002311,172.217.194.0-255,4320,163027,9,163567
8773,0.002313,172.31.36.0-255,66,163093,9,163567
8774,0.002364,172.31.36.0-255,66,163159,9,163567
8775,0.002378,172.31.36.0-255,66,163225,9,163567
8776,0.002392,172.31.36.0-255,66,163291,9,163567
8777,0.002395,172.217.194.0-255,105,163396,9,163567
8778,0.006012,172.31.36.0-255,105,163501,9,163567
8779,0.008254,172.217.194.0-255,66,163567,9,163567
8780,0.0,172.217.194.0-255,143,143,9,147164
8781,2.2e-05,172.31.36.0-255,66,209,9,147164
8782,2.9e-05,172.217.194.0-255,1484,1693,9,147164
8783,3.3e-05,172.31.36.0-255,66,1759,9,147164
8784,4.7e-05,172.217.194.0-255,2902,4661,9,147164
8785,5e-05,172.31.36.0-255,66,4727,9,147164
8786,5.5e-05,172.217.194.0-255,2902,7629,9,147164
8787,5.9e-05,172.31.36.0-255,66,7695,9,147164
8788,6.5e-05,172.217.194.0-255,4320,12015,9,147164
8789,6.8e-05,172.31.36.0-255,66,12081,9,147164
8790,8e-05,172.31.36.0-255,66,12147,9,147164
8791,9.3e-05,172.31.36.0-255,66,12213,9,147164
8792,0.000158,172.217.194.0-255,1484,13697,9,147164
8793,0.000161,172.31.36.0-255,66,13763,9,147164
8794,0.000166,172.217.194.0-255,2902,16665,9,147164
8795,0.000168,172.31.36.0-255,66,16731,9,147164
8796,0.000172,172.217.194.0-255,1484,18215,9,147164
8797,0.00018,172.31.36.0-255,66,18281,9,147164
8798,0.000208,172.217.194.0-255,4320,22601,9,147164
8799,0.000214,172.31.36.0-255,66,22667,9,147164
8800,0.000226,172.31.36.0-255,66,22733,9,147164
8801,0.000265,172.217.194.0-255,5379,28112,9,147164
8802,0.000268,172.31.36.0-255,66,28178,9,147164
8803,0.000285,172.31.36.0-255,66,28244,9,147164
8804,0.000288,172.217.194.0-255,365,28609,9,147164
8805,0.00029,172.31.36.0-255,66,28675,9,147164
8806,0.000355,172.217.194.0-255,1484,30159,9,147164
8807,0.000358,172.31.36.0-255,66,30225,9,147164
8808,0.000363,172.217.194.0-255,2902,33127,9,147164
8809,0.000365,172.31.36.0-255,66,33193,9,147164
8810,0.000368,172.217.194.0-255,1484,34677,9,147164
8811,0.000403,172.217.194.0-255,4320,38997,9,147164
8812,0.000406,172.31.36.0-255,66,39063,9,147164
8813,0.000412,172.217.194.0-255,5738,44801,9,147164
8814,0.000415,172.31.36.0-255,66,44867,9,147164
8815,0.000436,172.31.36.0-255,66,44933,9,147164
8816,0.000439,172.217.194.0-255,766,45699,9,147164
8817,0.000497,172.217.194.0-255,1484,47183,9,147164
8818,0.0005,172.31.36.0-255,66,47249,9,147164
8819,0.000506,172.217.194.0-255,2902,50151,9,147164
8820,0.000508,172.31.36.0-255,66,50217,9,147164
8821,0.000511,172.217.194.0-255,1484,51701,9,147164
8822,0.000542,172.217.194.0-255,4320,56021,9,147164
8823,0.000545,172.31.36.0-255,66,56087,9,147164
8824,0.000563,172.31.36.0-255,66,56153,9,147164
8825,0.000591,172.217.194.0-255,7156,63309,9,147164
8826,0.000594,172.31.36.0-255,66,63375,9,147164
8827,0.000623,172.217.194.0-255,3053,66428,9,147164
8828,0.000626,172.31.36.0-255,66,66494,9,147164
8829,0.000629,172.217.194.0-255,1484,67978,9,147164
8830,0.000653,172.217.194.0-255,2902,70880,9,147164
8831,0.000656,172.31.36.0-255,66,70946,9,147164
8832,0.000662,172.217.194.0-255,5738,76684,9,147164
8833,0.000665,172.31.36.0-255,66,76750,9,147164
8834,0.000694,172.31.36.0-255,66,76816,9,147164
8835,0.000706,172.31.36.0-255,66,76882,9,147164
8836,0.000734,172.217.194.0-255,2184,79066,9,147164
8837,0.000737,172.31.36.0-255,66,79132,9,147164
8838,0.00077,172.217.194.0-255,2902,82034,9,147164
8839,0.000772,172.31.36.0-255,66,82100,9,147164
8840,0.000804,172.217.194.0-255,7156,89256,9,147164
8841,0.000807,172.31.36.0-255,66,89322,9,147164
8842,0.000811,172.217.194.0-255,2902,92224,9,147164
8843,0.000813,172.31.36.0-255,66,92290,9,147164
8844,0.000845,172.31.36.0-255,66,92356,9,147164
8845,0.000858,172.31.36.0-255,66,92422,9,147164
8846,0.000885,172.217.194.0-255,3602,96024,9,147164
8847,0.000887,172.31.36.0-255,66,96090,9,147164
8848,0.00094,172.31.36.0-255,66,96156,9,147164
8849,0.000981,172.217.194.0-255,2902,99058,9,147164
8850,0.000984,172.31.36.0-255,66,99124,9,147164
8851,0.00099,172.217.194.0-255,5738,104862,9,147164
8852,0.000993,172.31.36.0-255,66,104928,9,147164
8853,0.00101,172.31.36.0-255,66,104994,9,147164
8854,0.001013,172.217.194.0-255,1484,106478,9,147164
8855,0.001017,172.217.194.0-255,2902,109380,9,147164
8856,0.001019,172.31.36.0-255,66,109446,9,147164
8857,0.001022,172.217.194.0-255,1484,110930,9,147164
8858,0.00105,172.217.194.0-255,4320,115250,9,147164
8859,0.001053,172.31.36.0-255,66,115316,9,147164
8860,0.001068,172.31.36.0-255,66,115382,9,147164
8861,0.00112,172.31.36.0-255,66,115448,9,147164
8862,0.001146,172.217.194.0-255,2902,118350,9,147164
8863,0.001149,172.31.36.0-255,66,118416,9,147164
8864,0.001187,172.31.36.0-255,66,118482,9,147164
8865,0.001208,172.31.36.0-255,66,118548,9,147164
8866,0.001222,172.31.36.0-255,66,118614,9,147164
8867,0.001264,172.217.194.0-255,5738,124352,9,147164
8868,0.001268,172.31.36.0-255,66,124418,9,147164
8869,0.0013,172.31.36.0-255,66,124484,9,147164
8870,0.001306,172.217.194.0-255,4320,128804,9,147164
8871,0.001309,172.31.36.0-255,66,128870,9,147164
8872,0.001314,172.217.194.0-255,2902,131772,9,147164
8873,0.001316,172.31.36.0-255,66,131838,9,147164
8874,0.001341,172.217.194.0-255,2902,134740,9,147164
8875,0.001343,172.31.36.0-255,66,134806,9,147164
8876,0.001361,172.31.36.0-255,66,134872,9,147164
8877,0.001371,172.31.36.0-255,66,134938,9,147164
8878,0.001408,172.217.194.0-255,3602,138540,9,147164
8879,0.001411,172.31.36.0-255,66,138606,9,147164
8880,0.001415,172.217.194.0-255,2902,141508,9,147164
8881,0.001417,172.31.36.0-255,66,141574,9,147164
8882,0.001437,172.217.194.0-255,1484,143058,9,147164
8883,0.001455,172.31.36.0-255,66,143124,9,147164
8884,0.001465,172.31.36.0-255,66,143190,9,147164
8885,0.001527,172.31.36.0-255,66,143256,9,147164
8886,0.001533,172.217.194.0-255,3500,146756,9,147164
8887,0.001535,172.31.36.0-255,66,146822,9,147164
8888,0.001538,172.217.194.0-255,105,146927,9,147164
8889,0.005102,172.31.36.0-255,66,146993,9,147164
8890,0.005143,172.31.36.0-255,105,147098,9,147164
8891,0.007404,172.217.194.0-255,66,147164,9,147164
8892,0.0,172.31.36.0-255,105,105,9,459
8893,0.000372,172.31.36.0-255,90,195,9,459
8894,0.000383,172.31.36.0-255,66,261,9,459
8895,0.003038,74.125.24.0-255,66,327,9,459
8896,0.003068,74.125.24.0-255,66,393,9,459
8897,0.00309,172.31.36.0-255,66,459,9,459
8898,0.0,172.31.36.0-255,105,105,9,525
8899,0.000219,172.31.36.0-255,90,195,9,525
8900,0.000231,172.31.36.0-255,66,261,9,525
8901,0.002493,74.125.24.0-255,66,327,9,525
8902,0.002506,74.125.24.0-255,66,393,9,525
8903,0.002512,172.31.36.0-255,66,459,9,525
8904,0.002516,74.125.24.0-255,66,525,9,525
8905,0.0,74.125.24.0-255,189,189,9,193403
8906,1.1e-05,172.31.36.0-255,66,255,9,193403
8907,1.7e-05,74.125.24.0-255,1484,1739,9,193403
8908,2.1e-05,172.31.36.0-255,66,1805,9,193403
8909,2.6e-05,74.125.24.0-255,2902,4707,9,193403
8910,3.4e-05,172.31.36.0-255,66,4773,9,193403
8911,5.5e-05,74.125.24.0-255,4320,9093,9,193403
8912,5.9e-05,172.31.36.0-255,66,9159,9,193403
8913,0.000101,74.125.24.0-255,2902,12061,9,193403
8914,0.000104,172.31.36.0-255,66,12127,9,193403
8915,0.000108,74.125.24.0-255,1484,13611,9,193403
8916,0.00011,172.31.36.0-255,66,13677,9,193403
8917,0.000124,172.31.36.0-255,66,13743,9,193403
8918,0.000131,74.125.24.0-255,6797,20540,9,193403
8919,0.000134,172.31.36.0-255,66,20606,9,193403
8920,0.000207,74.125.24.0-255,1484,22090,9,193403
8921,0.00021,172.31.36.0-255,66,22156,9,193403
8922,0.000214,74.125.24.0-255,1484,23640,9,193403
8923,0.000216,172.31.36.0-255,66,23706,9,193403
8924,0.000238,74.125.24.0-255,1484,25190,9,193403
8925,0.000244,172.31.36.0-255,66,25256,9,193403
8926,0.000251,74.125.24.0-255,5738,30994,9,193403
8927,0.000253,172.31.36.0-255,66,31060,9,193403
8928,0.000261,74.125.24.0-255,6797,37857,9,193403
8929,0.000263,172.31.36.0-255,66,37923,9,193403
8930,0.000296,74.125.24.0-255,7156,45079,9,193403
8931,0.000299,172.31.36.0-255,66,45145,9,193403
8932,0.000333,74.125.24.0-255,7156,52301,9,193403
8933,0.000336,172.31.36.0-255,66,52367,9,193403
8934,0.00034,74.125.24.0-255,2850,55217,9,193403
8935,0.000342,172.31.36.0-255,66,55283,9,193403
8936,0.000399,74.125.24.0-255,347,55630,9,193403
8937,0.000585,74.125.24.0-255,1484,57114,9,193403
8938,0.00059,172.31.36.0-255,66,57180,9,193403
8939,0.000596,74.125.24.0-255,2902,60082,9,193403
8940,0.000599,172.31.36.0-255,66,60148,9,193403
8941,0.000629,74.125.24.0-255,5738,65886,9,193403
8942,0.000633,172.31.36.0-255,66,65952,9,193403
8943,0.000683,172.31.36.0-255,66,66018,9,193403
8944,0.000691,74.125.24.0-255,7156,73174,9,193403
8945,0.000694,172.31.36.0-255,66,73240,9,193403
8946,0.000729,74.125.24.0-255,5379,78619,9,193403
8947,0.000732,172.31.36.0-255,66,78685,9,193403
8948,0.001241,74.125.24.0-255,1484,80169,9,193403
8949,0.001248,74.125.24.0-255,2902,83071,9,193403
8950,0.001251,172.31.36.0-255,66,83137,9,193403
8951,0.001288,74.125.24.0-255,5738,88875,9,193403
8952,0.001291,172.31.36.0-255,66,88941,9,193403
8953,0.001298,74.125.24.0-255,7156,96097,9,193403
8954,0.001301,172.31.36.0-255,66,96163,9,193403
8955,0.001308,74.125.24.0-255,7156,103319,9,193403
8956,0.001315,172.31.36.0-255,66,103385,9,193403
8957,0.001349,74.125.24.0-255,7156,110541,9,193403
8958,0.001356,172.31.36.0-255,66,110607,9,193403
8959,0.001384,74.125.24.0-255,2184,112791,9,193403
8960,0.001391,172.31.36.0-255,66,112857,9,193403
8961,0.001558,74.125.24.0-255,1484,114341,9,193403
8962,0.001562,74.125.24.0-255,1484,115825,9,193403
8963,0.001565,172.31.36.0-255,66,115891,9,193403
8964,0.001576,74.125.24.0-255,1484,117375,9,193403
8965,0.001603,74.125.24.0-255,5738,123113,9,193403
8966,0.001605,172.31.36.0-255,66,123179,9,193403
8967,0.001627,172.31.36.0-255,66,123245,9,193403
8968,0.001636,74.125.24.0-255,7156,130401,9,193403
8969,0.001638,172.31.36.0-255,66,130467,9,193403
8970,0.001672,74.125.24.0-255,4320,134787,9,193403
8971,0.001675,172.31.36.0-255,66,134853,9,193403
8972,0.001679,74.125.24.0-255,2184,137037,9,193403
8973,0.001681,172.31.36.0-255,66,137103,9,193403
8974,0.001687,74.125.24.0-255,2902,140005,9,193403
8975,0.001694,172.31.36.0-255,66,140071,9,193403
8976,0.001697,74.125.24.0-255,1484,141555,9,193403
8977,0.001721,74.125.24.0-255,1484,143039,9,193403
8978,0.001723,172.31.36.0-255,66,143105,9,193403
8979,0.001735,74.125.24.0-255,7156,150261,9,193403
8980,0.001738,172.31.36.0-255,66,150327,9,193403
8981,0.001741,74.125.24.0-255,1484,151811,9,193403
8982,0.001791,172.31.36.0-255,66,151877,9,193403
8983,0.001798,74.125.24.0-255,5020,156897,9,193403
8984,0.0018,172.31.36.0-255,66,156963,9,193403
8985,0.002048,74.125.24.0-255,1484,158447,9,193403
8986,0.002068,74.125.24.0-255,2902,161349,9,193403
8987,0.002072,172.31.36.0-255,66,161415,9,193403
8988,0.002079,74.125.24.0-255,5738,167153,9,193403
8989,0.002081,172.31.36.0-255,66,167219,9,193403
8990,0.002085,74.125.24.0-255,2902,170121,9,193403
8991,0.002087,172.31.36.0-255,66,170187,9,193403
8992,0.002123,74.125.24.0-255,5738,175925,9,193403
8993,0.002127,172.31.36.0-255,66,175991,9,193403
8994,0.004207,74.125.24.0-255,5738,181729,9,193403
8995,0.004214,172.31.36.0-255,66,181795,9,193403
8996,0.006267,74.125.24.0-255,5738,187533,9,193403
8997,0.006271,172.31.36.0-255,66,187599,9,193403
8998,0.008332,74.125.24.0-255,5738,193337,9,193403
8999,0.008336,172.31.36.0-255,66,193403,9,193403
9000,0.0,172.31.36.0-255,66,66,9,66
