,TIME,SRC,PACKET_SIZE,CUMULATIVE_PACKET_SIZE,PAGE_NUMBER,TOTAL_PACKET_SIZE
0,0.0,172.217.194.0-255,153,153,33,317568
1,2.1e-05,172.31.33.0-255,66,219,33,317568
2,2.8e-05,172.217.194.0-255,1484,1703,33,317568
3,3.2e-05,172.31.33.0-255,66,1769,33,317568
4,4.3e-05,172.217.194.0-255,2902,4671,33,317568
5,4.7e-05,172.31.33.0-255,66,4737,33,317568
6,5.4e-05,172.217.194.0-255,7156,11893,33,317568
7,5.6e-05,172.31.33.0-255,66,11959,33,317568
8,5.9e-05,172.217.194.0-255,2009,13968,33,317568
9,6.1e-05,172.31.33.0-255,66,14034,33,317568
10,9.8e-05,172.31.33.0-255,66,14100,33,317568
11,0.000121,172.217.194.0-255,1484,15584,33,317568
12,0.000123,172.31.33.0-255,66,15650,33,317568
13,0.000129,172.217.194.0-255,5379,21029,33,317568
14,0.000131,172.31.33.0-255,66,21095,33,317568
15,0.000197,172.217.194.0-255,1484,22579,33,317568
16,0.0002,172.31.33.0-255,66,22645,33,317568
17,0.000222,172.217.194.0-255,2902,25547,33,317568
18,0.000225,172.31.33.0-255,66,25613,33,317568
19,0.000251,172.217.194.0-255,5738,31351,33,317568
20,0.000254,172.31.33.0-255,66,31417,33,317568
21,0.000259,172.217.194.0-255,4320,35737,33,317568
22,0.000261,172.31.33.0-255,66,35803,33,317568
23,0.000285,172.217.194.0-255,2902,38705,33,317568
24,0.000287,172.31.33.0-255,66,38771,33,317568
25,0.000323,172.31.33.0-255,66,38837,33,317568
26,0.000329,172.217.194.0-255,6797,45634,33,317568
27,0.000331,172.31.33.0-255,66,45700,33,317568
28,0.001056,172.217.194.0-255,645,46345,33,317568
29,0.001062,172.31.33.0-255,66,46411,33,317568
30,0.001196,172.217.194.0-255,1484,47895,33,317568
31,0.001203,172.217.194.0-255,2902,50797,33,317568
32,0.001206,172.31.33.0-255,66,50863,33,317568
33,0.00121,172.217.194.0-255,1484,52347,33,317568
34,0.001235,172.217.194.0-255,4320,56667,33,317568
35,0.001237,172.31.33.0-255,66,56733,33,317568
36,0.001242,172.217.194.0-255,2902,59635,33,317568
37,0.001244,172.31.33.0-255,66,59701,33,317568
38,0.001265,172.217.194.0-255,4320,64021,33,317568
39,0.001267,172.31.33.0-255,66,64087,33,317568
40,0.001312,172.31.33.0-255,66,64153,33,317568
41,0.001316,172.217.194.0-255,2184,66337,33,317568
42,0.001319,172.31.33.0-255,66,66403,33,317568
43,0.001793,172.217.194.0-255,1484,67887,33,317568
44,0.001802,172.217.194.0-255,2902,70789,33,317568
45,0.001807,172.31.33.0-255,66,70855,33,317568
46,0.001811,172.217.194.0-255,1484,72339,33,317568
47,0.001838,172.217.194.0-255,4320,76659,33,317568
48,0.001841,172.31.33.0-255,66,76725,33,317568
49,0.001848,172.217.194.0-255,4320,81045,33,317568
50,0.00185,172.31.33.0-255,66,81111,33,317568
51,0.001867,172.31.33.0-255,66,81177,33,317568
52,0.001892,172.217.194.0-255,1484,82661,33,317568
53,0.0019,172.217.194.0-255,7156,89817,33,317568
54,0.001902,172.31.33.0-255,66,89883,33,317568
55,0.001905,172.217.194.0-255,766,90649,33,317568
56,0.002071,172.217.194.0-255,1484,92133,33,317568
57,0.002074,172.31.33.0-255,66,92199,33,317568
58,0.002109,172.217.194.0-255,1484,93683,33,317568
59,0.002122,172.217.194.0-255,1484,95167,33,317568
60,0.002125,172.31.33.0-255,66,95233,33,317568
61,0.002132,172.217.194.0-255,5738,100971,33,317568
62,0.002134,172.31.33.0-255,66,101037,33,317568
63,0.00215,172.217.194.0-255,2902,103939,33,317568
64,0.002157,172.31.33.0-255,66,104005,33,317568
65,0.00219,172.31.33.0-255,66,104071,33,317568
66,0.002194,172.217.194.0-255,2902,106973,33,317568
67,0.002197,172.31.33.0-255,66,107039,33,317568
68,0.002226,172.31.33.0-255,66,107105,33,317568
69,0.002232,172.217.194.0-255,5738,112843,33,317568
70,0.002235,172.31.33.0-255,66,112909,33,317568
71,0.002276,172.31.33.0-255,66,112975,33,317568
72,0.002281,172.217.194.0-255,4320,117295,33,317568
73,0.002283,172.31.33.0-255,66,117361,33,317568
74,0.002289,172.217.194.0-255,5738,123099,33,317568
75,0.002291,172.31.33.0-255,66,123165,33,317568
76,0.002296,172.217.194.0-255,4320,127485,33,317568
77,0.002299,172.31.33.0-255,66,127551,33,317568
78,0.002327,172.217.194.0-255,2184,129735,33,317568
79,0.002329,172.31.33.0-255,66,129801,33,317568
80,0.002646,172.217.194.0-255,1484,131285,33,317568
81,0.00265,172.217.194.0-255,1484,132769,33,317568
82,0.002652,172.31.33.0-255,66,132835,33,317568
83,0.002689,172.217.194.0-255,1484,134319,33,317568
84,0.002696,172.217.194.0-255,5738,140057,33,317568
85,0.002699,172.31.33.0-255,66,140123,33,317568
86,0.002702,172.217.194.0-255,1484,141607,33,317568
87,0.002706,172.217.194.0-255,2902,144509,33,317568
88,0.002709,172.31.33.0-255,66,144575,33,317568
89,0.002745,172.217.194.0-255,5738,150313,33,317568
90,0.002747,172.31.33.0-255,66,150379,33,317568
91,0.002753,172.217.194.0-255,5738,156117,33,317568
92,0.002755,172.31.33.0-255,66,156183,33,317568
93,0.00548,172.217.194.0-255,4320,160503,33,317568
94,0.005485,172.31.33.0-255,66,160569,33,317568
95,0.005511,172.217.194.0-255,1484,162053,33,317568
96,0.008195,172.217.194.0-255,4320,166373,33,317568
97,0.008201,172.31.33.0-255,66,166439,33,317568
98,0.01096,172.217.194.0-255,5738,172177,33,317568
99,0.010967,172.31.33.0-255,66,172243,33,317568
100,0.013707,172.217.194.0-255,5738,177981,33,317568
101,0.013716,172.31.33.0-255,66,178047,33,317568
102,0.016451,172.217.194.0-255,5738,183785,33,317568
103,0.016462,172.31.33.0-255,66,183851,33,317568
104,0.019207,172.217.194.0-255,5738,189589,33,317568
105,0.019217,172.31.33.0-255,66,189655,33,317568
106,0.021983,172.217.194.0-255,5738,195393,33,317568
107,0.021994,172.31.33.0-255,66,195459,33,317568
108,0.024745,172.217.194.0-255,5738,201197,33,317568
109,0.024753,172.31.33.0-255,66,201263,33,317568
110,0.027498,172.217.194.0-255,5738,207001,33,317568
111,0.027507,172.31.33.0-255,66,207067,33,317568
112,0.030267,172.217.194.0-255,5738,212805,33,317568
113,0.030274,172.31.33.0-255,66,212871,33,317568
114,0.032532,172.31.33.0-255,172,213043,33,317568
115,0.032563,172.31.33.0-255,1117,214160,33,317568
116,0.03262,172.31.33.0-255,1514,215674,33,317568
117,0.032623,172.31.33.0-255,1280,216954,33,317568
118,0.032971,172.217.194.0-255,5738,222692,33,317568
119,0.032978,172.31.33.0-255,66,222758,33,317568
120,0.034225,104.244.42.0-255,66,222824,33,317568
121,0.034538,104.244.42.0-255,66,222890,33,317568
122,0.034565,104.244.42.0-255,66,222956,33,317568
123,0.035696,172.217.194.0-255,5738,228694,33,317568
124,0.035703,172.31.33.0-255,66,228760,33,317568
125,0.038433,172.217.194.0-255,5738,234498,33,317568
126,0.03844,172.31.33.0-255,66,234564,33,317568
127,0.041194,172.217.194.0-255,5738,240302,33,317568
128,0.041201,172.31.33.0-255,66,240368,33,317568
129,0.043949,172.217.194.0-255,5738,246106,33,317568
130,0.043959,172.31.33.0-255,66,246172,33,317568
131,0.046717,172.217.194.0-255,4320,250492,33,317568
132,0.046723,172.31.33.0-255,66,250558,33,317568
133,0.046746,172.217.194.0-255,1484,252042,33,317568
134,0.049415,172.217.194.0-255,4320,256362,33,317568
135,0.049422,172.31.33.0-255,66,256428,33,317568
136,0.052166,172.217.194.0-255,5738,262166,33,317568
137,0.052171,172.31.33.0-255,66,262232,33,317568
138,0.054892,172.217.194.0-255,5738,267970,33,317568
139,0.054899,172.31.33.0-255,66,268036,33,317568
140,0.05765,172.217.194.0-255,5738,273774,33,317568
141,0.057657,172.31.33.0-255,66,273840,33,317568
142,0.060356,172.217.194.0-255,5738,279578,33,317568
143,0.060361,172.31.33.0-255,66,279644,33,317568
144,0.063092,172.217.194.0-255,5738,285382,33,317568
145,0.063098,172.31.33.0-255,66,285448,33,317568
146,0.065817,172.217.194.0-255,5738,291186,33,317568
147,0.065823,172.31.33.0-255,66,291252,33,317568
148,0.06858,172.217.194.0-255,4320,295572,33,317568
149,0.068586,172.31.33.0-255,66,295638,33,317568
150,0.068617,172.217.194.0-255,1484,297122,33,317568
151,0.071302,172.217.194.0-255,4320,301442,33,317568
152,0.07131,172.31.33.0-255,66,301508,33,317568
153,0.074035,172.217.194.0-255,5738,307246,33,317568
154,0.074058,172.31.33.0-255,66,307312,33,317568
155,0.07675,172.217.194.0-255,4320,311632,33,317568
156,0.076756,172.31.33.0-255,66,311698,33,317568
157,0.076772,172.217.194.0-255,1484,313182,33,317568
158,0.079441,172.217.194.0-255,4320,317502,33,317568
159,0.079448,172.31.33.0-255,66,317568,33,317568
160,0.0,172.217.194.0-255,153,153,33,275059
161,1.7e-05,172.31.33.0-255,66,219,33,275059
162,2.4e-05,172.217.194.0-255,1484,1703,33,275059
163,2.9e-05,172.31.33.0-255,66,1769,33,275059
164,4.4e-05,172.217.194.0-255,1484,3253,33,275059
165,4.8e-05,172.31.33.0-255,66,3319,33,275059
166,6.7e-05,172.217.194.0-255,1484,4803,33,275059
167,6.9e-05,172.31.33.0-255,66,4869,33,275059
168,7.7e-05,172.217.194.0-255,7156,12025,33,275059
169,8e-05,172.31.33.0-255,66,12091,33,275059
170,8.4e-05,172.217.194.0-255,2068,14159,33,275059
171,8.7e-05,172.31.33.0-255,66,14225,33,275059
172,9.2e-05,172.217.194.0-255,2902,17127,33,275059
173,9.4e-05,172.31.33.0-255,66,17193,33,275059
174,9.7e-05,172.217.194.0-255,1484,18677,33,275059
175,0.0001,172.31.33.0-255,66,18743,33,275059
176,0.000118,172.217.194.0-255,5738,24481,33,275059
177,0.000121,172.31.33.0-255,66,24547,33,275059
178,0.000146,172.217.194.0-255,6797,31344,33,275059
179,0.000149,172.31.33.0-255,66,31410,33,275059
180,0.000205,172.217.194.0-255,1484,32894,33,275059
181,0.000208,172.31.33.0-255,66,32960,33,275059
182,0.000213,172.217.194.0-255,2902,35862,33,275059
183,0.000216,172.31.33.0-255,66,35928,33,275059
184,0.000222,172.217.194.0-255,5738,41666,33,275059
185,0.000224,172.31.33.0-255,66,41732,33,275059
186,0.000227,172.217.194.0-255,1484,43216,33,275059
187,0.000229,172.31.33.0-255,66,43282,33,275059
188,0.00025,172.217.194.0-255,2902,46184,33,275059
189,0.000252,172.31.33.0-255,66,46250,33,275059
190,0.000271,172.217.194.0-255,5738,51988,33,275059
191,0.000273,172.31.33.0-255,66,52054,33,275059
192,0.000308,172.217.194.0-255,6797,58851,33,275059
193,0.000317,172.217.194.0-255,7049,65900,33,275059
194,0.000319,172.217.194.0-255,118,66018,33,275059
195,0.000322,172.217.194.0-255,382,66400,33,275059
196,0.000467,172.31.33.0-255,66,66466,33,275059
197,0.000507,172.217.194.0-255,1484,67950,33,275059
198,0.000513,172.217.194.0-255,2902,70852,33,275059
199,0.00053,172.31.33.0-255,66,70918,33,275059
200,0.000535,172.217.194.0-255,4320,75238,33,275059
201,0.00054,172.31.33.0-255,66,75304,33,275059
202,0.000549,172.217.194.0-255,1484,76788,33,275059
203,0.000553,172.217.194.0-255,4320,81108,33,275059
204,0.000561,172.217.194.0-255,7156,88264,33,275059
205,0.00058,172.217.194.0-255,4320,92584,33,275059
206,0.000583,172.217.194.0-255,1484,94068,33,275059
207,0.000588,172.31.33.0-255,66,94134,33,275059
208,0.000599,172.217.194.0-255,6438,100572,33,275059
209,0.000603,172.31.33.0-255,66,100638,33,275059
210,0.00077,172.217.194.0-255,1484,102122,33,275059
211,0.000774,172.217.194.0-255,1484,103606,33,275059
212,0.000779,172.31.33.0-255,66,103672,33,275059
213,0.000793,172.217.194.0-255,1484,105156,33,275059
214,0.0008,172.217.194.0-255,5738,110894,33,275059
215,0.000806,172.217.194.0-255,4320,115214,33,275059
216,0.000808,172.217.194.0-255,1484,116698,33,275059
217,0.000817,172.31.33.0-255,66,116764,33,275059
218,0.000852,172.31.33.0-255,66,116830,33,275059
219,0.000868,172.217.194.0-255,1484,118314,33,275059
220,0.000894,172.217.194.0-255,6438,124752,33,275059
221,0.000907,172.217.194.0-255,1484,126236,33,275059
222,0.000925,172.217.194.0-255,2902,129138,33,275059
223,0.000929,172.217.194.0-255,2902,132040,33,275059
224,0.000931,172.31.33.0-255,66,132106,33,275059
225,0.000942,172.217.194.0-255,2902,135008,33,275059
226,0.000948,172.31.33.0-255,66,135074,33,275059
227,0.000955,172.217.194.0-255,1484,136558,33,275059
228,0.000972,172.217.194.0-255,4320,140878,33,275059
229,0.000989,172.217.194.0-255,4320,145198,33,275059
230,0.000994,172.31.33.0-255,66,145264,33,275059
231,0.001039,172.31.33.0-255,66,145330,33,275059
232,0.001051,172.217.194.0-255,5020,150350,33,275059
233,0.001062,172.31.33.0-255,66,150416,33,275059
234,0.001128,172.217.194.0-255,1484,151900,33,275059
235,0.001154,172.217.194.0-255,2902,154802,33,275059
236,0.00116,172.217.194.0-255,5738,160540,33,275059
237,0.001165,172.31.33.0-255,66,160606,33,275059
238,0.001273,172.217.194.0-255,1484,162090,33,275059
239,0.001287,172.217.194.0-255,2902,164992,33,275059
240,0.001303,172.217.194.0-255,5738,170730,33,275059
241,0.001323,172.217.194.0-255,5738,176468,33,275059
242,0.00134,172.217.194.0-255,7156,183624,33,275059
243,0.001371,172.217.194.0-255,5738,189362,33,275059
244,0.001391,172.217.194.0-255,5020,194382,33,275059
245,0.001845,172.217.194.0-255,1484,195866,33,275059
246,0.001854,172.217.194.0-255,2902,198768,33,275059
247,0.001867,172.217.194.0-255,1484,200252,33,275059
248,0.001913,172.217.194.0-255,5738,205990,33,275059
249,0.001946,172.217.194.0-255,7156,213146,33,275059
250,0.001964,172.217.194.0-255,5738,218884,33,275059
251,0.001983,172.217.194.0-255,766,219650,33,275059
252,0.002059,172.217.194.0-255,1484,221134,33,275059
253,0.002071,172.217.194.0-255,2902,224036,33,275059
254,0.002081,172.217.194.0-255,1484,225520,33,275059
255,0.002095,172.217.194.0-255,4320,229840,33,275059
256,0.002115,172.217.194.0-255,5738,235578,33,275059
257,0.002132,172.217.194.0-255,7156,242734,33,275059
258,0.002138,172.217.194.0-255,5738,248472,33,275059
259,0.002181,172.217.194.0-255,4320,252792,33,275059
260,0.002235,172.217.194.0-255,2902,255694,33,275059
261,0.002275,172.217.194.0-255,4320,260014,33,275059
262,0.002292,172.217.194.0-255,7156,267170,33,275059
263,0.00239,172.217.194.0-255,1484,268654,33,275059
264,0.002406,172.217.194.0-255,836,269490,33,275059
265,0.002409,172.217.194.0-255,105,269595,33,275059
266,0.005604,172.31.33.0-255,66,269661,33,275059
267,0.008048,172.31.33.0-255,105,269766,33,275059
268,0.010319,172.217.194.0-255,66,269832,33,275059
269,0.028641,172.31.33.0-255,176,270008,33,275059
270,0.028669,172.31.33.0-255,1117,271125,33,275059
271,0.028722,172.31.33.0-255,1514,272639,33,275059
272,0.028724,172.31.33.0-255,1514,274153,33,275059
273,0.028746,172.31.33.0-255,642,274795,33,275059
274,0.030129,104.244.42.0-255,66,274861,33,275059
275,0.030228,104.244.42.0-255,66,274927,33,275059
276,0.03028,104.244.42.0-255,66,274993,33,275059
277,0.030283,104.244.42.0-255,66,275059,33,275059
278,0.0,172.217.194.0-255,153,153,33,315261
279,2.4e-05,172.31.33.0-255,66,219,33,315261
280,3e-05,172.217.194.0-255,1484,1703,33,315261
281,3.4e-05,172.31.33.0-255,66,1769,33,315261
282,3.9e-05,172.217.194.0-255,2902,4671,33,315261
283,4.2e-05,172.31.33.0-255,66,4737,33,315261
284,4.9e-05,172.217.194.0-255,7156,11893,33,315261
285,5.1e-05,172.31.33.0-255,66,11959,33,315261
286,8.3e-05,172.217.194.0-255,2028,13987,33,315261
287,8.5e-05,172.31.33.0-255,66,14053,33,315261
288,0.000101,172.217.194.0-255,1484,15537,33,315261
289,0.000103,172.31.33.0-255,66,15603,33,315261
290,0.000121,172.217.194.0-255,1484,17087,33,315261
291,0.000123,172.31.33.0-255,66,17153,33,315261
292,0.000129,172.217.194.0-255,7156,24309,33,315261
293,0.000131,172.31.33.0-255,66,24375,33,315261
294,0.000166,172.217.194.0-255,5738,30113,33,315261
295,0.000169,172.31.33.0-255,66,30179,33,315261
296,0.000185,172.217.194.0-255,6797,36976,33,315261
297,0.000187,172.31.33.0-255,66,37042,33,315261
298,0.000249,172.217.194.0-255,5738,42780,33,315261
299,0.000252,172.31.33.0-255,66,42846,33,315261
300,0.000274,172.217.194.0-255,5379,48225,33,315261
301,0.000277,172.31.33.0-255,66,48291,33,315261
302,0.000342,172.217.194.0-255,4320,52611,33,315261
303,0.000345,172.31.33.0-255,66,52677,33,315261
304,0.000368,172.217.194.0-255,7156,59833,33,315261
305,0.000371,172.31.33.0-255,66,59899,33,315261
306,0.000409,172.217.194.0-255,2902,62801,33,315261
307,0.000412,172.31.33.0-255,66,62867,33,315261
308,0.000429,172.217.194.0-255,2855,65722,33,315261
309,0.000431,172.31.33.0-255,66,65788,33,315261
310,0.00057,172.217.194.0-255,364,66152,33,315261
311,0.000622,172.31.33.0-255,66,66218,33,315261
312,0.000743,172.217.194.0-255,1484,67702,33,315261
313,0.000751,172.217.194.0-255,2902,70604,33,315261
314,0.000754,172.31.33.0-255,66,70670,33,315261
315,0.000759,172.217.194.0-255,2902,73572,33,315261
316,0.000761,172.31.33.0-255,66,73638,33,315261
317,0.000775,172.217.194.0-255,2902,76540,33,315261
318,0.000778,172.31.33.0-255,66,76606,33,315261
319,0.0008,172.217.194.0-255,4320,80926,33,315261
320,0.000803,172.31.33.0-255,66,80992,33,315261
321,0.000832,172.217.194.0-255,2543,83535,33,315261
322,0.000835,172.31.33.0-255,66,83601,33,315261
323,0.000884,172.217.194.0-255,2902,86503,33,315261
324,0.000888,172.31.33.0-255,66,86569,33,315261
325,0.000893,172.217.194.0-255,2902,89471,33,315261
326,0.000895,172.31.33.0-255,66,89537,33,315261
327,0.000905,172.217.194.0-255,1484,91021,33,315261
328,0.000931,172.31.33.0-255,66,91087,33,315261
329,0.000946,172.217.194.0-255,1125,92212,33,315261
330,0.001991,172.217.194.0-255,1484,93696,33,315261
331,0.001997,172.31.33.0-255,66,93762,33,315261
332,0.002003,172.217.194.0-255,2902,96664,33,315261
333,0.002005,172.31.33.0-255,66,96730,33,315261
334,0.002008,172.217.194.0-255,1484,98214,33,315261
335,0.002031,172.217.194.0-255,4320,102534,33,315261
336,0.002033,172.31.33.0-255,66,102600,33,315261
337,0.002048,172.217.194.0-255,4320,106920,33,315261
338,0.002051,172.31.33.0-255,66,106986,33,315261
339,0.00209,172.31.33.0-255,66,107052,33,315261
340,0.002133,172.217.194.0-255,1484,108536,33,315261
341,0.002149,172.217.194.0-255,4320,112856,33,315261
342,0.002154,172.31.33.0-255,66,112922,33,315261
343,0.002173,172.217.194.0-255,2902,115824,33,315261
344,0.002177,172.31.33.0-255,66,115890,33,315261
345,0.002192,172.217.194.0-255,2184,118074,33,315261
346,0.002195,172.31.33.0-255,66,118140,33,315261
347,0.004451,172.217.194.0-255,2902,121042,33,315261
348,0.004457,172.31.33.0-255,66,121108,33,315261
349,0.00452,172.217.194.0-255,2902,124010,33,315261
350,0.004525,172.31.33.0-255,66,124076,33,315261
351,0.006771,172.217.194.0-255,2902,126978,33,315261
352,0.006777,172.31.33.0-255,66,127044,33,315261
353,0.006802,172.217.194.0-255,1484,128528,33,315261
354,0.00682,172.217.194.0-255,1484,130012,33,315261
355,0.006823,172.31.33.0-255,66,130078,33,315261
356,0.009049,172.217.194.0-255,2902,132980,33,315261
357,0.009056,172.31.33.0-255,66,133046,33,315261
358,0.00911,172.217.194.0-255,1484,134530,33,315261
359,0.00912,172.217.194.0-255,1484,136014,33,315261
360,0.009123,172.31.33.0-255,66,136080,33,315261
361,0.011355,172.217.194.0-255,2902,138982,33,315261
362,0.011362,172.31.33.0-255,66,139048,33,315261
363,0.011408,172.217.194.0-255,2902,141950,33,315261
364,0.011413,172.31.33.0-255,66,142016,33,315261
365,0.013678,172.217.194.0-255,5738,147754,33,315261
366,0.013686,172.31.33.0-255,66,147820,33,315261
367,0.015997,172.217.194.0-255,4320,152140,33,315261
368,0.016005,172.31.33.0-255,66,152206,33,315261
369,0.016036,172.217.194.0-255,1484,153690,33,315261
370,0.018295,172.217.194.0-255,4320,158010,33,315261
371,0.018301,172.31.33.0-255,66,158076,33,315261
372,0.020566,172.217.194.0-255,5738,163814,33,315261
373,0.020573,172.31.33.0-255,66,163880,33,315261
374,0.022088,172.31.33.0-255,172,164052,33,315261
375,0.022117,172.31.33.0-255,1117,165169,33,315261
376,0.022162,172.31.33.0-255,1514,166683,33,315261
377,0.022163,172.31.33.0-255,1514,168197,33,315261
378,0.022202,172.31.33.0-255,676,168873,33,315261
379,0.022875,172.217.194.0-255,2902,171775,33,315261
380,0.02288,172.31.33.0-255,66,171841,33,315261
381,0.022906,172.217.194.0-255,2902,174743,33,315261
382,0.022909,172.31.33.0-255,66,174809,33,315261
383,0.023644,104.244.42.0-255,66,174875,33,315261
384,0.023687,104.244.42.0-255,66,174941,33,315261
385,0.023751,104.244.42.0-255,66,175007,33,315261
386,0.023753,104.244.42.0-255,66,175073,33,315261
387,0.025184,172.217.194.0-255,2902,177975,33,315261
388,0.025187,172.31.33.0-255,66,178041,33,315261
389,0.025218,172.217.194.0-255,2902,180943,33,315261
390,0.025221,172.31.33.0-255,66,181009,33,315261
391,0.027505,172.217.194.0-255,5738,186747,33,315261
392,0.02751,172.31.33.0-255,66,186813,33,315261
393,0.029786,172.217.194.0-255,5738,192551,33,315261
394,0.029791,172.31.33.0-255,66,192617,33,315261
395,0.032072,172.217.194.0-255,5738,198355,33,315261
396,0.032079,172.31.33.0-255,66,198421,33,315261
397,0.034352,172.217.194.0-255,5738,204159,33,315261
398,0.034359,172.31.33.0-255,66,204225,33,315261
399,0.036645,172.217.194.0-255,5738,209963,33,315261
400,0.036649,172.31.33.0-255,66,210029,33,315261
401,0.038923,172.217.194.0-255,4320,214349,33,315261
402,0.038928,172.31.33.0-255,66,214415,33,315261
403,0.038948,172.217.194.0-255,1484,215899,33,315261
404,0.041222,172.217.194.0-255,4320,220219,33,315261
405,0.041227,172.31.33.0-255,66,220285,33,315261
406,0.043526,172.217.194.0-255,5738,226023,33,315261
407,0.043531,172.31.33.0-255,66,226089,33,315261
408,0.045832,172.217.194.0-255,2902,228991,33,315261
409,0.045837,172.31.33.0-255,66,229057,33,315261
410,0.045868,172.217.194.0-255,2902,231959,33,315261
411,0.04587,172.31.33.0-255,66,232025,33,315261
412,0.048133,172.217.194.0-255,2902,234927,33,315261
413,0.048138,172.31.33.0-255,66,234993,33,315261
414,0.048157,172.217.194.0-255,2902,237895,33,315261
415,0.04816,172.31.33.0-255,66,237961,33,315261
416,0.050438,172.217.194.0-255,2902,240863,33,315261
417,0.050442,172.31.33.0-255,66,240929,33,315261
418,0.050471,172.217.194.0-255,2902,243831,33,315261
419,0.050474,172.31.33.0-255,66,243897,33,315261
420,0.052706,172.217.194.0-255,2902,246799,33,315261
421,0.052711,172.31.33.0-255,66,246865,33,315261
422,0.052741,172.217.194.0-255,1484,248349,33,315261
423,0.052758,172.217.194.0-255,1484,249833,33,315261
424,0.052761,172.31.33.0-255,66,249899,33,315261
425,0.055,172.217.194.0-255,2902,252801,33,315261
426,0.055004,172.31.33.0-255,66,252867,33,315261
427,0.055032,172.217.194.0-255,2902,255769,33,315261
428,0.055034,172.31.33.0-255,66,255835,33,315261
429,0.057262,172.217.194.0-255,1484,257319,33,315261
430,0.057278,172.217.194.0-255,1484,258803,33,315261
431,0.057281,172.31.33.0-255,66,258869,33,315261
432,0.057312,172.217.194.0-255,2902,261771,33,315261
433,0.057315,172.31.33.0-255,66,261837,33,315261
434,0.059571,172.217.194.0-255,2902,264739,33,315261
435,0.059576,172.31.33.0-255,66,264805,33,315261
436,0.059613,172.217.194.0-255,2902,267707,33,315261
437,0.059616,172.31.33.0-255,66,267773,33,315261
438,0.061868,172.217.194.0-255,2902,270675,33,315261
439,0.061873,172.31.33.0-255,66,270741,33,315261
440,0.0619,172.217.194.0-255,2902,273643,33,315261
441,0.061902,172.31.33.0-255,66,273709,33,315261
442,0.064157,172.217.194.0-255,2902,276611,33,315261
443,0.064163,172.31.33.0-255,66,276677,33,315261
444,0.064194,172.217.194.0-255,2902,279579,33,315261
445,0.064198,172.31.33.0-255,66,279645,33,315261
446,0.066434,172.217.194.0-255,2902,282547,33,315261
447,0.066438,172.31.33.0-255,66,282613,33,315261
448,0.066485,172.217.194.0-255,2902,285515,33,315261
449,0.066488,172.31.33.0-255,66,285581,33,315261
450,0.068729,172.217.194.0-255,2902,288483,33,315261
451,0.068733,172.31.33.0-255,66,288549,33,315261
452,0.068769,172.217.194.0-255,2902,291451,33,315261
453,0.068772,172.31.33.0-255,66,291517,33,315261
454,0.07102,172.217.194.0-255,2902,294419,33,315261
455,0.071025,172.31.33.0-255,66,294485,33,315261
456,0.071063,172.217.194.0-255,2902,297387,33,315261
457,0.071066,172.31.33.0-255,66,297453,33,315261
458,0.073299,172.217.194.0-255,2902,300355,33,315261
459,0.073304,172.31.33.0-255,66,300421,33,315261
460,0.073346,172.217.194.0-255,2902,303323,33,315261
461,0.073349,172.31.33.0-255,66,303389,33,315261
462,0.075599,172.217.194.0-255,2902,306291,33,315261
463,0.075604,172.31.33.0-255,66,306357,33,315261
464,0.07563,172.217.194.0-255,2902,309259,33,315261
465,0.075634,172.31.33.0-255,66,309325,33,315261
466,0.077866,172.217.194.0-255,2902,312227,33,315261
467,0.077871,172.31.33.0-255,66,312293,33,315261
468,0.077929,172.217.194.0-255,2902,315195,33,315261
469,0.077934,172.31.33.0-255,66,315261,33,315261
470,0.0,74.125.68.0-255,153,153,33,348009
471,2.6e-05,172.31.33.0-255,66,219,33,348009
472,3.3e-05,74.125.68.0-255,1484,1703,33,348009
473,3.8e-05,172.31.33.0-255,66,1769,33,348009
474,4.2e-05,74.125.68.0-255,2902,4671,33,348009
475,4.5e-05,172.31.33.0-255,66,4737,33,348009
476,4.9e-05,74.125.68.0-255,2902,7639,33,348009
477,5.2e-05,172.31.33.0-255,66,7705,33,348009
478,7.8e-05,74.125.68.0-255,4320,12025,33,348009
479,8e-05,172.31.33.0-255,66,12091,33,348009
480,8.4e-05,74.125.68.0-255,2049,14140,33,348009
481,8.6e-05,172.31.33.0-255,66,14206,33,348009
482,0.000215,74.125.68.0-255,1484,15690,33,348009
483,0.000219,172.31.33.0-255,66,15756,33,348009
484,0.000224,74.125.68.0-255,1484,17240,33,348009
485,0.000226,172.31.33.0-255,66,17306,33,348009
486,0.000239,74.125.68.0-255,1484,18790,33,348009
487,0.000242,172.31.33.0-255,66,18856,33,348009
488,0.000258,74.125.68.0-255,2902,21758,33,348009
489,0.000261,172.31.33.0-255,66,21824,33,348009
490,0.000277,74.125.68.0-255,2902,24726,33,348009
491,0.00028,172.31.33.0-255,66,24792,33,348009
492,0.000285,74.125.68.0-255,4320,29112,33,348009
493,0.000287,172.31.33.0-255,66,29178,33,348009
494,0.000311,74.125.68.0-255,4320,33498,33,348009
495,0.000314,172.31.33.0-255,66,33564,33,348009
496,0.000328,74.125.68.0-255,1125,34689,33,348009
497,0.000331,172.31.33.0-255,66,34755,33,348009
498,0.000335,74.125.68.0-255,2902,37657,33,348009
499,0.000337,172.31.33.0-255,66,37723,33,348009
500,0.000342,74.125.68.0-255,4320,42043,33,348009
501,0.000344,172.31.33.0-255,66,42109,33,348009
502,0.000395,172.31.33.0-255,66,42175,33,348009
503,0.000399,74.125.68.0-255,4320,46495,33,348009
504,0.000401,172.31.33.0-255,66,46561,33,348009
505,0.000407,74.125.68.0-255,5738,52299,33,348009
506,0.00041,172.31.33.0-255,66,52365,33,348009
507,0.000434,74.125.68.0-255,5020,57385,33,348009
508,0.000438,172.31.33.0-255,66,57451,33,348009
509,0.000758,74.125.68.0-255,394,57845,33,348009
510,0.000798,172.31.33.0-255,66,57911,33,348009
511,0.001,74.125.68.0-255,1484,59395,33,348009
512,0.001019,74.125.68.0-255,2902,62297,33,348009
513,0.001024,172.31.33.0-255,66,62363,33,348009
514,0.001028,74.125.68.0-255,1484,63847,33,348009
515,0.001044,74.125.68.0-255,2902,66749,33,348009
516,0.001047,172.31.33.0-255,66,66815,33,348009
517,0.001065,74.125.68.0-255,2902,69717,33,348009
518,0.001067,172.31.33.0-255,66,69783,33,348009
519,0.001088,74.125.68.0-255,2902,72685,33,348009
520,0.001091,172.31.33.0-255,66,72751,33,348009
521,0.001094,74.125.68.0-255,1484,74235,33,348009
522,0.001098,74.125.68.0-255,2902,77137,33,348009
523,0.0011,172.31.33.0-255,66,77203,33,348009
524,0.001124,74.125.68.0-255,4320,81523,33,348009
525,0.001126,172.31.33.0-255,66,81589,33,348009
526,0.001145,74.125.68.0-255,1484,83073,33,348009
527,0.001148,74.125.68.0-255,1484,84557,33,348009
528,0.00115,172.31.33.0-255,66,84623,33,348009
529,0.001154,74.125.68.0-255,2902,87525,33,348009
530,0.001156,172.31.33.0-255,66,87591,33,348009
531,0.001187,74.125.68.0-255,2902,90493,33,348009
532,0.00119,172.31.33.0-255,66,90559,33,348009
533,0.001209,74.125.68.0-255,2184,92743,33,348009
534,0.001211,172.31.33.0-255,66,92809,33,348009
535,0.00127,74.125.68.0-255,349,93158,33,348009
536,0.001295,74.125.68.0-255,1484,94642,33,348009
537,0.001298,172.31.33.0-255,66,94708,33,348009
538,0.00131,74.125.68.0-255,1484,96192,33,348009
539,0.001327,74.125.68.0-255,2902,99094,33,348009
540,0.00133,172.31.33.0-255,66,99160,33,348009
541,0.001334,74.125.68.0-255,2902,102062,33,348009
542,0.001336,172.31.33.0-255,66,102128,33,348009
543,0.001351,74.125.68.0-255,5738,107866,33,348009
544,0.001354,172.31.33.0-255,66,107932,33,348009
545,0.001376,74.125.68.0-255,4320,112252,33,348009
546,0.001379,172.31.33.0-255,66,112318,33,348009
547,0.0014,74.125.68.0-255,5738,118056,33,348009
548,0.001402,172.31.33.0-255,66,118122,33,348009
549,0.00141,74.125.68.0-255,5738,123860,33,348009
550,0.001412,172.31.33.0-255,66,123926,33,348009
551,0.001452,74.125.68.0-255,3602,127528,33,348009
552,0.001455,172.31.33.0-255,66,127594,33,348009
553,0.003426,74.125.68.0-255,1484,129078,33,348009
554,0.003476,74.125.68.0-255,1484,130562,33,348009
555,0.00348,172.31.33.0-255,66,130628,33,348009
556,0.003494,74.125.68.0-255,2902,133530,33,348009
557,0.003497,172.31.33.0-255,66,133596,33,348009
558,0.005507,74.125.68.0-255,5738,139334,33,348009
559,0.005513,172.31.33.0-255,66,139400,33,348009
560,0.007554,74.125.68.0-255,5738,145138,33,348009
561,0.007559,172.31.33.0-255,66,145204,33,348009
562,0.009594,74.125.68.0-255,5738,150942,33,348009
563,0.0096,172.31.33.0-255,66,151008,33,348009
564,0.011633,74.125.68.0-255,5738,156746,33,348009
565,0.01164,172.31.33.0-255,66,156812,33,348009
566,0.013677,74.125.68.0-255,5738,162550,33,348009
567,0.013687,172.31.33.0-255,66,162616,33,348009
568,0.015724,74.125.68.0-255,5738,168354,33,348009
569,0.015731,172.31.33.0-255,66,168420,33,348009
570,0.017779,74.125.68.0-255,5738,174158,33,348009
571,0.017786,172.31.33.0-255,66,174224,33,348009
572,0.01982,74.125.68.0-255,2902,177126,33,348009
573,0.019826,172.31.33.0-255,66,177192,33,348009
574,0.019847,74.125.68.0-255,2902,180094,33,348009
575,0.019849,172.31.33.0-255,66,180160,33,348009
576,0.021879,74.125.68.0-255,4320,184480,33,348009
577,0.021886,172.31.33.0-255,66,184546,33,348009
578,0.021902,74.125.68.0-255,1484,186030,33,348009
579,0.023933,74.125.68.0-255,4320,190350,33,348009
580,0.02394,172.31.33.0-255,66,190416,33,348009
581,0.025972,74.125.68.0-255,5738,196154,33,348009
582,0.025978,172.31.33.0-255,66,196220,33,348009
583,0.028012,74.125.68.0-255,4320,200540,33,348009
584,0.028019,172.31.33.0-255,66,200606,33,348009
585,0.028037,74.125.68.0-255,1484,202090,33,348009
586,0.03006,74.125.68.0-255,4320,206410,33,348009
587,0.030077,172.31.33.0-255,66,206476,33,348009
588,0.031841,172.31.33.0-255,172,206648,33,348009
589,0.031869,172.31.33.0-255,1117,207765,33,348009
590,0.031906,172.31.33.0-255,1514,209279,33,348009
591,0.031908,172.31.33.0-255,1280,210559,33,348009
592,0.032112,74.125.68.0-255,5738,216297,33,348009
593,0.032119,172.31.33.0-255,66,216363,33,348009
594,0.033386,104.244.42.0-255,66,216429,33,348009
595,0.033438,104.244.42.0-255,66,216495,33,348009
596,0.033492,104.244.42.0-255,66,216561,33,348009
597,0.034139,74.125.68.0-255,2902,219463,33,348009
598,0.034142,172.31.33.0-255,66,219529,33,348009
599,0.034174,74.125.68.0-255,2902,222431,33,348009
600,0.034178,172.31.33.0-255,66,222497,33,348009
601,0.036166,74.125.68.0-255,2902,225399,33,348009
602,0.036171,172.31.33.0-255,66,225465,33,348009
603,0.036205,74.125.68.0-255,2902,228367,33,348009
604,0.036208,172.31.33.0-255,66,228433,33,348009
605,0.038212,74.125.68.0-255,2902,231335,33,348009
606,0.038218,172.31.33.0-255,66,231401,33,348009
607,0.038252,74.125.68.0-255,2902,234303,33,348009
608,0.038255,172.31.33.0-255,66,234369,33,348009
609,0.040244,74.125.68.0-255,2902,237271,33,348009
610,0.040248,172.31.33.0-255,66,237337,33,348009
611,0.04028,74.125.68.0-255,2902,240239,33,348009
612,0.040283,172.31.33.0-255,66,240305,33,348009
613,0.042285,74.125.68.0-255,2902,243207,33,348009
614,0.04229,172.31.33.0-255,66,243273,33,348009
615,0.042304,74.125.68.0-255,2902,246175,33,348009
616,0.042307,172.31.33.0-255,66,246241,33,348009
617,0.044337,74.125.68.0-255,5738,251979,33,348009
618,0.044355,172.31.33.0-255,66,252045,33,348009
619,0.046414,74.125.68.0-255,5738,257783,33,348009
620,0.046431,172.31.33.0-255,66,257849,33,348009
621,0.048473,74.125.68.0-255,5738,263587,33,348009
622,0.048488,172.31.33.0-255,66,263653,33,348009
623,0.050542,74.125.68.0-255,5738,269391,33,348009
624,0.050559,172.31.33.0-255,66,269457,33,348009
625,0.05261,74.125.68.0-255,5738,275195,33,348009
626,0.052638,172.31.33.0-255,66,275261,33,348009
627,0.054703,74.125.68.0-255,5738,280999,33,348009
628,0.054717,172.31.33.0-255,66,281065,33,348009
629,0.056775,74.125.68.0-255,5738,286803,33,348009
630,0.056781,172.31.33.0-255,66,286869,33,348009
631,0.058815,74.125.68.0-255,5738,292607,33,348009
632,0.058819,172.31.33.0-255,66,292673,33,348009
633,0.060854,74.125.68.0-255,4320,296993,33,348009
634,0.06086,172.31.33.0-255,66,297059,33,348009
635,0.060877,74.125.68.0-255,1484,298543,33,348009
636,0.062885,74.125.68.0-255,4320,302863,33,348009
637,0.062891,172.31.33.0-255,66,302929,33,348009
638,0.06493,74.125.68.0-255,5738,308667,33,348009
639,0.064936,172.31.33.0-255,66,308733,33,348009
640,0.066967,74.125.68.0-255,5738,314471,33,348009
641,0.066972,172.31.33.0-255,66,314537,33,348009
642,0.069016,74.125.68.0-255,5738,320275,33,348009
643,0.069021,172.31.33.0-255,66,320341,33,348009
644,0.071057,74.125.68.0-255,5738,326079,33,348009
645,0.071062,172.31.33.0-255,66,326145,33,348009
646,0.07309,74.125.68.0-255,5738,331883,33,348009
647,0.073096,172.31.33.0-255,66,331949,33,348009
648,0.075118,74.125.68.0-255,4320,336269,33,348009
649,0.075123,172.31.33.0-255,66,336335,33,348009
650,0.07515,74.125.68.0-255,1484,337819,33,348009
651,0.077155,74.125.68.0-255,4320,342139,33,348009
652,0.07716,172.31.33.0-255,66,342205,33,348009
653,0.079185,74.125.68.0-255,5738,347943,33,348009
654,0.079189,172.31.33.0-255,66,348009,33,348009
655,0.0,74.125.200.0-255,153,153,33,344980
656,2.1e-05,172.31.33.0-255,66,219,33,344980
657,2.8e-05,74.125.200.0-255,1484,1703,33,344980
658,3.2e-05,172.31.33.0-255,66,1769,33,344980
659,3.8e-05,74.125.200.0-255,2902,4671,33,344980
660,4.8e-05,172.31.33.0-255,66,4737,33,344980
661,5.2e-05,74.125.200.0-255,2902,7639,33,344980
662,5.4e-05,172.31.33.0-255,66,7705,33,344980
663,8.6e-05,74.125.200.0-255,4320,12025,33,344980
664,8.9e-05,172.31.33.0-255,66,12091,33,344980
665,9.4e-05,74.125.200.0-255,2019,14110,33,344980
666,9.6e-05,172.31.33.0-255,66,14176,33,344980
667,0.0001,74.125.200.0-255,2902,17078,33,344980
668,0.000102,172.31.33.0-255,66,17144,33,344980
669,0.000136,74.125.200.0-255,7156,24300,33,344980
670,0.000138,172.31.33.0-255,66,24366,33,344980
671,0.000141,74.125.200.0-255,1484,25850,33,344980
672,0.000143,172.31.33.0-255,66,25916,33,344980
673,0.000172,74.125.200.0-255,5379,31295,33,344980
674,0.000174,172.31.33.0-255,66,31361,33,344980
675,0.000236,74.125.200.0-255,1484,32845,33,344980
676,0.000239,172.31.33.0-255,66,32911,33,344980
677,0.000242,74.125.200.0-255,1484,34395,33,344980
678,0.000244,172.31.33.0-255,66,34461,33,344980
679,0.000272,74.125.200.0-255,1484,35945,33,344980
680,0.000274,172.31.33.0-255,66,36011,33,344980
681,0.00028,74.125.200.0-255,5738,41749,33,344980
682,0.000282,172.31.33.0-255,66,41815,33,344980
683,0.000314,74.125.200.0-255,6797,48612,33,344980
684,0.000317,172.31.33.0-255,66,48678,33,344980
685,0.00032,74.125.200.0-255,2902,51580,33,344980
686,0.000322,172.31.33.0-255,66,51646,33,344980
687,0.000345,74.125.200.0-255,4320,55966,33,344980
688,0.000347,172.31.33.0-255,66,56032,33,344980
689,0.000352,74.125.200.0-255,5738,61770,33,344980
690,0.000355,172.31.33.0-255,66,61836,33,344980
691,0.000377,74.125.200.0-255,4273,66109,33,344980
692,0.00038,172.31.33.0-255,66,66175,33,344980
693,0.000425,74.125.200.0-255,109,66284,33,344980
694,0.000428,74.125.200.0-255,331,66615,33,344980
695,0.000636,74.125.200.0-255,1484,68099,33,344980
696,0.000641,172.31.33.0-255,66,68165,33,344980
697,0.000644,74.125.200.0-255,1484,69649,33,344980
698,0.000664,74.125.200.0-255,1484,71133,33,344980
699,0.000666,172.31.33.0-255,66,71199,33,344980
700,0.000672,74.125.200.0-255,4320,75519,33,344980
701,0.000674,172.31.33.0-255,66,75585,33,344980
702,0.00072,172.31.33.0-255,66,75651,33,344980
703,0.000903,74.125.200.0-255,1484,77135,33,344980
704,0.000923,74.125.200.0-255,2902,80037,33,344980
705,0.000927,172.31.33.0-255,66,80103,33,344980
706,0.000933,74.125.200.0-255,5738,85841,33,344980
707,0.000935,172.31.33.0-255,66,85907,33,344980
708,0.000958,74.125.200.0-255,2902,88809,33,344980
709,0.00096,172.31.33.0-255,66,88875,33,344980
710,0.000994,172.31.33.0-255,66,88941,33,344980
711,0.001023,74.125.200.0-255,1484,90425,33,344980
712,0.001076,172.31.33.0-255,66,90491,33,344980
713,0.001682,74.125.200.0-255,1484,91975,33,344980
714,0.001689,74.125.200.0-255,2902,94877,33,344980
715,0.001693,172.31.33.0-255,66,94943,33,344980
716,0.001717,74.125.200.0-255,5738,100681,33,344980
717,0.00172,172.31.33.0-255,66,100747,33,344980
718,0.001723,74.125.200.0-255,1484,102231,33,344980
719,0.001748,74.125.200.0-255,5738,107969,33,344980
720,0.001751,172.31.33.0-255,66,108035,33,344980
721,0.001763,74.125.200.0-255,1484,109519,33,344980
722,0.001785,172.31.33.0-255,66,109585,33,344980
723,0.001809,74.125.200.0-255,4320,113905,33,344980
724,0.001812,172.31.33.0-255,66,113971,33,344980
725,0.001815,74.125.200.0-255,2184,116155,33,344980
726,0.001817,172.31.33.0-255,66,116221,33,344980
727,0.001859,74.125.200.0-255,1484,117705,33,344980
728,0.001879,74.125.200.0-255,2902,120607,33,344980
729,0.001881,172.31.33.0-255,66,120673,33,344980
730,0.001894,74.125.200.0-255,1484,122157,33,344980
731,0.00191,74.125.200.0-255,4320,126477,33,344980
732,0.001912,172.31.33.0-255,66,126543,33,344980
733,0.001952,172.31.33.0-255,66,126609,33,344980
734,0.001977,74.125.200.0-255,2902,129511,33,344980
735,0.001979,172.31.33.0-255,66,129577,33,344980
736,0.002004,172.31.33.0-255,66,129643,33,344980
737,0.002064,74.125.200.0-255,1484,131127,33,344980
738,0.002091,74.125.200.0-255,2902,134029,33,344980
739,0.002092,172.31.33.0-255,66,134095,33,344980
740,0.002122,74.125.200.0-255,5738,139833,33,344980
741,0.002124,172.31.33.0-255,66,139899,33,344980
742,0.002129,74.125.200.0-255,5738,145637,33,344980
743,0.002131,172.31.33.0-255,66,145703,33,344980
744,0.002134,74.125.200.0-255,1484,147187,33,344980
745,0.002158,74.125.200.0-255,5738,152925,33,344980
746,0.00216,172.31.33.0-255,66,152991,33,344980
747,0.002176,74.125.200.0-255,1484,154475,33,344980
748,0.002193,74.125.200.0-255,7156,161631,33,344980
749,0.002195,172.31.33.0-255,66,161697,33,344980
750,0.00223,74.125.200.0-255,2184,163881,33,344980
751,0.002377,74.125.200.0-255,1484,165365,33,344980
752,0.002381,74.125.200.0-255,2902,168267,33,344980
753,0.002386,74.125.200.0-255,5738,174005,33,344980
754,0.002389,74.125.200.0-255,1484,175489,33,344980
755,0.002392,74.125.200.0-255,2902,178391,33,344980
756,0.002397,74.125.200.0-255,5738,184129,33,344980
757,0.002455,74.125.200.0-255,3602,187731,33,344980
758,0.005465,172.31.33.0-255,66,187797,33,344980
759,0.007893,74.125.200.0-255,4320,192117,33,344980
760,0.007899,172.31.33.0-255,66,192183,33,344980
761,0.007923,74.125.200.0-255,1484,193667,33,344980
762,0.010296,74.125.200.0-255,4320,197987,33,344980
763,0.010303,172.31.33.0-255,66,198053,33,344980
764,0.012728,74.125.200.0-255,5738,203791,33,344980
765,0.012735,172.31.33.0-255,66,203857,33,344980
766,0.015138,74.125.200.0-255,5738,209595,33,344980
767,0.015143,172.31.33.0-255,66,209661,33,344980
768,0.017541,74.125.200.0-255,5738,215399,33,344980
769,0.01755,172.31.33.0-255,66,215465,33,344980
770,0.019964,74.125.200.0-255,5738,221203,33,344980
771,0.019978,172.31.33.0-255,66,221269,33,344980
772,0.022387,74.125.200.0-255,5738,227007,33,344980
773,0.0224,172.31.33.0-255,66,227073,33,344980
774,0.024814,74.125.200.0-255,5738,232811,33,344980
775,0.024822,172.31.33.0-255,66,232877,33,344980
776,0.026366,172.31.33.0-255,172,233049,33,344980
777,0.026395,172.31.33.0-255,1117,234166,33,344980
778,0.026437,172.31.33.0-255,1514,235680,33,344980
779,0.026439,172.31.33.0-255,1514,237194,33,344980
780,0.026461,172.31.33.0-255,676,237870,33,344980
781,0.027234,74.125.200.0-255,5738,243608,33,344980
782,0.02724,172.31.33.0-255,66,243674,33,344980
783,0.028038,104.244.42.0-255,66,243740,33,344980
784,0.028079,104.244.42.0-255,66,243806,33,344980
785,0.028131,104.244.42.0-255,66,243872,33,344980
786,0.028134,104.244.42.0-255,66,243938,33,344980
787,0.02964,74.125.200.0-255,5738,249676,33,344980
788,0.029645,172.31.33.0-255,66,249742,33,344980
789,0.032033,74.125.200.0-255,5738,255480,33,344980
790,0.032039,172.31.33.0-255,66,255546,33,344980
791,0.03443,74.125.200.0-255,4320,259866,33,344980
792,0.034436,172.31.33.0-255,66,259932,33,344980
793,0.034467,74.125.200.0-255,1484,261416,33,344980
794,0.036827,74.125.200.0-255,4320,265736,33,344980
795,0.036838,172.31.33.0-255,66,265802,33,344980
796,0.039236,74.125.200.0-255,5738,271540,33,344980
797,0.039242,172.31.33.0-255,66,271606,33,344980
798,0.041643,74.125.200.0-255,5738,277344,33,344980
799,0.041649,172.31.33.0-255,66,277410,33,344980
800,0.044058,74.125.200.0-255,5738,283148,33,344980
801,0.044063,172.31.33.0-255,66,283214,33,344980
802,0.046463,74.125.200.0-255,5738,288952,33,344980
803,0.046469,172.31.33.0-255,66,289018,33,344980
804,0.048976,74.125.200.0-255,5738,294756,33,344980
805,0.048982,172.31.33.0-255,66,294822,33,344980
806,0.051389,74.125.200.0-255,5738,300560,33,344980
807,0.051396,172.31.33.0-255,66,300626,33,344980
808,0.053799,74.125.200.0-255,5738,306364,33,344980
809,0.053809,172.31.33.0-255,66,306430,33,344980
810,0.056201,74.125.200.0-255,5738,312168,33,344980
811,0.056207,172.31.33.0-255,66,312234,33,344980
812,0.058602,74.125.200.0-255,5738,317972,33,344980
813,0.058609,172.31.33.0-255,66,318038,33,344980
814,0.061001,74.125.200.0-255,5738,323776,33,344980
815,0.061006,172.31.33.0-255,66,323842,33,344980
816,0.063401,74.125.200.0-255,5738,329580,33,344980
817,0.063406,172.31.33.0-255,66,329646,33,344980
818,0.065798,74.125.200.0-255,4320,333966,33,344980
819,0.065804,172.31.33.0-255,66,334032,33,344980
820,0.065826,74.125.200.0-255,1484,335516,33,344980
821,0.0682,74.125.200.0-255,4320,339836,33,344980
822,0.068206,172.31.33.0-255,66,339902,33,344980
823,0.070606,74.125.200.0-255,4841,344743,33,344980
824,0.070615,172.31.33.0-255,66,344809,33,344980
825,0.070822,172.31.33.0-255,105,344914,33,344980
826,0.073163,74.125.200.0-255,66,344980,33,344980
827,0.0,74.125.24.0-255,146,146,33,239489
828,2.2e-05,172.31.33.0-255,66,212,33,239489
829,2.8e-05,74.125.24.0-255,1484,1696,33,239489
830,3.2e-05,172.31.33.0-255,66,1762,33,239489
831,3.7e-05,74.125.24.0-255,2902,4664,33,239489
832,4.1e-05,172.31.33.0-255,66,4730,33,239489
833,4.7e-05,74.125.24.0-255,7156,11886,33,239489
834,5.1e-05,172.31.33.0-255,66,11952,33,239489
835,5.4e-05,74.125.24.0-255,2902,14854,33,239489
836,5.7e-05,172.31.33.0-255,66,14920,33,239489
837,8.4e-05,172.31.33.0-255,66,14986,33,239489
838,9e-05,74.125.24.0-255,5738,20724,33,239489
839,9.2e-05,172.31.33.0-255,66,20790,33,239489
840,0.000105,74.125.24.0-255,1125,21915,33,239489
841,0.000107,172.31.33.0-255,66,21981,33,239489
842,0.000167,74.125.24.0-255,1484,23465,33,239489
843,0.000169,172.31.33.0-255,66,23531,33,239489
844,0.000188,74.125.24.0-255,2902,26433,33,239489
845,0.00019,172.31.33.0-255,66,26499,33,239489
846,0.000194,74.125.24.0-255,2902,29401,33,239489
847,0.000196,172.31.33.0-255,66,29467,33,239489
848,0.00021,74.125.24.0-255,2902,32369,33,239489
849,0.000213,172.31.33.0-255,66,32435,33,239489
850,0.000235,74.125.24.0-255,1484,33919,33,239489
851,0.000236,172.31.33.0-255,66,33985,33,239489
852,0.000262,172.31.33.0-255,66,34051,33,239489
853,0.000283,74.125.24.0-255,1484,35535,33,239489
854,0.000285,172.31.33.0-255,66,35601,33,239489
855,0.00031,172.31.33.0-255,66,35667,33,239489
856,0.000325,74.125.24.0-255,331,35998,33,239489
857,0.000844,172.31.33.0-255,66,36064,33,239489
858,0.002061,74.125.24.0-255,1484,37548,33,239489
859,0.002069,74.125.24.0-255,1484,39032,33,239489
860,0.002079,74.125.24.0-255,1484,40516,33,239489
861,0.002092,74.125.24.0-255,1484,42000,33,239489
862,0.002109,74.125.24.0-255,4320,46320,33,239489
863,0.002126,74.125.24.0-255,2902,49222,33,239489
864,0.002166,74.125.24.0-255,4320,53542,33,239489
865,0.002176,74.125.24.0-255,2902,56444,33,239489
866,0.002187,74.125.24.0-255,3602,60046,33,239489
867,0.005935,172.31.33.0-255,66,60112,33,239489
868,0.00827,74.125.24.0-255,5738,65850,33,239489
869,0.008277,172.31.33.0-255,66,65916,33,239489
870,0.010562,74.125.24.0-255,5738,71654,33,239489
871,0.010849,172.31.33.0-255,66,71720,33,239489
872,0.013131,74.125.24.0-255,5738,77458,33,239489
873,0.01314,172.31.33.0-255,66,77524,33,239489
874,0.015438,74.125.24.0-255,5738,83262,33,239489
875,0.015445,172.31.33.0-255,66,83328,33,239489
876,0.017734,74.125.24.0-255,5738,89066,33,239489
877,0.017742,172.31.33.0-255,66,89132,33,239489
878,0.020041,74.125.24.0-255,5738,94870,33,239489
879,0.020049,172.31.33.0-255,66,94936,33,239489
880,0.022362,74.125.24.0-255,5738,100674,33,239489
881,0.022369,172.31.33.0-255,66,100740,33,239489
882,0.023141,172.31.33.0-255,172,100912,33,239489
883,0.023172,172.31.33.0-255,1113,102025,33,239489
884,0.023224,172.31.33.0-255,1514,103539,33,239489
885,0.023226,172.31.33.0-255,1514,105053,33,239489
886,0.023251,172.31.33.0-255,680,105733,33,239489
887,0.024684,74.125.24.0-255,5738,111471,33,239489
888,0.024691,172.31.33.0-255,66,111537,33,239489
889,0.024698,104.244.42.0-255,66,111603,33,239489
890,0.024704,104.244.42.0-255,66,111669,33,239489
891,0.024761,104.244.42.0-255,66,111735,33,239489
892,0.024764,104.244.42.0-255,66,111801,33,239489
893,0.027006,74.125.24.0-255,5738,117539,33,239489
894,0.027012,172.31.33.0-255,66,117605,33,239489
895,0.029293,74.125.24.0-255,5738,123343,33,239489
896,0.0293,172.31.33.0-255,66,123409,33,239489
897,0.031585,74.125.24.0-255,5738,129147,33,239489
898,0.031591,172.31.33.0-255,66,129213,33,239489
899,0.033877,74.125.24.0-255,5738,134951,33,239489
900,0.033883,172.31.33.0-255,66,135017,33,239489
901,0.036233,74.125.24.0-255,5738,140755,33,239489
902,0.036239,172.31.33.0-255,66,140821,33,239489
903,0.038565,74.125.24.0-255,5738,146559,33,239489
904,0.03857,172.31.33.0-255,66,146625,33,239489
905,0.040853,74.125.24.0-255,5738,152363,33,239489
906,0.04086,172.31.33.0-255,66,152429,33,239489
907,0.043141,74.125.24.0-255,5738,158167,33,239489
908,0.043146,172.31.33.0-255,66,158233,33,239489
909,0.04543,74.125.24.0-255,5738,163971,33,239489
910,0.045434,172.31.33.0-255,66,164037,33,239489
911,0.047739,74.125.24.0-255,5738,169775,33,239489
912,0.047756,172.31.33.0-255,66,169841,33,239489
913,0.050062,74.125.24.0-255,5738,175579,33,239489
914,0.050069,172.31.33.0-255,66,175645,33,239489
915,0.052366,74.125.24.0-255,5738,181383,33,239489
916,0.052372,172.31.33.0-255,66,181449,33,239489
917,0.054705,74.125.24.0-255,5738,187187,33,239489
918,0.05471,172.31.33.0-255,66,187253,33,239489
919,0.057001,74.125.24.0-255,5738,192991,33,239489
920,0.057007,172.31.33.0-255,66,193057,33,239489
921,0.059297,74.125.24.0-255,5738,198795,33,239489
922,0.059303,172.31.33.0-255,66,198861,33,239489
923,0.061603,74.125.24.0-255,5738,204599,33,239489
924,0.061609,172.31.33.0-255,66,204665,33,239489
925,0.06389,74.125.24.0-255,5738,210403,33,239489
926,0.063896,172.31.33.0-255,66,210469,33,239489
927,0.066232,74.125.24.0-255,5738,216207,33,239489
928,0.066237,172.31.33.0-255,66,216273,33,239489
929,0.068512,74.125.24.0-255,5738,222011,33,239489
930,0.070974,172.31.33.0-255,66,222077,33,239489
931,0.073261,74.125.24.0-255,5738,227815,33,239489
932,0.073271,172.31.33.0-255,66,227881,33,239489
933,0.075562,74.125.24.0-255,5738,233619,33,239489
934,0.075568,172.31.33.0-255,66,233685,33,239489
935,0.077897,74.125.24.0-255,5738,239423,33,239489
936,0.077903,172.31.33.0-255,66,239489,33,239489
937,0.0,74.125.24.0-255,153,153,33,149726
938,3.6e-05,172.31.33.0-255,66,219,33,149726
939,4.4e-05,74.125.24.0-255,1484,1703,33,149726
940,4.8e-05,172.31.33.0-255,66,1769,33,149726
941,5.3e-05,74.125.24.0-255,2902,4671,33,149726
942,6.4e-05,172.31.33.0-255,66,4737,33,149726
943,6.8e-05,74.125.24.0-255,1484,6221,33,149726
944,7e-05,172.31.33.0-255,66,6287,33,149726
945,7.4e-05,74.125.24.0-255,2902,9189,33,149726
946,7.7e-05,172.31.33.0-255,66,9255,33,149726
947,8.3e-05,74.125.24.0-255,4905,14160,33,149726
948,8.6e-05,172.31.33.0-255,66,14226,33,149726
949,0.000149,74.125.24.0-255,1484,15710,33,149726
950,0.000153,172.31.33.0-255,66,15776,33,149726
951,0.000189,74.125.24.0-255,2902,18678,33,149726
952,0.000192,172.31.33.0-255,66,18744,33,149726
953,0.000198,74.125.24.0-255,4320,23064,33,149726
954,0.000201,172.31.33.0-255,66,23130,33,149726
955,0.000239,74.125.24.0-255,4320,27450,33,149726
956,0.000243,172.31.33.0-255,66,27516,33,149726
957,0.000263,74.125.24.0-255,3961,31477,33,149726
958,0.000266,172.31.33.0-255,66,31543,33,149726
959,0.000283,74.125.24.0-255,1484,33027,33,149726
960,0.000286,172.31.33.0-255,66,33093,33,149726
961,0.000292,74.125.24.0-255,2902,35995,33,149726
962,0.000294,172.31.33.0-255,66,36061,33,149726
963,0.000299,74.125.24.0-255,2902,38963,33,149726
964,0.000302,172.31.33.0-255,66,39029,33,149726
965,0.000316,74.125.24.0-255,2902,41931,33,149726
966,0.000322,172.31.33.0-255,66,41997,33,149726
967,0.000352,74.125.24.0-255,5738,47735,33,149726
968,0.000355,172.31.33.0-255,66,47801,33,149726
969,0.000389,74.125.24.0-255,5379,53180,33,149726
970,0.000393,172.31.33.0-255,66,53246,33,149726
971,0.000413,172.31.33.0-255,66,53312,33,149726
972,0.000416,74.125.24.0-255,1395,54707,33,149726
973,0.000802,172.31.33.0-255,66,54773,33,149726
974,0.000989,74.125.24.0-255,134,54907,33,149726
975,0.001047,74.125.24.0-255,1484,56391,33,149726
976,0.001052,172.31.33.0-255,66,56457,33,149726
977,0.001058,74.125.24.0-255,2902,59359,33,149726
978,0.001061,172.31.33.0-255,66,59425,33,149726
979,0.001071,74.125.24.0-255,2902,62327,33,149726
980,0.001074,172.31.33.0-255,66,62393,33,149726
981,0.001102,74.125.24.0-255,2902,65295,33,149726
982,0.001105,172.31.33.0-255,66,65361,33,149726
983,0.001109,74.125.24.0-255,1484,66845,33,149726
984,0.001145,172.31.33.0-255,66,66911,33,149726
985,0.001148,74.125.24.0-255,1484,68395,33,149726
986,0.001151,74.125.24.0-255,1484,69879,33,149726
987,0.001153,172.31.33.0-255,66,69945,33,149726
988,0.001188,172.31.33.0-255,66,70011,33,149726
989,0.001298,74.125.24.0-255,1484,71495,33,149726
990,0.001313,74.125.24.0-255,2902,74397,33,149726
991,0.001317,172.31.33.0-255,66,74463,33,149726
992,0.001324,74.125.24.0-255,4320,78783,33,149726
993,0.001326,172.31.33.0-255,66,78849,33,149726
994,0.001362,74.125.24.0-255,1484,80333,33,149726
995,0.001378,172.31.33.0-255,66,80399,33,149726
996,0.00139,172.31.33.0-255,66,80465,33,149726
997,0.001428,172.31.33.0-255,66,80531,33,149726
998,0.001439,172.31.33.0-255,66,80597,33,149726
999,0.001475,172.31.33.0-255,66,80663,33,149726
1000,0.001507,74.125.24.0-255,2902,83565,33,149726
1001,0.001509,172.31.33.0-255,66,83631,33,149726
1002,0.001536,74.125.24.0-255,3602,87233,33,149726
1003,0.001539,172.31.33.0-255,66,87299,33,149726
1004,0.001614,74.125.24.0-255,1484,88783,33,149726
1005,0.001619,74.125.24.0-255,2902,91685,33,149726
1006,0.001621,172.31.33.0-255,66,91751,33,149726
1007,0.001645,74.125.24.0-255,5738,97489,33,149726
1008,0.001647,172.31.33.0-255,66,97555,33,149726
1009,0.00165,74.125.24.0-255,1484,99039,33,149726
1010,0.001674,172.31.33.0-255,66,99105,33,149726
1011,0.00168,74.125.24.0-255,7156,106261,33,149726
1012,0.001682,172.31.33.0-255,66,106327,33,149726
1013,0.001706,74.125.24.0-255,2902,109229,33,149726
1014,0.001708,172.31.33.0-255,66,109295,33,149726
1015,0.001714,74.125.24.0-255,766,110061,33,149726
1016,0.0019,74.125.24.0-255,1484,111545,33,149726
1017,0.001903,172.31.33.0-255,66,111611,33,149726
1018,0.001907,74.125.24.0-255,2902,114513,33,149726
1019,0.001909,172.31.33.0-255,66,114579,33,149726
1020,0.001938,74.125.24.0-255,5738,120317,33,149726
1021,0.00194,172.31.33.0-255,66,120383,33,149726
1022,0.001943,74.125.24.0-255,1484,121867,33,149726
1023,0.001957,172.31.33.0-255,66,121933,33,149726
1024,0.00199,74.125.24.0-255,7156,129089,33,149726
1025,0.001992,172.31.33.0-255,66,129155,33,149726
1026,0.002024,172.31.33.0-255,66,129221,33,149726
1027,0.002087,172.31.33.0-255,66,129287,33,149726
1028,0.002118,74.125.24.0-255,7156,136443,33,149726
1029,0.002121,172.31.33.0-255,66,136509,33,149726
1030,0.002142,172.31.33.0-255,66,136575,33,149726
1031,0.002167,172.31.33.0-255,66,136641,33,149726
1032,0.002185,172.31.33.0-255,66,136707,33,149726
1033,0.002219,172.31.33.0-255,66,136773,33,149726
1034,0.002226,74.125.24.0-255,7156,143929,33,149726
1035,0.002228,172.31.33.0-255,66,143995,33,149726
1036,0.002271,172.31.33.0-255,66,144061,33,149726
1037,0.0023,172.31.33.0-255,66,144127,33,149726
1038,0.002303,74.125.24.0-255,105,144232,33,149726
1039,0.006843,172.31.33.0-255,66,144298,33,149726
1040,0.00687,172.31.33.0-255,105,144403,33,149726
1041,0.009204,74.125.24.0-255,66,144469,33,149726
1042,0.030868,172.31.33.0-255,172,144641,33,149726
1043,0.030899,172.31.33.0-255,1117,145758,33,149726
1044,0.030943,172.31.33.0-255,1514,147272,33,149726
1045,0.030945,172.31.33.0-255,1514,148786,33,149726
1046,0.030945,172.31.33.0-255,676,149462,33,149726
1047,0.032412,104.244.42.0-255,66,149528,33,149726
1048,0.032444,104.244.42.0-255,66,149594,33,149726
1049,0.032491,104.244.42.0-255,66,149660,33,149726
1050,0.032495,104.244.42.0-255,66,149726,33,149726
1051,0.0,172.31.33.0-255,105,105,33,1836
1052,6.1e-05,172.31.33.0-255,105,210,33,1836
1053,8.9e-05,172.31.33.0-255,105,315,33,1836
1054,0.000149,172.31.33.0-255,105,420,33,1836
1055,0.000369,172.31.33.0-255,90,510,33,1836
1056,0.000377,172.31.33.0-255,66,576,33,1836
1057,0.000592,172.31.33.0-255,90,666,33,1836
1058,0.000599,172.31.33.0-255,66,732,33,1836
1059,0.00076,172.31.33.0-255,90,822,33,1836
1060,0.000767,172.31.33.0-255,66,888,33,1836
1061,0.000897,172.31.33.0-255,90,978,33,1836
1062,0.000903,172.31.33.0-255,66,1044,33,1836
1063,0.002647,74.125.200.0-255,66,1110,33,1836
1064,0.002661,74.125.200.0-255,66,1176,33,1836
1065,0.002671,172.31.33.0-255,66,1242,33,1836
1066,0.003002,74.125.24.0-255,66,1308,33,1836
1067,0.003007,74.125.24.0-255,66,1374,33,1836
1068,0.00301,172.31.33.0-255,66,1440,33,1836
1069,0.003037,74.125.24.0-255,66,1506,33,1836
1070,0.003049,74.125.24.0-255,66,1572,33,1836
1071,0.003051,172.31.33.0-255,66,1638,33,1836
1072,0.003471,74.125.200.0-255,66,1704,33,1836
1073,0.00349,74.125.200.0-255,66,1770,33,1836
1074,0.003493,172.31.33.0-255,66,1836,33,1836
1075,0.0,172.31.33.0-255,105,105,33,459
1076,0.000186,172.31.33.0-255,90,195,33,459
1077,0.000194,172.31.33.0-255,66,261,33,459
1078,0.002486,74.125.130.0-255,66,327,33,459
1079,0.002512,74.125.130.0-255,66,393,33,459
1080,0.002532,172.31.33.0-255,66,459,33,459
1081,0.0,74.125.24.0-255,153,153,33,329992
1082,2.4e-05,172.31.33.0-255,66,219,33,329992
1083,3.2e-05,74.125.24.0-255,1484,1703,33,329992
1084,3.6e-05,172.31.33.0-255,66,1769,33,329992
1085,4.2e-05,74.125.24.0-255,2902,4671,33,329992
1086,4.5e-05,172.31.33.0-255,66,4737,33,329992
1087,5e-05,74.125.24.0-255,4320,9057,33,329992
1088,5.3e-05,172.31.33.0-255,66,9123,33,329992
1089,7.8e-05,74.125.24.0-255,1484,10607,33,329992
1090,8e-05,172.31.33.0-255,66,10673,33,329992
1091,9.4e-05,74.125.24.0-255,3509,14182,33,329992
1092,9.6e-05,172.31.33.0-255,66,14248,33,329992
1093,0.000545,74.125.24.0-255,1484,15732,33,329992
1094,0.000552,172.31.33.0-255,66,15798,33,329992
1095,0.000561,74.125.24.0-255,2902,18700,33,329992
1096,0.000563,172.31.33.0-255,66,18766,33,329992
1097,0.00057,74.125.24.0-255,4320,23086,33,329992
1098,0.000572,172.31.33.0-255,66,23152,33,329992
1099,0.000589,74.125.24.0-255,1484,24636,33,329992
1100,0.000591,172.31.33.0-255,66,24702,33,329992
1101,0.000598,74.125.24.0-255,5738,30440,33,329992
1102,0.0006,172.31.33.0-255,66,30506,33,329992
1103,0.000624,74.125.24.0-255,1125,31631,33,329992
1104,0.000626,172.31.33.0-255,66,31697,33,329992
1105,0.000634,74.125.24.0-255,7156,38853,33,329992
1106,0.000637,172.31.33.0-255,66,38919,33,329992
1107,0.00064,74.125.24.0-255,1484,40403,33,329992
1108,0.000642,172.31.33.0-255,66,40469,33,329992
1109,0.000678,172.31.33.0-255,66,40535,33,329992
1110,0.000684,74.125.24.0-255,4320,44855,33,329992
1111,0.000686,172.31.33.0-255,66,44921,33,329992
1112,0.000701,74.125.24.0-255,5738,50659,33,329992
1113,0.000705,172.31.33.0-255,66,50725,33,329992
1114,0.000711,74.125.24.0-255,5738,56463,33,329992
1115,0.000714,172.31.33.0-255,66,56529,33,329992
1116,0.000732,74.125.24.0-255,1125,57654,33,329992
1117,0.000737,74.125.24.0-255,647,58301,33,329992
1118,0.000739,172.31.33.0-255,66,58367,33,329992
1119,0.001539,74.125.24.0-255,1484,59851,33,329992
1120,0.001549,74.125.24.0-255,2902,62753,33,329992
1121,0.001555,172.31.33.0-255,66,62819,33,329992
1122,0.001562,74.125.24.0-255,5738,68557,33,329992
1123,0.001565,172.31.33.0-255,66,68623,33,329992
1124,0.001569,74.125.24.0-255,2902,71525,33,329992
1125,0.001572,172.31.33.0-255,66,71591,33,329992
1126,0.001592,74.125.24.0-255,7156,78747,33,329992
1127,0.001595,172.31.33.0-255,66,78813,33,329992
1128,0.001609,74.125.24.0-255,2902,81715,33,329992
1129,0.001611,172.31.33.0-255,66,81781,33,329992
1130,0.001648,172.31.33.0-255,66,81847,33,329992
1131,0.001853,74.125.24.0-255,1484,83331,33,329992
1132,0.001859,74.125.24.0-255,2902,86233,33,329992
1133,0.001862,172.31.33.0-255,66,86299,33,329992
1134,0.001885,74.125.24.0-255,5738,92037,33,329992
1135,0.001888,172.31.33.0-255,66,92103,33,329992
1136,0.001891,74.125.24.0-255,1484,93587,33,329992
1137,0.001917,172.31.33.0-255,66,93653,33,329992
1138,0.00192,74.125.24.0-255,1484,95137,33,329992
1139,0.001978,172.31.33.0-255,66,95203,33,329992
1140,0.001997,74.125.24.0-255,766,95969,33,329992
1141,0.002021,172.31.33.0-255,66,96035,33,329992
1142,0.002032,172.31.33.0-255,66,96101,33,329992
1143,0.002082,74.125.24.0-255,1484,97585,33,329992
1144,0.002097,74.125.24.0-255,2902,100487,33,329992
1145,0.0021,172.31.33.0-255,66,100553,33,329992
1146,0.002106,74.125.24.0-255,5738,106291,33,329992
1147,0.002108,172.31.33.0-255,66,106357,33,329992
1148,0.002152,172.31.33.0-255,66,106423,33,329992
1149,0.002171,74.125.24.0-255,4320,110743,33,329992
1150,0.002173,172.31.33.0-255,66,110809,33,329992
1151,0.002179,74.125.24.0-255,4320,115129,33,329992
1152,0.002181,172.31.33.0-255,66,115195,33,329992
1153,0.002201,74.125.24.0-255,6438,121633,33,329992
1154,0.002204,172.31.33.0-255,66,121699,33,329992
1155,0.002278,74.125.24.0-255,1484,123183,33,329992
1156,0.002296,74.125.24.0-255,1484,124667,33,329992
1157,0.002299,172.31.33.0-255,66,124733,33,329992
1158,0.004467,74.125.24.0-255,2902,127635,33,329992
1159,0.004477,172.31.33.0-255,66,127701,33,329992
1160,0.00453,74.125.24.0-255,2902,130603,33,329992
1161,0.004534,172.31.33.0-255,66,130669,33,329992
1162,0.006704,74.125.24.0-255,2902,133571,33,329992
1163,0.006714,172.31.33.0-255,66,133637,33,329992
1164,0.006789,74.125.24.0-255,2902,136539,33,329992
1165,0.006793,172.31.33.0-255,66,136605,33,329992
1166,0.008998,74.125.24.0-255,2902,139507,33,329992
1167,0.009006,172.31.33.0-255,66,139573,33,329992
1168,0.009038,74.125.24.0-255,1484,141057,33,329992
1169,0.009054,74.125.24.0-255,1484,142541,33,329992
1170,0.009057,172.31.33.0-255,66,142607,33,329992
1171,0.0113,74.125.24.0-255,2902,145509,33,329992
1172,0.01131,172.31.33.0-255,66,145575,33,329992
1173,0.011331,74.125.24.0-255,2902,148477,33,329992
1174,0.011334,172.31.33.0-255,66,148543,33,329992
1175,0.013612,74.125.24.0-255,5738,154281,33,329992
1176,0.01362,172.31.33.0-255,66,154347,33,329992
1177,0.015871,74.125.24.0-255,5738,160085,33,329992
1178,0.015879,172.31.33.0-255,66,160151,33,329992
1179,0.018143,74.125.24.0-255,5738,165889,33,329992
1180,0.018151,172.31.33.0-255,66,165955,33,329992
1181,0.020444,74.125.24.0-255,5738,171693,33,329992
1182,0.020454,172.31.33.0-255,66,171759,33,329992
1183,0.022744,74.125.24.0-255,5738,177497,33,329992
1184,0.022762,172.31.33.0-255,66,177563,33,329992
1185,0.025047,74.125.24.0-255,5738,183301,33,329992
1186,0.025064,172.31.33.0-255,66,183367,33,329992
1187,0.027356,74.125.24.0-255,5738,189105,33,329992
1188,0.027375,172.31.33.0-255,66,189171,33,329992
1189,0.029646,74.125.24.0-255,5738,194909,33,329992
1190,0.029662,172.31.33.0-255,66,194975,33,329992
1191,0.031917,74.125.24.0-255,5738,200713,33,329992
1192,0.031925,172.31.33.0-255,66,200779,33,329992
1193,0.034201,74.125.24.0-255,5738,206517,33,329992
1194,0.034213,172.31.33.0-255,66,206583,33,329992
1195,0.036498,74.125.24.0-255,5738,212321,33,329992
1196,0.036517,172.31.33.0-255,66,212387,33,329992
1197,0.038753,74.125.24.0-255,5738,218125,33,329992
1198,0.038762,172.31.33.0-255,66,218191,33,329992
1199,0.039908,172.31.33.0-255,172,218363,33,329992
1200,0.039941,172.31.33.0-255,1117,219480,33,329992
1201,0.040007,172.31.33.0-255,1514,220994,33,329992
1202,0.040008,172.31.33.0-255,1514,222508,33,329992
1203,0.040009,172.31.33.0-255,1514,224022,33,329992
1204,0.040011,172.31.33.0-255,1060,225082,33,329992
1205,0.041028,74.125.24.0-255,5738,230820,33,329992
1206,0.041036,172.31.33.0-255,66,230886,33,329992
1207,0.041463,104.244.42.0-255,66,230952,33,329992
1208,0.041545,104.244.42.0-255,66,231018,33,329992
1209,0.041606,104.244.42.0-255,66,231084,33,329992
1210,0.041611,104.244.42.0-255,66,231150,33,329992
1211,0.042999,104.244.42.0-255,108,231258,33,329992
1212,0.043008,172.31.33.0-255,66,231324,33,329992
1213,0.043298,74.125.24.0-255,5738,237062,33,329992
1214,0.043302,172.31.33.0-255,66,237128,33,329992
1215,0.045584,74.125.24.0-255,5738,242866,33,329992
1216,0.045589,172.31.33.0-255,66,242932,33,329992
1217,0.047838,74.125.24.0-255,5738,248670,33,329992
1218,0.047846,172.31.33.0-255,66,248736,33,329992
1219,0.050129,74.125.24.0-255,5738,254474,33,329992
1220,0.050137,172.31.33.0-255,66,254540,33,329992
1221,0.052406,74.125.24.0-255,5738,260278,33,329992
1222,0.052412,172.31.33.0-255,66,260344,33,329992
1223,0.054653,74.125.24.0-255,5738,266082,33,329992
1224,0.05466,172.31.33.0-255,66,266148,33,329992
1225,0.056944,74.125.24.0-255,5738,271886,33,329992
1226,0.056952,172.31.33.0-255,66,271952,33,329992
1227,0.059208,74.125.24.0-255,5738,277690,33,329992
1228,0.059214,172.31.33.0-255,66,277756,33,329992
1229,0.061472,74.125.24.0-255,5738,283494,33,329992
1230,0.061477,172.31.33.0-255,66,283560,33,329992
1231,0.063758,74.125.24.0-255,5738,289298,33,329992
1232,0.063764,172.31.33.0-255,66,289364,33,329992
1233,0.066014,74.125.24.0-255,5738,295102,33,329992
1234,0.066021,172.31.33.0-255,66,295168,33,329992
1235,0.068304,74.125.24.0-255,5738,300906,33,329992
1236,0.068311,172.31.33.0-255,66,300972,33,329992
1237,0.070575,74.125.24.0-255,5738,306710,33,329992
1238,0.070585,172.31.33.0-255,66,306776,33,329992
1239,0.072854,74.125.24.0-255,5738,312514,33,329992
1240,0.072862,172.31.33.0-255,66,312580,33,329992
1241,0.075136,74.125.24.0-255,5738,318318,33,329992
1242,0.075143,172.31.33.0-255,66,318384,33,329992
1243,0.077407,74.125.24.0-255,5738,324122,33,329992
1244,0.077413,172.31.33.0-255,66,324188,33,329992
1245,0.079708,74.125.24.0-255,5738,329926,33,329992
1246,0.079715,172.31.33.0-255,66,329992,33,329992
1247,0.0,172.217.194.0-255,154,154,33,179858
1248,1.5e-05,172.31.33.0-255,66,220,33,179858
1249,2.2e-05,172.217.194.0-255,1484,1704,33,179858
1250,2.6e-05,172.31.33.0-255,66,1770,33,179858
1251,3.9e-05,172.217.194.0-255,2902,4672,33,179858
1252,4.2e-05,172.31.33.0-255,66,4738,33,179858
1253,7.9e-05,172.217.194.0-255,7156,11894,33,179858
1254,8.3e-05,172.31.33.0-255,66,11960,33,179858
1255,8.7e-05,172.217.194.0-255,2012,13972,33,179858
1256,8.9e-05,172.31.33.0-255,66,14038,33,179858
1257,0.000119,172.217.194.0-255,1484,15522,33,179858
1258,0.000121,172.31.33.0-255,66,15588,33,179858
1259,0.000147,172.217.194.0-255,2902,18490,33,179858
1260,0.000149,172.31.33.0-255,66,18556,33,179858
1261,0.000155,172.217.194.0-255,5738,24294,33,179858
1262,0.000158,172.31.33.0-255,66,24360,33,179858
1263,0.000188,172.217.194.0-255,6797,31157,33,179858
1264,0.00019,172.31.33.0-255,66,31223,33,179858
1265,0.00023,172.217.194.0-255,1484,32707,33,179858
1266,0.000233,172.31.33.0-255,66,32773,33,179858
1267,0.000238,172.217.194.0-255,2902,35675,33,179858
1268,0.00024,172.31.33.0-255,66,35741,33,179858
1269,0.000257,172.217.194.0-255,1484,37225,33,179858
1270,0.00026,172.31.33.0-255,66,37291,33,179858
1271,0.000289,172.217.194.0-255,4320,41611,33,179858
1272,0.000292,172.31.33.0-255,66,41677,33,179858
1273,0.000297,172.217.194.0-255,4320,45997,33,179858
1274,0.000299,172.31.33.0-255,66,46063,33,179858
1275,0.000331,172.217.194.0-255,2543,48606,33,179858
1276,0.000334,172.31.33.0-255,66,48672,33,179858
1277,0.000341,172.217.194.0-255,7156,55828,33,179858
1278,0.000343,172.31.33.0-255,66,55894,33,179858
1279,0.000354,172.31.33.0-255,66,55960,33,179858
1280,0.000356,172.217.194.0-255,396,56356,33,179858
1281,0.00042,172.217.194.0-255,1484,57840,33,179858
1282,0.000423,172.31.33.0-255,66,57906,33,179858
1283,0.000428,172.217.194.0-255,4320,62226,33,179858
1284,0.00043,172.31.33.0-255,66,62292,33,179858
1285,0.00044,172.31.33.0-255,66,62358,33,179858
1286,0.000465,172.217.194.0-255,4320,66678,33,179858
1287,0.000467,172.31.33.0-255,66,66744,33,179858
1288,0.000499,172.31.33.0-255,66,66810,33,179858
1289,0.000503,172.217.194.0-255,3961,70771,33,179858
1290,0.000505,172.31.33.0-255,66,70837,33,179858
1291,0.000556,172.217.194.0-255,1484,72321,33,179858
1292,0.000562,172.217.194.0-255,2902,75223,33,179858
1293,0.000564,172.31.33.0-255,66,75289,33,179858
1294,0.00059,172.217.194.0-255,5738,81027,33,179858
1295,0.000593,172.31.33.0-255,66,81093,33,179858
1296,0.000595,172.217.194.0-255,1484,82577,33,179858
1297,0.000606,172.31.33.0-255,66,82643,33,179858
1298,0.000634,172.217.194.0-255,2902,85545,33,179858
1299,0.000636,172.31.33.0-255,66,85611,33,179858
1300,0.000648,172.31.33.0-255,66,85677,33,179858
1301,0.000652,172.217.194.0-255,2902,88579,33,179858
1302,0.000654,172.31.33.0-255,66,88645,33,179858
1303,0.000685,172.217.194.0-255,7156,95801,33,179858
1304,0.000688,172.31.33.0-255,66,95867,33,179858
1305,0.000695,172.217.194.0-255,6797,102664,33,179858
1306,0.000697,172.31.33.0-255,66,102730,33,179858
1307,0.000849,172.217.194.0-255,1484,104214,33,179858
1308,0.000863,172.217.194.0-255,2902,107116,33,179858
1309,0.000866,172.217.194.0-255,1484,108600,33,179858
1310,0.000876,172.31.33.0-255,66,108666,33,179858
1311,0.000881,172.217.194.0-255,4320,112986,33,179858
1312,0.000898,172.217.194.0-255,1484,114470,33,179858
1313,0.000912,172.217.194.0-255,4320,118790,33,179858
1314,0.000932,172.31.33.0-255,66,118856,33,179858
1315,0.000939,172.217.194.0-255,7156,126012,33,179858
1316,0.000942,172.217.194.0-255,1484,127496,33,179858
1317,0.000966,172.31.33.0-255,66,127562,33,179858
1318,0.000979,172.217.194.0-255,7156,134718,33,179858
1319,0.001001,172.217.194.0-255,2902,137620,33,179858
1320,0.001015,172.31.33.0-255,66,137686,33,179858
1321,0.00102,172.217.194.0-255,4320,142006,33,179858
1322,0.001049,172.31.33.0-255,66,142072,33,179858
1323,0.001074,172.217.194.0-255,2902,144974,33,179858
1324,0.001077,172.217.194.0-255,1484,146458,33,179858
1325,0.001079,172.217.194.0-255,766,147224,33,179858
1326,0.001089,172.31.33.0-255,66,147290,33,179858
1327,0.001122,172.217.194.0-255,1484,148774,33,179858
1328,0.001139,172.217.194.0-255,2902,151676,33,179858
1329,0.001145,172.217.194.0-255,5738,157414,33,179858
1330,0.001159,172.31.33.0-255,66,157480,33,179858
1331,0.001195,172.217.194.0-255,1484,158964,33,179858
1332,0.001243,172.31.33.0-255,66,159030,33,179858
1333,0.001295,172.217.194.0-255,766,159796,33,179858
1334,0.001314,172.217.194.0-255,1484,161280,33,179858
1335,0.001319,172.217.194.0-255,4320,165600,33,179858
1336,0.001357,172.31.33.0-255,66,165666,33,179858
1337,0.001402,172.217.194.0-255,4320,169986,33,179858
1338,0.001422,172.217.194.0-255,5020,175006,33,179858
1339,0.001486,172.31.33.0-255,66,175072,33,179858
1340,0.001558,172.217.194.0-255,97,175169,33,179858
1341,0.001577,172.31.33.0-255,66,175235,33,179858
1342,0.001618,172.217.194.0-255,105,175340,33,179858
1343,0.009684,172.31.33.0-255,66,175406,33,179858
1344,0.020326,172.31.33.0-255,105,175511,33,179858
1345,0.022363,172.217.194.0-255,66,175577,33,179858
1346,0.029304,172.31.33.0-255,172,175749,33,179858
1347,0.029338,172.31.33.0-255,1117,176866,33,179858
1348,0.029401,172.31.33.0-255,1514,178380,33,179858
1349,0.029403,172.31.33.0-255,1280,179660,33,179858
1350,0.030884,104.244.42.0-255,66,179726,33,179858
1351,0.031059,104.244.42.0-255,66,179792,33,179858
1352,0.031104,104.244.42.0-255,66,179858,33,179858
1353,0.0,172.217.24.0-255,150,150,33,318765
1354,2.4e-05,172.31.33.0-255,66,216,33,318765
1355,3.2e-05,172.217.24.0-255,1484,1700,33,318765
1356,3.6e-05,172.31.33.0-255,66,1766,33,318765
1357,4.9e-05,172.217.24.0-255,2902,4668,33,318765
1358,5.4e-05,172.31.33.0-255,66,4734,33,318765
1359,6.1e-05,172.217.24.0-255,5738,10472,33,318765
1360,6.4e-05,172.31.33.0-255,66,10538,33,318765
1361,0.000102,172.217.24.0-255,6302,16840,33,318765
1362,0.000104,172.31.33.0-255,66,16906,33,318765
1363,0.000109,172.217.24.0-255,2902,19808,33,318765
1364,0.000111,172.31.33.0-255,66,19874,33,318765
1365,0.00012,172.217.24.0-255,4320,24194,33,318765
1366,0.000122,172.31.33.0-255,66,24260,33,318765
1367,0.00015,172.217.24.0-255,6797,31057,33,318765
1368,0.000153,172.31.33.0-255,66,31123,33,318765
1369,0.00031,172.217.24.0-255,1484,32607,33,318765
1370,0.000314,172.31.33.0-255,66,32673,33,318765
1371,0.000321,172.217.24.0-255,2902,35575,33,318765
1372,0.000323,172.31.33.0-255,66,35641,33,318765
1373,0.000335,172.217.24.0-255,5738,41379,33,318765
1374,0.000338,172.31.33.0-255,66,41445,33,318765
1375,0.000342,172.217.24.0-255,2902,44347,33,318765
1376,0.000344,172.31.33.0-255,66,44413,33,318765
1377,0.000348,172.217.24.0-255,3961,48374,33,318765
1378,0.000351,172.31.33.0-255,66,48440,33,318765
1379,0.000388,172.31.33.0-255,66,48506,33,318765
1380,0.00039,172.217.24.0-255,1484,49990,33,318765
1381,0.000392,172.31.33.0-255,66,50056,33,318765
1382,0.000398,172.217.24.0-255,5738,55794,33,318765
1383,0.000404,172.31.33.0-255,66,55860,33,318765
1384,0.000453,172.217.24.0-255,1396,57256,33,318765
1385,0.000943,172.31.33.0-255,66,57322,33,318765
1386,0.001184,172.217.24.0-255,133,57455,33,318765
1387,0.001359,172.217.24.0-255,1484,58939,33,318765
1388,0.001365,172.31.33.0-255,66,59005,33,318765
1389,0.001371,172.217.24.0-255,2902,61907,33,318765
1390,0.001373,172.31.33.0-255,66,61973,33,318765
1391,0.001378,172.217.24.0-255,2902,64875,33,318765
1392,0.001383,172.31.33.0-255,66,64941,33,318765
1393,0.001407,172.217.24.0-255,2902,67843,33,318765
1394,0.001413,172.31.33.0-255,66,67909,33,318765
1395,0.001422,172.31.33.0-255,66,67975,33,318765
1396,0.001428,172.217.24.0-255,5738,73713,33,318765
1397,0.00143,172.31.33.0-255,66,73779,33,318765
1398,0.001455,172.217.24.0-255,2902,76681,33,318765
1399,0.001457,172.31.33.0-255,66,76747,33,318765
1400,0.001463,172.217.24.0-255,6797,83544,33,318765
1401,0.001465,172.31.33.0-255,66,83610,33,318765
1402,0.003395,172.217.24.0-255,1484,85094,33,318765
1403,0.003436,172.217.24.0-255,4320,89414,33,318765
1404,0.00344,172.31.33.0-255,66,89480,33,318765
1405,0.00537,172.217.24.0-255,5738,95218,33,318765
1406,0.005377,172.31.33.0-255,66,95284,33,318765
1407,0.00731,172.217.24.0-255,5738,101022,33,318765
1408,0.007315,172.31.33.0-255,66,101088,33,318765
1409,0.009254,172.217.24.0-255,5738,106826,33,318765
1410,0.009261,172.31.33.0-255,66,106892,33,318765
1411,0.011196,172.217.24.0-255,5738,112630,33,318765
1412,0.011205,172.31.33.0-255,66,112696,33,318765
1413,0.013138,172.217.24.0-255,5738,118434,33,318765
1414,0.013144,172.31.33.0-255,66,118500,33,318765
1415,0.015074,172.217.24.0-255,5738,124238,33,318765
1416,0.015082,172.31.33.0-255,66,124304,33,318765
1417,0.017018,172.217.24.0-255,5738,130042,33,318765
1418,0.017026,172.31.33.0-255,66,130108,33,318765
1419,0.018958,172.217.24.0-255,5738,135846,33,318765
1420,0.018966,172.31.33.0-255,66,135912,33,318765
1421,0.020888,172.217.24.0-255,4320,140232,33,318765
1422,0.020896,172.31.33.0-255,66,140298,33,318765
1423,0.020921,172.217.24.0-255,1484,141782,33,318765
1424,0.02282,172.217.24.0-255,4320,146102,33,318765
1425,0.022829,172.31.33.0-255,66,146168,33,318765
1426,0.024757,172.217.24.0-255,5738,151906,33,318765
1427,0.024765,172.31.33.0-255,66,151972,33,318765
1428,0.026693,172.217.24.0-255,5738,157710,33,318765
1429,0.0267,172.31.33.0-255,66,157776,33,318765
1430,0.027686,172.31.33.0-255,172,157948,33,318765
1431,0.02775,172.31.33.0-255,1117,159065,33,318765
1432,0.027815,172.31.33.0-255,1514,160579,33,318765
1433,0.027817,172.31.33.0-255,1280,161859,33,318765
1434,0.028635,172.217.24.0-255,5738,167597,33,318765
1435,0.028642,172.31.33.0-255,66,167663,33,318765
1436,0.029217,104.244.42.0-255,66,167729,33,318765
1437,0.029311,104.244.42.0-255,66,167795,33,318765
1438,0.029364,104.244.42.0-255,66,167861,33,318765
1439,0.030564,172.217.24.0-255,5738,173599,33,318765
1440,0.03057,172.31.33.0-255,66,173665,33,318765
1441,0.032498,172.217.24.0-255,5738,179403,33,318765
1442,0.032505,172.31.33.0-255,66,179469,33,318765
1443,0.034425,172.217.24.0-255,5738,185207,33,318765
1444,0.03443,172.31.33.0-255,66,185273,33,318765
1445,0.036376,172.217.24.0-255,5738,191011,33,318765
1446,0.036388,172.31.33.0-255,66,191077,33,318765
1447,0.038312,172.217.24.0-255,5738,196815,33,318765
1448,0.03832,172.31.33.0-255,66,196881,33,318765
1449,0.040275,172.217.24.0-255,5738,202619,33,318765
1450,0.040281,172.31.33.0-255,66,202685,33,318765
1451,0.042229,172.217.24.0-255,5738,208423,33,318765
1452,0.042236,172.31.33.0-255,66,208489,33,318765
1453,0.044164,172.217.24.0-255,5738,214227,33,318765
1454,0.04417,172.31.33.0-255,66,214293,33,318765
1455,0.046106,172.217.24.0-255,5738,220031,33,318765
1456,0.046112,172.31.33.0-255,66,220097,33,318765
1457,0.048042,172.217.24.0-255,5738,225835,33,318765
1458,0.048049,172.31.33.0-255,66,225901,33,318765
1459,0.049979,172.217.24.0-255,5738,231639,33,318765
1460,0.049986,172.31.33.0-255,66,231705,33,318765
1461,0.051914,172.217.24.0-255,5738,237443,33,318765
1462,0.05192,172.31.33.0-255,66,237509,33,318765
1463,0.053864,172.217.24.0-255,5738,243247,33,318765
1464,0.053878,172.31.33.0-255,66,243313,33,318765
1465,0.055811,172.217.24.0-255,5738,249051,33,318765
1466,0.055825,172.31.33.0-255,66,249117,33,318765
1467,0.057765,172.217.24.0-255,5738,254855,33,318765
1468,0.057774,172.31.33.0-255,66,254921,33,318765
1469,0.059738,172.217.24.0-255,5738,260659,33,318765
1470,0.059759,172.31.33.0-255,66,260725,33,318765
1471,0.061712,172.217.24.0-255,5738,266463,33,318765
1472,0.061728,172.31.33.0-255,66,266529,33,318765
1473,0.063675,172.217.24.0-255,5738,272267,33,318765
1474,0.063688,172.31.33.0-255,66,272333,33,318765
1475,0.065678,172.217.24.0-255,5738,278071,33,318765
1476,0.06569,172.31.33.0-255,66,278137,33,318765
1477,0.067616,172.217.24.0-255,5738,283875,33,318765
1478,0.067624,172.31.33.0-255,66,283941,33,318765
1479,0.069567,172.217.24.0-255,5738,289679,33,318765
1480,0.069577,172.31.33.0-255,66,289745,33,318765
1481,0.071514,172.217.24.0-255,5738,295483,33,318765
1482,0.071519,172.31.33.0-255,66,295549,33,318765
1483,0.073459,172.217.24.0-255,5738,301287,33,318765
1484,0.073465,172.31.33.0-255,66,301353,33,318765
1485,0.075408,172.217.24.0-255,5738,307091,33,318765
1486,0.075414,172.31.33.0-255,66,307157,33,318765
1487,0.07735,172.217.24.0-255,5738,312895,33,318765
1488,0.077354,172.31.33.0-255,66,312961,33,318765
1489,0.079297,172.217.24.0-255,5738,318699,33,318765
1490,0.079304,172.31.33.0-255,66,318765,33,318765
1491,0.0,74.125.200.0-255,219,219,33,318650
1492,1.3e-05,172.31.33.0-255,66,285,33,318650
1493,3.1e-05,74.125.200.0-255,1484,1769,33,318650
1494,3.6e-05,172.31.33.0-255,66,1835,33,318650
1495,3.9e-05,74.125.200.0-255,1484,3319,33,318650
1496,4.1e-05,172.31.33.0-255,66,3385,33,318650
1497,6.6e-05,74.125.200.0-255,1484,4869,33,318650
1498,6.9e-05,172.31.33.0-255,66,4935,33,318650
1499,9.4e-05,74.125.200.0-255,4320,9255,33,318650
1500,9.7e-05,172.31.33.0-255,66,9321,33,318650
1501,0.000102,74.125.200.0-255,4682,14003,33,318650
1502,0.000105,172.31.33.0-255,66,14069,33,318650
1503,0.000142,74.125.200.0-255,5738,19807,33,318650
1504,0.000145,172.31.33.0-255,66,19873,33,318650
1505,0.000164,74.125.200.0-255,4320,24193,33,318650
1506,0.000166,172.31.33.0-255,66,24259,33,318650
1507,0.000206,74.125.200.0-255,2902,27161,33,318650
1508,0.000208,172.31.33.0-255,66,27227,33,318650
1509,0.000226,74.125.200.0-255,3961,31188,33,318650
1510,0.000229,172.31.33.0-255,66,31254,33,318650
1511,0.000239,74.125.200.0-255,1484,32738,33,318650
1512,0.00024,172.31.33.0-255,66,32804,33,318650
1513,0.000248,74.125.200.0-255,2902,35706,33,318650
1514,0.00025,172.31.33.0-255,66,35772,33,318650
1515,0.000284,74.125.200.0-255,5738,41510,33,318650
1516,0.000287,172.31.33.0-255,66,41576,33,318650
1517,0.000291,74.125.200.0-255,2902,44478,33,318650
1518,0.000293,172.31.33.0-255,66,44544,33,318650
1519,0.000297,74.125.200.0-255,4320,48864,33,318650
1520,0.0003,172.31.33.0-255,66,48930,33,318650
1521,0.000323,74.125.200.0-255,7156,56086,33,318650
1522,0.000325,172.31.33.0-255,66,56152,33,318650
1523,0.000346,74.125.200.0-255,1484,57636,33,318650
1524,0.000357,172.31.33.0-255,66,57702,33,318650
1525,0.000359,74.125.200.0-255,366,58068,33,318650
1526,0.000414,74.125.200.0-255,130,58198,33,318650
1527,0.000572,74.125.200.0-255,1484,59682,33,318650
1528,0.000576,172.31.33.0-255,66,59748,33,318650
1529,0.000599,74.125.200.0-255,2902,62650,33,318650
1530,0.000602,172.31.33.0-255,66,62716,33,318650
1531,0.000606,74.125.200.0-255,2902,65618,33,318650
1532,0.000608,172.31.33.0-255,66,65684,33,318650
1533,0.000612,74.125.200.0-255,4320,70004,33,318650
1534,0.000618,172.31.33.0-255,66,70070,33,318650
1535,0.000672,172.31.33.0-255,66,70136,33,318650
1536,0.000677,74.125.200.0-255,4320,74456,33,318650
1537,0.000679,172.31.33.0-255,66,74522,33,318650
1538,0.000702,74.125.200.0-255,5738,80260,33,318650
1539,0.000705,172.31.33.0-255,66,80326,33,318650
1540,0.00071,74.125.200.0-255,3602,83928,33,318650
1541,0.000712,172.31.33.0-255,66,83994,33,318650
1542,0.000737,74.125.200.0-255,343,84337,33,318650
1543,0.000878,74.125.200.0-255,1484,85821,33,318650
1544,0.000881,172.31.33.0-255,66,85887,33,318650
1545,0.000899,74.125.200.0-255,2902,88789,33,318650
1546,0.000901,172.31.33.0-255,66,88855,33,318650
1547,0.000926,74.125.200.0-255,5738,94593,33,318650
1548,0.000928,172.31.33.0-255,66,94659,33,318650
1549,0.000952,74.125.200.0-255,4320,98979,33,318650
1550,0.000954,172.31.33.0-255,66,99045,33,318650
1551,0.000986,172.31.33.0-255,66,99111,33,318650
1552,0.001017,172.31.33.0-255,66,99177,33,318650
1553,0.001037,74.125.200.0-255,766,99943,33,318650
1554,0.001233,74.125.200.0-255,1484,101427,33,318650
1555,0.001237,172.31.33.0-255,66,101493,33,318650
1556,0.001266,74.125.200.0-255,2902,104395,33,318650
1557,0.001269,172.31.33.0-255,66,104461,33,318650
1558,0.001274,74.125.200.0-255,5738,110199,33,318650
1559,0.001276,172.31.33.0-255,66,110265,33,318650
1560,0.001319,74.125.200.0-255,7156,117421,33,318650
1561,0.001321,172.31.33.0-255,66,117487,33,318650
1562,0.001363,74.125.200.0-255,4320,121807,33,318650
1563,0.001366,172.31.33.0-255,66,121873,33,318650
1564,0.001397,74.125.200.0-255,5738,127611,33,318650
1565,0.0014,172.31.33.0-255,66,127677,33,318650
1566,0.001403,74.125.200.0-255,2902,130579,33,318650
1567,0.001405,172.31.33.0-255,66,130645,33,318650
1568,0.001425,74.125.200.0-255,3602,134247,33,318650
1569,0.00143,172.31.33.0-255,66,134313,33,318650
1570,0.00147,74.125.200.0-255,1484,135797,33,318650
1571,0.001474,74.125.200.0-255,1484,137281,33,318650
1572,0.001476,172.31.33.0-255,66,137347,33,318650
1573,0.001498,74.125.200.0-255,1484,138831,33,318650
1574,0.001503,74.125.200.0-255,4320,143151,33,318650
1575,0.001505,172.31.33.0-255,66,143217,33,318650
1576,0.001531,74.125.200.0-255,1484,144701,33,318650
1577,0.001538,74.125.200.0-255,7156,151857,33,318650
1578,0.001541,172.31.33.0-255,66,151923,33,318650
1579,0.001551,74.125.200.0-255,1484,153407,33,318650
1580,0.001587,172.31.33.0-255,66,153473,33,318650
1581,0.00159,74.125.200.0-255,2184,155657,33,318650
1582,0.001592,172.31.33.0-255,66,155723,33,318650
1583,0.00202,74.125.200.0-255,1484,157207,33,318650
1584,0.002024,74.125.200.0-255,1484,158691,33,318650
1585,0.002027,172.31.33.0-255,66,158757,33,318650
1586,0.002049,74.125.200.0-255,1484,160241,33,318650
1587,0.002055,74.125.200.0-255,5738,165979,33,318650
1588,0.002057,172.31.33.0-255,66,166045,33,318650
1589,0.002084,74.125.200.0-255,5738,171783,33,318650
1590,0.00209,74.125.200.0-255,7156,178939,33,318650
1591,0.002093,172.31.33.0-255,66,179005,33,318650
1592,0.0021,172.31.33.0-255,66,179071,33,318650
1593,0.002142,74.125.200.0-255,4320,183391,33,318650
1594,0.002144,172.31.33.0-255,66,183457,33,318650
1595,0.002176,74.125.200.0-255,6438,189895,33,318650
1596,0.002178,172.31.33.0-255,66,189961,33,318650
1597,0.002182,74.125.200.0-255,2902,192863,33,318650
1598,0.002184,172.31.33.0-255,66,192929,33,318650
1599,0.002187,74.125.200.0-255,1484,194413,33,318650
1600,0.002221,74.125.200.0-255,2902,197315,33,318650
1601,0.002223,172.31.33.0-255,66,197381,33,318650
1602,0.002237,172.31.33.0-255,66,197447,33,318650
1603,0.002239,74.125.200.0-255,1484,198931,33,318650
1604,0.002244,74.125.200.0-255,2902,201833,33,318650
1605,0.002245,172.31.33.0-255,66,201899,33,318650
1606,0.002248,74.125.200.0-255,1484,203383,33,318650
1607,0.002277,74.125.200.0-255,4320,207703,33,318650
1608,0.002279,172.31.33.0-255,66,207769,33,318650
1609,0.002286,74.125.200.0-255,7156,214925,33,318650
1610,0.002288,172.31.33.0-255,66,214991,33,318650
1611,0.002353,172.31.33.0-255,66,215057,33,318650
1612,0.002356,74.125.200.0-255,1484,216541,33,318650
1613,0.002358,74.125.200.0-255,1484,218025,33,318650
1614,0.00236,172.31.33.0-255,66,218091,33,318650
1615,0.002365,74.125.200.0-255,4320,222411,33,318650
1616,0.002367,172.31.33.0-255,66,222477,33,318650
1617,0.002369,74.125.200.0-255,1484,223961,33,318650
1618,0.002372,74.125.200.0-255,1484,225445,33,318650
1619,0.002373,172.31.33.0-255,66,225511,33,318650
1620,0.0024,74.125.200.0-255,2902,228413,33,318650
1621,0.002402,172.31.33.0-255,66,228479,33,318650
1622,0.002405,74.125.200.0-255,1484,229963,33,318650
1623,0.002424,74.125.200.0-255,1484,231447,33,318650
1624,0.002427,172.31.33.0-255,66,231513,33,318650
1625,0.002439,74.125.200.0-255,2902,234415,33,318650
1626,0.002444,172.31.33.0-255,66,234481,33,318650
1627,0.002468,74.125.200.0-255,5738,240219,33,318650
1628,0.00247,172.31.33.0-255,66,240285,33,318650
1629,0.002472,74.125.200.0-255,1484,241769,33,318650
1630,0.002474,74.125.200.0-255,766,242535,33,318650
1631,0.002476,172.31.33.0-255,66,242601,33,318650
1632,0.002502,74.125.200.0-255,1484,244085,33,318650
1633,0.002513,74.125.200.0-255,1484,245569,33,318650
1634,0.002515,172.31.33.0-255,66,245635,33,318650
1635,0.00254,74.125.200.0-255,1484,247119,33,318650
1636,0.002554,74.125.200.0-255,1484,248603,33,318650
1637,0.002557,172.31.33.0-255,66,248669,33,318650
1638,0.002581,74.125.200.0-255,5738,254407,33,318650
1639,0.002584,172.31.33.0-255,66,254473,33,318650
1640,0.00261,74.125.200.0-255,7156,261629,33,318650
1641,0.002624,172.31.33.0-255,66,261695,33,318650
1642,0.002648,74.125.200.0-255,1484,263179,33,318650
1643,0.002653,74.125.200.0-255,2902,266081,33,318650
1644,0.002655,172.31.33.0-255,66,266147,33,318650
1645,0.002658,74.125.200.0-255,1484,267631,33,318650
1646,0.00266,74.125.200.0-255,1484,269115,33,318650
1647,0.002661,172.31.33.0-255,66,269181,33,318650
1648,0.002667,74.125.200.0-255,5738,274919,33,318650
1649,0.002669,172.31.33.0-255,66,274985,33,318650
1650,0.002672,74.125.200.0-255,2184,277169,33,318650
1651,0.002674,172.31.33.0-255,66,277235,33,318650
1652,0.00272,74.125.200.0-255,1484,278719,33,318650
1653,0.002731,74.125.200.0-255,1484,280203,33,318650
1654,0.002733,172.31.33.0-255,66,280269,33,318650
1655,0.002755,74.125.200.0-255,1484,281753,33,318650
1656,0.002766,74.125.200.0-255,1484,283237,33,318650
1657,0.002768,172.31.33.0-255,66,283303,33,318650
1658,0.002796,74.125.200.0-255,4320,287623,33,318650
1659,0.002798,172.31.33.0-255,66,287689,33,318650
1660,0.002817,172.31.33.0-255,66,287755,33,318650
1661,0.002829,172.31.33.0-255,66,287821,33,318650
1662,0.002832,74.125.200.0-255,2902,290723,33,318650
1663,0.002834,172.31.33.0-255,66,290789,33,318650
1664,0.002838,74.125.200.0-255,4320,295109,33,318650
1665,0.002841,172.31.33.0-255,66,295175,33,318650
1666,0.002881,172.31.33.0-255,66,295241,33,318650
1667,0.002887,74.125.200.0-255,5738,300979,33,318650
1668,0.002889,172.31.33.0-255,66,301045,33,318650
1669,0.002923,74.125.200.0-255,2902,303947,33,318650
1670,0.002926,172.31.33.0-255,66,304013,33,318650
1671,0.00293,74.125.200.0-255,2902,306915,33,318650
1672,0.002931,172.31.33.0-255,66,306981,33,318650
1673,0.002935,74.125.200.0-255,2902,309883,33,318650
1674,0.002937,172.31.33.0-255,66,309949,33,318650
1675,0.00294,74.125.200.0-255,1484,311433,33,318650
1676,0.002942,74.125.200.0-255,1455,312888,33,318650
1677,0.002944,172.31.33.0-255,66,312954,33,318650
1678,0.002947,74.125.200.0-255,97,313051,33,318650
1679,0.003031,74.125.200.0-255,105,313156,33,318650
1680,0.009206,172.31.33.0-255,66,313222,33,318650
1681,0.009241,172.31.33.0-255,105,313327,33,318650
1682,0.0115,74.125.200.0-255,66,313393,33,318650
1683,0.03047,172.31.33.0-255,172,313565,33,318650
1684,0.030497,172.31.33.0-255,1118,314683,33,318650
1685,0.030564,172.31.33.0-255,1514,316197,33,318650
1686,0.030566,172.31.33.0-255,1514,317711,33,318650
1687,0.030567,172.31.33.0-255,675,318386,33,318650
1688,0.032035,104.244.42.0-255,66,318452,33,318650
1689,0.032068,104.244.42.0-255,66,318518,33,318650
1690,0.032121,104.244.42.0-255,66,318584,33,318650
1691,0.032138,104.244.42.0-255,66,318650,33,318650
1692,0.0,172.31.33.0-255,105,105,33,1377
1693,4.3e-05,172.31.33.0-255,105,210,33,1377
1694,9.1e-05,172.31.33.0-255,105,315,33,1377
1695,0.000372,172.31.33.0-255,90,405,33,1377
1696,0.000381,172.31.33.0-255,66,471,33,1377
1697,0.000554,172.31.33.0-255,90,561,33,1377
1698,0.000561,172.31.33.0-255,66,627,33,1377
1699,0.000913,172.31.33.0-255,90,717,33,1377
1700,0.000922,172.31.33.0-255,66,783,33,1377
1701,0.002427,172.217.194.0-255,66,849,33,1377
1702,0.00244,172.217.194.0-255,66,915,33,1377
1703,0.00245,172.31.33.0-255,66,981,33,1377
1704,0.002695,74.125.200.0-255,66,1047,33,1377
1705,0.002701,74.125.200.0-255,66,1113,33,1377
1706,0.002705,172.31.33.0-255,66,1179,33,1377
1707,0.003589,74.125.24.0-255,66,1245,33,1377
1708,0.003594,74.125.24.0-255,66,1311,33,1377
1709,0.003596,172.31.33.0-255,66,1377,33,1377
1710,0.0,74.125.24.0-255,151,151,33,326261
1711,2.2e-05,172.31.33.0-255,66,217,33,326261
1712,2.8e-05,74.125.24.0-255,1484,1701,33,326261
1713,3.2e-05,172.31.33.0-255,66,1767,33,326261
1714,3.7e-05,74.125.24.0-255,2902,4669,33,326261
1715,4.6e-05,172.31.33.0-255,66,4735,33,326261
1716,5.3e-05,74.125.24.0-255,7156,11891,33,326261
1717,5.5e-05,172.31.33.0-255,66,11957,33,326261
1718,5.8e-05,74.125.24.0-255,2024,13981,33,326261
1719,6.1e-05,172.31.33.0-255,66,14047,33,326261
1720,0.000105,172.31.33.0-255,66,14113,33,326261
1721,0.00011,74.125.24.0-255,5379,19492,33,326261
1722,0.000112,172.31.33.0-255,66,19558,33,326261
1723,0.000183,74.125.24.0-255,1484,21042,33,326261
1724,0.000186,172.31.33.0-255,66,21108,33,326261
1725,0.000192,74.125.24.0-255,2902,24010,33,326261
1726,0.000193,172.31.33.0-255,66,24076,33,326261
1727,0.000197,74.125.24.0-255,2902,26978,33,326261
1728,0.000204,172.31.33.0-255,66,27044,33,326261
1729,0.000234,74.125.24.0-255,2902,29946,33,326261
1730,0.000236,172.31.33.0-255,66,30012,33,326261
1731,0.000241,74.125.24.0-255,4320,34332,33,326261
1732,0.000244,172.31.33.0-255,66,34398,33,326261
1733,0.000254,74.125.24.0-255,5738,40136,33,326261
1734,0.000257,172.31.33.0-255,66,40202,33,326261
1735,0.000295,172.31.33.0-255,66,40268,33,326261
1736,0.0003,74.125.24.0-255,3602,43870,33,326261
1737,0.000302,172.31.33.0-255,66,43936,33,326261
1738,0.000304,74.125.24.0-255,397,44333,33,326261
1739,0.000311,172.31.33.0-255,66,44399,33,326261
1740,0.000419,74.125.24.0-255,111,44510,33,326261
1741,0.000458,74.125.24.0-255,1484,45994,33,326261
1742,0.000461,172.31.33.0-255,66,46060,33,326261
1743,0.000465,74.125.24.0-255,1484,47544,33,326261
1744,0.000487,74.125.24.0-255,1484,49028,33,326261
1745,0.00049,172.31.33.0-255,66,49094,33,326261
1746,0.000497,74.125.24.0-255,7156,56250,33,326261
1747,0.000499,172.31.33.0-255,66,56316,33,326261
1748,0.000529,172.31.33.0-255,66,56382,33,326261
1749,0.000546,74.125.24.0-255,5738,62120,33,326261
1750,0.000548,172.31.33.0-255,66,62186,33,326261
1751,0.000569,74.125.24.0-255,2902,65088,33,326261
1752,0.000572,172.31.33.0-255,66,65154,33,326261
1753,0.000591,74.125.24.0-255,4706,69860,33,326261
1754,0.000593,172.31.33.0-255,66,69926,33,326261
1755,0.000713,74.125.24.0-255,1484,71410,33,326261
1756,0.000727,74.125.24.0-255,2902,74312,33,326261
1757,0.00073,172.31.33.0-255,66,74378,33,326261
1758,0.000755,74.125.24.0-255,5738,80116,33,326261
1759,0.000758,172.31.33.0-255,66,80182,33,326261
1760,0.000783,74.125.24.0-255,6783,86965,33,326261
1761,0.000786,172.31.33.0-255,66,87031,33,326261
1762,0.000822,74.125.24.0-255,1484,88515,33,326261
1763,0.000833,74.125.24.0-255,2902,91417,33,326261
1764,0.000836,172.31.33.0-255,66,91483,33,326261
1765,0.000863,74.125.24.0-255,5738,97221,33,326261
1766,0.000866,172.31.33.0-255,66,97287,33,326261
1767,0.000869,74.125.24.0-255,2902,100189,33,326261
1768,0.000872,172.31.33.0-255,66,100255,33,326261
1769,0.000888,74.125.24.0-255,1484,101739,33,326261
1770,0.000911,74.125.24.0-255,1533,103272,33,326261
1771,0.000914,172.31.33.0-255,66,103338,33,326261
1772,0.001143,74.125.24.0-255,1484,104822,33,326261
1773,0.001156,74.125.24.0-255,1484,106306,33,326261
1774,0.00116,172.31.33.0-255,66,106372,33,326261
1775,0.001181,74.125.24.0-255,1484,107856,33,326261
1776,0.001187,74.125.24.0-255,5738,113594,33,326261
1777,0.001189,172.31.33.0-255,66,113660,33,326261
1778,0.001218,172.31.33.0-255,66,113726,33,326261
1779,0.001246,74.125.24.0-255,4320,118046,33,326261
1780,0.001249,172.31.33.0-255,66,118112,33,326261
1781,0.00126,172.31.33.0-255,66,118178,33,326261
1782,0.001864,74.125.24.0-255,1484,119662,33,326261
1783,0.001875,74.125.24.0-255,2902,122564,33,326261
1784,0.00188,172.31.33.0-255,66,122630,33,326261
1785,0.001901,74.125.24.0-255,1484,124114,33,326261
1786,0.001905,74.125.24.0-255,1484,125598,33,326261
1787,0.001908,172.31.33.0-255,66,125664,33,326261
1788,0.001947,74.125.24.0-255,4320,129984,33,326261
1789,0.00195,172.31.33.0-255,66,130050,33,326261
1790,0.001972,172.31.33.0-255,66,130116,33,326261
1791,0.002008,172.31.33.0-255,66,130182,33,326261
1792,0.004225,74.125.24.0-255,2902,133084,33,326261
1793,0.004228,172.31.33.0-255,66,133150,33,326261
1794,0.004254,74.125.24.0-255,2902,136052,33,326261
1795,0.004256,172.31.33.0-255,66,136118,33,326261
1796,0.006457,74.125.24.0-255,2902,139020,33,326261
1797,0.006462,172.31.33.0-255,66,139086,33,326261
1798,0.006501,74.125.24.0-255,2902,141988,33,326261
1799,0.006504,172.31.33.0-255,66,142054,33,326261
1800,0.008683,74.125.24.0-255,2902,144956,33,326261
1801,0.008688,172.31.33.0-255,66,145022,33,326261
1802,0.008741,74.125.24.0-255,2902,147924,33,326261
1803,0.008745,172.31.33.0-255,66,147990,33,326261
1804,0.01098,74.125.24.0-255,2902,150892,33,326261
1805,0.010986,172.31.33.0-255,66,150958,33,326261
1806,0.011018,74.125.24.0-255,2902,153860,33,326261
1807,0.011021,172.31.33.0-255,66,153926,33,326261
1808,0.013222,74.125.24.0-255,2902,156828,33,326261
1809,0.013228,172.31.33.0-255,66,156894,33,326261
1810,0.013258,74.125.24.0-255,2902,159796,33,326261
1811,0.013262,172.31.33.0-255,66,159862,33,326261
1812,0.015483,74.125.24.0-255,2902,162764,33,326261
1813,0.015491,172.31.33.0-255,66,162830,33,326261
1814,0.015519,74.125.24.0-255,2902,165732,33,326261
1815,0.015522,172.31.33.0-255,66,165798,33,326261
1816,0.017709,74.125.24.0-255,2902,168700,33,326261
1817,0.017714,172.31.33.0-255,66,168766,33,326261
1818,0.017767,74.125.24.0-255,2902,171668,33,326261
1819,0.017772,172.31.33.0-255,66,171734,33,326261
1820,0.019979,74.125.24.0-255,2902,174636,33,326261
1821,0.019986,172.31.33.0-255,66,174702,33,326261
1822,0.020027,74.125.24.0-255,2902,177604,33,326261
1823,0.020031,172.31.33.0-255,66,177670,33,326261
1824,0.022248,74.125.24.0-255,2902,180572,33,326261
1825,0.022254,172.31.33.0-255,66,180638,33,326261
1826,0.022284,74.125.24.0-255,2902,183540,33,326261
1827,0.022287,172.31.33.0-255,66,183606,33,326261
1828,0.024494,74.125.24.0-255,2902,186508,33,326261
1829,0.024501,172.31.33.0-255,66,186574,33,326261
1830,0.024542,74.125.24.0-255,2902,189476,33,326261
1831,0.024545,172.31.33.0-255,66,189542,33,326261
1832,0.026622,172.31.33.0-255,172,189714,33,326261
1833,0.026651,172.31.33.0-255,1117,190831,33,326261
1834,0.026689,172.31.33.0-255,1514,192345,33,326261
1835,0.026691,172.31.33.0-255,1280,193625,33,326261
1836,0.026773,74.125.24.0-255,2902,196527,33,326261
1837,0.026779,172.31.33.0-255,66,196593,33,326261
1838,0.026816,74.125.24.0-255,2902,199495,33,326261
1839,0.02682,172.31.33.0-255,66,199561,33,326261
1840,0.028279,104.244.42.0-255,66,199627,33,326261
1841,0.028449,104.244.42.0-255,66,199693,33,326261
1842,0.028512,104.244.42.0-255,66,199759,33,326261
1843,0.029013,74.125.24.0-255,2902,202661,33,326261
1844,0.029016,172.31.33.0-255,66,202727,33,326261
1845,0.029058,74.125.24.0-255,2902,205629,33,326261
1846,0.029062,172.31.33.0-255,66,205695,33,326261
1847,0.031289,74.125.24.0-255,2902,208597,33,326261
1848,0.031294,172.31.33.0-255,66,208663,33,326261
1849,0.031327,74.125.24.0-255,2902,211565,33,326261
1850,0.03133,172.31.33.0-255,66,211631,33,326261
1851,0.033553,74.125.24.0-255,2902,214533,33,326261
1852,0.033557,172.31.33.0-255,66,214599,33,326261
1853,0.033589,74.125.24.0-255,2902,217501,33,326261
1854,0.033592,172.31.33.0-255,66,217567,33,326261
1855,0.035821,74.125.24.0-255,2902,220469,33,326261
1856,0.035826,172.31.33.0-255,66,220535,33,326261
1857,0.035852,74.125.24.0-255,2902,223437,33,326261
1858,0.035854,172.31.33.0-255,66,223503,33,326261
1859,0.038041,74.125.24.0-255,2902,226405,33,326261
1860,0.038046,172.31.33.0-255,66,226471,33,326261
1861,0.038084,74.125.24.0-255,2902,229373,33,326261
1862,0.03809,172.31.33.0-255,66,229439,33,326261
1863,0.040299,74.125.24.0-255,2902,232341,33,326261
1864,0.040304,172.31.33.0-255,66,232407,33,326261
1865,0.040344,74.125.24.0-255,2902,235309,33,326261
1866,0.040348,172.31.33.0-255,66,235375,33,326261
1867,0.042526,74.125.24.0-255,2902,238277,33,326261
1868,0.042542,172.31.33.0-255,66,238343,33,326261
1869,0.042568,74.125.24.0-255,2902,241245,33,326261
1870,0.042571,172.31.33.0-255,66,241311,33,326261
1871,0.044813,74.125.24.0-255,5738,247049,33,326261
1872,0.044819,172.31.33.0-255,66,247115,33,326261
1873,0.047035,74.125.24.0-255,5738,252853,33,326261
1874,0.04704,172.31.33.0-255,66,252919,33,326261
1875,0.049271,74.125.24.0-255,5738,258657,33,326261
1876,0.049275,172.31.33.0-255,66,258723,33,326261
1877,0.051571,74.125.24.0-255,1484,260207,33,326261
1878,0.051599,74.125.24.0-255,4320,264527,33,326261
1879,0.051603,172.31.33.0-255,66,264593,33,326261
1880,0.053848,74.125.24.0-255,5738,270331,33,326261
1881,0.053853,172.31.33.0-255,66,270397,33,326261
1882,0.056087,74.125.24.0-255,4320,274717,33,326261
1883,0.056092,172.31.33.0-255,66,274783,33,326261
1884,0.056116,74.125.24.0-255,1484,276267,33,326261
1885,0.058335,74.125.24.0-255,2902,279169,33,326261
1886,0.05834,172.31.33.0-255,66,279235,33,326261
1887,0.05837,74.125.24.0-255,1484,280719,33,326261
1888,0.060589,74.125.24.0-255,4320,285039,33,326261
1889,0.060593,172.31.33.0-255,66,285105,33,326261
1890,0.062846,74.125.24.0-255,2902,288007,33,326261
1891,0.062851,172.31.33.0-255,66,288073,33,326261
1892,0.062884,74.125.24.0-255,2902,290975,33,326261
1893,0.062887,172.31.33.0-255,66,291041,33,326261
1894,0.065139,74.125.24.0-255,4320,295361,33,326261
1895,0.065145,172.31.33.0-255,66,295427,33,326261
1896,0.065177,74.125.24.0-255,1484,296911,33,326261
1897,0.06735,74.125.24.0-255,4320,301231,33,326261
1898,0.067354,172.31.33.0-255,66,301297,33,326261
1899,0.069596,74.125.24.0-255,4320,305617,33,326261
1900,0.0696,172.31.33.0-255,66,305683,33,326261
1901,0.069627,74.125.24.0-255,1484,307167,33,326261
1902,0.071828,74.125.24.0-255,2902,310069,33,326261
1903,0.071833,172.31.33.0-255,66,310135,33,326261
1904,0.071858,74.125.24.0-255,1484,311619,33,326261
1905,0.074102,74.125.24.0-255,4320,315939,33,326261
1906,0.074107,172.31.33.0-255,66,316005,33,326261
1907,0.076382,74.125.24.0-255,4320,320325,33,326261
1908,0.076386,172.31.33.0-255,66,320391,33,326261
1909,0.076441,74.125.24.0-255,1484,321875,33,326261
1910,0.078636,74.125.24.0-255,4320,326195,33,326261
1911,0.07864,172.31.33.0-255,66,326261,33,326261
1912,0.0,172.253.118.0-255,155,155,33,340596
1913,1.6e-05,172.31.33.0-255,66,221,33,340596
1914,2.3e-05,172.253.118.0-255,1484,1705,33,340596
1915,2.7e-05,172.31.33.0-255,66,1771,33,340596
1916,3.9e-05,172.253.118.0-255,2902,4673,33,340596
1917,4.2e-05,172.31.33.0-255,66,4739,33,340596
1918,4.9e-05,172.253.118.0-255,5738,10477,33,340596
1919,5.1e-05,172.31.33.0-255,66,10543,33,340596
1920,0.000109,172.253.118.0-255,3475,14018,33,340596
1921,0.000112,172.31.33.0-255,66,14084,33,340596
1922,0.000165,172.253.118.0-255,1484,15568,33,340596
1923,0.000168,172.31.33.0-255,66,15634,33,340596
1924,0.000172,172.253.118.0-255,1484,17118,33,340596
1925,0.000174,172.31.33.0-255,66,17184,33,340596
1926,0.000204,172.253.118.0-255,1484,18668,33,340596
1927,0.000207,172.31.33.0-255,66,18734,33,340596
1928,0.000214,172.253.118.0-255,5738,24472,33,340596
1929,0.000216,172.31.33.0-255,66,24538,33,340596
1930,0.000227,172.253.118.0-255,5738,30276,33,340596
1931,0.000229,172.31.33.0-255,66,30342,33,340596
1932,0.000253,172.253.118.0-255,1125,31467,33,340596
1933,0.000256,172.31.33.0-255,66,31533,33,340596
1934,0.000828,172.253.118.0-255,1484,33017,33,340596
1935,0.000834,172.31.33.0-255,66,33083,33,340596
1936,0.000843,172.253.118.0-255,2902,35985,33,340596
1937,0.000845,172.31.33.0-255,66,36051,33,340596
1938,0.000858,172.253.118.0-255,5738,41789,33,340596
1939,0.00086,172.31.33.0-255,66,41855,33,340596
1940,0.000864,172.253.118.0-255,2902,44757,33,340596
1941,0.000866,172.31.33.0-255,66,44823,33,340596
1942,0.000925,172.31.33.0-255,66,44889,33,340596
1943,0.000932,172.253.118.0-255,5738,50627,33,340596
1944,0.000934,172.31.33.0-255,66,50693,33,340596
1945,0.000974,172.253.118.0-255,4257,54950,33,340596
1946,0.000977,172.31.33.0-255,66,55016,33,340596
1947,0.001019,172.253.118.0-255,130,55146,33,340596
1948,0.001244,172.253.118.0-255,1484,56630,33,340596
1949,0.001252,172.31.33.0-255,66,56696,33,340596
1950,0.001258,172.253.118.0-255,2902,59598,33,340596
1951,0.001261,172.31.33.0-255,66,59664,33,340596
1952,0.001272,172.253.118.0-255,5738,65402,33,340596
1953,0.001274,172.31.33.0-255,66,65468,33,340596
1954,0.00128,172.253.118.0-255,5738,71206,33,340596
1955,0.001282,172.31.33.0-255,66,71272,33,340596
1956,0.001327,172.253.118.0-255,2902,74174,33,340596
1957,0.00133,172.31.33.0-255,66,74240,33,340596
1958,0.001368,172.31.33.0-255,66,74306,33,340596
1959,0.001373,172.253.118.0-255,2902,77208,33,340596
1960,0.001375,172.31.33.0-255,66,77274,33,340596
1961,0.001392,172.253.118.0-255,1407,78681,33,340596
1962,0.00154,172.253.118.0-255,1484,80165,33,340596
1963,0.001545,172.31.33.0-255,66,80231,33,340596
1964,0.001552,172.253.118.0-255,2902,83133,33,340596
1965,0.001555,172.31.33.0-255,66,83199,33,340596
1966,0.001566,172.253.118.0-255,5738,88937,33,340596
1967,0.001569,172.31.33.0-255,66,89003,33,340596
1968,0.001606,172.31.33.0-255,66,89069,33,340596
1969,0.001621,172.31.33.0-255,66,89135,33,340596
1970,0.001657,172.253.118.0-255,2902,92037,33,340596
1971,0.001659,172.31.33.0-255,66,92103,33,340596
1972,0.001681,172.253.118.0-255,2184,94287,33,340596
1973,0.001683,172.31.33.0-255,66,94353,33,340596
1974,0.001841,172.253.118.0-255,1484,95837,33,340596
1975,0.001857,172.253.118.0-255,2902,98739,33,340596
1976,0.001859,172.31.33.0-255,66,98805,33,340596
1977,0.001883,172.253.118.0-255,4320,103125,33,340596
1978,0.001885,172.31.33.0-255,66,103191,33,340596
1979,0.00191,172.253.118.0-255,1484,104675,33,340596
1980,0.001916,172.253.118.0-255,7156,111831,33,340596
1981,0.001918,172.31.33.0-255,66,111897,33,340596
1982,0.001988,172.253.118.0-255,6438,118335,33,340596
1983,0.00203,172.253.118.0-255,1484,119819,33,340596
1984,0.002048,172.253.118.0-255,2902,122721,33,340596
1985,0.002054,172.253.118.0-255,5738,128459,33,340596
1986,0.002075,172.253.118.0-255,4320,132779,33,340596
1987,0.002102,172.253.118.0-255,7156,139935,33,340596
1988,0.002147,172.253.118.0-255,3602,143537,33,340596
1989,0.005581,172.31.33.0-255,66,143603,33,340596
1990,0.007798,172.253.118.0-255,5738,149341,33,340596
1991,0.007804,172.31.33.0-255,66,149407,33,340596
1992,0.009993,172.253.118.0-255,5738,155145,33,340596
1993,0.010002,172.31.33.0-255,66,155211,33,340596
1994,0.012188,172.253.118.0-255,5738,160949,33,340596
1995,0.012196,172.31.33.0-255,66,161015,33,340596
1996,0.014389,172.253.118.0-255,5738,166753,33,340596
1997,0.014397,172.31.33.0-255,66,166819,33,340596
1998,0.016582,172.253.118.0-255,5738,172557,33,340596
1999,0.016589,172.31.33.0-255,66,172623,33,340596
2000,0.018762,172.253.118.0-255,5738,178361,33,340596
2001,0.018768,172.31.33.0-255,66,178427,33,340596
2002,0.020933,172.253.118.0-255,5738,184165,33,340596
2003,0.02094,172.31.33.0-255,66,184231,33,340596
2004,0.023099,172.253.118.0-255,5738,189969,33,340596
2005,0.023103,172.31.33.0-255,66,190035,33,340596
2006,0.023913,172.31.33.0-255,200,190235,33,340596
2007,0.023938,172.31.33.0-255,1117,191352,33,340596
2008,0.023992,172.31.33.0-255,1514,192866,33,340596
2009,0.023998,172.31.33.0-255,1514,194380,33,340596
2010,0.023999,172.31.33.0-255,678,195058,33,340596
2011,0.025299,172.253.118.0-255,5738,200796,33,340596
2012,0.025305,172.31.33.0-255,66,200862,33,340596
2013,0.025546,104.244.42.0-255,66,200928,33,340596
2014,0.025553,104.244.42.0-255,66,200994,33,340596
2015,0.02565,104.244.42.0-255,66,201060,33,340596
2016,0.025656,104.244.42.0-255,66,201126,33,340596
2017,0.026684,104.244.42.0-255,108,201234,33,340596
2018,0.026691,172.31.33.0-255,66,201300,33,340596
2019,0.027484,172.253.118.0-255,5738,207038,33,340596
2020,0.027488,172.31.33.0-255,66,207104,33,340596
2021,0.029675,172.253.118.0-255,5738,212842,33,340596
2022,0.029681,172.31.33.0-255,66,212908,33,340596
2023,0.03189,172.253.118.0-255,5738,218646,33,340596
2024,0.031896,172.31.33.0-255,66,218712,33,340596
2025,0.034041,172.253.118.0-255,5738,224450,33,340596
2026,0.034046,172.31.33.0-255,66,224516,33,340596
2027,0.036224,172.253.118.0-255,5738,230254,33,340596
2028,0.036229,172.31.33.0-255,66,230320,33,340596
2029,0.038404,172.253.118.0-255,5738,236058,33,340596
2030,0.038409,172.31.33.0-255,66,236124,33,340596
2031,0.040602,172.253.118.0-255,5738,241862,33,340596
2032,0.040612,172.31.33.0-255,66,241928,33,340596
2033,0.042776,172.253.118.0-255,5738,247666,33,340596
2034,0.042782,172.31.33.0-255,66,247732,33,340596
2035,0.044967,172.253.118.0-255,5738,253470,33,340596
2036,0.044972,172.31.33.0-255,66,253536,33,340596
2037,0.047164,172.253.118.0-255,5738,259274,33,340596
2038,0.047169,172.31.33.0-255,66,259340,33,340596
2039,0.049396,172.253.118.0-255,5738,265078,33,340596
2040,0.049403,172.31.33.0-255,66,265144,33,340596
2041,0.051585,172.253.118.0-255,5738,270882,33,340596
2042,0.05159,172.31.33.0-255,66,270948,33,340596
2043,0.053782,172.253.118.0-255,5738,276686,33,340596
2044,0.053787,172.31.33.0-255,66,276752,33,340596
2045,0.05601,172.253.118.0-255,5738,282490,33,340596
2046,0.056015,172.31.33.0-255,66,282556,33,340596
2047,0.058226,172.253.118.0-255,5738,288294,33,340596
2048,0.058231,172.31.33.0-255,66,288360,33,340596
2049,0.060439,172.253.118.0-255,5738,294098,33,340596
2050,0.060446,172.31.33.0-255,66,294164,33,340596
2051,0.062596,172.253.118.0-255,5738,299902,33,340596
2052,0.0626,172.31.33.0-255,66,299968,33,340596
2053,0.064798,172.253.118.0-255,5738,305706,33,340596
2054,0.064803,172.31.33.0-255,66,305772,33,340596
2055,0.067,172.253.118.0-255,5738,311510,33,340596
2056,0.067006,172.31.33.0-255,66,311576,33,340596
2057,0.069203,172.253.118.0-255,5738,317314,33,340596
2058,0.069209,172.31.33.0-255,66,317380,33,340596
2059,0.071363,172.253.118.0-255,5738,323118,33,340596
2060,0.071369,172.31.33.0-255,66,323184,33,340596
2061,0.073551,172.253.118.0-255,5738,328922,33,340596
2062,0.073557,172.31.33.0-255,66,328988,33,340596
2063,0.075748,172.253.118.0-255,5738,334726,33,340596
2064,0.075753,172.31.33.0-255,66,334792,33,340596
2065,0.077942,172.253.118.0-255,5738,340530,33,340596
2066,0.077947,172.31.33.0-255,66,340596,33,340596
2067,0.0,74.125.24.0-255,153,153,33,329126
2068,6.7e-05,172.31.33.0-255,66,219,33,329126
2069,7.3e-05,74.125.24.0-255,1484,1703,33,329126
2070,7.8e-05,172.31.33.0-255,66,1769,33,329126
2071,8.3e-05,74.125.24.0-255,2902,4671,33,329126
2072,8.7e-05,172.31.33.0-255,66,4737,33,329126
2073,9.2e-05,74.125.24.0-255,4320,9057,33,329126
2074,9.5e-05,172.31.33.0-255,66,9123,33,329126
2075,0.0001,74.125.24.0-255,4885,14008,33,329126
2076,0.000102,172.31.33.0-255,66,14074,33,329126
2077,0.000164,74.125.24.0-255,1484,15558,33,329126
2078,0.000167,172.31.33.0-255,66,15624,33,329126
2079,0.000182,74.125.24.0-255,2902,18526,33,329126
2080,0.000185,172.31.33.0-255,66,18592,33,329126
2081,0.000193,74.125.24.0-255,5738,24330,33,329126
2082,0.000195,172.31.33.0-255,66,24396,33,329126
2083,0.000278,74.125.24.0-255,6797,31193,33,329126
2084,0.000283,172.31.33.0-255,66,31259,33,329126
2085,0.000396,74.125.24.0-255,1484,32743,33,329126
2086,0.0004,172.31.33.0-255,66,32809,33,329126
2087,0.000406,74.125.24.0-255,2902,35711,33,329126
2088,0.000409,172.31.33.0-255,66,35777,33,329126
2089,0.000415,74.125.24.0-255,5738,41515,33,329126
2090,0.000419,172.31.33.0-255,66,41581,33,329126
2091,0.000444,74.125.24.0-255,2902,44483,33,329126
2092,0.000448,172.31.33.0-255,66,44549,33,329126
2093,0.000468,74.125.24.0-255,3961,48510,33,329126
2094,0.000472,172.31.33.0-255,66,48576,33,329126
2095,0.000476,74.125.24.0-255,2902,51478,33,329126
2096,0.000478,172.31.33.0-255,66,51544,33,329126
2097,0.00049,74.125.24.0-255,4320,55864,33,329126
2098,0.000496,172.31.33.0-255,66,55930,33,329126
2099,0.000521,172.31.33.0-255,66,55996,33,329126
2100,0.00121,74.125.24.0-255,648,56644,33,329126
2101,0.001217,172.31.33.0-255,66,56710,33,329126
2102,0.001424,74.125.24.0-255,1484,58194,33,329126
2103,0.00143,172.31.33.0-255,66,58260,33,329126
2104,0.001437,74.125.24.0-255,2902,61162,33,329126
2105,0.001439,172.31.33.0-255,66,61228,33,329126
2106,0.001446,74.125.24.0-255,5738,66966,33,329126
2107,0.001448,172.31.33.0-255,66,67032,33,329126
2108,0.001454,74.125.24.0-255,4320,71352,33,329126
2109,0.001456,172.31.33.0-255,66,71418,33,329126
2110,0.001492,172.31.33.0-255,66,71484,33,329126
2111,0.001506,172.31.33.0-255,66,71550,33,329126
2112,0.00151,74.125.24.0-255,2184,73734,33,329126
2113,0.001512,172.31.33.0-255,66,73800,33,329126
2114,0.001831,74.125.24.0-255,1484,75284,33,329126
2115,0.001834,172.31.33.0-255,66,75350,33,329126
2116,0.001839,74.125.24.0-255,2902,78252,33,329126
2117,0.001841,172.31.33.0-255,66,78318,33,329126
2118,0.001866,74.125.24.0-255,5738,84056,33,329126
2119,0.001868,172.31.33.0-255,66,84122,33,329126
2120,0.001893,172.31.33.0-255,66,84188,33,329126
2121,0.001922,74.125.24.0-255,2902,87090,33,329126
2122,0.001924,172.31.33.0-255,66,87156,33,329126
2123,0.001943,74.125.24.0-255,7156,94312,33,329126
2124,0.001945,172.31.33.0-255,66,94378,33,329126
2125,0.001963,74.125.24.0-255,5020,99398,33,329126
2126,0.001965,172.31.33.0-255,66,99464,33,329126
2127,0.002006,74.125.24.0-255,1484,100948,33,329126
2128,0.002009,172.31.33.0-255,66,101014,33,329126
2129,0.002013,74.125.24.0-255,2902,103916,33,329126
2130,0.002016,172.31.33.0-255,66,103982,33,329126
2131,0.002021,74.125.24.0-255,4320,108302,33,329126
2132,0.002023,172.31.33.0-255,66,108368,33,329126
2133,0.002048,74.125.24.0-255,1484,109852,33,329126
2134,0.00205,172.31.33.0-255,66,109918,33,329126
2135,0.002074,74.125.24.0-255,2902,112820,33,329126
2136,0.002172,74.125.24.0-255,1484,114304,33,329126
2137,0.002191,74.125.24.0-255,2902,117206,33,329126
2138,0.002198,74.125.24.0-255,5738,122944,33,329126
2139,0.002245,74.125.24.0-255,4320,127264,33,329126
2140,0.002251,74.125.24.0-255,5738,133002,33,329126
2141,0.002301,74.125.24.0-255,5020,138022,33,329126
2142,0.002321,74.125.24.0-255,2902,140924,33,329126
2143,0.002339,74.125.24.0-255,2902,143826,33,329126
2144,0.002343,74.125.24.0-255,2902,146728,33,329126
2145,0.002378,74.125.24.0-255,1484,148212,33,329126
2146,0.002381,74.125.24.0-255,1484,149696,33,329126
2147,0.0024,74.125.24.0-255,4320,154016,33,329126
2148,0.002415,74.125.24.0-255,2902,156918,33,329126
2149,0.002426,74.125.24.0-255,2902,159820,33,329126
2150,0.002435,74.125.24.0-255,1484,161304,33,329126
2151,0.002471,74.125.24.0-255,2184,163488,33,329126
2152,0.004711,172.31.33.0-255,66,163554,33,329126
2153,0.007355,74.125.24.0-255,5738,169292,33,329126
2154,0.007369,172.31.33.0-255,66,169358,33,329126
2155,0.009962,74.125.24.0-255,5738,175096,33,329126
2156,0.009974,172.31.33.0-255,66,175162,33,329126
2157,0.012574,74.125.24.0-255,5738,180900,33,329126
2158,0.012593,172.31.33.0-255,66,180966,33,329126
2159,0.015173,74.125.24.0-255,5738,186704,33,329126
2160,0.015185,172.31.33.0-255,66,186770,33,329126
2161,0.017797,74.125.24.0-255,5738,192508,33,329126
2162,0.017818,172.31.33.0-255,66,192574,33,329126
2163,0.02041,74.125.24.0-255,5738,198312,33,329126
2164,0.020418,172.31.33.0-255,66,198378,33,329126
2165,0.023008,74.125.24.0-255,5738,204116,33,329126
2166,0.023016,172.31.33.0-255,66,204182,33,329126
2167,0.025634,74.125.24.0-255,5738,209920,33,329126
2168,0.025654,172.31.33.0-255,66,209986,33,329126
2169,0.028207,74.125.24.0-255,5738,215724,33,329126
2170,0.028214,172.31.33.0-255,66,215790,33,329126
2171,0.030771,74.125.24.0-255,5738,221528,33,329126
2172,0.030779,172.31.33.0-255,66,221594,33,329126
2173,0.033371,74.125.24.0-255,5738,227332,33,329126
2174,0.033393,172.31.33.0-255,66,227398,33,329126
2175,0.035991,74.125.24.0-255,5738,233136,33,329126
2176,0.036004,172.31.33.0-255,66,233202,33,329126
2177,0.038583,74.125.24.0-255,5738,238940,33,329126
2178,0.038594,172.31.33.0-255,66,239006,33,329126
2179,0.040255,172.31.33.0-255,171,239177,33,329126
2180,0.040285,172.31.33.0-255,1141,240318,33,329126
2181,0.040323,172.31.33.0-255,1514,241832,33,329126
2182,0.040325,172.31.33.0-255,1256,243088,33,329126
2183,0.041193,74.125.24.0-255,5738,248826,33,329126
2184,0.041202,172.31.33.0-255,66,248892,33,329126
2185,0.04181,104.244.42.0-255,66,248958,33,329126
2186,0.041998,104.244.42.0-255,66,249024,33,329126
2187,0.042003,104.244.42.0-255,66,249090,33,329126
2188,0.043818,74.125.24.0-255,5738,254828,33,329126
2189,0.043831,172.31.33.0-255,66,254894,33,329126
2190,0.046414,74.125.24.0-255,5738,260632,33,329126
2191,0.046421,172.31.33.0-255,66,260698,33,329126
2192,0.048992,74.125.24.0-255,5738,266436,33,329126
2193,0.048999,172.31.33.0-255,66,266502,33,329126
2194,0.051547,74.125.24.0-255,5738,272240,33,329126
2195,0.051553,172.31.33.0-255,66,272306,33,329126
2196,0.054101,74.125.24.0-255,5738,278044,33,329126
2197,0.054107,172.31.33.0-255,66,278110,33,329126
2198,0.056698,74.125.24.0-255,5738,283848,33,329126
2199,0.056703,172.31.33.0-255,66,283914,33,329126
2200,0.059271,74.125.24.0-255,2902,286816,33,329126
2201,0.059275,172.31.33.0-255,66,286882,33,329126
2202,0.059303,74.125.24.0-255,2902,289784,33,329126
2203,0.059306,172.31.33.0-255,66,289850,33,329126
2204,0.06184,74.125.24.0-255,5738,295588,33,329126
2205,0.061845,172.31.33.0-255,66,295654,33,329126
2206,0.064426,74.125.24.0-255,4320,299974,33,329126
2207,0.064431,172.31.33.0-255,66,300040,33,329126
2208,0.064458,74.125.24.0-255,1484,301524,33,329126
2209,0.067009,74.125.24.0-255,4320,305844,33,329126
2210,0.067015,172.31.33.0-255,66,305910,33,329126
2211,0.069625,74.125.24.0-255,5738,311648,33,329126
2212,0.069629,172.31.33.0-255,66,311714,33,329126
2213,0.072253,74.125.24.0-255,5738,317452,33,329126
2214,0.072259,172.31.33.0-255,66,317518,33,329126
2215,0.074869,74.125.24.0-255,5738,323256,33,329126
2216,0.074874,172.31.33.0-255,66,323322,33,329126
2217,0.077447,74.125.24.0-255,5738,329060,33,329126
2218,0.077453,172.31.33.0-255,66,329126,33,329126
2219,0.0,172.217.194.0-255,153,153,33,336960
2220,2.2e-05,172.31.33.0-255,66,219,33,336960
2221,3e-05,172.217.194.0-255,1484,1703,33,336960
2222,3.5e-05,172.31.33.0-255,66,1769,33,336960
2223,4.8e-05,172.217.194.0-255,2902,4671,33,336960
2224,5.2e-05,172.31.33.0-255,66,4737,33,336960
2225,6e-05,172.217.194.0-255,7156,11893,33,336960
2226,6.3e-05,172.31.33.0-255,66,11959,33,336960
2227,6.7e-05,172.217.194.0-255,2021,13980,33,336960
2228,7.1e-05,172.31.33.0-255,66,14046,33,336960
2229,0.00011,172.217.194.0-255,1484,15530,33,336960
2230,0.000113,172.31.33.0-255,66,15596,33,336960
2231,0.000118,172.217.194.0-255,2902,18498,33,336960
2232,0.000121,172.31.33.0-255,66,18564,33,336960
2233,0.000126,172.217.194.0-255,2902,21466,33,336960
2234,0.000134,172.31.33.0-255,66,21532,33,336960
2235,0.000165,172.217.194.0-255,2902,24434,33,336960
2236,0.000167,172.31.33.0-255,66,24500,33,336960
2237,0.000175,172.217.194.0-255,6797,31297,33,336960
2238,0.000177,172.31.33.0-255,66,31363,33,336960
2239,0.000219,172.217.194.0-255,1484,32847,33,336960
2240,0.000222,172.31.33.0-255,66,32913,33,336960
2241,0.000247,172.217.194.0-255,2902,35815,33,336960
2242,0.00025,172.31.33.0-255,66,35881,33,336960
2243,0.000257,172.217.194.0-255,5738,41619,33,336960
2244,0.00026,172.31.33.0-255,66,41685,33,336960
2245,0.000272,172.217.194.0-255,6797,48482,33,336960
2246,0.000275,172.31.33.0-255,66,48548,33,336960
2247,0.000322,172.217.194.0-255,5738,54286,33,336960
2248,0.000326,172.31.33.0-255,66,54352,33,336960
2249,0.000334,172.217.194.0-255,7156,61508,33,336960
2250,0.000336,172.31.33.0-255,66,61574,33,336960
2251,0.000375,172.217.194.0-255,3961,65535,33,336960
2252,0.000378,172.31.33.0-255,66,65601,33,336960
2253,0.000498,172.217.194.0-255,646,66247,33,336960
2254,0.000607,172.217.194.0-255,1484,67731,33,336960
2255,0.000611,172.31.33.0-255,66,67797,33,336960
2256,0.000618,172.217.194.0-255,2902,70699,33,336960
2257,0.000621,172.31.33.0-255,66,70765,33,336960
2258,0.000631,172.217.194.0-255,4320,75085,33,336960
2259,0.000633,172.31.33.0-255,66,75151,33,336960
2260,0.00064,172.217.194.0-255,5738,80889,33,336960
2261,0.000643,172.31.33.0-255,66,80955,33,336960
2262,0.000674,172.217.194.0-255,2902,83857,33,336960
2263,0.000676,172.31.33.0-255,66,83923,33,336960
2264,0.000683,172.217.194.0-255,5738,89661,33,336960
2265,0.000686,172.31.33.0-255,66,89727,33,336960
2266,0.000733,172.31.33.0-255,66,89793,33,336960
2267,0.001146,172.217.194.0-255,1484,91277,33,336960
2268,0.001153,172.217.194.0-255,2902,94179,33,336960
2269,0.001156,172.31.33.0-255,66,94245,33,336960
2270,0.001163,172.217.194.0-255,5738,99983,33,336960
2271,0.001165,172.31.33.0-255,66,100049,33,336960
2272,0.001201,172.31.33.0-255,66,100115,33,336960
2273,0.001253,172.31.33.0-255,66,100181,33,336960
2274,0.001868,172.217.194.0-255,1484,101665,33,336960
2275,0.001891,172.217.194.0-255,2902,104567,33,336960
2276,0.001895,172.31.33.0-255,66,104633,33,336960
2277,0.001902,172.217.194.0-255,5738,110371,33,336960
2278,0.001904,172.31.33.0-255,66,110437,33,336960
2279,0.001938,172.31.33.0-255,66,110503,33,336960
2280,0.001968,172.217.194.0-255,2902,113405,33,336960
2281,0.00197,172.31.33.0-255,66,113471,33,336960
2282,0.001999,172.31.33.0-255,66,113537,33,336960
2283,0.002002,172.217.194.0-255,1484,115021,33,336960
2284,0.002006,172.217.194.0-255,2902,117923,33,336960
2285,0.002007,172.31.33.0-255,66,117989,33,336960
2286,0.002015,172.217.194.0-255,2902,120891,33,336960
2287,0.002017,172.31.33.0-255,66,120957,33,336960
2288,0.00205,172.217.194.0-255,2902,123859,33,336960
2289,0.002052,172.31.33.0-255,66,123925,33,336960
2290,0.002055,172.217.194.0-255,1484,125409,33,336960
2291,0.002085,172.31.33.0-255,66,125475,33,336960
2292,0.002113,172.217.194.0-255,7156,132631,33,336960
2293,0.002115,172.31.33.0-255,66,132697,33,336960
2294,0.002133,172.217.194.0-255,6438,139135,33,336960
2295,0.002135,172.31.33.0-255,66,139201,33,336960
2296,0.002179,172.217.194.0-255,1484,140685,33,336960
2297,0.002184,172.217.194.0-255,2902,143587,33,336960
2298,0.002186,172.31.33.0-255,66,143653,33,336960
2299,0.002213,172.217.194.0-255,5738,149391,33,336960
2300,0.002216,172.31.33.0-255,66,149457,33,336960
2301,0.002238,172.217.194.0-255,4320,153777,33,336960
2302,0.002241,172.31.33.0-255,66,153843,33,336960
2303,0.002257,172.217.194.0-255,5738,159581,33,336960
2304,0.002259,172.31.33.0-255,66,159647,33,336960
2305,0.002285,172.217.194.0-255,2902,162549,33,336960
2306,0.002288,172.31.33.0-255,66,162615,33,336960
2307,0.002297,172.31.33.0-255,66,162681,33,336960
2308,0.002307,172.217.194.0-255,2184,164865,33,336960
2309,0.00231,172.31.33.0-255,66,164931,33,336960
2310,0.004616,172.217.194.0-255,5738,170669,33,336960
2311,0.004626,172.31.33.0-255,66,170735,33,336960
2312,0.006902,172.217.194.0-255,5738,176473,33,336960
2313,0.006907,172.31.33.0-255,66,176539,33,336960
2314,0.009192,172.217.194.0-255,5738,182277,33,336960
2315,0.009198,172.31.33.0-255,66,182343,33,336960
2316,0.011513,172.217.194.0-255,5738,188081,33,336960
2317,0.01152,172.31.33.0-255,66,188147,33,336960
2318,0.013837,172.217.194.0-255,5738,193885,33,336960
2319,0.013844,172.31.33.0-255,66,193951,33,336960
2320,0.016144,172.217.194.0-255,5738,199689,33,336960
2321,0.016154,172.31.33.0-255,66,199755,33,336960
2322,0.018455,172.217.194.0-255,5738,205493,33,336960
2323,0.018463,172.31.33.0-255,66,205559,33,336960
2324,0.020762,172.217.194.0-255,5738,211297,33,336960
2325,0.020769,172.31.33.0-255,66,211363,33,336960
2326,0.023058,172.217.194.0-255,5738,217101,33,336960
2327,0.023069,172.31.33.0-255,66,217167,33,336960
2328,0.025415,172.217.194.0-255,5738,222905,33,336960
2329,0.025421,172.31.33.0-255,66,222971,33,336960
2330,0.027733,172.217.194.0-255,5738,228709,33,336960
2331,0.027742,172.31.33.0-255,66,228775,33,336960
2332,0.029028,172.31.33.0-255,176,228951,33,336960
2333,0.029056,172.31.33.0-255,1117,230068,33,336960
2334,0.029108,172.31.33.0-255,1514,231582,33,336960
2335,0.029109,172.31.33.0-255,1514,233096,33,336960
2336,0.029131,172.31.33.0-255,676,233772,33,336960
2337,0.030038,172.217.194.0-255,5738,239510,33,336960
2338,0.030045,172.31.33.0-255,66,239576,33,336960
2339,0.030605,104.244.42.0-255,66,239642,33,336960
2340,0.030651,104.244.42.0-255,66,239708,33,336960
2341,0.030699,104.244.42.0-255,66,239774,33,336960
2342,0.030709,104.244.42.0-255,66,239840,33,336960
2343,0.032345,172.217.194.0-255,2902,242742,33,336960
2344,0.032351,172.31.33.0-255,66,242808,33,336960
2345,0.032379,172.217.194.0-255,2902,245710,33,336960
2346,0.032381,172.31.33.0-255,66,245776,33,336960
2347,0.03467,172.217.194.0-255,5738,251514,33,336960
2348,0.034675,172.31.33.0-255,66,251580,33,336960
2349,0.037008,172.217.194.0-255,5738,257318,33,336960
2350,0.037015,172.31.33.0-255,66,257384,33,336960
2351,0.039336,172.217.194.0-255,5738,263122,33,336960
2352,0.039342,172.31.33.0-255,66,263188,33,336960
2353,0.041622,172.217.194.0-255,5738,268926,33,336960
2354,0.04163,172.31.33.0-255,66,268992,33,336960
2355,0.043922,172.217.194.0-255,5738,274730,33,336960
2356,0.043933,172.31.33.0-255,66,274796,33,336960
2357,0.04631,172.217.194.0-255,5738,280534,33,336960
2358,0.046317,172.31.33.0-255,66,280600,33,336960
2359,0.048625,172.217.194.0-255,5738,286338,33,336960
2360,0.048632,172.31.33.0-255,66,286404,33,336960
2361,0.050962,172.217.194.0-255,5738,292142,33,336960
2362,0.050969,172.31.33.0-255,66,292208,33,336960
2363,0.053288,172.217.194.0-255,5738,297946,33,336960
2364,0.053296,172.31.33.0-255,66,298012,33,336960
2365,0.055603,172.217.194.0-255,5738,303750,33,336960
2366,0.055611,172.31.33.0-255,66,303816,33,336960
2367,0.057915,172.217.194.0-255,5738,309554,33,336960
2368,0.057922,172.31.33.0-255,66,309620,33,336960
2369,0.060228,172.217.194.0-255,5738,315358,33,336960
2370,0.060234,172.31.33.0-255,66,315424,33,336960
2371,0.062563,172.217.194.0-255,5738,321162,33,336960
2372,0.06257,172.31.33.0-255,66,321228,33,336960
2373,0.064862,172.217.194.0-255,5738,326966,33,336960
2374,0.064869,172.31.33.0-255,66,327032,33,336960
2375,0.06718,172.217.194.0-255,5738,332770,33,336960
2376,0.067187,172.31.33.0-255,66,332836,33,336960
2377,0.069604,172.217.194.0-255,3887,336723,33,336960
2378,0.069611,172.31.33.0-255,66,336789,33,336960
2379,0.069819,172.31.33.0-255,105,336894,33,336960
2380,0.072086,172.217.194.0-255,66,336960,33,336960
2381,0.0,172.31.33.0-255,66,66,33,66
2382,0.0,172.217.194.0-255,153,153,33,172008
2383,2.2e-05,172.31.33.0-255,66,219,33,172008
2384,2.9e-05,172.217.194.0-255,1484,1703,33,172008
2385,3.3e-05,172.31.33.0-255,66,1769,33,172008
2386,3.9e-05,172.217.194.0-255,2902,4671,33,172008
2387,5.1e-05,172.31.33.0-255,66,4737,33,172008
2388,5.8e-05,172.217.194.0-255,7156,11893,33,172008
2389,6.2e-05,172.31.33.0-255,66,11959,33,172008
2390,7.6e-05,172.31.33.0-255,66,12025,33,172008
2391,8.1e-05,172.217.194.0-255,2902,14927,33,172008
2392,8.4e-05,172.31.33.0-255,66,14993,33,172008
2393,0.000117,172.217.194.0-255,3961,18954,33,172008
2394,0.00012,172.31.33.0-255,66,19020,33,172008
2395,0.000148,172.217.194.0-255,1484,20504,33,172008
2396,0.00015,172.31.33.0-255,66,20570,33,172008
2397,0.000155,172.217.194.0-255,2902,23472,33,172008
2398,0.000157,172.31.33.0-255,66,23538,33,172008
2399,0.000161,172.217.194.0-255,1484,25022,33,172008
2400,0.000168,172.31.33.0-255,66,25088,33,172008
2401,0.000202,172.217.194.0-255,4320,29408,33,172008
2402,0.000205,172.31.33.0-255,66,29474,33,172008
2403,0.000211,172.217.194.0-255,5738,35212,33,172008
2404,0.000213,172.31.33.0-255,66,35278,33,172008
2405,0.000232,172.31.33.0-255,66,35344,33,172008
2406,0.000237,172.217.194.0-255,4249,39593,33,172008
2407,0.000239,172.31.33.0-255,66,39659,33,172008
2408,0.000293,172.217.194.0-255,4320,43979,33,172008
2409,0.000297,172.31.33.0-255,66,44045,33,172008
2410,0.000324,172.217.194.0-255,2935,46980,33,172008
2411,0.000327,172.31.33.0-255,66,47046,33,172008
2412,0.000342,172.31.33.0-255,66,47112,33,172008
2413,0.000345,172.217.194.0-255,844,47956,33,172008
2414,0.000729,172.217.194.0-255,1484,49440,33,172008
2415,0.000735,172.31.33.0-255,66,49506,33,172008
2416,0.000741,172.217.194.0-255,2902,52408,33,172008
2417,0.000744,172.31.33.0-255,66,52474,33,172008
2418,0.000752,172.217.194.0-255,1484,53958,33,172008
2419,0.000781,172.217.194.0-255,4320,58278,33,172008
2420,0.000784,172.31.33.0-255,66,58344,33,172008
2421,0.000797,172.31.33.0-255,66,58410,33,172008
2422,0.000809,172.217.194.0-255,7156,65566,33,172008
2423,0.000812,172.31.33.0-255,66,65632,33,172008
2424,0.00086,172.217.194.0-255,3602,69234,33,172008
2425,0.000863,172.31.33.0-255,66,69300,33,172008
2426,0.001215,172.217.194.0-255,1484,70784,33,172008
2427,0.001221,172.217.194.0-255,2902,73686,33,172008
2428,0.001225,172.31.33.0-255,66,73752,33,172008
2429,0.001231,172.217.194.0-255,4320,78072,33,172008
2430,0.001233,172.31.33.0-255,66,78138,33,172008
2431,0.001261,172.217.194.0-255,1484,79622,33,172008
2432,0.00127,172.217.194.0-255,7156,86778,33,172008
2433,0.001272,172.31.33.0-255,66,86844,33,172008
2434,0.001306,172.31.33.0-255,66,86910,33,172008
2435,0.001332,172.217.194.0-255,1484,88394,33,172008
2436,0.001337,172.217.194.0-255,2184,90578,33,172008
2437,0.001339,172.31.33.0-255,66,90644,33,172008
2438,0.001441,172.217.194.0-255,1484,92128,33,172008
2439,0.001447,172.217.194.0-255,2902,95030,33,172008
2440,0.00145,172.31.33.0-255,66,95096,33,172008
2441,0.001483,172.217.194.0-255,5738,100834,33,172008
2442,0.001486,172.31.33.0-255,66,100900,33,172008
2443,0.001506,172.31.33.0-255,66,100966,33,172008
2444,0.001509,172.217.194.0-255,1484,102450,33,172008
2445,0.001542,172.31.33.0-255,66,102516,33,172008
2446,0.001574,172.217.194.0-255,1484,104000,33,172008
2447,0.001579,172.217.194.0-255,2902,106902,33,172008
2448,0.001581,172.31.33.0-255,66,106968,33,172008
2449,0.001587,172.217.194.0-255,5738,112706,33,172008
2450,0.001589,172.31.33.0-255,66,112772,33,172008
2451,0.001592,172.217.194.0-255,1484,114256,33,172008
2452,0.001632,172.31.33.0-255,66,114322,33,172008
2453,0.001641,172.31.33.0-255,66,114388,33,172008
2454,0.001671,172.217.194.0-255,2184,116572,33,172008
2455,0.001673,172.31.33.0-255,66,116638,33,172008
2456,0.001778,172.217.194.0-255,1484,118122,33,172008
2457,0.001784,172.217.194.0-255,2902,121024,33,172008
2458,0.001787,172.31.33.0-255,66,121090,33,172008
2459,0.001817,172.217.194.0-255,5738,126828,33,172008
2460,0.00182,172.31.33.0-255,66,126894,33,172008
2461,0.001827,172.217.194.0-255,5738,132632,33,172008
2462,0.001829,172.31.33.0-255,66,132698,33,172008
2463,0.001858,172.217.194.0-255,7156,139854,33,172008
2464,0.00186,172.31.33.0-255,66,139920,33,172008
2465,0.00187,172.217.194.0-255,1484,141404,33,172008
2466,0.001901,172.31.33.0-255,66,141470,33,172008
2467,0.001925,172.217.194.0-255,7156,148626,33,172008
2468,0.001927,172.31.33.0-255,66,148692,33,172008
2469,0.001955,172.217.194.0-255,4320,153012,33,172008
2470,0.001958,172.31.33.0-255,66,153078,33,172008
2471,0.001974,172.31.33.0-255,66,153144,33,172008
2472,0.001977,172.217.194.0-255,2902,156046,33,172008
2473,0.00198,172.31.33.0-255,66,156112,33,172008
2474,0.002028,172.31.33.0-255,66,156178,33,172008
2475,0.002073,172.31.33.0-255,66,156244,33,172008
2476,0.002094,172.217.194.0-255,1484,157728,33,172008
2477,0.002104,172.31.33.0-255,66,157794,33,172008
2478,0.002114,172.31.33.0-255,66,157860,33,172008
2479,0.002133,172.31.33.0-255,66,157926,33,172008
2480,0.002174,172.31.33.0-255,66,157992,33,172008
2481,0.00218,172.217.194.0-255,5738,163730,33,172008
2482,0.002182,172.31.33.0-255,66,163796,33,172008
2483,0.002215,172.31.33.0-255,66,163862,33,172008
2484,0.002234,172.31.33.0-255,66,163928,33,172008
2485,0.002258,172.217.194.0-255,1761,165689,33,172008
2486,0.00226,172.31.33.0-255,66,165755,33,172008
2487,0.002284,172.217.194.0-255,105,165860,33,172008
2488,0.004172,172.31.33.0-255,66,165926,33,172008
2489,0.004205,172.31.33.0-255,105,166031,33,172008
2490,0.004489,172.217.194.0-255,129,166160,33,172008
2491,0.006463,172.217.194.0-255,66,166226,33,172008
2492,0.010451,172.31.33.0-255,105,166331,33,172008
2493,0.010675,172.31.33.0-255,90,166421,33,172008
2494,0.010685,172.31.33.0-255,66,166487,33,172008
2495,0.012726,172.217.194.0-255,66,166553,33,172008
2496,0.012957,172.217.194.0-255,66,166619,33,172008
2497,0.012976,172.217.194.0-255,66,166685,33,172008
2498,0.012982,172.31.33.0-255,66,166751,33,172008
2499,0.037066,172.31.33.0-255,172,166923,33,172008
2500,0.037104,172.31.33.0-255,1117,168040,33,172008
2501,0.037165,172.31.33.0-255,1514,169554,33,172008
2502,0.037167,172.31.33.0-255,1514,171068,33,172008
2503,0.037168,172.31.33.0-255,676,171744,33,172008
2504,0.038612,104.244.42.0-255,66,171810,33,172008
2505,0.038662,104.244.42.0-255,66,171876,33,172008
2506,0.038755,104.244.42.0-255,66,171942,33,172008
2507,0.038759,104.244.42.0-255,66,172008,33,172008
2508,0.0,74.125.68.0-255,153,153,33,372568
2509,2.4e-05,172.31.33.0-255,66,219,33,372568
2510,3e-05,74.125.68.0-255,1484,1703,33,372568
2511,3.4e-05,172.31.33.0-255,66,1769,33,372568
2512,4.9e-05,74.125.68.0-255,2902,4671,33,372568
2513,5.1e-05,172.31.33.0-255,66,4737,33,372568
2514,5.3e-05,74.125.68.0-255,1484,6221,33,372568
2515,5.5e-05,172.31.33.0-255,66,6287,33,372568
2516,7.9e-05,74.125.68.0-255,4320,10607,33,372568
2517,8.2e-05,172.31.33.0-255,66,10673,33,372568
2518,8.6e-05,74.125.68.0-255,3508,14181,33,372568
2519,8.8e-05,172.31.33.0-255,66,14247,33,372568
2520,0.000441,74.125.68.0-255,1484,15731,33,372568
2521,0.000448,172.31.33.0-255,66,15797,33,372568
2522,0.000457,74.125.68.0-255,2902,18699,33,372568
2523,0.00046,172.31.33.0-255,66,18765,33,372568
2524,0.000487,74.125.68.0-255,5738,24503,33,372568
2525,0.000491,172.31.33.0-255,66,24569,33,372568
2526,0.000497,74.125.68.0-255,5738,30307,33,372568
2527,0.000499,172.31.33.0-255,66,30373,33,372568
2528,0.000535,74.125.68.0-255,1125,31498,33,372568
2529,0.000539,172.31.33.0-255,66,31564,33,372568
2530,0.000738,74.125.68.0-255,1484,33048,33,372568
2531,0.000743,172.31.33.0-255,66,33114,33,372568
2532,0.000747,74.125.68.0-255,1484,34598,33,372568
2533,0.000749,172.31.33.0-255,66,34664,33,372568
2534,0.000754,74.125.68.0-255,2902,37566,33,372568
2535,0.000756,172.31.33.0-255,66,37632,33,372568
2536,0.000789,74.125.68.0-255,5738,43370,33,372568
2537,0.000792,172.31.33.0-255,66,43436,33,372568
2538,0.0008,74.125.68.0-255,5379,48815,33,372568
2539,0.000802,172.31.33.0-255,66,48881,33,372568
2540,0.000806,74.125.68.0-255,2902,51783,33,372568
2541,0.000808,172.31.33.0-255,66,51849,33,372568
2542,0.000834,74.125.68.0-255,2902,54751,33,372568
2543,0.000837,172.31.33.0-255,66,54817,33,372568
2544,0.00084,74.125.68.0-255,1484,56301,33,372568
2545,0.000843,172.31.33.0-255,66,56367,33,372568
2546,0.000869,172.31.33.0-255,66,56433,33,372568
2547,0.001431,74.125.68.0-255,648,57081,33,372568
2548,0.001437,172.31.33.0-255,66,57147,33,372568
2549,0.001593,74.125.68.0-255,1484,58631,33,372568
2550,0.001597,172.31.33.0-255,66,58697,33,372568
2551,0.001604,74.125.68.0-255,2902,61599,33,372568
2552,0.001606,172.31.33.0-255,66,61665,33,372568
2553,0.00163,74.125.68.0-255,4320,65985,33,372568
2554,0.001632,172.31.33.0-255,66,66051,33,372568
2555,0.001648,74.125.68.0-255,7156,73207,33,372568
2556,0.00165,172.31.33.0-255,66,73273,33,372568
2557,0.001664,74.125.68.0-255,1484,74757,33,372568
2558,0.001666,172.31.33.0-255,66,74823,33,372568
2559,0.001671,74.125.68.0-255,4320,79143,33,372568
2560,0.001673,172.31.33.0-255,66,79209,33,372568
2561,0.001677,74.125.68.0-255,4320,83529,33,372568
2562,0.001679,172.31.33.0-255,66,83595,33,372568
2563,0.001695,74.125.68.0-255,1484,85079,33,372568
2564,0.001697,172.31.33.0-255,66,85145,33,372568
2565,0.001715,74.125.68.0-255,4320,89465,33,372568
2566,0.001717,172.31.33.0-255,66,89531,33,372568
2567,0.001732,74.125.68.0-255,2184,91715,33,372568
2568,0.001734,172.31.33.0-255,66,91781,33,372568
2569,0.001838,74.125.68.0-255,1484,93265,33,372568
2570,0.001842,172.31.33.0-255,66,93331,33,372568
2571,0.001855,74.125.68.0-255,2902,96233,33,372568
2572,0.001858,172.31.33.0-255,66,96299,33,372568
2573,0.001876,74.125.68.0-255,4320,100619,33,372568
2574,0.001878,172.31.33.0-255,66,100685,33,372568
2575,0.001922,74.125.68.0-255,4320,105005,33,372568
2576,0.001925,172.31.33.0-255,66,105071,33,372568
2577,0.00194,74.125.68.0-255,4320,109391,33,372568
2578,0.001943,172.31.33.0-255,66,109457,33,372568
2579,0.00195,74.125.68.0-255,7156,116613,33,372568
2580,0.001952,172.31.33.0-255,66,116679,33,372568
2581,0.001962,172.31.33.0-255,66,116745,33,372568
2582,0.001964,74.125.68.0-255,766,117511,33,372568
2583,0.001966,172.31.33.0-255,66,117577,33,372568
2584,0.002022,74.125.68.0-255,1484,119061,33,372568
2585,0.002032,172.31.33.0-255,66,119127,33,372568
2586,0.002037,74.125.68.0-255,2902,122029,33,372568
2587,0.002039,172.31.33.0-255,66,122095,33,372568
2588,0.00205,74.125.68.0-255,1484,123579,33,372568
2589,0.002052,172.31.33.0-255,66,123645,33,372568
2590,0.002066,74.125.68.0-255,4320,127965,33,372568
2591,0.002071,74.125.68.0-255,4320,132285,33,372568
2592,0.002086,74.125.68.0-255,2902,135187,33,372568
2593,0.002089,172.31.33.0-255,66,135253,33,372568
2594,0.002097,74.125.68.0-255,2902,138155,33,372568
2595,0.002101,172.31.33.0-255,66,138221,33,372568
2596,0.002109,74.125.68.0-255,2902,141123,33,372568
2597,0.002124,74.125.68.0-255,7156,148279,33,372568
2598,0.002133,172.31.33.0-255,66,148345,33,372568
2599,0.002141,74.125.68.0-255,1484,149829,33,372568
2600,0.002144,74.125.68.0-255,2184,152013,33,372568
2601,0.002149,172.31.33.0-255,66,152079,33,372568
2602,0.002287,74.125.68.0-255,1484,153563,33,372568
2603,0.002299,74.125.68.0-255,2902,156465,33,372568
2604,0.002301,172.31.33.0-255,66,156531,33,372568
2605,0.002321,74.125.68.0-255,5738,162269,33,372568
2606,0.002323,74.125.68.0-255,1484,163753,33,372568
2607,0.002334,172.31.33.0-255,66,163819,33,372568
2608,0.00235,74.125.68.0-255,2902,166721,33,372568
2609,0.002354,172.31.33.0-255,66,166787,33,372568
2610,0.002371,74.125.68.0-255,5738,172525,33,372568
2611,0.002389,74.125.68.0-255,5738,178263,33,372568
2612,0.002393,172.31.33.0-255,66,178329,33,372568
2613,0.002407,74.125.68.0-255,7156,185485,33,372568
2614,0.00241,74.125.68.0-255,766,186251,33,372568
2615,0.002426,172.31.33.0-255,66,186317,33,372568
2616,0.002548,74.125.68.0-255,1484,187801,33,372568
2617,0.002552,74.125.68.0-255,1484,189285,33,372568
2618,0.002554,172.31.33.0-255,66,189351,33,372568
2619,0.002571,74.125.68.0-255,1484,190835,33,372568
2620,0.002575,74.125.68.0-255,2902,193737,33,372568
2621,0.002578,172.31.33.0-255,66,193803,33,372568
2622,0.005097,74.125.68.0-255,1484,195287,33,372568
2623,0.005101,172.31.33.0-255,66,195353,33,372568
2624,0.00512,74.125.68.0-255,1484,196837,33,372568
2625,0.005121,172.31.33.0-255,66,196903,33,372568
2626,0.00514,74.125.68.0-255,2902,199805,33,372568
2627,0.005142,172.31.33.0-255,66,199871,33,372568
2628,0.007653,74.125.68.0-255,1484,201355,33,372568
2629,0.007659,172.31.33.0-255,66,201421,33,372568
2630,0.007681,74.125.68.0-255,4320,205741,33,372568
2631,0.007684,172.31.33.0-255,66,205807,33,372568
2632,0.010214,74.125.68.0-255,1484,207291,33,372568
2633,0.010223,172.31.33.0-255,66,207357,33,372568
2634,0.010249,74.125.68.0-255,4320,211677,33,372568
2635,0.010252,172.31.33.0-255,66,211743,33,372568
2636,0.012768,74.125.68.0-255,1484,213227,33,372568
2637,0.012777,172.31.33.0-255,66,213293,33,372568
2638,0.0128,74.125.68.0-255,4320,217613,33,372568
2639,0.012803,172.31.33.0-255,66,217679,33,372568
2640,0.015327,74.125.68.0-255,1484,219163,33,372568
2641,0.015336,172.31.33.0-255,66,219229,33,372568
2642,0.01536,74.125.68.0-255,4320,223549,33,372568
2643,0.015363,172.31.33.0-255,66,223615,33,372568
2644,0.017884,74.125.68.0-255,1484,225099,33,372568
2645,0.01789,172.31.33.0-255,66,225165,33,372568
2646,0.017916,74.125.68.0-255,4320,229485,33,372568
2647,0.017934,172.31.33.0-255,66,229551,33,372568
2648,0.020439,74.125.68.0-255,1484,231035,33,372568
2649,0.020448,172.31.33.0-255,66,231101,33,372568
2650,0.020488,74.125.68.0-255,2902,234003,33,372568
2651,0.020501,74.125.68.0-255,1484,235487,33,372568
2652,0.020528,172.31.33.0-255,66,235553,33,372568
2653,0.023005,74.125.68.0-255,1484,237037,33,372568
2654,0.023024,172.31.33.0-255,66,237103,33,372568
2655,0.023079,74.125.68.0-255,4320,241423,33,372568
2656,0.023143,172.31.33.0-255,66,241489,33,372568
2657,0.025596,74.125.68.0-255,1484,242973,33,372568
2658,0.025692,74.125.68.0-255,4320,247293,33,372568
2659,0.025727,172.31.33.0-255,66,247359,33,372568
2660,0.028295,74.125.68.0-255,5738,253097,33,372568
2661,0.028314,172.31.33.0-255,66,253163,33,372568
2662,0.030888,74.125.68.0-255,5738,258901,33,372568
2663,0.030896,172.31.33.0-255,66,258967,33,372568
2664,0.033457,74.125.68.0-255,5738,264705,33,372568
2665,0.033466,172.31.33.0-255,66,264771,33,372568
2666,0.034253,172.31.33.0-255,172,264943,33,372568
2667,0.034292,172.31.33.0-255,1117,266060,33,372568
2668,0.034417,172.31.33.0-255,1514,267574,33,372568
2669,0.03442,172.31.33.0-255,1280,268854,33,372568
2670,0.035813,104.244.42.0-255,66,268920,33,372568
2671,0.035854,104.244.42.0-255,66,268986,33,372568
2672,0.035996,104.244.42.0-255,66,269052,33,372568
2673,0.036018,74.125.68.0-255,5738,274790,33,372568
2674,0.036022,172.31.33.0-255,66,274856,33,372568
2675,0.038565,74.125.68.0-255,5738,280594,33,372568
2676,0.038571,172.31.33.0-255,66,280660,33,372568
2677,0.041156,74.125.68.0-255,5738,286398,33,372568
2678,0.041162,172.31.33.0-255,66,286464,33,372568
2679,0.043705,74.125.68.0-255,5738,292202,33,372568
2680,0.043709,172.31.33.0-255,66,292268,33,372568
2681,0.046253,74.125.68.0-255,5738,298006,33,372568
2682,0.046258,172.31.33.0-255,66,298072,33,372568
2683,0.048812,74.125.68.0-255,5738,303810,33,372568
2684,0.048816,172.31.33.0-255,66,303876,33,372568
2685,0.05137,74.125.68.0-255,5738,309614,33,372568
2686,0.051375,172.31.33.0-255,66,309680,33,372568
2687,0.053929,74.125.68.0-255,4320,314000,33,372568
2688,0.053935,172.31.33.0-255,66,314066,33,372568
2689,0.053966,74.125.68.0-255,1484,315550,33,372568
2690,0.056488,74.125.68.0-255,4320,319870,33,372568
2691,0.056492,172.31.33.0-255,66,319936,33,372568
2692,0.059048,74.125.68.0-255,5738,325674,33,372568
2693,0.0591,172.31.33.0-255,66,325740,33,372568
2694,0.061651,74.125.68.0-255,5738,331478,33,372568
2695,0.061655,172.31.33.0-255,66,331544,33,372568
2696,0.064242,74.125.68.0-255,5738,337282,33,372568
2697,0.064247,172.31.33.0-255,66,337348,33,372568
2698,0.0668,74.125.68.0-255,5738,343086,33,372568
2699,0.066805,172.31.33.0-255,66,343152,33,372568
2700,0.069374,74.125.68.0-255,5738,348890,33,372568
2701,0.069378,172.31.33.0-255,66,348956,33,372568
2702,0.071925,74.125.68.0-255,5738,354694,33,372568
2703,0.071929,172.31.33.0-255,66,354760,33,372568
2704,0.074486,74.125.68.0-255,2902,357662,33,372568
2705,0.074491,172.31.33.0-255,66,357728,33,372568
2706,0.074516,74.125.68.0-255,2902,360630,33,372568
2707,0.074532,172.31.33.0-255,66,360696,33,372568
2708,0.07704,74.125.68.0-255,2902,363598,33,372568
2709,0.077044,172.31.33.0-255,66,363664,33,372568
2710,0.077082,74.125.68.0-255,2902,366566,33,372568
2711,0.077089,172.31.33.0-255,66,366632,33,372568
2712,0.079593,74.125.68.0-255,2902,369534,33,372568
2713,0.079597,172.31.33.0-255,66,369600,33,372568
2714,0.07963,74.125.68.0-255,2902,372502,33,372568
2715,0.079641,172.31.33.0-255,66,372568,33,372568
2716,0.0,172.217.194.0-255,143,143,33,182950
2717,2.5e-05,172.31.33.0-255,66,209,33,182950
2718,3.3e-05,172.217.194.0-255,1484,1693,33,182950
2719,3.8e-05,172.31.33.0-255,66,1759,33,182950
2720,4.4e-05,172.217.194.0-255,2902,4661,33,182950
2721,4.7e-05,172.31.33.0-255,66,4727,33,182950
2722,6.1e-05,172.217.194.0-255,7156,11883,33,182950
2723,6.4e-05,172.31.33.0-255,66,11949,33,182950
2724,8.2e-05,172.217.194.0-255,2059,14008,33,182950
2725,8.8e-05,172.31.33.0-255,66,14074,33,182950
2726,0.000141,172.217.194.0-255,1484,15558,33,182950
2727,0.000143,172.31.33.0-255,66,15624,33,182950
2728,0.000147,172.217.194.0-255,1484,17108,33,182950
2729,0.000149,172.31.33.0-255,66,17174,33,182950
2730,0.000184,172.217.194.0-255,1484,18658,33,182950
2731,0.000186,172.31.33.0-255,66,18724,33,182950
2732,0.000193,172.217.194.0-255,5738,24462,33,182950
2733,0.000195,172.31.33.0-255,66,24528,33,182950
2734,0.000206,172.217.194.0-255,6797,31325,33,182950
2735,0.000208,172.31.33.0-255,66,31391,33,182950
2736,0.000215,172.217.194.0-255,7156,38547,33,182950
2737,0.000217,172.31.33.0-255,66,38613,33,182950
2738,0.000253,172.31.33.0-255,66,38679,33,182950
2739,0.00038,172.217.194.0-255,1484,40163,33,182950
2740,0.000384,172.31.33.0-255,66,40229,33,182950
2741,0.000388,172.217.194.0-255,1484,41713,33,182950
2742,0.00039,172.31.33.0-255,66,41779,33,182950
2743,0.000414,172.217.194.0-255,1484,43263,33,182950
2744,0.000416,172.31.33.0-255,66,43329,33,182950
2745,0.000427,172.217.194.0-255,5738,49067,33,182950
2746,0.000429,172.31.33.0-255,66,49133,33,182950
2747,0.000435,172.217.194.0-255,4320,53453,33,182950
2748,0.000437,172.31.33.0-255,66,53519,33,182950
2749,0.000468,172.217.194.0-255,2543,56062,33,182950
2750,0.00047,172.31.33.0-255,66,56128,33,182950
2751,0.000473,172.217.194.0-255,363,56491,33,182950
2752,0.000624,172.217.194.0-255,380,56871,33,182950
2753,0.000835,172.217.194.0-255,1484,58355,33,182950
2754,0.000839,172.31.33.0-255,66,58421,33,182950
2755,0.000844,172.217.194.0-255,2902,61323,33,182950
2756,0.000846,172.31.33.0-255,66,61389,33,182950
2757,0.000852,172.217.194.0-255,4320,65709,33,182950
2758,0.000853,172.31.33.0-255,66,65775,33,182950
2759,0.000868,172.217.194.0-255,1484,67259,33,182950
2760,0.000915,172.31.33.0-255,66,67325,33,182950
2761,0.000931,172.217.194.0-255,1484,68809,33,182950
2762,0.000941,172.31.33.0-255,66,68875,33,182950
2763,0.000945,172.217.194.0-255,2184,71059,33,182950
2764,0.000946,172.31.33.0-255,66,71125,33,182950
2765,0.001149,172.217.194.0-255,1484,72609,33,182950
2766,0.001155,172.217.194.0-255,2902,75511,33,182950
2767,0.001157,172.31.33.0-255,66,75577,33,182950
2768,0.001162,172.217.194.0-255,2902,78479,33,182950
2769,0.001164,172.31.33.0-255,66,78545,33,182950
2770,0.001183,172.217.194.0-255,2902,81447,33,182950
2771,0.001185,172.31.33.0-255,66,81513,33,182950
2772,0.001195,172.217.194.0-255,5738,87251,33,182950
2773,0.001197,172.31.33.0-255,66,87317,33,182950
2774,0.001227,172.217.194.0-255,7156,94473,33,182950
2775,0.001229,172.31.33.0-255,66,94539,33,182950
2776,0.001239,172.31.33.0-255,66,94605,33,182950
2777,0.00126,172.217.194.0-255,2184,96789,33,182950
2778,0.001262,172.31.33.0-255,66,96855,33,182950
2779,0.001311,172.217.194.0-255,1484,98339,33,182950
2780,0.001316,172.217.194.0-255,2902,101241,33,182950
2781,0.001319,172.31.33.0-255,66,101307,33,182950
2782,0.001347,172.217.194.0-255,5738,107045,33,182950
2783,0.00135,172.31.33.0-255,66,107111,33,182950
2784,0.001355,172.217.194.0-255,4320,111431,33,182950
2785,0.001357,172.31.33.0-255,66,111497,33,182950
2786,0.001381,172.217.194.0-255,1484,112981,33,182950
2787,0.001395,172.31.33.0-255,66,113047,33,182950
2788,0.001429,172.217.194.0-255,5020,118067,33,182950
2789,0.001434,172.31.33.0-255,66,118133,33,182950
2790,0.001729,172.217.194.0-255,1484,119617,33,182950
2791,0.001746,172.217.194.0-255,2902,122519,33,182950
2792,0.001749,172.31.33.0-255,66,122585,33,182950
2793,0.001754,172.217.194.0-255,2902,125487,33,182950
2794,0.001757,172.31.33.0-255,66,125553,33,182950
2795,0.001781,172.217.194.0-255,2902,128455,33,182950
2796,0.001789,172.217.194.0-255,4320,132775,33,182950
2797,0.001804,172.31.33.0-255,66,132841,33,182950
2798,0.001838,172.31.33.0-255,66,132907,33,182950
2799,0.001841,172.31.33.0-255,66,132973,33,182950
2800,0.001859,172.31.33.0-255,66,133039,33,182950
2801,0.001909,172.217.194.0-255,1484,134523,33,182950
2802,0.001915,172.217.194.0-255,2902,137425,33,182950
2803,0.001918,172.31.33.0-255,66,137491,33,182950
2804,0.001949,172.217.194.0-255,5738,143229,33,182950
2805,0.001954,172.31.33.0-255,66,143295,33,182950
2806,0.001963,172.217.194.0-255,2902,146197,33,182950
2807,0.001966,172.31.33.0-255,66,146263,33,182950
2808,0.002013,172.31.33.0-255,66,146329,33,182950
2809,0.002017,172.217.194.0-255,2902,149231,33,182950
2810,0.00202,172.31.33.0-255,66,149297,33,182950
2811,0.002074,172.217.194.0-255,1484,150781,33,182950
2812,0.002079,172.31.33.0-255,66,150847,33,182950
2813,0.002087,172.31.33.0-255,66,150913,33,182950
2814,0.002099,172.217.194.0-255,5738,156651,33,182950
2815,0.002101,172.31.33.0-255,66,156717,33,182950
2816,0.002134,172.31.33.0-255,66,156783,33,182950
2817,0.002211,172.31.33.0-255,66,156849,33,182950
2818,0.002219,172.217.194.0-255,5738,162587,33,182950
2819,0.002221,172.31.33.0-255,66,162653,33,182950
2820,0.002237,172.31.33.0-255,66,162719,33,182950
2821,0.002269,172.217.194.0-255,5020,167739,33,182950
2822,0.002297,172.31.33.0-255,66,167805,33,182950
2823,0.002302,172.31.33.0-255,66,167871,33,182950
2824,0.002315,172.31.33.0-255,66,167937,33,182950
2825,0.002346,172.31.33.0-255,66,168003,33,182950
2826,0.002383,172.31.33.0-255,66,168069,33,182950
2827,0.002397,172.31.33.0-255,66,168135,33,182950
2828,0.002429,172.217.194.0-255,6438,174573,33,182950
2829,0.002432,172.31.33.0-255,66,174639,33,182950
2830,0.002453,172.31.33.0-255,66,174705,33,182950
2831,0.002486,172.31.33.0-255,66,174771,33,182950
2832,0.002502,172.217.194.0-255,2512,177283,33,182950
2833,0.002505,172.31.33.0-255,66,177349,33,182950
2834,0.004904,172.217.194.0-255,105,177454,33,182950
2835,0.009155,172.31.33.0-255,66,177520,33,182950
2836,0.009194,172.31.33.0-255,105,177625,33,182950
2837,0.011635,172.217.194.0-255,66,177691,33,182950
2838,0.034416,172.31.33.0-255,172,177863,33,182950
2839,0.034445,172.31.33.0-255,1117,178980,33,182950
2840,0.034495,172.31.33.0-255,1514,180494,33,182950
2841,0.034514,172.31.33.0-255,1514,182008,33,182950
2842,0.034515,172.31.33.0-255,678,182686,33,182950
2843,0.036026,104.244.42.0-255,66,182752,33,182950
2844,0.036039,104.244.42.0-255,66,182818,33,182950
2845,0.036123,104.244.42.0-255,66,182884,33,182950
2846,0.03614,104.244.42.0-255,66,182950,33,182950
2847,0.0,216.58.203.0-255,153,153,33,383726
2848,2.2e-05,172.31.33.0-255,66,219,33,383726
2849,4.1e-05,216.58.203.0-255,1484,1703,33,383726
2850,4.5e-05,172.31.33.0-255,66,1769,33,383726
2851,5e-05,216.58.203.0-255,2902,4671,33,383726
2852,5.3e-05,172.31.33.0-255,66,4737,33,383726
2853,8.2e-05,216.58.203.0-255,7156,11893,33,383726
2854,8.5e-05,172.31.33.0-255,66,11959,33,383726
2855,8.9e-05,216.58.203.0-255,2057,14016,33,383726
2856,9e-05,172.31.33.0-255,66,14082,33,383726
2857,0.000236,216.58.203.0-255,1484,15566,33,383726
2858,0.000241,172.31.33.0-255,66,15632,33,383726
2859,0.000247,216.58.203.0-255,2902,18534,33,383726
2860,0.000249,172.31.33.0-255,66,18600,33,383726
2861,0.000263,216.58.203.0-255,2902,21502,33,383726
2862,0.000265,172.31.33.0-255,66,21568,33,383726
2863,0.000276,216.58.203.0-255,1484,23052,33,383726
2864,0.000278,172.31.33.0-255,66,23118,33,383726
2865,0.00029,216.58.203.0-255,2902,26020,33,383726
2866,0.000292,172.31.33.0-255,66,26086,33,383726
2867,0.000336,216.58.203.0-255,5379,31465,33,383726
2868,0.000339,172.31.33.0-255,66,31531,33,383726
2869,0.000369,216.58.203.0-255,4320,35851,33,383726
2870,0.000371,172.31.33.0-255,66,35917,33,383726
2871,0.00039,216.58.203.0-255,1484,37401,33,383726
2872,0.000392,172.31.33.0-255,66,37467,33,383726
2873,0.000399,216.58.203.0-255,5738,43205,33,383726
2874,0.0004,172.31.33.0-255,66,43271,33,383726
2875,0.000429,216.58.203.0-255,1484,44755,33,383726
2876,0.000431,172.31.33.0-255,66,44821,33,383726
2877,0.000453,216.58.203.0-255,3961,48782,33,383726
2878,0.000456,172.31.33.0-255,66,48848,33,383726
2879,0.000498,216.58.203.0-255,5738,54586,33,383726
2880,0.000501,172.31.33.0-255,66,54652,33,383726
2881,0.000512,216.58.203.0-255,1484,56136,33,383726
2882,0.000531,216.58.203.0-255,5738,61874,33,383726
2883,0.000533,172.31.33.0-255,66,61940,33,383726
2884,0.000567,216.58.203.0-255,4227,66167,33,383726
2885,0.000569,172.31.33.0-255,66,66233,33,383726
2886,0.000868,216.58.203.0-255,140,66373,33,383726
2887,0.000992,172.31.33.0-255,66,66439,33,383726
2888,0.001002,216.58.203.0-255,1484,67923,33,383726
2889,0.001006,216.58.203.0-255,1484,69407,33,383726
2890,0.001007,172.31.33.0-255,66,69473,33,383726
2891,0.001033,216.58.203.0-255,1484,70957,33,383726
2892,0.00104,216.58.203.0-255,5738,76695,33,383726
2893,0.001042,172.31.33.0-255,66,76761,33,383726
2894,0.001045,216.58.203.0-255,1484,78245,33,383726
2895,0.001063,216.58.203.0-255,5379,83624,33,383726
2896,0.001065,172.31.33.0-255,66,83690,33,383726
2897,0.001101,216.58.203.0-255,5738,89428,33,383726
2898,0.001105,172.31.33.0-255,66,89494,33,383726
2899,0.001131,172.31.33.0-255,66,89560,33,383726
2900,0.001134,216.58.203.0-255,1484,91044,33,383726
2901,0.001136,216.58.203.0-255,1125,92169,33,383726
2902,0.001138,172.31.33.0-255,66,92235,33,383726
2903,0.001188,216.58.203.0-255,1484,93719,33,383726
2904,0.00122,216.58.203.0-255,1484,95203,33,383726
2905,0.001223,172.31.33.0-255,66,95269,33,383726
2906,0.001235,216.58.203.0-255,1484,96753,33,383726
2907,0.001247,216.58.203.0-255,2902,99655,33,383726
2908,0.001249,172.31.33.0-255,66,99721,33,383726
2909,0.001254,216.58.203.0-255,4320,104041,33,383726
2910,0.001256,172.31.33.0-255,66,104107,33,383726
2911,0.001269,216.58.203.0-255,1484,105591,33,383726
2912,0.00128,216.58.203.0-255,1484,107075,33,383726
2913,0.001282,172.31.33.0-255,66,107141,33,383726
2914,0.001311,172.31.33.0-255,66,107207,33,383726
2915,0.001353,172.31.33.0-255,66,107273,33,383726
2916,0.001462,216.58.203.0-255,1484,108757,33,383726
2917,0.001492,216.58.203.0-255,1484,110241,33,383726
2918,0.001495,172.31.33.0-255,66,110307,33,383726
2919,0.001509,216.58.203.0-255,2902,113209,33,383726
2920,0.001511,172.31.33.0-255,66,113275,33,383726
2921,0.001534,216.58.203.0-255,2902,116177,33,383726
2922,0.001537,172.31.33.0-255,66,116243,33,383726
2923,0.001539,216.58.203.0-255,1484,117727,33,383726
2924,0.001555,216.58.203.0-255,2902,120629,33,383726
2925,0.001557,172.31.33.0-255,66,120695,33,383726
2926,0.001572,216.58.203.0-255,1484,122179,33,383726
2927,0.001592,216.58.203.0-255,7156,129335,33,383726
2928,0.001594,172.31.33.0-255,66,129401,33,383726
2929,0.001597,216.58.203.0-255,1484,130885,33,383726
2930,0.001613,216.58.203.0-255,4320,135205,33,383726
2931,0.001615,172.31.33.0-255,66,135271,33,383726
2932,0.001636,216.58.203.0-255,5738,141009,33,383726
2933,0.001639,172.31.33.0-255,66,141075,33,383726
2934,0.001656,216.58.203.0-255,766,141841,33,383726
2935,0.001706,216.58.203.0-255,1484,143325,33,383726
2936,0.001709,172.31.33.0-255,66,143391,33,383726
2937,0.001714,216.58.203.0-255,2902,146293,33,383726
2938,0.001715,172.31.33.0-255,66,146359,33,383726
2939,0.00172,216.58.203.0-255,2902,149261,33,383726
2940,0.001722,172.31.33.0-255,66,149327,33,383726
2941,0.001737,216.58.203.0-255,2902,152229,33,383726
2942,0.001739,172.31.33.0-255,66,152295,33,383726
2943,0.001744,216.58.203.0-255,4320,156615,33,383726
2944,0.001746,172.31.33.0-255,66,156681,33,383726
2945,0.003458,216.58.203.0-255,4320,161001,33,383726
2946,0.003464,172.31.33.0-255,66,161067,33,383726
2947,0.003483,216.58.203.0-255,1484,162551,33,383726
2948,0.005189,216.58.203.0-255,4320,166871,33,383726
2949,0.005194,172.31.33.0-255,66,166937,33,383726
2950,0.00693,216.58.203.0-255,5738,172675,33,383726
2951,0.006935,172.31.33.0-255,66,172741,33,383726
2952,0.008665,216.58.203.0-255,5738,178479,33,383726
2953,0.008672,172.31.33.0-255,66,178545,33,383726
2954,0.010403,216.58.203.0-255,5738,184283,33,383726
2955,0.010408,172.31.33.0-255,66,184349,33,383726
2956,0.012144,216.58.203.0-255,4320,188669,33,383726
2957,0.012149,172.31.33.0-255,66,188735,33,383726
2958,0.01217,216.58.203.0-255,1484,190219,33,383726
2959,0.013897,216.58.203.0-255,4320,194539,33,383726
2960,0.013905,172.31.33.0-255,66,194605,33,383726
2961,0.01567,216.58.203.0-255,5738,200343,33,383726
2962,0.015685,172.31.33.0-255,66,200409,33,383726
2963,0.017431,216.58.203.0-255,5738,206147,33,383726
2964,0.017439,172.31.33.0-255,66,206213,33,383726
2965,0.019163,216.58.203.0-255,5738,211951,33,383726
2966,0.01917,172.31.33.0-255,66,212017,33,383726
2967,0.020909,216.58.203.0-255,5738,217755,33,383726
2968,0.020915,172.31.33.0-255,66,217821,33,383726
2969,0.02269,216.58.203.0-255,5738,223559,33,383726
2970,0.022697,172.31.33.0-255,66,223625,33,383726
2971,0.024435,216.58.203.0-255,5738,229363,33,383726
2972,0.024441,172.31.33.0-255,66,229429,33,383726
2973,0.02617,216.58.203.0-255,5738,235167,33,383726
2974,0.026176,172.31.33.0-255,66,235233,33,383726
2975,0.0279,216.58.203.0-255,5738,240971,33,383726
2976,0.027906,172.31.33.0-255,66,241037,33,383726
2977,0.029628,216.58.203.0-255,4320,245357,33,383726
2978,0.029634,172.31.33.0-255,66,245423,33,383726
2979,0.029655,216.58.203.0-255,1484,246907,33,383726
2980,0.031021,172.31.33.0-255,192,247099,33,383726
2981,0.031047,172.31.33.0-255,1117,248216,33,383726
2982,0.031078,172.31.33.0-255,1514,249730,33,383726
2983,0.031079,172.31.33.0-255,1514,251244,33,383726
2984,0.03108,172.31.33.0-255,676,251920,33,383726
2985,0.031358,216.58.203.0-255,4320,256240,33,383726
2986,0.031363,172.31.33.0-255,66,256306,33,383726
2987,0.03276,104.244.42.0-255,66,256372,33,383726
2988,0.032768,104.244.42.0-255,66,256438,33,383726
2989,0.032801,104.244.42.0-255,66,256504,33,383726
2990,0.032804,104.244.42.0-255,66,256570,33,383726
2991,0.033084,216.58.203.0-255,4320,260890,33,383726
2992,0.033088,172.31.33.0-255,66,260956,33,383726
2993,0.033115,216.58.203.0-255,1484,262440,33,383726
2994,0.03483,216.58.203.0-255,4320,266760,33,383726
2995,0.034835,172.31.33.0-255,66,266826,33,383726
2996,0.03656,216.58.203.0-255,5738,272564,33,383726
2997,0.036568,172.31.33.0-255,66,272630,33,383726
2998,0.0383,216.58.203.0-255,5738,278368,33,383726
2999,0.038306,172.31.33.0-255,66,278434,33,383726
3000,0.040033,216.58.203.0-255,5738,284172,33,383726
3001,0.040039,172.31.33.0-255,66,284238,33,383726
3002,0.041764,216.58.203.0-255,5738,289976,33,383726
3003,0.04177,172.31.33.0-255,66,290042,33,383726
3004,0.043497,216.58.203.0-255,4320,294362,33,383726
3005,0.043501,172.31.33.0-255,66,294428,33,383726
3006,0.043528,216.58.203.0-255,1484,295912,33,383726
3007,0.04522,216.58.203.0-255,4320,300232,33,383726
3008,0.045224,172.31.33.0-255,66,300298,33,383726
3009,0.046948,216.58.203.0-255,4320,304618,33,383726
3010,0.046952,172.31.33.0-255,66,304684,33,383726
3011,0.046978,216.58.203.0-255,1484,306168,33,383726
3012,0.04868,216.58.203.0-255,4320,310488,33,383726
3013,0.048685,172.31.33.0-255,66,310554,33,383726
3014,0.050409,216.58.203.0-255,5738,316292,33,383726
3015,0.050413,172.31.33.0-255,66,316358,33,383726
3016,0.05213,216.58.203.0-255,4320,320678,33,383726
3017,0.052135,172.31.33.0-255,66,320744,33,383726
3018,0.052159,216.58.203.0-255,1484,322228,33,383726
3019,0.053856,216.58.203.0-255,4320,326548,33,383726
3020,0.053861,172.31.33.0-255,66,326614,33,383726
3021,0.055618,216.58.203.0-255,4320,330934,33,383726
3022,0.055623,172.31.33.0-255,66,331000,33,383726
3023,0.05564,216.58.203.0-255,1484,332484,33,383726
3024,0.057371,216.58.203.0-255,4320,336804,33,383726
3025,0.057378,172.31.33.0-255,66,336870,33,383726
3026,0.059108,216.58.203.0-255,5738,342608,33,383726
3027,0.059114,172.31.33.0-255,66,342674,33,383726
3028,0.060839,216.58.203.0-255,5738,348412,33,383726
3029,0.060845,172.31.33.0-255,66,348478,33,383726
3030,0.062564,216.58.203.0-255,5738,354216,33,383726
3031,0.062569,172.31.33.0-255,66,354282,33,383726
3032,0.064322,216.58.203.0-255,2902,357184,33,383726
3033,0.064327,172.31.33.0-255,66,357250,33,383726
3034,0.064348,216.58.203.0-255,2902,360152,33,383726
3035,0.06435,172.31.33.0-255,66,360218,33,383726
3036,0.066058,216.58.203.0-255,2902,363120,33,383726
3037,0.066062,172.31.33.0-255,66,363186,33,383726
3038,0.066087,216.58.203.0-255,2902,366088,33,383726
3039,0.06609,172.31.33.0-255,66,366154,33,383726
3040,0.067797,216.58.203.0-255,4320,370474,33,383726
3041,0.067802,172.31.33.0-255,66,370540,33,383726
3042,0.067829,216.58.203.0-255,1484,372024,33,383726
3043,0.069533,216.58.203.0-255,4320,376344,33,383726
3044,0.069539,172.31.33.0-255,66,376410,33,383726
3045,0.07127,216.58.203.0-255,5738,382148,33,383726
3046,0.071275,172.31.33.0-255,66,382214,33,383726
3047,0.072989,216.58.203.0-255,1275,383489,33,383726
3048,0.073105,172.31.33.0-255,66,383555,33,383726
3049,0.073126,172.31.33.0-255,105,383660,33,383726
3050,0.074811,216.58.203.0-255,66,383726,33,383726
3051,0.0,74.125.24.0-255,292,292,33,275291
3052,2.3e-05,172.31.33.0-255,66,358,33,275291
3053,2.7e-05,74.125.24.0-255,1484,1842,33,275291
3054,3.1e-05,172.31.33.0-255,66,1908,33,275291
3055,3.6e-05,74.125.24.0-255,4320,6228,33,275291
3056,3.9e-05,172.31.33.0-255,66,6294,33,275291
3057,8.3e-05,74.125.24.0-255,2902,9196,33,275291
3058,8.5e-05,172.31.33.0-255,66,9262,33,275291
3059,0.000105,74.125.24.0-255,4792,14054,33,275291
3060,0.000108,172.31.33.0-255,66,14120,33,275291
3061,0.000328,74.125.24.0-255,1484,15604,33,275291
3062,0.000332,172.31.33.0-255,66,15670,33,275291
3063,0.000336,74.125.24.0-255,1484,17154,33,275291
3064,0.000338,172.31.33.0-255,66,17220,33,275291
3065,0.000352,74.125.24.0-255,1484,18704,33,275291
3066,0.000354,172.31.33.0-255,66,18770,33,275291
3067,0.000366,74.125.24.0-255,4320,23090,33,275291
3068,0.000369,172.31.33.0-255,66,23156,33,275291
3069,0.000387,74.125.24.0-255,1484,24640,33,275291
3070,0.000389,172.31.33.0-255,66,24706,33,275291
3071,0.000394,74.125.24.0-255,2902,27608,33,275291
3072,0.000395,172.31.33.0-255,66,27674,33,275291
3073,0.000411,74.125.24.0-255,3961,31635,33,275291
3074,0.000413,172.31.33.0-255,66,31701,33,275291
3075,0.000495,74.125.24.0-255,1484,33185,33,275291
3076,0.000498,172.31.33.0-255,66,33251,33,275291
3077,0.000512,74.125.24.0-255,2902,36153,33,275291
3078,0.000514,172.31.33.0-255,66,36219,33,275291
3079,0.000529,74.125.24.0-255,2902,39121,33,275291
3080,0.000533,172.31.33.0-255,66,39187,33,275291
3081,0.000542,74.125.24.0-255,2902,42089,33,275291
3082,0.000545,172.31.33.0-255,66,42155,33,275291
3083,0.000549,74.125.24.0-255,4320,46475,33,275291
3084,0.000551,172.31.33.0-255,66,46541,33,275291
3085,0.000599,74.125.24.0-255,5738,52279,33,275291
3086,0.000602,172.31.33.0-255,66,52345,33,275291
3087,0.000621,74.125.24.0-255,6797,59142,33,275291
3088,0.000624,172.31.33.0-255,66,59208,33,275291
3089,0.000658,74.125.24.0-255,6797,66005,33,275291
3090,0.00066,74.125.24.0-255,412,66417,33,275291
3091,0.000663,172.31.33.0-255,66,66483,33,275291
3092,0.000741,172.31.33.0-255,66,66549,33,275291
3093,0.000748,74.125.24.0-255,330,66879,33,275291
3094,0.000754,172.31.33.0-255,66,66945,33,275291
3095,0.001219,74.125.24.0-255,1484,68429,33,275291
3096,0.00123,74.125.24.0-255,2902,71331,33,275291
3097,0.001234,172.31.33.0-255,66,71397,33,275291
3098,0.001242,74.125.24.0-255,5738,77135,33,275291
3099,0.001244,172.31.33.0-255,66,77201,33,275291
3100,0.001277,74.125.24.0-255,7156,84357,33,275291
3101,0.00128,172.31.33.0-255,66,84423,33,275291
3102,0.001292,172.31.33.0-255,66,84489,33,275291
3103,0.001311,74.125.24.0-255,2902,87391,33,275291
3104,0.001313,172.31.33.0-255,66,87457,33,275291
3105,0.001316,74.125.24.0-255,2184,89641,33,275291
3106,0.001318,172.31.33.0-255,66,89707,33,275291
3107,0.003686,74.125.24.0-255,2902,92609,33,275291
3108,0.00369,172.31.33.0-255,66,92675,33,275291
3109,0.003708,74.125.24.0-255,2902,95577,33,275291
3110,0.00371,172.31.33.0-255,66,95643,33,275291
3111,0.006054,74.125.24.0-255,5738,101381,33,275291
3112,0.006059,172.31.33.0-255,66,101447,33,275291
3113,0.008455,74.125.24.0-255,4320,105767,33,275291
3114,0.008462,172.31.33.0-255,66,105833,33,275291
3115,0.00848,74.125.24.0-255,1484,107317,33,275291
3116,0.010855,74.125.24.0-255,4320,111637,33,275291
3117,0.010863,172.31.33.0-255,66,111703,33,275291
3118,0.013246,74.125.24.0-255,5738,117441,33,275291
3119,0.013254,172.31.33.0-255,66,117507,33,275291
3120,0.015617,74.125.24.0-255,5738,123245,33,275291
3121,0.015623,172.31.33.0-255,66,123311,33,275291
3122,0.018009,74.125.24.0-255,4320,127631,33,275291
3123,0.018015,172.31.33.0-255,66,127697,33,275291
3124,0.018031,74.125.24.0-255,1484,129181,33,275291
3125,0.020377,74.125.24.0-255,4320,133501,33,275291
3126,0.020383,172.31.33.0-255,66,133567,33,275291
3127,0.021509,172.31.33.0-255,176,133743,33,275291
3128,0.021549,172.31.33.0-255,1113,134856,33,275291
3129,0.021627,172.31.33.0-255,1514,136370,33,275291
3130,0.021629,172.31.33.0-255,1514,137884,33,275291
3131,0.02163,172.31.33.0-255,680,138564,33,275291
3132,0.022773,74.125.24.0-255,5738,144302,33,275291
3133,0.022778,172.31.33.0-255,66,144368,33,275291
3134,0.02305,104.244.42.0-255,66,144434,33,275291
3135,0.02309,104.244.42.0-255,66,144500,33,275291
3136,0.023181,104.244.42.0-255,66,144566,33,275291
3137,0.023185,104.244.42.0-255,66,144632,33,275291
3138,0.025144,74.125.24.0-255,2902,147534,33,275291
3139,0.025149,172.31.33.0-255,66,147600,33,275291
3140,0.025181,74.125.24.0-255,2902,150502,33,275291
3141,0.025183,172.31.33.0-255,66,150568,33,275291
3142,0.025505,172.31.33.0-255,101,150669,33,275291
3143,0.027492,74.125.24.0-255,2902,153571,33,275291
3144,0.027496,172.31.33.0-255,66,153637,33,275291
3145,0.027544,74.125.24.0-255,2902,156539,33,275291
3146,0.027547,172.31.33.0-255,66,156605,33,275291
3147,0.027845,74.125.24.0-255,66,156671,33,275291
3148,0.029865,74.125.24.0-255,2902,159573,33,275291
3149,0.029869,172.31.33.0-255,66,159639,33,275291
3150,0.029911,74.125.24.0-255,2902,162541,33,275291
3151,0.029915,172.31.33.0-255,66,162607,33,275291
3152,0.032237,74.125.24.0-255,2902,165509,33,275291
3153,0.032241,172.31.33.0-255,66,165575,33,275291
3154,0.032292,74.125.24.0-255,2902,168477,33,275291
3155,0.032295,172.31.33.0-255,66,168543,33,275291
3156,0.03459,74.125.24.0-255,2902,171445,33,275291
3157,0.034594,172.31.33.0-255,66,171511,33,275291
3158,0.034634,74.125.24.0-255,2902,174413,33,275291
3159,0.034637,172.31.33.0-255,66,174479,33,275291
3160,0.036983,74.125.24.0-255,5738,180217,33,275291
3161,0.036989,172.31.33.0-255,66,180283,33,275291
3162,0.039378,74.125.24.0-255,4320,184603,33,275291
3163,0.039383,172.31.33.0-255,66,184669,33,275291
3164,0.039407,74.125.24.0-255,1484,186153,33,275291
3165,0.041743,74.125.24.0-255,4320,190473,33,275291
3166,0.041747,172.31.33.0-255,66,190539,33,275291
3167,0.044134,74.125.24.0-255,5738,196277,33,275291
3168,0.044138,172.31.33.0-255,66,196343,33,275291
3169,0.046517,74.125.24.0-255,1484,197827,33,275291
3170,0.04668,74.125.24.0-255,4320,202147,33,275291
3171,0.046685,172.31.33.0-255,66,202213,33,275291
3172,0.049042,74.125.24.0-255,5738,207951,33,275291
3173,0.049046,172.31.33.0-255,66,208017,33,275291
3174,0.051428,74.125.24.0-255,5738,213755,33,275291
3175,0.051433,172.31.33.0-255,66,213821,33,275291
3176,0.05383,74.125.24.0-255,5738,219559,33,275291
3177,0.053835,172.31.33.0-255,66,219625,33,275291
3178,0.056201,74.125.24.0-255,4320,223945,33,275291
3179,0.056206,172.31.33.0-255,66,224011,33,275291
3180,0.056231,74.125.24.0-255,1484,225495,33,275291
3181,0.058561,74.125.24.0-255,4320,229815,33,275291
3182,0.058565,172.31.33.0-255,66,229881,33,275291
3183,0.060974,74.125.24.0-255,5738,235619,33,275291
3184,0.060978,172.31.33.0-255,66,235685,33,275291
3185,0.063355,74.125.24.0-255,5738,241423,33,275291
3186,0.06336,172.31.33.0-255,66,241489,33,275291
3187,0.065688,74.125.24.0-255,5738,247227,33,275291
3188,0.065692,172.31.33.0-255,66,247293,33,275291
3189,0.068067,74.125.24.0-255,4320,251613,33,275291
3190,0.068073,172.31.33.0-255,66,251679,33,275291
3191,0.068104,74.125.24.0-255,1484,253163,33,275291
3192,0.070472,74.125.24.0-255,4320,257483,33,275291
3193,0.070476,172.31.33.0-255,66,257549,33,275291
3194,0.072856,74.125.24.0-255,1484,259033,33,275291
3195,0.072884,74.125.24.0-255,4320,263353,33,275291
3196,0.072888,172.31.33.0-255,66,263419,33,275291
3197,0.075271,74.125.24.0-255,2902,266321,33,275291
3198,0.075276,172.31.33.0-255,66,266387,33,275291
3199,0.075293,74.125.24.0-255,2902,269289,33,275291
3200,0.075295,172.31.33.0-255,66,269355,33,275291
3201,0.077636,74.125.24.0-255,2902,272257,33,275291
3202,0.077642,172.31.33.0-255,66,272323,33,275291
3203,0.077662,74.125.24.0-255,2902,275225,33,275291
3204,0.077664,172.31.33.0-255,66,275291,33,275291
3205,0.0,74.125.68.0-255,153,153,33,375645
3206,1.1e-05,172.31.33.0-255,66,219,33,375645
3207,3.4e-05,74.125.68.0-255,1484,1703,33,375645
3208,3.8e-05,172.31.33.0-255,66,1769,33,375645
3209,4.1e-05,74.125.68.0-255,1484,3253,33,375645
3210,4.4e-05,172.31.33.0-255,66,3319,33,375645
3211,5.7e-05,74.125.68.0-255,1484,4803,33,375645
3212,6e-05,172.31.33.0-255,66,4869,33,375645
3213,6.3e-05,74.125.68.0-255,1484,6353,33,375645
3214,6.5e-05,172.31.33.0-255,66,6419,33,375645
3215,7.2e-05,74.125.68.0-255,2902,9321,33,375645
3216,7.5e-05,172.31.33.0-255,66,9387,33,375645
3217,0.000107,74.125.68.0-255,2902,12289,33,375645
3218,0.00011,172.31.33.0-255,66,12355,33,375645
3219,0.000128,74.125.68.0-255,1958,14313,33,375645
3220,0.000131,172.31.33.0-255,66,14379,33,375645
3221,0.000193,74.125.68.0-255,1484,15863,33,375645
3222,0.000196,172.31.33.0-255,66,15929,33,375645
3223,0.000199,74.125.68.0-255,1484,17413,33,375645
3224,0.000201,172.31.33.0-255,66,17479,33,375645
3225,0.000216,74.125.68.0-255,1484,18963,33,375645
3226,0.000219,172.31.33.0-255,66,19029,33,375645
3227,0.000225,74.125.68.0-255,4320,23349,33,375645
3228,0.000227,172.31.33.0-255,66,23415,33,375645
3229,0.00026,74.125.68.0-255,2902,26317,33,375645
3230,0.000263,172.31.33.0-255,66,26383,33,375645
3231,0.000285,74.125.68.0-255,5379,31762,33,375645
3232,0.000288,172.31.33.0-255,66,31828,33,375645
3233,0.000299,172.31.33.0-255,66,31894,33,375645
3234,0.000302,74.125.68.0-255,1484,33378,33,375645
3235,0.000304,172.31.33.0-255,66,33444,33,375645
3236,0.00033,74.125.68.0-255,6797,40241,33,375645
3237,0.000332,172.31.33.0-255,66,40307,33,375645
3238,0.000515,74.125.68.0-255,1484,41791,33,375645
3239,0.000522,74.125.68.0-255,2902,44693,33,375645
3240,0.000526,172.31.33.0-255,66,44759,33,375645
3241,0.000554,74.125.68.0-255,5738,50497,33,375645
3242,0.000557,172.31.33.0-255,66,50563,33,375645
3243,0.000563,74.125.68.0-255,4320,54883,33,375645
3244,0.000565,172.31.33.0-255,66,54949,33,375645
3245,0.00062,74.125.68.0-255,3123,58072,33,375645
3246,0.000624,172.31.33.0-255,66,58138,33,375645
3247,0.000676,74.125.68.0-255,1484,59622,33,375645
3248,0.00068,74.125.68.0-255,1484,61106,33,375645
3249,0.000682,172.31.33.0-255,66,61172,33,375645
3250,0.000698,74.125.68.0-255,1484,62656,33,375645
3251,0.000721,74.125.68.0-255,5738,68394,33,375645
3252,0.000724,172.31.33.0-255,66,68460,33,375645
3253,0.000753,74.125.68.0-255,6797,75257,33,375645
3254,0.000755,172.31.33.0-255,66,75323,33,375645
3255,0.000766,74.125.68.0-255,2902,78225,33,375645
3256,0.000768,172.31.33.0-255,66,78291,33,375645
3257,0.000791,74.125.68.0-255,7156,85447,33,375645
3258,0.000793,172.31.33.0-255,66,85513,33,375645
3259,0.000808,74.125.68.0-255,1484,86997,33,375645
3260,0.00083,74.125.68.0-255,5379,92376,33,375645
3261,0.000833,172.31.33.0-255,66,92442,33,375645
3262,0.001445,74.125.68.0-255,1484,93926,33,375645
3263,0.001452,74.125.68.0-255,2902,96828,33,375645
3264,0.001456,172.31.33.0-255,66,96894,33,375645
3265,0.001475,74.125.68.0-255,2902,99796,33,375645
3266,0.001477,172.31.33.0-255,66,99862,33,375645
3267,0.001482,74.125.68.0-255,4320,104182,33,375645
3268,0.001484,172.31.33.0-255,66,104248,33,375645
3269,0.001522,74.125.68.0-255,4320,108568,33,375645
3270,0.001524,172.31.33.0-255,66,108634,33,375645
3271,0.001537,74.125.68.0-255,458,109092,33,375645
3272,0.00178,74.125.68.0-255,1484,110576,33,375645
3273,0.001783,172.31.33.0-255,66,110642,33,375645
3274,0.001799,74.125.68.0-255,1484,112126,33,375645
3275,0.001809,74.125.68.0-255,1484,113610,33,375645
3276,0.001811,172.31.33.0-255,66,113676,33,375645
3277,0.001822,74.125.68.0-255,1484,115160,33,375645
3278,0.001828,74.125.68.0-255,5738,120898,33,375645
3279,0.00183,172.31.33.0-255,66,120964,33,375645
3280,0.001868,74.125.68.0-255,6077,127041,33,375645
3281,0.00187,172.31.33.0-255,66,127107,33,375645
3282,0.001985,74.125.68.0-255,1484,128591,33,375645
3283,0.001989,74.125.68.0-255,2902,131493,33,375645
3284,0.001991,172.31.33.0-255,66,131559,33,375645
3285,0.002004,74.125.68.0-255,2902,134461,33,375645
3286,0.002006,172.31.33.0-255,66,134527,33,375645
3287,0.002011,74.125.68.0-255,4320,138847,33,375645
3288,0.002012,172.31.33.0-255,66,138913,33,375645
3289,0.002034,74.125.68.0-255,4320,143233,33,375645
3290,0.002036,172.31.33.0-255,66,143299,33,375645
3291,0.002049,74.125.68.0-255,4320,147619,33,375645
3292,0.002051,172.31.33.0-255,66,147685,33,375645
3293,0.002055,74.125.68.0-255,2902,150587,33,375645
3294,0.002056,172.31.33.0-255,66,150653,33,375645
3295,0.00206,74.125.68.0-255,1484,152137,33,375645
3296,0.002078,74.125.68.0-255,2902,155039,33,375645
3297,0.00208,172.31.33.0-255,66,155105,33,375645
3298,0.002108,74.125.68.0-255,5738,160843,33,375645
3299,0.00211,172.31.33.0-255,66,160909,33,375645
3300,0.002125,74.125.68.0-255,766,161675,33,375645
3301,0.002221,74.125.68.0-255,1484,163159,33,375645
3302,0.002223,172.31.33.0-255,66,163225,33,375645
3303,0.00224,74.125.68.0-255,2902,166127,33,375645
3304,0.002242,172.31.33.0-255,66,166193,33,375645
3305,0.00227,74.125.68.0-255,4320,170513,33,375645
3306,0.002272,172.31.33.0-255,66,170579,33,375645
3307,0.002277,74.125.68.0-255,5738,176317,33,375645
3308,0.00228,172.31.33.0-255,66,176383,33,375645
3309,0.002291,74.125.68.0-255,1484,177867,33,375645
3310,0.002317,172.31.33.0-255,66,177933,33,375645
3311,0.002322,74.125.68.0-255,4320,182253,33,375645
3312,0.002324,172.31.33.0-255,66,182319,33,375645
3313,0.002327,74.125.68.0-255,1484,183803,33,375645
3314,0.004639,74.125.68.0-255,4320,188123,33,375645
3315,0.004646,172.31.33.0-255,66,188189,33,375645
3316,0.006971,74.125.68.0-255,5738,193927,33,375645
3317,0.006978,172.31.33.0-255,66,193993,33,375645
3318,0.009286,74.125.68.0-255,5738,199731,33,375645
3319,0.009292,172.31.33.0-255,66,199797,33,375645
3320,0.011605,74.125.68.0-255,5738,205535,33,375645
3321,0.011608,172.31.33.0-255,66,205601,33,375645
3322,0.013916,74.125.68.0-255,5738,211339,33,375645
3323,0.013922,172.31.33.0-255,66,211405,33,375645
3324,0.016229,74.125.68.0-255,5738,217143,33,375645
3325,0.016235,172.31.33.0-255,66,217209,33,375645
3326,0.018553,74.125.68.0-255,5738,222947,33,375645
3327,0.018561,172.31.33.0-255,66,223013,33,375645
3328,0.020879,74.125.68.0-255,5738,228751,33,375645
3329,0.020885,172.31.33.0-255,66,228817,33,375645
3330,0.023193,74.125.68.0-255,5738,234555,33,375645
3331,0.023201,172.31.33.0-255,66,234621,33,375645
3332,0.025507,74.125.68.0-255,5738,240359,33,375645
3333,0.025512,172.31.33.0-255,66,240425,33,375645
3334,0.027854,74.125.68.0-255,5738,246163,33,375645
3335,0.02786,172.31.33.0-255,66,246229,33,375645
3336,0.029004,172.31.33.0-255,172,246401,33,375645
3337,0.029045,172.31.33.0-255,1113,247514,33,375645
3338,0.029094,172.31.33.0-255,1514,249028,33,375645
3339,0.029096,172.31.33.0-255,1171,250199,33,375645
3340,0.030173,74.125.68.0-255,5738,255937,33,375645
3341,0.030179,172.31.33.0-255,66,256003,33,375645
3342,0.030525,104.244.42.0-255,66,256069,33,375645
3343,0.030559,104.244.42.0-255,66,256135,33,375645
3344,0.030636,104.244.42.0-255,66,256201,33,375645
3345,0.03251,74.125.68.0-255,5738,261939,33,375645
3346,0.032517,172.31.33.0-255,66,262005,33,375645
3347,0.034834,74.125.68.0-255,5738,267743,33,375645
3348,0.03484,172.31.33.0-255,66,267809,33,375645
3349,0.037165,74.125.68.0-255,5738,273547,33,375645
3350,0.037173,172.31.33.0-255,66,273613,33,375645
3351,0.039498,74.125.68.0-255,5738,279351,33,375645
3352,0.039503,172.31.33.0-255,66,279417,33,375645
3353,0.04182,74.125.68.0-255,5738,285155,33,375645
3354,0.041828,172.31.33.0-255,66,285221,33,375645
3355,0.04414,74.125.68.0-255,5738,290959,33,375645
3356,0.044145,172.31.33.0-255,66,291025,33,375645
3357,0.046465,74.125.68.0-255,5738,296763,33,375645
3358,0.046473,172.31.33.0-255,66,296829,33,375645
3359,0.048789,74.125.68.0-255,5738,302567,33,375645
3360,0.048794,172.31.33.0-255,66,302633,33,375645
3361,0.051096,74.125.68.0-255,5738,308371,33,375645
3362,0.051102,172.31.33.0-255,66,308437,33,375645
3363,0.053422,74.125.68.0-255,5738,314175,33,375645
3364,0.053429,172.31.33.0-255,66,314241,33,375645
3365,0.055732,74.125.68.0-255,2902,317143,33,375645
3366,0.055738,172.31.33.0-255,66,317209,33,375645
3367,0.055756,74.125.68.0-255,2902,320111,33,375645
3368,0.055759,172.31.33.0-255,66,320177,33,375645
3369,0.058034,74.125.68.0-255,2902,323079,33,375645
3370,0.05804,172.31.33.0-255,66,323145,33,375645
3371,0.058059,74.125.68.0-255,2902,326047,33,375645
3372,0.058061,172.31.33.0-255,66,326113,33,375645
3373,0.060358,74.125.68.0-255,5738,331851,33,375645
3374,0.060363,172.31.33.0-255,66,331917,33,375645
3375,0.062681,74.125.68.0-255,5738,337655,33,375645
3376,0.062686,172.31.33.0-255,66,337721,33,375645
3377,0.065002,74.125.68.0-255,5738,343459,33,375645
3378,0.065008,172.31.33.0-255,66,343525,33,375645
3379,0.067321,74.125.68.0-255,5738,349263,33,375645
3380,0.067328,172.31.33.0-255,66,349329,33,375645
3381,0.069666,74.125.68.0-255,5738,355067,33,375645
3382,0.069674,172.31.33.0-255,66,355133,33,375645
3383,0.071987,74.125.68.0-255,4320,359453,33,375645
3384,0.071993,172.31.33.0-255,66,359519,33,375645
3385,0.072011,74.125.68.0-255,1484,361003,33,375645
3386,0.074296,74.125.68.0-255,4320,365323,33,375645
3387,0.074301,172.31.33.0-255,66,365389,33,375645
3388,0.076612,74.125.68.0-255,4320,369709,33,375645
3389,0.076618,172.31.33.0-255,66,369775,33,375645
3390,0.076638,74.125.68.0-255,1484,371259,33,375645
3391,0.078942,74.125.68.0-255,4320,375579,33,375645
3392,0.078949,172.31.33.0-255,66,375645,33,375645
3393,0.0,74.125.200.0-255,430,430,33,164086
3394,2.2e-05,74.125.200.0-255,1484,1914,33,164086
3395,2.8e-05,172.31.33.0-255,66,1980,33,164086
3396,3.6e-05,74.125.200.0-255,4320,6300,33,164086
3397,3.8e-05,172.31.33.0-255,66,6366,33,164086
3398,0.00022,74.125.200.0-255,5738,12104,33,164086
3399,0.000225,172.31.33.0-255,66,12170,33,164086
3400,0.000243,74.125.200.0-255,2017,14187,33,164086
3401,0.000245,172.31.33.0-255,66,14253,33,164086
3402,0.000543,74.125.200.0-255,5738,19991,33,164086
3403,0.000548,172.31.33.0-255,66,20057,33,164086
3404,0.000565,74.125.200.0-255,2902,22959,33,164086
3405,0.000569,172.31.33.0-255,66,23025,33,164086
3406,0.00091,74.125.200.0-255,7156,30181,33,164086
3407,0.000915,172.31.33.0-255,66,30247,33,164086
3408,0.002497,74.125.200.0-255,5738,35985,33,164086
3409,0.002689,74.125.200.0-255,5738,41723,33,164086
3410,0.002707,74.125.200.0-255,7156,48879,33,164086
3411,0.003132,172.31.33.0-255,66,48945,33,164086
3412,0.00317,74.125.200.0-255,2902,51847,33,164086
3413,0.003183,172.31.33.0-255,66,51913,33,164086
3414,0.003197,172.31.33.0-255,66,51979,33,164086
3415,0.003214,74.125.200.0-255,7156,59135,33,164086
3416,0.003221,172.31.33.0-255,66,59201,33,164086
3417,0.003988,172.31.33.0-255,66,59267,33,164086
3418,0.004205,172.31.33.0-255,66,59333,33,164086
3419,0.004684,74.125.200.0-255,2902,62235,33,164086
3420,0.004689,172.31.33.0-255,66,62301,33,164086
3421,0.004707,74.125.200.0-255,4320,66621,33,164086
3422,0.005617,74.125.200.0-255,7156,73777,33,164086
3423,0.005639,74.125.200.0-255,4320,78097,33,164086
3424,0.005749,74.125.200.0-255,7156,85253,33,164086
3425,0.006488,74.125.200.0-255,2902,88155,33,164086
3426,0.006559,74.125.200.0-255,5738,93893,33,164086
3427,0.006635,74.125.200.0-255,7156,101049,33,164086
3428,0.006999,74.125.200.0-255,5738,106787,33,164086
3429,0.009905,172.31.33.0-255,66,106853,33,164086
3430,0.012405,74.125.200.0-255,7156,114009,33,164086
3431,0.012414,172.31.33.0-255,66,114075,33,164086
3432,0.012445,172.31.33.0-255,66,114141,33,164086
3433,0.012523,74.125.200.0-255,2902,117043,33,164086
3434,0.012526,172.31.33.0-255,66,117109,33,164086
3435,0.012556,172.31.33.0-255,66,117175,33,164086
3436,0.012833,74.125.200.0-255,2902,120077,33,164086
3437,0.012836,172.31.33.0-255,66,120143,33,164086
3438,0.012884,172.31.33.0-255,66,120209,33,164086
3439,0.012904,172.31.33.0-255,66,120275,33,164086
3440,0.013385,74.125.200.0-255,4320,124595,33,164086
3441,0.01339,172.31.33.0-255,66,124661,33,164086
3442,0.013408,74.125.200.0-255,4320,128981,33,164086
3443,0.013411,172.31.33.0-255,66,129047,33,164086
3444,0.01345,172.31.33.0-255,66,129113,33,164086
3445,0.013467,74.125.200.0-255,4320,133433,33,164086
3446,0.01347,172.31.33.0-255,66,133499,33,164086
3447,0.013943,74.125.200.0-255,5738,139237,33,164086
3448,0.013948,172.31.33.0-255,66,139303,33,164086
3449,0.013962,74.125.200.0-255,1354,140657,33,164086
3450,0.014938,74.125.200.0-255,5738,146395,33,164086
3451,0.014943,172.31.33.0-255,66,146461,33,164086
3452,0.01498,172.31.33.0-255,66,146527,33,164086
3453,0.015141,74.125.200.0-255,7156,153683,33,164086
3454,0.015146,172.31.33.0-255,66,153749,33,164086
3455,0.015177,172.31.33.0-255,66,153815,33,164086
3456,0.015206,172.31.33.0-255,66,153881,33,164086
3457,0.01583,74.125.200.0-255,5738,159619,33,164086
3458,0.015834,172.31.33.0-255,66,159685,33,164086
3459,0.015872,172.31.33.0-255,66,159751,33,164086
3460,0.017144,172.31.33.0-255,105,159856,33,164086
3461,0.019574,74.125.200.0-255,66,159922,33,164086
3462,0.021865,172.31.33.0-255,167,160089,33,164086
3463,0.021893,172.31.33.0-255,1113,161202,33,164086
3464,0.021924,172.31.33.0-255,1514,162716,33,164086
3465,0.021954,172.31.33.0-255,1172,163888,33,164086
3466,0.023395,104.244.42.0-255,66,163954,33,164086
3467,0.023434,104.244.42.0-255,66,164020,33,164086
3468,0.023489,104.244.42.0-255,66,164086,33,164086
3469,0.0,74.125.130.0-255,153,153,33,360697
3470,2.3e-05,172.31.33.0-255,66,219,33,360697
3471,2.9e-05,74.125.130.0-255,1484,1703,33,360697
3472,3.3e-05,172.31.33.0-255,66,1769,33,360697
3473,3.7e-05,74.125.130.0-255,2902,4671,33,360697
3474,3.9e-05,172.31.33.0-255,66,4737,33,360697
3475,6.6e-05,74.125.130.0-255,4320,9057,33,360697
3476,6.8e-05,172.31.33.0-255,66,9123,33,360697
3477,7.3e-05,74.125.130.0-255,4792,13915,33,360697
3478,7.5e-05,172.31.33.0-255,66,13981,33,360697
3479,0.000141,74.125.130.0-255,1484,15465,33,360697
3480,0.000145,172.31.33.0-255,66,15531,33,360697
3481,0.000167,74.125.130.0-255,2902,18433,33,360697
3482,0.000169,172.31.33.0-255,66,18499,33,360697
3483,0.000192,74.125.130.0-255,5738,24237,33,360697
3484,0.000194,172.31.33.0-255,66,24303,33,360697
3485,0.000216,74.125.130.0-255,6797,31100,33,360697
3486,0.000218,172.31.33.0-255,66,31166,33,360697
3487,0.000339,74.125.130.0-255,1484,32650,33,360697
3488,0.000342,172.31.33.0-255,66,32716,33,360697
3489,0.000346,74.125.130.0-255,1484,34200,33,360697
3490,0.000348,172.31.33.0-255,66,34266,33,360697
3491,0.000361,74.125.130.0-255,1484,35750,33,360697
3492,0.000363,172.31.33.0-255,66,35816,33,360697
3493,0.000368,74.125.130.0-255,4320,40136,33,360697
3494,0.00037,172.31.33.0-255,66,40202,33,360697
3495,0.000405,172.31.33.0-255,66,40268,33,360697
3496,0.00041,74.125.130.0-255,4320,44588,33,360697
3497,0.000412,172.31.33.0-255,66,44654,33,360697
3498,0.000468,74.125.130.0-255,4320,48974,33,360697
3499,0.000471,172.31.33.0-255,66,49040,33,360697
3500,0.000493,74.125.130.0-255,7088,56128,33,360697
3501,0.000495,74.125.130.0-255,364,56492,33,360697
3502,0.0005,172.31.33.0-255,66,56558,33,360697
3503,0.000586,172.31.33.0-255,101,56659,33,360697
3504,0.000692,74.125.130.0-255,1484,58143,33,360697
3505,0.000705,74.125.130.0-255,2902,61045,33,360697
3506,0.000708,172.31.33.0-255,66,61111,33,360697
3507,0.000729,74.125.130.0-255,4320,65431,33,360697
3508,0.000732,172.31.33.0-255,66,65497,33,360697
3509,0.000782,172.31.33.0-255,66,65563,33,360697
3510,0.000788,74.125.130.0-255,2902,68465,33,360697
3511,0.00079,172.31.33.0-255,66,68531,33,360697
3512,0.00085,172.31.33.0-255,66,68597,33,360697
3513,0.001179,74.125.130.0-255,1484,70081,33,360697
3514,0.001197,74.125.130.0-255,2902,72983,33,360697
3515,0.001201,172.31.33.0-255,66,73049,33,360697
3516,0.001219,74.125.130.0-255,4320,77369,33,360697
3517,0.001221,172.31.33.0-255,66,77435,33,360697
3518,0.001233,74.125.130.0-255,1484,78919,33,360697
3519,0.001238,74.125.130.0-255,2902,81821,33,360697
3520,0.00124,172.31.33.0-255,66,81887,33,360697
3521,0.001257,74.125.130.0-255,4320,86207,33,360697
3522,0.00126,172.31.33.0-255,66,86273,33,360697
3523,0.001284,74.125.130.0-255,5738,92011,33,360697
3524,0.001286,172.31.33.0-255,66,92077,33,360697
3525,0.001292,74.125.130.0-255,7156,99233,33,360697
3526,0.001294,172.31.33.0-255,66,99299,33,360697
3527,0.001326,74.125.130.0-255,3602,102901,33,360697
3528,0.001329,172.31.33.0-255,66,102967,33,360697
3529,0.001399,74.125.130.0-255,1484,104451,33,360697
3530,0.001415,74.125.130.0-255,2902,107353,33,360697
3531,0.001418,172.31.33.0-255,66,107419,33,360697
3532,0.001421,74.125.130.0-255,1484,108903,33,360697
3533,0.001443,74.125.130.0-255,2902,111805,33,360697
3534,0.001446,172.31.33.0-255,66,111871,33,360697
3535,0.001469,74.125.130.0-255,5738,117609,33,360697
3536,0.001472,172.31.33.0-255,66,117675,33,360697
3537,0.001485,74.125.130.0-255,4320,121995,33,360697
3538,0.001487,172.31.33.0-255,66,122061,33,360697
3539,0.001507,74.125.130.0-255,4320,126381,33,360697
3540,0.001509,172.31.33.0-255,66,126447,33,360697
3541,0.001515,74.125.130.0-255,7156,133603,33,360697
3542,0.001518,172.31.33.0-255,66,133669,33,360697
3543,0.001531,74.125.130.0-255,2902,136571,33,360697
3544,0.001533,172.31.33.0-255,66,136637,33,360697
3545,0.001536,74.125.130.0-255,766,137403,33,360697
3546,0.001615,74.125.130.0-255,1484,138887,33,360697
3547,0.001619,172.31.33.0-255,66,138953,33,360697
3548,0.001625,74.125.130.0-255,2902,141855,33,360697
3549,0.001629,172.31.33.0-255,66,141921,33,360697
3550,0.001647,74.125.130.0-255,4320,146241,33,360697
3551,0.001649,172.31.33.0-255,66,146307,33,360697
3552,0.001667,74.125.130.0-255,4320,150627,33,360697
3553,0.00167,172.31.33.0-255,66,150693,33,360697
3554,0.001682,74.125.130.0-255,4320,155013,33,360697
3555,0.001683,172.31.33.0-255,66,155079,33,360697
3556,0.001687,74.125.130.0-255,2902,157981,33,360697
3557,0.001689,172.31.33.0-255,66,158047,33,360697
3558,0.001692,74.125.130.0-255,2902,160949,33,360697
3559,0.001694,172.31.33.0-255,66,161015,33,360697
3560,0.001712,74.125.130.0-255,1484,162499,33,360697
3561,0.00173,172.31.33.0-255,66,162565,33,360697
3562,0.001732,74.125.130.0-255,766,163331,33,360697
3563,0.00179,74.125.130.0-255,1484,164815,33,360697
3564,0.001792,172.31.33.0-255,66,164881,33,360697
3565,0.001795,74.125.130.0-255,2902,167783,33,360697
3566,0.001797,172.31.33.0-255,66,167849,33,360697
3567,0.001817,74.125.130.0-255,1484,169333,33,360697
3568,0.001837,74.125.130.0-255,4320,173653,33,360697
3569,0.001839,172.31.33.0-255,66,173719,33,360697
3570,0.001841,74.125.130.0-255,1484,175203,33,360697
3571,0.001844,74.125.130.0-255,2902,178105,33,360697
3572,0.001846,172.31.33.0-255,66,178171,33,360697
3573,0.00186,74.125.130.0-255,1484,179655,33,360697
3574,0.001872,74.125.130.0-255,2902,182557,33,360697
3575,0.001874,172.31.33.0-255,66,182623,33,360697
3576,0.001884,74.125.130.0-255,1484,184107,33,360697
3577,0.001887,74.125.130.0-255,1484,185591,33,360697
3578,0.001888,172.31.33.0-255,66,185657,33,360697
3579,0.001891,74.125.130.0-255,1484,187141,33,360697
3580,0.001908,74.125.130.0-255,1484,188625,33,360697
3581,0.00191,172.31.33.0-255,66,188691,33,360697
3582,0.001912,74.125.130.0-255,1484,190175,33,360697
3583,0.001928,74.125.130.0-255,4320,194495,33,360697
3584,0.00193,172.31.33.0-255,66,194561,33,360697
3585,0.001934,74.125.130.0-255,3602,198163,33,360697
3586,0.001936,172.31.33.0-255,66,198229,33,360697
3587,0.00208,74.125.130.0-255,1484,199713,33,360697
3588,0.002097,74.125.130.0-255,2902,202615,33,360697
3589,0.002099,172.31.33.0-255,66,202681,33,360697
3590,0.002101,74.125.130.0-255,1484,204165,33,360697
3591,0.002117,74.125.130.0-255,4320,208485,33,360697
3592,0.002119,172.31.33.0-255,66,208551,33,360697
3593,0.002141,74.125.130.0-255,2902,211453,33,360697
3594,0.002143,172.31.33.0-255,66,211519,33,360697
3595,0.002158,74.125.130.0-255,7156,218675,33,360697
3596,0.002161,172.31.33.0-255,66,218741,33,360697
3597,0.002163,74.125.130.0-255,1484,220225,33,360697
3598,0.00219,172.31.33.0-255,66,220291,33,360697
3599,0.002193,74.125.130.0-255,2184,222475,33,360697
3600,0.002196,172.31.33.0-255,66,222541,33,360697
3601,0.002767,74.125.130.0-255,66,222607,33,360697
3602,0.004416,74.125.130.0-255,5738,228345,33,360697
3603,0.00442,172.31.33.0-255,66,228411,33,360697
3604,0.006654,74.125.130.0-255,5738,234149,33,360697
3605,0.00666,172.31.33.0-255,66,234215,33,360697
3606,0.00889,74.125.130.0-255,5738,239953,33,360697
3607,0.008895,172.31.33.0-255,66,240019,33,360697
3608,0.01113,74.125.130.0-255,5738,245757,33,360697
3609,0.011138,172.31.33.0-255,66,245823,33,360697
3610,0.013372,74.125.130.0-255,5738,251561,33,360697
3611,0.013378,172.31.33.0-255,66,251627,33,360697
3612,0.015612,74.125.130.0-255,5738,257365,33,360697
3613,0.015619,172.31.33.0-255,66,257431,33,360697
3614,0.017859,74.125.130.0-255,5738,263169,33,360697
3615,0.017864,172.31.33.0-255,66,263235,33,360697
3616,0.020099,74.125.130.0-255,5738,268973,33,360697
3617,0.020105,172.31.33.0-255,66,269039,33,360697
3618,0.022345,74.125.130.0-255,5738,274777,33,360697
3619,0.022352,172.31.33.0-255,66,274843,33,360697
3620,0.024579,74.125.130.0-255,4320,279163,33,360697
3621,0.024586,172.31.33.0-255,66,279229,33,360697
3622,0.024604,74.125.130.0-255,1484,280713,33,360697
3623,0.024713,172.31.33.0-255,172,280885,33,360697
3624,0.024747,172.31.33.0-255,1113,281998,33,360697
3625,0.024865,172.31.33.0-255,1514,283512,33,360697
3626,0.024867,172.31.33.0-255,1171,284683,33,360697
3627,0.026246,104.244.42.0-255,66,284749,33,360697
3628,0.026288,104.244.42.0-255,66,284815,33,360697
3629,0.026427,104.244.42.0-255,66,284881,33,360697
3630,0.026808,74.125.130.0-255,4320,289201,33,360697
3631,0.026812,172.31.33.0-255,66,289267,33,360697
3632,0.029056,74.125.130.0-255,4320,293587,33,360697
3633,0.029061,172.31.33.0-255,66,293653,33,360697
3634,0.029088,74.125.130.0-255,1484,295137,33,360697
3635,0.031288,74.125.130.0-255,4320,299457,33,360697
3636,0.031294,172.31.33.0-255,66,299523,33,360697
3637,0.033517,74.125.130.0-255,5738,305261,33,360697
3638,0.033522,172.31.33.0-255,66,305327,33,360697
3639,0.035746,74.125.130.0-255,4320,309647,33,360697
3640,0.03575,172.31.33.0-255,66,309713,33,360697
3641,0.035778,74.125.130.0-255,1484,311197,33,360697
3642,0.037975,74.125.130.0-255,4320,315517,33,360697
3643,0.037979,172.31.33.0-255,66,315583,33,360697
3644,0.040206,74.125.130.0-255,2902,318485,33,360697
3645,0.040212,172.31.33.0-255,66,318551,33,360697
3646,0.040229,74.125.130.0-255,2902,321453,33,360697
3647,0.040232,172.31.33.0-255,66,321519,33,360697
3648,0.042442,74.125.130.0-255,4320,325839,33,360697
3649,0.042449,172.31.33.0-255,66,325905,33,360697
3650,0.042469,74.125.130.0-255,1484,327389,33,360697
3651,0.044683,74.125.130.0-255,4320,331709,33,360697
3652,0.044688,172.31.33.0-255,66,331775,33,360697
3653,0.046923,74.125.130.0-255,5738,337513,33,360697
3654,0.046929,172.31.33.0-255,66,337579,33,360697
3655,0.04916,74.125.130.0-255,5738,343317,33,360697
3656,0.049165,172.31.33.0-255,66,343383,33,360697
3657,0.051401,74.125.130.0-255,5738,349121,33,360697
3658,0.051406,172.31.33.0-255,66,349187,33,360697
3659,0.053634,74.125.130.0-255,2902,352089,33,360697
3660,0.053639,172.31.33.0-255,66,352155,33,360697
3661,0.053668,74.125.130.0-255,2902,355057,33,360697
3662,0.053671,172.31.33.0-255,66,355123,33,360697
3663,0.055874,74.125.130.0-255,2902,358025,33,360697
3664,0.055879,172.31.33.0-255,66,358091,33,360697
3665,0.055901,74.125.130.0-255,2369,360460,33,360697
3666,0.055903,172.31.33.0-255,66,360526,33,360697
3667,0.056612,172.31.33.0-255,105,360631,33,360697
3668,0.062991,74.125.130.0-255,66,360697,33,360697
3669,0.0,172.31.33.0-255,160,160,33,226
3670,0.007153,74.125.200.0-255,66,226,33,226
3671,0.0,74.125.200.0-255,149,149,33,338497
3672,1.5e-05,172.31.33.0-255,66,215,33,338497
3673,2.1e-05,74.125.200.0-255,1484,1699,33,338497
3674,2.6e-05,172.31.33.0-255,66,1765,33,338497
3675,3.8e-05,74.125.200.0-255,2902,4667,33,338497
3676,4.3e-05,172.31.33.0-255,66,4733,33,338497
3677,7.6e-05,74.125.200.0-255,4320,9053,33,338497
3678,7.9e-05,172.31.33.0-255,66,9119,33,338497
3679,8.4e-05,74.125.200.0-255,2902,12021,33,338497
3680,8.6e-05,172.31.33.0-255,66,12087,33,338497
3681,0.000115,74.125.200.0-255,1991,14078,33,338497
3682,0.000118,172.31.33.0-255,66,14144,33,338497
3683,0.00014,74.125.200.0-255,1484,15628,33,338497
3684,0.000142,172.31.33.0-255,66,15694,33,338497
3685,0.000147,74.125.200.0-255,2902,18596,33,338497
3686,0.000149,172.31.33.0-255,66,18662,33,338497
3687,0.000151,74.125.200.0-255,1484,20146,33,338497
3688,0.000153,172.31.33.0-255,66,20212,33,338497
3689,0.000177,74.125.200.0-255,2902,23114,33,338497
3690,0.00018,172.31.33.0-255,66,23180,33,338497
3691,0.000186,74.125.200.0-255,5738,28918,33,338497
3692,0.000188,172.31.33.0-255,66,28984,33,338497
3693,0.000212,74.125.200.0-255,2543,31527,33,338497
3694,0.000215,172.31.33.0-255,66,31593,33,338497
3695,0.000339,74.125.200.0-255,1484,33077,33,338497
3696,0.000343,172.31.33.0-255,66,33143,33,338497
3697,0.000356,74.125.200.0-255,2902,36045,33,338497
3698,0.000358,172.31.33.0-255,66,36111,33,338497
3699,0.000365,74.125.200.0-255,2902,39013,33,338497
3700,0.000368,172.31.33.0-255,66,39079,33,338497
3701,0.00039,74.125.200.0-255,4320,43399,33,338497
3702,0.000392,172.31.33.0-255,66,43465,33,338497
3703,0.00043,172.31.33.0-255,66,43531,33,338497
3704,0.000433,74.125.200.0-255,1484,45015,33,338497
3705,0.000472,74.125.200.0-255,1484,46499,33,338497
3706,0.000474,172.31.33.0-255,66,46565,33,338497
3707,0.000504,172.31.33.0-255,66,46631,33,338497
3708,0.000506,74.125.200.0-255,398,47029,33,338497
3709,0.00055,74.125.200.0-255,345,47374,33,338497
3710,0.000758,74.125.200.0-255,1484,48858,33,338497
3711,0.000762,172.31.33.0-255,66,48924,33,338497
3712,0.000767,74.125.200.0-255,2902,51826,33,338497
3713,0.000769,172.31.33.0-255,66,51892,33,338497
3714,0.000795,74.125.200.0-255,4320,56212,33,338497
3715,0.000797,172.31.33.0-255,66,56278,33,338497
3716,0.000802,74.125.200.0-255,4320,60598,33,338497
3717,0.000804,172.31.33.0-255,66,60664,33,338497
3718,0.000823,74.125.200.0-255,1484,62148,33,338497
3719,0.000833,172.31.33.0-255,66,62214,33,338497
3720,0.000856,74.125.200.0-255,2902,65116,33,338497
3721,0.000858,172.31.33.0-255,66,65182,33,338497
3722,0.000863,74.125.200.0-255,4320,69502,33,338497
3723,0.000865,172.31.33.0-255,66,69568,33,338497
3724,0.000899,74.125.200.0-255,3602,73170,33,338497
3725,0.000901,172.31.33.0-255,66,73236,33,338497
3726,0.0011,74.125.200.0-255,1484,74720,33,338497
3727,0.00112,74.125.200.0-255,2902,77622,33,338497
3728,0.001124,172.31.33.0-255,66,77688,33,338497
3729,0.001143,74.125.200.0-255,2902,80590,33,338497
3730,0.001145,172.31.33.0-255,66,80656,33,338497
3731,0.001157,74.125.200.0-255,1484,82140,33,338497
3732,0.001167,74.125.200.0-255,5738,87878,33,338497
3733,0.001169,172.31.33.0-255,66,87944,33,338497
3734,0.001193,74.125.200.0-255,7156,95100,33,338497
3735,0.001195,172.31.33.0-255,66,95166,33,338497
3736,0.001219,74.125.200.0-255,4320,99486,33,338497
3737,0.001221,172.31.33.0-255,66,99552,33,338497
3738,0.001252,172.31.33.0-255,66,99618,33,338497
3739,0.001703,74.125.200.0-255,1484,101102,33,338497
3740,0.001738,74.125.200.0-255,2902,104004,33,338497
3741,0.001742,172.31.33.0-255,66,104070,33,338497
3742,0.001745,74.125.200.0-255,1484,105554,33,338497
3743,0.001786,74.125.200.0-255,2902,108456,33,338497
3744,0.001789,172.31.33.0-255,66,108522,33,338497
3745,0.001792,74.125.200.0-255,1484,110006,33,338497
3746,0.001812,74.125.200.0-255,2902,112908,33,338497
3747,0.001814,172.31.33.0-255,66,112974,33,338497
3748,0.001848,74.125.200.0-255,1484,114458,33,338497
3749,0.001866,74.125.200.0-255,2902,117360,33,338497
3750,0.001868,172.31.33.0-255,66,117426,33,338497
3751,0.001871,74.125.200.0-255,1484,118910,33,338497
3752,0.001895,74.125.200.0-255,4320,123230,33,338497
3753,0.001899,74.125.200.0-255,2902,126132,33,338497
3754,0.001903,172.31.33.0-255,66,126198,33,338497
3755,0.001906,172.31.33.0-255,66,126264,33,338497
3756,0.001931,74.125.200.0-255,5738,132002,33,338497
3757,0.001934,172.31.33.0-255,66,132068,33,338497
3758,0.001959,74.125.200.0-255,2184,134252,33,338497
3759,0.001961,172.31.33.0-255,66,134318,33,338497
3760,0.002291,74.125.200.0-255,1484,135802,33,338497
3761,0.002298,74.125.200.0-255,1484,137286,33,338497
3762,0.002301,172.31.33.0-255,66,137352,33,338497
3763,0.002307,74.125.200.0-255,2902,140254,33,338497
3764,0.002309,172.31.33.0-255,66,140320,33,338497
3765,0.002329,74.125.200.0-255,5738,146058,33,338497
3766,0.002331,172.31.33.0-255,66,146124,33,338497
3767,0.00235,74.125.200.0-255,1484,147608,33,338497
3768,0.002375,172.31.33.0-255,66,147674,33,338497
3769,0.002378,74.125.200.0-255,1484,149158,33,338497
3770,0.00472,74.125.200.0-255,4320,153478,33,338497
3771,0.004726,172.31.33.0-255,66,153544,33,338497
3772,0.007072,74.125.200.0-255,5738,159282,33,338497
3773,0.007077,172.31.33.0-255,66,159348,33,338497
3774,0.00944,74.125.200.0-255,5738,165086,33,338497
3775,0.009448,172.31.33.0-255,66,165152,33,338497
3776,0.011798,74.125.200.0-255,2902,168054,33,338497
3777,0.011804,172.31.33.0-255,66,168120,33,338497
3778,0.01183,74.125.200.0-255,2902,171022,33,338497
3779,0.011832,172.31.33.0-255,66,171088,33,338497
3780,0.014154,74.125.200.0-255,2902,173990,33,338497
3781,0.014162,172.31.33.0-255,66,174056,33,338497
3782,0.014195,74.125.200.0-255,2902,176958,33,338497
3783,0.014197,172.31.33.0-255,66,177024,33,338497
3784,0.016517,74.125.200.0-255,2902,179926,33,338497
3785,0.016524,172.31.33.0-255,66,179992,33,338497
3786,0.016552,74.125.200.0-255,2902,182894,33,338497
3787,0.016554,172.31.33.0-255,66,182960,33,338497
3788,0.018886,74.125.200.0-255,2902,185862,33,338497
3789,0.018896,172.31.33.0-255,66,185928,33,338497
3790,0.018929,74.125.200.0-255,2902,188830,33,338497
3791,0.018931,172.31.33.0-255,66,188896,33,338497
3792,0.021247,74.125.200.0-255,2902,191798,33,338497
3793,0.021254,172.31.33.0-255,66,191864,33,338497
3794,0.021285,74.125.200.0-255,2902,194766,33,338497
3795,0.021288,172.31.33.0-255,66,194832,33,338497
3796,0.023607,74.125.200.0-255,2902,197734,33,338497
3797,0.023614,172.31.33.0-255,66,197800,33,338497
3798,0.023648,74.125.200.0-255,2902,200702,33,338497
3799,0.023651,172.31.33.0-255,66,200768,33,338497
3800,0.025962,74.125.200.0-255,2902,203670,33,338497
3801,0.025969,172.31.33.0-255,66,203736,33,338497
3802,0.025997,74.125.200.0-255,2902,206638,33,338497
3803,0.026,172.31.33.0-255,66,206704,33,338497
3804,0.026631,172.31.33.0-255,172,206876,33,338497
3805,0.026657,172.31.33.0-255,1113,207989,33,338497
3806,0.026711,172.31.33.0-255,1514,209503,33,338497
3807,0.026712,172.31.33.0-255,1514,211017,33,338497
3808,0.026713,172.31.33.0-255,682,211699,33,338497
3809,0.028203,104.244.42.0-255,66,211765,33,338497
3810,0.028232,104.244.42.0-255,66,211831,33,338497
3811,0.028255,104.244.42.0-255,66,211897,33,338497
3812,0.028271,104.244.42.0-255,66,211963,33,338497
3813,0.02835,74.125.200.0-255,2902,214865,33,338497
3814,0.028355,172.31.33.0-255,66,214931,33,338497
3815,0.028379,74.125.200.0-255,2902,217833,33,338497
3816,0.028382,172.31.33.0-255,66,217899,33,338497
3817,0.030701,74.125.200.0-255,1484,219383,33,338497
3818,0.030731,74.125.200.0-255,4320,223703,33,338497
3819,0.030736,172.31.33.0-255,66,223769,33,338497
3820,0.033094,74.125.200.0-255,5738,229507,33,338497
3821,0.0331,172.31.33.0-255,66,229573,33,338497
3822,0.035458,74.125.200.0-255,5738,235311,33,338497
3823,0.035463,172.31.33.0-255,66,235377,33,338497
3824,0.037814,74.125.200.0-255,5738,241115,33,338497
3825,0.03782,172.31.33.0-255,66,241181,33,338497
3826,0.040172,74.125.200.0-255,5738,246919,33,338497
3827,0.040178,172.31.33.0-255,66,246985,33,338497
3828,0.042525,74.125.200.0-255,5738,252723,33,338497
3829,0.04253,172.31.33.0-255,66,252789,33,338497
3830,0.04488,74.125.200.0-255,5738,258527,33,338497
3831,0.044886,172.31.33.0-255,66,258593,33,338497
3832,0.047243,74.125.200.0-255,5738,264331,33,338497
3833,0.047249,172.31.33.0-255,66,264397,33,338497
3834,0.049606,74.125.200.0-255,5738,270135,33,338497
3835,0.049611,172.31.33.0-255,66,270201,33,338497
3836,0.051959,74.125.200.0-255,5738,275939,33,338497
3837,0.051963,172.31.33.0-255,66,276005,33,338497
3838,0.054327,74.125.200.0-255,5738,281743,33,338497
3839,0.054335,172.31.33.0-255,66,281809,33,338497
3840,0.056717,74.125.200.0-255,5738,287547,33,338497
3841,0.056723,172.31.33.0-255,66,287613,33,338497
3842,0.059079,74.125.200.0-255,5738,293351,33,338497
3843,0.059084,172.31.33.0-255,66,293417,33,338497
3844,0.061439,74.125.200.0-255,5738,299155,33,338497
3845,0.061445,172.31.33.0-255,66,299221,33,338497
3846,0.063807,74.125.200.0-255,5738,304959,33,338497
3847,0.063814,172.31.33.0-255,66,305025,33,338497
3848,0.066171,74.125.200.0-255,5738,310763,33,338497
3849,0.066176,172.31.33.0-255,66,310829,33,338497
3850,0.068528,74.125.200.0-255,5738,316567,33,338497
3851,0.068535,172.31.33.0-255,66,316633,33,338497
3852,0.070892,74.125.200.0-255,4320,320953,33,338497
3853,0.070898,172.31.33.0-255,66,321019,33,338497
3854,0.070923,74.125.200.0-255,1484,322503,33,338497
3855,0.073283,74.125.200.0-255,4320,326823,33,338497
3856,0.073288,172.31.33.0-255,66,326889,33,338497
3857,0.075641,74.125.200.0-255,5738,332627,33,338497
3858,0.075646,172.31.33.0-255,66,332693,33,338497
3859,0.078,74.125.200.0-255,5738,338431,33,338497
3860,0.078005,172.31.33.0-255,66,338497,33,338497
3861,0.0,74.125.24.0-255,150,150,33,287365
3862,2.8e-05,172.31.33.0-255,66,216,33,287365
3863,3.4e-05,74.125.24.0-255,1484,1700,33,287365
3864,3.7e-05,172.31.33.0-255,66,1766,33,287365
3865,5.4e-05,74.125.24.0-255,2902,4668,33,287365
3866,5.7e-05,172.31.33.0-255,66,4734,33,287365
3867,6.3e-05,74.125.24.0-255,5738,10472,33,287365
3868,6.6e-05,172.31.33.0-255,66,10538,33,287365
3869,8.7e-05,74.125.24.0-255,4320,14858,33,287365
3870,9e-05,172.31.33.0-255,66,14924,33,287365
3871,0.000129,172.31.33.0-255,66,14990,33,287365
3872,0.000136,74.125.24.0-255,6797,21787,33,287365
3873,0.000138,172.31.33.0-255,66,21853,33,287365
3874,0.000314,74.125.24.0-255,1484,23337,33,287365
3875,0.000318,172.31.33.0-255,66,23403,33,287365
3876,0.000324,74.125.24.0-255,2902,26305,33,287365
3877,0.000327,172.31.33.0-255,66,26371,33,287365
3878,0.000332,74.125.24.0-255,4320,30691,33,287365
3879,0.000334,172.31.33.0-255,66,30757,33,287365
3880,0.000354,74.125.24.0-255,1484,32241,33,287365
3881,0.000357,172.31.33.0-255,66,32307,33,287365
3882,0.000363,74.125.24.0-255,5738,38045,33,287365
3883,0.000366,172.31.33.0-255,66,38111,33,287365
3884,0.000387,74.125.24.0-255,5738,43849,33,287365
3885,0.00039,172.31.33.0-255,66,43915,33,287365
3886,0.000412,74.125.24.0-255,5738,49653,33,287365
3887,0.000415,172.31.33.0-255,66,49719,33,287365
3888,0.000433,74.125.24.0-255,6438,56157,33,287365
3889,0.000435,172.31.33.0-255,66,56223,33,287365
3890,0.000438,74.125.24.0-255,676,56899,33,287365
3891,0.000442,172.31.33.0-255,66,56965,33,287365
3892,0.00097,74.125.24.0-255,1484,58449,33,287365
3893,0.000979,74.125.24.0-255,2902,61351,33,287365
3894,0.000983,172.31.33.0-255,66,61417,33,287365
3895,0.001005,74.125.24.0-255,2902,64319,33,287365
3896,0.001007,172.31.33.0-255,66,64385,33,287365
3897,0.001031,74.125.24.0-255,2902,67287,33,287365
3898,0.001033,172.31.33.0-255,66,67353,33,287365
3899,0.001044,172.31.33.0-255,66,67419,33,287365
3900,0.001081,74.125.24.0-255,4320,71739,33,287365
3901,0.001084,172.31.33.0-255,66,71805,33,287365
3902,0.001109,74.125.24.0-255,6438,78243,33,287365
3903,0.001111,172.31.33.0-255,66,78309,33,287365
3904,0.001295,74.125.24.0-255,1484,79793,33,287365
3905,0.0013,74.125.24.0-255,2902,82695,33,287365
3906,0.001303,172.31.33.0-255,66,82761,33,287365
3907,0.001327,74.125.24.0-255,1484,84245,33,287365
3908,0.001342,74.125.24.0-255,4320,88565,33,287365
3909,0.001344,172.31.33.0-255,66,88631,33,287365
3910,0.001362,74.125.24.0-255,4320,92951,33,287365
3911,0.001364,172.31.33.0-255,66,93017,33,287365
3912,0.001388,74.125.24.0-255,5738,98755,33,287365
3913,0.00139,172.31.33.0-255,66,98821,33,287365
3914,0.001414,172.31.33.0-255,66,98887,33,287365
3915,0.001436,74.125.24.0-255,5020,103907,33,287365
3916,0.001439,172.31.33.0-255,66,103973,33,287365
3917,0.001931,74.125.24.0-255,1484,105457,33,287365
3918,0.001937,74.125.24.0-255,1484,106941,33,287365
3919,0.00194,172.31.33.0-255,66,107007,33,287365
3920,0.001958,74.125.24.0-255,1484,108491,33,287365
3921,0.001964,74.125.24.0-255,5738,114229,33,287365
3922,0.001966,172.31.33.0-255,66,114295,33,287365
3923,0.001991,74.125.24.0-255,2902,117197,33,287365
3924,0.001993,172.31.33.0-255,66,117263,33,287365
3925,0.002009,74.125.24.0-255,7156,124419,33,287365
3926,0.002012,172.31.33.0-255,66,124485,33,287365
3927,0.002044,74.125.24.0-255,5738,130223,33,287365
3928,0.002046,172.31.33.0-255,66,130289,33,287365
3929,0.002075,172.31.33.0-255,66,130355,33,287365
3930,0.002241,74.125.24.0-255,1484,131839,33,287365
3931,0.002279,74.125.24.0-255,1484,133323,33,287365
3932,0.002282,172.31.33.0-255,66,133389,33,287365
3933,0.002337,74.125.24.0-255,2902,136291,33,287365
3934,0.002341,172.31.33.0-255,66,136357,33,287365
3935,0.002346,74.125.24.0-255,4320,140677,33,287365
3936,0.002347,172.31.33.0-255,66,140743,33,287365
3937,0.002371,74.125.24.0-255,1484,142227,33,287365
3938,0.002383,74.125.24.0-255,4320,146547,33,287365
3939,0.002385,172.31.33.0-255,66,146613,33,287365
3940,0.002404,74.125.24.0-255,2902,149515,33,287365
3941,0.002406,172.31.33.0-255,66,149581,33,287365
3942,0.002428,74.125.24.0-255,7156,156737,33,287365
3943,0.00243,172.31.33.0-255,66,156803,33,287365
3944,0.002442,74.125.24.0-255,2902,159705,33,287365
3945,0.002444,172.31.33.0-255,66,159771,33,287365
3946,0.00249,74.125.24.0-255,4320,164091,33,287365
3947,0.002493,172.31.33.0-255,66,164157,33,287365
3948,0.00251,74.125.24.0-255,5738,169895,33,287365
3949,0.002512,172.31.33.0-255,66,169961,33,287365
3950,0.002545,74.125.24.0-255,6438,176399,33,287365
3951,0.002549,172.31.33.0-255,66,176465,33,287365
3952,0.002553,74.125.24.0-255,4320,180785,33,287365
3953,0.002555,172.31.33.0-255,66,180851,33,287365
3954,0.00256,74.125.24.0-255,2902,183753,33,287365
3955,0.002562,172.31.33.0-255,66,183819,33,287365
3956,0.002587,74.125.24.0-255,2902,186721,33,287365
3957,0.00259,172.31.33.0-255,66,186787,33,287365
3958,0.0026,74.125.24.0-255,1484,188271,33,287365
3959,0.002615,74.125.24.0-255,2902,191173,33,287365
3960,0.002618,172.31.33.0-255,66,191239,33,287365
3961,0.002648,74.125.24.0-255,2902,194141,33,287365
3962,0.002651,172.31.33.0-255,66,194207,33,287365
3963,0.002673,74.125.24.0-255,5020,199227,33,287365
3964,0.002675,172.31.33.0-255,66,199293,33,287365
3965,0.0027,74.125.24.0-255,1484,200777,33,287365
3966,0.002719,74.125.24.0-255,2902,203679,33,287365
3967,0.002722,172.31.33.0-255,66,203745,33,287365
3968,0.002742,74.125.24.0-255,5738,209483,33,287365
3969,0.002744,172.31.33.0-255,66,209549,33,287365
3970,0.002747,74.125.24.0-255,1484,211033,33,287365
3971,0.002788,172.31.33.0-255,66,211099,33,287365
3972,0.002801,172.31.33.0-255,66,211165,33,287365
3973,0.002805,74.125.24.0-255,2184,213349,33,287365
3974,0.002807,172.31.33.0-255,66,213415,33,287365
3975,0.003172,74.125.24.0-255,1484,214899,33,287365
3976,0.003177,74.125.24.0-255,2902,217801,33,287365
3977,0.00318,172.31.33.0-255,66,217867,33,287365
3978,0.003186,74.125.24.0-255,5738,223605,33,287365
3979,0.003188,172.31.33.0-255,66,223671,33,287365
3980,0.0032,172.31.33.0-255,66,223737,33,287365
3981,0.003207,74.125.24.0-255,7156,230893,33,287365
3982,0.003209,172.31.33.0-255,66,230959,33,287365
3983,0.003215,74.125.24.0-255,6438,237397,33,287365
3984,0.003218,172.31.33.0-255,66,237463,33,287365
3985,0.003228,172.31.33.0-255,66,237529,33,287365
3986,0.003242,172.31.33.0-255,66,237595,33,287365
3987,0.003247,74.125.24.0-255,5020,242615,33,287365
3988,0.003251,172.31.33.0-255,66,242681,33,287365
3989,0.003255,74.125.24.0-255,4320,247001,33,287365
3990,0.003257,172.31.33.0-255,66,247067,33,287365
3991,0.003277,74.125.24.0-255,1484,248551,33,287365
3992,0.003282,74.125.24.0-255,2902,251453,33,287365
3993,0.003284,172.31.33.0-255,66,251519,33,287365
3994,0.003286,74.125.24.0-255,1484,253003,33,287365
3995,0.003312,172.31.33.0-255,66,253069,33,287365
3996,0.003332,74.125.24.0-255,4320,257389,33,287365
3997,0.003335,172.31.33.0-255,66,257455,33,287365
3998,0.003337,74.125.24.0-255,1484,258939,33,287365
3999,0.003376,74.125.24.0-255,1484,260423,33,287365
4000,0.003378,172.31.33.0-255,66,260489,33,287365
4001,0.0034,172.31.33.0-255,66,260555,33,287365
4002,0.003473,74.125.24.0-255,1484,262039,33,287365
4003,0.003503,74.125.24.0-255,2902,264941,33,287365
4004,0.003506,172.31.33.0-255,66,265007,33,287365
4005,0.003511,74.125.24.0-255,2902,267909,33,287365
4006,0.003513,172.31.33.0-255,66,267975,33,287365
4007,0.003526,74.125.24.0-255,2902,270877,33,287365
4008,0.003528,172.31.33.0-255,66,270943,33,287365
4009,0.003533,74.125.24.0-255,2902,273845,33,287365
4010,0.003535,172.31.33.0-255,66,273911,33,287365
4011,0.003571,172.31.33.0-255,66,273977,33,287365
4012,0.003574,74.125.24.0-255,1484,275461,33,287365
4013,0.003577,74.125.24.0-255,1484,276945,33,287365
4014,0.003579,172.31.33.0-255,66,277011,33,287365
4015,0.003581,74.125.24.0-255,1484,278495,33,287365
4016,0.003593,74.125.24.0-255,1484,279979,33,287365
4017,0.003595,172.31.33.0-255,66,280045,33,287365
4018,0.00361,74.125.24.0-255,1655,281700,33,287365
4019,0.003612,172.31.33.0-255,66,281766,33,287365
4020,0.003645,74.125.24.0-255,105,281871,33,287365
4021,0.005131,172.31.33.0-255,66,281937,33,287365
4022,0.005161,172.31.33.0-255,105,282042,33,287365
4023,0.007122,74.125.24.0-255,66,282108,33,287365
4024,0.021559,172.31.33.0-255,172,282280,33,287365
4025,0.021602,172.31.33.0-255,1117,283397,33,287365
4026,0.021664,172.31.33.0-255,1514,284911,33,287365
4027,0.021666,172.31.33.0-255,1514,286425,33,287365
4028,0.021667,172.31.33.0-255,676,287101,33,287365
4029,0.023135,104.244.42.0-255,66,287167,33,287365
4030,0.023207,104.244.42.0-255,66,287233,33,287365
4031,0.023331,104.244.42.0-255,66,287299,33,287365
4032,0.023335,104.244.42.0-255,66,287365,33,287365
4033,0.0,172.217.194.0-255,153,153,33,139944
4034,2.1e-05,172.31.33.0-255,66,219,33,139944
4035,2.9e-05,172.217.194.0-255,1484,1703,33,139944
4036,3.3e-05,172.31.33.0-255,66,1769,33,139944
4037,3.9e-05,172.217.194.0-255,2902,4671,33,139944
4038,4.2e-05,172.31.33.0-255,66,4737,33,139944
4039,5e-05,172.217.194.0-255,7156,11893,33,139944
4040,5.4e-05,172.31.33.0-255,66,11959,33,139944
4041,6.2e-05,172.217.194.0-255,7156,19115,33,139944
4042,6.4e-05,172.31.33.0-255,66,19181,33,139944
4043,8.4e-05,172.217.194.0-255,632,19813,33,139944
4044,8.6e-05,172.31.33.0-255,66,19879,33,139944
4045,0.000101,172.31.33.0-255,66,19945,33,139944
4046,0.000225,172.217.194.0-255,1484,21429,33,139944
4047,0.00023,172.31.33.0-255,66,21495,33,139944
4048,0.00025,172.217.194.0-255,2902,24397,33,139944
4049,0.000252,172.31.33.0-255,66,24463,33,139944
4050,0.000258,172.217.194.0-255,2902,27365,33,139944
4051,0.000261,172.31.33.0-255,66,27431,33,139944
4052,0.000278,172.217.194.0-255,2902,30333,33,139944
4053,0.00028,172.31.33.0-255,66,30399,33,139944
4054,0.000284,172.217.194.0-255,2902,33301,33,139944
4055,0.000287,172.31.33.0-255,66,33367,33,139944
4056,0.000324,172.31.33.0-255,66,33433,33,139944
4057,0.000331,172.217.194.0-255,5738,39171,33,139944
4058,0.000333,172.31.33.0-255,66,39237,33,139944
4059,0.000349,172.217.194.0-255,5602,44839,33,139944
4060,0.000351,172.31.33.0-255,66,44905,33,139944
4061,0.000525,172.217.194.0-255,1484,46389,33,139944
4062,0.000529,172.31.33.0-255,66,46455,33,139944
4063,0.000534,172.217.194.0-255,1484,47939,33,139944
4064,0.000549,172.217.194.0-255,1484,49423,33,139944
4065,0.000551,172.31.33.0-255,66,49489,33,139944
4066,0.000558,172.217.194.0-255,5738,55227,33,139944
4067,0.000561,172.31.33.0-255,66,55293,33,139944
4068,0.000591,172.31.33.0-255,66,55359,33,139944
4069,0.000596,172.217.194.0-255,4320,59679,33,139944
4070,0.000598,172.31.33.0-255,66,59745,33,139944
4071,0.000623,172.217.194.0-255,6438,66183,33,139944
4072,0.000626,172.31.33.0-255,66,66249,33,139944
4073,0.001249,172.217.194.0-255,1484,67733,33,139944
4074,0.001255,172.217.194.0-255,2902,70635,33,139944
4075,0.001259,172.31.33.0-255,66,70701,33,139944
4076,0.001282,172.217.194.0-255,1484,72185,33,139944
4077,0.001298,172.217.194.0-255,4320,76505,33,139944
4078,0.0013,172.31.33.0-255,66,76571,33,139944
4079,0.001308,172.217.194.0-255,7156,83727,33,139944
4080,0.00131,172.31.33.0-255,66,83793,33,139944
4081,0.001326,172.217.194.0-255,5738,89531,33,139944
4082,0.001328,172.31.33.0-255,66,89597,33,139944
4083,0.001332,172.217.194.0-255,2902,92499,33,139944
4084,0.001334,172.31.33.0-255,66,92565,33,139944
4085,0.001355,172.217.194.0-255,5738,98303,33,139944
4086,0.001358,172.31.33.0-255,66,98369,33,139944
4087,0.001372,172.217.194.0-255,2184,100553,33,139944
4088,0.001374,172.31.33.0-255,66,100619,33,139944
4089,0.001477,172.217.194.0-255,1484,102103,33,139944
4090,0.001483,172.217.194.0-255,2902,105005,33,139944
4091,0.001486,172.31.33.0-255,66,105071,33,139944
4092,0.001493,172.217.194.0-255,5738,110809,33,139944
4093,0.001496,172.31.33.0-255,66,110875,33,139944
4094,0.001536,172.31.33.0-255,66,110941,33,139944
4095,0.001543,172.217.194.0-255,5738,116679,33,139944
4096,0.001546,172.31.33.0-255,66,116745,33,139944
4097,0.001582,172.31.33.0-255,66,116811,33,139944
4098,0.001595,172.31.33.0-255,66,116877,33,139944
4099,0.00163,172.31.33.0-255,66,116943,33,139944
4100,0.001658,172.31.33.0-255,66,117009,33,139944
4101,0.001661,172.217.194.0-255,1484,118493,33,139944
4102,0.001698,172.31.33.0-255,66,118559,33,139944
4103,0.001716,172.217.194.0-255,1484,120043,33,139944
4104,0.001729,172.217.194.0-255,2902,122945,33,139944
4105,0.001731,172.31.33.0-255,66,123011,33,139944
4106,0.001761,172.31.33.0-255,66,123077,33,139944
4107,0.001776,172.31.33.0-255,66,123143,33,139944
4108,0.001788,172.217.194.0-255,7156,130299,33,139944
4109,0.001791,172.31.33.0-255,66,130365,33,139944
4110,0.001812,172.31.33.0-255,66,130431,33,139944
4111,0.001849,172.31.33.0-255,66,130497,33,139944
4112,0.001915,172.31.33.0-255,66,130563,33,139944
4113,0.001947,172.31.33.0-255,66,130629,33,139944
4114,0.001975,172.31.33.0-255,66,130695,33,139944
4115,0.001987,172.31.33.0-255,66,130761,33,139944
4116,0.002033,172.31.33.0-255,66,130827,33,139944
4117,0.002059,172.31.33.0-255,66,130893,33,139944
4118,0.002062,172.217.194.0-255,1484,132377,33,139944
4119,0.002076,172.31.33.0-255,66,132443,33,139944
4120,0.002079,172.217.194.0-255,105,132548,33,139944
4121,0.012572,172.31.33.0-255,66,132614,33,139944
4122,0.012622,172.31.33.0-255,105,132719,33,139944
4123,0.01487,172.217.194.0-255,66,132785,33,139944
4124,0.033237,172.31.33.0-255,176,132961,33,139944
4125,0.033264,172.31.33.0-255,1117,134078,33,139944
4126,0.033318,172.31.33.0-255,1514,135592,33,139944
4127,0.033319,172.31.33.0-255,1514,137106,33,139944
4128,0.03332,172.31.33.0-255,1514,138620,33,139944
4129,0.033321,172.31.33.0-255,1060,139680,33,139944
4130,0.034788,104.244.42.0-255,66,139746,33,139944
4131,0.034806,104.244.42.0-255,66,139812,33,139944
4132,0.034853,104.244.42.0-255,66,139878,33,139944
4133,0.034883,104.244.42.0-255,66,139944,33,139944
4134,0.0,172.217.194.0-255,148,148,33,240437
4135,2.2e-05,172.31.33.0-255,66,214,33,240437
4136,2.8e-05,172.217.194.0-255,1484,1698,33,240437
4137,3.1e-05,172.31.33.0-255,66,1764,33,240437
4138,3.4e-05,172.217.194.0-255,1484,3248,33,240437
4139,3.6e-05,172.31.33.0-255,66,3314,33,240437
4140,6.2e-05,172.217.194.0-255,1484,4798,33,240437
4141,6.5e-05,172.31.33.0-255,66,4864,33,240437
4142,6.7e-05,172.217.194.0-255,1484,6348,33,240437
4143,7.1e-05,172.31.33.0-255,66,6414,33,240437
4144,7.3e-05,172.217.194.0-255,4320,10734,33,240437
4145,7.4e-05,172.31.33.0-255,66,10800,33,240437
4146,0.0001,172.217.194.0-255,1484,12284,33,240437
4147,0.000102,172.31.33.0-255,66,12350,33,240437
4148,0.000107,172.217.194.0-255,4320,16670,33,240437
4149,0.00011,172.31.33.0-255,66,16736,33,240437
4150,0.000135,172.217.194.0-255,639,17375,33,240437
4151,0.000138,172.31.33.0-255,66,17441,33,240437
4152,0.000144,172.217.194.0-255,5738,23179,33,240437
4153,0.000146,172.31.33.0-255,66,23245,33,240437
4154,0.000182,172.217.194.0-255,7156,30401,33,240437
4155,0.000185,172.31.33.0-255,66,30467,33,240437
4156,0.000222,172.31.33.0-255,66,30533,33,240437
4157,0.00025,172.217.194.0-255,3602,34135,33,240437
4158,0.000254,172.31.33.0-255,66,34201,33,240437
4159,0.00135,172.217.194.0-255,1484,35685,33,240437
4160,0.001355,172.31.33.0-255,66,35751,33,240437
4161,0.001363,172.217.194.0-255,2902,38653,33,240437
4162,0.001365,172.31.33.0-255,66,38719,33,240437
4163,0.001374,172.217.194.0-255,5738,44457,33,240437
4164,0.001376,172.31.33.0-255,66,44523,33,240437
4165,0.001381,172.217.194.0-255,4320,48843,33,240437
4166,0.00143,172.217.194.0-255,2849,51692,33,240437
4167,0.001987,172.31.33.0-255,66,51758,33,240437
4168,0.00428,172.217.194.0-255,5738,57496,33,240437
4169,0.004285,172.31.33.0-255,66,57562,33,240437
4170,0.006591,172.217.194.0-255,5738,63300,33,240437
4171,0.006596,172.31.33.0-255,66,63366,33,240437
4172,0.008927,172.217.194.0-255,5738,69104,33,240437
4173,0.008935,172.31.33.0-255,66,69170,33,240437
4174,0.011245,172.217.194.0-255,5738,74908,33,240437
4175,0.01125,172.31.33.0-255,66,74974,33,240437
4176,0.013565,172.217.194.0-255,5738,80712,33,240437
4177,0.013574,172.31.33.0-255,66,80778,33,240437
4178,0.015876,172.217.194.0-255,5738,86516,33,240437
4179,0.015884,172.31.33.0-255,66,86582,33,240437
4180,0.018178,172.217.194.0-255,5738,92320,33,240437
4181,0.018185,172.31.33.0-255,66,92386,33,240437
4182,0.020471,172.217.194.0-255,5738,98124,33,240437
4183,0.020477,172.31.33.0-255,66,98190,33,240437
4184,0.022768,172.217.194.0-255,5738,103928,33,240437
4185,0.022775,172.31.33.0-255,66,103994,33,240437
4186,0.02451,172.31.33.0-255,172,104166,33,240437
4187,0.024535,172.31.33.0-255,1117,105283,33,240437
4188,0.024568,172.31.33.0-255,1514,106797,33,240437
4189,0.024569,172.31.33.0-255,1514,108311,33,240437
4190,0.02457,172.31.33.0-255,678,108989,33,240437
4191,0.025076,172.217.194.0-255,5738,114727,33,240437
4192,0.025082,172.31.33.0-255,66,114793,33,240437
4193,0.026171,104.244.42.0-255,66,114859,33,240437
4194,0.026214,104.244.42.0-255,66,114925,33,240437
4195,0.026216,104.244.42.0-255,66,114991,33,240437
4196,0.026219,104.244.42.0-255,66,115057,33,240437
4197,0.027371,172.217.194.0-255,5738,120795,33,240437
4198,0.027376,172.31.33.0-255,66,120861,33,240437
4199,0.029673,172.217.194.0-255,5738,126599,33,240437
4200,0.029679,172.31.33.0-255,66,126665,33,240437
4201,0.031977,172.217.194.0-255,5738,132403,33,240437
4202,0.031983,172.31.33.0-255,66,132469,33,240437
4203,0.034278,172.217.194.0-255,4320,136789,33,240437
4204,0.034283,172.31.33.0-255,66,136855,33,240437
4205,0.034309,172.217.194.0-255,1484,138339,33,240437
4206,0.036581,172.217.194.0-255,4320,142659,33,240437
4207,0.036585,172.31.33.0-255,66,142725,33,240437
4208,0.038873,172.217.194.0-255,4320,147045,33,240437
4209,0.038878,172.31.33.0-255,66,147111,33,240437
4210,0.038912,172.217.194.0-255,1484,148595,33,240437
4211,0.04118,172.217.194.0-255,4320,152915,33,240437
4212,0.041185,172.31.33.0-255,66,152981,33,240437
4213,0.043473,172.217.194.0-255,5738,158719,33,240437
4214,0.043477,172.31.33.0-255,66,158785,33,240437
4215,0.045784,172.217.194.0-255,4320,163105,33,240437
4216,0.045788,172.31.33.0-255,66,163171,33,240437
4217,0.045822,172.217.194.0-255,1484,164655,33,240437
4218,0.048081,172.217.194.0-255,4320,168975,33,240437
4219,0.048087,172.31.33.0-255,66,169041,33,240437
4220,0.050386,172.217.194.0-255,4320,173361,33,240437
4221,0.050391,172.31.33.0-255,66,173427,33,240437
4222,0.050418,172.217.194.0-255,1484,174911,33,240437
4223,0.052711,172.217.194.0-255,4320,179231,33,240437
4224,0.052715,172.31.33.0-255,66,179297,33,240437
4225,0.05501,172.217.194.0-255,5738,185035,33,240437
4226,0.055014,172.31.33.0-255,66,185101,33,240437
4227,0.05734,172.217.194.0-255,5738,190839,33,240437
4228,0.057344,172.31.33.0-255,66,190905,33,240437
4229,0.059662,172.217.194.0-255,5738,196643,33,240437
4230,0.059666,172.31.33.0-255,66,196709,33,240437
4231,0.061962,172.217.194.0-255,4320,201029,33,240437
4232,0.061967,172.31.33.0-255,66,201095,33,240437
4233,0.062,172.217.194.0-255,1484,202579,33,240437
4234,0.064265,172.217.194.0-255,4320,206899,33,240437
4235,0.064269,172.31.33.0-255,66,206965,33,240437
4236,0.066567,172.217.194.0-255,5738,212703,33,240437
4237,0.066572,172.31.33.0-255,66,212769,33,240437
4238,0.068871,172.217.194.0-255,5738,218507,33,240437
4239,0.068876,172.31.33.0-255,66,218573,33,240437
4240,0.071159,172.217.194.0-255,4320,222893,33,240437
4241,0.071164,172.31.33.0-255,66,222959,33,240437
4242,0.071188,172.217.194.0-255,1484,224443,33,240437
4243,0.073616,172.217.194.0-255,4320,228763,33,240437
4244,0.073621,172.31.33.0-255,66,228829,33,240437
4245,0.075924,172.217.194.0-255,5738,234567,33,240437
4246,0.075928,172.31.33.0-255,66,234633,33,240437
4247,0.078306,172.217.194.0-255,5738,240371,33,240437
4248,0.078314,172.31.33.0-255,66,240437,33,240437
4249,0.0,172.217.194.0-255,146,146,33,209810
4250,2.4e-05,172.31.33.0-255,66,212,33,209810
4251,2.9e-05,172.217.194.0-255,1484,1696,33,209810
4252,3.3e-05,172.31.33.0-255,66,1762,33,209810
4253,3.5e-05,172.217.194.0-255,1484,3246,33,209810
4254,3.8e-05,172.31.33.0-255,66,3312,33,209810
4255,5.9e-05,172.217.194.0-255,1484,4796,33,209810
4256,6.1e-05,172.31.33.0-255,66,4862,33,209810
4257,6.8e-05,172.217.194.0-255,7156,12018,33,209810
4258,7.6e-05,172.31.33.0-255,66,12084,33,209810
4259,8.6e-05,172.31.33.0-255,66,12150,33,209810
4260,0.000125,172.217.194.0-255,4320,16470,33,209810
4261,0.000127,172.31.33.0-255,66,16536,33,209810
4262,0.000153,172.217.194.0-255,6797,23333,33,209810
4263,0.000156,172.31.33.0-255,66,23399,33,209810
4264,0.000158,172.217.194.0-255,1484,24883,33,209810
4265,0.00016,172.31.33.0-255,66,24949,33,209810
4266,0.000193,172.217.194.0-255,2902,27851,33,209810
4267,0.000196,172.31.33.0-255,66,27917,33,209810
4268,0.000199,172.217.194.0-255,1484,29401,33,209810
4269,0.0002,172.31.33.0-255,66,29467,33,209810
4270,0.000224,172.217.194.0-255,4320,33787,33,209810
4271,0.000227,172.31.33.0-255,66,33853,33,209810
4272,0.000234,172.217.194.0-255,2902,36755,33,209810
4273,0.000236,172.31.33.0-255,66,36821,33,209810
4274,0.000287,172.217.194.0-255,1484,38305,33,209810
4275,0.00029,172.31.33.0-255,66,38371,33,209810
4276,0.000321,172.31.33.0-255,66,38437,33,209810
4277,0.000327,172.217.194.0-255,5738,44175,33,209810
4278,0.00033,172.31.33.0-255,66,44241,33,209810
4279,0.000354,172.217.194.0-255,5020,49261,33,209810
4280,0.000362,172.31.33.0-255,66,49327,33,209810
4281,0.000364,172.217.194.0-255,677,50004,33,209810
4282,0.000366,172.31.33.0-255,66,50070,33,209810
4283,0.000417,172.217.194.0-255,1484,51554,33,209810
4284,0.00042,172.31.33.0-255,66,51620,33,209810
4285,0.00045,172.217.194.0-255,2902,54522,33,209810
4286,0.000453,172.31.33.0-255,66,54588,33,209810
4287,0.000494,172.217.194.0-255,2902,57490,33,209810
4288,0.000497,172.31.33.0-255,66,57556,33,209810
4289,0.000519,172.217.194.0-255,2902,60458,33,209810
4290,0.000523,172.31.33.0-255,66,60524,33,209810
4291,0.000525,172.217.194.0-255,7156,67680,33,209810
4292,0.000527,172.31.33.0-255,66,67746,33,209810
4293,0.000561,172.31.33.0-255,66,67812,33,209810
4294,0.000581,172.217.194.0-255,5738,73550,33,209810
4295,0.000596,172.31.33.0-255,66,73616,33,209810
4296,0.000599,172.217.194.0-255,1484,75100,33,209810
4297,0.000631,172.217.194.0-255,766,75866,33,209810
4298,0.000639,172.31.33.0-255,66,75932,33,209810
4299,0.000689,172.217.194.0-255,1484,77416,33,209810
4300,0.000708,172.217.194.0-255,1484,78900,33,209810
4301,0.000713,172.31.33.0-255,66,78966,33,209810
4302,0.000718,172.217.194.0-255,1484,80450,33,209810
4303,0.000721,172.217.194.0-255,1484,81934,33,209810
4304,0.000726,172.31.33.0-255,66,82000,33,209810
4305,0.000745,172.217.194.0-255,4320,86320,33,209810
4306,0.000748,172.31.33.0-255,66,86386,33,209810
4307,0.000751,172.217.194.0-255,2902,89288,33,209810
4308,0.000768,172.31.33.0-255,66,89354,33,209810
4309,0.000787,172.217.194.0-255,1484,90838,33,209810
4310,0.000789,172.31.33.0-255,66,90904,33,209810
4311,0.000826,172.31.33.0-255,66,90970,33,209810
4312,0.000882,172.217.194.0-255,1484,92454,33,209810
4313,0.000887,172.217.194.0-255,2902,95356,33,209810
4314,0.000892,172.217.194.0-255,4320,99676,33,209810
4315,0.000898,172.31.33.0-255,66,99742,33,209810
4316,0.000904,172.217.194.0-255,1484,101226,33,209810
4317,0.000925,172.217.194.0-255,4320,105546,33,209810
4318,0.000928,172.31.33.0-255,66,105612,33,209810
4319,0.000956,172.31.33.0-255,66,105678,33,209810
4320,0.000967,172.31.33.0-255,66,105744,33,209810
4321,0.001001,172.217.194.0-255,5738,111482,33,209810
4322,0.001013,172.31.33.0-255,66,111548,33,209810
4323,0.001029,172.31.33.0-255,66,111614,33,209810
4324,0.001055,172.217.194.0-255,7156,118770,33,209810
4325,0.001059,172.31.33.0-255,66,118836,33,209810
4326,0.001067,172.217.194.0-255,766,119602,33,209810
4327,0.001188,172.217.194.0-255,1484,121086,33,209810
4328,0.001192,172.31.33.0-255,66,121152,33,209810
4329,0.001208,172.217.194.0-255,2902,124054,33,209810
4330,0.001211,172.31.33.0-255,66,124120,33,209810
4331,0.001223,172.217.194.0-255,1484,125604,33,209810
4332,0.001244,172.217.194.0-255,4320,129924,33,209810
4333,0.001249,172.217.194.0-255,4320,134244,33,209810
4334,0.001249,172.31.33.0-255,66,134310,33,209810
4335,0.001252,172.31.33.0-255,66,134376,33,209810
4336,0.001285,172.217.194.0-255,4320,138696,33,209810
4337,0.001291,172.31.33.0-255,66,138762,33,209810
4338,0.001301,172.31.33.0-255,66,138828,33,209810
4339,0.001303,172.217.194.0-255,5020,143848,33,209810
4340,0.001312,172.31.33.0-255,66,143914,33,209810
4341,0.001387,172.217.194.0-255,1484,145398,33,209810
4342,0.00139,172.217.194.0-255,1484,146882,33,209810
4343,0.001392,172.31.33.0-255,66,146948,33,209810
4344,0.001422,172.217.194.0-255,1484,148432,33,209810
4345,0.001428,172.217.194.0-255,5738,154170,33,209810
4346,0.001434,172.31.33.0-255,66,154236,33,209810
4347,0.001445,172.31.33.0-255,66,154302,33,209810
4348,0.001457,172.217.194.0-255,4320,158622,33,209810
4349,0.001464,172.217.194.0-255,7156,165778,33,209810
4350,0.001467,172.31.33.0-255,66,165844,33,209810
4351,0.001476,172.31.33.0-255,66,165910,33,209810
4352,0.001503,172.217.194.0-255,2902,168812,33,209810
4353,0.001507,172.31.33.0-255,66,168878,33,209810
4354,0.001529,172.31.33.0-255,66,168944,33,209810
4355,0.001553,172.217.194.0-255,2902,171846,33,209810
4356,0.001558,172.31.33.0-255,66,171912,33,209810
4357,0.001585,172.31.33.0-255,66,171978,33,209810
4358,0.001618,172.31.33.0-255,66,172044,33,209810
4359,0.001634,172.217.194.0-255,2902,174946,33,209810
4360,0.001641,172.31.33.0-255,66,175012,33,209810
4361,0.001656,172.217.194.0-255,3602,178614,33,209810
4362,0.001662,172.31.33.0-255,66,178680,33,209810
4363,0.001688,172.217.194.0-255,1484,180164,33,209810
4364,0.001715,172.31.33.0-255,66,180230,33,209810
4365,0.001726,172.217.194.0-255,5738,185968,33,209810
4366,0.001734,172.31.33.0-255,66,186034,33,209810
4367,0.001736,172.217.194.0-255,5738,191772,33,209810
4368,0.001747,172.31.33.0-255,66,191838,33,209810
4369,0.00177,172.217.194.0-255,7156,198994,33,209810
4370,0.001775,172.31.33.0-255,66,199060,33,209810
4371,0.001805,172.31.33.0-255,66,199126,33,209810
4372,0.001833,172.217.194.0-255,5020,204146,33,209810
4373,0.001839,172.31.33.0-255,66,204212,33,209810
4374,0.001843,172.217.194.0-255,105,204317,33,209810
4375,0.001852,172.31.33.0-255,66,204383,33,209810
4376,0.007046,172.31.33.0-255,105,204488,33,209810
4377,0.009346,172.217.194.0-255,66,204554,33,209810
4378,0.024447,172.31.33.0-255,171,204725,33,209810
4379,0.024479,172.31.33.0-255,1137,205862,33,209810
4380,0.02451,172.31.33.0-255,1514,207376,33,209810
4381,0.024511,172.31.33.0-255,1514,208890,33,209810
4382,0.024512,172.31.33.0-255,656,209546,33,209810
4383,0.026008,104.244.42.0-255,66,209612,33,209810
4384,0.026026,104.244.42.0-255,66,209678,33,209810
4385,0.026079,104.244.42.0-255,66,209744,33,209810
4386,0.026081,104.244.42.0-255,66,209810,33,209810
4387,0.0,74.125.200.0-255,153,153,33,375338
4388,2.4e-05,172.31.33.0-255,66,219,33,375338
4389,3.1e-05,74.125.200.0-255,1484,1703,33,375338
4390,3.6e-05,172.31.33.0-255,66,1769,33,375338
4391,5.2e-05,74.125.200.0-255,2902,4671,33,375338
4392,5.6e-05,172.31.33.0-255,66,4737,33,375338
4393,6.4e-05,74.125.200.0-255,7156,11893,33,375338
4394,6.7e-05,172.31.33.0-255,66,11959,33,375338
4395,7.1e-05,74.125.200.0-255,2078,14037,33,375338
4396,7.4e-05,172.31.33.0-255,66,14103,33,375338
4397,0.000173,74.125.200.0-255,1484,15587,33,375338
4398,0.000177,172.31.33.0-255,66,15653,33,375338
4399,0.000203,74.125.200.0-255,2902,18555,33,375338
4400,0.000208,172.31.33.0-255,66,18621,33,375338
4401,0.000214,74.125.200.0-255,5738,24359,33,375338
4402,0.000217,172.31.33.0-255,66,24425,33,375338
4403,0.000229,74.125.200.0-255,6797,31222,33,375338
4404,0.000231,172.31.33.0-255,66,31288,33,375338
4405,0.000236,74.125.200.0-255,4320,35608,33,375338
4406,0.000238,172.31.33.0-255,66,35674,33,375338
4407,0.000265,74.125.200.0-255,2902,38576,33,375338
4408,0.000267,172.31.33.0-255,66,38642,33,375338
4409,0.000272,74.125.200.0-255,2902,41544,33,375338
4410,0.000275,172.31.33.0-255,66,41610,33,375338
4411,0.000302,74.125.200.0-255,5738,47348,33,375338
4412,0.000305,172.31.33.0-255,66,47414,33,375338
4413,0.000309,74.125.200.0-255,2902,50316,33,375338
4414,0.00031,172.31.33.0-255,66,50382,33,375338
4415,0.000315,74.125.200.0-255,4320,54702,33,375338
4416,0.000318,172.31.33.0-255,66,54768,33,375338
4417,0.000358,172.31.33.0-255,66,54834,33,375338
4418,0.000401,74.125.200.0-255,2184,57018,33,375338
4419,0.000404,172.31.33.0-255,66,57084,33,375338
4420,0.000408,74.125.200.0-255,392,57476,33,375338
4421,0.000509,74.125.200.0-255,352,57828,33,375338
4422,0.000608,74.125.200.0-255,1484,59312,33,375338
4423,0.000613,172.31.33.0-255,66,59378,33,375338
4424,0.000619,74.125.200.0-255,2902,62280,33,375338
4425,0.000621,172.31.33.0-255,66,62346,33,375338
4426,0.000642,74.125.200.0-255,2902,65248,33,375338
4427,0.000645,172.31.33.0-255,66,65314,33,375338
4428,0.000665,74.125.200.0-255,1484,66798,33,375338
4429,0.000695,74.125.200.0-255,5738,72536,33,375338
4430,0.000699,172.31.33.0-255,66,72602,33,375338
4431,0.000706,74.125.200.0-255,7156,79758,33,375338
4432,0.000709,172.31.33.0-255,66,79824,33,375338
4433,0.000732,74.125.200.0-255,4320,84144,33,375338
4434,0.000735,172.31.33.0-255,66,84210,33,375338
4435,0.000745,74.125.200.0-255,4320,88530,33,375338
4436,0.000747,172.31.33.0-255,66,88596,33,375338
4437,0.000752,74.125.200.0-255,3602,92198,33,375338
4438,0.000754,172.31.33.0-255,66,92264,33,375338
4439,0.001256,74.125.200.0-255,1484,93748,33,375338
4440,0.00126,74.125.200.0-255,1484,95232,33,375338
4441,0.001271,172.31.33.0-255,66,95298,33,375338
4442,0.001276,74.125.200.0-255,1484,96782,33,375338
4443,0.001304,74.125.200.0-255,5738,102520,33,375338
4444,0.001307,172.31.33.0-255,66,102586,33,375338
4445,0.001312,74.125.200.0-255,2902,105488,33,375338
4446,0.001313,172.31.33.0-255,66,105554,33,375338
4447,0.001319,74.125.200.0-255,4320,109874,33,375338
4448,0.001321,172.31.33.0-255,66,109940,33,375338
4449,0.001326,74.125.200.0-255,4320,114260,33,375338
4450,0.001329,172.31.33.0-255,66,114326,33,375338
4451,0.001364,74.125.200.0-255,4320,118646,33,375338
4452,0.001367,172.31.33.0-255,66,118712,33,375338
4453,0.001374,74.125.200.0-255,7156,125868,33,375338
4454,0.001376,172.31.33.0-255,66,125934,33,375338
4455,0.001379,74.125.200.0-255,766,126700,33,375338
4456,0.001885,172.31.33.0-255,66,126766,33,375338
4457,0.001944,74.125.200.0-255,1484,128250,33,375338
4458,0.001958,74.125.200.0-255,2902,131152,33,375338
4459,0.001961,172.31.33.0-255,66,131218,33,375338
4460,0.001967,74.125.200.0-255,4320,135538,33,375338
4461,0.00197,172.31.33.0-255,66,135604,33,375338
4462,0.001989,74.125.200.0-255,1484,137088,33,375338
4463,0.002021,172.31.33.0-255,66,137154,33,375338
4464,0.002059,74.125.200.0-255,4320,141474,33,375338
4465,0.002062,172.31.33.0-255,66,141540,33,375338
4466,0.002083,74.125.200.0-255,6438,147978,33,375338
4467,0.002086,172.31.33.0-255,66,148044,33,375338
4468,0.002165,74.125.200.0-255,1484,149528,33,375338
4469,0.002179,74.125.200.0-255,2902,152430,33,375338
4470,0.002182,172.31.33.0-255,66,152496,33,375338
4471,0.002217,74.125.200.0-255,5738,158234,33,375338
4472,0.00222,172.31.33.0-255,66,158300,33,375338
4473,0.002224,74.125.200.0-255,2902,161202,33,375338
4474,0.002226,172.31.33.0-255,66,161268,33,375338
4475,0.002231,74.125.200.0-255,4320,165588,33,375338
4476,0.002233,172.31.33.0-255,66,165654,33,375338
4477,0.002239,74.125.200.0-255,5738,171392,33,375338
4478,0.002242,172.31.33.0-255,66,171458,33,375338
4479,0.002274,74.125.200.0-255,2902,174360,33,375338
4480,0.002276,172.31.33.0-255,66,174426,33,375338
4481,0.002283,74.125.200.0-255,5738,180164,33,375338
4482,0.002285,172.31.33.0-255,66,180230,33,375338
4483,0.002314,74.125.200.0-255,2184,182414,33,375338
4484,0.002317,172.31.33.0-255,66,182480,33,375338
4485,0.002452,74.125.200.0-255,1484,183964,33,375338
4486,0.002469,74.125.200.0-255,2902,186866,33,375338
4487,0.002472,172.31.33.0-255,66,186932,33,375338
4488,0.002505,74.125.200.0-255,5738,192670,33,375338
4489,0.002508,172.31.33.0-255,66,192736,33,375338
4490,0.002514,74.125.200.0-255,4320,197056,33,375338
4491,0.002516,172.31.33.0-255,66,197122,33,375338
4492,0.002542,74.125.200.0-255,5738,202860,33,375338
4493,0.002545,172.31.33.0-255,66,202926,33,375338
4494,0.002558,172.31.33.0-255,66,202992,33,375338
4495,0.005107,74.125.200.0-255,5738,208730,33,375338
4496,0.005114,172.31.33.0-255,66,208796,33,375338
4497,0.007651,74.125.200.0-255,5738,214534,33,375338
4498,0.007655,172.31.33.0-255,66,214600,33,375338
4499,0.010185,74.125.200.0-255,5738,220338,33,375338
4500,0.010194,172.31.33.0-255,66,220404,33,375338
4501,0.012717,74.125.200.0-255,5738,226142,33,375338
4502,0.012729,172.31.33.0-255,66,226208,33,375338
4503,0.015252,74.125.200.0-255,5738,231946,33,375338
4504,0.015261,172.31.33.0-255,66,232012,33,375338
4505,0.017784,74.125.200.0-255,5738,237750,33,375338
4506,0.017794,172.31.33.0-255,66,237816,33,375338
4507,0.020338,74.125.200.0-255,5738,243554,33,375338
4508,0.02035,172.31.33.0-255,66,243620,33,375338
4509,0.022889,74.125.200.0-255,5738,249358,33,375338
4510,0.022908,172.31.33.0-255,66,249424,33,375338
4511,0.025446,74.125.200.0-255,5738,255162,33,375338
4512,0.025454,172.31.33.0-255,66,255228,33,375338
4513,0.027979,74.125.200.0-255,5738,260966,33,375338
4514,0.027987,172.31.33.0-255,66,261032,33,375338
4515,0.030511,74.125.200.0-255,5738,266770,33,375338
4516,0.03052,172.31.33.0-255,66,266836,33,375338
4517,0.033073,74.125.200.0-255,5738,272574,33,375338
4518,0.033092,172.31.33.0-255,66,272640,33,375338
4519,0.035624,74.125.200.0-255,5738,278378,33,375338
4520,0.035632,172.31.33.0-255,66,278444,33,375338
4521,0.038156,74.125.200.0-255,5738,284182,33,375338
4522,0.038164,172.31.33.0-255,66,284248,33,375338
4523,0.038716,172.31.33.0-255,172,284420,33,375338
4524,0.038746,172.31.33.0-255,1117,285537,33,375338
4525,0.038807,172.31.33.0-255,1514,287051,33,375338
4526,0.038809,172.31.33.0-255,1280,288331,33,375338
4527,0.040288,104.244.42.0-255,66,288397,33,375338
4528,0.040296,104.244.42.0-255,66,288463,33,375338
4529,0.040384,104.244.42.0-255,66,288529,33,375338
4530,0.040677,74.125.200.0-255,5738,294267,33,375338
4531,0.040687,172.31.33.0-255,66,294333,33,375338
4532,0.043226,74.125.200.0-255,5738,300071,33,375338
4533,0.043243,172.31.33.0-255,66,300137,33,375338
4534,0.045769,74.125.200.0-255,5738,305875,33,375338
4535,0.045778,172.31.33.0-255,66,305941,33,375338
4536,0.048313,74.125.200.0-255,5738,311679,33,375338
4537,0.048328,172.31.33.0-255,66,311745,33,375338
4538,0.050851,74.125.200.0-255,5738,317483,33,375338
4539,0.050862,172.31.33.0-255,66,317549,33,375338
4540,0.053378,74.125.200.0-255,5738,323287,33,375338
4541,0.053385,172.31.33.0-255,66,323353,33,375338
4542,0.055908,74.125.200.0-255,5738,329091,33,375338
4543,0.055916,172.31.33.0-255,66,329157,33,375338
4544,0.058453,74.125.200.0-255,5738,334895,33,375338
4545,0.05846,172.31.33.0-255,66,334961,33,375338
4546,0.060986,74.125.200.0-255,5738,340699,33,375338
4547,0.060994,172.31.33.0-255,66,340765,33,375338
4548,0.063516,74.125.200.0-255,5738,346503,33,375338
4549,0.063524,172.31.33.0-255,66,346569,33,375338
4550,0.066054,74.125.200.0-255,5738,352307,33,375338
4551,0.066063,172.31.33.0-255,66,352373,33,375338
4552,0.06859,74.125.200.0-255,5738,358111,33,375338
4553,0.068598,172.31.33.0-255,66,358177,33,375338
4554,0.07115,74.125.200.0-255,5738,363915,33,375338
4555,0.071156,172.31.33.0-255,66,363981,33,375338
4556,0.073679,74.125.200.0-255,5738,369719,33,375338
4557,0.073686,172.31.33.0-255,66,369785,33,375338
4558,0.076221,74.125.200.0-255,5316,375101,33,375338
4559,0.076232,172.31.33.0-255,66,375167,33,375338
4560,0.076472,172.31.33.0-255,105,375272,33,375338
4561,0.078978,74.125.200.0-255,66,375338,33,375338
4562,0.0,172.217.194.0-255,156,156,33,365837
4563,2.4e-05,172.31.33.0-255,66,222,33,365837
4564,3.1e-05,172.217.194.0-255,1484,1706,33,365837
4565,3.4e-05,172.31.33.0-255,66,1772,33,365837
4566,4e-05,172.217.194.0-255,2902,4674,33,365837
4567,4.3e-05,172.31.33.0-255,66,4740,33,365837
4568,4.8e-05,172.217.194.0-255,4320,9060,33,365837
4569,5e-05,172.31.33.0-255,66,9126,33,365837
4570,7.8e-05,172.217.194.0-255,2902,12028,33,365837
4571,8e-05,172.31.33.0-255,66,12094,33,365837
4572,8.4e-05,172.217.194.0-255,2059,14153,33,365837
4573,8.6e-05,172.31.33.0-255,66,14219,33,365837
4574,0.000214,172.217.194.0-255,1484,15703,33,365837
4575,0.000218,172.31.33.0-255,66,15769,33,365837
4576,0.000223,172.217.194.0-255,2902,18671,33,365837
4577,0.000225,172.31.33.0-255,66,18737,33,365837
4578,0.000228,172.217.194.0-255,1484,20221,33,365837
4579,0.00023,172.31.33.0-255,66,20287,33,365837
4580,0.000254,172.217.194.0-255,4320,24607,33,365837
4581,0.000257,172.31.33.0-255,66,24673,33,365837
4582,0.00027,172.217.194.0-255,2902,27575,33,365837
4583,0.000272,172.31.33.0-255,66,27641,33,365837
4584,0.000285,172.217.194.0-255,3961,31602,33,365837
4585,0.000288,172.31.33.0-255,66,31668,33,365837
4586,0.000337,172.217.194.0-255,1484,33152,33,365837
4587,0.00034,172.31.33.0-255,66,33218,33,365837
4588,0.000354,172.217.194.0-255,2902,36120,33,365837
4589,0.000357,172.31.33.0-255,66,36186,33,365837
4590,0.000377,172.217.194.0-255,5738,41924,33,365837
4591,0.00038,172.31.33.0-255,66,41990,33,365837
4592,0.000402,172.217.194.0-255,1484,43474,33,365837
4593,0.000404,172.31.33.0-255,66,43540,33,365837
4594,0.000434,172.31.33.0-255,66,43606,33,365837
4595,0.000445,172.31.33.0-255,66,43672,33,365837
4596,0.000447,172.217.194.0-255,676,44348,33,365837
4597,0.000507,172.217.194.0-255,1484,45832,33,365837
4598,0.00051,172.31.33.0-255,66,45898,33,365837
4599,0.000528,172.217.194.0-255,2902,48800,33,365837
4600,0.00053,172.31.33.0-255,66,48866,33,365837
4601,0.000535,172.217.194.0-255,5738,54604,33,365837
4602,0.000537,172.31.33.0-255,66,54670,33,365837
4603,0.00056,172.217.194.0-255,1484,56154,33,365837
4604,0.000574,172.217.194.0-255,4831,60985,33,365837
4605,0.000577,172.31.33.0-255,66,61051,33,365837
4606,0.001709,172.217.194.0-255,1484,62535,33,365837
4607,0.001718,172.217.194.0-255,2902,65437,33,365837
4608,0.001721,172.31.33.0-255,66,65503,33,365837
4609,0.001727,172.217.194.0-255,4320,69823,33,365837
4610,0.001728,172.31.33.0-255,66,69889,33,365837
4611,0.001749,172.217.194.0-255,1484,71373,33,365837
4612,0.001755,172.217.194.0-255,6797,78170,33,365837
4613,0.001757,172.31.33.0-255,66,78236,33,365837
4614,0.001817,172.217.194.0-255,1484,79720,33,365837
4615,0.001833,172.217.194.0-255,2902,82622,33,365837
4616,0.001835,172.31.33.0-255,66,82688,33,365837
4617,0.001839,172.217.194.0-255,2902,85590,33,365837
4618,0.00184,172.31.33.0-255,66,85656,33,365837
4619,0.001855,172.217.194.0-255,2902,88558,33,365837
4620,0.001856,172.31.33.0-255,66,88624,33,365837
4621,0.001861,172.217.194.0-255,4320,92944,33,365837
4622,0.001862,172.31.33.0-255,66,93010,33,365837
4623,0.001892,172.31.33.0-255,66,93076,33,365837
4624,0.00191,172.217.194.0-255,7156,100232,33,365837
4625,0.001912,172.31.33.0-255,66,100298,33,365837
4626,0.001924,172.217.194.0-255,3602,103900,33,365837
4627,0.001925,172.31.33.0-255,66,103966,33,365837
4628,0.002206,172.217.194.0-255,1484,105450,33,365837
4629,0.002224,172.217.194.0-255,2902,108352,33,365837
4630,0.002226,172.31.33.0-255,66,108418,33,365837
4631,0.002246,172.217.194.0-255,5738,114156,33,365837
4632,0.002248,172.31.33.0-255,66,114222,33,365837
4633,0.002254,172.217.194.0-255,5738,119960,33,365837
4634,0.002255,172.31.33.0-255,66,120026,33,365837
4635,0.002264,172.217.194.0-255,1484,121510,33,365837
4636,0.002275,172.217.194.0-255,2902,124412,33,365837
4637,0.002276,172.31.33.0-255,66,124478,33,365837
4638,0.002286,172.217.194.0-255,1484,125962,33,365837
4639,0.002305,172.31.33.0-255,66,126028,33,365837
4640,0.002315,172.217.194.0-255,1484,127512,33,365837
4641,0.002318,172.217.194.0-255,2184,129696,33,365837
4642,0.00232,172.31.33.0-255,66,129762,33,365837
4643,0.002351,172.217.194.0-255,2902,132664,33,365837
4644,0.002352,172.31.33.0-255,66,132730,33,365837
4645,0.002355,172.217.194.0-255,1484,134214,33,365837
4646,0.002375,172.217.194.0-255,2902,137116,33,365837
4647,0.002377,172.31.33.0-255,66,137182,33,365837
4648,0.002381,172.217.194.0-255,2902,140084,33,365837
4649,0.002382,172.31.33.0-255,66,140150,33,365837
4650,0.002395,172.217.194.0-255,4320,144470,33,365837
4651,0.002397,172.31.33.0-255,66,144536,33,365837
4652,0.002406,172.217.194.0-255,1484,146020,33,365837
4653,0.002436,172.31.33.0-255,66,146086,33,365837
4654,0.002456,172.217.194.0-255,7156,153242,33,365837
4655,0.002457,172.31.33.0-255,66,153308,33,365837
4656,0.002468,172.217.194.0-255,2184,155492,33,365837
4657,0.002469,172.31.33.0-255,66,155558,33,365837
4658,0.002474,172.217.194.0-255,4320,159878,33,365837
4659,0.002475,172.31.33.0-255,66,159944,33,365837
4660,0.002479,172.217.194.0-255,4320,164264,33,365837
4661,0.002481,172.31.33.0-255,66,164330,33,365837
4662,0.002491,172.217.194.0-255,1484,165814,33,365837
4663,0.002495,172.217.194.0-255,4320,170134,33,365837
4664,0.002497,172.31.33.0-255,66,170200,33,365837
4665,0.002516,172.217.194.0-255,7156,177356,33,365837
4666,0.002518,172.31.33.0-255,66,177422,33,365837
4667,0.00252,172.217.194.0-255,1484,178906,33,365837
4668,0.004975,172.217.194.0-255,4320,183226,33,365837
4669,0.004978,172.31.33.0-255,66,183292,33,365837
4670,0.007453,172.217.194.0-255,5738,189030,33,365837
4671,0.007458,172.31.33.0-255,66,189096,33,365837
4672,0.009914,172.217.194.0-255,5738,194834,33,365837
4673,0.009921,172.31.33.0-255,66,194900,33,365837
4674,0.012418,172.217.194.0-255,5738,200638,33,365837
4675,0.01243,172.31.33.0-255,66,200704,33,365837
4676,0.014946,172.217.194.0-255,5738,206442,33,365837
4677,0.014955,172.31.33.0-255,66,206508,33,365837
4678,0.017421,172.217.194.0-255,5738,212246,33,365837
4679,0.017427,172.31.33.0-255,66,212312,33,365837
4680,0.019884,172.217.194.0-255,5738,218050,33,365837
4681,0.01989,172.31.33.0-255,66,218116,33,365837
4682,0.022348,172.217.194.0-255,5738,223854,33,365837
4683,0.022355,172.31.33.0-255,66,223920,33,365837
4684,0.024553,172.31.33.0-255,171,224091,33,365837
4685,0.024611,172.31.33.0-255,1141,225232,33,365837
4686,0.024717,172.31.33.0-255,1514,226746,33,365837
4687,0.024719,172.31.33.0-255,1514,228260,33,365837
4688,0.024742,172.31.33.0-255,652,228912,33,365837
4689,0.024854,172.217.194.0-255,2902,231814,33,365837
4690,0.02486,172.31.33.0-255,66,231880,33,365837
4691,0.024892,172.217.194.0-255,2902,234782,33,365837
4692,0.024895,172.31.33.0-255,66,234848,33,365837
4693,0.026196,104.244.42.0-255,66,234914,33,365837
4694,0.026293,104.244.42.0-255,66,234980,33,365837
4695,0.026396,104.244.42.0-255,66,235046,33,365837
4696,0.026399,104.244.42.0-255,66,235112,33,365837
4697,0.027311,172.217.194.0-255,2902,238014,33,365837
4698,0.027314,172.31.33.0-255,66,238080,33,365837
4699,0.027412,172.217.194.0-255,2902,240982,33,365837
4700,0.027417,172.31.33.0-255,66,241048,33,365837
4701,0.029778,172.217.194.0-255,2902,243950,33,365837
4702,0.029783,172.31.33.0-255,66,244016,33,365837
4703,0.029868,172.217.194.0-255,2902,246918,33,365837
4704,0.029872,172.31.33.0-255,66,246984,33,365837
4705,0.032246,172.217.194.0-255,2902,249886,33,365837
4706,0.032251,172.31.33.0-255,66,249952,33,365837
4707,0.0323,172.217.194.0-255,1484,251436,33,365837
4708,0.032324,172.217.194.0-255,1484,252920,33,365837
4709,0.032327,172.31.33.0-255,66,252986,33,365837
4710,0.034702,172.217.194.0-255,2902,255888,33,365837
4711,0.034708,172.31.33.0-255,66,255954,33,365837
4712,0.03478,172.217.194.0-255,1484,257438,33,365837
4713,0.034798,172.217.194.0-255,1484,258922,33,365837
4714,0.034803,172.31.33.0-255,66,258988,33,365837
4715,0.037159,172.217.194.0-255,2902,261890,33,365837
4716,0.037165,172.31.33.0-255,66,261956,33,365837
4717,0.037249,172.217.194.0-255,2902,264858,33,365837
4718,0.037254,172.31.33.0-255,66,264924,33,365837
4719,0.039647,172.217.194.0-255,2902,267826,33,365837
4720,0.039653,172.31.33.0-255,66,267892,33,365837
4721,0.039713,172.217.194.0-255,1484,269376,33,365837
4722,0.039726,172.217.194.0-255,1484,270860,33,365837
4723,0.03973,172.31.33.0-255,66,270926,33,365837
4724,0.042105,172.217.194.0-255,2902,273828,33,365837
4725,0.042109,172.31.33.0-255,66,273894,33,365837
4726,0.042214,172.217.194.0-255,2902,276796,33,365837
4727,0.042219,172.31.33.0-255,66,276862,33,365837
4728,0.044572,172.217.194.0-255,2902,279764,33,365837
4729,0.044578,172.31.33.0-255,66,279830,33,365837
4730,0.044699,172.217.194.0-255,2902,282732,33,365837
4731,0.044704,172.31.33.0-255,66,282798,33,365837
4732,0.047053,172.217.194.0-255,2902,285700,33,365837
4733,0.047058,172.31.33.0-255,66,285766,33,365837
4734,0.047164,172.217.194.0-255,2902,288668,33,365837
4735,0.047168,172.31.33.0-255,66,288734,33,365837
4736,0.049544,172.217.194.0-255,2902,291636,33,365837
4737,0.04955,172.31.33.0-255,66,291702,33,365837
4738,0.049627,172.217.194.0-255,2902,294604,33,365837
4739,0.049633,172.31.33.0-255,66,294670,33,365837
4740,0.052044,172.217.194.0-255,2902,297572,33,365837
4741,0.052049,172.31.33.0-255,66,297638,33,365837
4742,0.052121,172.217.194.0-255,2902,300540,33,365837
4743,0.052125,172.31.33.0-255,66,300606,33,365837
4744,0.054512,172.217.194.0-255,2902,303508,33,365837
4745,0.054517,172.31.33.0-255,66,303574,33,365837
4746,0.054574,172.217.194.0-255,2902,306476,33,365837
4747,0.054579,172.31.33.0-255,66,306542,33,365837
4748,0.056992,172.217.194.0-255,2902,309444,33,365837
4749,0.056997,172.31.33.0-255,66,309510,33,365837
4750,0.057032,172.217.194.0-255,2902,312412,33,365837
4751,0.057035,172.31.33.0-255,66,312478,33,365837
4752,0.059451,172.217.194.0-255,2902,315380,33,365837
4753,0.059456,172.31.33.0-255,66,315446,33,365837
4754,0.059481,172.217.194.0-255,2902,318348,33,365837
4755,0.059483,172.31.33.0-255,66,318414,33,365837
4756,0.061893,172.217.194.0-255,1484,319898,33,365837
4757,0.061942,172.217.194.0-255,1484,321382,33,365837
4758,0.061947,172.31.33.0-255,66,321448,33,365837
4759,0.061966,172.217.194.0-255,2902,324350,33,365837
4760,0.061969,172.31.33.0-255,66,324416,33,365837
4761,0.064449,172.217.194.0-255,2902,327318,33,365837
4762,0.064456,172.31.33.0-255,66,327384,33,365837
4763,0.064477,172.217.194.0-255,2902,330286,33,365837
4764,0.06448,172.31.33.0-255,66,330352,33,365837
4765,0.066899,172.217.194.0-255,2902,333254,33,365837
4766,0.066904,172.31.33.0-255,66,333320,33,365837
4767,0.066936,172.217.194.0-255,2902,336222,33,365837
4768,0.066938,172.31.33.0-255,66,336288,33,365837
4769,0.069355,172.217.194.0-255,1484,337772,33,365837
4770,0.06938,172.217.194.0-255,1484,339256,33,365837
4771,0.069384,172.31.33.0-255,66,339322,33,365837
4772,0.069437,172.217.194.0-255,2902,342224,33,365837
4773,0.06944,172.31.33.0-255,66,342290,33,365837
4774,0.071864,172.217.194.0-255,2902,345192,33,365837
4775,0.071868,172.31.33.0-255,66,345258,33,365837
4776,0.071913,172.217.194.0-255,2902,348160,33,365837
4777,0.071916,172.31.33.0-255,66,348226,33,365837
4778,0.074361,172.217.194.0-255,1484,349710,33,365837
4779,0.074386,172.217.194.0-255,1484,351194,33,365837
4780,0.07439,172.31.33.0-255,66,351260,33,365837
4781,0.074408,172.217.194.0-255,1484,352744,33,365837
4782,0.074421,172.217.194.0-255,1484,354228,33,365837
4783,0.074424,172.31.33.0-255,66,354294,33,365837
4784,0.076833,172.217.194.0-255,2902,357196,33,365837
4785,0.076838,172.31.33.0-255,66,357262,33,365837
4786,0.076879,172.217.194.0-255,2902,360164,33,365837
4787,0.076882,172.31.33.0-255,66,360230,33,365837
4788,0.079285,172.217.194.0-255,2902,363132,33,365837
4789,0.07929,172.31.33.0-255,66,363198,33,365837
4790,0.07932,172.217.194.0-255,2468,365666,33,365837
4791,0.079323,172.31.33.0-255,66,365732,33,365837
4792,0.079443,172.31.33.0-255,105,365837,33,365837
4793,0.0,172.217.194.0-255,149,149,33,184002
4794,1.7e-05,172.31.33.0-255,66,215,33,184002
4795,2.3e-05,172.217.194.0-255,1484,1699,33,184002
4796,2.7e-05,172.31.33.0-255,66,1765,33,184002
4797,3.2e-05,172.217.194.0-255,2902,4667,33,184002
4798,3.5e-05,172.31.33.0-255,66,4733,33,184002
4799,4.8e-05,172.217.194.0-255,7156,11889,33,184002
4800,5.1e-05,172.31.33.0-255,66,11955,33,184002
4801,6.2e-05,172.31.33.0-255,66,12021,33,184002
4802,0.000127,172.31.33.0-255,66,12087,33,184002
4803,0.000277,172.217.194.0-255,1484,13571,33,184002
4804,0.000282,172.31.33.0-255,66,13637,33,184002
4805,0.000287,172.217.194.0-255,2902,16539,33,184002
4806,0.000289,172.31.33.0-255,66,16605,33,184002
4807,0.000317,172.217.194.0-255,2902,19507,33,184002
4808,0.000319,172.31.33.0-255,66,19573,33,184002
4809,0.000322,172.217.194.0-255,1484,21057,33,184002
4810,0.000324,172.31.33.0-255,66,21123,33,184002
4811,0.000355,172.217.194.0-255,2902,24025,33,184002
4812,0.000357,172.31.33.0-255,66,24091,33,184002
4813,0.000363,172.217.194.0-255,5379,29470,33,184002
4814,0.000365,172.31.33.0-255,66,29536,33,184002
4815,0.000375,172.217.194.0-255,5738,35274,33,184002
4816,0.000377,172.31.33.0-255,66,35340,33,184002
4817,0.000413,172.31.33.0-255,66,35406,33,184002
4818,0.000432,172.217.194.0-255,2835,38241,33,184002
4819,0.000433,172.31.33.0-255,66,38307,33,184002
4820,0.000436,172.217.194.0-255,364,38671,33,184002
4821,0.000438,172.31.33.0-255,66,38737,33,184002
4822,0.000479,172.217.194.0-255,1484,40221,33,184002
4823,0.000501,172.217.194.0-255,2902,43123,33,184002
4824,0.000504,172.31.33.0-255,66,43189,33,184002
4825,0.00052,172.217.194.0-255,1484,44673,33,184002
4826,0.000535,172.217.194.0-255,2902,47575,33,184002
4827,0.000537,172.31.33.0-255,66,47641,33,184002
4828,0.000547,172.31.33.0-255,66,47707,33,184002
4829,0.000572,172.31.33.0-255,66,47773,33,184002
4830,0.000601,172.217.194.0-255,6438,54211,33,184002
4831,0.000604,172.31.33.0-255,66,54277,33,184002
4832,0.000676,172.217.194.0-255,1484,55761,33,184002
4833,0.000693,172.217.194.0-255,2902,58663,33,184002
4834,0.000697,172.31.33.0-255,66,58729,33,184002
4835,0.000703,172.217.194.0-255,5738,64467,33,184002
4836,0.000706,172.31.33.0-255,66,64533,33,184002
4837,0.000733,172.217.194.0-255,5738,70271,33,184002
4838,0.000736,172.31.33.0-255,66,70337,33,184002
4839,0.00077,172.217.194.0-255,7156,77493,33,184002
4840,0.000773,172.31.33.0-255,66,77559,33,184002
4841,0.000779,172.217.194.0-255,5738,83297,33,184002
4842,0.000781,172.31.33.0-255,66,83363,33,184002
4843,0.000786,172.217.194.0-255,2902,86265,33,184002
4844,0.000791,172.31.33.0-255,66,86331,33,184002
4845,0.000832,172.217.194.0-255,2184,88515,33,184002
4846,0.000835,172.31.33.0-255,66,88581,33,184002
4847,0.001641,172.217.194.0-255,1484,90065,33,184002
4848,0.001661,172.217.194.0-255,2902,92967,33,184002
4849,0.001665,172.31.33.0-255,66,93033,33,184002
4850,0.001672,172.217.194.0-255,5738,98771,33,184002
4851,0.001674,172.31.33.0-255,66,98837,33,184002
4852,0.001704,172.217.194.0-255,7156,105993,33,184002
4853,0.001708,172.31.33.0-255,66,106059,33,184002
4854,0.001734,172.217.194.0-255,5738,111797,33,184002
4855,0.001736,172.31.33.0-255,66,111863,33,184002
4856,0.001765,172.217.194.0-255,7156,119019,33,184002
4857,0.001767,172.31.33.0-255,66,119085,33,184002
4858,0.00182,172.217.194.0-255,3602,122687,33,184002
4859,0.001824,172.31.33.0-255,66,122753,33,184002
4860,0.001951,172.217.194.0-255,1484,124237,33,184002
4861,0.001971,172.217.194.0-255,2902,127139,33,184002
4862,0.001974,172.31.33.0-255,66,127205,33,184002
4863,0.001981,172.217.194.0-255,5738,132943,33,184002
4864,0.001983,172.31.33.0-255,66,133009,33,184002
4865,0.001996,172.217.194.0-255,5738,138747,33,184002
4866,0.001999,172.31.33.0-255,66,138813,33,184002
4867,0.002032,172.217.194.0-255,1484,140297,33,184002
4868,0.002062,172.31.33.0-255,66,140363,33,184002
4869,0.002069,172.217.194.0-255,5020,145383,33,184002
4870,0.002071,172.31.33.0-255,66,145449,33,184002
4871,0.00221,172.217.194.0-255,1484,146933,33,184002
4872,0.002245,172.217.194.0-255,1484,148417,33,184002
4873,0.002248,172.31.33.0-255,66,148483,33,184002
4874,0.002275,172.217.194.0-255,1484,149967,33,184002
4875,0.002281,172.217.194.0-255,5738,155705,33,184002
4876,0.002284,172.31.33.0-255,66,155771,33,184002
4877,0.002294,172.31.33.0-255,66,155837,33,184002
4878,0.002302,172.217.194.0-255,1484,157321,33,184002
4879,0.00234,172.31.33.0-255,66,157387,33,184002
4880,0.00237,172.31.33.0-255,66,157453,33,184002
4881,0.002377,172.217.194.0-255,7156,164609,33,184002
4882,0.00238,172.31.33.0-255,66,164675,33,184002
4883,0.00242,172.31.33.0-255,66,164741,33,184002
4884,0.002426,172.217.194.0-255,5738,170479,33,184002
4885,0.002428,172.31.33.0-255,66,170545,33,184002
4886,0.00248,172.31.33.0-255,66,170611,33,184002
4887,0.002503,172.31.33.0-255,66,170677,33,184002
4888,0.002539,172.31.33.0-255,66,170743,33,184002
4889,0.002576,172.31.33.0-255,66,170809,33,184002
4890,0.002587,172.31.33.0-255,66,170875,33,184002
4891,0.002627,172.31.33.0-255,66,170941,33,184002
4892,0.002634,172.217.194.0-255,7156,178097,33,184002
4893,0.002636,172.31.33.0-255,66,178163,33,184002
4894,0.00268,172.31.33.0-255,66,178229,33,184002
4895,0.005227,172.217.194.0-255,105,178334,33,184002
4896,0.008319,172.31.33.0-255,66,178400,33,184002
4897,0.008352,172.31.33.0-255,105,178505,33,184002
4898,0.01091,172.217.194.0-255,66,178571,33,184002
4899,0.03151,172.31.33.0-255,172,178743,33,184002
4900,0.031545,172.31.33.0-255,1113,179856,33,184002
4901,0.031631,172.31.33.0-255,1514,181370,33,184002
4902,0.031632,172.31.33.0-255,1514,182884,33,184002
4903,0.031656,172.31.33.0-255,680,183564,33,184002
4904,0.03307,104.244.42.0-255,66,183630,33,184002
4905,0.033105,104.244.42.0-255,66,183696,33,184002
4906,0.03318,104.244.42.0-255,66,183762,33,184002
4907,0.033263,104.244.42.0-255,66,183828,33,184002
4908,0.033848,104.244.42.0-255,108,183936,33,184002
4909,0.033855,172.31.33.0-255,66,184002,33,184002
4910,0.0,74.125.68.0-255,152,152,33,321982
4911,3e-05,172.31.33.0-255,66,218,33,321982
4912,3.7e-05,74.125.68.0-255,1484,1702,33,321982
4913,4.1e-05,172.31.33.0-255,66,1768,33,321982
4914,6.2e-05,74.125.68.0-255,1484,3252,33,321982
4915,6.9e-05,172.31.33.0-255,66,3318,33,321982
4916,9.6e-05,74.125.68.0-255,2902,6220,33,321982
4917,9.9e-05,172.31.33.0-255,66,6286,33,321982
4918,0.000128,74.125.68.0-255,4320,10606,33,321982
4919,0.000132,172.31.33.0-255,66,10672,33,321982
4920,0.00014,74.125.68.0-255,4892,15564,33,321982
4921,0.000143,172.31.33.0-255,66,15630,33,321982
4922,0.000181,172.31.33.0-255,66,15696,33,321982
4923,0.000207,74.125.68.0-255,1484,17180,33,321982
4924,0.00021,172.31.33.0-255,66,17246,33,321982
4925,0.000232,74.125.68.0-255,5379,22625,33,321982
4926,0.000235,172.31.33.0-255,66,22691,33,321982
4927,0.000464,74.125.68.0-255,1484,24175,33,321982
4928,0.000469,172.31.33.0-255,66,24241,33,321982
4929,0.000508,74.125.68.0-255,2902,27143,33,321982
4930,0.000512,172.31.33.0-255,66,27209,33,321982
4931,0.000541,74.125.68.0-255,4320,31529,33,321982
4932,0.000545,172.31.33.0-255,66,31595,33,321982
4933,0.000577,74.125.68.0-255,7156,38751,33,321982
4934,0.00058,172.31.33.0-255,66,38817,33,321982
4935,0.000611,172.31.33.0-255,66,38883,33,321982
4936,0.000619,74.125.68.0-255,5738,44621,33,321982
4937,0.000621,172.31.33.0-255,66,44687,33,321982
4938,0.000667,74.125.68.0-255,4279,48966,33,321982
4939,0.000671,172.31.33.0-255,66,49032,33,321982
4940,0.000869,74.125.68.0-255,106,49138,33,321982
4941,0.001364,74.125.68.0-255,1484,50622,33,321982
4942,0.001372,172.31.33.0-255,66,50688,33,321982
4943,0.001376,74.125.68.0-255,1484,52172,33,321982
4944,0.001381,74.125.68.0-255,2902,55074,33,321982
4945,0.001382,172.31.33.0-255,66,55140,33,321982
4946,0.001392,74.125.68.0-255,2902,58042,33,321982
4947,0.001395,172.31.33.0-255,66,58108,33,321982
4948,0.001421,74.125.68.0-255,2902,61010,33,321982
4949,0.001423,172.31.33.0-255,66,61076,33,321982
4950,0.001456,74.125.68.0-255,7156,68232,33,321982
4951,0.001458,172.31.33.0-255,66,68298,33,321982
4952,0.001491,74.125.68.0-255,2902,71200,33,321982
4953,0.001493,172.31.33.0-255,66,71266,33,321982
4954,0.001504,172.31.33.0-255,66,71332,33,321982
4955,0.001507,74.125.68.0-255,766,72098,33,321982
4956,0.001532,74.125.68.0-255,1484,73582,33,321982
4957,0.001534,172.31.33.0-255,66,73648,33,321982
4958,0.001537,74.125.68.0-255,1484,75132,33,321982
4959,0.001555,74.125.68.0-255,1484,76616,33,321982
4960,0.001558,172.31.33.0-255,66,76682,33,321982
4961,0.001564,74.125.68.0-255,5738,82420,33,321982
4962,0.001566,172.31.33.0-255,66,82486,33,321982
4963,0.001569,74.125.68.0-255,2902,85388,33,321982
4964,0.001572,172.31.33.0-255,66,85454,33,321982
4965,0.001601,74.125.68.0-255,4320,89774,33,321982
4966,0.001603,172.31.33.0-255,66,89840,33,321982
4967,0.001607,74.125.68.0-255,2902,92742,33,321982
4968,0.001609,172.31.33.0-255,66,92808,33,321982
4969,0.001648,74.125.68.0-255,5738,98546,33,321982
4970,0.001651,172.31.33.0-255,66,98612,33,321982
4971,0.001657,74.125.68.0-255,7156,105768,33,321982
4972,0.001659,172.31.33.0-255,66,105834,33,321982
4973,0.001662,74.125.68.0-255,1484,107318,33,321982
4974,0.001685,74.125.68.0-255,6438,113756,33,321982
4975,0.001688,172.31.33.0-255,66,113822,33,321982
4976,0.001692,74.125.68.0-255,2902,116724,33,321982
4977,0.001694,172.31.33.0-255,66,116790,33,321982
4978,0.001716,74.125.68.0-255,4320,121110,33,321982
4979,0.001718,172.31.33.0-255,66,121176,33,321982
4980,0.001756,172.31.33.0-255,66,121242,33,321982
4981,0.001763,74.125.68.0-255,7156,128398,33,321982
4982,0.001765,172.31.33.0-255,66,128464,33,321982
4983,0.00179,74.125.68.0-255,5020,133484,33,321982
4984,0.001792,172.31.33.0-255,66,133550,33,321982
4985,0.001797,74.125.68.0-255,4320,137870,33,321982
4986,0.001799,172.31.33.0-255,66,137936,33,321982
4987,0.001816,74.125.68.0-255,1484,139420,33,321982
4988,0.001833,74.125.68.0-255,2902,142322,33,321982
4989,0.001836,172.31.33.0-255,66,142388,33,321982
4990,0.001868,172.31.33.0-255,66,142454,33,321982
4991,0.001874,74.125.68.0-255,7156,149610,33,321982
4992,0.001877,172.31.33.0-255,66,149676,33,321982
4993,0.001902,74.125.68.0-255,6438,156114,33,321982
4994,0.001905,172.31.33.0-255,66,156180,33,321982
4995,0.001907,74.125.68.0-255,1484,157664,33,321982
4996,0.001911,74.125.68.0-255,2902,160566,33,321982
4997,0.001914,172.31.33.0-255,66,160632,33,321982
4998,0.001917,74.125.68.0-255,1484,162116,33,321982
4999,0.00195,74.125.68.0-255,4320,166436,33,321982
5000,0.001953,172.31.33.0-255,66,166502,33,321982
5001,0.001957,74.125.68.0-255,2902,169404,33,321982
5002,0.001959,172.31.33.0-255,66,169470,33,321982
5003,0.001965,74.125.68.0-255,4320,173790,33,321982
5004,0.001969,172.31.33.0-255,66,173856,33,321982
5005,0.002,74.125.68.0-255,5738,179594,33,321982
5006,0.002002,172.31.33.0-255,66,179660,33,321982
5007,0.002012,172.31.33.0-255,66,179726,33,321982
5008,0.002073,172.31.33.0-255,66,179792,33,321982
5009,0.002093,172.31.33.0-255,66,179858,33,321982
5010,0.002117,74.125.68.0-255,1484,181342,33,321982
5011,0.002124,74.125.68.0-255,7156,188498,33,321982
5012,0.002126,172.31.33.0-255,66,188564,33,321982
5013,0.002147,74.125.68.0-255,5020,193584,33,321982
5014,0.00215,172.31.33.0-255,66,193650,33,321982
5015,0.002204,74.125.68.0-255,5738,199388,33,321982
5016,0.002207,172.31.33.0-255,66,199454,33,321982
5017,0.002209,74.125.68.0-255,1484,200938,33,321982
5018,0.002214,74.125.68.0-255,2902,203840,33,321982
5019,0.002216,172.31.33.0-255,66,203906,33,321982
5020,0.002242,74.125.68.0-255,2902,206808,33,321982
5021,0.002244,172.31.33.0-255,66,206874,33,321982
5022,0.002268,74.125.68.0-255,4320,211194,33,321982
5023,0.002271,172.31.33.0-255,66,211260,33,321982
5024,0.002297,74.125.68.0-255,7156,218416,33,321982
5025,0.002299,172.31.33.0-255,66,218482,33,321982
5026,0.002332,172.31.33.0-255,66,218548,33,321982
5027,0.002334,74.125.68.0-255,766,219314,33,321982
5028,0.004614,74.125.68.0-255,4320,223634,33,321982
5029,0.004617,172.31.33.0-255,66,223700,33,321982
5030,0.00692,74.125.68.0-255,5738,229438,33,321982
5031,0.00693,172.31.33.0-255,66,229504,33,321982
5032,0.009239,74.125.68.0-255,5738,235242,33,321982
5033,0.009259,172.31.33.0-255,66,235308,33,321982
5034,0.011552,74.125.68.0-255,5738,241046,33,321982
5035,0.011561,172.31.33.0-255,66,241112,33,321982
5036,0.013878,74.125.68.0-255,5738,246850,33,321982
5037,0.013896,172.31.33.0-255,66,246916,33,321982
5038,0.016221,74.125.68.0-255,5738,252654,33,321982
5039,0.016244,172.31.33.0-255,66,252720,33,321982
5040,0.018547,74.125.68.0-255,5738,258458,33,321982
5041,0.018558,172.31.33.0-255,66,258524,33,321982
5042,0.020879,74.125.68.0-255,5738,264262,33,321982
5043,0.020894,172.31.33.0-255,66,264328,33,321982
5044,0.023188,74.125.68.0-255,5738,270066,33,321982
5045,0.023196,172.31.33.0-255,66,270132,33,321982
5046,0.025508,74.125.68.0-255,5738,275870,33,321982
5047,0.025513,172.31.33.0-255,66,275936,33,321982
5048,0.027831,74.125.68.0-255,5738,281674,33,321982
5049,0.027838,172.31.33.0-255,66,281740,33,321982
5050,0.030137,74.125.68.0-255,5738,287478,33,321982
5051,0.030151,172.31.33.0-255,66,287544,33,321982
5052,0.032437,74.125.68.0-255,5738,293282,33,321982
5053,0.032443,172.31.33.0-255,66,293348,33,321982
5054,0.034453,172.31.33.0-255,172,293520,33,321982
5055,0.034496,172.31.33.0-255,1117,294637,33,321982
5056,0.034558,172.31.33.0-255,1514,296151,33,321982
5057,0.03456,172.31.33.0-255,1282,297433,33,321982
5058,0.034738,74.125.68.0-255,5738,303171,33,321982
5059,0.034743,172.31.33.0-255,66,303237,33,321982
5060,0.035944,104.244.42.0-255,66,303303,33,321982
5061,0.035978,104.244.42.0-255,66,303369,33,321982
5062,0.03606,104.244.42.0-255,66,303435,33,321982
5063,0.037029,74.125.68.0-255,1484,304919,33,321982
5064,0.037048,74.125.68.0-255,4320,309239,33,321982
5065,0.037053,172.31.33.0-255,66,309305,33,321982
5066,0.039344,74.125.68.0-255,5738,315043,33,321982
5067,0.039349,172.31.33.0-255,66,315109,33,321982
5068,0.041632,74.125.68.0-255,4320,319429,33,321982
5069,0.041636,172.31.33.0-255,66,319495,33,321982
5070,0.041664,74.125.68.0-255,1484,320979,33,321982
5071,0.043912,74.125.68.0-255,766,321745,33,321982
5072,0.043916,172.31.33.0-255,66,321811,33,321982
5073,0.044455,172.31.33.0-255,105,321916,33,321982
5074,0.046709,74.125.68.0-255,66,321982,33,321982
5075,0.0,172.31.33.0-255,105,105,33,1836
5076,3.2e-05,172.31.33.0-255,105,210,33,1836
5077,9.3e-05,172.31.33.0-255,105,315,33,1836
5078,0.00016,172.31.33.0-255,105,420,33,1836
5079,0.000372,172.31.33.0-255,90,510,33,1836
5080,0.00038,172.31.33.0-255,66,576,33,1836
5081,0.000543,172.31.33.0-255,90,666,33,1836
5082,0.000549,172.31.33.0-255,66,732,33,1836
5083,0.000691,172.31.33.0-255,90,822,33,1836
5084,0.000696,172.31.33.0-255,66,888,33,1836
5085,0.001021,172.31.33.0-255,90,978,33,1836
5086,0.001027,172.31.33.0-255,66,1044,33,1836
5087,0.002524,74.125.200.0-255,66,1110,33,1836
5088,0.002549,74.125.200.0-255,66,1176,33,1836
5089,0.002566,172.31.33.0-255,66,1242,33,1836
5090,0.002605,74.125.130.0-255,66,1308,33,1836
5091,0.002619,74.125.130.0-255,66,1374,33,1836
5092,0.00263,172.31.33.0-255,66,1440,33,1836
5093,0.003054,74.125.24.0-255,66,1506,33,1836
5094,0.003069,74.125.24.0-255,66,1572,33,1836
5095,0.003081,172.31.33.0-255,66,1638,33,1836
5096,0.003263,172.217.194.0-255,66,1704,33,1836
5097,0.003277,172.217.194.0-255,66,1770,33,1836
5098,0.003288,172.31.33.0-255,66,1836,33,1836
5099,0.0,172.217.194.0-255,209,209,33,293151
5100,1.7e-05,172.31.33.0-255,66,275,33,293151
5101,2.4e-05,172.217.194.0-255,1484,1759,33,293151
5102,2.8e-05,172.31.33.0-255,66,1825,33,293151
5103,3.4e-05,172.217.194.0-255,4320,6145,33,293151
5104,3.7e-05,172.31.33.0-255,66,6211,33,293151
5105,4.2e-05,172.217.194.0-255,5738,11949,33,293151
5106,4.5e-05,172.31.33.0-255,66,12015,33,293151
5107,8.4e-05,172.217.194.0-255,1831,13846,33,293151
5108,8.7e-05,172.31.33.0-255,66,13912,33,293151
5109,9.2e-05,172.217.194.0-255,2902,16814,33,293151
5110,9.4e-05,172.31.33.0-255,66,16880,33,293151
5111,0.000118,172.217.194.0-255,1484,18364,33,293151
5112,0.000121,172.31.33.0-255,66,18430,33,293151
5113,0.000125,172.217.194.0-255,1484,19914,33,293151
5114,0.000127,172.31.33.0-255,66,19980,33,293151
5115,0.000138,172.217.194.0-255,1484,21464,33,293151
5116,0.00014,172.31.33.0-255,66,21530,33,293151
5117,0.000164,172.217.194.0-255,5738,27268,33,293151
5118,0.000166,172.31.33.0-255,66,27334,33,293151
5119,0.000171,172.217.194.0-255,2902,30236,33,293151
5120,0.000173,172.31.33.0-255,66,30302,33,293151
5121,0.000211,172.217.194.0-255,1125,31427,33,293151
5122,0.000214,172.31.33.0-255,66,31493,33,293151
5123,0.000281,172.217.194.0-255,1484,32977,33,293151
5124,0.000285,172.31.33.0-255,66,33043,33,293151
5125,0.000296,172.217.194.0-255,2902,35945,33,293151
5126,0.000299,172.31.33.0-255,66,36011,33,293151
5127,0.000305,172.217.194.0-255,5738,41749,33,293151
5128,0.000307,172.31.33.0-255,66,41815,33,293151
5129,0.000334,172.217.194.0-255,6797,48612,33,293151
5130,0.000337,172.31.33.0-255,66,48678,33,293151
5131,0.000357,172.217.194.0-255,7156,55834,33,293151
5132,0.00036,172.31.33.0-255,66,55900,33,293151
5133,0.000397,172.31.33.0-255,66,55966,33,293151
5134,0.00044,172.217.194.0-255,363,56329,33,293151
5135,0.000944,172.217.194.0-255,1484,57813,33,293151
5136,0.00095,172.31.33.0-255,66,57879,33,293151
5137,0.000956,172.217.194.0-255,2902,60781,33,293151
5138,0.000958,172.31.33.0-255,66,60847,33,293151
5139,0.000964,172.217.194.0-255,5738,66585,33,293151
5140,0.000967,172.31.33.0-255,66,66651,33,293151
5141,0.000996,172.217.194.0-255,5738,72389,33,293151
5142,0.000999,172.31.33.0-255,66,72455,33,293151
5143,0.001032,172.217.194.0-255,5738,78193,33,293151
5144,0.001036,172.31.33.0-255,66,78259,33,293151
5145,0.001052,172.217.194.0-255,7156,85415,33,293151
5146,0.001055,172.31.33.0-255,66,85481,33,293151
5147,0.001085,172.217.194.0-255,2902,88383,33,293151
5148,0.001087,172.31.33.0-255,66,88449,33,293151
5149,0.001104,172.217.194.0-255,2184,90633,33,293151
5150,0.001106,172.31.33.0-255,66,90699,33,293151
5151,0.001654,172.217.194.0-255,1484,92183,33,293151
5152,0.001664,172.217.194.0-255,2902,95085,33,293151
5153,0.001668,172.31.33.0-255,66,95151,33,293151
5154,0.001672,172.217.194.0-255,1484,96635,33,293151
5155,0.001691,172.217.194.0-255,4320,100955,33,293151
5156,0.001694,172.31.33.0-255,66,101021,33,293151
5157,0.001722,172.31.33.0-255,66,101087,33,293151
5158,0.001739,172.217.194.0-255,1484,102571,33,293151
5159,0.001771,172.217.194.0-255,5738,108309,33,293151
5160,0.001774,172.31.33.0-255,66,108375,33,293151
5161,0.001796,172.217.194.0-255,7156,115531,33,293151
5162,0.001799,172.31.33.0-255,66,115597,33,293151
5163,0.00182,172.217.194.0-255,5020,120617,33,293151
5164,0.001822,172.31.33.0-255,66,120683,33,293151
5165,0.001851,172.31.33.0-255,66,120749,33,293151
5166,0.001877,172.217.194.0-255,7156,127905,33,293151
5167,0.00188,172.31.33.0-255,66,127971,33,293151
5168,0.001888,172.217.194.0-255,7156,135127,33,293151
5169,0.00189,172.31.33.0-255,66,135193,33,293151
5170,0.001915,172.217.194.0-255,3602,138795,33,293151
5171,0.001918,172.31.33.0-255,66,138861,33,293151
5172,0.001992,172.217.194.0-255,1484,140345,33,293151
5173,0.001998,172.217.194.0-255,2902,143247,33,293151
5174,0.002001,172.31.33.0-255,66,143313,33,293151
5175,0.002005,172.217.194.0-255,1484,144797,33,293151
5176,0.002024,172.217.194.0-255,4320,149117,33,293151
5177,0.002026,172.31.33.0-255,66,149183,33,293151
5178,0.002029,172.217.194.0-255,1484,150667,33,293151
5179,0.002036,172.217.194.0-255,5738,156405,33,293151
5180,0.002038,172.31.33.0-255,66,156471,33,293151
5181,0.002057,172.217.194.0-255,2902,159373,33,293151
5182,0.00206,172.31.33.0-255,66,159439,33,293151
5183,0.002077,172.217.194.0-255,5738,165177,33,293151
5184,0.00208,172.31.33.0-255,66,165243,33,293151
5185,0.002114,172.31.33.0-255,66,165309,33,293151
5186,0.002215,172.217.194.0-255,1484,166793,33,293151
5187,0.002222,172.217.194.0-255,2902,169695,33,293151
5188,0.002226,172.31.33.0-255,66,169761,33,293151
5189,0.002229,172.217.194.0-255,1484,171245,33,293151
5190,0.002249,172.217.194.0-255,4320,175565,33,293151
5191,0.002252,172.31.33.0-255,66,175631,33,293151
5192,0.002274,172.217.194.0-255,5738,181369,33,293151
5193,0.002277,172.31.33.0-255,66,181435,33,293151
5194,0.002299,172.217.194.0-255,7156,188591,33,293151
5195,0.002301,172.31.33.0-255,66,188657,33,293151
5196,0.002312,172.31.33.0-255,66,188723,33,293151
5197,0.002337,172.31.33.0-255,66,188789,33,293151
5198,0.002388,172.31.33.0-255,66,188855,33,293151
5199,0.002402,172.31.33.0-255,66,188921,33,293151
5200,0.002408,172.217.194.0-255,5738,194659,33,293151
5201,0.002411,172.31.33.0-255,66,194725,33,293151
5202,0.002465,172.31.33.0-255,66,194791,33,293151
5203,0.002478,172.31.33.0-255,66,194857,33,293151
5204,0.00483,172.217.194.0-255,5738,200595,33,293151
5205,0.004837,172.31.33.0-255,66,200661,33,293151
5206,0.007206,172.217.194.0-255,4320,204981,33,293151
5207,0.007212,172.31.33.0-255,66,205047,33,293151
5208,0.00723,172.217.194.0-255,1484,206531,33,293151
5209,0.009577,172.217.194.0-255,4320,210851,33,293151
5210,0.009582,172.31.33.0-255,66,210917,33,293151
5211,0.011906,172.217.194.0-255,5738,216655,33,293151
5212,0.011912,172.31.33.0-255,66,216721,33,293151
5213,0.014269,172.217.194.0-255,5738,222459,33,293151
5214,0.014276,172.31.33.0-255,66,222525,33,293151
5215,0.016609,172.217.194.0-255,5738,228263,33,293151
5216,0.016617,172.31.33.0-255,66,228329,33,293151
5217,0.018956,172.217.194.0-255,2902,231231,33,293151
5218,0.018963,172.31.33.0-255,66,231297,33,293151
5219,0.018987,172.217.194.0-255,2902,234199,33,293151
5220,0.018989,172.31.33.0-255,66,234265,33,293151
5221,0.021336,172.217.194.0-255,5738,240003,33,293151
5222,0.021345,172.31.33.0-255,66,240069,33,293151
5223,0.023698,172.217.194.0-255,5738,245807,33,293151
5224,0.023705,172.31.33.0-255,66,245873,33,293151
5225,0.02609,172.217.194.0-255,5738,251611,33,293151
5226,0.026097,172.31.33.0-255,66,251677,33,293151
5227,0.027424,172.31.33.0-255,172,251849,33,293151
5228,0.027459,172.31.33.0-255,1117,252966,33,293151
5229,0.027521,172.31.33.0-255,1514,254480,33,293151
5230,0.027522,172.31.33.0-255,1514,255994,33,293151
5231,0.027573,172.31.33.0-255,676,256670,33,293151
5232,0.028455,172.217.194.0-255,1484,258154,33,293151
5233,0.028473,172.217.194.0-255,4320,262474,33,293151
5234,0.028479,172.31.33.0-255,66,262540,33,293151
5235,0.028948,104.244.42.0-255,66,262606,33,293151
5236,0.028999,104.244.42.0-255,66,262672,33,293151
5237,0.029148,104.244.42.0-255,66,262738,33,293151
5238,0.029153,104.244.42.0-255,66,262804,33,293151
5239,0.030838,172.217.194.0-255,5738,268542,33,293151
5240,0.030845,172.31.33.0-255,66,268608,33,293151
5241,0.033179,172.217.194.0-255,5738,274346,33,293151
5242,0.033185,172.31.33.0-255,66,274412,33,293151
5243,0.035572,172.217.194.0-255,5738,280150,33,293151
5244,0.035578,172.31.33.0-255,66,280216,33,293151
5245,0.037943,172.217.194.0-255,5738,285954,33,293151
5246,0.037948,172.31.33.0-255,66,286020,33,293151
5247,0.040296,172.217.194.0-255,5738,291758,33,293151
5248,0.040302,172.31.33.0-255,66,291824,33,293151
5249,0.042669,172.217.194.0-255,1090,292914,33,293151
5250,0.042772,172.31.33.0-255,66,292980,33,293151
5251,0.042802,172.31.33.0-255,105,293085,33,293151
5252,0.045129,172.217.194.0-255,66,293151,33,293151
5253,0.0,172.217.194.0-255,153,153,33,192079
5254,3.6e-05,172.31.33.0-255,66,219,33,192079
5255,4.3e-05,172.217.194.0-255,1484,1703,33,192079
5256,4.8e-05,172.31.33.0-255,66,1769,33,192079
5257,5.3e-05,172.217.194.0-255,2902,4671,33,192079
5258,5.6e-05,172.31.33.0-255,66,4737,33,192079
5259,5.9e-05,172.217.194.0-255,1484,6221,33,192079
5260,6.2e-05,172.31.33.0-255,66,6287,33,192079
5261,6.8e-05,172.217.194.0-255,5738,12025,33,192079
5262,7.1e-05,172.31.33.0-255,66,12091,33,192079
5263,0.000102,172.31.33.0-255,66,12157,33,192079
5264,0.000123,172.217.194.0-255,3501,15658,33,192079
5265,0.000126,172.31.33.0-255,66,15724,33,192079
5266,0.000131,172.217.194.0-255,5379,21103,33,192079
5267,0.000133,172.31.33.0-255,66,21169,33,192079
5268,0.000165,172.217.194.0-255,1484,22653,33,192079
5269,0.000168,172.31.33.0-255,66,22719,33,192079
5270,0.0002,172.217.194.0-255,2902,25621,33,192079
5271,0.000203,172.31.33.0-255,66,25687,33,192079
5272,0.00021,172.217.194.0-255,5738,31425,33,192079
5273,0.000212,172.31.33.0-255,66,31491,33,192079
5274,0.000215,172.217.194.0-255,1484,32975,33,192079
5275,0.000218,172.31.33.0-255,66,33041,33,192079
5276,0.000251,172.217.194.0-255,6797,39838,33,192079
5277,0.000255,172.31.33.0-255,66,39904,33,192079
5278,0.000267,172.31.33.0-255,66,39970,33,192079
5279,0.000274,172.217.194.0-255,7095,47065,33,192079
5280,0.000277,172.31.33.0-255,66,47131,33,192079
5281,0.000361,172.217.194.0-255,381,47512,33,192079
5282,0.000365,172.31.33.0-255,66,47578,33,192079
5283,0.000609,172.217.194.0-255,1484,49062,33,192079
5284,0.000616,172.217.194.0-255,2902,51964,33,192079
5285,0.00062,172.31.33.0-255,66,52030,33,192079
5286,0.000625,172.217.194.0-255,2902,54932,33,192079
5287,0.000631,172.31.33.0-255,66,54998,33,192079
5288,0.000642,172.217.194.0-255,2902,57900,33,192079
5289,0.000645,172.31.33.0-255,66,57966,33,192079
5290,0.000648,172.217.194.0-255,1484,59450,33,192079
5291,0.000687,172.31.33.0-255,66,59516,33,192079
5292,0.000695,172.217.194.0-255,7156,66672,33,192079
5293,0.000697,172.31.33.0-255,66,66738,33,192079
5294,0.000715,172.217.194.0-255,2902,69640,33,192079
5295,0.000718,172.31.33.0-255,66,69706,33,192079
5296,0.00072,172.217.194.0-255,766,70472,33,192079
5297,0.000925,172.217.194.0-255,1484,71956,33,192079
5298,0.000929,172.31.33.0-255,66,72022,33,192079
5299,0.000934,172.217.194.0-255,2902,74924,33,192079
5300,0.000937,172.31.33.0-255,66,74990,33,192079
5301,0.000948,172.217.194.0-255,1484,76474,33,192079
5302,0.000974,172.217.194.0-255,4320,80794,33,192079
5303,0.000977,172.31.33.0-255,66,80860,33,192079
5304,0.000989,172.31.33.0-255,66,80926,33,192079
5305,0.001001,172.31.33.0-255,66,80992,33,192079
5306,0.001004,172.217.194.0-255,766,81758,33,192079
5307,0.001151,172.217.194.0-255,1484,83242,33,192079
5308,0.001155,172.31.33.0-255,66,83308,33,192079
5309,0.001159,172.217.194.0-255,1484,84792,33,192079
5310,0.001174,172.217.194.0-255,1484,86276,33,192079
5311,0.001177,172.31.33.0-255,66,86342,33,192079
5312,0.001183,172.217.194.0-255,5738,92080,33,192079
5313,0.001185,172.31.33.0-255,66,92146,33,192079
5314,0.001188,172.217.194.0-255,1484,93630,33,192079
5315,0.001223,172.31.33.0-255,66,93696,33,192079
5316,0.001266,172.31.33.0-255,66,93762,33,192079
5317,0.001294,172.217.194.0-255,766,94528,33,192079
5318,0.001306,172.31.33.0-255,66,94594,33,192079
5319,0.001317,172.31.33.0-255,66,94660,33,192079
5320,0.001331,172.217.194.0-255,5738,100398,33,192079
5321,0.001334,172.31.33.0-255,66,100464,33,192079
5322,0.001354,172.217.194.0-255,6438,106902,33,192079
5323,0.001358,172.31.33.0-255,66,106968,33,192079
5324,0.001378,172.217.194.0-255,4320,111288,33,192079
5325,0.00138,172.31.33.0-255,66,111354,33,192079
5326,0.001408,172.217.194.0-255,5738,117092,33,192079
5327,0.001411,172.31.33.0-255,66,117158,33,192079
5328,0.001416,172.217.194.0-255,4320,121478,33,192079
5329,0.001423,172.31.33.0-255,66,121544,33,192079
5330,0.001432,172.217.194.0-255,7156,128700,33,192079
5331,0.001435,172.31.33.0-255,66,128766,33,192079
5332,0.001445,172.31.33.0-255,66,128832,33,192079
5333,0.001461,172.217.194.0-255,3602,132434,33,192079
5334,0.001464,172.31.33.0-255,66,132500,33,192079
5335,0.001481,172.217.194.0-255,4320,136820,33,192079
5336,0.001484,172.31.33.0-255,66,136886,33,192079
5337,0.001507,172.31.33.0-255,66,136952,33,192079
5338,0.001516,172.217.194.0-255,4320,141272,33,192079
5339,0.001519,172.31.33.0-255,66,141338,33,192079
5340,0.001557,172.31.33.0-255,66,141404,33,192079
5341,0.001558,172.217.194.0-255,6438,147842,33,192079
5342,0.00156,172.31.33.0-255,66,147908,33,192079
5343,0.001586,172.217.194.0-255,2902,150810,33,192079
5344,0.00159,172.31.33.0-255,66,150876,33,192079
5345,0.001603,172.217.194.0-255,4320,155196,33,192079
5346,0.001606,172.31.33.0-255,66,155262,33,192079
5347,0.001616,172.31.33.0-255,66,155328,33,192079
5348,0.00162,172.217.194.0-255,4320,159648,33,192079
5349,0.001623,172.31.33.0-255,66,159714,33,192079
5350,0.001656,172.31.33.0-255,66,159780,33,192079
5351,0.001659,172.217.194.0-255,766,160546,33,192079
5352,0.001679,172.217.194.0-255,1484,162030,33,192079
5353,0.001682,172.31.33.0-255,66,162096,33,192079
5354,0.001701,172.217.194.0-255,2902,164998,33,192079
5355,0.001704,172.31.33.0-255,66,165064,33,192079
5356,0.00171,172.217.194.0-255,5738,170802,33,192079
5357,0.001712,172.31.33.0-255,66,170868,33,192079
5358,0.001752,172.31.33.0-255,66,170934,33,192079
5359,0.001759,172.217.194.0-255,5738,176672,33,192079
5360,0.001761,172.31.33.0-255,66,176738,33,192079
5361,0.001776,172.217.194.0-255,5020,181758,33,192079
5362,0.001781,172.31.33.0-255,66,181824,33,192079
5363,0.001824,172.31.33.0-255,66,181890,33,192079
5364,0.001841,172.31.33.0-255,66,181956,33,192079
5365,0.001908,172.31.33.0-255,66,182022,33,192079
5366,0.001922,172.31.33.0-255,66,182088,33,192079
5367,0.001938,172.217.194.0-255,1393,183481,33,192079
5368,0.001942,172.217.194.0-255,105,183586,33,192079
5369,0.010959,172.31.33.0-255,66,183652,33,192079
5370,0.010987,172.31.33.0-255,105,183757,33,192079
5371,0.011909,172.217.194.0-255,105,183862,33,192079
5372,0.011921,172.31.33.0-255,78,183940,33,192079
5373,0.013563,172.217.194.0-255,66,184006,33,192079
5374,0.031365,172.31.33.0-255,172,184178,33,192079
5375,0.031393,172.31.33.0-255,1117,185295,33,192079
5376,0.031444,172.31.33.0-255,1514,186809,33,192079
5377,0.031445,172.31.33.0-255,1514,188323,33,192079
5378,0.031447,172.31.33.0-255,1514,189837,33,192079
5379,0.031448,172.31.33.0-255,1060,190897,33,192079
5380,0.032896,104.244.42.0-255,66,190963,33,192079
5381,0.032914,104.244.42.0-255,66,191029,33,192079
5382,0.03301,104.244.42.0-255,66,191095,33,192079
5383,0.033012,104.244.42.0-255,66,191161,33,192079
5384,0.033269,172.31.33.0-255,105,191266,33,192079
5385,0.033322,172.31.33.0-255,105,191371,33,192079
5386,0.033437,172.31.33.0-255,90,191461,33,192079
5387,0.033444,172.31.33.0-255,66,191527,33,192079
5388,0.033716,172.31.33.0-255,90,191617,33,192079
5389,0.033723,172.31.33.0-255,66,191683,33,192079
5390,0.035711,74.125.130.0-255,66,191749,33,192079
5391,0.035722,74.125.130.0-255,66,191815,33,192079
5392,0.035726,74.125.130.0-255,66,191881,33,192079
5393,0.035735,172.31.33.0-255,66,191947,33,192079
5394,0.035738,74.125.130.0-255,66,192013,33,192079
5395,0.03574,172.31.33.0-255,66,192079,33,192079
5396,0.0,74.125.24.0-255,298,298,33,302259
5397,1.3e-05,172.31.33.0-255,66,364,33,302259
5398,1.9e-05,74.125.24.0-255,1484,1848,33,302259
5399,2.2e-05,172.31.33.0-255,66,1914,33,302259
5400,2.7e-05,74.125.24.0-255,2902,4816,33,302259
5401,3.1e-05,172.31.33.0-255,66,4882,33,302259
5402,4.4e-05,74.125.24.0-255,1484,6366,33,302259
5403,4.6e-05,172.31.33.0-255,66,6432,33,302259
5404,6.6e-05,74.125.24.0-255,2902,9334,33,302259
5405,6.8e-05,172.31.33.0-255,66,9400,33,302259
5406,8.9e-05,74.125.24.0-255,6114,15514,33,302259
5407,9.1e-05,172.31.33.0-255,66,15580,33,302259
5408,9.7e-05,74.125.24.0-255,5738,21318,33,302259
5409,9.8e-05,172.31.33.0-255,66,21384,33,302259
5410,0.000144,74.125.24.0-255,7156,28540,33,302259
5411,0.000146,172.31.33.0-255,66,28606,33,302259
5412,0.000164,74.125.24.0-255,2543,31149,33,302259
5413,0.000166,172.31.33.0-255,66,31215,33,302259
5414,0.000198,74.125.24.0-255,4320,35535,33,302259
5415,0.000201,172.31.33.0-255,66,35601,33,302259
5416,0.000225,74.125.24.0-255,2902,38503,33,302259
5417,0.000227,172.31.33.0-255,66,38569,33,302259
5418,0.000238,172.31.33.0-255,66,38635,33,302259
5419,0.00025,172.31.33.0-255,66,38701,33,302259
5420,0.000269,74.125.24.0-255,4320,43021,33,302259
5421,0.000271,172.31.33.0-255,66,43087,33,302259
5422,0.000274,74.125.24.0-255,1063,44150,33,302259
5423,0.000275,172.31.33.0-255,66,44216,33,302259
5424,0.000278,74.125.24.0-255,379,44595,33,302259
5425,0.00028,172.31.33.0-255,66,44661,33,302259
5426,0.00044,74.125.24.0-255,1484,46145,33,302259
5427,0.000445,74.125.24.0-255,1484,47629,33,302259
5428,0.000448,172.31.33.0-255,66,47695,33,302259
5429,0.00046,74.125.24.0-255,1484,49179,33,302259
5430,0.000465,74.125.24.0-255,4320,53499,33,302259
5431,0.000467,172.31.33.0-255,66,53565,33,302259
5432,0.000486,74.125.24.0-255,1484,55049,33,302259
5433,0.00049,74.125.24.0-255,2902,57951,33,302259
5434,0.000492,172.31.33.0-255,66,58017,33,302259
5435,0.00052,172.31.33.0-255,66,58083,33,302259
5436,0.00053,172.31.33.0-255,66,58149,33,302259
5437,0.000532,74.125.24.0-255,766,58915,33,302259
5438,0.000645,74.125.24.0-255,1484,60399,33,302259
5439,0.000649,172.31.33.0-255,66,60465,33,302259
5440,0.000652,74.125.24.0-255,1484,61949,33,302259
5441,0.000668,74.125.24.0-255,1484,63433,33,302259
5442,0.000673,74.125.24.0-255,5738,69171,33,302259
5443,0.000677,172.31.33.0-255,66,69237,33,302259
5444,0.00068,172.31.33.0-255,66,69303,33,302259
5445,0.000702,74.125.24.0-255,2902,72205,33,302259
5446,0.000704,172.31.33.0-255,66,72271,33,302259
5447,0.000734,172.31.33.0-255,66,72337,33,302259
5448,0.000743,172.31.33.0-255,66,72403,33,302259
5449,0.000761,74.125.24.0-255,1636,74039,33,302259
5450,0.000766,172.31.33.0-255,66,74105,33,302259
5451,0.000785,74.125.24.0-255,2902,77007,33,302259
5452,0.000787,172.31.33.0-255,66,77073,33,302259
5453,0.000817,74.125.24.0-255,7156,84229,33,302259
5454,0.00082,172.31.33.0-255,66,84295,33,302259
5455,0.000826,74.125.24.0-255,5738,90033,33,302259
5456,0.000827,172.31.33.0-255,66,90099,33,302259
5457,0.000863,172.31.33.0-255,66,90165,33,302259
5458,0.000867,74.125.24.0-255,3602,93767,33,302259
5459,0.000869,172.31.33.0-255,66,93833,33,302259
5460,0.001022,74.125.24.0-255,1484,95317,33,302259
5461,0.001034,74.125.24.0-255,2902,98219,33,302259
5462,0.001037,172.31.33.0-255,66,98285,33,302259
5463,0.001041,74.125.24.0-255,1484,99769,33,302259
5464,0.001058,74.125.24.0-255,4320,104089,33,302259
5465,0.001061,172.31.33.0-255,66,104155,33,302259
5466,0.001064,74.125.24.0-255,1484,105639,33,302259
5467,0.00109,172.31.33.0-255,66,105705,33,302259
5468,0.001124,74.125.24.0-255,4320,110025,33,302259
5469,0.001127,172.31.33.0-255,66,110091,33,302259
5470,0.001147,74.125.24.0-255,6438,116529,33,302259
5471,0.001149,172.31.33.0-255,66,116595,33,302259
5472,0.001745,74.125.24.0-255,1484,118079,33,302259
5473,0.001787,74.125.24.0-255,2902,120981,33,302259
5474,0.00179,172.31.33.0-255,66,121047,33,302259
5475,0.001796,74.125.24.0-255,5738,126785,33,302259
5476,0.001798,172.31.33.0-255,66,126851,33,302259
5477,0.001803,74.125.24.0-255,5738,132589,33,302259
5478,0.001805,172.31.33.0-255,66,132655,33,302259
5479,0.00183,74.125.24.0-255,7156,139811,33,302259
5480,0.001833,172.31.33.0-255,66,139877,33,302259
5481,0.001844,172.31.33.0-255,66,139943,33,302259
5482,0.001884,74.125.24.0-255,1484,141427,33,302259
5483,0.001899,74.125.24.0-255,1484,142911,33,302259
5484,0.001901,172.31.33.0-255,66,142977,33,302259
5485,0.001916,74.125.24.0-255,1484,144461,33,302259
5486,0.001923,74.125.24.0-255,5738,150199,33,302259
5487,0.001925,172.31.33.0-255,66,150265,33,302259
5488,0.001931,74.125.24.0-255,5738,156003,33,302259
5489,0.001932,172.31.33.0-255,66,156069,33,302259
5490,0.001955,74.125.24.0-255,5738,161807,33,302259
5491,0.001957,172.31.33.0-255,66,161873,33,302259
5492,0.001989,74.125.24.0-255,7156,169029,33,302259
5493,0.001992,172.31.33.0-255,66,169095,33,302259
5494,0.001997,74.125.24.0-255,5020,174115,33,302259
5495,0.001999,172.31.33.0-255,66,174181,33,302259
5496,0.002146,74.125.24.0-255,1484,175665,33,302259
5497,0.00216,74.125.24.0-255,2902,178567,33,302259
5498,0.002163,172.31.33.0-255,66,178633,33,302259
5499,0.002167,74.125.24.0-255,1484,180117,33,302259
5500,0.002187,74.125.24.0-255,4320,184437,33,302259
5501,0.002189,172.31.33.0-255,66,184503,33,302259
5502,0.002196,74.125.24.0-255,5738,190241,33,302259
5503,0.002198,172.31.33.0-255,66,190307,33,302259
5504,0.002224,74.125.24.0-255,7156,197463,33,302259
5505,0.002227,172.31.33.0-255,66,197529,33,302259
5506,0.002239,172.31.33.0-255,66,197595,33,302259
5507,0.00233,74.125.24.0-255,1484,199079,33,302259
5508,0.002352,74.125.24.0-255,2902,201981,33,302259
5509,0.002355,172.31.33.0-255,66,202047,33,302259
5510,0.002362,74.125.24.0-255,5738,207785,33,302259
5511,0.002364,172.31.33.0-255,66,207851,33,302259
5512,0.002368,74.125.24.0-255,1484,209335,33,302259
5513,0.00239,74.125.24.0-255,4320,213655,33,302259
5514,0.002393,172.31.33.0-255,66,213721,33,302259
5515,0.002396,74.125.24.0-255,1484,215205,33,302259
5516,0.002417,74.125.24.0-255,7156,222361,33,302259
5517,0.00242,172.31.33.0-255,66,222427,33,302259
5518,0.002433,74.125.24.0-255,4320,226747,33,302259
5519,0.002435,172.31.33.0-255,66,226813,33,302259
5520,0.002441,74.125.24.0-255,5020,231833,33,302259
5521,0.002444,172.31.33.0-255,66,231899,33,302259
5522,0.005127,74.125.24.0-255,2902,234801,33,302259
5523,0.005133,172.31.33.0-255,66,234867,33,302259
5524,0.005155,74.125.24.0-255,2902,237769,33,302259
5525,0.005157,172.31.33.0-255,66,237835,33,302259
5526,0.007789,74.125.24.0-255,2902,240737,33,302259
5527,0.007795,172.31.33.0-255,66,240803,33,302259
5528,0.007824,74.125.24.0-255,2902,243705,33,302259
5529,0.007827,172.31.33.0-255,66,243771,33,302259
5530,0.010447,74.125.24.0-255,2902,246673,33,302259
5531,0.010462,172.31.33.0-255,66,246739,33,302259
5532,0.010487,74.125.24.0-255,2902,249641,33,302259
5533,0.010489,172.31.33.0-255,66,249707,33,302259
5534,0.013118,74.125.24.0-255,2902,252609,33,302259
5535,0.013127,172.31.33.0-255,66,252675,33,302259
5536,0.013152,74.125.24.0-255,2902,255577,33,302259
5537,0.013155,172.31.33.0-255,66,255643,33,302259
5538,0.015766,74.125.24.0-255,2902,258545,33,302259
5539,0.015772,172.31.33.0-255,66,258611,33,302259
5540,0.015791,74.125.24.0-255,2902,261513,33,302259
5541,0.015793,172.31.33.0-255,66,261579,33,302259
5542,0.018433,74.125.24.0-255,5738,267317,33,302259
5543,0.018441,172.31.33.0-255,66,267383,33,302259
5544,0.021097,74.125.24.0-255,4320,271703,33,302259
5545,0.021104,172.31.33.0-255,66,271769,33,302259
5546,0.021117,74.125.24.0-255,1484,273253,33,302259
5547,0.023772,74.125.24.0-255,4320,277573,33,302259
5548,0.023778,172.31.33.0-255,66,277639,33,302259
5549,0.026482,74.125.24.0-255,5738,283377,33,302259
5550,0.02649,172.31.33.0-255,66,283443,33,302259
5551,0.029151,74.125.24.0-255,4320,287763,33,302259
5552,0.029157,172.31.33.0-255,66,287829,33,302259
5553,0.029177,74.125.24.0-255,1484,289313,33,302259
5554,0.031817,74.125.24.0-255,4320,293633,33,302259
5555,0.031823,172.31.33.0-255,66,293699,33,302259
5556,0.034474,74.125.24.0-255,4032,297731,33,302259
5557,0.034481,172.31.33.0-255,66,297797,33,302259
5558,0.03466,172.31.33.0-255,105,297902,33,302259
5559,0.035058,172.31.33.0-255,182,298084,33,302259
5560,0.035091,172.31.33.0-255,1117,299201,33,302259
5561,0.035148,172.31.33.0-255,1514,300715,33,302259
5562,0.03515,172.31.33.0-255,1280,301995,33,302259
5563,0.036723,104.244.42.0-255,66,302061,33,302259
5564,0.036739,104.244.42.0-255,66,302127,33,302259
5565,0.036824,104.244.42.0-255,66,302193,33,302259
5566,0.037255,74.125.24.0-255,66,302259,33,302259
5567,0.0,74.125.24.0-255,153,153,33,234078
5568,1.4e-05,172.31.33.0-255,66,219,33,234078
5569,2.1e-05,74.125.24.0-255,1484,1703,33,234078
5570,2.4e-05,172.31.33.0-255,66,1769,33,234078
5571,2.9e-05,74.125.24.0-255,2902,4671,33,234078
5572,3.2e-05,172.31.33.0-255,66,4737,33,234078
5573,5.9e-05,74.125.24.0-255,1484,6221,33,234078
5574,6.2e-05,172.31.33.0-255,66,6287,33,234078
5575,8.2e-05,74.125.24.0-255,5738,12025,33,234078
5576,8.4e-05,172.31.33.0-255,66,12091,33,234078
5577,8.8e-05,74.125.24.0-255,2095,14186,33,234078
5578,8.9e-05,172.31.33.0-255,66,14252,33,234078
5579,0.000106,74.125.24.0-255,2902,17154,33,234078
5580,0.000109,172.31.33.0-255,66,17220,33,234078
5581,0.000115,74.125.24.0-255,7156,24376,33,234078
5582,0.000117,172.31.33.0-255,66,24442,33,234078
5583,0.000161,74.125.24.0-255,6797,31239,33,234078
5584,0.000163,172.31.33.0-255,66,31305,33,234078
5585,0.000256,74.125.24.0-255,1484,32789,33,234078
5586,0.000259,172.31.33.0-255,66,32855,33,234078
5587,0.000264,74.125.24.0-255,2902,35757,33,234078
5588,0.000266,172.31.33.0-255,66,35823,33,234078
5589,0.000291,74.125.24.0-255,5738,41561,33,234078
5590,0.000294,172.31.33.0-255,66,41627,33,234078
5591,0.000337,74.125.24.0-255,1484,43111,33,234078
5592,0.000339,172.31.33.0-255,66,43177,33,234078
5593,0.000355,74.125.24.0-255,5379,48556,33,234078
5594,0.000357,172.31.33.0-255,66,48622,33,234078
5595,0.000536,74.125.24.0-255,1484,50106,33,234078
5596,0.000539,172.31.33.0-255,66,50172,33,234078
5597,0.000544,74.125.24.0-255,2902,53074,33,234078
5598,0.000547,172.31.33.0-255,66,53140,33,234078
5599,0.00055,74.125.24.0-255,1484,54624,33,234078
5600,0.000565,74.125.24.0-255,4320,58944,33,234078
5601,0.000567,172.31.33.0-255,66,59010,33,234078
5602,0.000603,74.125.24.0-255,4320,63330,33,234078
5603,0.000607,172.31.33.0-255,66,63396,33,234078
5604,0.000625,74.125.24.0-255,3154,66550,33,234078
5605,0.000627,172.31.33.0-255,66,66616,33,234078
5606,0.001675,74.125.24.0-255,1484,68100,33,234078
5607,0.001686,74.125.24.0-255,2902,71002,33,234078
5608,0.00169,172.31.33.0-255,66,71068,33,234078
5609,0.001711,74.125.24.0-255,5738,76806,33,234078
5610,0.001713,172.31.33.0-255,66,76872,33,234078
5611,0.001718,74.125.24.0-255,4320,81192,33,234078
5612,0.00172,172.31.33.0-255,66,81258,33,234078
5613,0.001739,74.125.24.0-255,4320,85578,33,234078
5614,0.001741,172.31.33.0-255,66,85644,33,234078
5615,0.001765,74.125.24.0-255,7156,92800,33,234078
5616,0.001767,172.31.33.0-255,66,92866,33,234078
5617,0.001791,172.31.33.0-255,66,92932,33,234078
5618,0.002324,74.125.24.0-255,1484,94416,33,234078
5619,0.002342,74.125.24.0-255,2902,97318,33,234078
5620,0.002345,172.31.33.0-255,66,97384,33,234078
5621,0.002349,74.125.24.0-255,1484,98868,33,234078
5622,0.002367,74.125.24.0-255,4320,103188,33,234078
5623,0.002369,172.31.33.0-255,66,103254,33,234078
5624,0.002374,74.125.24.0-255,4320,107574,33,234078
5625,0.002376,172.31.33.0-255,66,107640,33,234078
5626,0.002379,74.125.24.0-255,1484,109124,33,234078
5627,0.002395,74.125.24.0-255,1484,110608,33,234078
5628,0.002398,172.31.33.0-255,66,110674,33,234078
5629,0.002415,74.125.24.0-255,5738,116412,33,234078
5630,0.002418,172.31.33.0-255,66,116478,33,234078
5631,0.002448,74.125.24.0-255,2902,119380,33,234078
5632,0.00245,172.31.33.0-255,66,119446,33,234078
5633,0.002461,172.31.33.0-255,66,119512,33,234078
5634,0.002483,74.125.24.0-255,1484,120996,33,234078
5635,0.002498,74.125.24.0-255,5738,126734,33,234078
5636,0.002502,172.31.33.0-255,66,126800,33,234078
5637,0.002513,172.31.33.0-255,66,126866,33,234078
5638,0.002517,74.125.24.0-255,2902,129768,33,234078
5639,0.002519,172.31.33.0-255,66,129834,33,234078
5640,0.002545,74.125.24.0-255,2902,132736,33,234078
5641,0.002549,172.31.33.0-255,66,132802,33,234078
5642,0.00256,74.125.24.0-255,2902,135704,33,234078
5643,0.002565,172.31.33.0-255,66,135770,33,234078
5644,0.002578,74.125.24.0-255,4320,140090,33,234078
5645,0.00258,172.31.33.0-255,66,140156,33,234078
5646,0.002583,74.125.24.0-255,1484,141640,33,234078
5647,0.002588,74.125.24.0-255,3602,145242,33,234078
5648,0.00259,172.31.33.0-255,66,145308,33,234078
5649,0.003196,74.125.24.0-255,1484,146792,33,234078
5650,0.003203,74.125.24.0-255,2902,149694,33,234078
5651,0.003206,172.31.33.0-255,66,149760,33,234078
5652,0.003213,74.125.24.0-255,4320,154080,33,234078
5653,0.003214,172.31.33.0-255,66,154146,33,234078
5654,0.003226,74.125.24.0-255,1484,155630,33,234078
5655,0.003239,74.125.24.0-255,2902,158532,33,234078
5656,0.003241,172.31.33.0-255,66,158598,33,234078
5657,0.003273,172.31.33.0-255,66,158664,33,234078
5658,0.003291,74.125.24.0-255,2902,161566,33,234078
5659,0.003293,172.31.33.0-255,66,161632,33,234078
5660,0.003314,172.31.33.0-255,66,161698,33,234078
5661,0.003544,74.125.24.0-255,1484,163182,33,234078
5662,0.00355,74.125.24.0-255,2902,166084,33,234078
5663,0.003553,172.31.33.0-255,66,166150,33,234078
5664,0.003599,74.125.24.0-255,5738,171888,33,234078
5665,0.003602,172.31.33.0-255,66,171954,33,234078
5666,0.003615,172.31.33.0-255,66,172020,33,234078
5667,0.003633,74.125.24.0-255,1484,173504,33,234078
5668,0.003656,172.31.33.0-255,66,173570,33,234078
5669,0.003663,74.125.24.0-255,7156,180726,33,234078
5670,0.003665,172.31.33.0-255,66,180792,33,234078
5671,0.003719,74.125.24.0-255,5738,186530,33,234078
5672,0.003723,172.31.33.0-255,66,186596,33,234078
5673,0.003755,172.31.33.0-255,66,186662,33,234078
5674,0.003758,74.125.24.0-255,766,187428,33,234078
5675,0.003786,172.31.33.0-255,66,187494,33,234078
5676,0.003806,74.125.24.0-255,7156,194650,33,234078
5677,0.00381,172.31.33.0-255,66,194716,33,234078
5678,0.003814,74.125.24.0-255,1484,196200,33,234078
5679,0.00384,172.31.33.0-255,66,196266,33,234078
5680,0.00387,74.125.24.0-255,3602,199868,33,234078
5681,0.003874,172.31.33.0-255,66,199934,33,234078
5682,0.003891,172.31.33.0-255,66,200000,33,234078
5683,0.003898,74.125.24.0-255,7156,207156,33,234078
5684,0.0039,172.31.33.0-255,66,207222,33,234078
5685,0.003928,74.125.24.0-255,4320,211542,33,234078
5686,0.003931,172.31.33.0-255,66,211608,33,234078
5687,0.003968,172.31.33.0-255,66,211674,33,234078
5688,0.003974,74.125.24.0-255,5738,217412,33,234078
5689,0.003977,172.31.33.0-255,66,217478,33,234078
5690,0.004007,172.31.33.0-255,66,217544,33,234078
5691,0.004015,74.125.24.0-255,7156,224700,33,234078
5692,0.004017,172.31.33.0-255,66,224766,33,234078
5693,0.004043,172.31.33.0-255,66,224832,33,234078
5694,0.00405,74.125.24.0-255,4460,229292,33,234078
5695,0.004053,172.31.33.0-255,66,229358,33,234078
5696,0.004056,74.125.24.0-255,97,229455,33,234078
5697,0.004107,74.125.24.0-255,105,229560,33,234078
5698,0.005879,172.31.33.0-255,66,229626,33,234078
5699,0.00595,172.31.33.0-255,105,229731,33,234078
5700,0.008317,74.125.24.0-255,66,229797,33,234078
5701,0.035475,172.31.33.0-255,172,229969,33,234078
5702,0.035532,172.31.33.0-255,1117,231086,33,234078
5703,0.03562,172.31.33.0-255,1514,232600,33,234078
5704,0.035622,172.31.33.0-255,1280,233880,33,234078
5705,0.037046,104.244.42.0-255,66,233946,33,234078
5706,0.037113,104.244.42.0-255,66,234012,33,234078
5707,0.037161,104.244.42.0-255,66,234078,33,234078
5708,0.0,172.31.33.0-255,66,66,33,66
5709,0.0,172.31.33.0-255,160,160,33,226
5710,0.006982,74.125.130.0-255,66,226,33,226
5711,0.0,172.217.194.0-255,288,288,33,279042
5712,2.3e-05,172.31.33.0-255,66,354,33,279042
5713,2.8e-05,172.217.194.0-255,1484,1838,33,279042
5714,3.2e-05,172.31.33.0-255,66,1904,33,279042
5715,3.7e-05,172.217.194.0-255,4320,6224,33,279042
5716,4e-05,172.31.33.0-255,66,6290,33,279042
5717,7.2e-05,172.217.194.0-255,7156,13446,33,279042
5718,7.5e-05,172.31.33.0-255,66,13512,33,279042
5719,7.8e-05,172.217.194.0-255,403,13915,33,279042
5720,7.9e-05,172.31.33.0-255,66,13981,33,279042
5721,0.000239,172.217.194.0-255,1484,15465,33,279042
5722,0.000243,172.31.33.0-255,66,15531,33,279042
5723,0.000246,172.217.194.0-255,1484,17015,33,279042
5724,0.000249,172.31.33.0-255,66,17081,33,279042
5725,0.000263,172.217.194.0-255,1484,18565,33,279042
5726,0.000266,172.31.33.0-255,66,18631,33,279042
5727,0.000268,172.217.194.0-255,1484,20115,33,279042
5728,0.00027,172.31.33.0-255,66,20181,33,279042
5729,0.000276,172.217.194.0-255,5738,25919,33,279042
5730,0.000279,172.31.33.0-255,66,25985,33,279042
5731,0.000318,172.217.194.0-255,5379,31364,33,279042
5732,0.000321,172.31.33.0-255,66,31430,33,279042
5733,0.000498,172.217.194.0-255,1484,32914,33,279042
5734,0.000502,172.31.33.0-255,66,32980,33,279042
5735,0.000519,172.217.194.0-255,1484,34464,33,279042
5736,0.000521,172.31.33.0-255,66,34530,33,279042
5737,0.000537,172.217.194.0-255,1484,36014,33,279042
5738,0.000539,172.31.33.0-255,66,36080,33,279042
5739,0.000545,172.217.194.0-255,5738,41818,33,279042
5740,0.000547,172.31.33.0-255,66,41884,33,279042
5741,0.000578,172.217.194.0-255,6797,48681,33,279042
5742,0.000582,172.31.33.0-255,66,48747,33,279042
5743,0.0006,172.217.194.0-255,2902,51649,33,279042
5744,0.000602,172.31.33.0-255,66,51715,33,279042
5745,0.000624,172.217.194.0-255,4320,56035,33,279042
5746,0.000627,172.31.33.0-255,66,56101,33,279042
5747,0.000638,172.31.33.0-255,66,56167,33,279042
5748,0.000824,172.217.194.0-255,645,56812,33,279042
5749,0.000969,172.217.194.0-255,1484,58296,33,279042
5750,0.000974,172.31.33.0-255,66,58362,33,279042
5751,0.000989,172.217.194.0-255,2902,61264,33,279042
5752,0.000991,172.31.33.0-255,66,61330,33,279042
5753,0.000994,172.217.194.0-255,1484,62814,33,279042
5754,0.001019,172.217.194.0-255,4320,67134,33,279042
5755,0.001021,172.31.33.0-255,66,67200,33,279042
5756,0.001027,172.217.194.0-255,5738,72938,33,279042
5757,0.001029,172.31.33.0-255,66,73004,33,279042
5758,0.001043,172.217.194.0-255,6797,79801,33,279042
5759,0.001045,172.31.33.0-255,66,79867,33,279042
5760,0.00107,172.217.194.0-255,1484,81351,33,279042
5761,0.001092,172.31.33.0-255,66,81417,33,279042
5762,0.00122,172.217.194.0-255,1484,82901,33,279042
5763,0.001226,172.217.194.0-255,2902,85803,33,279042
5764,0.001229,172.31.33.0-255,66,85869,33,279042
5765,0.001234,172.217.194.0-255,4320,90189,33,279042
5766,0.001236,172.31.33.0-255,66,90255,33,279042
5767,0.001248,172.217.194.0-255,1484,91739,33,279042
5768,0.00126,172.217.194.0-255,5738,97477,33,279042
5769,0.001263,172.31.33.0-255,66,97543,33,279042
5770,0.001284,172.217.194.0-255,7156,104699,33,279042
5771,0.001287,172.31.33.0-255,66,104765,33,279042
5772,0.001298,172.31.33.0-255,66,104831,33,279042
5773,0.001321,172.217.194.0-255,2902,107733,33,279042
5774,0.001323,172.31.33.0-255,66,107799,33,279042
5775,0.001328,172.217.194.0-255,4320,112119,33,279042
5776,0.00133,172.31.33.0-255,66,112185,33,279042
5777,0.001345,172.217.194.0-255,2902,115087,33,279042
5778,0.001347,172.31.33.0-255,66,115153,33,279042
5779,0.001364,172.217.194.0-255,5738,120891,33,279042
5780,0.001367,172.31.33.0-255,66,120957,33,279042
5781,0.00137,172.217.194.0-255,1484,122441,33,279042
5782,0.001399,172.31.33.0-255,66,122507,33,279042
5783,0.001429,172.217.194.0-255,6438,128945,33,279042
5784,0.001432,172.31.33.0-255,66,129011,33,279042
5785,0.001666,172.217.194.0-255,1484,130495,33,279042
5786,0.001689,172.217.194.0-255,2902,133397,33,279042
5787,0.001692,172.31.33.0-255,66,133463,33,279042
5788,0.001695,172.217.194.0-255,1484,134947,33,279042
5789,0.001712,172.217.194.0-255,4320,139267,33,279042
5790,0.001714,172.31.33.0-255,66,139333,33,279042
5791,0.00173,172.217.194.0-255,4320,143653,33,279042
5792,0.001732,172.31.33.0-255,66,143719,33,279042
5793,0.001751,172.217.194.0-255,7156,150875,33,279042
5794,0.001753,172.31.33.0-255,66,150941,33,279042
5795,0.001757,172.217.194.0-255,4320,155261,33,279042
5796,0.001759,172.31.33.0-255,66,155327,33,279042
5797,0.001784,172.31.33.0-255,66,155393,33,279042
5798,0.002008,172.217.194.0-255,1484,156877,33,279042
5799,0.002023,172.217.194.0-255,2902,159779,33,279042
5800,0.002025,172.31.33.0-255,66,159845,33,279042
5801,0.002036,172.217.194.0-255,2902,162747,33,279042
5802,0.002038,172.31.33.0-255,66,162813,33,279042
5803,0.002054,172.217.194.0-255,2902,165715,33,279042
5804,0.002056,172.31.33.0-255,66,165781,33,279042
5805,0.002067,172.217.194.0-255,1484,167265,33,279042
5806,0.002097,172.31.33.0-255,66,167331,33,279042
5807,0.002105,172.31.33.0-255,66,167397,33,279042
5808,0.002147,172.217.194.0-255,1484,168881,33,279042
5809,0.002181,172.31.33.0-255,66,168947,33,279042
5810,0.002196,172.217.194.0-255,1484,170431,33,279042
5811,0.002208,172.217.194.0-255,4320,174751,33,279042
5812,0.002211,172.31.33.0-255,66,174817,33,279042
5813,0.002227,172.217.194.0-255,2902,177719,33,279042
5814,0.002229,172.31.33.0-255,66,177785,33,279042
5815,0.002248,172.217.194.0-255,6438,184223,33,279042
5816,0.00225,172.31.33.0-255,66,184289,33,279042
5817,0.002261,172.31.33.0-255,66,184355,33,279042
5818,0.002292,172.217.194.0-255,2902,187257,33,279042
5819,0.002294,172.31.33.0-255,66,187323,33,279042
5820,0.002307,172.31.33.0-255,66,187389,33,279042
5821,0.002309,172.217.194.0-255,766,188155,33,279042
5822,0.002348,172.217.194.0-255,4320,192475,33,279042
5823,0.002351,172.31.33.0-255,66,192541,33,279042
5824,0.00238,172.31.33.0-255,66,192607,33,279042
5825,0.002386,172.217.194.0-255,4320,196927,33,279042
5826,0.002388,172.31.33.0-255,66,196993,33,279042
5827,0.004704,172.217.194.0-255,1484,198477,33,279042
5828,0.004719,172.217.194.0-255,4320,202797,33,279042
5829,0.004723,172.31.33.0-255,66,202863,33,279042
5830,0.007097,172.217.194.0-255,5738,208601,33,279042
5831,0.007103,172.31.33.0-255,66,208667,33,279042
5832,0.009434,172.217.194.0-255,5738,214405,33,279042
5833,0.00944,172.31.33.0-255,66,214471,33,279042
5834,0.011793,172.217.194.0-255,5738,220209,33,279042
5835,0.0118,172.31.33.0-255,66,220275,33,279042
5836,0.014155,172.217.194.0-255,5738,226013,33,279042
5837,0.014162,172.31.33.0-255,66,226079,33,279042
5838,0.016507,172.217.194.0-255,5738,231817,33,279042
5839,0.016517,172.31.33.0-255,66,231883,33,279042
5840,0.018888,172.217.194.0-255,5738,237621,33,279042
5841,0.018895,172.31.33.0-255,66,237687,33,279042
5842,0.021231,172.217.194.0-255,5738,243425,33,279042
5843,0.021237,172.31.33.0-255,66,243491,33,279042
5844,0.023578,172.217.194.0-255,5738,249229,33,279042
5845,0.023584,172.31.33.0-255,66,249295,33,279042
5846,0.025958,172.217.194.0-255,5738,255033,33,279042
5847,0.025964,172.31.33.0-255,66,255099,33,279042
5848,0.028322,172.217.194.0-255,5738,260837,33,279042
5849,0.02833,172.31.33.0-255,66,260903,33,279042
5850,0.030657,172.217.194.0-255,5738,266641,33,279042
5851,0.030663,172.31.33.0-255,66,266707,33,279042
5852,0.033007,172.217.194.0-255,5738,272445,33,279042
5853,0.033012,172.31.33.0-255,66,272511,33,279042
5854,0.033355,172.31.33.0-255,172,272683,33,279042
5855,0.033396,172.31.33.0-255,1117,273800,33,279042
5856,0.033471,172.31.33.0-255,1514,275314,33,279042
5857,0.033474,172.31.33.0-255,1514,276828,33,279042
5858,0.033505,172.31.33.0-255,676,277504,33,279042
5859,0.034897,104.244.42.0-255,66,277570,33,279042
5860,0.034933,104.244.42.0-255,66,277636,33,279042
5861,0.035044,104.244.42.0-255,66,277702,33,279042
5862,0.035046,104.244.42.0-255,66,277768,33,279042
5863,0.035355,172.217.194.0-255,1037,278805,33,279042
5864,0.035496,172.31.33.0-255,66,278871,33,279042
5865,0.03552,172.31.33.0-255,105,278976,33,279042
5866,0.037829,172.217.194.0-255,66,279042,33,279042
5867,0.0,172.217.194.0-255,150,150,33,205215
5868,2.2e-05,172.31.33.0-255,66,216,33,205215
5869,2.8e-05,172.217.194.0-255,1484,1700,33,205215
5870,3.2e-05,172.31.33.0-255,66,1766,33,205215
5871,3.7e-05,172.217.194.0-255,2902,4668,33,205215
5872,4e-05,172.31.33.0-255,66,4734,33,205215
5873,4.7e-05,172.217.194.0-255,7156,11890,33,205215
5874,5e-05,172.31.33.0-255,66,11956,33,205215
5875,7.3e-05,172.217.194.0-255,2902,14858,33,205215
5876,7.5e-05,172.31.33.0-255,66,14924,33,205215
5877,0.0001,172.31.33.0-255,66,14990,33,205215
5878,0.000137,172.31.33.0-255,66,15056,33,205215
5879,0.000168,172.217.194.0-255,1484,16540,33,205215
5880,0.00017,172.31.33.0-255,66,16606,33,205215
5881,0.000173,172.217.194.0-255,1484,18090,33,205215
5882,0.000175,172.31.33.0-255,66,18156,33,205215
5883,0.00019,172.217.194.0-255,1484,19640,33,205215
5884,0.000192,172.31.33.0-255,66,19706,33,205215
5885,0.000198,172.217.194.0-255,5738,25444,33,205215
5886,0.0002,172.31.33.0-255,66,25510,33,205215
5887,0.000214,172.217.194.0-255,2902,28412,33,205215
5888,0.000217,172.31.33.0-255,66,28478,33,205215
5889,0.000242,172.31.33.0-255,66,28544,33,205215
5890,0.000247,172.217.194.0-255,5738,34282,33,205215
5891,0.00025,172.31.33.0-255,66,34348,33,205215
5892,0.000267,172.217.194.0-255,2902,37250,33,205215
5893,0.000269,172.31.33.0-255,66,37316,33,205215
5894,0.000273,172.217.194.0-255,1746,39062,33,205215
5895,0.000274,172.31.33.0-255,66,39128,33,205215
5896,0.000468,172.217.194.0-255,1484,40612,33,205215
5897,0.000475,172.217.194.0-255,2902,43514,33,205215
5898,0.000479,172.31.33.0-255,66,43580,33,205215
5899,0.000486,172.217.194.0-255,5738,49318,33,205215
5900,0.000488,172.31.33.0-255,66,49384,33,205215
5901,0.000517,172.217.194.0-255,5738,55122,33,205215
5902,0.00052,172.31.33.0-255,66,55188,33,205215
5903,0.000544,172.217.194.0-255,7156,62344,33,205215
5904,0.000547,172.31.33.0-255,66,62410,33,205215
5905,0.000553,172.217.194.0-255,7156,69566,33,205215
5906,0.000555,172.31.33.0-255,66,69632,33,205215
5907,0.000569,172.217.194.0-255,3602,73234,33,205215
5908,0.000571,172.31.33.0-255,66,73300,33,205215
5909,0.000813,172.217.194.0-255,1484,74784,33,205215
5910,0.000819,172.217.194.0-255,2902,77686,33,205215
5911,0.000822,172.31.33.0-255,66,77752,33,205215
5912,0.000828,172.217.194.0-255,2902,80654,33,205215
5913,0.000829,172.31.33.0-255,66,80720,33,205215
5914,0.000852,172.217.194.0-255,2902,83622,33,205215
5915,0.000855,172.31.33.0-255,66,83688,33,205215
5916,0.000862,172.217.194.0-255,7156,90844,33,205215
5917,0.000864,172.31.33.0-255,66,90910,33,205215
5918,0.000876,172.31.33.0-255,66,90976,33,205215
5919,0.000899,172.217.194.0-255,2902,93878,33,205215
5920,0.000901,172.31.33.0-255,66,93944,33,205215
5921,0.000905,172.217.194.0-255,2184,96128,33,205215
5922,0.000907,172.31.33.0-255,66,96194,33,205215
5923,0.001193,172.217.194.0-255,1484,97678,33,205215
5924,0.001197,172.217.194.0-255,2902,100580,33,205215
5925,0.001203,172.31.33.0-255,66,100646,33,205215
5926,0.00121,172.217.194.0-255,1484,102130,33,205215
5927,0.001226,172.217.194.0-255,4320,106450,33,205215
5928,0.001228,172.31.33.0-255,66,106516,33,205215
5929,0.001233,172.217.194.0-255,2902,109418,33,205215
5930,0.001234,172.31.33.0-255,66,109484,33,205215
5931,0.00127,172.31.33.0-255,66,109550,33,205215
5932,0.001276,172.217.194.0-255,7156,116706,33,205215
5933,0.001278,172.31.33.0-255,66,116772,33,205215
5934,0.001287,172.217.194.0-255,1484,118256,33,205215
5935,0.001301,172.217.194.0-255,3602,121858,33,205215
5936,0.001303,172.31.33.0-255,66,121924,33,205215
5937,0.001308,172.217.194.0-255,5738,127662,33,205215
5938,0.00131,172.31.33.0-255,66,127728,33,205215
5939,0.001323,172.217.194.0-255,1484,129212,33,205215
5940,0.001345,172.31.33.0-255,66,129278,33,205215
5941,0.001349,172.217.194.0-255,2902,132180,33,205215
5942,0.001351,172.31.33.0-255,66,132246,33,205215
5943,0.001372,172.31.33.0-255,66,132312,33,205215
5944,0.001403,172.217.194.0-255,1484,133796,33,205215
5945,0.001427,172.217.194.0-255,2902,136698,33,205215
5946,0.001431,172.31.33.0-255,66,136764,33,205215
5947,0.001436,172.217.194.0-255,5738,142502,33,205215
5948,0.001438,172.31.33.0-255,66,142568,33,205215
5949,0.001492,172.31.33.0-255,66,142634,33,205215
5950,0.001519,172.31.33.0-255,66,142700,33,205215
5951,0.00158,172.217.194.0-255,1484,144184,33,205215
5952,0.001597,172.217.194.0-255,2902,147086,33,205215
5953,0.0016,172.31.33.0-255,66,147152,33,205215
5954,0.001606,172.217.194.0-255,5738,152890,33,205215
5955,0.001608,172.31.33.0-255,66,152956,33,205215
5956,0.001632,172.217.194.0-255,7156,160112,33,205215
5957,0.001635,172.31.33.0-255,66,160178,33,205215
5958,0.001656,172.217.194.0-255,5738,165916,33,205215
5959,0.001658,172.31.33.0-255,66,165982,33,205215
5960,0.001669,172.31.33.0-255,66,166048,33,205215
5961,0.00171,172.217.194.0-255,2902,168950,33,205215
5962,0.001712,172.31.33.0-255,66,169016,33,205215
5963,0.00173,172.217.194.0-255,5738,174754,33,205215
5964,0.001732,172.31.33.0-255,66,174820,33,205215
5965,0.001759,172.217.194.0-255,2902,177722,33,205215
5966,0.001761,172.31.33.0-255,66,177788,33,205215
5967,0.001773,172.31.33.0-255,66,177854,33,205215
5968,0.001792,172.217.194.0-255,1484,179338,33,205215
5969,0.001812,172.217.194.0-255,4320,183658,33,205215
5970,0.001816,172.31.33.0-255,66,183724,33,205215
5971,0.001841,172.31.33.0-255,66,183790,33,205215
5972,0.001868,172.31.33.0-255,66,183856,33,205215
5973,0.001871,172.217.194.0-255,1484,185340,33,205215
5974,0.001903,172.31.33.0-255,66,185406,33,205215
5975,0.001935,172.31.33.0-255,66,185472,33,205215
5976,0.001962,172.31.33.0-255,66,185538,33,205215
5977,0.001999,172.31.33.0-255,66,185604,33,205215
5978,0.002419,172.217.194.0-255,1484,187088,33,205215
5979,0.002444,172.217.194.0-255,2902,189990,33,205215
5980,0.002447,172.31.33.0-255,66,190056,33,205215
5981,0.002453,172.217.194.0-255,5738,195794,33,205215
5982,0.002455,172.31.33.0-255,66,195860,33,205215
5983,0.002459,172.217.194.0-255,2902,198762,33,205215
5984,0.00246,172.31.33.0-255,66,198828,33,205215
5985,0.002519,172.31.33.0-255,66,198894,33,205215
5986,0.002532,172.31.33.0-255,66,198960,33,205215
5987,0.002535,172.217.194.0-255,105,199065,33,205215
5988,0.002602,172.217.194.0-255,129,199194,33,205215
5989,0.003991,172.31.33.0-255,105,199299,33,205215
5990,0.004027,172.31.33.0-255,105,199404,33,205215
5991,0.004312,172.31.33.0-255,90,199494,33,205215
5992,0.004323,172.31.33.0-255,66,199560,33,205215
5993,0.006572,172.217.194.0-255,66,199626,33,205215
5994,0.0066,172.217.194.0-255,66,199692,33,205215
5995,0.006857,172.217.194.0-255,66,199758,33,205215
5996,0.00688,172.217.194.0-255,66,199824,33,205215
5997,0.006885,172.31.33.0-255,66,199890,33,205215
5998,0.006889,172.217.194.0-255,66,199956,33,205215
5999,0.033002,172.31.33.0-255,172,200128,33,205215
6000,0.033033,172.31.33.0-255,1113,201241,33,205215
6001,0.033095,172.31.33.0-255,1514,202755,33,205215
6002,0.033097,172.31.33.0-255,1514,204269,33,205215
6003,0.033119,172.31.33.0-255,682,204951,33,205215
6004,0.034497,104.244.42.0-255,66,205017,33,205215
6005,0.034527,104.244.42.0-255,66,205083,33,205215
6006,0.034584,104.244.42.0-255,66,205149,33,205215
6007,0.034597,104.244.42.0-255,66,205215,33,205215
6008,0.0,172.31.33.0-255,105,105,33,459
6009,0.000176,172.31.33.0-255,90,195,33,459
6010,0.000186,172.31.33.0-255,66,261,33,459
6011,0.001775,172.217.160.0-255,66,327,33,459
6012,0.00181,172.217.160.0-255,66,393,33,459
6013,0.00182,172.31.33.0-255,66,459,33,459
6014,0.0,74.125.24.0-255,153,153,33,155096
6015,1.7e-05,172.31.33.0-255,66,219,33,155096
6016,2.2e-05,74.125.24.0-255,1484,1703,33,155096
6017,2.6e-05,172.31.33.0-255,66,1769,33,155096
6018,3.1e-05,74.125.24.0-255,2902,4671,33,155096
6019,4e-05,172.31.33.0-255,66,4737,33,155096
6020,4.8e-05,74.125.24.0-255,7156,11893,33,155096
6021,5.1e-05,172.31.33.0-255,66,11959,33,155096
6022,5.6e-05,74.125.24.0-255,3484,15443,33,155096
6023,5.8e-05,172.31.33.0-255,66,15509,33,155096
6024,0.000101,172.31.33.0-255,66,15575,33,155096
6025,0.000105,74.125.24.0-255,2543,18118,33,155096
6026,0.000107,172.31.33.0-255,66,18184,33,155096
6027,0.00023,74.125.24.0-255,1484,19668,33,155096
6028,0.000233,172.31.33.0-255,66,19734,33,155096
6029,0.000238,74.125.24.0-255,2902,22636,33,155096
6030,0.00024,172.31.33.0-255,66,22702,33,155096
6031,0.000244,74.125.24.0-255,2902,25604,33,155096
6032,0.000246,172.31.33.0-255,66,25670,33,155096
6033,0.00027,74.125.24.0-255,2902,28572,33,155096
6034,0.000273,172.31.33.0-255,66,28638,33,155096
6035,0.000277,74.125.24.0-255,2902,31540,33,155096
6036,0.000279,172.31.33.0-255,66,31606,33,155096
6037,0.000317,172.31.33.0-255,66,31672,33,155096
6038,0.000328,172.31.33.0-255,66,31738,33,155096
6039,0.00033,74.125.24.0-255,423,32161,33,155096
6040,0.000334,172.31.33.0-255,66,32227,33,155096
6041,0.000477,74.125.24.0-255,1484,33711,33,155096
6042,0.000481,172.31.33.0-255,66,33777,33,155096
6043,0.000508,74.125.24.0-255,2902,36679,33,155096
6044,0.000511,172.31.33.0-255,66,36745,33,155096
6045,0.000515,74.125.24.0-255,2902,39647,33,155096
6046,0.000517,172.31.33.0-255,66,39713,33,155096
6047,0.000543,74.125.24.0-255,7156,46869,33,155096
6048,0.000545,172.31.33.0-255,66,46935,33,155096
6049,0.000579,74.125.24.0-255,7156,54091,33,155096
6050,0.000591,172.31.33.0-255,66,54157,33,155096
6051,0.000598,172.31.33.0-255,66,54223,33,155096
6052,0.000634,74.125.24.0-255,3887,58110,33,155096
6053,0.000636,172.31.33.0-255,66,58176,33,155096
6054,0.000738,74.125.24.0-255,1484,59660,33,155096
6055,0.000743,74.125.24.0-255,2902,62562,33,155096
6056,0.000746,172.31.33.0-255,66,62628,33,155096
6057,0.000771,74.125.24.0-255,5738,68366,33,155096
6058,0.000774,172.31.33.0-255,66,68432,33,155096
6059,0.000805,172.31.33.0-255,66,68498,33,155096
6060,0.000831,74.125.24.0-255,1484,69982,33,155096
6061,0.000843,172.31.33.0-255,66,70048,33,155096
6062,0.000877,172.31.33.0-255,66,70114,33,155096
6063,0.000909,172.31.33.0-255,66,70180,33,155096
6064,0.000914,74.125.24.0-255,4320,74500,33,155096
6065,0.000916,172.31.33.0-255,66,74566,33,155096
6066,0.00092,74.125.24.0-255,2184,76750,33,155096
6067,0.000925,172.31.33.0-255,66,76816,33,155096
6068,0.000952,74.125.24.0-255,2902,79718,33,155096
6069,0.000954,172.31.33.0-255,66,79784,33,155096
6070,0.000983,74.125.24.0-255,5738,85522,33,155096
6071,0.000986,172.31.33.0-255,66,85588,33,155096
6072,0.001003,74.125.24.0-255,5738,91326,33,155096
6073,0.001006,172.31.33.0-255,66,91392,33,155096
6074,0.001028,74.125.24.0-255,4320,95712,33,155096
6075,0.00103,172.31.33.0-255,66,95778,33,155096
6076,0.001039,172.31.33.0-255,66,95844,33,155096
6077,0.001063,74.125.24.0-255,2902,98746,33,155096
6078,0.001065,172.31.33.0-255,66,98812,33,155096
6079,0.001068,74.125.24.0-255,1484,100296,33,155096
6080,0.001094,74.125.24.0-255,2184,102480,33,155096
6081,0.001096,172.31.33.0-255,66,102546,33,155096
6082,0.001177,74.125.24.0-255,1484,104030,33,155096
6083,0.00118,74.125.24.0-255,1484,105514,33,155096
6084,0.001183,172.31.33.0-255,66,105580,33,155096
6085,0.001205,74.125.24.0-255,1484,107064,33,155096
6086,0.00121,74.125.24.0-255,5738,112802,33,155096
6087,0.001212,172.31.33.0-255,66,112868,33,155096
6088,0.001223,74.125.24.0-255,1484,114352,33,155096
6089,0.001252,172.31.33.0-255,66,114418,33,155096
6090,0.001314,172.31.33.0-255,66,114484,33,155096
6091,0.001317,74.125.24.0-255,2184,116668,33,155096
6092,0.001319,172.31.33.0-255,66,116734,33,155096
6093,0.001415,74.125.24.0-255,1484,118218,33,155096
6094,0.00142,74.125.24.0-255,2902,121120,33,155096
6095,0.001424,172.31.33.0-255,66,121186,33,155096
6096,0.00145,74.125.24.0-255,5738,126924,33,155096
6097,0.001453,172.31.33.0-255,66,126990,33,155096
6098,0.001457,74.125.24.0-255,2902,129892,33,155096
6099,0.001459,172.31.33.0-255,66,129958,33,155096
6100,0.001498,172.31.33.0-255,66,130024,33,155096
6101,0.00151,172.31.33.0-255,66,130090,33,155096
6102,0.001521,172.31.33.0-255,66,130156,33,155096
6103,0.001567,172.31.33.0-255,66,130222,33,155096
6104,0.001607,172.31.33.0-255,66,130288,33,155096
6105,0.001617,172.31.33.0-255,66,130354,33,155096
6106,0.001656,74.125.24.0-255,7156,137510,33,155096
6107,0.001659,172.31.33.0-255,66,137576,33,155096
6108,0.001703,74.125.24.0-255,4320,141896,33,155096
6109,0.001706,172.31.33.0-255,66,141962,33,155096
6110,0.001709,172.31.33.0-255,66,142028,33,155096
6111,0.001754,172.31.33.0-255,66,142094,33,155096
6112,0.001788,172.31.33.0-255,66,142160,33,155096
6113,0.001814,74.125.24.0-255,7097,149257,33,155096
6114,0.001821,172.31.33.0-255,66,149323,33,155096
6115,0.001842,74.125.24.0-255,105,149428,33,155096
6116,0.003969,172.31.33.0-255,66,149494,33,155096
6117,0.004007,172.31.33.0-255,105,149599,33,155096
6118,0.006258,74.125.24.0-255,66,149665,33,155096
6119,0.025169,172.31.33.0-255,172,149837,33,155096
6120,0.025202,172.31.33.0-255,1117,150954,33,155096
6121,0.025268,172.31.33.0-255,1514,152468,33,155096
6122,0.025288,172.31.33.0-255,1514,153982,33,155096
6123,0.025291,172.31.33.0-255,676,154658,33,155096
6124,0.026697,104.244.42.0-255,66,154724,33,155096
6125,0.026722,104.244.42.0-255,66,154790,33,155096
6126,0.026787,104.244.42.0-255,66,154856,33,155096
6127,0.026792,104.244.42.0-255,66,154922,33,155096
6128,0.027486,104.244.42.0-255,108,155030,33,155096
6129,0.027493,172.31.33.0-255,66,155096,33,155096
6130,0.0,74.125.130.0-255,153,153,33,385749
6131,2.2e-05,172.31.33.0-255,66,219,33,385749
6132,3e-05,74.125.130.0-255,1484,1703,33,385749
6133,3.4e-05,172.31.33.0-255,66,1769,33,385749
6134,3.8e-05,74.125.130.0-255,1484,3253,33,385749
6135,5.1e-05,172.31.33.0-255,66,3319,33,385749
6136,5.9e-05,74.125.130.0-255,2902,6221,33,385749
6137,6.2e-05,172.31.33.0-255,66,6287,33,385749
6138,6.7e-05,74.125.130.0-255,2902,9189,33,385749
6139,7.1e-05,172.31.33.0-255,66,9255,33,385749
6140,9.6e-05,74.125.130.0-255,2902,12157,33,385749
6141,9.9e-05,172.31.33.0-255,66,12223,33,385749
6142,0.000104,74.125.130.0-255,1974,14197,33,385749
6143,0.000107,172.31.33.0-255,66,14263,33,385749
6144,0.000197,74.125.130.0-255,1484,15747,33,385749
6145,0.000203,172.31.33.0-255,66,15813,33,385749
6146,0.000207,74.125.130.0-255,1484,17297,33,385749
6147,0.000209,172.31.33.0-255,66,17363,33,385749
6148,0.000243,74.125.130.0-255,1484,18847,33,385749
6149,0.000249,172.31.33.0-255,66,18913,33,385749
6150,0.000256,74.125.130.0-255,5738,24651,33,385749
6151,0.000259,172.31.33.0-255,66,24717,33,385749
6152,0.000284,74.125.130.0-255,2902,27619,33,385749
6153,0.000287,172.31.33.0-255,66,27685,33,385749
6154,0.000292,74.125.130.0-255,3961,31646,33,385749
6155,0.000295,172.31.33.0-255,66,31712,33,385749
6156,0.000324,74.125.130.0-255,1484,33196,33,385749
6157,0.000327,172.31.33.0-255,66,33262,33,385749
6158,0.000332,74.125.130.0-255,2902,36164,33,385749
6159,0.000337,172.31.33.0-255,66,36230,33,385749
6160,0.000357,74.125.130.0-255,2902,39132,33,385749
6161,0.00036,172.31.33.0-255,66,39198,33,385749
6162,0.000367,74.125.130.0-255,4320,43518,33,385749
6163,0.000369,172.31.33.0-255,66,43584,33,385749
6164,0.000418,74.125.130.0-255,5379,48963,33,385749
6165,0.000422,172.31.33.0-255,66,49029,33,385749
6166,0.000628,74.125.130.0-255,1484,50513,33,385749
6167,0.000655,74.125.130.0-255,2902,53415,33,385749
6168,0.00066,172.31.33.0-255,66,53481,33,385749
6169,0.000667,74.125.130.0-255,4320,57801,33,385749
6170,0.000669,172.31.33.0-255,66,57867,33,385749
6171,0.000706,74.125.130.0-255,5738,63605,33,385749
6172,0.00071,172.31.33.0-255,66,63671,33,385749
6173,0.000719,74.125.130.0-255,2543,66214,33,385749
6174,0.000721,172.31.33.0-255,66,66280,33,385749
6175,0.000744,74.125.130.0-255,4320,70600,33,385749
6176,0.000747,172.31.33.0-255,66,70666,33,385749
6177,0.000773,74.125.130.0-255,4320,74986,33,385749
6178,0.000775,74.125.130.0-255,1484,76470,33,385749
6179,0.000777,172.31.33.0-255,66,76536,33,385749
6180,0.000779,74.125.130.0-255,2902,79438,33,385749
6181,0.000782,172.31.33.0-255,66,79504,33,385749
6182,0.000805,74.125.130.0-255,4251,83755,33,385749
6183,0.000813,172.31.33.0-255,66,83821,33,385749
6184,0.000913,74.125.130.0-255,1484,85305,33,385749
6185,0.000928,74.125.130.0-255,2902,88207,33,385749
6186,0.000934,172.31.33.0-255,66,88273,33,385749
6187,0.000939,74.125.130.0-255,2902,91175,33,385749
6188,0.000941,172.31.33.0-255,66,91241,33,385749
6189,0.00096,74.125.130.0-255,2902,94143,33,385749
6190,0.000962,172.31.33.0-255,66,94209,33,385749
6191,0.000969,74.125.130.0-255,1484,95693,33,385749
6192,0.000973,74.125.130.0-255,2902,98595,33,385749
6193,0.000975,172.31.33.0-255,66,98661,33,385749
6194,0.001018,74.125.130.0-255,5738,104399,33,385749
6195,0.001021,172.31.33.0-255,66,104465,33,385749
6196,0.001024,74.125.130.0-255,2902,107367,33,385749
6197,0.001026,172.31.33.0-255,66,107433,33,385749
6198,0.001029,74.125.130.0-255,1484,108917,33,385749
6199,0.001057,74.125.130.0-255,2902,111819,33,385749
6200,0.001061,172.31.33.0-255,66,111885,33,385749
6201,0.001102,74.125.130.0-255,6438,118323,33,385749
6202,0.001105,172.31.33.0-255,66,118389,33,385749
6203,0.001108,74.125.130.0-255,1484,119873,33,385749
6204,0.00111,74.125.130.0-255,1484,121357,33,385749
6205,0.001113,172.31.33.0-255,66,121423,33,385749
6206,0.001142,74.125.130.0-255,1484,122907,33,385749
6207,0.001149,74.125.130.0-255,5738,128645,33,385749
6208,0.001152,172.31.33.0-255,66,128711,33,385749
6209,0.001157,74.125.130.0-255,2902,131613,33,385749
6210,0.001159,172.31.33.0-255,66,131679,33,385749
6211,0.001181,74.125.130.0-255,4237,135916,33,385749
6212,0.001188,172.31.33.0-255,66,135982,33,385749
6213,0.001258,74.125.130.0-255,1484,137466,33,385749
6214,0.001285,74.125.130.0-255,2902,140368,33,385749
6215,0.001288,172.31.33.0-255,66,140434,33,385749
6216,0.001291,74.125.130.0-255,1484,141918,33,385749
6217,0.001315,74.125.130.0-255,4320,146238,33,385749
6218,0.001318,172.31.33.0-255,66,146304,33,385749
6219,0.001321,74.125.130.0-255,1484,147788,33,385749
6220,0.001347,74.125.130.0-255,7156,154944,33,385749
6221,0.001351,172.31.33.0-255,66,155010,33,385749
6222,0.001375,74.125.130.0-255,1484,156494,33,385749
6223,0.001381,74.125.130.0-255,4320,160814,33,385749
6224,0.001384,172.31.33.0-255,66,160880,33,385749
6225,0.001389,74.125.130.0-255,2902,163782,33,385749
6226,0.00139,172.31.33.0-255,66,163848,33,385749
6227,0.001419,74.125.130.0-255,2902,166750,33,385749
6228,0.001422,172.31.33.0-255,66,166816,33,385749
6229,0.001427,74.125.130.0-255,3602,170418,33,385749
6230,0.00143,172.31.33.0-255,66,170484,33,385749
6231,0.001495,74.125.130.0-255,1484,171968,33,385749
6232,0.001499,74.125.130.0-255,1484,173452,33,385749
6233,0.001505,172.31.33.0-255,66,173518,33,385749
6234,0.001535,74.125.130.0-255,2902,176420,33,385749
6235,0.001539,172.31.33.0-255,66,176486,33,385749
6236,0.001544,74.125.130.0-255,4320,180806,33,385749
6237,0.001546,172.31.33.0-255,66,180872,33,385749
6238,0.001569,74.125.130.0-255,1484,182356,33,385749
6239,0.001581,172.31.33.0-255,66,182422,33,385749
6240,0.001586,74.125.130.0-255,2902,185324,33,385749
6241,0.001589,172.31.33.0-255,66,185390,33,385749
6242,0.001629,172.31.33.0-255,66,185456,33,385749
6243,0.001632,74.125.130.0-255,766,186222,33,385749
6244,0.001967,172.31.33.0-255,66,186288,33,385749
6245,0.002303,74.125.130.0-255,1484,187772,33,385749
6246,0.002312,74.125.130.0-255,1484,189256,33,385749
6247,0.002316,172.31.33.0-255,66,189322,33,385749
6248,0.002322,74.125.130.0-255,2902,192224,33,385749
6249,0.002324,172.31.33.0-255,66,192290,33,385749
6250,0.002343,74.125.130.0-255,1484,193774,33,385749
6251,0.002365,74.125.130.0-255,4320,198094,33,385749
6252,0.002368,172.31.33.0-255,66,198160,33,385749
6253,0.002371,74.125.130.0-255,1484,199644,33,385749
6254,0.004725,74.125.130.0-255,4320,203964,33,385749
6255,0.004731,172.31.33.0-255,66,204030,33,385749
6256,0.007099,74.125.130.0-255,5738,209768,33,385749
6257,0.007102,172.31.33.0-255,66,209834,33,385749
6258,0.009458,74.125.130.0-255,5738,215572,33,385749
6259,0.009465,172.31.33.0-255,66,215638,33,385749
6260,0.011811,74.125.130.0-255,5738,221376,33,385749
6261,0.011819,172.31.33.0-255,66,221442,33,385749
6262,0.014162,74.125.130.0-255,5738,227180,33,385749
6263,0.014169,172.31.33.0-255,66,227246,33,385749
6264,0.01652,74.125.130.0-255,5738,232984,33,385749
6265,0.016528,172.31.33.0-255,66,233050,33,385749
6266,0.01888,74.125.130.0-255,5738,238788,33,385749
6267,0.018888,172.31.33.0-255,66,238854,33,385749
6268,0.02124,74.125.130.0-255,5738,244592,33,385749
6269,0.021246,172.31.33.0-255,66,244658,33,385749
6270,0.023592,74.125.130.0-255,5738,250396,33,385749
6271,0.023598,172.31.33.0-255,66,250462,33,385749
6272,0.025943,74.125.130.0-255,5738,256200,33,385749
6273,0.025949,172.31.33.0-255,66,256266,33,385749
6274,0.028293,74.125.130.0-255,5738,262004,33,385749
6275,0.028298,172.31.33.0-255,66,262070,33,385749
6276,0.028719,172.31.33.0-255,172,262242,33,385749
6277,0.028754,172.31.33.0-255,1113,263355,33,385749
6278,0.028821,172.31.33.0-255,1514,264869,33,385749
6279,0.028823,172.31.33.0-255,1514,266383,33,385749
6280,0.02885,172.31.33.0-255,680,267063,33,385749
6281,0.030266,104.244.42.0-255,66,267129,33,385749
6282,0.030345,104.244.42.0-255,66,267195,33,385749
6283,0.030377,104.244.42.0-255,66,267261,33,385749
6284,0.030379,104.244.42.0-255,66,267327,33,385749
6285,0.030674,74.125.130.0-255,4320,271647,33,385749
6286,0.030678,172.31.33.0-255,66,271713,33,385749
6287,0.030705,74.125.130.0-255,1484,273197,33,385749
6288,0.033015,74.125.130.0-255,4320,277517,33,385749
6289,0.033023,172.31.33.0-255,66,277583,33,385749
6290,0.035362,74.125.130.0-255,5738,283321,33,385749
6291,0.035368,172.31.33.0-255,66,283387,33,385749
6292,0.037702,74.125.130.0-255,4320,287707,33,385749
6293,0.037707,172.31.33.0-255,66,287773,33,385749
6294,0.037733,74.125.130.0-255,1484,289257,33,385749
6295,0.04005,74.125.130.0-255,4320,293577,33,385749
6296,0.040056,172.31.33.0-255,66,293643,33,385749
6297,0.042405,74.125.130.0-255,5738,299381,33,385749
6298,0.04241,172.31.33.0-255,66,299447,33,385749
6299,0.044754,74.125.130.0-255,2902,302349,33,385749
6300,0.044759,172.31.33.0-255,66,302415,33,385749
6301,0.04478,74.125.130.0-255,2902,305317,33,385749
6302,0.044783,172.31.33.0-255,66,305383,33,385749
6303,0.047091,74.125.130.0-255,2902,308285,33,385749
6304,0.047096,172.31.33.0-255,66,308351,33,385749
6305,0.047122,74.125.130.0-255,2902,311253,33,385749
6306,0.047124,172.31.33.0-255,66,311319,33,385749
6307,0.049448,74.125.130.0-255,5738,317057,33,385749
6308,0.049455,172.31.33.0-255,66,317123,33,385749
6309,0.051811,74.125.130.0-255,5738,322861,33,385749
6310,0.051818,172.31.33.0-255,66,322927,33,385749
6311,0.05416,74.125.130.0-255,4320,327247,33,385749
6312,0.054165,172.31.33.0-255,66,327313,33,385749
6313,0.054202,74.125.130.0-255,1484,328797,33,385749
6314,0.0565,74.125.130.0-255,4320,333117,33,385749
6315,0.056506,172.31.33.0-255,66,333183,33,385749
6316,0.058842,74.125.130.0-255,4320,337503,33,385749
6317,0.058847,172.31.33.0-255,66,337569,33,385749
6318,0.058873,74.125.130.0-255,1484,339053,33,385749
6319,0.061186,74.125.130.0-255,4320,343373,33,385749
6320,0.06119,172.31.33.0-255,66,343439,33,385749
6321,0.063529,74.125.130.0-255,5738,349177,33,385749
6322,0.063535,172.31.33.0-255,66,349243,33,385749
6323,0.06588,74.125.130.0-255,5738,354981,33,385749
6324,0.065886,172.31.33.0-255,66,355047,33,385749
6325,0.06823,74.125.130.0-255,4320,359367,33,385749
6326,0.068237,172.31.33.0-255,66,359433,33,385749
6327,0.068265,74.125.130.0-255,1484,360917,33,385749
6328,0.070597,74.125.130.0-255,4320,365237,33,385749
6329,0.070601,172.31.33.0-255,66,365303,33,385749
6330,0.072943,74.125.130.0-255,5738,371041,33,385749
6331,0.072949,172.31.33.0-255,66,371107,33,385749
6332,0.07529,74.125.130.0-255,4320,375427,33,385749
6333,0.075295,172.31.33.0-255,66,375493,33,385749
6334,0.075319,74.125.130.0-255,1484,376977,33,385749
6335,0.07763,74.125.130.0-255,4320,381297,33,385749
6336,0.077635,172.31.33.0-255,66,381363,33,385749
6337,0.079983,74.125.130.0-255,4320,385683,33,385749
6338,0.079988,172.31.33.0-255,66,385749,33,385749
6339,0.0,172.31.33.0-255,105,105,33,459
6340,0.00026,172.31.33.0-255,90,195,33,459
6341,0.000269,172.31.33.0-255,66,261,33,459
6342,0.002217,74.125.24.0-255,66,327,33,459
6343,0.002232,74.125.24.0-255,66,393,33,459
6344,0.002243,172.31.33.0-255,66,459,33,459
6345,0.0,74.125.68.0-255,153,153,33,390338
6346,2.2e-05,172.31.33.0-255,66,219,33,390338
6347,5.2e-05,74.125.68.0-255,1484,1703,33,390338
6348,5.7e-05,172.31.33.0-255,66,1769,33,390338
6349,6.2e-05,74.125.68.0-255,2902,4671,33,390338
6350,6.5e-05,172.31.33.0-255,66,4737,33,390338
6351,8.9e-05,74.125.68.0-255,5738,10475,33,390338
6352,9.2e-05,172.31.33.0-255,66,10541,33,390338
6353,0.000122,74.125.68.0-255,2902,13443,33,390338
6354,0.000124,172.31.33.0-255,66,13509,33,390338
6355,0.000129,74.125.68.0-255,3446,16955,33,390338
6356,0.000133,172.31.33.0-255,66,17021,33,390338
6357,0.000153,74.125.68.0-255,2902,19923,33,390338
6358,0.000155,172.31.33.0-255,66,19989,33,390338
6359,0.000184,74.125.68.0-255,5738,25727,33,390338
6360,0.000187,172.31.33.0-255,66,25793,33,390338
6361,0.000214,74.125.68.0-255,5379,31172,33,390338
6362,0.000218,172.31.33.0-255,66,31238,33,390338
6363,0.000573,74.125.68.0-255,1484,32722,33,390338
6364,0.000578,172.31.33.0-255,66,32788,33,390338
6365,0.000586,74.125.68.0-255,2902,35690,33,390338
6366,0.000588,172.31.33.0-255,66,35756,33,390338
6367,0.000599,74.125.68.0-255,2902,38658,33,390338
6368,0.000601,172.31.33.0-255,66,38724,33,390338
6369,0.000607,74.125.68.0-255,4320,43044,33,390338
6370,0.000609,172.31.33.0-255,66,43110,33,390338
6371,0.000614,74.125.68.0-255,4320,47430,33,390338
6372,0.000616,172.31.33.0-255,66,47496,33,390338
6373,0.000648,74.125.68.0-255,1125,48621,33,390338
6374,0.000651,172.31.33.0-255,66,48687,33,390338
6375,0.000677,74.125.68.0-255,1484,50171,33,390338
6376,0.000679,172.31.33.0-255,66,50237,33,390338
6377,0.000699,74.125.68.0-255,4320,54557,33,390338
6378,0.000701,172.31.33.0-255,66,54623,33,390338
6379,0.000726,74.125.68.0-255,2902,57525,33,390338
6380,0.000728,172.31.33.0-255,66,57591,33,390338
6381,0.000732,74.125.68.0-255,2902,60493,33,390338
6382,0.000734,172.31.33.0-255,66,60559,33,390338
6383,0.000753,74.125.68.0-255,1484,62043,33,390338
6384,0.000768,74.125.68.0-255,2902,64945,33,390338
6385,0.00077,172.31.33.0-255,66,65011,33,390338
6386,0.000792,74.125.68.0-255,1437,66448,33,390338
6387,0.000844,74.125.68.0-255,110,66558,33,390338
6388,0.000979,74.125.68.0-255,1484,68042,33,390338
6389,0.000985,172.31.33.0-255,66,68108,33,390338
6390,0.000989,74.125.68.0-255,2902,71010,33,390338
6391,0.000991,172.31.33.0-255,66,71076,33,390338
6392,0.001014,74.125.68.0-255,5738,76814,33,390338
6393,0.001016,172.31.33.0-255,66,76880,33,390338
6394,0.00102,74.125.68.0-255,2902,79782,33,390338
6395,0.001021,172.31.33.0-255,66,79848,33,390338
6396,0.001048,74.125.68.0-255,4320,84168,33,390338
6397,0.001051,172.31.33.0-255,66,84234,33,390338
6398,0.001056,74.125.68.0-255,5738,89972,33,390338
6399,0.001058,172.31.33.0-255,66,90038,33,390338
6400,0.001087,74.125.68.0-255,2902,92940,33,390338
6401,0.001089,172.31.33.0-255,66,93006,33,390338
6402,0.001094,74.125.68.0-255,5738,98744,33,390338
6403,0.001096,172.31.33.0-255,66,98810,33,390338
6404,0.001098,74.125.68.0-255,1484,100294,33,390338
6405,0.001125,74.125.68.0-255,5020,105314,33,390338
6406,0.001127,172.31.33.0-255,66,105380,33,390338
6407,0.00113,74.125.68.0-255,2902,108282,33,390338
6408,0.001132,172.31.33.0-255,66,108348,33,390338
6409,0.001136,74.125.68.0-255,4320,112668,33,390338
6410,0.001138,172.31.33.0-255,66,112734,33,390338
6411,0.001167,74.125.68.0-255,7156,119890,33,390338
6412,0.001169,172.31.33.0-255,66,119956,33,390338
6413,0.00119,74.125.68.0-255,1484,121440,33,390338
6414,0.001197,74.125.68.0-255,7156,128596,33,390338
6415,0.001199,172.31.33.0-255,66,128662,33,390338
6416,0.00124,74.125.68.0-255,6702,135364,33,390338
6417,0.001242,172.31.33.0-255,66,135430,33,390338
6418,0.001781,74.125.68.0-255,1484,136914,33,390338
6419,0.0018,74.125.68.0-255,2902,139816,33,390338
6420,0.001803,172.31.33.0-255,66,139882,33,390338
6421,0.001831,74.125.68.0-255,1484,141366,33,390338
6422,0.001878,74.125.68.0-255,2902,144268,33,390338
6423,0.001881,172.31.33.0-255,66,144334,33,390338
6424,0.001887,74.125.68.0-255,5738,150072,33,390338
6425,0.001889,172.31.33.0-255,66,150138,33,390338
6426,0.001899,74.125.68.0-255,5738,155876,33,390338
6427,0.001901,172.31.33.0-255,66,155942,33,390338
6428,0.001908,74.125.68.0-255,7156,163098,33,390338
6429,0.00191,172.31.33.0-255,66,163164,33,390338
6430,0.001943,74.125.68.0-255,6438,169602,33,390338
6431,0.001945,172.31.33.0-255,66,169668,33,390338
6432,0.002035,74.125.68.0-255,1484,171152,33,390338
6433,0.002049,74.125.68.0-255,2902,174054,33,390338
6434,0.002052,172.31.33.0-255,66,174120,33,390338
6435,0.002077,74.125.68.0-255,5738,179858,33,390338
6436,0.002079,172.31.33.0-255,66,179924,33,390338
6437,0.002104,74.125.68.0-255,4320,184244,33,390338
6438,0.002107,172.31.33.0-255,66,184310,33,390338
6439,0.002113,74.125.68.0-255,5738,190048,33,390338
6440,0.002115,172.31.33.0-255,66,190114,33,390338
6441,0.002146,74.125.68.0-255,4320,194434,33,390338
6442,0.002148,172.31.33.0-255,66,194500,33,390338
6443,0.002173,74.125.68.0-255,5738,200238,33,390338
6444,0.002176,172.31.33.0-255,66,200304,33,390338
6445,0.00218,74.125.68.0-255,2902,203206,33,390338
6446,0.002182,172.31.33.0-255,66,203272,33,390338
6447,0.002207,172.31.33.0-255,66,203338,33,390338
6448,0.002215,74.125.68.0-255,2902,206240,33,390338
6449,0.002217,172.31.33.0-255,66,206306,33,390338
6450,0.002243,74.125.68.0-255,2902,209208,33,390338
6451,0.002245,172.31.33.0-255,66,209274,33,390338
6452,0.002284,172.31.33.0-255,66,209340,33,390338
6453,0.002287,74.125.68.0-255,1484,210824,33,390338
6454,0.004493,74.125.68.0-255,2902,213726,33,390338
6455,0.004496,172.31.33.0-255,66,213792,33,390338
6456,0.004519,74.125.68.0-255,1484,215276,33,390338
6457,0.006715,74.125.68.0-255,4320,219596,33,390338
6458,0.006721,172.31.33.0-255,66,219662,33,390338
6459,0.008934,74.125.68.0-255,4320,223982,33,390338
6460,0.00894,172.31.33.0-255,66,224048,33,390338
6461,0.008965,74.125.68.0-255,1484,225532,33,390338
6462,0.01117,74.125.68.0-255,4320,229852,33,390338
6463,0.011177,172.31.33.0-255,66,229918,33,390338
6464,0.013417,74.125.68.0-255,5738,235656,33,390338
6465,0.013427,172.31.33.0-255,66,235722,33,390338
6466,0.015648,74.125.68.0-255,5738,241460,33,390338
6467,0.015654,172.31.33.0-255,66,241526,33,390338
6468,0.017878,74.125.68.0-255,4320,245846,33,390338
6469,0.017884,172.31.33.0-255,66,245912,33,390338
6470,0.017906,74.125.68.0-255,1484,247396,33,390338
6471,0.020098,74.125.68.0-255,4320,251716,33,390338
6472,0.020104,172.31.33.0-255,66,251782,33,390338
6473,0.022328,74.125.68.0-255,5738,257520,33,390338
6474,0.022335,172.31.33.0-255,66,257586,33,390338
6475,0.02455,74.125.68.0-255,5738,263324,33,390338
6476,0.024556,172.31.33.0-255,66,263390,33,390338
6477,0.025484,172.31.33.0-255,172,263562,33,390338
6478,0.025511,172.31.33.0-255,1117,264679,33,390338
6479,0.025542,172.31.33.0-255,1514,266193,33,390338
6480,0.02556,172.31.33.0-255,1514,267707,33,390338
6481,0.025562,172.31.33.0-255,170,267877,33,390338
6482,0.026777,74.125.68.0-255,2902,270779,33,390338
6483,0.026783,172.31.33.0-255,66,270845,33,390338
6484,0.026817,74.125.68.0-255,2902,273747,33,390338
6485,0.026821,172.31.33.0-255,66,273813,33,390338
6486,0.027032,104.244.42.0-255,66,273879,33,390338
6487,0.027065,104.244.42.0-255,66,273945,33,390338
6488,0.027208,104.244.42.0-255,66,274011,33,390338
6489,0.028995,74.125.68.0-255,1484,275495,33,390338
6490,0.029022,74.125.68.0-255,4320,279815,33,390338
6491,0.029026,172.31.33.0-255,66,279881,33,390338
6492,0.031252,74.125.68.0-255,5738,285619,33,390338
6493,0.031258,172.31.33.0-255,66,285685,33,390338
6494,0.033475,74.125.68.0-255,2902,288587,33,390338
6495,0.033481,172.31.33.0-255,66,288653,33,390338
6496,0.033512,74.125.68.0-255,2902,291555,33,390338
6497,0.033515,172.31.33.0-255,66,291621,33,390338
6498,0.035689,74.125.68.0-255,2902,294523,33,390338
6499,0.035693,172.31.33.0-255,66,294589,33,390338
6500,0.035722,74.125.68.0-255,2902,297491,33,390338
6501,0.035725,172.31.33.0-255,66,297557,33,390338
6502,0.037965,74.125.68.0-255,5738,303295,33,390338
6503,0.037969,172.31.33.0-255,66,303361,33,390338
6504,0.040225,74.125.68.0-255,5738,309099,33,390338
6505,0.04023,172.31.33.0-255,66,309165,33,390338
6506,0.042452,74.125.68.0-255,5738,314903,33,390338
6507,0.04246,172.31.33.0-255,66,314969,33,390338
6508,0.044702,74.125.68.0-255,5738,320707,33,390338
6509,0.044718,172.31.33.0-255,66,320773,33,390338
6510,0.046971,74.125.68.0-255,5738,326511,33,390338
6511,0.046985,172.31.33.0-255,66,326577,33,390338
6512,0.049227,74.125.68.0-255,5738,332315,33,390338
6513,0.049239,172.31.33.0-255,66,332381,33,390338
6514,0.051486,74.125.68.0-255,5738,338119,33,390338
6515,0.051499,172.31.33.0-255,66,338185,33,390338
6516,0.053755,74.125.68.0-255,5738,343923,33,390338
6517,0.053772,172.31.33.0-255,66,343989,33,390338
6518,0.055999,74.125.68.0-255,5738,349727,33,390338
6519,0.056003,172.31.33.0-255,66,349793,33,390338
6520,0.058244,74.125.68.0-255,5738,355531,33,390338
6521,0.05826,172.31.33.0-255,66,355597,33,390338
6522,0.060512,74.125.68.0-255,5738,361335,33,390338
6523,0.060532,172.31.33.0-255,66,361401,33,390338
6524,0.062771,74.125.68.0-255,5738,367139,33,390338
6525,0.062791,172.31.33.0-255,66,367205,33,390338
6526,0.065044,74.125.68.0-255,5738,372943,33,390338
6527,0.065064,172.31.33.0-255,66,373009,33,390338
6528,0.067306,74.125.68.0-255,5738,378747,33,390338
6529,0.067342,172.31.33.0-255,66,378813,33,390338
6530,0.069587,74.125.68.0-255,5738,384551,33,390338
6531,0.069599,172.31.33.0-255,66,384617,33,390338
6532,0.071848,74.125.68.0-255,5484,390101,33,390338
6533,0.071869,172.31.33.0-255,66,390167,33,390338
6534,0.072228,172.31.33.0-255,105,390272,33,390338
6535,0.074448,74.125.68.0-255,66,390338,33,390338
6536,0.0,74.125.24.0-255,153,153,33,336135
6537,1.4e-05,172.31.33.0-255,66,219,33,336135
6538,2e-05,74.125.24.0-255,1484,1703,33,336135
6539,2.4e-05,172.31.33.0-255,66,1769,33,336135
6540,3.5e-05,74.125.24.0-255,2902,4671,33,336135
6541,3.8e-05,172.31.33.0-255,66,4737,33,336135
6542,4.1e-05,74.125.24.0-255,1484,6221,33,336135
6543,4.3e-05,172.31.33.0-255,66,6287,33,336135
6544,6.2e-05,74.125.24.0-255,5738,12025,33,336135
6545,6.7e-05,172.31.33.0-255,66,12091,33,336135
6546,7.1e-05,74.125.24.0-255,1991,14082,33,336135
6547,7.3e-05,172.31.33.0-255,66,14148,33,336135
6548,0.000553,74.125.24.0-255,1484,15632,33,336135
6549,0.000558,172.31.33.0-255,66,15698,33,336135
6550,0.000566,74.125.24.0-255,2902,18600,33,336135
6551,0.000568,172.31.33.0-255,66,18666,33,336135
6552,0.000593,74.125.24.0-255,5738,24404,33,336135
6553,0.000595,172.31.33.0-255,66,24470,33,336135
6554,0.000598,74.125.24.0-255,1484,25954,33,336135
6555,0.000599,172.31.33.0-255,66,26020,33,336135
6556,0.000648,74.125.24.0-255,4320,30340,33,336135
6557,0.000652,172.31.33.0-255,66,30406,33,336135
6558,0.000671,74.125.24.0-255,1125,31531,33,336135
6559,0.000674,172.31.33.0-255,66,31597,33,336135
6560,0.00076,74.125.24.0-255,1484,33081,33,336135
6561,0.000764,172.31.33.0-255,66,33147,33,336135
6562,0.000789,74.125.24.0-255,2902,36049,33,336135
6563,0.000792,172.31.33.0-255,66,36115,33,336135
6564,0.000798,74.125.24.0-255,5738,41853,33,336135
6565,0.0008,172.31.33.0-255,66,41919,33,336135
6566,0.000806,74.125.24.0-255,5738,47657,33,336135
6567,0.00081,172.31.33.0-255,66,47723,33,336135
6568,0.000826,74.125.24.0-255,1484,49207,33,336135
6569,0.000851,74.125.24.0-255,7156,56363,33,336135
6570,0.000854,172.31.33.0-255,66,56429,33,336135
6571,0.000881,74.125.24.0-255,5379,61808,33,336135
6572,0.000884,172.31.33.0-255,66,61874,33,336135
6573,0.000888,74.125.24.0-255,3961,65835,33,336135
6574,0.000891,172.31.33.0-255,66,65901,33,336135
6575,0.000894,74.125.24.0-255,363,66264,33,336135
6576,0.00092,74.125.24.0-255,134,66398,33,336135
6577,0.000943,74.125.24.0-255,342,66740,33,336135
6578,0.001766,74.125.24.0-255,1484,68224,33,336135
6579,0.001772,172.31.33.0-255,66,68290,33,336135
6580,0.001778,74.125.24.0-255,2902,71192,33,336135
6581,0.00178,172.31.33.0-255,66,71258,33,336135
6582,0.001809,74.125.24.0-255,5738,76996,33,336135
6583,0.001811,172.31.33.0-255,66,77062,33,336135
6584,0.001817,74.125.24.0-255,5738,82800,33,336135
6585,0.001818,172.31.33.0-255,66,82866,33,336135
6586,0.001858,172.31.33.0-255,66,82932,33,336135
6587,0.001884,74.125.24.0-255,2902,85834,33,336135
6588,0.001887,172.31.33.0-255,66,85900,33,336135
6589,0.001892,74.125.24.0-255,5020,90920,33,336135
6590,0.001894,172.31.33.0-255,66,90986,33,336135
6591,0.002004,74.125.24.0-255,1484,92470,33,336135
6592,0.00201,74.125.24.0-255,2902,95372,33,336135
6593,0.002013,172.31.33.0-255,66,95438,33,336135
6594,0.002033,74.125.24.0-255,5738,101176,33,336135
6595,0.002035,172.31.33.0-255,66,101242,33,336135
6596,0.002065,74.125.24.0-255,7156,108398,33,336135
6597,0.002067,172.31.33.0-255,66,108464,33,336135
6598,0.002096,74.125.24.0-255,5738,114202,33,336135
6599,0.002099,172.31.33.0-255,66,114268,33,336135
6600,0.002105,74.125.24.0-255,5738,120006,33,336135
6601,0.002107,172.31.33.0-255,66,120072,33,336135
6602,0.002148,172.31.33.0-255,66,120138,33,336135
6603,0.002172,74.125.24.0-255,3602,123740,33,336135
6604,0.002174,172.31.33.0-255,66,123806,33,336135
6605,0.002186,172.31.33.0-255,66,123872,33,336135
6606,0.002196,74.125.24.0-255,7156,131028,33,336135
6607,0.002198,172.31.33.0-255,66,131094,33,336135
6608,0.00225,74.125.24.0-255,6438,137532,33,336135
6609,0.002252,172.31.33.0-255,66,137598,33,336135
6610,0.004481,74.125.24.0-255,5738,143336,33,336135
6611,0.004487,172.31.33.0-255,66,143402,33,336135
6612,0.006732,74.125.24.0-255,5738,149140,33,336135
6613,0.006739,172.31.33.0-255,66,149206,33,336135
6614,0.008976,74.125.24.0-255,5738,154944,33,336135
6615,0.008984,172.31.33.0-255,66,155010,33,336135
6616,0.011352,74.125.24.0-255,4320,159330,33,336135
6617,0.011358,172.31.33.0-255,66,159396,33,336135
6618,0.011381,74.125.24.0-255,1484,160880,33,336135
6619,0.013592,74.125.24.0-255,4320,165200,33,336135
6620,0.013601,172.31.33.0-255,66,165266,33,336135
6621,0.015852,74.125.24.0-255,5738,171004,33,336135
6622,0.015858,172.31.33.0-255,66,171070,33,336135
6623,0.018116,74.125.24.0-255,5738,176808,33,336135
6624,0.018123,172.31.33.0-255,66,176874,33,336135
6625,0.020106,172.31.33.0-255,172,177046,33,336135
6626,0.020134,172.31.33.0-255,1113,178159,33,336135
6627,0.020187,172.31.33.0-255,1514,179673,33,336135
6628,0.020209,172.31.33.0-255,1514,181187,33,336135
6629,0.02021,172.31.33.0-255,680,181867,33,336135
6630,0.020342,74.125.24.0-255,5738,187605,33,336135
6631,0.020346,172.31.33.0-255,66,187671,33,336135
6632,0.021637,104.244.42.0-255,66,187737,33,336135
6633,0.02169,104.244.42.0-255,66,187803,33,336135
6634,0.021739,104.244.42.0-255,66,187869,33,336135
6635,0.021742,104.244.42.0-255,66,187935,33,336135
6636,0.022595,74.125.24.0-255,5738,193673,33,336135
6637,0.022601,172.31.33.0-255,66,193739,33,336135
6638,0.024816,74.125.24.0-255,5738,199477,33,336135
6639,0.024822,172.31.33.0-255,66,199543,33,336135
6640,0.027058,74.125.24.0-255,5738,205281,33,336135
6641,0.027065,172.31.33.0-255,66,205347,33,336135
6642,0.029297,74.125.24.0-255,4320,209667,33,336135
6643,0.029302,172.31.33.0-255,66,209733,33,336135
6644,0.029325,74.125.24.0-255,1484,211217,33,336135
6645,0.031526,74.125.24.0-255,4320,215537,33,336135
6646,0.031531,172.31.33.0-255,66,215603,33,336135
6647,0.033774,74.125.24.0-255,5738,221341,33,336135
6648,0.033779,172.31.33.0-255,66,221407,33,336135
6649,0.036026,74.125.24.0-255,5738,227145,33,336135
6650,0.036031,172.31.33.0-255,66,227211,33,336135
6651,0.038247,74.125.24.0-255,5738,232949,33,336135
6652,0.038253,172.31.33.0-255,66,233015,33,336135
6653,0.040488,74.125.24.0-255,5738,238753,33,336135
6654,0.040493,172.31.33.0-255,66,238819,33,336135
6655,0.042745,74.125.24.0-255,5738,244557,33,336135
6656,0.042752,172.31.33.0-255,66,244623,33,336135
6657,0.044969,74.125.24.0-255,4320,248943,33,336135
6658,0.044976,172.31.33.0-255,66,249009,33,336135
6659,0.045003,74.125.24.0-255,1484,250493,33,336135
6660,0.0472,74.125.24.0-255,4320,254813,33,336135
6661,0.047207,172.31.33.0-255,66,254879,33,336135
6662,0.049432,74.125.24.0-255,5738,260617,33,336135
6663,0.049437,172.31.33.0-255,66,260683,33,336135
6664,0.051692,74.125.24.0-255,5738,266421,33,336135
6665,0.051698,172.31.33.0-255,66,266487,33,336135
6666,0.053925,74.125.24.0-255,5738,272225,33,336135
6667,0.05393,172.31.33.0-255,66,272291,33,336135
6668,0.056146,74.125.24.0-255,5738,278029,33,336135
6669,0.056152,172.31.33.0-255,66,278095,33,336135
6670,0.058424,74.125.24.0-255,5738,283833,33,336135
6671,0.05843,172.31.33.0-255,66,283899,33,336135
6672,0.060644,74.125.24.0-255,5738,289637,33,336135
6673,0.06065,172.31.33.0-255,66,289703,33,336135
6674,0.062868,74.125.24.0-255,5738,295441,33,336135
6675,0.062874,172.31.33.0-255,66,295507,33,336135
6676,0.06511,74.125.24.0-255,5738,301245,33,336135
6677,0.065117,172.31.33.0-255,66,301311,33,336135
6678,0.067333,74.125.24.0-255,5738,307049,33,336135
6679,0.06734,172.31.33.0-255,66,307115,33,336135
6680,0.06959,74.125.24.0-255,5738,312853,33,336135
6681,0.069597,172.31.33.0-255,66,312919,33,336135
6682,0.071825,74.125.24.0-255,5738,318657,33,336135
6683,0.071831,172.31.33.0-255,66,318723,33,336135
6684,0.074076,74.125.24.0-255,5738,324461,33,336135
6685,0.074082,172.31.33.0-255,66,324527,33,336135
6686,0.07629,74.125.24.0-255,5738,330265,33,336135
6687,0.076295,172.31.33.0-255,66,330331,33,336135
6688,0.0785,74.125.24.0-255,5738,336069,33,336135
6689,0.078505,172.31.33.0-255,66,336135,33,336135
6690,0.0,172.31.33.0-255,105,105,33,918
6691,5.4e-05,172.31.33.0-255,105,210,33,918
6692,0.000253,172.31.33.0-255,90,300,33,918
6693,0.000261,172.31.33.0-255,66,366,33,918
6694,0.000421,172.31.33.0-255,90,456,33,918
6695,0.000428,172.31.33.0-255,66,522,33,918
6696,0.002667,172.217.194.0-255,66,588,33,918
6697,0.002678,172.217.194.0-255,66,654,33,918
6698,0.002686,172.31.33.0-255,66,720,33,918
6699,0.002758,74.125.24.0-255,66,786,33,918
6700,0.002771,74.125.24.0-255,66,852,33,918
6701,0.002773,172.31.33.0-255,66,918,33,918
6702,0.0,74.125.24.0-255,153,153,33,182666
6703,2e-05,172.31.33.0-255,66,219,33,182666
6704,2.6e-05,74.125.24.0-255,1484,1703,33,182666
6705,3.1e-05,172.31.33.0-255,66,1769,33,182666
6706,3.6e-05,74.125.24.0-255,2902,4671,33,182666
6707,4.6e-05,172.31.33.0-255,66,4737,33,182666
6708,5.3e-05,74.125.24.0-255,7156,11893,33,182666
6709,5.5e-05,172.31.33.0-255,66,11959,33,182666
6710,5.9e-05,74.125.24.0-255,2053,14012,33,182666
6711,6.2e-05,172.31.33.0-255,66,14078,33,182666
6712,0.000106,172.31.33.0-255,66,14144,33,182666
6713,0.000112,74.125.24.0-255,5379,19523,33,182666
6714,0.000115,172.31.33.0-255,66,19589,33,182666
6715,0.000155,74.125.24.0-255,1484,21073,33,182666
6716,0.000157,172.31.33.0-255,66,21139,33,182666
6717,0.000161,74.125.24.0-255,2902,24041,33,182666
6718,0.000162,172.31.33.0-255,66,24107,33,182666
6719,0.000165,74.125.24.0-255,1484,25591,33,182666
6720,0.000168,172.31.33.0-255,66,25657,33,182666
6721,0.000195,74.125.24.0-255,4320,29977,33,182666
6722,0.000197,172.31.33.0-255,66,30043,33,182666
6723,0.000204,74.125.24.0-255,7156,37199,33,182666
6724,0.000206,172.31.33.0-255,66,37265,33,182666
6725,0.000239,74.125.24.0-255,6797,44062,33,182666
6726,0.000241,172.31.33.0-255,66,44128,33,182666
6727,0.000246,74.125.24.0-255,2902,47030,33,182666
6728,0.000247,172.31.33.0-255,66,47096,33,182666
6729,0.000268,74.125.24.0-255,7096,54192,33,182666
6730,0.000273,172.31.33.0-255,66,54258,33,182666
6731,0.000283,74.125.24.0-255,378,54636,33,182666
6732,0.000289,172.31.33.0-255,66,54702,33,182666
6733,0.000829,74.125.24.0-255,1484,56186,33,182666
6734,0.000845,74.125.24.0-255,2902,59088,33,182666
6735,0.000849,172.31.33.0-255,66,59154,33,182666
6736,0.000855,74.125.24.0-255,5738,64892,33,182666
6737,0.000858,74.125.24.0-255,1484,66376,33,182666
6738,0.000875,74.125.24.0-255,1484,67860,33,182666
6739,0.000891,172.31.33.0-255,66,67926,33,182666
6740,0.000897,74.125.24.0-255,4320,72246,33,182666
6741,0.0009,172.31.33.0-255,66,72312,33,182666
6742,0.000912,74.125.24.0-255,4320,76632,33,182666
6743,0.000931,74.125.24.0-255,2543,79175,33,182666
6744,0.000953,74.125.24.0-255,5738,84913,33,182666
6745,0.000959,172.31.33.0-255,66,84979,33,182666
6746,0.000983,74.125.24.0-255,2902,87881,33,182666
6747,0.00099,172.31.33.0-255,66,87947,33,182666
6748,0.001027,172.31.33.0-255,66,88013,33,182666
6749,0.001314,74.125.24.0-255,1484,89497,33,182666
6750,0.00132,74.125.24.0-255,2902,92399,33,182666
6751,0.001323,172.31.33.0-255,66,92465,33,182666
6752,0.001338,74.125.24.0-255,5738,98203,33,182666
6753,0.001352,172.31.33.0-255,66,98269,33,182666
6754,0.001425,172.31.33.0-255,66,98335,33,182666
6755,0.001477,74.125.24.0-255,7156,105491,33,182666
6756,0.001481,172.31.33.0-255,66,105557,33,182666
6757,0.001491,74.125.24.0-255,2184,107741,33,182666
6758,0.001508,172.31.33.0-255,66,107807,33,182666
6759,0.001588,74.125.24.0-255,1484,109291,33,182666
6760,0.001602,74.125.24.0-255,2902,112193,33,182666
6761,0.001606,74.125.24.0-255,2902,115095,33,182666
6762,0.001611,172.31.33.0-255,66,115161,33,182666
6763,0.001619,74.125.24.0-255,2902,118063,33,182666
6764,0.001624,74.125.24.0-255,5738,123801,33,182666
6765,0.001643,74.125.24.0-255,1484,125285,33,182666
6766,0.00165,74.125.24.0-255,7156,132441,33,182666
6767,0.001665,74.125.24.0-255,7156,139597,33,182666
6768,0.001669,74.125.24.0-255,2184,141781,33,182666
6769,0.00168,172.31.33.0-255,66,141847,33,182666
6770,0.001765,74.125.24.0-255,1484,143331,33,182666
6771,0.001771,74.125.24.0-255,2902,146233,33,182666
6772,0.00179,74.125.24.0-255,5738,151971,33,182666
6773,0.001808,172.31.33.0-255,66,152037,33,182666
6774,0.001856,172.31.33.0-255,66,152103,33,182666
6775,0.0019,172.31.33.0-255,66,152169,33,182666
6776,0.001954,172.31.33.0-255,66,152235,33,182666
6777,0.001966,172.31.33.0-255,66,152301,33,182666
6778,0.002005,74.125.24.0-255,1484,153785,33,182666
6779,0.002008,74.125.24.0-255,2902,156687,33,182666
6780,0.002014,74.125.24.0-255,5738,162425,33,182666
6781,0.002028,172.31.33.0-255,66,162491,33,182666
6782,0.002079,74.125.24.0-255,4320,166811,33,182666
6783,0.002087,172.31.33.0-255,66,166877,33,182666
6784,0.002146,74.125.24.0-255,2902,169779,33,182666
6785,0.002152,172.31.33.0-255,66,169845,33,182666
6786,0.002163,74.125.24.0-255,7156,177001,33,182666
6787,0.002168,172.31.33.0-255,66,177067,33,182666
6788,0.002201,74.125.24.0-255,105,177172,33,182666
6789,0.002216,172.31.33.0-255,66,177238,33,182666
6790,0.003813,172.31.33.0-255,105,177343,33,182666
6791,0.006499,74.125.24.0-255,66,177409,33,182666
6792,0.02463,172.31.33.0-255,172,177581,33,182666
6793,0.024663,172.31.33.0-255,1117,178698,33,182666
6794,0.024713,172.31.33.0-255,1514,180212,33,182666
6795,0.024715,172.31.33.0-255,1514,181726,33,182666
6796,0.024739,172.31.33.0-255,676,182402,33,182666
6797,0.026279,104.244.42.0-255,66,182468,33,182666
6798,0.026332,104.244.42.0-255,66,182534,33,182666
6799,0.026372,104.244.42.0-255,66,182600,33,182666
6800,0.026389,104.244.42.0-255,66,182666,33,182666
6801,0.0,172.31.33.0-255,66,66,33,66
6802,0.0,172.217.194.0-255,152,152,33,296126
6803,2e-05,172.31.33.0-255,66,218,33,296126
6804,2.8e-05,172.217.194.0-255,1484,1702,33,296126
6805,3.4e-05,172.31.33.0-255,66,1768,33,296126
6806,4.6e-05,172.217.194.0-255,2902,4670,33,296126
6807,5.1e-05,172.31.33.0-255,66,4736,33,296126
6808,5.8e-05,172.217.194.0-255,7156,11892,33,296126
6809,6.1e-05,172.31.33.0-255,66,11958,33,296126
6810,6.4e-05,172.217.194.0-255,1484,13442,33,296126
6811,6.6e-05,172.31.33.0-255,66,13508,33,296126
6812,0.000106,172.31.33.0-255,66,13574,33,296126
6813,0.000111,172.217.194.0-255,3961,17535,33,296126
6814,0.000113,172.31.33.0-255,66,17601,33,296126
6815,0.000164,172.217.194.0-255,1484,19085,33,296126
6816,0.000167,172.31.33.0-255,66,19151,33,296126
6817,0.000172,172.217.194.0-255,2902,22053,33,296126
6818,0.000174,172.31.33.0-255,66,22119,33,296126
6819,0.000179,172.217.194.0-255,2902,25021,33,296126
6820,0.000185,172.31.33.0-255,66,25087,33,296126
6821,0.00021,172.217.194.0-255,2902,27989,33,296126
6822,0.000217,172.31.33.0-255,66,28055,33,296126
6823,0.000229,172.31.33.0-255,66,28121,33,296126
6824,0.000235,172.217.194.0-255,7156,35277,33,296126
6825,0.000238,172.31.33.0-255,66,35343,33,296126
6826,0.00027,172.217.194.0-255,2902,38245,33,296126
6827,0.000272,172.31.33.0-255,66,38311,33,296126
6828,0.000278,172.217.194.0-255,3961,42272,33,296126
6829,0.00028,172.31.33.0-255,66,42338,33,296126
6830,0.001435,172.217.194.0-255,645,42983,33,296126
6831,0.001441,172.31.33.0-255,66,43049,33,296126
6832,0.001927,172.217.194.0-255,1484,44533,33,296126
6833,0.001943,172.217.194.0-255,2902,47435,33,296126
6834,0.001947,172.31.33.0-255,66,47501,33,296126
6835,0.001976,172.217.194.0-255,5738,53239,33,296126
6836,0.001978,172.31.33.0-255,66,53305,33,296126
6837,0.002011,172.217.194.0-255,7156,60461,33,296126
6838,0.002013,172.31.33.0-255,66,60527,33,296126
6839,0.002035,172.217.194.0-255,2902,63429,33,296126
6840,0.002037,172.31.33.0-255,66,63495,33,296126
6841,0.002048,172.31.33.0-255,66,63561,33,296126
6842,0.002079,172.217.194.0-255,2902,66463,33,296126
6843,0.002081,172.31.33.0-255,66,66529,33,296126
6844,0.002085,172.217.194.0-255,1636,68165,33,296126
6845,0.002087,172.31.33.0-255,66,68231,33,296126
6846,0.002173,172.217.194.0-255,1484,69715,33,296126
6847,0.002185,172.217.194.0-255,2902,72617,33,296126
6848,0.002187,172.31.33.0-255,66,72683,33,296126
6849,0.002193,172.217.194.0-255,2902,75585,33,296126
6850,0.002194,172.31.33.0-255,66,75651,33,296126
6851,0.002213,172.217.194.0-255,2902,78553,33,296126
6852,0.00222,172.31.33.0-255,66,78619,33,296126
6853,0.002241,172.217.194.0-255,7156,85775,33,296126
6854,0.002243,172.31.33.0-255,66,85841,33,296126
6855,0.002277,172.217.194.0-255,5738,91579,33,296126
6856,0.002279,172.31.33.0-255,66,91645,33,296126
6857,0.002286,172.217.194.0-255,7156,98801,33,296126
6858,0.002289,172.31.33.0-255,66,98867,33,296126
6859,0.002298,172.217.194.0-255,3602,102469,33,296126
6860,0.002301,172.31.33.0-255,66,102535,33,296126
6861,0.004583,172.217.194.0-255,1484,104019,33,296126
6862,0.004605,172.217.194.0-255,4320,108339,33,296126
6863,0.004609,172.31.33.0-255,66,108405,33,296126
6864,0.006935,172.217.194.0-255,5738,114143,33,296126
6865,0.00694,172.31.33.0-255,66,114209,33,296126
6866,0.009236,172.217.194.0-255,5738,119947,33,296126
6867,0.009245,172.31.33.0-255,66,120013,33,296126
6868,0.011565,172.217.194.0-255,5738,125751,33,296126
6869,0.011574,172.31.33.0-255,66,125817,33,296126
6870,0.013894,172.217.194.0-255,5738,131555,33,296126
6871,0.013904,172.31.33.0-255,66,131621,33,296126
6872,0.016188,172.217.194.0-255,5738,137359,33,296126
6873,0.016196,172.31.33.0-255,66,137425,33,296126
6874,0.018492,172.217.194.0-255,5738,143163,33,296126
6875,0.0185,172.31.33.0-255,66,143229,33,296126
6876,0.02087,172.217.194.0-255,4320,147549,33,296126
6877,0.020878,172.31.33.0-255,66,147615,33,296126
6878,0.0209,172.217.194.0-255,1484,149099,33,296126
6879,0.023202,172.217.194.0-255,4320,153419,33,296126
6880,0.02321,172.31.33.0-255,66,153485,33,296126
6881,0.024798,172.31.33.0-255,172,153657,33,296126
6882,0.024831,172.31.33.0-255,1117,154774,33,296126
6883,0.024891,172.31.33.0-255,1514,156288,33,296126
6884,0.024893,172.31.33.0-255,1514,157802,33,296126
6885,0.024916,172.31.33.0-255,676,158478,33,296126
6886,0.025517,172.217.194.0-255,5738,164216,33,296126
6887,0.025524,172.31.33.0-255,66,164282,33,296126
6888,0.026352,104.244.42.0-255,66,164348,33,296126
6889,0.026428,104.244.42.0-255,66,164414,33,296126
6890,0.026504,104.244.42.0-255,66,164480,33,296126
6891,0.026525,104.244.42.0-255,66,164546,33,296126
6892,0.027824,172.217.194.0-255,5738,170284,33,296126
6893,0.02783,172.31.33.0-255,66,170350,33,296126
6894,0.030173,172.217.194.0-255,5738,176088,33,296126
6895,0.030181,172.31.33.0-255,66,176154,33,296126
6896,0.03249,172.217.194.0-255,5738,181892,33,296126
6897,0.032497,172.31.33.0-255,66,181958,33,296126
6898,0.034812,172.217.194.0-255,5738,187696,33,296126
6899,0.034819,172.31.33.0-255,66,187762,33,296126
6900,0.037123,172.217.194.0-255,5738,193500,33,296126
6901,0.037129,172.31.33.0-255,66,193566,33,296126
6902,0.039435,172.217.194.0-255,5738,199304,33,296126
6903,0.039442,172.31.33.0-255,66,199370,33,296126
6904,0.041735,172.217.194.0-255,4320,203690,33,296126
6905,0.04174,172.31.33.0-255,66,203756,33,296126
6906,0.041766,172.217.194.0-255,1484,205240,33,296126
6907,0.044153,172.217.194.0-255,4320,209560,33,296126
6908,0.044159,172.31.33.0-255,66,209626,33,296126
6909,0.046463,172.217.194.0-255,5738,215364,33,296126
6910,0.046468,172.31.33.0-255,66,215430,33,296126
6911,0.048762,172.217.194.0-255,5738,221168,33,296126
6912,0.048767,172.31.33.0-255,66,221234,33,296126
6913,0.051068,172.217.194.0-255,5738,226972,33,296126
6914,0.051074,172.31.33.0-255,66,227038,33,296126
6915,0.053413,172.217.194.0-255,5738,232776,33,296126
6916,0.053418,172.31.33.0-255,66,232842,33,296126
6917,0.05575,172.217.194.0-255,5738,238580,33,296126
6918,0.055756,172.31.33.0-255,66,238646,33,296126
6919,0.058049,172.217.194.0-255,5738,244384,33,296126
6920,0.058054,172.31.33.0-255,66,244450,33,296126
6921,0.06037,172.217.194.0-255,4320,248770,33,296126
6922,0.060378,172.31.33.0-255,66,248836,33,296126
6923,0.060403,172.217.194.0-255,1484,250320,33,296126
6924,0.062681,172.217.194.0-255,1484,251804,33,296126
6925,0.062686,172.31.33.0-255,66,251870,33,296126
6926,0.062718,172.217.194.0-255,2902,254772,33,296126
6927,0.06272,172.31.33.0-255,66,254838,33,296126
6928,0.064995,172.217.194.0-255,2902,257740,33,296126
6929,0.065001,172.31.33.0-255,66,257806,33,296126
6930,0.065028,172.217.194.0-255,2902,260708,33,296126
6931,0.065031,172.31.33.0-255,66,260774,33,296126
6932,0.067307,172.217.194.0-255,2902,263676,33,296126
6933,0.067313,172.31.33.0-255,66,263742,33,296126
6934,0.067342,172.217.194.0-255,2902,266644,33,296126
6935,0.067345,172.31.33.0-255,66,266710,33,296126
6936,0.069594,172.217.194.0-255,2902,269612,33,296126
6937,0.0696,172.31.33.0-255,66,269678,33,296126
6938,0.06964,172.217.194.0-255,2902,272580,33,296126
6939,0.069643,172.31.33.0-255,66,272646,33,296126
6940,0.07191,172.217.194.0-255,2902,275548,33,296126
6941,0.071916,172.31.33.0-255,66,275614,33,296126
6942,0.071941,172.217.194.0-255,2902,278516,33,296126
6943,0.071944,172.31.33.0-255,66,278582,33,296126
6944,0.074205,172.217.194.0-255,2902,281484,33,296126
6945,0.074211,172.31.33.0-255,66,281550,33,296126
6946,0.07424,172.217.194.0-255,2902,284452,33,296126
6947,0.074243,172.31.33.0-255,66,284518,33,296126
6948,0.076527,172.217.194.0-255,5738,290256,33,296126
6949,0.076532,172.31.33.0-255,66,290322,33,296126
6950,0.078855,172.217.194.0-255,5738,296060,33,296126
6951,0.078861,172.31.33.0-255,66,296126,33,296126
6952,0.0,172.217.194.0-255,153,153,33,254611
6953,1.2e-05,172.31.33.0-255,66,219,33,254611
6954,1.7e-05,172.217.194.0-255,1484,1703,33,254611
6955,2.1e-05,172.31.33.0-255,66,1769,33,254611
6956,2.6e-05,172.217.194.0-255,2902,4671,33,254611
6957,2.9e-05,172.31.33.0-255,66,4737,33,254611
6958,3.3e-05,172.217.194.0-255,2902,7639,33,254611
6959,3.5e-05,172.31.33.0-255,66,7705,33,254611
6960,5.6e-05,172.217.194.0-255,2902,10607,33,254611
6961,5.9e-05,172.31.33.0-255,66,10673,33,254611
6962,0.0001,172.31.33.0-255,66,10739,33,254611
6963,0.000109,172.31.33.0-255,66,10805,33,254611
6964,0.000131,172.217.194.0-255,1484,12289,33,254611
6965,0.000133,172.31.33.0-255,66,12355,33,254611
6966,0.000146,172.217.194.0-255,2543,14898,33,254611
6967,0.000148,172.31.33.0-255,66,14964,33,254611
6968,0.000178,172.217.194.0-255,4320,19284,33,254611
6969,0.000181,172.31.33.0-255,66,19350,33,254611
6970,0.000203,172.217.194.0-255,7156,26506,33,254611
6971,0.000206,172.31.33.0-255,66,26572,33,254611
6972,0.000245,172.217.194.0-255,1484,28056,33,254611
6973,0.000247,172.31.33.0-255,66,28122,33,254611
6974,0.000269,172.217.194.0-255,5379,33501,33,254611
6975,0.000272,172.31.33.0-255,66,33567,33,254611
6976,0.000278,172.217.194.0-255,7156,40723,33,254611
6977,0.00028,172.31.33.0-255,66,40789,33,254611
6978,0.000303,172.217.194.0-255,7156,47945,33,254611
6979,0.000305,172.31.33.0-255,66,48011,33,254611
6980,0.000322,172.217.194.0-255,1436,49447,33,254611
6981,0.000324,172.31.33.0-255,66,49513,33,254611
6982,0.000327,172.217.194.0-255,366,49879,33,254611
6983,0.000359,172.217.194.0-255,1484,51363,33,254611
6984,0.000361,172.31.33.0-255,66,51429,33,254611
6985,0.000364,172.217.194.0-255,1484,52913,33,254611
6986,0.000382,172.217.194.0-255,2902,55815,33,254611
6987,0.000384,172.31.33.0-255,66,55881,33,254611
6988,0.000388,172.217.194.0-255,2902,58783,33,254611
6989,0.000391,172.31.33.0-255,66,58849,33,254611
6990,0.000407,172.217.194.0-255,7156,66005,33,254611
6991,0.000409,172.31.33.0-255,66,66071,33,254611
6992,0.000412,172.217.194.0-255,1125,67196,33,254611
6993,0.000433,172.217.194.0-255,5738,72934,33,254611
6994,0.000435,172.31.33.0-255,66,73000,33,254611
6995,0.000454,172.217.194.0-255,7156,80156,33,254611
6996,0.000456,172.31.33.0-255,66,80222,33,254611
6997,0.000461,172.217.194.0-255,3961,84183,33,254611
6998,0.000463,172.31.33.0-255,66,84249,33,254611
6999,0.000537,172.217.194.0-255,1484,85733,33,254611
7000,0.000548,172.217.194.0-255,2902,88635,33,254611
7001,0.000551,172.31.33.0-255,66,88701,33,254611
7002,0.000573,172.217.194.0-255,5738,94439,33,254611
7003,0.000576,172.31.33.0-255,66,94505,33,254611
7004,0.00058,172.217.194.0-255,2902,97407,33,254611
7005,0.000582,172.31.33.0-255,66,97473,33,254611
7006,0.000608,172.31.33.0-255,66,97539,33,254611
7007,0.000619,172.31.33.0-255,66,97605,33,254611
7008,0.000654,172.217.194.0-255,4320,101925,33,254611
7009,0.000656,172.31.33.0-255,66,101991,33,254611
7010,0.00068,172.217.194.0-255,7156,109147,33,254611
7011,0.000693,172.31.33.0-255,66,109213,33,254611
7012,0.000699,172.31.33.0-255,66,109279,33,254611
7013,0.000704,172.217.194.0-255,4320,113599,33,254611
7014,0.000705,172.31.33.0-255,66,113665,33,254611
7015,0.000725,172.217.194.0-255,5020,118685,33,254611
7016,0.000727,172.31.33.0-255,66,118751,33,254611
7017,0.000733,172.217.194.0-255,5738,124489,33,254611
7018,0.000735,172.31.33.0-255,66,124555,33,254611
7019,0.000757,172.217.194.0-255,4320,128875,33,254611
7020,0.000759,172.31.33.0-255,66,128941,33,254611
7021,0.000765,172.217.194.0-255,5738,134679,33,254611
7022,0.000767,172.31.33.0-255,66,134745,33,254611
7023,0.000806,172.217.194.0-255,766,135511,33,254611
7024,0.000809,172.31.33.0-255,66,135577,33,254611
7025,0.00086,172.217.194.0-255,1484,137061,33,254611
7026,0.000863,172.31.33.0-255,66,137127,33,254611
7027,0.000867,172.217.194.0-255,2902,140029,33,254611
7028,0.000869,172.31.33.0-255,66,140095,33,254611
7029,0.000872,172.217.194.0-255,1484,141579,33,254611
7030,0.000896,172.217.194.0-255,4320,145899,33,254611
7031,0.000898,172.31.33.0-255,66,145965,33,254611
7032,0.00091,172.31.33.0-255,66,146031,33,254611
7033,0.00095,172.217.194.0-255,4320,150351,33,254611
7034,0.000952,172.31.33.0-255,66,150417,33,254611
7035,0.000966,172.217.194.0-255,5738,156155,33,254611
7036,0.000968,172.31.33.0-255,66,156221,33,254611
7037,0.00097,172.217.194.0-255,766,156987,33,254611
7038,0.001146,172.217.194.0-255,1484,158471,33,254611
7039,0.00115,172.31.33.0-255,66,158537,33,254611
7040,0.001155,172.217.194.0-255,2902,161439,33,254611
7041,0.001157,172.31.33.0-255,66,161505,33,254611
7042,0.001159,172.217.194.0-255,1484,162989,33,254611
7043,0.001177,172.217.194.0-255,4320,167309,33,254611
7044,0.001179,172.31.33.0-255,66,167375,33,254611
7045,0.001184,172.217.194.0-255,4320,171695,33,254611
7046,0.001186,172.31.33.0-255,66,171761,33,254611
7047,0.00122,172.31.33.0-255,66,171827,33,254611
7048,0.001232,172.31.33.0-255,66,171893,33,254611
7049,0.001265,172.217.194.0-255,1484,173377,33,254611
7050,0.00127,172.217.194.0-255,2902,176279,33,254611
7051,0.001272,172.31.33.0-255,66,176345,33,254611
7052,0.001275,172.217.194.0-255,1484,177829,33,254611
7053,0.001291,172.217.194.0-255,4320,182149,33,254611
7054,0.001293,172.31.33.0-255,66,182215,33,254611
7055,0.001321,172.31.33.0-255,66,182281,33,254611
7056,0.001326,172.217.194.0-255,4320,186601,33,254611
7057,0.001328,172.31.33.0-255,66,186667,33,254611
7058,0.001353,172.217.194.0-255,6438,193105,33,254611
7059,0.001356,172.31.33.0-255,66,193171,33,254611
7060,0.001389,172.217.194.0-255,1484,194655,33,254611
7061,0.001394,172.217.194.0-255,2902,197557,33,254611
7062,0.001396,172.31.33.0-255,66,197623,33,254611
7063,0.001399,172.217.194.0-255,1484,199107,33,254611
7064,0.001418,172.217.194.0-255,4320,203427,33,254611
7065,0.00142,172.31.33.0-255,66,203493,33,254611
7066,0.001426,172.217.194.0-255,5738,209231,33,254611
7067,0.001428,172.31.33.0-255,66,209297,33,254611
7068,0.001456,172.31.33.0-255,66,209363,33,254611
7069,0.001466,172.217.194.0-255,1484,210847,33,254611
7070,0.001484,172.217.194.0-255,3602,214449,33,254611
7071,0.001491,172.31.33.0-255,66,214515,33,254611
7072,0.001504,172.217.194.0-255,5738,220253,33,254611
7073,0.001513,172.31.33.0-255,66,220319,33,254611
7074,0.001522,172.217.194.0-255,4320,224639,33,254611
7075,0.001526,172.31.33.0-255,66,224705,33,254611
7076,0.001534,172.217.194.0-255,2902,227607,33,254611
7077,0.001538,172.217.194.0-255,4320,231927,33,254611
7078,0.001557,172.217.194.0-255,4320,236247,33,254611
7079,0.001564,172.31.33.0-255,66,236313,33,254611
7080,0.001577,172.217.194.0-255,2902,239215,33,254611
7081,0.001587,172.31.33.0-255,66,239281,33,254611
7082,0.001604,172.217.194.0-255,1484,240765,33,254611
7083,0.001609,172.31.33.0-255,66,240831,33,254611
7084,0.001632,172.217.194.0-255,5738,246569,33,254611
7085,0.001648,172.217.194.0-255,2374,248943,33,254611
7086,0.001656,172.31.33.0-255,66,249009,33,254611
7087,0.001668,172.217.194.0-255,105,249114,33,254611
7088,0.006908,172.31.33.0-255,66,249180,33,254611
7089,0.006941,172.31.33.0-255,105,249285,33,254611
7090,0.0089,172.217.194.0-255,66,249351,33,254611
7091,0.027114,172.31.33.0-255,172,249523,33,254611
7092,0.027149,172.31.33.0-255,1117,250640,33,254611
7093,0.027213,172.31.33.0-255,1514,252154,33,254611
7094,0.027215,172.31.33.0-255,1514,253668,33,254611
7095,0.027242,172.31.33.0-255,679,254347,33,254611
7096,0.028595,104.244.42.0-255,66,254413,33,254611
7097,0.028628,104.244.42.0-255,66,254479,33,254611
7098,0.028724,104.244.42.0-255,66,254545,33,254611
7099,0.028731,104.244.42.0-255,66,254611,33,254611
7100,0.0,172.31.33.0-255,105,105,33,1194
7101,0.001772,157.240.7.0-255,105,210,33,1194
7102,0.001783,172.31.33.0-255,66,276,33,1194
7103,0.040046,172.31.33.0-255,105,381,33,1194
7104,0.04009,172.31.33.0-255,105,486,33,1194
7105,0.040289,172.31.33.0-255,90,576,33,1194
7106,0.040296,172.31.33.0-255,66,642,33,1194
7107,0.040481,172.31.33.0-255,90,732,33,1194
7108,0.040489,172.31.33.0-255,66,798,33,1194
7109,0.042445,74.125.200.0-255,66,864,33,1194
7110,0.042468,74.125.200.0-255,66,930,33,1194
7111,0.042484,172.31.33.0-255,66,996,33,1194
7112,0.042828,74.125.24.0-255,66,1062,33,1194
7113,0.042842,74.125.24.0-255,66,1128,33,1194
7114,0.042853,172.31.33.0-255,66,1194,33,1194
7115,0.0,172.217.194.0-255,143,143,33,293240
7116,3.4e-05,172.31.33.0-255,66,209,33,293240
7117,4.1e-05,172.217.194.0-255,1484,1693,33,293240
7118,4.6e-05,172.31.33.0-255,66,1759,33,293240
7119,5e-05,172.217.194.0-255,2902,4661,33,293240
7120,6e-05,172.31.33.0-255,66,4727,33,293240
7121,6.8e-05,172.217.194.0-255,7156,11883,33,293240
7122,7e-05,172.31.33.0-255,66,11949,33,293240
7123,0.000111,172.217.194.0-255,2020,13969,33,293240
7124,0.000115,172.31.33.0-255,66,14035,33,293240
7125,0.00012,172.217.194.0-255,2902,16937,33,293240
7126,0.000122,172.31.33.0-255,66,17003,33,293240
7127,0.000161,172.217.194.0-255,7156,24159,33,293240
7128,0.000165,172.31.33.0-255,66,24225,33,293240
7129,0.00017,172.217.194.0-255,2902,27127,33,293240
7130,0.000173,172.31.33.0-255,66,27193,33,293240
7131,0.000205,172.217.194.0-255,5738,32931,33,293240
7132,0.000209,172.31.33.0-255,66,32997,33,293240
7133,0.000214,172.217.194.0-255,4320,37317,33,293240
7134,0.000217,172.31.33.0-255,66,37383,33,293240
7135,0.000246,172.217.194.0-255,4320,41703,33,293240
7136,0.000249,172.31.33.0-255,66,41769,33,293240
7137,0.000252,172.217.194.0-255,1484,43253,33,293240
7138,0.000254,172.31.33.0-255,66,43319,33,293240
7139,0.000285,172.217.194.0-255,5020,48339,33,293240
7140,0.000289,172.31.33.0-255,66,48405,33,293240
7141,0.000327,172.217.194.0-255,7156,55561,33,293240
7142,0.000331,172.31.33.0-255,66,55627,33,293240
7143,0.000348,172.217.194.0-255,2902,58529,33,293240
7144,0.000352,172.31.33.0-255,66,58595,33,293240
7145,0.000381,172.217.194.0-255,5738,64333,33,293240
7146,0.000385,172.31.33.0-255,66,64399,33,293240
7147,0.000388,172.217.194.0-255,1413,65812,33,293240
7148,0.000623,172.217.194.0-255,99,65911,33,293240
7149,0.000696,172.217.194.0-255,1484,67395,33,293240
7150,0.000701,172.31.33.0-255,66,67461,33,293240
7151,0.000704,172.217.194.0-255,1484,68945,33,293240
7152,0.00073,172.217.194.0-255,1484,70429,33,293240
7153,0.000734,172.31.33.0-255,66,70495,33,293240
7154,0.00074,172.217.194.0-255,5738,76233,33,293240
7155,0.000744,172.31.33.0-255,66,76299,33,293240
7156,0.000799,172.217.194.0-255,6797,83096,33,293240
7157,0.000803,172.31.33.0-255,66,83162,33,293240
7158,0.002107,172.217.194.0-255,1484,84646,33,293240
7159,0.002116,172.217.194.0-255,2902,87548,33,293240
7160,0.00212,172.31.33.0-255,66,87614,33,293240
7161,0.002159,172.217.194.0-255,2902,90516,33,293240
7162,0.002161,172.31.33.0-255,66,90582,33,293240
7163,0.002171,172.217.194.0-255,1484,92066,33,293240
7164,0.002178,172.217.194.0-255,2902,94968,33,293240
7165,0.002179,172.31.33.0-255,66,95034,33,293240
7166,0.0022,172.217.194.0-255,2902,97936,33,293240
7167,0.002202,172.31.33.0-255,66,98002,33,293240
7168,0.002206,172.217.194.0-255,2543,100545,33,293240
7169,0.002207,172.31.33.0-255,66,100611,33,293240
7170,0.00221,172.217.194.0-255,1484,102095,33,293240
7171,0.002229,172.217.194.0-255,1484,103579,33,293240
7172,0.002231,172.31.33.0-255,66,103645,33,293240
7173,0.002235,172.217.194.0-255,4320,107965,33,293240
7174,0.002237,172.31.33.0-255,66,108031,33,293240
7175,0.00226,172.217.194.0-255,2902,110933,33,293240
7176,0.002262,172.31.33.0-255,66,110999,33,293240
7177,0.002267,172.217.194.0-255,5738,116737,33,293240
7178,0.002269,172.31.33.0-255,66,116803,33,293240
7179,0.002288,172.217.194.0-255,4320,121123,33,293240
7180,0.002289,172.31.33.0-255,66,121189,33,293240
7181,0.002325,172.31.33.0-255,66,121255,33,293240
7182,0.00233,172.217.194.0-255,3602,124857,33,293240
7183,0.002332,172.31.33.0-255,66,124923,33,293240
7184,0.005584,172.217.194.0-255,1484,126407,33,293240
7185,0.005596,172.217.194.0-255,1484,127891,33,293240
7186,0.005598,172.31.33.0-255,66,127957,33,293240
7187,0.005614,172.217.194.0-255,1484,129441,33,293240
7188,0.005637,172.217.194.0-255,1484,130925,33,293240
7189,0.005639,172.31.33.0-255,66,130991,33,293240
7190,0.008269,172.217.194.0-255,2902,133893,33,293240
7191,0.008277,172.31.33.0-255,66,133959,33,293240
7192,0.00834,172.217.194.0-255,2902,136861,33,293240
7193,0.008345,172.31.33.0-255,66,136927,33,293240
7194,0.010949,172.217.194.0-255,2902,139829,33,293240
7195,0.010957,172.31.33.0-255,66,139895,33,293240
7196,0.011031,172.217.194.0-255,2902,142797,33,293240
7197,0.011036,172.31.33.0-255,66,142863,33,293240
7198,0.01364,172.217.194.0-255,2902,145765,33,293240
7199,0.013648,172.31.33.0-255,66,145831,33,293240
7200,0.013748,172.217.194.0-255,2902,148733,33,293240
7201,0.013754,172.31.33.0-255,66,148799,33,293240
7202,0.016441,172.217.194.0-255,2902,151701,33,293240
7203,0.016448,172.31.33.0-255,66,151767,33,293240
7204,0.016572,172.217.194.0-255,1484,153251,33,293240
7205,0.016599,172.217.194.0-255,1484,154735,33,293240
7206,0.016603,172.31.33.0-255,66,154801,33,293240
7207,0.019316,172.217.194.0-255,5738,160539,33,293240
7208,0.019326,172.31.33.0-255,66,160605,33,293240
7209,0.022091,172.217.194.0-255,5738,166343,33,293240
7210,0.022098,172.31.33.0-255,66,166409,33,293240
7211,0.024796,172.217.194.0-255,5738,172147,33,293240
7212,0.024803,172.31.33.0-255,66,172213,33,293240
7213,0.026045,172.31.33.0-255,190,172403,33,293240
7214,0.026073,172.31.33.0-255,1117,173520,33,293240
7215,0.026106,172.31.33.0-255,1514,175034,33,293240
7216,0.026107,172.31.33.0-255,1514,176548,33,293240
7217,0.026127,172.31.33.0-255,676,177224,33,293240
7218,0.027478,172.217.194.0-255,2902,180126,33,293240
7219,0.027484,172.31.33.0-255,66,180192,33,293240
7220,0.027515,172.217.194.0-255,2902,183094,33,293240
7221,0.027519,172.31.33.0-255,66,183160,33,293240
7222,0.027692,104.244.42.0-255,66,183226,33,293240
7223,0.027752,104.244.42.0-255,66,183292,33,293240
7224,0.027757,104.244.42.0-255,66,183358,33,293240
7225,0.027789,104.244.42.0-255,66,183424,33,293240
7226,0.030201,172.217.194.0-255,1484,184908,33,293240
7227,0.030233,172.217.194.0-255,4320,189228,33,293240
7228,0.030238,172.31.33.0-255,66,189294,33,293240
7229,0.032935,172.217.194.0-255,2902,192196,33,293240
7230,0.03294,172.31.33.0-255,66,192262,33,293240
7231,0.032962,172.217.194.0-255,2902,195164,33,293240
7232,0.032966,172.31.33.0-255,66,195230,33,293240
7233,0.035696,172.217.194.0-255,1484,196714,33,293240
7234,0.035728,172.217.194.0-255,4320,201034,33,293240
7235,0.035733,172.31.33.0-255,66,201100,33,293240
7236,0.038419,172.217.194.0-255,4320,205420,33,293240
7237,0.038423,172.31.33.0-255,66,205486,33,293240
7238,0.03845,172.217.194.0-255,1484,206970,33,293240
7239,0.04113,172.217.194.0-255,1484,208454,33,293240
7240,0.041134,172.31.33.0-255,66,208520,33,293240
7241,0.041162,172.217.194.0-255,2902,211422,33,293240
7242,0.041165,172.31.33.0-255,66,211488,33,293240
7243,0.043803,172.217.194.0-255,2902,214390,33,293240
7244,0.043807,172.31.33.0-255,66,214456,33,293240
7245,0.043853,172.217.194.0-255,2902,217358,33,293240
7246,0.043857,172.31.33.0-255,66,217424,33,293240
7247,0.046514,172.217.194.0-255,2902,220326,33,293240
7248,0.046519,172.31.33.0-255,66,220392,33,293240
7249,0.046568,172.217.194.0-255,2902,223294,33,293240
7250,0.046574,172.31.33.0-255,66,223360,33,293240
7251,0.049223,172.217.194.0-255,2902,226262,33,293240
7252,0.049228,172.31.33.0-255,66,226328,33,293240
7253,0.049295,172.217.194.0-255,2902,229230,33,293240
7254,0.049298,172.31.33.0-255,66,229296,33,293240
7255,0.051917,172.217.194.0-255,2902,232198,33,293240
7256,0.051922,172.31.33.0-255,66,232264,33,293240
7257,0.051982,172.217.194.0-255,2902,235166,33,293240
7258,0.051986,172.31.33.0-255,66,235232,33,293240
7259,0.0546,172.217.194.0-255,2902,238134,33,293240
7260,0.054604,172.31.33.0-255,66,238200,33,293240
7261,0.054657,172.217.194.0-255,2902,241102,33,293240
7262,0.054661,172.31.33.0-255,66,241168,33,293240
7263,0.057284,172.217.194.0-255,2902,244070,33,293240
7264,0.057289,172.31.33.0-255,66,244136,33,293240
7265,0.057325,172.217.194.0-255,2902,247038,33,293240
7266,0.057329,172.31.33.0-255,66,247104,33,293240
7267,0.059964,172.217.194.0-255,1484,248588,33,293240
7268,0.059996,172.217.194.0-255,1484,250072,33,293240
7269,0.06,172.31.33.0-255,66,250138,33,293240
7270,0.060103,172.217.194.0-255,2902,253040,33,293240
7271,0.060109,172.31.33.0-255,66,253106,33,293240
7272,0.062661,172.217.194.0-255,2902,256008,33,293240
7273,0.062666,172.31.33.0-255,66,256074,33,293240
7274,0.062765,172.217.194.0-255,2902,258976,33,293240
7275,0.062771,172.31.33.0-255,66,259042,33,293240
7276,0.065374,172.217.194.0-255,2902,261944,33,293240
7277,0.065378,172.31.33.0-255,66,262010,33,293240
7278,0.065448,172.217.194.0-255,2902,264912,33,293240
7279,0.065452,172.31.33.0-255,66,264978,33,293240
7280,0.068097,172.217.194.0-255,2902,267880,33,293240
7281,0.068102,172.31.33.0-255,66,267946,33,293240
7282,0.068133,172.217.194.0-255,1484,269430,33,293240
7283,0.068143,172.217.194.0-255,1484,270914,33,293240
7284,0.068145,172.31.33.0-255,66,270980,33,293240
7285,0.070786,172.217.194.0-255,2902,273882,33,293240
7286,0.070791,172.31.33.0-255,66,273948,33,293240
7287,0.070824,172.217.194.0-255,2902,276850,33,293240
7288,0.070827,172.31.33.0-255,66,276916,33,293240
7289,0.07348,172.217.194.0-255,1484,278400,33,293240
7290,0.073508,172.217.194.0-255,1484,279884,33,293240
7291,0.073512,172.31.33.0-255,66,279950,33,293240
7292,0.073532,172.217.194.0-255,2902,282852,33,293240
7293,0.073536,172.31.33.0-255,66,282918,33,293240
7294,0.076223,172.217.194.0-255,1484,284402,33,293240
7295,0.076254,172.217.194.0-255,2902,287304,33,293240
7296,0.076258,172.31.33.0-255,66,287370,33,293240
7297,0.076287,172.217.194.0-255,1484,288854,33,293240
7298,0.078965,172.217.194.0-255,4320,293174,33,293240
7299,0.078971,172.31.33.0-255,66,293240,33,293240
7300,0.0,74.125.24.0-255,153,153,33,267748
7301,1.1e-05,172.31.33.0-255,66,219,33,267748
7302,1.6e-05,74.125.24.0-255,1484,1703,33,267748
7303,2e-05,172.31.33.0-255,66,1769,33,267748
7304,2.3e-05,74.125.24.0-255,1484,3253,33,267748
7305,2.5e-05,172.31.33.0-255,66,3319,33,267748
7306,3.9e-05,74.125.24.0-255,1484,4803,33,267748
7307,4.1e-05,172.31.33.0-255,66,4869,33,267748
7308,4.9e-05,74.125.24.0-255,7156,12025,33,267748
7309,5.1e-05,172.31.33.0-255,66,12091,33,267748
7310,5.4e-05,74.125.24.0-255,1958,14049,33,267748
7311,5.7e-05,172.31.33.0-255,66,14115,33,267748
7312,0.000108,74.125.24.0-255,1484,15599,33,267748
7313,0.00011,172.31.33.0-255,66,15665,33,267748
7314,0.000133,172.31.33.0-255,66,15731,33,267748
7315,0.000136,74.125.24.0-255,1484,17215,33,267748
7316,0.000137,172.31.33.0-255,66,17281,33,267748
7317,0.000159,74.125.24.0-255,1484,18765,33,267748
7318,0.000161,172.31.33.0-255,66,18831,33,267748
7319,0.000175,74.125.24.0-255,2543,21374,33,267748
7320,0.000178,172.31.33.0-255,66,21440,33,267748
7321,0.000201,74.125.24.0-255,1484,22924,33,267748
7322,0.000204,172.31.33.0-255,66,22990,33,267748
7323,0.000224,74.125.24.0-255,2902,25892,33,267748
7324,0.000227,172.31.33.0-255,66,25958,33,267748
7325,0.000233,74.125.24.0-255,7156,33114,33,267748
7326,0.000235,172.31.33.0-255,66,33180,33,267748
7327,0.000256,74.125.24.0-255,5738,38918,33,267748
7328,0.000258,172.31.33.0-255,66,38984,33,267748
7329,0.000287,172.31.33.0-255,66,39050,33,267748
7330,0.000295,74.125.24.0-255,5738,44788,33,267748
7331,0.000297,172.31.33.0-255,66,44854,33,267748
7332,0.000319,74.125.24.0-255,2854,47708,33,267748
7333,0.000321,172.31.33.0-255,66,47774,33,267748
7334,0.000423,74.125.24.0-255,110,47884,33,267748
7335,0.000506,74.125.24.0-255,1484,49368,33,267748
7336,0.000511,172.31.33.0-255,66,49434,33,267748
7337,0.000531,74.125.24.0-255,2902,52336,33,267748
7338,0.000534,172.31.33.0-255,66,52402,33,267748
7339,0.000547,74.125.24.0-255,4320,56722,33,267748
7340,0.000549,172.31.33.0-255,66,56788,33,267748
7341,0.000552,74.125.24.0-255,1484,58272,33,267748
7342,0.000573,74.125.24.0-255,4320,62592,33,267748
7343,0.000576,172.31.33.0-255,66,62658,33,267748
7344,0.000591,74.125.24.0-255,2543,65201,33,267748
7345,0.000593,172.31.33.0-255,66,65267,33,267748
7346,0.001051,74.125.24.0-255,1484,66751,33,267748
7347,0.001058,74.125.24.0-255,2902,69653,33,267748
7348,0.001061,172.31.33.0-255,66,69719,33,267748
7349,0.001067,74.125.24.0-255,2902,72621,33,267748
7350,0.001068,172.31.33.0-255,66,72687,33,267748
7351,0.001082,74.125.24.0-255,2902,75589,33,267748
7352,0.001084,172.31.33.0-255,66,75655,33,267748
7353,0.001088,74.125.24.0-255,2902,78557,33,267748
7354,0.00109,172.31.33.0-255,66,78623,33,267748
7355,0.001113,74.125.24.0-255,3961,82584,33,267748
7356,0.001115,172.31.33.0-255,66,82650,33,267748
7357,0.001128,74.125.24.0-255,4320,86970,33,267748
7358,0.00113,172.31.33.0-255,66,87036,33,267748
7359,0.001155,172.31.33.0-255,66,87102,33,267748
7360,0.001159,74.125.24.0-255,2902,90004,33,267748
7361,0.001161,172.31.33.0-255,66,90070,33,267748
7362,0.001183,172.31.33.0-255,66,90136,33,267748
7363,0.001201,74.125.24.0-255,2902,93038,33,267748
7364,0.001203,172.31.33.0-255,66,93104,33,267748
7365,0.001218,74.125.24.0-255,4705,97809,33,267748
7366,0.001219,172.31.33.0-255,66,97875,33,267748
7367,0.001292,74.125.24.0-255,1484,99359,33,267748
7368,0.00131,74.125.24.0-255,2902,102261,33,267748
7369,0.001313,172.31.33.0-255,66,102327,33,267748
7370,0.001317,74.125.24.0-255,2902,105229,33,267748
7371,0.001319,172.31.33.0-255,66,105295,33,267748
7372,0.001333,74.125.24.0-255,2902,108197,33,267748
7373,0.001335,172.31.33.0-255,66,108263,33,267748
7374,0.00137,172.31.33.0-255,66,108329,33,267748
7375,0.001374,74.125.24.0-255,4320,112649,33,267748
7376,0.001376,172.31.33.0-255,66,112715,33,267748
7377,0.001401,172.31.33.0-255,66,112781,33,267748
7378,0.001493,74.125.24.0-255,1484,114265,33,267748
7379,0.001497,74.125.24.0-255,1484,115749,33,267748
7380,0.001499,172.31.33.0-255,66,115815,33,267748
7381,0.001516,74.125.24.0-255,1484,117299,33,267748
7382,0.001523,74.125.24.0-255,5738,123037,33,267748
7383,0.001525,172.31.33.0-255,66,123103,33,267748
7384,0.001553,172.31.33.0-255,66,123169,33,267748
7385,0.001557,74.125.24.0-255,2902,126071,33,267748
7386,0.001559,172.31.33.0-255,66,126137,33,267748
7387,0.001572,74.125.24.0-255,4320,130457,33,267748
7388,0.001575,172.31.33.0-255,66,130523,33,267748
7389,0.001594,74.125.24.0-255,3602,134125,33,267748
7390,0.001597,172.31.33.0-255,66,134191,33,267748
7391,0.002026,74.125.24.0-255,1484,135675,33,267748
7392,0.002034,74.125.24.0-255,2902,138577,33,267748
7393,0.002038,172.31.33.0-255,66,138643,33,267748
7394,0.002059,74.125.24.0-255,4320,142963,33,267748
7395,0.002062,172.31.33.0-255,66,143029,33,267748
7396,0.002067,74.125.24.0-255,5738,148767,33,267748
7397,0.002069,172.31.33.0-255,66,148833,33,267748
7398,0.002086,74.125.24.0-255,2902,151735,33,267748
7399,0.002088,172.31.33.0-255,66,151801,33,267748
7400,0.002109,172.31.33.0-255,66,151867,33,267748
7401,0.002121,74.125.24.0-255,1484,153351,33,267748
7402,0.002141,74.125.24.0-255,6438,159789,33,267748
7403,0.002144,172.31.33.0-255,66,159855,33,267748
7404,0.002342,74.125.24.0-255,1484,161339,33,267748
7405,0.002362,74.125.24.0-255,2902,164241,33,267748
7406,0.002365,172.31.33.0-255,66,164307,33,267748
7407,0.002369,74.125.24.0-255,2902,167209,33,267748
7408,0.002371,172.31.33.0-255,66,167275,33,267748
7409,0.002385,74.125.24.0-255,2902,170177,33,267748
7410,0.002387,172.31.33.0-255,66,170243,33,267748
7411,0.002408,74.125.24.0-255,7156,177399,33,267748
7412,0.002411,172.31.33.0-255,66,177465,33,267748
7413,0.002416,74.125.24.0-255,4320,181785,33,267748
7414,0.002418,172.31.33.0-255,66,181851,33,267748
7415,0.002457,172.31.33.0-255,66,181917,33,267748
7416,0.002461,74.125.24.0-255,2184,184101,33,267748
7417,0.002463,172.31.33.0-255,66,184167,33,267748
7418,0.002717,74.125.24.0-255,1484,185651,33,267748
7419,0.002721,74.125.24.0-255,1484,187135,33,267748
7420,0.002724,172.31.33.0-255,66,187201,33,267748
7421,0.002741,74.125.24.0-255,1484,188685,33,267748
7422,0.002747,74.125.24.0-255,5738,194423,33,267748
7423,0.002749,172.31.33.0-255,66,194489,33,267748
7424,0.002753,74.125.24.0-255,2902,197391,33,267748
7425,0.002754,172.31.33.0-255,66,197457,33,267748
7426,0.00277,74.125.24.0-255,4320,201777,33,267748
7427,0.002772,172.31.33.0-255,66,201843,33,267748
7428,0.002787,74.125.24.0-255,2902,204745,33,267748
7429,0.002789,172.31.33.0-255,66,204811,33,267748
7430,0.00282,172.31.33.0-255,66,204877,33,267748
7431,0.002831,74.125.24.0-255,2902,207779,33,267748
7432,0.002833,172.31.33.0-255,66,207845,33,267748
7433,0.00286,172.31.33.0-255,66,207911,33,267748
7434,0.002878,74.125.24.0-255,1484,209395,33,267748
7435,0.0029,172.31.33.0-255,66,209461,33,267748
7436,0.00292,74.125.24.0-255,6438,215899,33,267748
7437,0.002923,172.31.33.0-255,66,215965,33,267748
7438,0.003063,74.125.24.0-255,1484,217449,33,267748
7439,0.003079,74.125.24.0-255,2902,220351,33,267748
7440,0.003082,172.31.33.0-255,66,220417,33,267748
7441,0.003087,74.125.24.0-255,5738,226155,33,267748
7442,0.003089,172.31.33.0-255,66,226221,33,267748
7443,0.003091,74.125.24.0-255,1484,227705,33,267748
7444,0.003108,74.125.24.0-255,1484,229189,33,267748
7445,0.003109,172.31.33.0-255,66,229255,33,267748
7446,0.003112,74.125.24.0-255,1484,230739,33,267748
7447,0.003179,74.125.24.0-255,4320,235059,33,267748
7448,0.003182,172.31.33.0-255,66,235125,33,267748
7449,0.003191,172.31.33.0-255,66,235191,33,267748
7450,0.003193,74.125.24.0-255,1484,236675,33,267748
7451,0.003196,74.125.24.0-255,1484,238159,33,267748
7452,0.003199,172.31.33.0-255,66,238225,33,267748
7453,0.003218,74.125.24.0-255,2184,240409,33,267748
7454,0.00322,172.31.33.0-255,66,240475,33,267748
7455,0.003334,74.125.24.0-255,1484,241959,33,267748
7456,0.003346,74.125.24.0-255,2902,244861,33,267748
7457,0.003348,172.31.33.0-255,66,244927,33,267748
7458,0.003382,74.125.24.0-255,4320,249247,33,267748
7459,0.003385,172.31.33.0-255,66,249313,33,267748
7460,0.003403,74.125.24.0-255,1484,250797,33,267748
7461,0.003414,172.31.33.0-255,66,250863,33,267748
7462,0.003421,74.125.24.0-255,7156,258019,33,267748
7463,0.003424,172.31.33.0-255,66,258085,33,267748
7464,0.00343,74.125.24.0-255,5087,263172,33,267748
7465,0.003432,172.31.33.0-255,66,263238,33,267748
7466,0.003492,74.125.24.0-255,105,263343,33,267748
7467,0.005681,172.31.33.0-255,66,263409,33,267748
7468,0.005712,172.31.33.0-255,105,263514,33,267748
7469,0.007686,74.125.24.0-255,66,263580,33,267748
7470,0.027123,172.31.33.0-255,172,263752,33,267748
7471,0.027148,172.31.33.0-255,1113,264865,33,267748
7472,0.027198,172.31.33.0-255,1514,266379,33,267748
7473,0.0272,172.31.33.0-255,1171,267550,33,267748
7474,0.02867,104.244.42.0-255,66,267616,33,267748
7475,0.028703,104.244.42.0-255,66,267682,33,267748
7476,0.028738,104.244.42.0-255,66,267748,33,267748
7477,0.0,74.125.200.0-255,155,155,33,365786
7478,1.8e-05,172.31.33.0-255,66,221,33,365786
7479,3.9e-05,74.125.200.0-255,1484,1705,33,365786
7480,4.3e-05,172.31.33.0-255,66,1771,33,365786
7481,7.2e-05,74.125.200.0-255,2902,4673,33,365786
7482,7.6e-05,172.31.33.0-255,66,4739,33,365786
7483,7.8e-05,74.125.200.0-255,1484,6223,33,365786
7484,8.1e-05,172.31.33.0-255,66,6289,33,365786
7485,9.4e-05,74.125.200.0-255,1484,7773,33,365786
7486,9.6e-05,172.31.33.0-255,66,7839,33,365786
7487,0.00012,74.125.200.0-255,1484,9323,33,365786
7488,0.000123,172.31.33.0-255,66,9389,33,365786
7489,0.000143,74.125.200.0-255,2902,12291,33,365786
7490,0.000145,172.31.33.0-255,66,12357,33,365786
7491,0.000164,74.125.200.0-255,3485,15842,33,365786
7492,0.000166,172.31.33.0-255,66,15908,33,365786
7493,0.000173,74.125.200.0-255,7156,23064,33,365786
7494,0.000175,172.31.33.0-255,66,23130,33,365786
7495,0.000179,74.125.200.0-255,5738,28868,33,365786
7496,0.000182,172.31.33.0-255,66,28934,33,365786
7497,0.000224,74.125.200.0-255,2543,31477,33,365786
7498,0.000229,172.31.33.0-255,66,31543,33,365786
7499,0.000343,74.125.200.0-255,1484,33027,33,365786
7500,0.000348,172.31.33.0-255,66,33093,33,365786
7501,0.000368,74.125.200.0-255,2902,35995,33,365786
7502,0.000371,172.31.33.0-255,66,36061,33,365786
7503,0.000374,74.125.200.0-255,1484,37545,33,365786
7504,0.000376,172.31.33.0-255,66,37611,33,365786
7505,0.000405,74.125.200.0-255,2902,40513,33,365786
7506,0.000408,172.31.33.0-255,66,40579,33,365786
7507,0.000414,74.125.200.0-255,5738,46317,33,365786
7508,0.000417,172.31.33.0-255,66,46383,33,365786
7509,0.000421,74.125.200.0-255,1484,47867,33,365786
7510,0.000441,74.125.200.0-255,1484,49351,33,365786
7511,0.000444,172.31.33.0-255,66,49417,33,365786
7512,0.000463,74.125.200.0-255,1484,50901,33,365786
7513,0.000469,74.125.200.0-255,5738,56639,33,365786
7514,0.000473,172.31.33.0-255,66,56705,33,365786
7515,0.000478,74.125.200.0-255,4320,61025,33,365786
7516,0.000481,172.31.33.0-255,66,61091,33,365786
7517,0.000485,74.125.200.0-255,2902,63993,33,365786
7518,0.000489,172.31.33.0-255,66,64059,33,365786
7519,0.000511,74.125.200.0-255,2184,66243,33,365786
7520,0.000514,172.31.33.0-255,66,66309,33,365786
7521,0.000517,74.125.200.0-255,361,66670,33,365786
7522,0.000547,74.125.200.0-255,131,66801,33,365786
7523,0.000645,74.125.200.0-255,1484,68285,33,365786
7524,0.000649,172.31.33.0-255,66,68351,33,365786
7525,0.000653,74.125.200.0-255,1484,69835,33,365786
7526,0.000667,74.125.200.0-255,1484,71319,33,365786
7527,0.00067,172.31.33.0-255,66,71385,33,365786
7528,0.000674,74.125.200.0-255,1484,72869,33,365786
7529,0.00069,74.125.200.0-255,4320,77189,33,365786
7530,0.000693,172.31.33.0-255,66,77255,33,365786
7531,0.000721,74.125.200.0-255,2902,80157,33,365786
7532,0.000724,172.31.33.0-255,66,80223,33,365786
7533,0.000746,74.125.200.0-255,4320,84543,33,365786
7534,0.000749,172.31.33.0-255,66,84609,33,365786
7535,0.000762,172.31.33.0-255,66,84675,33,365786
7536,0.000785,74.125.200.0-255,2902,87577,33,365786
7537,0.000788,172.31.33.0-255,66,87643,33,365786
7538,0.000808,74.125.200.0-255,3602,91245,33,365786
7539,0.00081,172.31.33.0-255,66,91311,33,365786
7540,0.000826,74.125.200.0-255,1484,92795,33,365786
7541,0.000841,74.125.200.0-255,5738,98533,33,365786
7542,0.000844,172.31.33.0-255,66,98599,33,365786
7543,0.000851,74.125.200.0-255,7156,105755,33,365786
7544,0.000853,172.31.33.0-255,66,105821,33,365786
7545,0.000898,74.125.200.0-255,2245,108066,33,365786
7546,0.000902,172.31.33.0-255,66,108132,33,365786
7547,0.001054,74.125.200.0-255,1484,109616,33,365786
7548,0.001067,74.125.200.0-255,2902,112518,33,365786
7549,0.00107,172.31.33.0-255,66,112584,33,365786
7550,0.001094,74.125.200.0-255,5738,118322,33,365786
7551,0.001098,172.31.33.0-255,66,118388,33,365786
7552,0.001116,74.125.200.0-255,5738,124126,33,365786
7553,0.001119,172.31.33.0-255,66,124192,33,365786
7554,0.001141,74.125.200.0-255,1484,125676,33,365786
7555,0.00115,172.31.33.0-255,66,125742,33,365786
7556,0.001177,172.31.33.0-255,66,125808,33,365786
7557,0.001256,74.125.200.0-255,1484,127292,33,365786
7558,0.00126,74.125.200.0-255,2902,130194,33,365786
7559,0.001263,172.31.33.0-255,66,130260,33,365786
7560,0.001285,74.125.200.0-255,5738,135998,33,365786
7561,0.001289,172.31.33.0-255,66,136064,33,365786
7562,0.00131,74.125.200.0-255,2902,138966,33,365786
7563,0.001314,172.31.33.0-255,66,139032,33,365786
7564,0.001338,172.31.33.0-255,66,139098,33,365786
7565,0.00137,172.31.33.0-255,66,139164,33,365786
7566,0.001394,74.125.200.0-255,1484,140648,33,365786
7567,0.001411,74.125.200.0-255,2902,143550,33,365786
7568,0.001414,172.31.33.0-255,66,143616,33,365786
7569,0.001432,74.125.200.0-255,1484,145100,33,365786
7570,0.001444,74.125.200.0-255,2902,148002,33,365786
7571,0.001447,172.31.33.0-255,66,148068,33,365786
7572,0.001467,74.125.200.0-255,5738,153806,33,365786
7573,0.001469,74.125.200.0-255,1484,155290,33,365786
7574,0.00147,172.31.33.0-255,66,155356,33,365786
7575,0.001499,74.125.200.0-255,4320,159676,33,365786
7576,0.001502,172.31.33.0-255,66,159742,33,365786
7577,0.001509,74.125.200.0-255,7156,166898,33,365786
7578,0.001511,172.31.33.0-255,66,166964,33,365786
7579,0.001532,74.125.200.0-255,6438,173402,33,365786
7580,0.001535,172.31.33.0-255,66,173468,33,365786
7581,0.00364,74.125.200.0-255,5738,179206,33,365786
7582,0.003645,172.31.33.0-255,66,179272,33,365786
7583,0.005736,74.125.200.0-255,2902,182174,33,365786
7584,0.005739,172.31.33.0-255,66,182240,33,365786
7585,0.005757,74.125.200.0-255,2902,185142,33,365786
7586,0.005759,172.31.33.0-255,66,185208,33,365786
7587,0.007908,74.125.200.0-255,5738,190946,33,365786
7588,0.007914,172.31.33.0-255,66,191012,33,365786
7589,0.010023,74.125.200.0-255,5738,196750,33,365786
7590,0.010028,172.31.33.0-255,66,196816,33,365786
7591,0.01213,74.125.200.0-255,5738,202554,33,365786
7592,0.012138,172.31.33.0-255,66,202620,33,365786
7593,0.014239,74.125.200.0-255,5738,208358,33,365786
7594,0.014245,172.31.33.0-255,66,208424,33,365786
7595,0.016353,74.125.200.0-255,4320,212744,33,365786
7596,0.016359,172.31.33.0-255,66,212810,33,365786
7597,0.016383,74.125.200.0-255,1484,214294,33,365786
7598,0.018475,74.125.200.0-255,4320,218614,33,365786
7599,0.018481,172.31.33.0-255,66,218680,33,365786
7600,0.020606,74.125.200.0-255,5738,224418,33,365786
7601,0.020614,172.31.33.0-255,66,224484,33,365786
7602,0.022718,74.125.200.0-255,4320,228804,33,365786
7603,0.022725,172.31.33.0-255,66,228870,33,365786
7604,0.022752,74.125.200.0-255,1484,230354,33,365786
7605,0.024825,74.125.200.0-255,1484,231838,33,365786
7606,0.024832,172.31.33.0-255,66,231904,33,365786
7607,0.024854,74.125.200.0-255,2902,234806,33,365786
7608,0.024857,172.31.33.0-255,66,234872,33,365786
7609,0.025003,172.31.33.0-255,172,235044,33,365786
7610,0.025031,172.31.33.0-255,1117,236161,33,365786
7611,0.025107,172.31.33.0-255,1514,237675,33,365786
7612,0.025109,172.31.33.0-255,1514,239189,33,365786
7613,0.025138,172.31.33.0-255,677,239866,33,365786
7614,0.026528,104.244.42.0-255,66,239932,33,365786
7615,0.026586,104.244.42.0-255,66,239998,33,365786
7616,0.026662,104.244.42.0-255,66,240064,33,365786
7617,0.026702,104.244.42.0-255,66,240130,33,365786
7618,0.02692,74.125.200.0-255,1484,241614,33,365786
7619,0.026945,74.125.200.0-255,4320,245934,33,365786
7620,0.026949,172.31.33.0-255,66,246000,33,365786
7621,0.02905,74.125.200.0-255,4320,250320,33,365786
7622,0.029054,172.31.33.0-255,66,250386,33,365786
7623,0.029076,74.125.200.0-255,1484,251870,33,365786
7624,0.031173,74.125.200.0-255,2902,254772,33,365786
7625,0.031178,172.31.33.0-255,66,254838,33,365786
7626,0.031207,74.125.200.0-255,1484,256322,33,365786
7627,0.033289,74.125.200.0-255,4320,260642,33,365786
7628,0.033294,172.31.33.0-255,66,260708,33,365786
7629,0.035383,74.125.200.0-255,1484,262192,33,365786
7630,0.03541,74.125.200.0-255,4320,266512,33,365786
7631,0.035414,172.31.33.0-255,66,266578,33,365786
7632,0.037533,74.125.200.0-255,2902,269480,33,365786
7633,0.037538,172.31.33.0-255,66,269546,33,365786
7634,0.037566,74.125.200.0-255,2902,272448,33,365786
7635,0.037569,172.31.33.0-255,66,272514,33,365786
7636,0.039647,74.125.200.0-255,2902,275416,33,365786
7637,0.039652,172.31.33.0-255,66,275482,33,365786
7638,0.039675,74.125.200.0-255,2902,278384,33,365786
7639,0.039677,172.31.33.0-255,66,278450,33,365786
7640,0.041754,74.125.200.0-255,2902,281352,33,365786
7641,0.041759,172.31.33.0-255,66,281418,33,365786
7642,0.041785,74.125.200.0-255,2902,284320,33,365786
7643,0.041787,172.31.33.0-255,66,284386,33,365786
7644,0.043849,74.125.200.0-255,2902,287288,33,365786
7645,0.043853,172.31.33.0-255,66,287354,33,365786
7646,0.043892,74.125.200.0-255,2902,290256,33,365786
7647,0.043895,172.31.33.0-255,66,290322,33,365786
7648,0.045953,74.125.200.0-255,2902,293224,33,365786
7649,0.045957,172.31.33.0-255,66,293290,33,365786
7650,0.045985,74.125.200.0-255,2902,296192,33,365786
7651,0.045987,172.31.33.0-255,66,296258,33,365786
7652,0.048077,74.125.200.0-255,2902,299160,33,365786
7653,0.048081,172.31.33.0-255,66,299226,33,365786
7654,0.048104,74.125.200.0-255,2902,302128,33,365786
7655,0.048107,172.31.33.0-255,66,302194,33,365786
7656,0.050185,74.125.200.0-255,2902,305096,33,365786
7657,0.050191,172.31.33.0-255,66,305162,33,365786
7658,0.05023,74.125.200.0-255,2902,308064,33,365786
7659,0.050233,172.31.33.0-255,66,308130,33,365786
7660,0.052284,74.125.200.0-255,2902,311032,33,365786
7661,0.05229,172.31.33.0-255,66,311098,33,365786
7662,0.052318,74.125.200.0-255,1484,312582,33,365786
7663,0.052335,74.125.200.0-255,1484,314066,33,365786
7664,0.052337,172.31.33.0-255,66,314132,33,365786
7665,0.054385,74.125.200.0-255,2902,317034,33,365786
7666,0.054391,172.31.33.0-255,66,317100,33,365786
7667,0.054422,74.125.200.0-255,1484,318584,33,365786
7668,0.054437,74.125.200.0-255,1484,320068,33,365786
7669,0.05444,172.31.33.0-255,66,320134,33,365786
7670,0.056479,74.125.200.0-255,2902,323036,33,365786
7671,0.056486,172.31.33.0-255,66,323102,33,365786
7672,0.056531,74.125.200.0-255,2902,326004,33,365786
7673,0.056536,172.31.33.0-255,66,326070,33,365786
7674,0.058605,74.125.200.0-255,2902,328972,33,365786
7675,0.058609,172.31.33.0-255,66,329038,33,365786
7676,0.058639,74.125.200.0-255,2902,331940,33,365786
7677,0.058641,172.31.33.0-255,66,332006,33,365786
7678,0.060706,74.125.200.0-255,2902,334908,33,365786
7679,0.060712,172.31.33.0-255,66,334974,33,365786
7680,0.060741,74.125.200.0-255,1484,336458,33,365786
7681,0.06076,74.125.200.0-255,1484,337942,33,365786
7682,0.060763,172.31.33.0-255,66,338008,33,365786
7683,0.062818,74.125.200.0-255,2902,340910,33,365786
7684,0.062826,172.31.33.0-255,66,340976,33,365786
7685,0.062852,74.125.200.0-255,2902,343878,33,365786
7686,0.062854,172.31.33.0-255,66,343944,33,365786
7687,0.064954,74.125.200.0-255,1484,345428,33,365786
7688,0.064986,74.125.200.0-255,4320,349748,33,365786
7689,0.064993,172.31.33.0-255,66,349814,33,365786
7690,0.067093,74.125.200.0-255,5738,355552,33,365786
7691,0.0671,172.31.33.0-255,66,355618,33,365786
7692,0.069199,74.125.200.0-255,5738,361356,33,365786
7693,0.069205,172.31.33.0-255,66,361422,33,365786
7694,0.07131,74.125.200.0-255,4127,365549,33,365786
7695,0.071316,172.31.33.0-255,66,365615,33,365786
7696,0.071493,172.31.33.0-255,105,365720,33,365786
7697,0.073557,74.125.200.0-255,66,365786,33,365786
7698,0.0,172.217.194.0-255,147,147,33,213190
7699,2.5e-05,172.31.33.0-255,66,213,33,213190
7700,3.1e-05,172.217.194.0-255,1484,1697,33,213190
7701,3.4e-05,172.31.33.0-255,66,1763,33,213190
7702,3.9e-05,172.217.194.0-255,2902,4665,33,213190
7703,5e-05,172.31.33.0-255,66,4731,33,213190
7704,5.7e-05,172.217.194.0-255,7156,11887,33,213190
7705,6e-05,172.31.33.0-255,66,11953,33,213190
7706,9.4e-05,172.31.33.0-255,66,12019,33,213190
7707,0.000121,172.217.194.0-255,4854,16873,33,213190
7708,0.000124,172.31.33.0-255,66,16939,33,213190
7709,0.000129,172.217.194.0-255,5379,22318,33,213190
7710,0.000131,172.31.33.0-255,66,22384,33,213190
7711,0.000235,172.217.194.0-255,1484,23868,33,213190
7712,0.000238,172.31.33.0-255,66,23934,33,213190
7713,0.000256,172.217.194.0-255,2902,26836,33,213190
7714,0.000259,172.31.33.0-255,66,26902,33,213190
7715,0.000262,172.217.194.0-255,2902,29804,33,213190
7716,0.000265,172.31.33.0-255,66,29870,33,213190
7717,0.000283,172.217.194.0-255,2902,32772,33,213190
7718,0.000285,172.31.33.0-255,66,32838,33,213190
7719,0.000292,172.217.194.0-255,6797,39635,33,213190
7720,0.000299,172.31.33.0-255,66,39701,33,213190
7721,0.000306,172.217.194.0-255,7156,46857,33,213190
7722,0.000308,172.31.33.0-255,66,46923,33,213190
7723,0.000344,172.31.33.0-255,66,46989,33,213190
7724,0.000784,172.217.194.0-255,646,47635,33,213190
7725,0.000788,172.31.33.0-255,66,47701,33,213190
7726,0.000927,172.217.194.0-255,1484,49185,33,213190
7727,0.00093,172.31.33.0-255,66,49251,33,213190
7728,0.000936,172.217.194.0-255,2902,52153,33,213190
7729,0.000958,172.217.194.0-255,5738,57891,33,213190
7730,0.000961,172.217.194.0-255,1484,59375,33,213190
7731,0.000989,172.217.194.0-255,1484,60859,33,213190
7732,0.001204,172.217.194.0-255,1484,62343,33,213190
7733,0.00121,172.217.194.0-255,2902,65245,33,213190
7734,0.001229,172.217.194.0-255,5738,70983,33,213190
7735,0.001243,172.217.194.0-255,1484,72467,33,213190
7736,0.001253,172.217.194.0-255,4320,76787,33,213190
7737,0.001266,172.217.194.0-255,4320,81107,33,213190
7738,0.001269,172.217.194.0-255,2902,84009,33,213190
7739,0.00129,172.217.194.0-255,7156,91165,33,213190
7740,0.0013,172.217.194.0-255,1484,92649,33,213190
7741,0.001303,172.217.194.0-255,2184,94833,33,213190
7742,0.001402,172.217.194.0-255,1484,96317,33,213190
7743,0.001415,172.217.194.0-255,2902,99219,33,213190
7744,0.001425,172.217.194.0-255,4320,103539,33,213190
7745,0.001436,172.217.194.0-255,1484,105023,33,213190
7746,0.001439,172.217.194.0-255,2902,107925,33,213190
7747,0.001448,172.217.194.0-255,2902,110827,33,213190
7748,0.001464,172.217.194.0-255,4320,115147,33,213190
7749,0.0015,172.217.194.0-255,5020,120167,33,213190
7750,0.001609,172.217.194.0-255,1484,121651,33,213190
7751,0.00162,172.217.194.0-255,2902,124553,33,213190
7752,0.00163,172.217.194.0-255,1484,126037,33,213190
7753,0.001646,172.217.194.0-255,4320,130357,33,213190
7754,0.001651,172.217.194.0-255,5738,136095,33,213190
7755,0.001689,172.217.194.0-255,4320,140415,33,213190
7756,0.001691,172.217.194.0-255,1484,141899,33,213190
7757,0.001703,172.217.194.0-255,3602,145501,33,213190
7758,0.001751,172.217.194.0-255,1484,146985,33,213190
7759,0.00177,172.217.194.0-255,2902,149887,33,213190
7760,0.001773,172.217.194.0-255,1484,151371,33,213190
7761,0.001788,172.217.194.0-255,4320,155691,33,213190
7762,0.001799,172.217.194.0-255,1484,157175,33,213190
7763,0.001827,172.217.194.0-255,1484,158659,33,213190
7764,0.001829,172.217.194.0-255,1484,160143,33,213190
7765,0.001857,172.217.194.0-255,4320,164463,33,213190
7766,0.001883,172.217.194.0-255,1484,165947,33,213190
7767,0.00193,172.217.194.0-255,4320,170267,33,213190
7768,0.001955,172.217.194.0-255,2902,173169,33,213190
7769,0.002004,172.217.194.0-255,5738,178907,33,213190
7770,0.002006,172.217.194.0-255,1484,180391,33,213190
7771,0.002031,172.217.194.0-255,7156,187547,33,213190
7772,0.00211,172.217.194.0-255,2184,189731,33,213190
7773,0.002146,172.217.194.0-255,7156,196887,33,213190
7774,0.002186,172.217.194.0-255,7156,204043,33,213190
7775,0.00219,172.217.194.0-255,3548,207591,33,213190
7776,0.002192,172.217.194.0-255,105,207696,33,213190
7777,0.002643,172.31.33.0-255,66,207762,33,213190
7778,0.004791,172.31.33.0-255,105,207867,33,213190
7779,0.006906,172.217.194.0-255,66,207933,33,213190
7780,0.025928,172.31.33.0-255,172,208105,33,213190
7781,0.02596,172.31.33.0-255,1117,209222,33,213190
7782,0.026001,172.31.33.0-255,1514,210736,33,213190
7783,0.026002,172.31.33.0-255,1514,212250,33,213190
7784,0.026026,172.31.33.0-255,676,212926,33,213190
7785,0.027521,104.244.42.0-255,66,212992,33,213190
7786,0.027573,104.244.42.0-255,66,213058,33,213190
7787,0.027634,104.244.42.0-255,66,213124,33,213190
7788,0.027643,104.244.42.0-255,66,213190,33,213190
7789,0.0,74.125.24.0-255,153,153,33,170133
7790,2.8e-05,172.31.33.0-255,66,219,33,170133
7791,5.5e-05,74.125.24.0-255,1484,1703,33,170133
7792,5.9e-05,172.31.33.0-255,66,1769,33,170133
7793,6.4e-05,74.125.24.0-255,2902,4671,33,170133
7794,6.7e-05,172.31.33.0-255,66,4737,33,170133
7795,7.2e-05,74.125.24.0-255,4320,9057,33,170133
7796,7.5e-05,172.31.33.0-255,66,9123,33,170133
7797,0.000102,74.125.24.0-255,1484,10607,33,170133
7798,0.000104,172.31.33.0-255,66,10673,33,170133
7799,0.00011,74.125.24.0-255,6228,16901,33,170133
7800,0.000112,172.31.33.0-255,66,16967,33,170133
7801,0.000123,172.31.33.0-255,66,17033,33,170133
7802,0.000145,74.125.24.0-255,2543,19576,33,170133
7803,0.000147,172.31.33.0-255,66,19642,33,170133
7804,0.000534,74.125.24.0-255,1484,21126,33,170133
7805,0.000538,172.31.33.0-255,66,21192,33,170133
7806,0.000546,74.125.24.0-255,2902,24094,33,170133
7807,0.000548,172.31.33.0-255,66,24160,33,170133
7808,0.000551,74.125.24.0-255,1484,25644,33,170133
7809,0.000553,172.31.33.0-255,66,25710,33,170133
7810,0.000579,74.125.24.0-255,4320,30030,33,170133
7811,0.000581,172.31.33.0-255,66,30096,33,170133
7812,0.000585,74.125.24.0-255,2902,32998,33,170133
7813,0.000587,172.31.33.0-255,66,33064,33,170133
7814,0.000624,172.31.33.0-255,66,33130,33,170133
7815,0.000652,172.31.33.0-255,66,33196,33,170133
7816,0.000687,74.125.24.0-255,2184,35380,33,170133
7817,0.000691,172.31.33.0-255,66,35446,33,170133
7818,0.001127,74.125.24.0-255,412,35858,33,170133
7819,0.001157,172.31.33.0-255,66,35924,33,170133
7820,0.001168,74.125.24.0-255,1484,37408,33,170133
7821,0.001186,74.125.24.0-255,4320,41728,33,170133
7822,0.001188,172.31.33.0-255,66,41794,33,170133
7823,0.00121,74.125.24.0-255,5738,47532,33,170133
7824,0.001213,172.31.33.0-255,66,47598,33,170133
7825,0.001231,74.125.24.0-255,4320,51918,33,170133
7826,0.001234,172.31.33.0-255,66,51984,33,170133
7827,0.001244,172.31.33.0-255,66,52050,33,170133
7828,0.001264,74.125.24.0-255,2902,54952,33,170133
7829,0.001273,74.125.24.0-255,6438,61390,33,170133
7830,0.001277,172.31.33.0-255,66,61456,33,170133
7831,0.001279,172.31.33.0-255,66,61522,33,170133
7832,0.001439,74.125.24.0-255,1484,63006,33,170133
7833,0.001455,74.125.24.0-255,2902,65908,33,170133
7834,0.001458,172.31.33.0-255,66,65974,33,170133
7835,0.001464,74.125.24.0-255,4320,70294,33,170133
7836,0.001465,172.31.33.0-255,66,70360,33,170133
7837,0.001478,74.125.24.0-255,1484,71844,33,170133
7838,0.00149,74.125.24.0-255,2902,74746,33,170133
7839,0.001492,172.31.33.0-255,66,74812,33,170133
7840,0.001513,172.31.33.0-255,66,74878,33,170133
7841,0.001519,74.125.24.0-255,5738,80616,33,170133
7842,0.001521,172.31.33.0-255,66,80682,33,170133
7843,0.001545,74.125.24.0-255,5020,85702,33,170133
7844,0.001547,172.31.33.0-255,66,85768,33,170133
7845,0.001741,74.125.24.0-255,1484,87252,33,170133
7846,0.001754,74.125.24.0-255,2902,90154,33,170133
7847,0.001757,172.31.33.0-255,66,90220,33,170133
7848,0.001778,74.125.24.0-255,5738,95958,33,170133
7849,0.00178,172.31.33.0-255,66,96024,33,170133
7850,0.001808,74.125.24.0-255,2902,98926,33,170133
7851,0.00181,172.31.33.0-255,66,98992,33,170133
7852,0.001834,172.31.33.0-255,66,99058,33,170133
7853,0.001848,172.31.33.0-255,66,99124,33,170133
7854,0.001886,172.31.33.0-255,66,99190,33,170133
7855,0.001896,172.31.33.0-255,66,99256,33,170133
7856,0.001918,74.125.24.0-255,2902,102158,33,170133
7857,0.001922,172.31.33.0-255,66,102224,33,170133
7858,0.001962,74.125.24.0-255,5020,107244,33,170133
7859,0.001967,74.125.24.0-255,5738,112982,33,170133
7860,0.00197,74.125.24.0-255,2902,115884,33,170133
7861,0.001973,172.31.33.0-255,66,115950,33,170133
7862,0.001976,172.31.33.0-255,66,116016,33,170133
7863,0.001979,172.31.33.0-255,66,116082,33,170133
7864,0.001996,74.125.24.0-255,5738,121820,33,170133
7865,0.001999,172.31.33.0-255,66,121886,33,170133
7866,0.002022,74.125.24.0-255,1484,123370,33,170133
7867,0.002046,172.31.33.0-255,66,123436,33,170133
7868,0.002065,74.125.24.0-255,5020,128456,33,170133
7869,0.002067,172.31.33.0-255,66,128522,33,170133
7870,0.002106,74.125.24.0-255,1484,130006,33,170133
7871,0.002122,74.125.24.0-255,2902,132908,33,170133
7872,0.002126,172.31.33.0-255,66,132974,33,170133
7873,0.002129,74.125.24.0-255,2902,135876,33,170133
7874,0.002131,172.31.33.0-255,66,135942,33,170133
7875,0.002146,74.125.24.0-255,2902,138844,33,170133
7876,0.002148,172.31.33.0-255,66,138910,33,170133
7877,0.002151,74.125.24.0-255,1484,140394,33,170133
7878,0.002193,172.31.33.0-255,66,140460,33,170133
7879,0.002204,172.31.33.0-255,66,140526,33,170133
7880,0.00224,74.125.24.0-255,2902,143428,33,170133
7881,0.002243,172.31.33.0-255,66,143494,33,170133
7882,0.002279,172.31.33.0-255,66,143560,33,170133
7883,0.002301,74.125.24.0-255,2902,146462,33,170133
7884,0.002304,172.31.33.0-255,66,146528,33,170133
7885,0.002315,172.31.33.0-255,66,146594,33,170133
7886,0.002325,172.31.33.0-255,66,146660,33,170133
7887,0.002346,74.125.24.0-255,1484,148144,33,170133
7888,0.002353,74.125.24.0-255,5738,153882,33,170133
7889,0.002356,172.31.33.0-255,66,153948,33,170133
7890,0.002373,74.125.24.0-255,1484,155432,33,170133
7891,0.00243,74.125.24.0-255,7156,162588,33,170133
7892,0.002434,172.31.33.0-255,66,162654,33,170133
7893,0.002464,172.31.33.0-255,66,162720,33,170133
7894,0.002479,172.31.33.0-255,66,162786,33,170133
7895,0.002492,172.31.33.0-255,66,162852,33,170133
7896,0.002503,172.31.33.0-255,66,162918,33,170133
7897,0.002526,74.125.24.0-255,1484,164402,33,170133
7898,0.00253,172.31.33.0-255,66,164468,33,170133
7899,0.002553,172.31.33.0-255,66,164534,33,170133
7900,0.002556,74.125.24.0-255,105,164639,33,170133
7901,0.004077,172.31.33.0-255,66,164705,33,170133
7902,0.004111,172.31.33.0-255,105,164810,33,170133
7903,0.006604,74.125.24.0-255,66,164876,33,170133
7904,0.02437,172.31.33.0-255,172,165048,33,170133
7905,0.024417,172.31.33.0-255,1113,166161,33,170133
7906,0.024481,172.31.33.0-255,1514,167675,33,170133
7907,0.024483,172.31.33.0-255,1514,169189,33,170133
7908,0.024508,172.31.33.0-255,680,169869,33,170133
7909,0.025951,104.244.42.0-255,66,169935,33,170133
7910,0.025981,104.244.42.0-255,66,170001,33,170133
7911,0.026118,104.244.42.0-255,66,170067,33,170133
7912,0.026121,104.244.42.0-255,66,170133,33,170133
7913,0.0,172.217.194.0-255,146,146,33,277716
7914,2.4e-05,172.31.33.0-255,66,212,33,277716
7915,3e-05,172.217.194.0-255,1484,1696,33,277716
7916,3.4e-05,172.31.33.0-255,66,1762,33,277716
7917,3.9e-05,172.217.194.0-255,2902,4664,33,277716
7918,4.2e-05,172.31.33.0-255,66,4730,33,277716
7919,5.5e-05,172.217.194.0-255,7156,11886,33,277716
7920,5.7e-05,172.31.33.0-255,66,11952,33,277716
7921,9.9e-05,172.217.194.0-255,2011,13963,33,277716
7922,0.000102,172.31.33.0-255,66,14029,33,277716
7923,0.000106,172.217.194.0-255,2902,16931,33,277716
7924,0.000109,172.31.33.0-255,66,16997,33,277716
7925,0.000115,172.217.194.0-255,7156,24153,33,277716
7926,0.000117,172.31.33.0-255,66,24219,33,277716
7927,0.000121,172.217.194.0-255,4320,28539,33,277716
7928,0.000123,172.31.33.0-255,66,28605,33,277716
7929,0.00015,172.217.194.0-255,2543,31148,33,277716
7930,0.000153,172.31.33.0-255,66,31214,33,277716
7931,0.000188,172.217.194.0-255,1484,32698,33,277716
7932,0.00019,172.31.33.0-255,66,32764,33,277716
7933,0.000215,172.217.194.0-255,2902,35666,33,277716
7934,0.000218,172.31.33.0-255,66,35732,33,277716
7935,0.000223,172.217.194.0-255,5738,41470,33,277716
7936,0.000225,172.217.194.0-255,1484,42954,33,277716
7937,0.000228,172.31.33.0-255,66,43020,33,277716
7938,0.00023,172.31.33.0-255,66,43086,33,277716
7939,0.000246,172.217.194.0-255,4320,47406,33,277716
7940,0.000253,172.31.33.0-255,66,47472,33,277716
7941,0.00029,172.31.33.0-255,66,47538,33,277716
7942,0.0003,172.31.33.0-255,66,47604,33,277716
7943,0.000302,172.217.194.0-255,676,48280,33,277716
7944,0.000563,172.217.194.0-255,1484,49764,33,277716
7945,0.000566,172.31.33.0-255,66,49830,33,277716
7946,0.00057,172.217.194.0-255,1484,51314,33,277716
7947,0.000594,172.217.194.0-255,1484,52798,33,277716
7948,0.000596,172.31.33.0-255,66,52864,33,277716
7949,0.000599,172.217.194.0-255,1484,54348,33,277716
7950,0.000604,172.217.194.0-255,5738,60086,33,277716
7951,0.000606,172.31.33.0-255,66,60152,33,277716
7952,0.00065,172.31.33.0-255,66,60218,33,277716
7953,0.000653,172.217.194.0-255,1484,61702,33,277716
7954,0.000689,172.217.194.0-255,4320,66022,33,277716
7955,0.000692,172.31.33.0-255,66,66088,33,277716
7956,0.000717,172.217.194.0-255,3602,69690,33,277716
7957,0.000719,172.31.33.0-255,66,69756,33,277716
7958,0.00123,172.217.194.0-255,1484,71240,33,277716
7959,0.001239,172.217.194.0-255,2902,74142,33,277716
7960,0.001243,172.31.33.0-255,66,74208,33,277716
7961,0.001249,172.217.194.0-255,5738,79946,33,277716
7962,0.001251,172.31.33.0-255,66,80012,33,277716
7963,0.001276,172.217.194.0-255,7156,87168,33,277716
7964,0.001279,172.31.33.0-255,66,87234,33,277716
7965,0.001305,172.217.194.0-255,5738,92972,33,277716
7966,0.001308,172.31.33.0-255,66,93038,33,277716
7967,0.001318,172.31.33.0-255,66,93104,33,277716
7968,0.001355,172.217.194.0-255,1484,94588,33,277716
7969,0.001359,172.217.194.0-255,1484,96072,33,277716
7970,0.001362,172.31.33.0-255,66,96138,33,277716
7971,0.001375,172.217.194.0-255,1484,97622,33,277716
7972,0.001384,172.217.194.0-255,5738,103360,33,277716
7973,0.001386,172.31.33.0-255,66,103426,33,277716
7974,0.001413,172.31.33.0-255,66,103492,33,277716
7975,0.001416,172.217.194.0-255,1484,104976,33,277716
7976,0.001438,172.217.194.0-255,7156,112132,33,277716
7977,0.00144,172.31.33.0-255,66,112198,33,277716
7978,0.00146,172.217.194.0-255,2902,115100,33,277716
7979,0.001462,172.31.33.0-255,66,115166,33,277716
7980,0.001465,172.217.194.0-255,2184,117350,33,277716
7981,0.001466,172.31.33.0-255,66,117416,33,277716
7982,0.001584,172.217.194.0-255,1484,118900,33,277716
7983,0.001599,172.217.194.0-255,2902,121802,33,277716
7984,0.001602,172.31.33.0-255,66,121868,33,277716
7985,0.001605,172.217.194.0-255,1484,123352,33,277716
7986,0.001629,172.217.194.0-255,4320,127672,33,277716
7987,0.001631,172.31.33.0-255,66,127738,33,277716
7988,0.001635,172.217.194.0-255,5738,133476,33,277716
7989,0.001637,172.31.33.0-255,66,133542,33,277716
7990,0.001655,172.217.194.0-255,4320,137862,33,277716
7991,0.001657,172.31.33.0-255,66,137928,33,277716
7992,0.001706,172.217.194.0-255,7156,145084,33,277716
7993,0.001708,172.31.33.0-255,66,145150,33,277716
7994,0.001732,172.217.194.0-255,6438,151588,33,277716
7995,0.001734,172.31.33.0-255,66,151654,33,277716
7996,0.001824,172.217.194.0-255,1484,153138,33,277716
7997,0.001835,172.217.194.0-255,1484,154622,33,277716
7998,0.001836,172.31.33.0-255,66,154688,33,277716
7999,0.001887,172.217.194.0-255,1484,156172,33,277716
8000,0.001893,172.217.194.0-255,5738,161910,33,277716
8001,0.001895,172.31.33.0-255,66,161976,33,277716
8002,0.001904,172.31.33.0-255,66,162042,33,277716
8003,0.001948,172.31.33.0-255,66,162108,33,277716
8004,0.001958,172.31.33.0-255,66,162174,33,277716
8005,0.002002,172.217.194.0-255,7156,169330,33,277716
8006,0.002004,172.31.33.0-255,66,169396,33,277716
8007,0.002044,172.31.33.0-255,66,169462,33,277716
8008,0.002057,172.31.33.0-255,66,169528,33,277716
8009,0.002085,172.217.194.0-255,6438,175966,33,277716
8010,0.002087,172.31.33.0-255,66,176032,33,277716
8011,0.002093,172.217.194.0-255,5738,181770,33,277716
8012,0.002095,172.31.33.0-255,66,181836,33,277716
8013,0.002127,172.31.33.0-255,66,181902,33,277716
8014,0.002136,172.31.33.0-255,66,181968,33,277716
8015,0.002167,172.217.194.0-255,7156,189124,33,277716
8016,0.002169,172.31.33.0-255,66,189190,33,277716
8017,0.004258,172.217.194.0-255,2902,192092,33,277716
8018,0.004261,172.31.33.0-255,66,192158,33,277716
8019,0.004273,172.217.194.0-255,2902,195060,33,277716
8020,0.004278,172.31.33.0-255,66,195126,33,277716
8021,0.00634,172.217.194.0-255,2902,198028,33,277716
8022,0.006345,172.31.33.0-255,66,198094,33,277716
8023,0.006387,172.217.194.0-255,2902,200996,33,277716
8024,0.006392,172.31.33.0-255,66,201062,33,277716
8025,0.008406,172.217.194.0-255,2902,203964,33,277716
8026,0.008412,172.31.33.0-255,66,204030,33,277716
8027,0.008469,172.217.194.0-255,1484,205514,33,277716
8028,0.008483,172.217.194.0-255,1484,206998,33,277716
8029,0.008486,172.31.33.0-255,66,207064,33,277716
8030,0.010549,172.217.194.0-255,2902,209966,33,277716
8031,0.010555,172.31.33.0-255,66,210032,33,277716
8032,0.010583,172.217.194.0-255,2902,212934,33,277716
8033,0.010585,172.31.33.0-255,66,213000,33,277716
8034,0.012642,172.217.194.0-255,2902,215902,33,277716
8035,0.012649,172.31.33.0-255,66,215968,33,277716
8036,0.012701,172.217.194.0-255,2902,218870,33,277716
8037,0.012705,172.31.33.0-255,66,218936,33,277716
8038,0.014774,172.217.194.0-255,5738,224674,33,277716
8039,0.014782,172.31.33.0-255,66,224740,33,277716
8040,0.01687,172.217.194.0-255,5738,230478,33,277716
8041,0.016877,172.31.33.0-255,66,230544,33,277716
8042,0.018968,172.217.194.0-255,5738,236282,33,277716
8043,0.018975,172.31.33.0-255,66,236348,33,277716
8044,0.021093,172.217.194.0-255,5738,242086,33,277716
8045,0.021098,172.31.33.0-255,66,242152,33,277716
8046,0.023212,172.217.194.0-255,5738,247890,33,277716
8047,0.02322,172.31.33.0-255,66,247956,33,277716
8048,0.025319,172.217.194.0-255,5738,253694,33,277716
8049,0.025324,172.31.33.0-255,66,253760,33,277716
8050,0.027412,172.217.194.0-255,4320,258080,33,277716
8051,0.027418,172.31.33.0-255,66,258146,33,277716
8052,0.027447,172.217.194.0-255,1484,259630,33,277716
8053,0.029145,172.31.33.0-255,172,259802,33,277716
8054,0.029169,172.31.33.0-255,1118,260920,33,277716
8055,0.029205,172.31.33.0-255,1514,262434,33,277716
8056,0.029206,172.31.33.0-255,1514,263948,33,277716
8057,0.029228,172.31.33.0-255,675,264623,33,277716
8058,0.029511,172.217.194.0-255,4320,268943,33,277716
8059,0.029517,172.31.33.0-255,66,269009,33,277716
8060,0.030689,104.244.42.0-255,66,269075,33,277716
8061,0.030695,104.244.42.0-255,66,269141,33,277716
8062,0.030757,104.244.42.0-255,66,269207,33,277716
8063,0.031635,172.217.194.0-255,4320,273527,33,277716
8064,0.031638,172.31.33.0-255,66,273593,33,277716
8065,0.031669,172.217.194.0-255,1484,275077,33,277716
8066,0.033735,172.217.194.0-255,2402,277479,33,277716
8067,0.03374,172.31.33.0-255,66,277545,33,277716
8068,0.033897,172.31.33.0-255,105,277650,33,277716
8069,0.035935,172.217.194.0-255,66,277716,33,277716
8070,0.0,172.31.33.0-255,105,105,33,459
8071,0.000209,172.31.33.0-255,90,195,33,459
8072,0.000217,172.31.33.0-255,66,261,33,459
8073,0.00224,74.125.24.0-255,66,327,33,459
8074,0.002271,74.125.24.0-255,66,393,33,459
8075,0.002294,172.31.33.0-255,66,459,33,459
8076,0.0,172.31.33.0-255,296,296,33,362
8077,0.001548,104.244.42.0-255,66,362,33,362
8078,0.0,74.125.68.0-255,151,151,33,255808
8079,1.9e-05,172.31.33.0-255,66,217,33,255808
8080,4.1e-05,74.125.68.0-255,1484,1701,33,255808
8081,4.5e-05,172.31.33.0-255,66,1767,33,255808
8082,5e-05,74.125.68.0-255,2902,4669,33,255808
8083,5.3e-05,172.31.33.0-255,66,4735,33,255808
8084,7.9e-05,74.125.68.0-255,4320,9055,33,255808
8085,8.1e-05,172.31.33.0-255,66,9121,33,255808
8086,0.000112,172.31.33.0-255,66,9187,33,255808
8087,0.000137,172.31.33.0-255,66,9253,33,255808
8088,0.00016,74.125.68.0-255,2543,11796,33,255808
8089,0.000162,172.31.33.0-255,66,11862,33,255808
8090,0.000508,74.125.68.0-255,1484,13346,33,255808
8091,0.000519,172.31.33.0-255,66,13412,33,255808
8092,0.000524,74.125.68.0-255,2902,16314,33,255808
8093,0.000526,172.31.33.0-255,66,16380,33,255808
8094,0.00055,74.125.68.0-255,5738,22118,33,255808
8095,0.000553,172.31.33.0-255,66,22184,33,255808
8096,0.000559,74.125.68.0-255,5738,27922,33,255808
8097,0.00056,172.31.33.0-255,66,27988,33,255808
8098,0.000592,74.125.68.0-255,5738,33726,33,255808
8099,0.000594,172.31.33.0-255,66,33792,33,255808
8100,0.000618,74.125.68.0-255,1125,34917,33,255808
8101,0.000621,172.31.33.0-255,66,34983,33,255808
8102,0.000632,172.31.33.0-255,66,35049,33,255808
8103,0.000657,74.125.68.0-255,2816,37865,33,255808
8104,0.00066,172.31.33.0-255,66,37931,33,255808
8105,0.000825,74.125.68.0-255,134,38065,33,255808
8106,0.000829,172.31.33.0-255,66,38131,33,255808
8107,0.000862,74.125.68.0-255,1484,39615,33,255808
8108,0.000882,74.125.68.0-255,2902,42517,33,255808
8109,0.000884,172.31.33.0-255,66,42583,33,255808
8110,0.000888,74.125.68.0-255,1484,44067,33,255808
8111,0.000915,74.125.68.0-255,5738,49805,33,255808
8112,0.000918,172.31.33.0-255,66,49871,33,255808
8113,0.000922,74.125.68.0-255,4320,54191,33,255808
8114,0.000924,172.31.33.0-255,66,54257,33,255808
8115,0.000929,74.125.68.0-255,2902,57159,33,255808
8116,0.000937,172.31.33.0-255,66,57225,33,255808
8117,0.000963,74.125.68.0-255,2902,60127,33,255808
8118,0.000965,172.31.33.0-255,66,60193,33,255808
8119,0.000981,172.31.33.0-255,66,60259,33,255808
8120,0.000983,74.125.68.0-255,766,61025,33,255808
8121,0.00112,74.125.68.0-255,1484,62509,33,255808
8122,0.001125,172.31.33.0-255,66,62575,33,255808
8123,0.00113,74.125.68.0-255,2902,65477,33,255808
8124,0.001133,172.31.33.0-255,66,65543,33,255808
8125,0.001163,74.125.68.0-255,5738,71281,33,255808
8126,0.001167,172.31.33.0-255,66,71347,33,255808
8127,0.001176,74.125.68.0-255,2902,74249,33,255808
8128,0.001178,172.31.33.0-255,66,74315,33,255808
8129,0.001207,74.125.68.0-255,7156,81471,33,255808
8130,0.001209,172.31.33.0-255,66,81537,33,255808
8131,0.001212,74.125.68.0-255,1484,83021,33,255808
8132,0.001245,172.31.33.0-255,66,83087,33,255808
8133,0.001272,74.125.68.0-255,2184,85271,33,255808
8134,0.001275,172.31.33.0-255,66,85337,33,255808
8135,0.001501,74.125.68.0-255,1484,86821,33,255808
8136,0.001505,74.125.68.0-255,1484,88305,33,255808
8137,0.001508,172.31.33.0-255,66,88371,33,255808
8138,0.001534,74.125.68.0-255,1484,89855,33,255808
8139,0.001539,74.125.68.0-255,2902,92757,33,255808
8140,0.001541,172.31.33.0-255,66,92823,33,255808
8141,0.001546,74.125.68.0-255,4320,97143,33,255808
8142,0.001548,172.31.33.0-255,66,97209,33,255808
8143,0.00155,74.125.68.0-255,1484,98693,33,255808
8144,0.001577,74.125.68.0-255,7156,105849,33,255808
8145,0.001579,172.31.33.0-255,66,105915,33,255808
8146,0.001584,74.125.68.0-255,4320,110235,33,255808
8147,0.001586,172.31.33.0-255,66,110301,33,255808
8148,0.001613,74.125.68.0-255,2902,113203,33,255808
8149,0.001616,172.31.33.0-255,66,113269,33,255808
8150,0.001649,74.125.68.0-255,5738,119007,33,255808
8151,0.001651,172.31.33.0-255,66,119073,33,255808
8152,0.001681,74.125.68.0-255,2184,121257,33,255808
8153,0.001684,172.31.33.0-255,66,121323,33,255808
8154,0.001688,74.125.68.0-255,4320,125643,33,255808
8155,0.00169,172.31.33.0-255,66,125709,33,255808
8156,0.001706,172.31.33.0-255,66,125775,33,255808
8157,0.001711,74.125.68.0-255,5738,131513,33,255808
8158,0.001713,172.31.33.0-255,66,131579,33,255808
8159,0.001733,74.125.68.0-255,1484,133063,33,255808
8160,0.00176,74.125.68.0-255,6438,139501,33,255808
8161,0.001762,172.31.33.0-255,66,139567,33,255808
8162,0.001766,74.125.68.0-255,2902,142469,33,255808
8163,0.001768,172.31.33.0-255,66,142535,33,255808
8164,0.001791,74.125.68.0-255,5738,148273,33,255808
8165,0.001797,172.31.33.0-255,66,148339,33,255808
8166,0.0018,74.125.68.0-255,2902,151241,33,255808
8167,0.001802,172.31.33.0-255,66,151307,33,255808
8168,0.001823,74.125.68.0-255,5738,157045,33,255808
8169,0.001825,172.31.33.0-255,66,157111,33,255808
8170,0.001843,74.125.68.0-255,7156,164267,33,255808
8171,0.001845,172.31.33.0-255,66,164333,33,255808
8172,0.001847,74.125.68.0-255,1484,165817,33,255808
8173,0.001876,74.125.68.0-255,7156,172973,33,255808
8174,0.001878,172.31.33.0-255,66,173039,33,255808
8175,0.00188,74.125.68.0-255,1484,174523,33,255808
8176,0.001909,172.31.33.0-255,66,174589,33,255808
8177,0.001936,172.31.33.0-255,66,174655,33,255808
8178,0.001941,74.125.68.0-255,7156,181811,33,255808
8179,0.001943,172.31.33.0-255,66,181877,33,255808
8180,0.001971,74.125.68.0-255,4320,186197,33,255808
8181,0.001975,172.31.33.0-255,66,186263,33,255808
8182,0.002003,172.31.33.0-255,66,186329,33,255808
8183,0.002007,74.125.68.0-255,4320,190649,33,255808
8184,0.002028,172.31.33.0-255,66,190715,33,255808
8185,0.002048,74.125.68.0-255,7156,197871,33,255808
8186,0.00205,172.31.33.0-255,66,197937,33,255808
8187,0.002089,172.31.33.0-255,66,198003,33,255808
8188,0.002092,74.125.68.0-255,2184,200187,33,255808
8189,0.002099,172.31.33.0-255,66,200253,33,255808
8190,0.002141,74.125.68.0-255,2902,203155,33,255808
8191,0.002144,74.125.68.0-255,1484,204639,33,255808
8192,0.00217,74.125.68.0-255,1484,206123,33,255808
8193,0.002174,172.31.33.0-255,66,206189,33,255808
8194,0.002191,74.125.68.0-255,2902,209091,33,255808
8195,0.002206,74.125.68.0-255,2902,211993,33,255808
8196,0.002218,172.31.33.0-255,66,212059,33,255808
8197,0.002287,74.125.68.0-255,5738,217797,33,255808
8198,0.002291,74.125.68.0-255,4320,222117,33,255808
8199,0.002295,172.31.33.0-255,66,222183,33,255808
8200,0.00233,74.125.68.0-255,1484,223667,33,255808
8201,0.002346,74.125.68.0-255,4320,227987,33,255808
8202,0.002361,172.31.33.0-255,66,228053,33,255808
8203,0.004665,74.125.68.0-255,5738,233791,33,255808
8204,0.004679,172.31.33.0-255,66,233857,33,255808
8205,0.006963,74.125.68.0-255,5738,239595,33,255808
8206,0.006968,172.31.33.0-255,66,239661,33,255808
8207,0.00926,74.125.68.0-255,5738,245399,33,255808
8208,0.009267,172.31.33.0-255,66,245465,33,255808
8209,0.011541,74.125.68.0-255,1867,247332,33,255808
8210,0.011549,172.31.33.0-255,66,247398,33,255808
8211,0.014823,172.31.33.0-255,105,247503,33,255808
8212,0.017064,74.125.68.0-255,66,247569,33,255808
8213,0.024558,172.31.33.0-255,172,247741,33,255808
8214,0.024583,172.31.33.0-255,1113,248854,33,255808
8215,0.024625,172.31.33.0-255,1514,250368,33,255808
8216,0.024627,172.31.33.0-255,1514,251882,33,255808
8217,0.024628,172.31.33.0-255,1514,253396,33,255808
8218,0.024629,172.31.33.0-255,1514,254910,33,255808
8219,0.02463,172.31.33.0-255,460,255370,33,255808
8220,0.026095,104.244.42.0-255,66,255436,33,255808
8221,0.026103,104.244.42.0-255,66,255502,33,255808
8222,0.026149,104.244.42.0-255,66,255568,33,255808
8223,0.026152,104.244.42.0-255,66,255634,33,255808
8224,0.026939,104.244.42.0-255,108,255742,33,255808
8225,0.026956,172.31.33.0-255,66,255808,33,255808
8226,0.0,74.125.24.0-255,153,153,33,132098
8227,2.1e-05,172.31.33.0-255,66,219,33,132098
8228,2.8e-05,74.125.24.0-255,1484,1703,33,132098
8229,3.3e-05,172.31.33.0-255,66,1769,33,132098
8230,3.8e-05,74.125.24.0-255,2902,4671,33,132098
8231,4.2e-05,172.31.33.0-255,66,4737,33,132098
8232,4.8e-05,74.125.24.0-255,4320,9057,33,132098
8233,5.2e-05,172.31.33.0-255,66,9123,33,132098
8234,7.9e-05,74.125.24.0-255,1484,10607,33,132098
8235,8.2e-05,172.31.33.0-255,66,10673,33,132098
8236,9e-05,74.125.24.0-255,6211,16884,33,132098
8237,9.3e-05,172.31.33.0-255,66,16950,33,132098
8238,0.000121,74.125.24.0-255,7156,24106,33,132098
8239,0.000124,172.31.33.0-255,66,24172,33,132098
8240,0.000146,74.125.24.0-255,6797,30969,33,132098
8241,0.000149,172.31.33.0-255,66,31035,33,132098
8242,0.000163,74.125.24.0-255,1484,32519,33,132098
8243,0.000165,172.31.33.0-255,66,32585,33,132098
8244,0.000177,74.125.24.0-255,1484,34069,33,132098
8245,0.000179,172.31.33.0-255,66,34135,33,132098
8246,0.000202,74.125.24.0-255,1484,35619,33,132098
8247,0.000205,172.31.33.0-255,66,35685,33,132098
8248,0.000212,74.125.24.0-255,5738,41423,33,132098
8249,0.000214,172.31.33.0-255,66,41489,33,132098
8250,0.000222,74.125.24.0-255,7156,48645,33,132098
8251,0.000225,172.31.33.0-255,66,48711,33,132098
8252,0.000258,74.125.24.0-255,5738,54449,33,132098
8253,0.00026,172.31.33.0-255,66,54515,33,132098
8254,0.000272,172.31.33.0-255,66,54581,33,132098
8255,0.000275,74.125.24.0-255,1102,55683,33,132098
8256,0.000277,172.31.33.0-255,66,55749,33,132098
8257,0.000381,74.125.24.0-255,109,55858,33,132098
8258,0.000399,74.125.24.0-255,329,56187,33,132098
8259,0.000587,74.125.24.0-255,1484,57671,33,132098
8260,0.000594,172.31.33.0-255,66,57737,33,132098
8261,0.0006,74.125.24.0-255,2902,60639,33,132098
8262,0.000602,172.31.33.0-255,66,60705,33,132098
8263,0.000609,74.125.24.0-255,5738,66443,33,132098
8264,0.000611,172.31.33.0-255,66,66509,33,132098
8265,0.000644,172.31.33.0-255,66,66575,33,132098
8266,0.000652,74.125.24.0-255,5738,72313,33,132098
8267,0.000654,172.31.33.0-255,66,72379,33,132098
8268,0.000677,74.125.24.0-255,2902,75281,33,132098
8269,0.000679,172.31.33.0-255,66,75347,33,132098
8270,0.000684,74.125.24.0-255,2184,77531,33,132098
8271,0.000686,172.31.33.0-255,66,77597,33,132098
8272,0.00144,74.125.24.0-255,1484,79081,33,132098
8273,0.001444,74.125.24.0-255,1484,80565,33,132098
8274,0.001453,172.31.33.0-255,66,80631,33,132098
8275,0.00146,74.125.24.0-255,1484,82115,33,132098
8276,0.001479,74.125.24.0-255,4320,86435,33,132098
8277,0.001481,172.31.33.0-255,66,86501,33,132098
8278,0.0015,74.125.24.0-255,1484,87985,33,132098
8279,0.001513,172.31.33.0-255,66,88051,33,132098
8280,0.001531,74.125.24.0-255,1484,89535,33,132098
8281,0.001535,74.125.24.0-255,2902,92437,33,132098
8282,0.001537,172.31.33.0-255,66,92503,33,132098
8283,0.001571,74.125.24.0-255,1484,93987,33,132098
8284,0.001587,74.125.24.0-255,2902,96889,33,132098
8285,0.00159,172.31.33.0-255,66,96955,33,132098
8286,0.0016,74.125.24.0-255,2184,99139,33,132098
8287,0.001603,172.31.33.0-255,66,99205,33,132098
8288,0.001785,74.125.24.0-255,1484,100689,33,132098
8289,0.00179,74.125.24.0-255,2902,103591,33,132098
8290,0.001793,172.31.33.0-255,66,103657,33,132098
8291,0.001819,74.125.24.0-255,5738,109395,33,132098
8292,0.001821,172.31.33.0-255,66,109461,33,132098
8293,0.001826,74.125.24.0-255,4320,113781,33,132098
8294,0.001828,172.31.33.0-255,66,113847,33,132098
8295,0.001849,172.31.33.0-255,66,113913,33,132098
8296,0.001856,74.125.24.0-255,1484,115397,33,132098
8297,0.001875,172.31.33.0-255,66,115463,33,132098
8298,0.001897,74.125.24.0-255,766,116229,33,132098
8299,0.001911,172.31.33.0-255,66,116295,33,132098
8300,0.001937,172.31.33.0-255,66,116361,33,132098
8301,0.001967,172.31.33.0-255,66,116427,33,132098
8302,0.002018,172.31.33.0-255,66,116493,33,132098
8303,0.002039,74.125.24.0-255,2902,119395,33,132098
8304,0.002041,172.31.33.0-255,66,119461,33,132098
8305,0.002057,172.31.33.0-255,66,119527,33,132098
8306,0.002059,74.125.24.0-255,766,120293,33,132098
8307,0.002079,172.31.33.0-255,66,120359,33,132098
8308,0.002091,172.31.33.0-255,66,120425,33,132098
8309,0.00214,172.31.33.0-255,66,120491,33,132098
8310,0.00217,172.31.33.0-255,66,120557,33,132098
8311,0.002199,172.31.33.0-255,66,120623,33,132098
8312,0.002236,172.31.33.0-255,66,120689,33,132098
8313,0.002255,172.31.33.0-255,66,120755,33,132098
8314,0.002277,74.125.24.0-255,2184,122939,33,132098
8315,0.002279,172.31.33.0-255,66,123005,33,132098
8316,0.002295,172.31.33.0-255,66,123071,33,132098
8317,0.00232,74.125.24.0-255,4320,127391,33,132098
8318,0.002324,172.31.33.0-255,66,127457,33,132098
8319,0.002327,172.31.33.0-255,66,127523,33,132098
8320,0.002393,172.31.33.0-255,66,127589,33,132098
8321,0.004689,74.125.24.0-255,105,127694,33,132098
8322,0.00947,172.31.33.0-255,66,127760,33,132098
8323,0.009516,172.31.33.0-255,105,127865,33,132098
8324,0.011807,74.125.24.0-255,66,127931,33,132098
8325,0.025893,172.31.33.0-255,172,128103,33,132098
8326,0.025925,172.31.33.0-255,1113,129216,33,132098
8327,0.025976,172.31.33.0-255,1514,130730,33,132098
8328,0.025978,172.31.33.0-255,1170,131900,33,132098
8329,0.027422,104.244.42.0-255,66,131966,33,132098
8330,0.027447,104.244.42.0-255,66,132032,33,132098
8331,0.027518,104.244.42.0-255,66,132098,33,132098
8332,0.0,74.125.24.0-255,154,154,33,320292
8333,1.6e-05,172.31.33.0-255,66,220,33,320292
8334,2.3e-05,74.125.24.0-255,1484,1704,33,320292
8335,2.8e-05,172.31.33.0-255,66,1770,33,320292
8336,4.1e-05,74.125.24.0-255,2902,4672,33,320292
8337,4.5e-05,172.31.33.0-255,66,4738,33,320292
8338,5e-05,74.125.24.0-255,2902,7640,33,320292
8339,5.3e-05,172.31.33.0-255,66,7706,33,320292
8340,8e-05,74.125.24.0-255,4320,12026,33,320292
8341,8.4e-05,172.31.33.0-255,66,12092,33,320292
8342,9.2e-05,74.125.24.0-255,1484,13576,33,320292
8343,9.4e-05,172.31.33.0-255,66,13642,33,320292
8344,0.000122,74.125.24.0-255,3107,16749,33,320292
8345,0.000125,172.31.33.0-255,66,16815,33,320292
8346,0.000131,74.125.24.0-255,5738,22553,33,320292
8347,0.000133,172.31.33.0-255,66,22619,33,320292
8348,0.000145,172.31.33.0-255,66,22685,33,320292
8349,0.00035,74.125.24.0-255,1484,24169,33,320292
8350,0.000355,172.31.33.0-255,66,24235,33,320292
8351,0.000384,74.125.24.0-255,2902,27137,33,320292
8352,0.000387,172.31.33.0-255,66,27203,33,320292
8353,0.000434,74.125.24.0-255,2902,30105,33,320292
8354,0.000437,172.31.33.0-255,66,30171,33,320292
8355,0.000467,74.125.24.0-255,2902,33073,33,320292
8356,0.00047,172.31.33.0-255,66,33139,33,320292
8357,0.000487,172.31.33.0-255,66,33205,33,320292
8358,0.000493,74.125.24.0-255,5738,38943,33,320292
8359,0.000496,172.31.33.0-255,66,39009,33,320292
8360,0.000502,74.125.24.0-255,5020,44029,33,320292
8361,0.000505,172.31.33.0-255,66,44095,33,320292
8362,0.000911,74.125.24.0-255,398,44493,33,320292
8363,0.001013,172.31.33.0-255,66,44559,33,320292
8364,0.001104,74.125.24.0-255,111,44670,33,320292
8365,0.001143,74.125.24.0-255,1484,46154,33,320292
8366,0.001146,172.31.33.0-255,66,46220,33,320292
8367,0.001152,74.125.24.0-255,2902,49122,33,320292
8368,0.001155,172.31.33.0-255,66,49188,33,320292
8369,0.00119,74.125.24.0-255,7156,56344,33,320292
8370,0.001193,172.31.33.0-255,66,56410,33,320292
8371,0.00122,74.125.24.0-255,7156,63566,33,320292
8372,0.001222,172.31.33.0-255,66,63632,33,320292
8373,0.00127,74.125.24.0-255,2902,66534,33,320292
8374,0.001273,172.31.33.0-255,66,66600,33,320292
8375,0.001299,172.31.33.0-255,66,66666,33,320292
8376,0.001327,74.125.24.0-255,3602,70268,33,320292
8377,0.00133,172.31.33.0-255,66,70334,33,320292
8378,0.0016,74.125.24.0-255,1484,71818,33,320292
8379,0.001607,74.125.24.0-255,2902,74720,33,320292
8380,0.00161,172.31.33.0-255,66,74786,33,320292
8381,0.001614,74.125.24.0-255,1484,76270,33,320292
8382,0.00164,74.125.24.0-255,4320,80590,33,320292
8383,0.001642,172.31.33.0-255,66,80656,33,320292
8384,0.001655,74.125.24.0-255,4320,84976,33,320292
8385,0.00166,172.31.33.0-255,66,85042,33,320292
8386,0.001685,74.125.24.0-255,7156,92198,33,320292
8387,0.001687,172.31.33.0-255,66,92264,33,320292
8388,0.001713,74.125.24.0-255,5738,98002,33,320292
8389,0.001715,172.31.33.0-255,66,98068,33,320292
8390,0.001748,172.31.33.0-255,66,98134,33,320292
8391,0.001766,172.31.33.0-255,66,98200,33,320292
8392,0.001768,74.125.24.0-255,1484,99684,33,320292
8393,0.001831,74.125.24.0-255,5738,105422,33,320292
8394,0.001835,172.31.33.0-255,66,105488,33,320292
8395,0.001861,172.31.33.0-255,66,105554,33,320292
8396,0.001871,74.125.24.0-255,2902,108456,33,320292
8397,0.001873,172.31.33.0-255,66,108522,33,320292
8398,0.001896,74.125.24.0-255,7156,115678,33,320292
8399,0.001898,172.31.33.0-255,66,115744,33,320292
8400,0.00191,172.31.33.0-255,66,115810,33,320292
8401,0.001955,172.31.33.0-255,66,115876,33,320292
8402,0.001957,74.125.24.0-255,766,116642,33,320292
8403,0.004105,74.125.24.0-255,4320,120962,33,320292
8404,0.004109,172.31.33.0-255,66,121028,33,320292
8405,0.006277,74.125.24.0-255,4320,125348,33,320292
8406,0.006282,172.31.33.0-255,66,125414,33,320292
8407,0.006305,74.125.24.0-255,1484,126898,33,320292
8408,0.008476,74.125.24.0-255,4320,131218,33,320292
8409,0.008482,172.31.33.0-255,66,131284,33,320292
8410,0.010722,74.125.24.0-255,5738,137022,33,320292
8411,0.010731,172.31.33.0-255,66,137088,33,320292
8412,0.01289,74.125.24.0-255,5738,142826,33,320292
8413,0.012898,172.31.33.0-255,66,142892,33,320292
8414,0.015079,74.125.24.0-255,5738,148630,33,320292
8415,0.015086,172.31.33.0-255,66,148696,33,320292
8416,0.017223,74.125.24.0-255,1484,150180,33,320292
8417,0.017243,74.125.24.0-255,4320,154500,33,320292
8418,0.017247,172.31.33.0-255,66,154566,33,320292
8419,0.019432,74.125.24.0-255,5738,160304,33,320292
8420,0.019439,172.31.33.0-255,66,160370,33,320292
8421,0.021584,74.125.24.0-255,5738,166108,33,320292
8422,0.02159,172.31.33.0-255,66,166174,33,320292
8423,0.022913,172.31.33.0-255,172,166346,33,320292
8424,0.022941,172.31.33.0-255,1118,167464,33,320292
8425,0.022996,172.31.33.0-255,1514,168978,33,320292
8426,0.022997,172.31.33.0-255,1279,170257,33,320292
8427,0.023727,74.125.24.0-255,5738,175995,33,320292
8428,0.023733,172.31.33.0-255,66,176061,33,320292
8429,0.024595,104.244.42.0-255,66,176127,33,320292
8430,0.024651,104.244.42.0-255,66,176193,33,320292
8431,0.024744,104.244.42.0-255,66,176259,33,320292
8432,0.025851,74.125.24.0-255,5738,181997,33,320292
8433,0.025857,172.31.33.0-255,66,182063,33,320292
8434,0.028001,74.125.24.0-255,5738,187801,33,320292
8435,0.028008,172.31.33.0-255,66,187867,33,320292
8436,0.030178,74.125.24.0-255,4320,192187,33,320292
8437,0.030185,172.31.33.0-255,66,192253,33,320292
8438,0.030209,74.125.24.0-255,1484,193737,33,320292
8439,0.032348,74.125.24.0-255,4320,198057,33,320292
8440,0.032355,172.31.33.0-255,66,198123,33,320292
8441,0.034521,74.125.24.0-255,5738,203861,33,320292
8442,0.034528,172.31.33.0-255,66,203927,33,320292
8443,0.036653,74.125.24.0-255,5738,209665,33,320292
8444,0.036659,172.31.33.0-255,66,209731,33,320292
8445,0.0388,74.125.24.0-255,5738,215469,33,320292
8446,0.038805,172.31.33.0-255,66,215535,33,320292
8447,0.040987,74.125.24.0-255,5738,221273,33,320292
8448,0.040994,172.31.33.0-255,66,221339,33,320292
8449,0.043153,74.125.24.0-255,5738,227077,33,320292
8450,0.043159,172.31.33.0-255,66,227143,33,320292
8451,0.045342,74.125.24.0-255,5738,232881,33,320292
8452,0.045347,172.31.33.0-255,66,232947,33,320292
8453,0.047541,74.125.24.0-255,5738,238685,33,320292
8454,0.047547,172.31.33.0-255,66,238751,33,320292
8455,0.049676,74.125.24.0-255,5738,244489,33,320292
8456,0.049683,172.31.33.0-255,66,244555,33,320292
8457,0.051847,74.125.24.0-255,5738,250293,33,320292
8458,0.051852,172.31.33.0-255,66,250359,33,320292
8459,0.054011,74.125.24.0-255,5738,256097,33,320292
8460,0.054019,172.31.33.0-255,66,256163,33,320292
8461,0.056183,74.125.24.0-255,5738,261901,33,320292
8462,0.056189,172.31.33.0-255,66,261967,33,320292
8463,0.058329,74.125.24.0-255,5738,267705,33,320292
8464,0.058335,172.31.33.0-255,66,267771,33,320292
8465,0.060484,74.125.24.0-255,4320,272091,33,320292
8466,0.06049,172.31.33.0-255,66,272157,33,320292
8467,0.060515,74.125.24.0-255,1484,273641,33,320292
8468,0.062613,74.125.24.0-255,1484,275125,33,320292
8469,0.062618,172.31.33.0-255,66,275191,33,320292
8470,0.062643,74.125.24.0-255,2902,278093,33,320292
8471,0.062645,172.31.33.0-255,66,278159,33,320292
8472,0.064781,74.125.24.0-255,5738,283897,33,320292
8473,0.064786,172.31.33.0-255,66,283963,33,320292
8474,0.066926,74.125.24.0-255,5738,289701,33,320292
8475,0.066931,172.31.33.0-255,66,289767,33,320292
8476,0.069107,74.125.24.0-255,4320,294087,33,320292
8477,0.069113,172.31.33.0-255,66,294153,33,320292
8478,0.06914,74.125.24.0-255,1484,295637,33,320292
8479,0.071291,74.125.24.0-255,4320,299957,33,320292
8480,0.071296,172.31.33.0-255,66,300023,33,320292
8481,0.073503,74.125.24.0-255,5738,305761,33,320292
8482,0.073509,172.31.33.0-255,66,305827,33,320292
8483,0.075652,74.125.24.0-255,5738,311565,33,320292
8484,0.075658,172.31.33.0-255,66,311631,33,320292
8485,0.077803,74.125.24.0-255,5738,317369,33,320292
8486,0.077808,172.31.33.0-255,66,317435,33,320292
8487,0.079946,74.125.24.0-255,2791,320226,33,320292
8488,0.079952,172.31.33.0-255,66,320292,33,320292
8489,0.0,172.31.33.0-255,105,105,33,1194
8490,0.001764,157.240.7.0-255,105,210,33,1194
8491,0.001775,172.31.33.0-255,66,276,33,1194
8492,0.006759,172.31.33.0-255,105,381,33,1194
8493,0.006805,172.31.33.0-255,105,486,33,1194
8494,0.007005,172.31.33.0-255,90,576,33,1194
8495,0.007013,172.31.33.0-255,66,642,33,1194
8496,0.007166,172.31.33.0-255,90,732,33,1194
8497,0.007172,172.31.33.0-255,66,798,33,1194
8498,0.009514,172.217.194.0-255,66,864,33,1194
8499,0.009536,172.217.194.0-255,66,930,33,1194
8500,0.009554,172.31.33.0-255,66,996,33,1194
8501,0.009583,74.125.24.0-255,66,1062,33,1194
8502,0.009596,74.125.24.0-255,66,1128,33,1194
8503,0.009607,172.31.33.0-255,66,1194,33,1194
8504,0.0,74.125.68.0-255,156,156,33,332581
8505,2.2e-05,172.31.33.0-255,66,222,33,332581
8506,6.3e-05,74.125.68.0-255,1484,1706,33,332581
8507,7.8e-05,172.31.33.0-255,66,1772,33,332581
8508,8.4e-05,74.125.68.0-255,2902,4674,33,332581
8509,8.8e-05,172.31.33.0-255,66,4740,33,332581
8510,9.7e-05,74.125.68.0-255,4320,9060,33,332581
8511,0.0001,172.31.33.0-255,66,9126,33,332581
8512,0.000142,74.125.68.0-255,2902,12028,33,332581
8513,0.000145,172.31.33.0-255,66,12094,33,332581
8514,0.000174,74.125.68.0-255,2018,14112,33,332581
8515,0.000176,172.31.33.0-255,66,14178,33,332581
8516,0.000182,74.125.68.0-255,5738,19916,33,332581
8517,0.000184,172.31.33.0-255,66,19982,33,332581
8518,0.000189,74.125.68.0-255,4320,24302,33,332581
8519,0.000191,172.31.33.0-255,66,24368,33,332581
8520,0.000227,74.125.68.0-255,6797,31165,33,332581
8521,0.00023,172.31.33.0-255,66,31231,33,332581
8522,0.000275,74.125.68.0-255,1484,32715,33,332581
8523,0.000278,172.31.33.0-255,66,32781,33,332581
8524,0.000283,74.125.68.0-255,2902,35683,33,332581
8525,0.000286,172.31.33.0-255,66,35749,33,332581
8526,0.000316,74.125.68.0-255,5738,41487,33,332581
8527,0.000318,172.31.33.0-255,66,41553,33,332581
8528,0.000338,74.125.68.0-255,1484,43037,33,332581
8529,0.00034,172.31.33.0-255,66,43103,33,332581
8530,0.000376,172.31.33.0-255,66,43169,33,332581
8531,0.000415,74.125.68.0-255,7156,50325,33,332581
8532,0.000417,172.31.33.0-255,66,50391,33,332581
8533,0.000439,74.125.68.0-255,5020,55411,33,332581
8534,0.000442,172.31.33.0-255,66,55477,33,332581
8535,0.000444,74.125.68.0-255,361,55838,33,332581
8536,0.000481,74.125.68.0-255,381,56219,33,332581
8537,0.00074,74.125.68.0-255,1484,57703,33,332581
8538,0.000745,172.31.33.0-255,66,57769,33,332581
8539,0.000773,74.125.68.0-255,2902,60671,33,332581
8540,0.000775,172.31.33.0-255,66,60737,33,332581
8541,0.000781,74.125.68.0-255,5738,66475,33,332581
8542,0.000783,172.31.33.0-255,66,66541,33,332581
8543,0.000785,74.125.68.0-255,1484,68025,33,332581
8544,0.000811,74.125.68.0-255,5738,73763,33,332581
8545,0.000813,172.31.33.0-255,66,73829,33,332581
8546,0.000825,74.125.68.0-255,1484,75313,33,332581
8547,0.000846,74.125.68.0-255,7156,82469,33,332581
8548,0.000848,172.31.33.0-255,66,82535,33,332581
8549,0.000854,74.125.68.0-255,5738,88273,33,332581
8550,0.000856,172.31.33.0-255,66,88339,33,332581
8551,0.000892,74.125.68.0-255,2184,90523,33,332581
8552,0.000895,172.31.33.0-255,66,90589,33,332581
8553,0.000918,74.125.68.0-255,1484,92073,33,332581
8554,0.00093,74.125.68.0-255,1484,93557,33,332581
8555,0.000933,172.31.33.0-255,66,93623,33,332581
8556,0.000955,74.125.68.0-255,2902,96525,33,332581
8557,0.000958,172.31.33.0-255,66,96591,33,332581
8558,0.000989,74.125.68.0-255,4320,100911,33,332581
8559,0.000992,172.31.33.0-255,66,100977,33,332581
8560,0.000998,74.125.68.0-255,5738,106715,33,332581
8561,0.001,172.31.33.0-255,66,106781,33,332581
8562,0.001015,74.125.68.0-255,1484,108265,33,332581
8563,0.00104,172.31.33.0-255,66,108331,33,332581
8564,0.001042,74.125.68.0-255,1484,109815,33,332581
8565,0.001079,74.125.68.0-255,5738,115553,33,332581
8566,0.001082,172.31.33.0-255,66,115619,33,332581
8567,0.001092,172.31.33.0-255,66,115685,33,332581
8568,0.001095,74.125.68.0-255,1484,117169,33,332581
8569,0.001108,74.125.68.0-255,1484,118653,33,332581
8570,0.00111,172.31.33.0-255,66,118719,33,332581
8571,0.001115,74.125.68.0-255,4320,123039,33,332581
8572,0.001118,172.31.33.0-255,66,123105,33,332581
8573,0.00116,172.31.33.0-255,66,123171,33,332581
8574,0.001166,74.125.68.0-255,5738,128909,33,332581
8575,0.001168,172.31.33.0-255,66,128975,33,332581
8576,0.001199,74.125.68.0-255,1484,130459,33,332581
8577,0.001218,74.125.68.0-255,3602,134061,33,332581
8578,0.001221,172.31.33.0-255,66,134127,33,332581
8579,0.001329,74.125.68.0-255,1484,135611,33,332581
8580,0.001349,74.125.68.0-255,2902,138513,33,332581
8581,0.001351,172.31.33.0-255,66,138579,33,332581
8582,0.001357,74.125.68.0-255,2902,141481,33,332581
8583,0.001359,172.31.33.0-255,66,141547,33,332581
8584,0.001387,74.125.68.0-255,1484,143031,33,332581
8585,0.001399,172.31.33.0-255,66,143097,33,332581
8586,0.001404,74.125.68.0-255,4320,147417,33,332581
8587,0.001406,172.31.33.0-255,66,147483,33,332581
8588,0.001425,74.125.68.0-255,2902,150385,33,332581
8589,0.001427,172.31.33.0-255,66,150451,33,332581
8590,0.001442,172.31.33.0-255,66,150517,33,332581
8591,0.001445,74.125.68.0-255,766,151283,33,332581
8592,0.001786,74.125.68.0-255,1484,152767,33,332581
8593,0.001792,172.31.33.0-255,66,152833,33,332581
8594,0.001797,74.125.68.0-255,2902,155735,33,332581
8595,0.0018,172.31.33.0-255,66,155801,33,332581
8596,0.001803,74.125.68.0-255,1484,157285,33,332581
8597,0.001833,74.125.68.0-255,5738,163023,33,332581
8598,0.001835,172.31.33.0-255,66,163089,33,332581
8599,0.001877,172.31.33.0-255,66,163155,33,332581
8600,0.001901,74.125.68.0-255,1484,164639,33,332581
8601,0.001913,172.31.33.0-255,66,164705,33,332581
8602,0.001916,74.125.68.0-255,766,165471,33,332581
8603,0.002019,74.125.68.0-255,1484,166955,33,332581
8604,0.002025,172.31.33.0-255,66,167021,33,332581
8605,0.002054,74.125.68.0-255,2902,169923,33,332581
8606,0.002057,172.31.33.0-255,66,169989,33,332581
8607,0.002063,74.125.68.0-255,5738,175727,33,332581
8608,0.002066,172.31.33.0-255,66,175793,33,332581
8609,0.00207,74.125.68.0-255,2902,178695,33,332581
8610,0.002072,172.31.33.0-255,66,178761,33,332581
8611,0.002087,74.125.68.0-255,4320,183081,33,332581
8612,0.00209,172.31.33.0-255,66,183147,33,332581
8613,0.002168,172.31.33.0-255,66,183213,33,332581
8614,0.002173,74.125.68.0-255,2902,186115,33,332581
8615,0.002175,172.31.33.0-255,66,186181,33,332581
8616,0.002181,74.125.68.0-255,4320,190501,33,332581
8617,0.002188,172.31.33.0-255,66,190567,33,332581
8618,0.002195,74.125.68.0-255,6438,197005,33,332581
8619,0.002197,172.31.33.0-255,66,197071,33,332581
8620,0.002201,74.125.68.0-255,2902,199973,33,332581
8621,0.002205,172.31.33.0-255,66,200039,33,332581
8622,0.002232,74.125.68.0-255,4320,204359,33,332581
8623,0.002235,172.31.33.0-255,66,204425,33,332581
8624,0.002242,74.125.68.0-255,1484,205909,33,332581
8625,0.002247,74.125.68.0-255,2902,208811,33,332581
8626,0.002248,172.31.33.0-255,66,208877,33,332581
8627,0.002255,74.125.68.0-255,5738,214615,33,332581
8628,0.002257,172.31.33.0-255,66,214681,33,332581
8629,0.002285,74.125.68.0-255,7156,221837,33,332581
8630,0.002288,172.31.33.0-255,66,221903,33,332581
8631,0.002315,74.125.68.0-255,1484,223387,33,332581
8632,0.002319,74.125.68.0-255,2184,225571,33,332581
8633,0.002322,172.31.33.0-255,66,225637,33,332581
8634,0.002341,74.125.68.0-255,4320,229957,33,332581
8635,0.002343,172.31.33.0-255,66,230023,33,332581
8636,0.002368,74.125.68.0-255,2902,232925,33,332581
8637,0.002371,172.31.33.0-255,66,232991,33,332581
8638,0.004603,74.125.68.0-255,2902,235893,33,332581
8639,0.004611,172.31.33.0-255,66,235959,33,332581
8640,0.004636,74.125.68.0-255,2902,238861,33,332581
8641,0.004638,172.31.33.0-255,66,238927,33,332581
8642,0.006862,74.125.68.0-255,2902,241829,33,332581
8643,0.006866,172.31.33.0-255,66,241895,33,332581
8644,0.006889,74.125.68.0-255,2902,244797,33,332581
8645,0.006891,172.31.33.0-255,66,244863,33,332581
8646,0.009124,74.125.68.0-255,2902,247765,33,332581
8647,0.00913,172.31.33.0-255,66,247831,33,332581
8648,0.009159,74.125.68.0-255,2902,250733,33,332581
8649,0.009162,172.31.33.0-255,66,250799,33,332581
8650,0.0114,74.125.68.0-255,2902,253701,33,332581
8651,0.011409,172.31.33.0-255,66,253767,33,332581
8652,0.011444,74.125.68.0-255,2902,256669,33,332581
8653,0.011446,172.31.33.0-255,66,256735,33,332581
8654,0.013723,74.125.68.0-255,2902,259637,33,332581
8655,0.01373,172.31.33.0-255,66,259703,33,332581
8656,0.013767,74.125.68.0-255,1484,261187,33,332581
8657,0.013778,74.125.68.0-255,1484,262671,33,332581
8658,0.01378,172.31.33.0-255,66,262737,33,332581
8659,0.01604,74.125.68.0-255,5738,268475,33,332581
8660,0.016047,172.31.33.0-255,66,268541,33,332581
8661,0.018322,74.125.68.0-255,5738,274279,33,332581
8662,0.018329,172.31.33.0-255,66,274345,33,332581
8663,0.020608,74.125.68.0-255,5738,280083,33,332581
8664,0.020614,172.31.33.0-255,66,280149,33,332581
8665,0.022889,74.125.68.0-255,5738,285887,33,332581
8666,0.022897,172.31.33.0-255,66,285953,33,332581
8667,0.02396,172.31.33.0-255,167,286120,33,332581
8668,0.023993,172.31.33.0-255,1113,287233,33,332581
8669,0.024053,172.31.33.0-255,1514,288747,33,332581
8670,0.024055,172.31.33.0-255,1171,289918,33,332581
8671,0.025175,74.125.68.0-255,5738,295656,33,332581
8672,0.025181,172.31.33.0-255,66,295722,33,332581
8673,0.025487,104.244.42.0-255,66,295788,33,332581
8674,0.025563,104.244.42.0-255,66,295854,33,332581
8675,0.025611,104.244.42.0-255,66,295920,33,332581
8676,0.027462,74.125.68.0-255,5738,301658,33,332581
8677,0.027472,172.31.33.0-255,66,301724,33,332581
8678,0.029741,74.125.68.0-255,5738,307462,33,332581
8679,0.029747,172.31.33.0-255,66,307528,33,332581
8680,0.032021,74.125.68.0-255,5738,313266,33,332581
8681,0.032028,172.31.33.0-255,66,313332,33,332581
8682,0.034298,74.125.68.0-255,5738,319070,33,332581
8683,0.034305,172.31.33.0-255,66,319136,33,332581
8684,0.036568,74.125.68.0-255,5738,324874,33,332581
8685,0.036573,172.31.33.0-255,66,324940,33,332581
8686,0.038847,74.125.68.0-255,5738,330678,33,332581
8687,0.038852,172.31.33.0-255,66,330744,33,332581
8688,0.041155,74.125.68.0-255,1600,332344,33,332581
8689,0.041164,172.31.33.0-255,66,332410,33,332581
8690,0.041362,172.31.33.0-255,105,332515,33,332581
8691,0.043595,74.125.68.0-255,66,332581,33,332581
8692,0.0,172.31.33.0-255,105,105,33,459
8693,0.000181,172.31.33.0-255,90,195,33,459
8694,0.000189,172.31.33.0-255,66,261,33,459
8695,0.002576,74.125.24.0-255,66,327,33,459
8696,0.002587,74.125.24.0-255,66,393,33,459
8697,0.002594,172.31.33.0-255,66,459,33,459
8698,0.0,172.217.194.0-255,148,148,33,160883
8699,2.6e-05,172.31.33.0-255,66,214,33,160883
8700,3.3e-05,172.217.194.0-255,1484,1698,33,160883
8701,3.7e-05,172.31.33.0-255,66,1764,33,160883
8702,4.2e-05,172.217.194.0-255,2902,4666,33,160883
8703,4.4e-05,172.31.33.0-255,66,4732,33,160883
8704,4.7e-05,172.217.194.0-255,1484,6216,33,160883
8705,5e-05,172.31.33.0-255,66,6282,33,160883
8706,7.4e-05,172.217.194.0-255,5738,12020,33,160883
8707,7.6e-05,172.31.33.0-255,66,12086,33,160883
8708,8e-05,172.217.194.0-255,2020,14106,33,160883
8709,8.2e-05,172.31.33.0-255,66,14172,33,160883
8710,0.000135,172.217.194.0-255,1484,15656,33,160883
8711,0.000139,172.31.33.0-255,66,15722,33,160883
8712,0.000145,172.217.194.0-255,2902,18624,33,160883
8713,0.000147,172.31.33.0-255,66,18690,33,160883
8714,0.000171,172.217.194.0-255,5738,24428,33,160883
8715,0.000174,172.31.33.0-255,66,24494,33,160883
8716,0.000178,172.217.194.0-255,4320,28814,33,160883
8717,0.00018,172.31.33.0-255,66,28880,33,160883
8718,0.000222,172.217.194.0-255,2543,31423,33,160883
8719,0.000225,172.31.33.0-255,66,31489,33,160883
8720,0.000336,172.217.194.0-255,1484,32973,33,160883
8721,0.000339,172.31.33.0-255,66,33039,33,160883
8722,0.000345,172.217.194.0-255,2902,35941,33,160883
8723,0.000348,172.31.33.0-255,66,36007,33,160883
8724,0.000354,172.217.194.0-255,5738,41745,33,160883
8725,0.000357,172.31.33.0-255,66,41811,33,160883
8726,0.000373,172.217.194.0-255,1484,43295,33,160883
8727,0.000377,172.31.33.0-255,66,43361,33,160883
8728,0.000411,172.31.33.0-255,66,43427,33,160883
8729,0.000414,172.217.194.0-255,1484,44911,33,160883
8730,0.000429,172.217.194.0-255,1484,46395,33,160883
8731,0.000431,172.31.33.0-255,66,46461,33,160883
8732,0.000455,172.217.194.0-255,7107,53568,33,160883
8733,0.000458,172.31.33.0-255,66,53634,33,160883
8734,0.000523,172.217.194.0-255,366,54000,33,160883
8735,0.000642,172.217.194.0-255,1484,55484,33,160883
8736,0.000646,172.31.33.0-255,66,55550,33,160883
8737,0.000651,172.217.194.0-255,2902,58452,33,160883
8738,0.000654,172.31.33.0-255,66,58518,33,160883
8739,0.000658,172.217.194.0-255,2902,61420,33,160883
8740,0.00066,172.31.33.0-255,66,61486,33,160883
8741,0.000678,172.217.194.0-255,2902,64388,33,160883
8742,0.000681,172.31.33.0-255,66,64454,33,160883
8743,0.000695,172.31.33.0-255,66,64520,33,160883
8744,0.000705,172.31.33.0-255,66,64586,33,160883
8745,0.001215,172.217.194.0-255,1484,66070,33,160883
8746,0.001225,172.217.194.0-255,2902,68972,33,160883
8747,0.001229,172.31.33.0-255,66,69038,33,160883
8748,0.001237,172.217.194.0-255,5738,74776,33,160883
8749,0.001239,172.31.33.0-255,66,74842,33,160883
8750,0.001257,172.217.194.0-255,7156,81998,33,160883
8751,0.00126,172.31.33.0-255,66,82064,33,160883
8752,0.001295,172.217.194.0-255,4320,86384,33,160883
8753,0.001299,172.31.33.0-255,66,86450,33,160883
8754,0.001323,172.31.33.0-255,66,86516,33,160883
8755,0.001327,172.217.194.0-255,2184,88700,33,160883
8756,0.001329,172.31.33.0-255,66,88766,33,160883
8757,0.001621,172.217.194.0-255,1484,90250,33,160883
8758,0.001629,172.217.194.0-255,2902,93152,33,160883
8759,0.001633,172.31.33.0-255,66,93218,33,160883
8760,0.001642,172.217.194.0-255,5738,98956,33,160883
8761,0.001645,172.31.33.0-255,66,99022,33,160883
8762,0.001648,172.217.194.0-255,1484,100506,33,160883
8763,0.001674,172.31.33.0-255,66,100572,33,160883
8764,0.001718,172.31.33.0-255,66,100638,33,160883
8765,0.001741,172.31.33.0-255,66,100704,33,160883
8766,0.001751,172.31.33.0-255,66,100770,33,160883
8767,0.001773,172.217.194.0-255,5738,106508,33,160883
8768,0.001775,172.31.33.0-255,66,106574,33,160883
8769,0.001787,172.31.33.0-255,66,106640,33,160883
8770,0.001853,172.31.33.0-255,66,106706,33,160883
8771,0.001866,172.31.33.0-255,66,106772,33,160883
8772,0.001898,172.31.33.0-255,66,106838,33,160883
8773,0.001901,172.217.194.0-255,1484,108322,33,160883
8774,0.001927,172.31.33.0-255,66,108388,33,160883
8775,0.001936,172.217.194.0-255,4320,112708,33,160883
8776,0.001938,172.31.33.0-255,66,112774,33,160883
8777,0.001959,172.31.33.0-255,66,112840,33,160883
8778,0.001972,172.31.33.0-255,66,112906,33,160883
8779,0.001999,172.217.194.0-255,7156,120062,33,160883
8780,0.002002,172.31.33.0-255,66,120128,33,160883
8781,0.002012,172.31.33.0-255,66,120194,33,160883
8782,0.002034,172.217.194.0-255,5738,125932,33,160883
8783,0.002036,172.31.33.0-255,66,125998,33,160883
8784,0.002061,172.31.33.0-255,66,126064,33,160883
8785,0.002074,172.217.194.0-255,3602,129666,33,160883
8786,0.002077,172.31.33.0-255,66,129732,33,160883
8787,0.002096,172.217.194.0-255,2902,132634,33,160883
8788,0.002099,172.31.33.0-255,66,132700,33,160883
8789,0.002122,172.31.33.0-255,66,132766,33,160883
8790,0.002141,172.217.194.0-255,7156,139922,33,160883
8791,0.002143,172.31.33.0-255,66,139988,33,160883
8792,0.002165,172.217.194.0-255,3602,143590,33,160883
8793,0.002167,172.31.33.0-255,66,143656,33,160883
8794,0.002177,172.217.194.0-255,1484,145140,33,160883
8795,0.002196,172.217.194.0-255,5738,150878,33,160883
8796,0.002198,172.31.33.0-255,66,150944,33,160883
8797,0.002235,172.217.194.0-255,4320,155264,33,160883
8798,0.002284,172.217.194.0-255,105,155369,33,160883
8799,0.006532,172.31.33.0-255,66,155435,33,160883
8800,0.008815,172.31.33.0-255,105,155540,33,160883
8801,0.01113,172.217.194.0-255,66,155606,33,160883
8802,0.031561,172.31.33.0-255,192,155798,33,160883
8803,0.03159,172.31.33.0-255,1117,156915,33,160883
8804,0.031621,172.31.33.0-255,1514,158429,33,160883
8805,0.031622,172.31.33.0-255,1514,159943,33,160883
8806,0.031642,172.31.33.0-255,676,160619,33,160883
8807,0.033139,104.244.42.0-255,66,160685,33,160883
8808,0.033176,104.244.42.0-255,66,160751,33,160883
8809,0.033225,104.244.42.0-255,66,160817,33,160883
8810,0.033229,104.244.42.0-255,66,160883,33,160883
8811,0.0,172.31.33.0-255,105,105,33,459
8812,0.000484,172.31.33.0-255,90,195,33,459
8813,0.000496,172.31.33.0-255,66,261,33,459
8814,0.002743,74.125.24.0-255,66,327,33,459
8815,0.002773,74.125.24.0-255,66,393,33,459
8816,0.002797,172.31.33.0-255,66,459,33,459
8817,0.0,74.125.24.0-255,153,153,33,328013
8818,1.5e-05,172.31.33.0-255,66,219,33,328013
8819,2.1e-05,74.125.24.0-255,1484,1703,33,328013
8820,2.5e-05,172.31.33.0-255,66,1769,33,328013
8821,2.8e-05,74.125.24.0-255,1484,3253,33,328013
8822,3.8e-05,172.31.33.0-255,66,3319,33,328013
8823,4.6e-05,74.125.24.0-255,4320,7639,33,328013
8824,4.8e-05,172.31.33.0-255,66,7705,33,328013
8825,8.1e-05,74.125.24.0-255,4320,12025,33,328013
8826,8.5e-05,172.31.33.0-255,66,12091,33,328013
8827,0.000111,74.125.24.0-255,6283,18374,33,328013
8828,0.000114,172.31.33.0-255,66,18440,33,328013
8829,0.000121,74.125.24.0-255,7156,25596,33,328013
8830,0.000123,172.31.33.0-255,66,25662,33,328013
8831,0.000157,74.125.24.0-255,5379,31041,33,328013
8832,0.00016,172.31.33.0-255,66,31107,33,328013
8833,0.000859,74.125.24.0-255,1484,32591,33,328013
8834,0.000865,172.31.33.0-255,66,32657,33,328013
8835,0.000874,74.125.24.0-255,2902,35559,33,328013
8836,0.000877,172.31.33.0-255,66,35625,33,328013
8837,0.000889,74.125.24.0-255,5738,41363,33,328013
8838,0.000892,172.31.33.0-255,66,41429,33,328013
8839,0.000943,172.31.33.0-255,66,41495,33,328013
8840,0.000951,74.125.24.0-255,7156,48651,33,328013
8841,0.000952,172.31.33.0-255,66,48717,33,328013
8842,0.000969,74.125.24.0-255,2543,51260,33,328013
8843,0.000975,172.31.33.0-255,66,51326,33,328013
8844,0.000994,74.125.24.0-255,1484,52810,33,328013
8845,0.000996,172.31.33.0-255,66,52876,33,328013
8846,0.001026,74.125.24.0-255,2902,55778,33,328013
8847,0.001029,172.31.33.0-255,66,55844,33,328013
8848,0.001036,74.125.24.0-255,5738,61582,33,328013
8849,0.001038,172.31.33.0-255,66,61648,33,328013
8850,0.001066,74.125.24.0-255,4320,65968,33,328013
8851,0.001068,172.31.33.0-255,66,66034,33,328013
8852,0.001107,172.31.33.0-255,66,66100,33,328013
8853,0.001122,172.31.33.0-255,66,66166,33,328013
8854,0.001125,74.125.24.0-255,1484,67650,33,328013
8855,0.00117,74.125.24.0-255,2902,70552,33,328013
8856,0.001226,74.125.24.0-255,1825,72377,33,328013
8857,0.001274,74.125.24.0-255,1484,73861,33,328013
8858,0.001278,74.125.24.0-255,1484,75345,33,328013
8859,0.001291,74.125.24.0-255,1484,76829,33,328013
8860,0.001296,74.125.24.0-255,2902,79731,33,328013
8861,0.001313,74.125.24.0-255,2902,82633,33,328013
8862,0.001317,74.125.24.0-255,4320,86953,33,328013
8863,0.001345,74.125.24.0-255,4320,91273,33,328013
8864,0.001356,74.125.24.0-255,1484,92757,33,328013
8865,0.001368,74.125.24.0-255,2902,95659,33,328013
8866,0.001371,74.125.24.0-255,2184,97843,33,328013
8867,0.001466,74.125.24.0-255,1484,99327,33,328013
8868,0.001473,74.125.24.0-255,2902,102229,33,328013
8869,0.001486,74.125.24.0-255,4320,106549,33,328013
8870,0.001496,74.125.24.0-255,1484,108033,33,328013
8871,0.001513,74.125.24.0-255,4320,112353,33,328013
8872,0.001527,74.125.24.0-255,4320,116673,33,328013
8873,0.001539,74.125.24.0-255,4320,120993,33,328013
8874,0.001547,74.125.24.0-255,7156,128149,33,328013
8875,0.001562,74.125.24.0-255,3602,131751,33,328013
8876,0.002093,172.31.33.0-255,66,131817,33,328013
8877,0.004412,74.125.24.0-255,5738,137555,33,328013
8878,0.004418,172.31.33.0-255,66,137621,33,328013
8879,0.006775,74.125.24.0-255,5738,143359,33,328013
8880,0.00678,172.31.33.0-255,66,143425,33,328013
8881,0.009126,74.125.24.0-255,5738,149163,33,328013
8882,0.009135,172.31.33.0-255,66,149229,33,328013
8883,0.011494,74.125.24.0-255,5738,154967,33,328013
8884,0.011503,172.31.33.0-255,66,155033,33,328013
8885,0.013849,74.125.24.0-255,5738,160771,33,328013
8886,0.013861,172.31.33.0-255,66,160837,33,328013
8887,0.0162,74.125.24.0-255,5738,166575,33,328013
8888,0.016212,172.31.33.0-255,66,166641,33,328013
8889,0.018532,74.125.24.0-255,2902,169543,33,328013
8890,0.018539,172.31.33.0-255,66,169609,33,328013
8891,0.018571,74.125.24.0-255,2902,172511,33,328013
8892,0.018592,172.31.33.0-255,66,172577,33,328013
8893,0.020879,74.125.24.0-255,2902,175479,33,328013
8894,0.020887,172.31.33.0-255,66,175545,33,328013
8895,0.020919,74.125.24.0-255,2902,178447,33,328013
8896,0.020951,172.31.33.0-255,66,178513,33,328013
8897,0.023223,74.125.24.0-255,2902,181415,33,328013
8898,0.023229,172.31.33.0-255,66,181481,33,328013
8899,0.023284,74.125.24.0-255,2902,184383,33,328013
8900,0.023304,172.31.33.0-255,66,184449,33,328013
8901,0.025578,74.125.24.0-255,2902,187351,33,328013
8902,0.025586,172.31.33.0-255,66,187417,33,328013
8903,0.025627,74.125.24.0-255,2902,190319,33,328013
8904,0.025656,172.31.33.0-255,66,190385,33,328013
8905,0.027929,74.125.24.0-255,2902,193287,33,328013
8906,0.027936,172.31.33.0-255,66,193353,33,328013
8907,0.027969,74.125.24.0-255,2902,196255,33,328013
8908,0.027983,172.31.33.0-255,66,196321,33,328013
8909,0.028313,172.31.33.0-255,171,196492,33,328013
8910,0.028342,172.31.33.0-255,1141,197633,33,328013
8911,0.028398,172.31.33.0-255,1514,199147,33,328013
8912,0.0284,172.31.33.0-255,1514,200661,33,328013
8913,0.028423,172.31.33.0-255,652,201313,33,328013
8914,0.029894,104.244.42.0-255,66,201379,33,328013
8915,0.029921,104.244.42.0-255,66,201445,33,328013
8916,0.029981,104.244.42.0-255,66,201511,33,328013
8917,0.029993,104.244.42.0-255,66,201577,33,328013
8918,0.030289,74.125.24.0-255,5738,207315,33,328013
8919,0.030335,172.31.33.0-255,66,207381,33,328013
8920,0.032666,74.125.24.0-255,5738,213119,33,328013
8921,0.032674,172.31.33.0-255,66,213185,33,328013
8922,0.035022,74.125.24.0-255,5738,218923,33,328013
8923,0.035027,172.31.33.0-255,66,218989,33,328013
8924,0.037343,74.125.24.0-255,5738,224727,33,328013
8925,0.037348,172.31.33.0-255,66,224793,33,328013
8926,0.039683,74.125.24.0-255,5738,230531,33,328013
8927,0.039688,172.31.33.0-255,66,230597,33,328013
8928,0.042025,74.125.24.0-255,5738,236335,33,328013
8929,0.04203,172.31.33.0-255,66,236401,33,328013
8930,0.044345,74.125.24.0-255,5738,242139,33,328013
8931,0.044353,172.31.33.0-255,66,242205,33,328013
8932,0.046672,74.125.24.0-255,4320,246525,33,328013
8933,0.046676,172.31.33.0-255,66,246591,33,328013
8934,0.046706,74.125.24.0-255,1484,248075,33,328013
8935,0.049007,74.125.24.0-255,4320,252395,33,328013
8936,0.049012,172.31.33.0-255,66,252461,33,328013
8937,0.051324,74.125.24.0-255,4320,256781,33,328013
8938,0.05133,172.31.33.0-255,66,256847,33,328013
8939,0.051359,74.125.24.0-255,1484,258331,33,328013
8940,0.053647,74.125.24.0-255,4320,262651,33,328013
8941,0.053652,172.31.33.0-255,66,262717,33,328013
8942,0.055968,74.125.24.0-255,2902,265619,33,328013
8943,0.055972,172.31.33.0-255,66,265685,33,328013
8944,0.056003,74.125.24.0-255,2902,268587,33,328013
8945,0.056015,172.31.33.0-255,66,268653,33,328013
8946,0.058294,74.125.24.0-255,2902,271555,33,328013
8947,0.058298,172.31.33.0-255,66,271621,33,328013
8948,0.058326,74.125.24.0-255,2902,274523,33,328013
8949,0.058343,172.31.33.0-255,66,274589,33,328013
8950,0.06064,74.125.24.0-255,2902,277491,33,328013
8951,0.060645,172.31.33.0-255,66,277557,33,328013
8952,0.060677,74.125.24.0-255,2902,280459,33,328013
8953,0.060688,172.31.33.0-255,66,280525,33,328013
8954,0.062993,74.125.24.0-255,2902,283427,33,328013
8955,0.062998,172.31.33.0-255,66,283493,33,328013
8956,0.063025,74.125.24.0-255,2902,286395,33,328013
8957,0.06304,172.31.33.0-255,66,286461,33,328013
8958,0.065332,74.125.24.0-255,2902,289363,33,328013
8959,0.065337,172.31.33.0-255,66,289429,33,328013
8960,0.065363,74.125.24.0-255,2902,292331,33,328013
8961,0.065444,172.31.33.0-255,66,292397,33,328013
8962,0.067651,74.125.24.0-255,2902,295299,33,328013
8963,0.067655,172.31.33.0-255,66,295365,33,328013
8964,0.06778,74.125.24.0-255,2902,298267,33,328013
8965,0.067785,172.31.33.0-255,66,298333,33,328013
8966,0.069987,74.125.24.0-255,2902,301235,33,328013
8967,0.069991,172.31.33.0-255,66,301301,33,328013
8968,0.070126,74.125.24.0-255,2902,304203,33,328013
8969,0.070131,172.31.33.0-255,66,304269,33,328013
8970,0.072326,74.125.24.0-255,2902,307171,33,328013
8971,0.07233,172.31.33.0-255,66,307237,33,328013
8972,0.072465,74.125.24.0-255,2902,310139,33,328013
8973,0.07247,172.31.33.0-255,66,310205,33,328013
8974,0.074655,74.125.24.0-255,2902,313107,33,328013
8975,0.074663,172.31.33.0-255,66,313173,33,328013
8976,0.074785,74.125.24.0-255,2902,316075,33,328013
8977,0.074791,172.31.33.0-255,66,316141,33,328013
8978,0.076988,74.125.24.0-255,2902,319043,33,328013
8979,0.076994,172.31.33.0-255,66,319109,33,328013
8980,0.077167,74.125.24.0-255,2902,322011,33,328013
8981,0.077172,172.31.33.0-255,66,322077,33,328013
8982,0.079311,74.125.24.0-255,2902,324979,33,328013
8983,0.079316,172.31.33.0-255,66,325045,33,328013
8984,0.079494,74.125.24.0-255,2902,327947,33,328013
8985,0.079499,172.31.33.0-255,66,328013,33,328013
8986,0.0,172.217.194.0-255,152,152,33,301850
8987,1.4e-05,172.31.33.0-255,66,218,33,301850
8988,2e-05,172.217.194.0-255,1484,1702,33,301850
8989,2.5e-05,172.31.33.0-255,66,1768,33,301850
8990,3e-05,172.217.194.0-255,2902,4670,33,301850
8991,4.2e-05,172.31.33.0-255,66,4736,33,301850
8992,4.7e-05,172.217.194.0-255,5738,10474,33,301850
8993,5e-05,172.31.33.0-255,66,10540,33,301850
8994,8.2e-05,172.217.194.0-255,3426,13966,33,301850
8995,8.4e-05,172.31.33.0-255,66,14032,33,301850
8996,0.000128,172.217.194.0-255,4320,18352,33,301850
8997,0.000132,172.31.33.0-255,66,18418,33,301850
8998,0.000136,172.217.194.0-255,2902,21320,33,301850
8999,0.000138,172.31.33.0-255,66,21386,33,301850
9000,0.000164,172.217.194.0-255,2902,24288,33,301850
9001,0.000167,172.31.33.0-255,66,24354,33,301850
9002,0.000177,172.217.194.0-255,5738,30092,33,301850
9003,0.000179,172.31.33.0-255,66,30158,33,301850
9004,0.000215,172.217.194.0-255,6797,36955,33,301850
9005,0.000217,172.31.33.0-255,66,37021,33,301850
9006,0.000251,172.217.194.0-255,7156,44177,33,301850
9007,0.000253,172.31.33.0-255,66,44243,33,301850
9008,0.000277,172.217.194.0-255,3961,48204,33,301850
9009,0.000279,172.31.33.0-255,66,48270,33,301850
9010,0.000661,172.217.194.0-255,1484,49754,33,301850
9011,0.000667,172.31.33.0-255,66,49820,33,301850
9012,0.000674,172.217.194.0-255,2902,52722,33,301850
9013,0.000676,172.31.33.0-255,66,52788,33,301850
9014,0.00068,172.217.194.0-255,1484,54272,33,301850
9015,0.000689,172.31.33.0-255,66,54338,33,301850
9016,0.000719,172.217.194.0-255,4320,58658,33,301850
9017,0.000725,172.31.33.0-255,66,58724,33,301850
9018,0.000732,172.217.194.0-255,5738,64462,33,301850
9019,0.000734,172.31.33.0-255,66,64528,33,301850
9020,0.000758,172.217.194.0-255,1421,65949,33,301850
9021,0.000829,172.217.194.0-255,380,66329,33,301850
9022,0.000833,172.31.33.0-255,66,66395,33,301850
9023,0.001017,172.217.194.0-255,1484,67879,33,301850
9024,0.001023,172.217.194.0-255,1484,69363,33,301850
9025,0.001026,172.31.33.0-255,66,69429,33,301850
9026,0.001051,172.217.194.0-255,1484,70913,33,301850
9027,0.001058,172.217.194.0-255,5738,76651,33,301850
9028,0.00106,172.31.33.0-255,66,76717,33,301850
9029,0.001063,172.217.194.0-255,1484,78201,33,301850
9030,0.001089,172.217.194.0-255,5379,83580,33,301850
9031,0.001091,172.31.33.0-255,66,83646,33,301850
9032,0.001107,172.217.194.0-255,1484,85130,33,301850
9033,0.001126,172.217.194.0-255,2902,88032,33,301850
9034,0.001128,172.31.33.0-255,66,88098,33,301850
9035,0.001133,172.217.194.0-255,2902,91000,33,301850
9036,0.001135,172.31.33.0-255,66,91066,33,301850
9037,0.001172,172.217.194.0-255,2902,93968,33,301850
9038,0.001174,172.31.33.0-255,66,94034,33,301850
9039,0.001181,172.217.194.0-255,6797,100831,33,301850
9040,0.001184,172.31.33.0-255,66,100897,33,301850
9041,0.002088,172.217.194.0-255,1484,102381,33,301850
9042,0.0021,172.217.194.0-255,2902,105283,33,301850
9043,0.002105,172.31.33.0-255,66,105349,33,301850
9044,0.002113,172.217.194.0-255,5738,111087,33,301850
9045,0.002115,172.31.33.0-255,66,111153,33,301850
9046,0.002141,172.217.194.0-255,5738,116891,33,301850
9047,0.002144,172.31.33.0-255,66,116957,33,301850
9048,0.002168,172.217.194.0-255,1484,118441,33,301850
9049,0.00219,172.217.194.0-255,5738,124179,33,301850
9050,0.002192,172.31.33.0-255,66,124245,33,301850
9051,0.002231,172.31.33.0-255,66,124311,33,301850
9052,0.002234,172.217.194.0-255,766,125077,33,301850
9053,0.004795,172.217.194.0-255,2902,127979,33,301850
9054,0.004802,172.31.33.0-255,66,128045,33,301850
9055,0.004829,172.217.194.0-255,1484,129529,33,301850
9056,0.007328,172.217.194.0-255,4320,133849,33,301850
9057,0.007335,172.31.33.0-255,66,133915,33,301850
9058,0.009882,172.217.194.0-255,5738,139653,33,301850
9059,0.009889,172.31.33.0-255,66,139719,33,301850
9060,0.012425,172.217.194.0-255,5738,145457,33,301850
9061,0.012433,172.31.33.0-255,66,145523,33,301850
9062,0.014983,172.217.194.0-255,5738,151261,33,301850
9063,0.01499,172.31.33.0-255,66,151327,33,301850
9064,0.017517,172.217.194.0-255,5738,157065,33,301850
9065,0.017525,172.31.33.0-255,66,157131,33,301850
9066,0.020084,172.217.194.0-255,5738,162869,33,301850
9067,0.020092,172.31.33.0-255,66,162935,33,301850
9068,0.022611,172.217.194.0-255,5738,168673,33,301850
9069,0.022618,172.31.33.0-255,66,168739,33,301850
9070,0.023958,172.31.33.0-255,171,168910,33,301850
9071,0.023985,172.31.33.0-255,1137,170047,33,301850
9072,0.024048,172.31.33.0-255,1514,171561,33,301850
9073,0.024049,172.31.33.0-255,1514,173075,33,301850
9074,0.02407,172.31.33.0-255,656,173731,33,301850
9075,0.025135,172.217.194.0-255,5738,179469,33,301850
9076,0.025158,172.31.33.0-255,66,179535,33,301850
9077,0.025506,104.244.42.0-255,66,179601,33,301850
9078,0.02555,104.244.42.0-255,66,179667,33,301850
9079,0.02563,104.244.42.0-255,66,179733,33,301850
9080,0.025634,104.244.42.0-255,66,179799,33,301850
9081,0.027684,172.217.194.0-255,5738,185537,33,301850
9082,0.027689,172.31.33.0-255,66,185603,33,301850
9083,0.030208,172.217.194.0-255,5738,191341,33,301850
9084,0.030214,172.31.33.0-255,66,191407,33,301850
9085,0.032794,172.217.194.0-255,5738,197145,33,301850
9086,0.032799,172.31.33.0-255,66,197211,33,301850
9087,0.035345,172.217.194.0-255,5738,202949,33,301850
9088,0.035351,172.31.33.0-255,66,203015,33,301850
9089,0.037876,172.217.194.0-255,5738,208753,33,301850
9090,0.037882,172.31.33.0-255,66,208819,33,301850
9091,0.040464,172.217.194.0-255,5738,214557,33,301850
9092,0.04047,172.31.33.0-255,66,214623,33,301850
9093,0.043072,172.217.194.0-255,5738,220361,33,301850
9094,0.043079,172.31.33.0-255,66,220427,33,301850
9095,0.043152,172.31.33.0-255,101,220528,33,301850
9096,0.04562,172.217.194.0-255,5738,226266,33,301850
9097,0.045625,172.31.33.0-255,66,226332,33,301850
9098,0.045648,172.217.194.0-255,66,226398,33,301850
9099,0.048149,172.217.194.0-255,5738,232136,33,301850
9100,0.048154,172.31.33.0-255,66,232202,33,301850
9101,0.050712,172.217.194.0-255,5738,237940,33,301850
9102,0.050718,172.31.33.0-255,66,238006,33,301850
9103,0.053342,172.217.194.0-255,5738,243744,33,301850
9104,0.053347,172.31.33.0-255,66,243810,33,301850
9105,0.055896,172.217.194.0-255,5738,249548,33,301850
9106,0.055901,172.31.33.0-255,66,249614,33,301850
9107,0.058425,172.217.194.0-255,5738,255352,33,301850
9108,0.058431,172.31.33.0-255,66,255418,33,301850
9109,0.060954,172.217.194.0-255,5738,261156,33,301850
9110,0.060961,172.31.33.0-255,66,261222,33,301850
9111,0.063481,172.217.194.0-255,5738,266960,33,301850
9112,0.063486,172.31.33.0-255,66,267026,33,301850
9113,0.06602,172.217.194.0-255,5738,272764,33,301850
9114,0.066026,172.31.33.0-255,66,272830,33,301850
9115,0.068604,172.217.194.0-255,5738,278568,33,301850
9116,0.06861,172.31.33.0-255,66,278634,33,301850
9117,0.071202,172.217.194.0-255,5738,284372,33,301850
9118,0.071209,172.31.33.0-255,66,284438,33,301850
9119,0.073774,172.217.194.0-255,5738,290176,33,301850
9120,0.073779,172.31.33.0-255,66,290242,33,301850
9121,0.076307,172.217.194.0-255,5738,295980,33,301850
9122,0.076313,172.31.33.0-255,66,296046,33,301850
9123,0.078896,172.217.194.0-255,5738,301784,33,301850
9124,0.078901,172.31.33.0-255,66,301850,33,301850
9125,0.0,172.217.194.0-255,146,146,33,194252
9126,2.7e-05,172.31.33.0-255,66,212,33,194252
9127,3.4e-05,172.217.194.0-255,1484,1696,33,194252
9128,3.9e-05,172.31.33.0-255,66,1762,33,194252
9129,4.4e-05,172.217.194.0-255,2902,4664,33,194252
9130,4.7e-05,172.31.33.0-255,66,4730,33,194252
9131,5.3e-05,172.217.194.0-255,7156,11886,33,194252
9132,5.6e-05,172.31.33.0-255,66,11952,33,194252
9133,8.2e-05,172.217.194.0-255,1997,13949,33,194252
9134,8.5e-05,172.31.33.0-255,66,14015,33,194252
9135,0.000138,172.217.194.0-255,1484,15499,33,194252
9136,0.000141,172.31.33.0-255,66,15565,33,194252
9137,0.000147,172.217.194.0-255,2902,18467,33,194252
9138,0.000149,172.31.33.0-255,66,18533,33,194252
9139,0.000153,172.217.194.0-255,2902,21435,33,194252
9140,0.000155,172.31.33.0-255,66,21501,33,194252
9141,0.000179,172.217.194.0-255,2902,24403,33,194252
9142,0.000181,172.31.33.0-255,66,24469,33,194252
9143,0.000188,172.217.194.0-255,6797,31266,33,194252
9144,0.00019,172.31.33.0-255,66,31332,33,194252
9145,0.00022,172.217.194.0-255,7156,38488,33,194252
9146,0.000224,172.31.33.0-255,66,38554,33,194252
9147,0.000253,172.31.33.0-255,66,38620,33,194252
9148,0.000269,172.217.194.0-255,1125,39745,33,194252
9149,0.000271,172.31.33.0-255,66,39811,33,194252
9150,0.000296,172.217.194.0-255,1484,41295,33,194252
9151,0.000298,172.31.33.0-255,66,41361,33,194252
9152,0.000303,172.217.194.0-255,2902,44263,33,194252
9153,0.000306,172.31.33.0-255,66,44329,33,194252
9154,0.000324,172.217.194.0-255,5738,50067,33,194252
9155,0.000327,172.31.33.0-255,66,50133,33,194252
9156,0.000332,172.217.194.0-255,2902,53035,33,194252
9157,0.000334,172.31.33.0-255,66,53101,33,194252
9158,0.000357,172.217.194.0-255,3961,57062,33,194252
9159,0.00036,172.31.33.0-255,66,57128,33,194252
9160,0.000363,172.217.194.0-255,365,57493,33,194252
9161,0.000364,172.31.33.0-255,66,57559,33,194252
9162,0.000408,172.217.194.0-255,380,57939,33,194252
9163,0.000414,172.31.33.0-255,66,58005,33,194252
9164,0.000568,172.217.194.0-255,1484,59489,33,194252
9165,0.000572,172.31.33.0-255,66,59555,33,194252
9166,0.000578,172.217.194.0-255,2902,62457,33,194252
9167,0.00058,172.31.33.0-255,66,62523,33,194252
9168,0.000586,172.217.194.0-255,5738,68261,33,194252
9169,0.00059,172.31.33.0-255,66,68327,33,194252
9170,0.000642,172.217.194.0-255,5738,74065,33,194252
9171,0.000646,172.31.33.0-255,66,74131,33,194252
9172,0.000679,172.31.33.0-255,66,74197,33,194252
9173,0.000689,172.31.33.0-255,66,74263,33,194252
9174,0.001224,172.217.194.0-255,1484,75747,33,194252
9175,0.001229,172.31.33.0-255,66,75813,33,194252
9176,0.001237,172.217.194.0-255,2902,78715,33,194252
9177,0.001239,172.31.33.0-255,66,78781,33,194252
9178,0.001245,172.217.194.0-255,5738,84519,33,194252
9179,0.001247,172.31.33.0-255,66,84585,33,194252
9180,0.001251,172.217.194.0-255,2902,87487,33,194252
9181,0.001253,172.31.33.0-255,66,87553,33,194252
9182,0.001277,172.217.194.0-255,2902,90455,33,194252
9183,0.00128,172.31.33.0-255,66,90521,33,194252
9184,0.001286,172.217.194.0-255,7156,97677,33,194252
9185,0.001287,172.31.33.0-255,66,97743,33,194252
9186,0.001302,172.217.194.0-255,5738,103481,33,194252
9187,0.001303,172.31.33.0-255,66,103547,33,194252
9188,0.001317,172.217.194.0-255,5020,108567,33,194252
9189,0.00132,172.31.33.0-255,66,108633,33,194252
9190,0.001334,172.217.194.0-255,5738,114371,33,194252
9191,0.001335,172.31.33.0-255,66,114437,33,194252
9192,0.001347,172.217.194.0-255,1484,115921,33,194252
9193,0.001349,172.31.33.0-255,66,115987,33,194252
9194,0.001373,172.31.33.0-255,66,116053,33,194252
9195,0.001405,172.217.194.0-255,4320,120373,33,194252
9196,0.001407,172.31.33.0-255,66,120439,33,194252
9197,0.001425,172.217.194.0-255,4320,124759,33,194252
9198,0.001427,172.31.33.0-255,66,124825,33,194252
9199,0.001438,172.31.33.0-255,66,124891,33,194252
9200,0.001462,172.217.194.0-255,5020,129911,33,194252
9201,0.001464,172.31.33.0-255,66,129977,33,194252
9202,0.001479,172.217.194.0-255,2902,132879,33,194252
9203,0.001481,172.31.33.0-255,66,132945,33,194252
9204,0.001501,172.31.33.0-255,66,133011,33,194252
9205,0.001524,172.31.33.0-255,66,133077,33,194252
9206,0.00156,172.217.194.0-255,1484,134561,33,194252
9207,0.001604,172.31.33.0-255,66,134627,33,194252
9208,0.001637,172.217.194.0-255,1484,136111,33,194252
9209,0.00166,172.31.33.0-255,66,136177,33,194252
9210,0.001688,172.217.194.0-255,4320,140497,33,194252
9211,0.00169,172.31.33.0-255,66,140563,33,194252
9212,0.001793,172.217.194.0-255,5738,146301,33,194252
9213,0.001869,172.217.194.0-255,5738,152039,33,194252
9214,0.00189,172.217.194.0-255,6438,158477,33,194252
9215,0.001905,172.217.194.0-255,4320,162797,33,194252
9216,0.00195,172.217.194.0-255,5738,168535,33,194252
9217,0.002026,172.217.194.0-255,5738,174273,33,194252
9218,0.002098,172.217.194.0-255,5738,180011,33,194252
9219,0.002168,172.217.194.0-255,1484,181495,33,194252
9220,0.002185,172.217.194.0-255,7156,188651,33,194252
9221,0.002221,172.217.194.0-255,105,188756,33,194252
9222,0.005916,172.31.33.0-255,66,188822,33,194252
9223,0.007744,172.31.33.0-255,105,188927,33,194252
9224,0.010314,172.217.194.0-255,66,188993,33,194252
9225,0.025656,172.31.33.0-255,172,189165,33,194252
9226,0.025682,172.31.33.0-255,1113,190278,33,194252
9227,0.025717,172.31.33.0-255,1514,191792,33,194252
9228,0.025718,172.31.33.0-255,1514,193306,33,194252
9229,0.025738,172.31.33.0-255,682,193988,33,194252
9230,0.027145,104.244.42.0-255,66,194054,33,194252
9231,0.027224,104.244.42.0-255,66,194120,33,194252
9232,0.027226,104.244.42.0-255,66,194186,33,194252
9233,0.027228,104.244.42.0-255,66,194252,33,194252
9234,0.0,74.125.24.0-255,298,298,33,204688
9235,2e-05,172.31.33.0-255,66,364,33,204688
9236,2.6e-05,74.125.24.0-255,1484,1848,33,204688
9237,2.9e-05,172.31.33.0-255,66,1914,33,204688
9238,3.2e-05,74.125.24.0-255,1484,3398,33,204688
9239,3.4e-05,172.31.33.0-255,66,3464,33,204688
9240,6.4e-05,74.125.24.0-255,2902,6366,33,204688
9241,6.7e-05,172.31.33.0-255,66,6432,33,204688
9242,7.8e-05,172.31.33.0-255,66,6498,33,204688
9243,8.4e-05,74.125.24.0-255,4320,10818,33,204688
9244,8.6e-05,172.31.33.0-255,66,10884,33,204688
9245,0.000109,74.125.24.0-255,2902,13786,33,204688
9246,0.000112,172.31.33.0-255,66,13852,33,204688
9247,0.000142,172.31.33.0-255,66,13918,33,204688
9248,0.000334,74.125.24.0-255,1484,15402,33,204688
9249,0.000338,172.31.33.0-255,66,15468,33,204688
9250,0.000343,74.125.24.0-255,2902,18370,33,204688
9251,0.000346,172.31.33.0-255,66,18436,33,204688
9252,0.000351,74.125.24.0-255,4320,22756,33,204688
9253,0.000358,172.31.33.0-255,66,22822,33,204688
9254,0.000378,74.125.24.0-255,1484,24306,33,204688
9255,0.000381,172.31.33.0-255,66,24372,33,204688
9256,0.000393,172.31.33.0-255,66,24438,33,204688
9257,0.00041,74.125.24.0-255,1484,25922,33,204688
9258,0.000413,172.31.33.0-255,66,25988,33,204688
9259,0.000441,172.31.33.0-255,66,26054,33,204688
9260,0.000444,74.125.24.0-255,1400,27454,33,204688
9261,0.000446,172.31.33.0-255,66,27520,33,204688
9262,0.000507,74.125.24.0-255,130,27650,33,204688
9263,0.000521,74.125.24.0-255,347,27997,33,204688
9264,0.000665,172.31.33.0-255,66,28063,33,204688
9265,0.000684,74.125.24.0-255,1484,29547,33,204688
9266,0.000689,74.125.24.0-255,2902,32449,33,204688
9267,0.000693,172.31.33.0-255,66,32515,33,204688
9268,0.0007,74.125.24.0-255,5738,38253,33,204688
9269,0.000702,172.31.33.0-255,66,38319,33,204688
9270,0.000737,172.31.33.0-255,66,38385,33,204688
9271,0.000763,74.125.24.0-255,1484,39869,33,204688
9272,0.000774,172.31.33.0-255,66,39935,33,204688
9273,0.001027,74.125.24.0-255,1484,41419,33,204688
9274,0.001036,74.125.24.0-255,2902,44321,33,204688
9275,0.00104,172.31.33.0-255,66,44387,33,204688
9276,0.001067,74.125.24.0-255,1484,45871,33,204688
9277,0.001072,74.125.24.0-255,2902,48773,33,204688
9278,0.001074,172.31.33.0-255,66,48839,33,204688
9279,0.001081,74.125.24.0-255,5738,54577,33,204688
9280,0.001083,172.31.33.0-255,66,54643,33,204688
9281,0.001107,74.125.24.0-255,7156,61799,33,204688
9282,0.00111,172.31.33.0-255,66,61865,33,204688
9283,0.001136,74.125.24.0-255,5738,67603,33,204688
9284,0.001139,172.31.33.0-255,66,67669,33,204688
9285,0.00116,74.125.24.0-255,4320,71989,33,204688
9286,0.001163,172.31.33.0-255,66,72055,33,204688
9287,0.001185,74.125.24.0-255,2184,74239,33,204688
9288,0.001188,172.31.33.0-255,66,74305,33,204688
9289,0.001297,74.125.24.0-255,1484,75789,33,204688
9290,0.001301,74.125.24.0-255,1484,77273,33,204688
9291,0.001304,172.31.33.0-255,66,77339,33,204688
9292,0.001333,74.125.24.0-255,1484,78823,33,204688
9293,0.001339,74.125.24.0-255,5738,84561,33,204688
9294,0.001341,172.31.33.0-255,66,84627,33,204688
9295,0.001377,172.31.33.0-255,66,84693,33,204688
9296,0.001387,172.31.33.0-255,66,84759,33,204688
9297,0.001405,74.125.24.0-255,3602,88361,33,204688
9298,0.001411,172.31.33.0-255,66,88427,33,204688
9299,0.001417,74.125.24.0-255,5738,94165,33,204688
9300,0.00142,172.31.33.0-255,66,94231,33,204688
9301,0.001464,74.125.24.0-255,7156,101387,33,204688
9302,0.001468,172.31.33.0-255,66,101453,33,204688
9303,0.001483,172.31.33.0-255,66,101519,33,204688
9304,0.001489,74.125.24.0-255,6438,107957,33,204688
9305,0.001491,172.31.33.0-255,66,108023,33,204688
9306,0.001635,74.125.24.0-255,1484,109507,33,204688
9307,0.00165,74.125.24.0-255,2902,112409,33,204688
9308,0.001654,172.31.33.0-255,66,112475,33,204688
9309,0.001685,74.125.24.0-255,5738,118213,33,204688
9310,0.001688,172.31.33.0-255,66,118279,33,204688
9311,0.001728,172.31.33.0-255,66,118345,33,204688
9312,0.001733,74.125.24.0-255,7156,125501,33,204688
9313,0.001735,172.31.33.0-255,66,125567,33,204688
9314,0.001755,74.125.24.0-255,1484,127051,33,204688
9315,0.001776,74.125.24.0-255,2184,129235,33,204688
9316,0.001777,172.31.33.0-255,66,129301,33,204688
9317,0.001876,74.125.24.0-255,1484,130785,33,204688
9318,0.001897,74.125.24.0-255,2902,133687,33,204688
9319,0.001899,172.31.33.0-255,66,133753,33,204688
9320,0.001902,74.125.24.0-255,1484,135237,33,204688
9321,0.001931,74.125.24.0-255,1484,136721,33,204688
9322,0.001933,172.31.33.0-255,66,136787,33,204688
9323,0.001957,74.125.24.0-255,4320,141107,33,204688
9324,0.001959,172.31.33.0-255,66,141173,33,204688
9325,0.001974,172.31.33.0-255,66,141239,33,204688
9326,0.001999,74.125.24.0-255,1484,142723,33,204688
9327,0.002004,74.125.24.0-255,5738,148461,33,204688
9328,0.002006,172.31.33.0-255,66,148527,33,204688
9329,0.00203,74.125.24.0-255,1484,150011,33,204688
9330,0.002043,74.125.24.0-255,7156,157167,33,204688
9331,0.002046,172.31.33.0-255,66,157233,33,204688
9332,0.002078,74.125.24.0-255,6438,163671,33,204688
9333,0.002081,172.31.33.0-255,66,163737,33,204688
9334,0.002099,172.31.33.0-255,66,163803,33,204688
9335,0.002105,74.125.24.0-255,5738,169541,33,204688
9336,0.002107,172.31.33.0-255,66,169607,33,204688
9337,0.002174,172.31.33.0-255,66,169673,33,204688
9338,0.002188,172.31.33.0-255,66,169739,33,204688
9339,0.002193,74.125.24.0-255,4320,174059,33,204688
9340,0.002196,172.31.33.0-255,66,174125,33,204688
9341,0.002236,74.125.24.0-255,4320,178445,33,204688
9342,0.00224,172.31.33.0-255,66,178511,33,204688
9343,0.002268,172.31.33.0-255,66,178577,33,204688
9344,0.002272,74.125.24.0-255,4320,182897,33,204688
9345,0.002274,172.31.33.0-255,66,182963,33,204688
9346,0.002319,172.31.33.0-255,66,183029,33,204688
9347,0.002325,74.125.24.0-255,7156,190185,33,204688
9348,0.002327,172.31.33.0-255,66,190251,33,204688
9349,0.00233,74.125.24.0-255,1484,191735,33,204688
9350,0.002374,172.31.33.0-255,66,191801,33,204688
9351,0.002392,74.125.24.0-255,7156,198957,33,204688
9352,0.0024,172.31.33.0-255,66,199023,33,204688
9353,0.002435,172.31.33.0-255,66,199089,33,204688
9354,0.004772,74.125.24.0-255,105,199194,33,204688
9355,0.008322,172.31.33.0-255,66,199260,33,204688
9356,0.008344,172.31.33.0-255,105,199365,33,204688
9357,0.010677,74.125.24.0-255,66,199431,33,204688
9358,0.030651,172.31.33.0-255,172,199603,33,204688
9359,0.03068,172.31.33.0-255,1113,200716,33,204688
9360,0.030726,172.31.33.0-255,1514,202230,33,204688
9361,0.030747,172.31.33.0-255,1514,203744,33,204688
9362,0.03075,172.31.33.0-255,680,204424,33,204688
9363,0.032203,104.244.42.0-255,66,204490,33,204688
9364,0.032212,104.244.42.0-255,66,204556,33,204688
9365,0.032293,104.244.42.0-255,66,204622,33,204688
9366,0.032297,104.244.42.0-255,66,204688,33,204688
9367,0.0,74.125.200.0-255,354,354,33,354426
9368,3e-05,172.31.33.0-255,66,420,33,354426
9369,3.5e-05,74.125.200.0-255,1484,1904,33,354426
9370,3.8e-05,172.31.33.0-255,66,1970,33,354426
9371,4.3e-05,74.125.200.0-255,2902,4872,33,354426
9372,4.6e-05,172.31.33.0-255,66,4938,33,354426
9373,5.6e-05,74.125.200.0-255,2902,7840,33,354426
9374,5.9e-05,172.31.33.0-255,66,7906,33,354426
9375,6.4e-05,74.125.200.0-255,4320,12226,33,354426
9376,6.6e-05,172.31.33.0-255,66,12292,33,354426
9377,9.5e-05,74.125.200.0-255,1688,13980,33,354426
9378,9.9e-05,172.31.33.0-255,66,14046,33,354426
9379,0.000146,74.125.200.0-255,1484,15530,33,354426
9380,0.00015,172.31.33.0-255,66,15596,33,354426
9381,0.000155,74.125.200.0-255,2902,18498,33,354426
9382,0.000157,172.31.33.0-255,66,18564,33,354426
9383,0.000162,74.125.200.0-255,2902,21466,33,354426
9384,0.000169,172.31.33.0-255,66,21532,33,354426
9385,0.000188,74.125.200.0-255,2902,24434,33,354426
9386,0.000191,172.31.33.0-255,66,24500,33,354426
9387,0.000201,74.125.200.0-255,4320,28820,33,354426
9388,0.000203,172.31.33.0-255,66,28886,33,354426
9389,0.000235,74.125.200.0-255,4320,33206,33,354426
9390,0.000238,172.31.33.0-255,66,33272,33,354426
9391,0.000264,74.125.200.0-255,1125,34397,33,354426
9392,0.000267,172.31.33.0-255,66,34463,33,354426
9393,0.00027,74.125.200.0-255,1484,35947,33,354426
9394,0.000272,172.31.33.0-255,66,36013,33,354426
9395,0.000307,74.125.200.0-255,2902,38915,33,354426
9396,0.000311,172.31.33.0-255,66,38981,33,354426
9397,0.000324,74.125.200.0-255,2902,41883,33,354426
9398,0.000326,172.31.33.0-255,66,41949,33,354426
9399,0.000358,74.125.200.0-255,2902,44851,33,354426
9400,0.000364,74.125.200.0-255,3961,48812,33,354426
9401,0.000364,172.31.33.0-255,66,48878,33,354426
9402,0.000367,172.31.33.0-255,66,48944,33,354426
9403,0.00115,74.125.200.0-255,1484,50428,33,354426
9404,0.001171,74.125.200.0-255,2902,53330,33,354426
9405,0.001175,172.31.33.0-255,66,53396,33,354426
9406,0.00118,74.125.200.0-255,4320,57716,33,354426
9407,0.001182,172.31.33.0-255,66,57782,33,354426
9408,0.001193,74.125.200.0-255,5738,63520,33,354426
9409,0.001195,172.31.33.0-255,66,63586,33,354426
9410,0.001234,172.31.33.0-255,66,63652,33,354426
9411,0.001244,172.31.33.0-255,66,63718,33,354426
9412,0.001274,74.125.200.0-255,2902,66620,33,354426
9413,0.001277,172.31.33.0-255,66,66686,33,354426
9414,0.001309,172.31.33.0-255,66,66752,33,354426
9415,0.001314,74.125.200.0-255,5599,72351,33,354426
9416,0.001317,172.31.33.0-255,66,72417,33,354426
9417,0.001778,74.125.200.0-255,1484,73901,33,354426
9418,0.001808,74.125.200.0-255,2902,76803,33,354426
9419,0.001812,172.31.33.0-255,66,76869,33,354426
9420,0.001838,74.125.200.0-255,2902,79771,33,354426
9421,0.00184,172.31.33.0-255,66,79837,33,354426
9422,0.001856,74.125.200.0-255,2902,82739,33,354426
9423,0.001859,172.31.33.0-255,66,82805,33,354426
9424,0.00187,74.125.200.0-255,2902,85707,33,354426
9425,0.001874,172.31.33.0-255,66,85773,33,354426
9426,0.001887,74.125.200.0-255,2902,88675,33,354426
9427,0.001889,172.31.33.0-255,66,88741,33,354426
9428,0.001906,74.125.200.0-255,5738,94479,33,354426
9429,0.001911,172.31.33.0-255,66,94545,33,354426
9430,0.001956,74.125.200.0-255,2902,97447,33,354426
9431,0.001959,172.31.33.0-255,66,97513,33,354426
9432,0.001987,74.125.200.0-255,7156,104669,33,354426
9433,0.001989,172.31.33.0-255,66,104735,33,354426
9434,0.001993,74.125.200.0-255,2184,106919,33,354426
9435,0.001995,172.31.33.0-255,66,106985,33,354426
9436,0.002033,74.125.200.0-255,1484,108469,33,354426
9437,0.002051,74.125.200.0-255,1484,109953,33,354426
9438,0.002054,172.31.33.0-255,66,110019,33,354426
9439,0.002077,74.125.200.0-255,1484,111503,33,354426
9440,0.002094,74.125.200.0-255,5738,117241,33,354426
9441,0.002097,172.31.33.0-255,66,117307,33,354426
9442,0.002124,74.125.200.0-255,7156,124463,33,354426
9443,0.002127,172.31.33.0-255,66,124529,33,354426
9444,0.002175,74.125.200.0-255,4320,128849,33,354426
9445,0.002178,172.31.33.0-255,66,128915,33,354426
9446,0.002206,74.125.200.0-255,7156,136071,33,354426
9447,0.002209,172.31.33.0-255,66,136137,33,354426
9448,0.00224,74.125.200.0-255,2902,139039,33,354426
9449,0.002242,172.31.33.0-255,66,139105,33,354426
9450,0.002266,74.125.200.0-255,2184,141289,33,354426
9451,0.002269,172.31.33.0-255,66,141355,33,354426
9452,0.004351,74.125.200.0-255,2902,144257,33,354426
9453,0.004355,172.31.33.0-255,66,144323,33,354426
9454,0.004384,74.125.200.0-255,2902,147225,33,354426
9455,0.004387,172.31.33.0-255,66,147291,33,354426
9456,0.006476,74.125.200.0-255,2902,150193,33,354426
9457,0.006482,172.31.33.0-255,66,150259,33,354426
9458,0.006509,74.125.200.0-255,2902,153161,33,354426
9459,0.006512,172.31.33.0-255,66,153227,33,354426
9460,0.008604,74.125.200.0-255,2902,156129,33,354426
9461,0.008612,172.31.33.0-255,66,156195,33,354426
9462,0.00865,74.125.200.0-255,2902,159097,33,354426
9463,0.008653,172.31.33.0-255,66,159163,33,354426
9464,0.010727,74.125.200.0-255,2902,162065,33,354426
9465,0.010734,172.31.33.0-255,66,162131,33,354426
9466,0.010762,74.125.200.0-255,1484,163615,33,354426
9467,0.010773,74.125.200.0-255,1484,165099,33,354426
9468,0.010775,172.31.33.0-255,66,165165,33,354426
9469,0.012873,74.125.200.0-255,1484,166649,33,354426
9470,0.012902,74.125.200.0-255,1484,168133,33,354426
9471,0.012907,172.31.33.0-255,66,168199,33,354426
9472,0.01295,74.125.200.0-255,2902,171101,33,354426
9473,0.012953,172.31.33.0-255,66,171167,33,354426
9474,0.015033,74.125.200.0-255,2902,174069,33,354426
9475,0.015039,172.31.33.0-255,66,174135,33,354426
9476,0.015069,74.125.200.0-255,2902,177037,33,354426
9477,0.015072,172.31.33.0-255,66,177103,33,354426
9478,0.017595,74.125.200.0-255,2902,180005,33,354426
9479,0.017601,172.31.33.0-255,66,180071,33,354426
9480,0.017647,74.125.200.0-255,2902,182973,33,354426
9481,0.017651,172.31.33.0-255,66,183039,33,354426
9482,0.019714,74.125.200.0-255,2902,185941,33,354426
9483,0.01972,172.31.33.0-255,66,186007,33,354426
9484,0.019762,74.125.200.0-255,2902,188909,33,354426
9485,0.019766,172.31.33.0-255,66,188975,33,354426
9486,0.021838,74.125.200.0-255,2902,191877,33,354426
9487,0.021844,172.31.33.0-255,66,191943,33,354426
9488,0.021881,74.125.200.0-255,2902,194845,33,354426
9489,0.021883,172.31.33.0-255,66,194911,33,354426
9490,0.023963,74.125.200.0-255,2902,197813,33,354426
9491,0.023968,172.31.33.0-255,66,197879,33,354426
9492,0.024006,74.125.200.0-255,2902,200781,33,354426
9493,0.02401,172.31.33.0-255,66,200847,33,354426
9494,0.025357,172.31.33.0-255,172,201019,33,354426
9495,0.025386,172.31.33.0-255,1118,202137,33,354426
9496,0.025425,172.31.33.0-255,1514,203651,33,354426
9497,0.025426,172.31.33.0-255,1279,204930,33,354426
9498,0.02618,74.125.200.0-255,2902,207832,33,354426
9499,0.026187,172.31.33.0-255,66,207898,33,354426
9500,0.026225,74.125.200.0-255,2902,210800,33,354426
9501,0.02623,172.31.33.0-255,66,210866,33,354426
9502,0.026999,104.244.42.0-255,66,210932,33,354426
9503,0.027055,104.244.42.0-255,66,210998,33,354426
9504,0.02708,104.244.42.0-255,66,211064,33,354426
9505,0.028309,74.125.200.0-255,2902,213966,33,354426
9506,0.028316,172.31.33.0-255,66,214032,33,354426
9507,0.02835,74.125.200.0-255,2902,216934,33,354426
9508,0.028353,172.31.33.0-255,66,217000,33,354426
9509,0.028701,104.244.42.0-255,108,217108,33,354426
9510,0.028717,172.31.33.0-255,66,217174,33,354426
9511,0.030456,74.125.200.0-255,2902,220076,33,354426
9512,0.030462,172.31.33.0-255,66,220142,33,354426
9513,0.030497,74.125.200.0-255,2902,223044,33,354426
9514,0.0305,172.31.33.0-255,66,223110,33,354426
9515,0.03259,74.125.200.0-255,2902,226012,33,354426
9516,0.032596,172.31.33.0-255,66,226078,33,354426
9517,0.032615,74.125.200.0-255,2902,228980,33,354426
9518,0.032618,172.31.33.0-255,66,229046,33,354426
9519,0.034737,74.125.200.0-255,5738,234784,33,354426
9520,0.034742,172.31.33.0-255,66,234850,33,354426
9521,0.036871,74.125.200.0-255,5738,240588,33,354426
9522,0.036878,172.31.33.0-255,66,240654,33,354426
9523,0.039067,74.125.200.0-255,5738,246392,33,354426
9524,0.039072,172.31.33.0-255,66,246458,33,354426
9525,0.041182,74.125.200.0-255,5738,252196,33,354426
9526,0.041188,172.31.33.0-255,66,252262,33,354426
9527,0.043312,74.125.200.0-255,5738,258000,33,354426
9528,0.043321,172.31.33.0-255,66,258066,33,354426
9529,0.045451,74.125.200.0-255,5738,263804,33,354426
9530,0.045457,172.31.33.0-255,66,263870,33,354426
9531,0.047585,74.125.200.0-255,5738,269608,33,354426
9532,0.047593,172.31.33.0-255,66,269674,33,354426
9533,0.049719,74.125.200.0-255,5738,275412,33,354426
9534,0.049725,172.31.33.0-255,66,275478,33,354426
9535,0.051859,74.125.200.0-255,5738,281216,33,354426
9536,0.051864,172.31.33.0-255,66,281282,33,354426
9537,0.053988,74.125.200.0-255,5738,287020,33,354426
9538,0.053994,172.31.33.0-255,66,287086,33,354426
9539,0.056187,74.125.200.0-255,4320,291406,33,354426
9540,0.056193,172.31.33.0-255,66,291472,33,354426
9541,0.05622,74.125.200.0-255,1484,292956,33,354426
9542,0.058305,74.125.200.0-255,4320,297276,33,354426
9543,0.058311,172.31.33.0-255,66,297342,33,354426
9544,0.060426,74.125.200.0-255,4320,301662,33,354426
9545,0.060432,172.31.33.0-255,66,301728,33,354426
9546,0.060461,74.125.200.0-255,1484,303212,33,354426
9547,0.062577,74.125.200.0-255,4320,307532,33,354426
9548,0.062586,172.31.33.0-255,66,307598,33,354426
9549,0.064723,74.125.200.0-255,5738,313336,33,354426
9550,0.064729,172.31.33.0-255,66,313402,33,354426
9551,0.066864,74.125.200.0-255,5738,319140,33,354426
9552,0.06687,172.31.33.0-255,66,319206,33,354426
9553,0.068998,74.125.200.0-255,5738,324944,33,354426
9554,0.069004,172.31.33.0-255,66,325010,33,354426
9555,0.071139,74.125.200.0-255,5738,330748,33,354426
9556,0.071145,172.31.33.0-255,66,330814,33,354426
9557,0.073276,74.125.200.0-255,5738,336552,33,354426
9558,0.073281,172.31.33.0-255,66,336618,33,354426
9559,0.075398,74.125.200.0-255,2902,339520,33,354426
9560,0.075404,172.31.33.0-255,66,339586,33,354426
9561,0.075433,74.125.200.0-255,2902,342488,33,354426
9562,0.075435,172.31.33.0-255,66,342554,33,354426
9563,0.077524,74.125.200.0-255,2902,345456,33,354426
9564,0.07753,172.31.33.0-255,66,345522,33,354426
9565,0.077559,74.125.200.0-255,2902,348424,33,354426
9566,0.077561,172.31.33.0-255,66,348490,33,354426
9567,0.079653,74.125.200.0-255,2902,351392,33,354426
9568,0.079662,172.31.33.0-255,66,351458,33,354426
9569,0.079694,74.125.200.0-255,2902,354360,33,354426
9570,0.079697,172.31.33.0-255,66,354426,33,354426
9571,0.0,74.125.24.0-255,153,153,33,310106
9572,2.7e-05,172.31.33.0-255,66,219,33,310106
9573,3.6e-05,74.125.24.0-255,1484,1703,33,310106
9574,4e-05,172.31.33.0-255,66,1769,33,310106
9575,4.5e-05,74.125.24.0-255,2902,4671,33,310106
9576,4.9e-05,172.31.33.0-255,66,4737,33,310106
9577,5.6e-05,74.125.24.0-255,7156,11893,33,310106
9578,6e-05,172.31.33.0-255,66,11959,33,310106
9579,6.4e-05,74.125.24.0-255,2049,14008,33,310106
9580,6.8e-05,172.31.33.0-255,66,14074,33,310106
9581,0.000852,74.125.24.0-255,1484,15558,33,310106
9582,0.000861,172.31.33.0-255,66,15624,33,310106
9583,0.00087,74.125.24.0-255,2902,18526,33,310106
9584,0.000873,172.31.33.0-255,66,18592,33,310106
9585,0.00088,74.125.24.0-255,5738,24330,33,310106
9586,0.000883,172.31.33.0-255,66,24396,33,310106
9587,0.000891,74.125.24.0-255,6797,31193,33,310106
9588,0.000894,172.31.33.0-255,66,31259,33,310106
9589,0.00099,74.125.24.0-255,1484,32743,33,310106
9590,0.000994,172.31.33.0-255,66,32809,33,310106
9591,0.001016,74.125.24.0-255,2902,35711,33,310106
9592,0.001018,172.31.33.0-255,66,35777,33,310106
9593,0.001023,74.125.24.0-255,2902,38679,33,310106
9594,0.001025,172.31.33.0-255,66,38745,33,310106
9595,0.001043,74.125.24.0-255,7156,45901,33,310106
9596,0.001046,172.31.33.0-255,66,45967,33,310106
9597,0.001071,74.125.24.0-255,4320,50287,33,310106
9598,0.001074,172.31.33.0-255,66,50353,33,310106
9599,0.001093,74.125.24.0-255,6797,57150,33,310106
9600,0.001096,172.31.33.0-255,66,57216,33,310106
9601,0.001139,74.125.24.0-255,5738,62954,33,310106
9602,0.001158,172.31.33.0-255,66,63020,33,310106
9603,0.001179,74.125.24.0-255,2839,65859,33,310106
9604,0.001182,172.31.33.0-255,66,65925,33,310106
9605,0.001907,74.125.24.0-255,132,66057,33,310106
9606,0.001944,74.125.24.0-255,1484,67541,33,310106
9607,0.00195,172.31.33.0-255,66,67607,33,310106
9608,0.001957,74.125.24.0-255,2902,70509,33,310106
9609,0.001959,172.31.33.0-255,66,70575,33,310106
9610,0.001987,74.125.24.0-255,7156,77731,33,310106
9611,0.00199,172.31.33.0-255,66,77797,33,310106
9612,0.001995,74.125.24.0-255,2902,80699,33,310106
9613,0.001998,172.31.33.0-255,66,80765,33,310106
9614,0.002014,74.125.24.0-255,5738,86503,33,310106
9615,0.002016,172.31.33.0-255,66,86569,33,310106
9616,0.002028,172.31.33.0-255,66,86635,33,310106
9617,0.002041,74.125.24.0-255,3602,90237,33,310106
9618,0.002044,172.31.33.0-255,66,90303,33,310106
9619,0.002224,74.125.24.0-255,1484,91787,33,310106
9620,0.002239,74.125.24.0-255,2902,94689,33,310106
9621,0.002242,172.31.33.0-255,66,94755,33,310106
9622,0.002246,74.125.24.0-255,1484,96239,33,310106
9623,0.002265,74.125.24.0-255,4320,100559,33,310106
9624,0.002267,172.31.33.0-255,66,100625,33,310106
9625,0.002272,74.125.24.0-255,2902,103527,33,310106
9626,0.002274,172.31.33.0-255,66,103593,33,310106
9627,0.002298,172.31.33.0-255,66,103659,33,310106
9628,0.002304,74.125.24.0-255,7156,110815,33,310106
9629,0.002307,172.31.33.0-255,66,110881,33,310106
9630,0.002328,74.125.24.0-255,2902,113783,33,310106
9631,0.00233,172.31.33.0-255,66,113849,33,310106
9632,0.002362,172.31.33.0-255,66,113915,33,310106
9633,0.002384,74.125.24.0-255,6438,120353,33,310106
9634,0.002387,172.31.33.0-255,66,120419,33,310106
9635,0.0024,172.31.33.0-255,66,120485,33,310106
9636,0.002422,74.125.24.0-255,2902,123387,33,310106
9637,0.002424,172.31.33.0-255,66,123453,33,310106
9638,0.002429,74.125.24.0-255,3602,127055,33,310106
9639,0.002431,172.31.33.0-255,66,127121,33,310106
9640,0.002503,74.125.24.0-255,1484,128605,33,310106
9641,0.002535,74.125.24.0-255,2902,131507,33,310106
9642,0.002538,172.31.33.0-255,66,131573,33,310106
9643,0.002545,74.125.24.0-255,5738,137311,33,310106
9644,0.002548,172.31.33.0-255,66,137377,33,310106
9645,0.002561,172.31.33.0-255,66,137443,33,310106
9646,0.002621,172.31.33.0-255,66,137509,33,310106
9647,0.005209,74.125.24.0-255,5738,143247,33,310106
9648,0.005215,172.31.33.0-255,66,143313,33,310106
9649,0.007838,74.125.24.0-255,5738,149051,33,310106
9650,0.007852,172.31.33.0-255,66,149117,33,310106
9651,0.010444,74.125.24.0-255,5738,154855,33,310106
9652,0.010457,172.31.33.0-255,66,154921,33,310106
9653,0.013038,74.125.24.0-255,5738,160659,33,310106
9654,0.013051,172.31.33.0-255,66,160725,33,310106
9655,0.015674,74.125.24.0-255,5738,166463,33,310106
9656,0.015691,172.31.33.0-255,66,166529,33,310106
9657,0.018262,74.125.24.0-255,5738,172267,33,310106
9658,0.018277,172.31.33.0-255,66,172333,33,310106
9659,0.02088,74.125.24.0-255,5738,178071,33,310106
9660,0.020891,172.31.33.0-255,66,178137,33,310106
9661,0.02347,74.125.24.0-255,5738,183875,33,310106
9662,0.023482,172.31.33.0-255,66,183941,33,310106
9663,0.026062,74.125.24.0-255,5738,189679,33,310106
9664,0.026076,172.31.33.0-255,66,189745,33,310106
9665,0.02871,74.125.24.0-255,5738,195483,33,310106
9666,0.028731,172.31.33.0-255,66,195549,33,310106
9667,0.031296,74.125.24.0-255,5738,201287,33,310106
9668,0.031315,172.31.33.0-255,66,201353,33,310106
9669,0.033934,74.125.24.0-255,5738,207091,33,310106
9670,0.033953,172.31.33.0-255,66,207157,33,310106
9671,0.036518,74.125.24.0-255,5738,212895,33,310106
9672,0.036536,172.31.33.0-255,66,212961,33,310106
9673,0.039169,74.125.24.0-255,5738,218699,33,310106
9674,0.039188,172.31.33.0-255,66,218765,33,310106
9675,0.041333,172.31.33.0-255,172,218937,33,310106
9676,0.041376,172.31.33.0-255,1117,220054,33,310106
9677,0.041441,172.31.33.0-255,1514,221568,33,310106
9678,0.041443,172.31.33.0-255,1280,222848,33,310106
9679,0.041771,74.125.24.0-255,5738,228586,33,310106
9680,0.041787,172.31.33.0-255,66,228652,33,310106
9681,0.042865,104.244.42.0-255,66,228718,33,310106
9682,0.042961,104.244.42.0-255,66,228784,33,310106
9683,0.043007,104.244.42.0-255,66,228850,33,310106
9684,0.044381,74.125.24.0-255,5738,234588,33,310106
9685,0.044391,172.31.33.0-255,66,234654,33,310106
9686,0.046992,74.125.24.0-255,5738,240392,33,310106
9687,0.047003,172.31.33.0-255,66,240458,33,310106
9688,0.049602,74.125.24.0-255,5738,246196,33,310106
9689,0.04961,172.31.33.0-255,66,246262,33,310106
9690,0.052197,74.125.24.0-255,5738,252000,33,310106
9691,0.05221,172.31.33.0-255,66,252066,33,310106
9692,0.054789,74.125.24.0-255,5738,257804,33,310106
9693,0.054797,172.31.33.0-255,66,257870,33,310106
9694,0.05738,74.125.24.0-255,5738,263608,33,310106
9695,0.057388,172.31.33.0-255,66,263674,33,310106
9696,0.059961,74.125.24.0-255,5738,269412,33,310106
9697,0.059968,172.31.33.0-255,66,269478,33,310106
9698,0.062569,74.125.24.0-255,5738,275216,33,310106
9699,0.062581,172.31.33.0-255,66,275282,33,310106
9700,0.065202,74.125.24.0-255,5738,281020,33,310106
9701,0.065215,172.31.33.0-255,66,281086,33,310106
9702,0.067817,74.125.24.0-255,5738,286824,33,310106
9703,0.067829,172.31.33.0-255,66,286890,33,310106
9704,0.070444,74.125.24.0-255,5738,292628,33,310106
9705,0.070455,172.31.33.0-255,66,292694,33,310106
9706,0.073065,74.125.24.0-255,5738,298432,33,310106
9707,0.073075,172.31.33.0-255,66,298498,33,310106
9708,0.075693,74.125.24.0-255,5738,304236,33,310106
9709,0.075702,172.31.33.0-255,66,304302,33,310106
9710,0.078281,74.125.24.0-255,5738,310040,33,310106
9711,0.078289,172.31.33.0-255,66,310106,33,310106
9712,0.0,74.125.130.0-255,146,146,33,348372
9713,1.3e-05,172.31.33.0-255,66,212,33,348372
9714,5.2e-05,74.125.130.0-255,1484,1696,33,348372
9715,5.7e-05,172.31.33.0-255,66,1762,33,348372
9716,6.1e-05,74.125.130.0-255,1484,3246,33,348372
9717,6.4e-05,172.31.33.0-255,66,3312,33,348372
9718,9.8e-05,74.125.130.0-255,1484,4796,33,348372
9719,0.000101,172.31.33.0-255,66,4862,33,348372
9720,0.000108,74.125.130.0-255,5738,10600,33,348372
9721,0.000111,172.31.33.0-255,66,10666,33,348372
9722,0.000121,74.125.130.0-255,4320,14986,33,348372
9723,0.000124,172.31.33.0-255,66,15052,33,348372
9724,0.000151,74.125.130.0-255,2029,17081,33,348372
9725,0.000154,172.31.33.0-255,66,17147,33,348372
9726,0.000161,74.125.130.0-255,7156,24303,33,348372
9727,0.000164,172.31.33.0-255,66,24369,33,348372
9728,0.000196,74.125.130.0-255,6797,31166,33,348372
9729,0.000199,172.31.33.0-255,66,31232,33,348372
9730,0.000316,74.125.130.0-255,1484,32716,33,348372
9731,0.00032,172.31.33.0-255,66,32782,33,348372
9732,0.000325,74.125.130.0-255,2902,35684,33,348372
9733,0.000328,172.31.33.0-255,66,35750,33,348372
9734,0.00034,74.125.130.0-255,1484,37234,33,348372
9735,0.000343,172.31.33.0-255,66,37300,33,348372
9736,0.000366,74.125.130.0-255,1484,38784,33,348372
9737,0.000367,172.31.33.0-255,66,38850,33,348372
9738,0.000376,74.125.130.0-255,4320,43170,33,348372
9739,0.000378,172.31.33.0-255,66,43236,33,348372
9740,0.000382,74.125.130.0-255,2902,46138,33,348372
9741,0.000384,172.31.33.0-255,66,46204,33,348372
9742,0.000398,74.125.130.0-255,6797,53001,33,348372
9743,0.000401,172.31.33.0-255,66,53067,33,348372
9744,0.00043,172.31.33.0-255,66,53133,33,348372
9745,0.000433,74.125.130.0-255,1484,54617,33,348372
9746,0.000456,74.125.130.0-255,1414,56031,33,348372
9747,0.000458,172.31.33.0-255,66,56097,33,348372
9748,0.000461,74.125.130.0-255,98,56195,33,348372
9749,0.000642,74.125.130.0-255,1484,57679,33,348372
9750,0.000646,172.31.33.0-255,66,57745,33,348372
9751,0.000652,74.125.130.0-255,2902,60647,33,348372
9752,0.000654,172.31.33.0-255,66,60713,33,348372
9753,0.000688,74.125.130.0-255,5738,66451,33,348372
9754,0.000691,172.31.33.0-255,66,66517,33,348372
9755,0.000712,74.125.130.0-255,7156,73673,33,348372
9756,0.000714,172.31.33.0-255,66,73739,33,348372
9757,0.000739,74.125.130.0-255,2902,76641,33,348372
9758,0.000742,172.31.33.0-255,66,76707,33,348372
9759,0.000759,172.31.33.0-255,66,76773,33,348372
9760,0.000762,74.125.130.0-255,1903,78676,33,348372
9761,0.000764,172.31.33.0-255,66,78742,33,348372
9762,0.000815,74.125.130.0-255,5738,84480,33,348372
9763,0.000818,172.31.33.0-255,66,84546,33,348372
9764,0.000844,74.125.130.0-255,7156,91702,33,348372
9765,0.000846,172.31.33.0-255,66,91768,33,348372
9766,0.000868,74.125.130.0-255,1484,93252,33,348372
9767,0.000889,172.31.33.0-255,66,93318,33,348372
9768,0.000916,74.125.130.0-255,5020,98338,33,348372
9769,0.000921,172.31.33.0-255,66,98404,33,348372
9770,0.001095,74.125.130.0-255,1484,99888,33,348372
9771,0.001113,74.125.130.0-255,2902,102790,33,348372
9772,0.001116,172.31.33.0-255,66,102856,33,348372
9773,0.00112,74.125.130.0-255,1484,104340,33,348372
9774,0.001143,74.125.130.0-255,4320,108660,33,348372
9775,0.001146,172.31.33.0-255,66,108726,33,348372
9776,0.001151,74.125.130.0-255,4320,113046,33,348372
9777,0.001153,172.31.33.0-255,66,113112,33,348372
9778,0.001182,74.125.130.0-255,4320,117432,33,348372
9779,0.001184,172.31.33.0-255,66,117498,33,348372
9780,0.001201,172.31.33.0-255,66,117564,33,348372
9781,0.001207,74.125.130.0-255,5020,122584,33,348372
9782,0.00121,172.31.33.0-255,66,122650,33,348372
9783,0.001393,74.125.130.0-255,1484,124134,33,348372
9784,0.001407,74.125.130.0-255,2902,127036,33,348372
9785,0.001412,172.31.33.0-255,66,127102,33,348372
9786,0.001448,74.125.130.0-255,5738,132840,33,348372
9787,0.001451,172.31.33.0-255,66,132906,33,348372
9788,0.001456,74.125.130.0-255,2902,135808,33,348372
9789,0.001458,172.31.33.0-255,66,135874,33,348372
9790,0.001461,74.125.130.0-255,1484,137358,33,348372
9791,0.001484,74.125.130.0-255,2902,140260,33,348372
9792,0.001486,172.31.33.0-255,66,140326,33,348372
9793,0.001504,74.125.130.0-255,4320,144646,33,348372
9794,0.001507,172.31.33.0-255,66,144712,33,348372
9795,0.001539,74.125.130.0-255,4320,149032,33,348372
9796,0.001542,172.31.33.0-255,66,149098,33,348372
9797,0.001547,74.125.130.0-255,2902,152000,33,348372
9798,0.001549,172.31.33.0-255,66,152066,33,348372
9799,0.001559,74.125.130.0-255,4320,156386,33,348372
9800,0.001561,172.31.33.0-255,66,156452,33,348372
9801,0.001564,74.125.130.0-255,766,157218,33,348372
9802,0.002012,74.125.130.0-255,1484,158702,33,348372
9803,0.002017,172.31.33.0-255,66,158768,33,348372
9804,0.002023,74.125.130.0-255,2902,161670,33,348372
9805,0.002025,172.31.33.0-255,66,161736,33,348372
9806,0.002055,74.125.130.0-255,5738,167474,33,348372
9807,0.002058,172.31.33.0-255,66,167540,33,348372
9808,0.002086,74.125.130.0-255,2902,170442,33,348372
9809,0.002089,172.31.33.0-255,66,170508,33,348372
9810,0.002094,74.125.130.0-255,4320,174828,33,348372
9811,0.002096,172.31.33.0-255,66,174894,33,348372
9812,0.002133,172.31.33.0-255,66,174960,33,348372
9813,0.002175,172.31.33.0-255,66,175026,33,348372
9814,0.002219,74.125.130.0-255,1484,176510,33,348372
9815,0.002238,74.125.130.0-255,4320,180830,33,348372
9816,0.002241,172.31.33.0-255,66,180896,33,348372
9817,0.002245,74.125.130.0-255,1484,182380,33,348372
9818,0.002262,74.125.130.0-255,5738,188118,33,348372
9819,0.002264,172.31.33.0-255,66,188184,33,348372
9820,0.002273,74.125.130.0-255,2902,191086,33,348372
9821,0.002275,172.31.33.0-255,66,191152,33,348372
9822,0.002278,74.125.130.0-255,1484,192636,33,348372
9823,0.002304,74.125.130.0-255,2902,195538,33,348372
9824,0.002306,172.31.33.0-255,66,195604,33,348372
9825,0.002335,74.125.130.0-255,7156,202760,33,348372
9826,0.002337,172.31.33.0-255,66,202826,33,348372
9827,0.002365,74.125.130.0-255,1484,204310,33,348372
9828,0.002381,74.125.130.0-255,5020,209330,33,348372
9829,0.002383,172.31.33.0-255,66,209396,33,348372
9830,0.002416,74.125.130.0-255,1484,210880,33,348372
9831,0.002437,74.125.130.0-255,2902,213782,33,348372
9832,0.00244,172.31.33.0-255,66,213848,33,348372
9833,0.002463,74.125.130.0-255,5738,219586,33,348372
9834,0.002466,172.31.33.0-255,66,219652,33,348372
9835,0.002493,74.125.130.0-255,2902,222554,33,348372
9836,0.002495,172.31.33.0-255,66,222620,33,348372
9837,0.002521,74.125.130.0-255,4320,226940,33,348372
9838,0.002524,172.31.33.0-255,66,227006,33,348372
9839,0.002527,74.125.130.0-255,1484,228490,33,348372
9840,0.002549,74.125.130.0-255,2902,231392,33,348372
9841,0.002551,172.31.33.0-255,66,231458,33,348372
9842,0.002557,74.125.130.0-255,5738,237196,33,348372
9843,0.002559,172.31.33.0-255,66,237262,33,348372
9844,0.002586,74.125.130.0-255,2902,240164,33,348372
9845,0.002588,172.31.33.0-255,66,240230,33,348372
9846,0.002617,74.125.130.0-255,3602,243832,33,348372
9847,0.00262,172.31.33.0-255,66,243898,33,348372
9848,0.005146,74.125.130.0-255,1484,245382,33,348372
9849,0.00518,74.125.130.0-255,4320,249702,33,348372
9850,0.005184,172.31.33.0-255,66,249768,33,348372
9851,0.007739,74.125.130.0-255,5738,255506,33,348372
9852,0.007744,172.31.33.0-255,66,255572,33,348372
9853,0.010335,74.125.130.0-255,5738,261310,33,348372
9854,0.010342,172.31.33.0-255,66,261376,33,348372
9855,0.012905,74.125.130.0-255,5738,267114,33,348372
9856,0.012914,172.31.33.0-255,66,267180,33,348372
9857,0.015477,74.125.130.0-255,5738,272918,33,348372
9858,0.015487,172.31.33.0-255,66,272984,33,348372
9859,0.01805,74.125.130.0-255,5738,278722,33,348372
9860,0.018057,172.31.33.0-255,66,278788,33,348372
9861,0.020619,74.125.130.0-255,5738,284526,33,348372
9862,0.020628,172.31.33.0-255,66,284592,33,348372
9863,0.023202,74.125.130.0-255,5738,290330,33,348372
9864,0.023213,172.31.33.0-255,66,290396,33,348372
9865,0.025844,74.125.130.0-255,5738,296134,33,348372
9866,0.025851,172.31.33.0-255,66,296200,33,348372
9867,0.028414,74.125.130.0-255,5738,301938,33,348372
9868,0.028422,172.31.33.0-255,66,302004,33,348372
9869,0.029012,172.31.33.0-255,172,302176,33,348372
9870,0.029043,172.31.33.0-255,1117,303293,33,348372
9871,0.029105,172.31.33.0-255,1514,304807,33,348372
9872,0.029107,172.31.33.0-255,1514,306321,33,348372
9873,0.029129,172.31.33.0-255,677,306998,33,348372
9874,0.030577,104.244.42.0-255,66,307064,33,348372
9875,0.030602,104.244.42.0-255,66,307130,33,348372
9876,0.030646,104.244.42.0-255,66,307196,33,348372
9877,0.030657,104.244.42.0-255,66,307262,33,348372
9878,0.030984,74.125.130.0-255,5738,313000,33,348372
9879,0.030989,172.31.33.0-255,66,313066,33,348372
9880,0.033567,74.125.130.0-255,5738,318804,33,348372
9881,0.033573,172.31.33.0-255,66,318870,33,348372
9882,0.036134,74.125.130.0-255,5738,324608,33,348372
9883,0.03614,172.31.33.0-255,66,324674,33,348372
9884,0.038712,74.125.130.0-255,5738,330412,33,348372
9885,0.038717,172.31.33.0-255,66,330478,33,348372
9886,0.041284,74.125.130.0-255,5738,336216,33,348372
9887,0.04129,172.31.33.0-255,66,336282,33,348372
9888,0.043852,74.125.130.0-255,5738,342020,33,348372
9889,0.04386,172.31.33.0-255,66,342086,33,348372
9890,0.046439,74.125.130.0-255,5738,347824,33,348372
9891,0.046445,172.31.33.0-255,66,347890,33,348372
9892,0.049191,74.125.130.0-255,245,348135,33,348372
9893,0.049311,172.31.33.0-255,66,348201,33,348372
9894,0.049344,172.31.33.0-255,105,348306,33,348372
9895,0.051864,74.125.130.0-255,66,348372,33,348372
9896,0.0,172.217.194.0-255,298,298,33,225761
9897,3.2e-05,172.31.33.0-255,66,364,33,225761
9898,4e-05,172.217.194.0-255,1484,1848,33,225761
9899,4.5e-05,172.31.33.0-255,66,1914,33,225761
9900,5e-05,172.217.194.0-255,4320,6234,33,225761
9901,5.3e-05,172.31.33.0-255,66,6300,33,225761
9902,6e-05,172.217.194.0-255,5738,12038,33,225761
9903,6.3e-05,172.31.33.0-255,66,12104,33,225761
9904,6.9e-05,172.217.194.0-255,5738,17842,33,225761
9905,7.1e-05,172.31.33.0-255,66,17908,33,225761
9906,0.000107,172.217.194.0-255,6110,24018,33,225761
9907,0.000109,172.31.33.0-255,66,24084,33,225761
9908,0.000116,172.217.194.0-255,6797,30881,33,225761
9909,0.000118,172.31.33.0-255,66,30947,33,225761
9910,0.000136,172.217.194.0-255,1484,32431,33,225761
9911,0.000139,172.31.33.0-255,66,32497,33,225761
9912,0.000162,172.217.194.0-255,2902,35399,33,225761
9913,0.000165,172.31.33.0-255,66,35465,33,225761
9914,0.000171,172.217.194.0-255,5738,41203,33,225761
9915,0.000173,172.31.33.0-255,66,41269,33,225761
9916,0.000213,172.31.33.0-255,66,41335,33,225761
9917,0.000225,172.31.33.0-255,66,41401,33,225761
9918,0.000227,172.217.194.0-255,378,41779,33,225761
9919,0.000229,172.31.33.0-255,66,41845,33,225761
9920,0.000295,172.217.194.0-255,100,41945,33,225761
9921,0.000299,172.31.33.0-255,66,42011,33,225761
9922,0.000406,172.217.194.0-255,1484,43495,33,225761
9923,0.000409,172.31.33.0-255,66,43561,33,225761
9924,0.000413,172.217.194.0-255,2902,46463,33,225761
9925,0.00042,172.31.33.0-255,66,46529,33,225761
9926,0.000428,172.217.194.0-255,4320,50849,33,225761
9927,0.00043,172.31.33.0-255,66,50915,33,225761
9928,0.000445,172.217.194.0-255,1484,52399,33,225761
9929,0.000479,172.31.33.0-255,66,52465,33,225761
9930,0.000491,172.31.33.0-255,66,52531,33,225761
9931,0.000527,172.217.194.0-255,2902,55433,33,225761
9932,0.00053,172.31.33.0-255,66,55499,33,225761
9933,0.000566,172.31.33.0-255,66,55565,33,225761
9934,0.00058,172.31.33.0-255,66,55631,33,225761
9935,0.000602,172.217.194.0-255,5738,61369,33,225761
9936,0.000605,172.31.33.0-255,66,61435,33,225761
9937,0.000623,172.217.194.0-255,2184,63619,33,225761
9938,0.000625,172.31.33.0-255,66,63685,33,225761
9939,0.00063,172.217.194.0-255,4320,68005,33,225761
9940,0.000632,172.31.33.0-255,66,68071,33,225761
9941,0.000646,172.217.194.0-255,4320,72391,33,225761
9942,0.000649,172.31.33.0-255,66,72457,33,225761
9943,0.000654,172.217.194.0-255,5738,78195,33,225761
9944,0.000656,172.31.33.0-255,66,78261,33,225761
9945,0.000673,172.217.194.0-255,1484,79745,33,225761
9946,0.00068,172.217.194.0-255,7156,86901,33,225761
9947,0.000682,172.31.33.0-255,66,86967,33,225761
9948,0.000704,172.217.194.0-255,1484,88451,33,225761
9949,0.00071,172.217.194.0-255,6438,94889,33,225761
9950,0.000712,172.31.33.0-255,66,94955,33,225761
9951,0.000753,172.217.194.0-255,2902,97857,33,225761
9952,0.000756,172.31.33.0-255,66,97923,33,225761
9953,0.00076,172.217.194.0-255,4320,102243,33,225761
9954,0.000762,172.31.33.0-255,66,102309,33,225761
9955,0.000824,172.31.33.0-255,66,102375,33,225761
9956,0.00084,172.31.33.0-255,66,102441,33,225761
9957,0.000862,172.217.194.0-255,1484,103925,33,225761
9958,0.000865,172.217.194.0-255,1484,105409,33,225761
9959,0.000868,172.31.33.0-255,66,105475,33,225761
9960,0.000881,172.217.194.0-255,1484,106959,33,225761
9961,0.000886,172.217.194.0-255,5738,112697,33,225761
9962,0.000888,172.31.33.0-255,66,112763,33,225761
9963,0.000917,172.31.33.0-255,66,112829,33,225761
9964,0.000956,172.217.194.0-255,4320,117149,33,225761
9965,0.00096,172.31.33.0-255,66,117215,33,225761
9966,0.00098,172.217.194.0-255,6438,123653,33,225761
9967,0.000983,172.31.33.0-255,66,123719,33,225761
9968,0.0011,172.217.194.0-255,1484,125203,33,225761
9969,0.001115,172.217.194.0-255,2902,128105,33,225761
9970,0.001118,172.31.33.0-255,66,128171,33,225761
9971,0.001121,172.217.194.0-255,1484,129655,33,225761
9972,0.001138,172.217.194.0-255,4320,133975,33,225761
9973,0.00114,172.31.33.0-255,66,134041,33,225761
9974,0.001153,172.31.33.0-255,66,134107,33,225761
9975,0.001176,172.217.194.0-255,4320,138427,33,225761
9976,0.001178,172.31.33.0-255,66,138493,33,225761
9977,0.001182,172.217.194.0-255,2902,141395,33,225761
9978,0.001184,172.31.33.0-255,66,141461,33,225761
9979,0.001211,172.217.194.0-255,2902,144363,33,225761
9980,0.001213,172.31.33.0-255,66,144429,33,225761
9981,0.00123,172.217.194.0-255,5020,149449,33,225761
9982,0.001232,172.31.33.0-255,66,149515,33,225761
9983,0.001295,172.217.194.0-255,1484,150999,33,225761
9984,0.001317,172.217.194.0-255,2902,153901,33,225761
9985,0.00132,172.31.33.0-255,66,153967,33,225761
9986,0.001324,172.217.194.0-255,2902,156869,33,225761
9987,0.001325,172.31.33.0-255,66,156935,33,225761
9988,0.001337,172.217.194.0-255,2902,159837,33,225761
9989,0.001339,172.31.33.0-255,66,159903,33,225761
9990,0.001345,172.217.194.0-255,5738,165641,33,225761
9991,0.001346,172.31.33.0-255,66,165707,33,225761
9992,0.001361,172.217.194.0-255,7156,172863,33,225761
9993,0.001364,172.31.33.0-255,66,172929,33,225761
9994,0.001366,172.217.194.0-255,1484,174413,33,225761
9995,0.001389,172.217.194.0-255,2902,177315,33,225761
9996,0.001391,172.31.33.0-255,66,177381,33,225761
9997,0.001396,172.217.194.0-255,5738,183119,33,225761
9998,0.001399,172.31.33.0-255,66,183185,33,225761
9999,0.001408,172.217.194.0-255,1484,184669,33,225761
10000,0.001428,172.217.194.0-255,2184,186853,33,225761
10001,0.00143,172.31.33.0-255,66,186919,33,225761
10002,0.001435,172.217.194.0-255,4320,191239,33,225761
10003,0.001437,172.31.33.0-255,66,191305,33,225761
10004,0.001448,172.217.194.0-255,1484,192789,33,225761
10005,0.001462,172.217.194.0-255,5738,198527,33,225761
10006,0.001464,172.31.33.0-255,66,198593,33,225761
10007,0.001484,172.217.194.0-255,2902,201495,33,225761
10008,0.001486,172.31.33.0-255,66,201561,33,225761
10009,0.001489,172.217.194.0-255,1484,203045,33,225761
10010,0.001514,172.31.33.0-255,66,203111,33,225761
10011,0.001533,172.217.194.0-255,766,203877,33,225761
10012,0.00155,172.31.33.0-255,66,203943,33,225761
10013,0.001578,172.217.194.0-255,7156,211099,33,225761
10014,0.001581,172.31.33.0-255,66,211165,33,225761
10015,0.001612,172.217.194.0-255,2902,214067,33,225761
10016,0.001614,172.31.33.0-255,66,214133,33,225761
10017,0.001636,172.31.33.0-255,66,214199,33,225761
10018,0.001661,172.217.194.0-255,1484,215683,33,225761
10019,0.001667,172.217.194.0-255,5389,221072,33,225761
10020,0.00167,172.31.33.0-255,66,221138,33,225761
10021,0.001684,172.217.194.0-255,105,221243,33,225761
10022,0.003149,172.31.33.0-255,66,221309,33,225761
10023,0.003175,172.31.33.0-255,105,221414,33,225761
10024,0.005221,172.217.194.0-255,66,221480,33,225761
10025,0.036379,172.31.33.0-255,172,221652,33,225761
10026,0.036406,172.31.33.0-255,1117,222769,33,225761
10027,0.036453,172.31.33.0-255,1514,224283,33,225761
10028,0.036455,172.31.33.0-255,1280,225563,33,225761
10029,0.037917,104.244.42.0-255,66,225629,33,225761
10030,0.037955,104.244.42.0-255,66,225695,33,225761
10031,0.038008,104.244.42.0-255,66,225761,33,225761
10032,0.0,172.31.33.0-255,105,105,33,459
10033,0.000321,172.31.33.0-255,90,195,33,459
10034,0.000331,172.31.33.0-255,66,261,33,459
10035,0.002704,74.125.200.0-255,66,327,33,459
10036,0.002717,74.125.200.0-255,66,393,33,459
10037,0.002725,172.31.33.0-255,66,459,33,459
10038,0.0,216.58.221.0-255,153,153,33,342800
10039,2.8e-05,172.31.33.0-255,66,219,33,342800
10040,3.4e-05,216.58.221.0-255,1484,1703,33,342800
10041,3.9e-05,172.31.33.0-255,66,1769,33,342800
10042,4.2e-05,216.58.221.0-255,1484,3253,33,342800
10043,4.4e-05,172.31.33.0-255,66,3319,33,342800
10044,5.6e-05,216.58.221.0-255,2902,6221,33,342800
10045,5.9e-05,172.31.33.0-255,66,6287,33,342800
10046,6.5e-05,216.58.221.0-255,5738,12025,33,342800
10047,6.8e-05,172.31.33.0-255,66,12091,33,342800
10048,0.000116,172.31.33.0-255,66,12157,33,342800
10049,0.000143,216.58.221.0-255,5379,17536,33,342800
10050,0.000147,172.31.33.0-255,66,17602,33,342800
10051,0.000176,216.58.221.0-255,5738,23340,33,342800
10052,0.000179,172.31.33.0-255,66,23406,33,342800
10053,0.000183,216.58.221.0-255,2902,26308,33,342800
10054,0.000186,172.31.33.0-255,66,26374,33,342800
10055,0.000209,216.58.221.0-255,5738,32112,33,342800
10056,0.000217,172.31.33.0-255,66,32178,33,342800
10057,0.000237,216.58.221.0-255,2543,34721,33,342800
10058,0.00024,172.31.33.0-255,66,34787,33,342800
10059,0.000265,216.58.221.0-255,2902,37689,33,342800
10060,0.000269,172.31.33.0-255,66,37755,33,342800
10061,0.000295,216.58.221.0-255,1484,39239,33,342800
10062,0.000299,172.31.33.0-255,66,39305,33,342800
10063,0.00033,216.58.221.0-255,5738,45043,33,342800
10064,0.000334,172.31.33.0-255,66,45109,33,342800
10065,0.000342,216.58.221.0-255,6797,51906,33,342800
10066,0.000344,172.31.33.0-255,66,51972,33,342800
10067,0.000352,216.58.221.0-255,356,52328,33,342800
10068,0.000356,172.31.33.0-255,66,52394,33,342800
10069,0.000876,216.58.221.0-255,137,52531,33,342800
10070,0.000992,216.58.221.0-255,1484,54015,33,342800
10071,0.000997,172.31.33.0-255,66,54081,33,342800
10072,0.001003,216.58.221.0-255,2902,56983,33,342800
10073,0.001005,172.31.33.0-255,66,57049,33,342800
10074,0.001008,216.58.221.0-255,1484,58533,33,342800
10075,0.001032,216.58.221.0-255,4320,62853,33,342800
10076,0.001035,172.31.33.0-255,66,62919,33,342800
10077,0.001039,216.58.221.0-255,1484,64403,33,342800
10078,0.001061,216.58.221.0-255,5379,69782,33,342800
10079,0.001078,216.58.221.0-255,4320,74102,33,342800
10080,0.001088,216.58.221.0-255,2902,77004,33,342800
10081,0.001101,216.58.221.0-255,1484,78488,33,342800
10082,0.001114,216.58.221.0-255,2902,81390,33,342800
10083,0.001128,216.58.221.0-255,4320,85710,33,342800
10084,0.001171,216.58.221.0-255,1125,86835,33,342800
10085,0.001266,216.58.221.0-255,1484,88319,33,342800
10086,0.001271,216.58.221.0-255,1484,89803,33,342800
10087,0.001282,216.58.221.0-255,1484,91287,33,342800
10088,0.001288,216.58.221.0-255,4320,95607,33,342800
10089,0.001309,216.58.221.0-255,1484,97091,33,342800
10090,0.001314,216.58.221.0-255,4320,101411,33,342800
10091,0.001319,216.58.221.0-255,5738,107149,33,342800
10092,0.001321,216.58.221.0-255,1484,108633,33,342800
10093,0.001361,216.58.221.0-255,2184,110817,33,342800
10094,0.001393,216.58.221.0-255,1484,112301,33,342800
10095,0.001403,216.58.221.0-255,2902,115203,33,342800
10096,0.001418,216.58.221.0-255,5738,120941,33,342800
10097,0.001498,216.58.221.0-255,766,121707,33,342800
10098,0.001761,216.58.221.0-255,1484,123191,33,342800
10099,0.001764,216.58.221.0-255,1484,124675,33,342800
10100,0.001774,216.58.221.0-255,1484,126159,33,342800
10101,0.001778,216.58.221.0-255,2902,129061,33,342800
10102,0.001795,216.58.221.0-255,2902,131963,33,342800
10103,0.001814,216.58.221.0-255,5738,137701,33,342800
10104,0.001829,216.58.221.0-255,7156,144857,33,342800
10105,0.001835,216.58.221.0-255,7156,152013,33,342800
10106,0.001865,216.58.221.0-255,3602,155615,33,342800
10107,0.001894,216.58.221.0-255,2902,158517,33,342800
10108,0.001907,216.58.221.0-255,1484,160001,33,342800
10109,0.001912,216.58.221.0-255,2902,162903,33,342800
10110,0.001933,216.58.221.0-255,7156,170059,33,342800
10111,0.003699,172.31.33.0-255,66,170125,33,342800
10112,0.005647,216.58.221.0-255,5738,175863,33,342800
10113,0.005653,172.31.33.0-255,66,175929,33,342800
10114,0.007576,216.58.221.0-255,5738,181667,33,342800
10115,0.007582,172.31.33.0-255,66,181733,33,342800
10116,0.009508,216.58.221.0-255,5738,187471,33,342800
10117,0.009515,172.31.33.0-255,66,187537,33,342800
10118,0.011459,216.58.221.0-255,5738,193275,33,342800
10119,0.011467,172.31.33.0-255,66,193341,33,342800
10120,0.013391,216.58.221.0-255,5738,199079,33,342800
10121,0.013397,172.31.33.0-255,66,199145,33,342800
10122,0.015324,216.58.221.0-255,5738,204883,33,342800
10123,0.015332,172.31.33.0-255,66,204949,33,342800
10124,0.017255,216.58.221.0-255,5738,210687,33,342800
10125,0.01726,172.31.33.0-255,66,210753,33,342800
10126,0.019183,216.58.221.0-255,5738,216491,33,342800
10127,0.01919,172.31.33.0-255,66,216557,33,342800
10128,0.021113,216.58.221.0-255,5738,222295,33,342800
10129,0.021119,172.31.33.0-255,66,222361,33,342800
10130,0.023045,216.58.221.0-255,5738,228099,33,342800
10131,0.023051,172.31.33.0-255,66,228165,33,342800
10132,0.024976,216.58.221.0-255,5738,233903,33,342800
10133,0.024983,172.31.33.0-255,66,233969,33,342800
10134,0.026916,216.58.221.0-255,5738,239707,33,342800
10135,0.026922,172.31.33.0-255,66,239773,33,342800
10136,0.02748,172.31.33.0-255,167,239940,33,342800
10137,0.027523,172.31.33.0-255,1113,241053,33,342800
10138,0.027597,172.31.33.0-255,1514,242567,33,342800
10139,0.027599,172.31.33.0-255,1173,243740,33,342800
10140,0.028837,216.58.221.0-255,4320,248060,33,342800
10141,0.028842,172.31.33.0-255,66,248126,33,342800
10142,0.02887,216.58.221.0-255,1484,249610,33,342800
10143,0.029001,104.244.42.0-255,66,249676,33,342800
10144,0.029092,104.244.42.0-255,66,249742,33,342800
10145,0.029137,104.244.42.0-255,66,249808,33,342800
10146,0.030758,216.58.221.0-255,2902,252710,33,342800
10147,0.030762,172.31.33.0-255,66,252776,33,342800
10148,0.030789,216.58.221.0-255,1484,254260,33,342800
10149,0.032688,216.58.221.0-255,4320,258580,33,342800
10150,0.032695,172.31.33.0-255,66,258646,33,342800
10151,0.03464,216.58.221.0-255,5738,264384,33,342800
10152,0.034645,172.31.33.0-255,66,264450,33,342800
10153,0.036564,216.58.221.0-255,5738,270188,33,342800
10154,0.036569,172.31.33.0-255,66,270254,33,342800
10155,0.038512,216.58.221.0-255,5738,275992,33,342800
10156,0.038516,172.31.33.0-255,66,276058,33,342800
10157,0.04044,216.58.221.0-255,5738,281796,33,342800
10158,0.040445,172.31.33.0-255,66,281862,33,342800
10159,0.042363,216.58.221.0-255,5738,287600,33,342800
10160,0.04237,172.31.33.0-255,66,287666,33,342800
10161,0.044291,216.58.221.0-255,5738,293404,33,342800
10162,0.044297,172.31.33.0-255,66,293470,33,342800
10163,0.046216,216.58.221.0-255,2902,296372,33,342800
10164,0.04622,172.31.33.0-255,66,296438,33,342800
10165,0.046248,216.58.221.0-255,2902,299340,33,342800
10166,0.04625,172.31.33.0-255,66,299406,33,342800
10167,0.048145,216.58.221.0-255,2902,302308,33,342800
10168,0.04815,172.31.33.0-255,66,302374,33,342800
10169,0.048179,216.58.221.0-255,2902,305276,33,342800
10170,0.048182,172.31.33.0-255,66,305342,33,342800
10171,0.050069,216.58.221.0-255,2902,308244,33,342800
10172,0.050075,172.31.33.0-255,66,308310,33,342800
10173,0.050104,216.58.221.0-255,2902,311212,33,342800
10174,0.050108,172.31.33.0-255,66,311278,33,342800
10175,0.051997,216.58.221.0-255,2902,314180,33,342800
10176,0.052002,172.31.33.0-255,66,314246,33,342800
10177,0.052042,216.58.221.0-255,2902,317148,33,342800
10178,0.052045,172.31.33.0-255,66,317214,33,342800
10179,0.05392,216.58.221.0-255,2902,320116,33,342800
10180,0.053924,172.31.33.0-255,66,320182,33,342800
10181,0.053958,216.58.221.0-255,2902,323084,33,342800
10182,0.053964,172.31.33.0-255,66,323150,33,342800
10183,0.055871,216.58.221.0-255,5738,328888,33,342800
10184,0.055876,172.31.33.0-255,66,328954,33,342800
10185,0.05779,216.58.221.0-255,4320,333274,33,342800
10186,0.057795,172.31.33.0-255,66,333340,33,342800
10187,0.057819,216.58.221.0-255,1484,334824,33,342800
10188,0.059713,216.58.221.0-255,4320,339144,33,342800
10189,0.059718,172.31.33.0-255,66,339210,33,342800
10190,0.061643,216.58.221.0-255,3353,342563,33,342800
10191,0.061649,172.31.33.0-255,66,342629,33,342800
10192,0.061926,172.31.33.0-255,105,342734,33,342800
10193,0.063811,216.58.221.0-255,66,342800,33,342800
10194,0.0,172.31.33.0-255,105,105,33,735
10195,0.002052,157.240.7.0-255,105,210,33,735
10196,0.002063,172.31.33.0-255,66,276,33,735
10197,0.010995,172.31.33.0-255,105,381,33,735
10198,0.011309,172.31.33.0-255,90,471,33,735
10199,0.01132,172.31.33.0-255,66,537,33,735
10200,0.013531,74.125.68.0-255,66,603,33,735
10201,0.013546,74.125.68.0-255,66,669,33,735
10202,0.01356,172.31.33.0-255,66,735,33,735
10203,0.0,172.217.194.0-255,296,296,33,229582
10204,1.9e-05,172.31.33.0-255,66,362,33,229582
10205,2.5e-05,172.217.194.0-255,1484,1846,33,229582
10206,2.8e-05,172.31.33.0-255,66,1912,33,229582
10207,3.4e-05,172.217.194.0-255,4320,6232,33,229582
10208,3.7e-05,172.31.33.0-255,66,6298,33,229582
10209,7.1e-05,172.31.33.0-255,66,6364,33,229582
10210,9.3e-05,172.217.194.0-255,5738,12102,33,229582
10211,9.5e-05,172.31.33.0-255,66,12168,33,229582
10212,0.000118,172.31.33.0-255,66,12234,33,229582
10213,0.000245,172.217.194.0-255,1484,13718,33,229582
10214,0.00025,172.31.33.0-255,66,13784,33,229582
10215,0.000255,172.217.194.0-255,2902,16686,33,229582
10216,0.000257,172.31.33.0-255,66,16752,33,229582
10217,0.000264,172.217.194.0-255,5738,22490,33,229582
10218,0.000266,172.31.33.0-255,66,22556,33,229582
10219,0.000302,172.217.194.0-255,4320,26876,33,229582
10220,0.000304,172.31.33.0-255,66,26942,33,229582
10221,0.000329,172.217.194.0-255,2902,29844,33,229582
10222,0.000331,172.31.33.0-255,66,29910,33,229582
10223,0.000341,172.31.33.0-255,66,29976,33,229582
10224,0.000347,172.217.194.0-255,5738,35714,33,229582
10225,0.000349,172.31.33.0-255,66,35780,33,229582
10226,0.00038,172.217.194.0-255,2527,38307,33,229582
10227,0.000382,172.31.33.0-255,66,38373,33,229582
10228,0.000418,172.217.194.0-255,365,38738,33,229582
10229,0.000421,172.31.33.0-255,66,38804,33,229582
10230,0.000686,172.31.33.0-255,101,38905,33,229582
10231,0.000794,172.217.194.0-255,1484,40389,33,229582
10232,0.000799,172.217.194.0-255,1484,41873,33,229582
10233,0.000801,172.31.33.0-255,66,41939,33,229582
10234,0.000822,172.217.194.0-255,1484,43423,33,229582
10235,0.000829,172.217.194.0-255,5738,49161,33,229582
10236,0.000831,172.31.33.0-255,66,49227,33,229582
10237,0.000853,172.217.194.0-255,5738,54965,33,229582
10238,0.000855,172.31.33.0-255,66,55031,33,229582
10239,0.000871,172.217.194.0-255,5738,60769,33,229582
10240,0.000872,172.31.33.0-255,66,60835,33,229582
10241,0.000885,172.31.33.0-255,66,60901,33,229582
10242,0.000903,172.217.194.0-255,766,61667,33,229582
10243,0.000933,172.217.194.0-255,5738,67405,33,229582
10244,0.000938,172.31.33.0-255,66,67471,33,229582
10245,0.000957,172.217.194.0-255,7156,74627,33,229582
10246,0.00096,172.31.33.0-255,66,74693,33,229582
10247,0.000971,172.31.33.0-255,66,74759,33,229582
10248,0.001046,172.31.33.0-255,66,74825,33,229582
10249,0.001063,172.217.194.0-255,766,75591,33,229582
10250,0.001188,172.217.194.0-255,1484,77075,33,229582
10251,0.001192,172.31.33.0-255,66,77141,33,229582
10252,0.001197,172.217.194.0-255,2902,80043,33,229582
10253,0.001199,172.31.33.0-255,66,80109,33,229582
10254,0.001222,172.217.194.0-255,5738,85847,33,229582
10255,0.001224,172.31.33.0-255,66,85913,33,229582
10256,0.001258,172.31.33.0-255,66,85979,33,229582
10257,0.001275,172.217.194.0-255,2902,88881,33,229582
10258,0.001278,172.31.33.0-255,66,88947,33,229582
10259,0.001306,172.217.194.0-255,5738,94685,33,229582
10260,0.001309,172.31.33.0-255,66,94751,33,229582
10261,0.00133,172.217.194.0-255,5020,99771,33,229582
10262,0.001335,172.31.33.0-255,66,99837,33,229582
10263,0.001345,172.217.194.0-255,2902,102739,33,229582
10264,0.001348,172.31.33.0-255,66,102805,33,229582
10265,0.001362,172.217.194.0-255,4320,107125,33,229582
10266,0.001364,172.31.33.0-255,66,107191,33,229582
10267,0.001392,172.217.194.0-255,4320,111511,33,229582
10268,0.001405,172.217.194.0-255,1484,112995,33,229582
10269,0.001412,172.31.33.0-255,66,113061,33,229582
10270,0.001415,172.31.33.0-255,66,113127,33,229582
10271,0.001422,172.217.194.0-255,6438,119565,33,229582
10272,0.001425,172.31.33.0-255,66,119631,33,229582
10273,0.001545,172.217.194.0-255,1484,121115,33,229582
10274,0.001559,172.217.194.0-255,2902,124017,33,229582
10275,0.001562,172.31.33.0-255,66,124083,33,229582
10276,0.001566,172.217.194.0-255,2902,126985,33,229582
10277,0.001568,172.31.33.0-255,66,127051,33,229582
10278,0.001581,172.217.194.0-255,2902,129953,33,229582
10279,0.001583,172.31.33.0-255,66,130019,33,229582
10280,0.001622,172.31.33.0-255,66,130085,33,229582
10281,0.001631,172.31.33.0-255,66,130151,33,229582
10282,0.001666,172.217.194.0-255,2184,132335,33,229582
10283,0.001668,172.31.33.0-255,66,132401,33,229582
10284,0.001966,172.217.194.0-255,1484,133885,33,229582
10285,0.001985,172.217.194.0-255,2902,136787,33,229582
10286,0.001988,172.31.33.0-255,66,136853,33,229582
10287,0.002009,172.217.194.0-255,5738,142591,33,229582
10288,0.002011,172.31.33.0-255,66,142657,33,229582
10289,0.002028,172.217.194.0-255,5738,148395,33,229582
10290,0.00203,172.31.33.0-255,66,148461,33,229582
10291,0.002048,172.217.194.0-255,4320,152781,33,229582
10292,0.00205,172.31.33.0-255,66,152847,33,229582
10293,0.002092,172.31.33.0-255,66,152913,33,229582
10294,0.002104,172.31.33.0-255,66,152979,33,229582
10295,0.002157,172.31.33.0-255,66,153045,33,229582
10296,0.00218,172.217.194.0-255,2902,155947,33,229582
10297,0.002182,172.31.33.0-255,66,156013,33,229582
10298,0.00221,172.31.33.0-255,66,156079,33,229582
10299,0.002241,172.217.194.0-255,1484,157563,33,229582
10300,0.002265,172.31.33.0-255,66,157629,33,229582
10301,0.002268,172.217.194.0-255,766,158395,33,229582
10302,0.003033,172.217.194.0-255,66,158461,33,229582
10303,0.004658,172.217.194.0-255,4320,162781,33,229582
10304,0.004665,172.31.33.0-255,66,162847,33,229582
10305,0.007048,172.217.194.0-255,4320,167167,33,229582
10306,0.007053,172.31.33.0-255,66,167233,33,229582
10307,0.007071,172.217.194.0-255,1484,168717,33,229582
10308,0.009439,172.217.194.0-255,4320,173037,33,229582
10309,0.009444,172.31.33.0-255,66,173103,33,229582
10310,0.011851,172.217.194.0-255,5738,178841,33,229582
10311,0.011859,172.31.33.0-255,66,178907,33,229582
10312,0.014254,172.217.194.0-255,5738,184645,33,229582
10313,0.014267,172.31.33.0-255,66,184711,33,229582
10314,0.016677,172.217.194.0-255,5738,190449,33,229582
10315,0.016686,172.31.33.0-255,66,190515,33,229582
10316,0.019085,172.217.194.0-255,5738,196253,33,229582
10317,0.019093,172.31.33.0-255,66,196319,33,229582
10318,0.021469,172.217.194.0-255,5738,202057,33,229582
10319,0.021475,172.31.33.0-255,66,202123,33,229582
10320,0.02387,172.217.194.0-255,5738,207861,33,229582
10321,0.023877,172.31.33.0-255,66,207927,33,229582
10322,0.02465,172.31.33.0-255,172,208099,33,229582
10323,0.024678,172.31.33.0-255,1117,209216,33,229582
10324,0.024712,172.31.33.0-255,1514,210730,33,229582
10325,0.024713,172.31.33.0-255,1514,212244,33,229582
10326,0.024714,172.31.33.0-255,676,212920,33,229582
10327,0.02629,172.217.194.0-255,5738,218658,33,229582
10328,0.026297,172.31.33.0-255,66,218724,33,229582
10329,0.026319,104.244.42.0-255,66,218790,33,229582
10330,0.026361,104.244.42.0-255,66,218856,33,229582
10331,0.026411,104.244.42.0-255,66,218922,33,229582
10332,0.026415,104.244.42.0-255,66,218988,33,229582
10333,0.028694,172.217.194.0-255,4320,223308,33,229582
10334,0.028701,172.31.33.0-255,66,223374,33,229582
10335,0.028731,172.217.194.0-255,1484,224858,33,229582
10336,0.031095,172.217.194.0-255,4320,229178,33,229582
10337,0.0311,172.31.33.0-255,66,229244,33,229582
10338,0.03346,172.217.194.0-255,167,229411,33,229582
10339,0.033597,172.31.33.0-255,105,229516,33,229582
10340,0.040453,172.217.194.0-255,66,229582,33,229582
10341,0.0,172.31.33.0-255,105,105,33,459
10342,0.00019,172.31.33.0-255,90,195,33,459
10343,0.000198,172.31.33.0-255,66,261,33,459
10344,0.002763,74.125.24.0-255,66,327,33,459
10345,0.002788,74.125.24.0-255,66,393,33,459
10346,0.002809,172.31.33.0-255,66,459,33,459
10347,0.0,172.217.27.0-255,66,66,33,132
10348,0.031748,172.31.33.0-255,66,132,33,132
10349,0.0,172.31.33.0-255,105,105,33,525
10350,0.000287,172.31.33.0-255,90,195,33,525
10351,0.000297,172.31.33.0-255,66,261,33,525
10352,0.002663,74.125.24.0-255,66,327,33,525
10353,0.002692,74.125.24.0-255,66,393,33,525
10354,0.002697,172.31.33.0-255,66,459,33,525
10355,0.0027,74.125.24.0-255,66,525,33,525
10356,0.0,172.31.33.0-255,105,105,33,1194
10357,0.001748,157.240.7.0-255,105,210,33,1194
10358,0.001758,172.31.33.0-255,66,276,33,1194
10359,0.005713,172.31.33.0-255,105,381,33,1194
10360,0.005789,172.31.33.0-255,105,486,33,1194
10361,0.005923,172.31.33.0-255,90,576,33,1194
10362,0.005931,172.31.33.0-255,66,642,33,1194
10363,0.00606,172.31.33.0-255,90,732,33,1194
10364,0.006067,172.31.33.0-255,66,798,33,1194
10365,0.008163,74.125.130.0-255,66,864,33,1194
10366,0.008174,74.125.130.0-255,66,930,33,1194
10367,0.008182,172.31.33.0-255,66,996,33,1194
10368,0.008615,74.125.200.0-255,66,1062,33,1194
10369,0.008648,74.125.200.0-255,66,1128,33,1194
10370,0.00865,172.31.33.0-255,66,1194,33,1194
10371,0.0,74.125.68.0-255,153,153,33,297386
10372,1.6e-05,172.31.33.0-255,66,219,33,297386
10373,4.7e-05,74.125.68.0-255,1484,1703,33,297386
10374,5.2e-05,172.31.33.0-255,66,1769,33,297386
10375,5.7e-05,74.125.68.0-255,2902,4671,33,297386
10376,6e-05,172.31.33.0-255,66,4737,33,297386
10377,8.5e-05,74.125.68.0-255,4320,9057,33,297386
10378,8.8e-05,172.31.33.0-255,66,9123,33,297386
10379,9.2e-05,74.125.68.0-255,2902,12025,33,297386
10380,9.4e-05,172.31.33.0-255,66,12091,33,297386
10381,0.000121,74.125.68.0-255,1994,14085,33,297386
10382,0.000123,172.31.33.0-255,66,14151,33,297386
10383,0.000125,74.125.68.0-255,1484,15635,33,297386
10384,0.000127,172.31.33.0-255,66,15701,33,297386
10385,0.000148,74.125.68.0-255,2902,18603,33,297386
10386,0.000153,172.31.33.0-255,66,18669,33,297386
10387,0.000159,74.125.68.0-255,5738,24407,33,297386
10388,0.000161,172.31.33.0-255,66,24473,33,297386
10389,0.000163,74.125.68.0-255,1484,25957,33,297386
10390,0.000165,172.31.33.0-255,66,26023,33,297386
10391,0.000183,74.125.68.0-255,1484,27507,33,297386
10392,0.000185,172.31.33.0-255,66,27573,33,297386
10393,0.00019,74.125.68.0-255,3961,31534,33,297386
10394,0.000192,172.31.33.0-255,66,31600,33,297386
10395,0.000349,74.125.68.0-255,1484,33084,33,297386
10396,0.000353,172.31.33.0-255,66,33150,33,297386
10397,0.000376,74.125.68.0-255,2902,36052,33,297386
10398,0.000378,172.31.33.0-255,66,36118,33,297386
10399,0.000415,74.125.68.0-255,4320,40438,33,297386
10400,0.000417,172.31.33.0-255,66,40504,33,297386
10401,0.00042,74.125.68.0-255,1484,41988,33,297386
10402,0.000421,172.31.33.0-255,66,42054,33,297386
10403,0.00045,74.125.68.0-255,2902,44956,33,297386
10404,0.000452,172.31.33.0-255,66,45022,33,297386
10405,0.000473,74.125.68.0-255,2902,47924,33,297386
10406,0.000475,172.31.33.0-255,66,47990,33,297386
10407,0.000499,74.125.68.0-255,2902,50892,33,297386
10408,0.000501,172.31.33.0-255,66,50958,33,297386
10409,0.000525,74.125.68.0-255,1484,52442,33,297386
10410,0.000542,74.125.68.0-255,4320,56762,33,297386
10411,0.000545,172.31.33.0-255,66,56828,33,297386
10412,0.000555,74.125.68.0-255,1484,58312,33,297386
10413,0.000575,74.125.68.0-255,5738,64050,33,297386
10414,0.000578,172.31.33.0-255,66,64116,33,297386
10415,0.000603,74.125.68.0-255,1484,65600,33,297386
10416,0.000618,74.125.68.0-255,766,66366,33,297386
10417,0.000621,172.31.33.0-255,66,66432,33,297386
10418,0.000782,74.125.68.0-255,363,66795,33,297386
10419,0.000812,74.125.68.0-255,124,66919,33,297386
10420,0.001949,74.125.68.0-255,1484,68403,33,297386
10421,0.001956,172.31.33.0-255,66,68469,33,297386
10422,0.001984,74.125.68.0-255,2902,71371,33,297386
10423,0.001987,172.31.33.0-255,66,71437,33,297386
10424,0.00199,74.125.68.0-255,1484,72921,33,297386
10425,0.002015,74.125.68.0-255,2902,75823,33,297386
10426,0.002017,172.31.33.0-255,66,75889,33,297386
10427,0.002023,74.125.68.0-255,5738,81627,33,297386
10428,0.002025,172.31.33.0-255,66,81693,33,297386
10429,0.002068,74.125.68.0-255,4320,86013,33,297386
10430,0.00207,172.31.33.0-255,66,86079,33,297386
10431,0.002075,74.125.68.0-255,5738,91817,33,297386
10432,0.002077,172.31.33.0-255,66,91883,33,297386
10433,0.00211,74.125.68.0-255,5738,97621,33,297386
10434,0.002113,172.31.33.0-255,66,97687,33,297386
10435,0.002144,74.125.68.0-255,3602,101289,33,297386
10436,0.002147,172.31.33.0-255,66,101355,33,297386
10437,0.004441,74.125.68.0-255,1484,102839,33,297386
10438,0.00448,74.125.68.0-255,4320,107159,33,297386
10439,0.004484,172.31.33.0-255,66,107225,33,297386
10440,0.006846,74.125.68.0-255,5738,112963,33,297386
10441,0.006851,172.31.33.0-255,66,113029,33,297386
10442,0.009189,74.125.68.0-255,5738,118767,33,297386
10443,0.009196,172.31.33.0-255,66,118833,33,297386
10444,0.011537,74.125.68.0-255,5738,124571,33,297386
10445,0.011546,172.31.33.0-255,66,124637,33,297386
10446,0.013885,74.125.68.0-255,5738,130375,33,297386
10447,0.013891,172.31.33.0-255,66,130441,33,297386
10448,0.01624,74.125.68.0-255,5738,136179,33,297386
10449,0.016246,172.31.33.0-255,66,136245,33,297386
10450,0.01859,74.125.68.0-255,5738,141983,33,297386
10451,0.0186,172.31.33.0-255,66,142049,33,297386
10452,0.020973,74.125.68.0-255,5738,147787,33,297386
10453,0.020989,172.31.33.0-255,66,147853,33,297386
10454,0.023334,74.125.68.0-255,5738,153591,33,297386
10455,0.023344,172.31.33.0-255,66,153657,33,297386
10456,0.025705,74.125.68.0-255,5738,159395,33,297386
10457,0.025712,172.31.33.0-255,66,159461,33,297386
10458,0.025841,172.31.33.0-255,172,159633,33,297386
10459,0.025865,172.31.33.0-255,1113,160746,33,297386
10460,0.025919,172.31.33.0-255,1514,162260,33,297386
10461,0.025921,172.31.33.0-255,1514,163774,33,297386
10462,0.025945,172.31.33.0-255,680,164454,33,297386
10463,0.027382,104.244.42.0-255,66,164520,33,297386
10464,0.027389,104.244.42.0-255,66,164586,33,297386
10465,0.02746,104.244.42.0-255,66,164652,33,297386
10466,0.027463,104.244.42.0-255,66,164718,33,297386
10467,0.028041,74.125.68.0-255,5738,170456,33,297386
10468,0.028045,172.31.33.0-255,66,170522,33,297386
10469,0.030378,74.125.68.0-255,5738,176260,33,297386
10470,0.030383,172.31.33.0-255,66,176326,33,297386
10471,0.032728,74.125.68.0-255,5738,182064,33,297386
10472,0.032733,172.31.33.0-255,66,182130,33,297386
10473,0.035068,74.125.68.0-255,5738,187868,33,297386
10474,0.035075,172.31.33.0-255,66,187934,33,297386
10475,0.037424,74.125.68.0-255,5738,193672,33,297386
10476,0.037431,172.31.33.0-255,66,193738,33,297386
10477,0.039787,74.125.68.0-255,5738,199476,33,297386
10478,0.039795,172.31.33.0-255,66,199542,33,297386
10479,0.042124,74.125.68.0-255,4320,203862,33,297386
10480,0.042131,172.31.33.0-255,66,203928,33,297386
10481,0.042154,74.125.68.0-255,1484,205412,33,297386
10482,0.044471,74.125.68.0-255,4320,209732,33,297386
10483,0.044477,172.31.33.0-255,66,209798,33,297386
10484,0.046813,74.125.68.0-255,5738,215536,33,297386
10485,0.046819,172.31.33.0-255,66,215602,33,297386
10486,0.049167,74.125.68.0-255,5738,221340,33,297386
10487,0.049172,172.31.33.0-255,66,221406,33,297386
10488,0.051516,74.125.68.0-255,5738,227144,33,297386
10489,0.051524,172.31.33.0-255,66,227210,33,297386
10490,0.053856,74.125.68.0-255,5738,232948,33,297386
10491,0.05386,172.31.33.0-255,66,233014,33,297386
10492,0.056195,74.125.68.0-255,2902,235916,33,297386
10493,0.056201,172.31.33.0-255,66,235982,33,297386
10494,0.056226,74.125.68.0-255,2902,238884,33,297386
10495,0.056229,172.31.33.0-255,66,238950,33,297386
10496,0.058525,74.125.68.0-255,2902,241852,33,297386
10497,0.058531,172.31.33.0-255,66,241918,33,297386
10498,0.058555,74.125.68.0-255,2902,244820,33,297386
10499,0.058557,172.31.33.0-255,66,244886,33,297386
10500,0.060856,74.125.68.0-255,2902,247788,33,297386
10501,0.060861,172.31.33.0-255,66,247854,33,297386
10502,0.060892,74.125.68.0-255,2902,250756,33,297386
10503,0.060894,172.31.33.0-255,66,250822,33,297386
10504,0.063209,74.125.68.0-255,2902,253724,33,297386
10505,0.063215,172.31.33.0-255,66,253790,33,297386
10506,0.063244,74.125.68.0-255,2902,256692,33,297386
10507,0.063247,172.31.33.0-255,66,256758,33,297386
10508,0.065562,74.125.68.0-255,5738,262496,33,297386
10509,0.065571,172.31.33.0-255,66,262562,33,297386
10510,0.067912,74.125.68.0-255,5738,268300,33,297386
10511,0.067919,172.31.33.0-255,66,268366,33,297386
10512,0.070291,74.125.68.0-255,5738,274104,33,297386
10513,0.070297,172.31.33.0-255,66,274170,33,297386
10514,0.07264,74.125.68.0-255,5738,279908,33,297386
10515,0.072645,172.31.33.0-255,66,279974,33,297386
10516,0.074977,74.125.68.0-255,5738,285712,33,297386
10517,0.074982,172.31.33.0-255,66,285778,33,297386
10518,0.077329,74.125.68.0-255,5738,291516,33,297386
10519,0.077336,172.31.33.0-255,66,291582,33,297386
10520,0.079682,74.125.68.0-255,5738,297320,33,297386
10521,0.079692,172.31.33.0-255,66,297386,33,297386
10522,0.0,74.125.24.0-255,219,219,33,173952
10523,1.1e-05,172.31.33.0-255,66,285,33,173952
10524,1.6e-05,74.125.24.0-255,1484,1769,33,173952
10525,2.1e-05,172.31.33.0-255,66,1835,33,173952
10526,4.8e-05,74.125.24.0-255,4320,6155,33,173952
10527,5.1e-05,172.31.33.0-255,66,6221,33,173952
10528,7.5e-05,172.31.33.0-255,66,6287,33,173952
10529,0.000115,172.31.33.0-255,66,6353,33,173952
10530,0.000143,74.125.24.0-255,3961,10314,33,173952
10531,0.000145,172.31.33.0-255,66,10380,33,173952
10532,0.000188,74.125.24.0-255,4320,14700,33,173952
10533,0.000191,172.31.33.0-255,66,14766,33,173952
10534,0.000193,74.125.24.0-255,1484,16250,33,173952
10535,0.000195,172.31.33.0-255,66,16316,33,173952
10536,0.000202,74.125.24.0-255,7156,23472,33,173952
10537,0.000209,172.31.33.0-255,66,23538,33,173952
10538,0.00023,74.125.24.0-255,4320,27858,33,173952
10539,0.000233,172.31.33.0-255,66,27924,33,173952
10540,0.000278,172.31.33.0-255,66,27990,33,173952
10541,0.000283,74.125.24.0-255,4273,32263,33,173952
10542,0.000285,172.31.33.0-255,66,32329,33,173952
10543,0.000287,74.125.24.0-255,110,32439,33,173952
10544,0.00029,172.31.33.0-255,66,32505,33,173952
10545,0.000361,74.125.24.0-255,1484,33989,33,173952
10546,0.000364,172.31.33.0-255,66,34055,33,173952
10547,0.000369,74.125.24.0-255,2902,36957,33,173952
10548,0.000371,172.31.33.0-255,66,37023,33,173952
10549,0.000376,74.125.24.0-255,5738,42761,33,173952
10550,0.000382,172.31.33.0-255,66,42827,33,173952
10551,0.000416,172.31.33.0-255,66,42893,33,173952
10552,0.000513,172.31.33.0-255,66,42959,33,173952
10553,0.000707,74.125.24.0-255,1484,44443,33,173952
10554,0.000721,74.125.24.0-255,2902,47345,33,173952
10555,0.000724,172.31.33.0-255,66,47411,33,173952
10556,0.000728,74.125.24.0-255,2902,50313,33,173952
10557,0.000749,74.125.24.0-255,2902,53215,33,173952
10558,0.000756,74.125.24.0-255,7156,60371,33,173952
10559,0.000787,172.31.33.0-255,66,60437,33,173952
10560,0.000827,74.125.24.0-255,4320,64757,33,173952
10561,0.000835,172.31.33.0-255,66,64823,33,173952
10562,0.000857,74.125.24.0-255,5738,70561,33,173952
10563,0.000862,172.31.33.0-255,66,70627,33,173952
10564,0.000877,74.125.24.0-255,5020,75647,33,173952
10565,0.000894,172.31.33.0-255,66,75713,33,173952
10566,0.000917,74.125.24.0-255,1484,77197,33,173952
10567,0.000922,74.125.24.0-255,2902,80099,33,173952
10568,0.000926,172.31.33.0-255,66,80165,33,173952
10569,0.000937,74.125.24.0-255,5738,85903,33,173952
10570,0.000956,74.125.24.0-255,7156,93059,33,173952
10571,0.00097,74.125.24.0-255,1484,94543,33,173952
10572,0.000973,172.31.33.0-255,66,94609,33,173952
10573,0.001055,172.31.33.0-255,66,94675,33,173952
10574,0.001066,74.125.24.0-255,1484,96159,33,173952
10575,0.00108,172.31.33.0-255,66,96225,33,173952
10576,0.001146,172.31.33.0-255,66,96291,33,173952
10577,0.001169,74.125.24.0-255,5738,102029,33,173952
10578,0.00118,172.31.33.0-255,66,102095,33,173952
10579,0.001211,74.125.24.0-255,4320,106415,33,173952
10580,0.001222,172.31.33.0-255,66,106481,33,173952
10581,0.001229,74.125.24.0-255,1484,107965,33,173952
10582,0.001234,74.125.24.0-255,7156,115121,33,173952
10583,0.001277,172.31.33.0-255,66,115187,33,173952
10584,0.001314,74.125.24.0-255,6438,121625,33,173952
10585,0.001316,74.125.24.0-255,1484,123109,33,173952
10586,0.001327,172.31.33.0-255,66,123175,33,173952
10587,0.001339,74.125.24.0-255,2902,126077,33,173952
10588,0.001347,74.125.24.0-255,5738,131815,33,173952
10589,0.001376,74.125.24.0-255,4320,136135,33,173952
10590,0.001378,172.31.33.0-255,66,136201,33,173952
10591,0.001383,172.31.33.0-255,66,136267,33,173952
10592,0.001404,74.125.24.0-255,4320,140587,33,173952
10593,0.001418,172.31.33.0-255,66,140653,33,173952
10594,0.001426,74.125.24.0-255,2184,142837,33,173952
10595,0.001445,74.125.24.0-255,2902,145739,33,173952
10596,0.001448,74.125.24.0-255,1484,147223,33,173952
10597,0.001452,172.31.33.0-255,66,147289,33,173952
10598,0.001478,74.125.24.0-255,5738,153027,33,173952
10599,0.001502,74.125.24.0-255,7156,160183,33,173952
10600,0.001514,74.125.24.0-255,2902,163085,33,173952
10601,0.001517,172.31.33.0-255,66,163151,33,173952
10602,0.001521,172.31.33.0-255,66,163217,33,173952
10603,0.001548,74.125.24.0-255,5129,168346,33,173952
10604,0.001578,74.125.24.0-255,105,168451,33,173952
10605,0.001583,172.31.33.0-255,66,168517,33,173952
10606,0.003898,172.31.33.0-255,105,168622,33,173952
10607,0.006185,74.125.24.0-255,66,168688,33,173952
10608,0.029004,172.31.33.0-255,176,168864,33,173952
10609,0.029038,172.31.33.0-255,1117,169981,33,173952
10610,0.029108,172.31.33.0-255,1514,171495,33,173952
10611,0.02911,172.31.33.0-255,1514,173009,33,173952
10612,0.029131,172.31.33.0-255,679,173688,33,173952
10613,0.030484,104.244.42.0-255,66,173754,33,173952
10614,0.030516,104.244.42.0-255,66,173820,33,173952
10615,0.030607,104.244.42.0-255,66,173886,33,173952
10616,0.030626,104.244.42.0-255,66,173952,33,173952
10617,0.0,74.125.24.0-255,297,297,33,290774
10618,1.4e-05,172.31.33.0-255,66,363,33,290774
10619,2e-05,74.125.24.0-255,1484,1847,33,290774
10620,2.4e-05,172.31.33.0-255,66,1913,33,290774
10621,3e-05,74.125.24.0-255,4320,6233,33,290774
10622,3.4e-05,172.31.33.0-255,66,6299,33,290774
10623,6.3e-05,172.31.33.0-255,66,6365,33,290774
10624,7.6e-05,172.31.33.0-255,66,6431,33,290774
10625,0.000114,74.125.24.0-255,6797,13228,33,290774
10626,0.000117,172.31.33.0-255,66,13294,33,290774
10627,0.000586,74.125.24.0-255,1484,14778,33,290774
10628,0.000591,172.31.33.0-255,66,14844,33,290774
10629,0.000595,74.125.24.0-255,1484,16328,33,290774
10630,0.000597,172.31.33.0-255,66,16394,33,290774
10631,0.000626,74.125.24.0-255,1484,17878,33,290774
10632,0.000629,172.31.33.0-255,66,17944,33,290774
10633,0.000635,74.125.24.0-255,5738,23682,33,290774
10634,0.000637,172.31.33.0-255,66,23748,33,290774
10635,0.00066,74.125.24.0-255,6797,30545,33,290774
10636,0.000662,172.31.33.0-255,66,30611,33,290774
10637,0.000685,74.125.24.0-255,7156,37767,33,290774
10638,0.000687,172.31.33.0-255,66,37833,33,290774
10639,0.000707,74.125.24.0-255,1484,39317,33,290774
10640,0.000709,172.31.33.0-255,66,39383,33,290774
10641,0.000744,172.31.33.0-255,66,39449,33,290774
10642,0.000747,74.125.24.0-255,111,39560,33,290774
10643,0.000749,172.31.33.0-255,66,39626,33,290774
10644,0.000787,74.125.24.0-255,330,39956,33,290774
10645,0.00079,172.31.33.0-255,66,40022,33,290774
10646,0.000943,74.125.24.0-255,1484,41506,33,290774
10647,0.000949,74.125.24.0-255,2902,44408,33,290774
10648,0.000952,172.31.33.0-255,66,44474,33,290774
10649,0.000957,74.125.24.0-255,5738,50212,33,290774
10650,0.000959,172.31.33.0-255,66,50278,33,290774
10651,0.000995,172.31.33.0-255,66,50344,33,290774
10652,0.001011,74.125.24.0-255,1484,51828,33,290774
10653,0.001036,74.125.24.0-255,5738,57566,33,290774
10654,0.001039,172.31.33.0-255,66,57632,33,290774
10655,0.001065,74.125.24.0-255,5020,62652,33,290774
10656,0.001068,172.31.33.0-255,66,62718,33,290774
10657,0.003092,74.125.24.0-255,5738,68456,33,290774
10658,0.003099,172.31.33.0-255,66,68522,33,290774
10659,0.005135,74.125.24.0-255,5738,74260,33,290774
10660,0.005141,172.31.33.0-255,66,74326,33,290774
10661,0.007174,74.125.24.0-255,5738,80064,33,290774
10662,0.007181,172.31.33.0-255,66,80130,33,290774
10663,0.009222,74.125.24.0-255,2902,83032,33,290774
10664,0.009228,172.31.33.0-255,66,83098,33,290774
10665,0.009254,74.125.24.0-255,2902,86000,33,290774
10666,0.009257,172.31.33.0-255,66,86066,33,290774
10667,0.01128,74.125.24.0-255,2902,88968,33,290774
10668,0.011287,172.31.33.0-255,66,89034,33,290774
10669,0.011323,74.125.24.0-255,2902,91936,33,290774
10670,0.011326,172.31.33.0-255,66,92002,33,290774
10671,0.013314,74.125.24.0-255,2902,94904,33,290774
10672,0.013321,172.31.33.0-255,66,94970,33,290774
10673,0.013349,74.125.24.0-255,2902,97872,33,290774
10674,0.013352,172.31.33.0-255,66,97938,33,290774
10675,0.015387,74.125.24.0-255,5738,103676,33,290774
10676,0.015396,172.31.33.0-255,66,103742,33,290774
10677,0.017438,74.125.24.0-255,5738,109480,33,290774
10678,0.017445,172.31.33.0-255,66,109546,33,290774
10679,0.019473,74.125.24.0-255,5738,115284,33,290774
10680,0.01948,172.31.33.0-255,66,115350,33,290774
10681,0.021032,172.31.33.0-255,172,115522,33,290774
10682,0.02106,172.31.33.0-255,1113,116635,33,290774
10683,0.02111,172.31.33.0-255,1514,118149,33,290774
10684,0.021129,172.31.33.0-255,1514,119663,33,290774
10685,0.021133,172.31.33.0-255,1514,121177,33,290774
10686,0.021147,172.31.33.0-255,951,122128,33,290774
10687,0.021511,74.125.24.0-255,5738,127866,33,290774
10688,0.021517,172.31.33.0-255,66,127932,33,290774
10689,0.022594,104.244.42.0-255,66,127998,33,290774
10690,0.022601,104.244.42.0-255,66,128064,33,290774
10691,0.022677,104.244.42.0-255,66,128130,33,290774
10692,0.022682,104.244.42.0-255,66,128196,33,290774
10693,0.022685,104.244.42.0-255,66,128262,33,290774
10694,0.023563,74.125.24.0-255,5738,134000,33,290774
10695,0.023567,172.31.33.0-255,66,134066,33,290774
10696,0.025627,74.125.24.0-255,5738,139804,33,290774
10697,0.025633,172.31.33.0-255,66,139870,33,290774
10698,0.027692,74.125.24.0-255,5738,145608,33,290774
10699,0.027699,172.31.33.0-255,66,145674,33,290774
10700,0.029755,74.125.24.0-255,5738,151412,33,290774
10701,0.029761,172.31.33.0-255,66,151478,33,290774
10702,0.031806,74.125.24.0-255,5738,157216,33,290774
10703,0.031812,172.31.33.0-255,66,157282,33,290774
10704,0.033864,74.125.24.0-255,5738,163020,33,290774
10705,0.03387,172.31.33.0-255,66,163086,33,290774
10706,0.035912,74.125.24.0-255,5738,168824,33,290774
10707,0.035918,172.31.33.0-255,66,168890,33,290774
10708,0.037973,74.125.24.0-255,5738,174628,33,290774
10709,0.03798,172.31.33.0-255,66,174694,33,290774
10710,0.040068,74.125.24.0-255,5738,180432,33,290774
10711,0.040076,172.31.33.0-255,66,180498,33,290774
10712,0.042132,74.125.24.0-255,5738,186236,33,290774
10713,0.042139,172.31.33.0-255,66,186302,33,290774
10714,0.044233,74.125.24.0-255,5738,192040,33,290774
10715,0.04424,172.31.33.0-255,66,192106,33,290774
10716,0.046275,74.125.24.0-255,5738,197844,33,290774
10717,0.046281,172.31.33.0-255,66,197910,33,290774
10718,0.048341,74.125.24.0-255,5738,203648,33,290774
10719,0.048347,172.31.33.0-255,66,203714,33,290774
10720,0.05042,74.125.24.0-255,5738,209452,33,290774
10721,0.050426,172.31.33.0-255,66,209518,33,290774
10722,0.052465,74.125.24.0-255,5738,215256,33,290774
10723,0.052471,172.31.33.0-255,66,215322,33,290774
10724,0.0545,74.125.24.0-255,5738,221060,33,290774
10725,0.054507,172.31.33.0-255,66,221126,33,290774
10726,0.056561,74.125.24.0-255,5738,226864,33,290774
10727,0.056568,172.31.33.0-255,66,226930,33,290774
10728,0.058618,74.125.24.0-255,5738,232668,33,290774
10729,0.058623,172.31.33.0-255,66,232734,33,290774
10730,0.060672,74.125.24.0-255,5738,238472,33,290774
10731,0.060679,172.31.33.0-255,66,238538,33,290774
10732,0.062716,74.125.24.0-255,5738,244276,33,290774
10733,0.062721,172.31.33.0-255,66,244342,33,290774
10734,0.064759,74.125.24.0-255,5738,250080,33,290774
10735,0.064765,172.31.33.0-255,66,250146,33,290774
10736,0.066835,74.125.24.0-255,5738,255884,33,290774
10737,0.066841,172.31.33.0-255,66,255950,33,290774
10738,0.068949,74.125.24.0-255,5738,261688,33,290774
10739,0.068955,172.31.33.0-255,66,261754,33,290774
10740,0.071003,74.125.24.0-255,5738,267492,33,290774
10741,0.071009,172.31.33.0-255,66,267558,33,290774
10742,0.073065,74.125.24.0-255,5738,273296,33,290774
10743,0.073071,172.31.33.0-255,66,273362,33,290774
10744,0.075133,74.125.24.0-255,5738,279100,33,290774
10745,0.07514,172.31.33.0-255,66,279166,33,290774
10746,0.077178,74.125.24.0-255,5738,284904,33,290774
10747,0.077184,172.31.33.0-255,66,284970,33,290774
10748,0.079251,74.125.24.0-255,5738,290708,33,290774
10749,0.079258,172.31.33.0-255,66,290774,33,290774
10750,0.0,74.125.68.0-255,152,152,33,323744
10751,2.2e-05,172.31.33.0-255,66,218,33,323744
10752,5.3e-05,74.125.68.0-255,1484,1702,33,323744
10753,5.7e-05,172.31.33.0-255,66,1768,33,323744
10754,6.8e-05,74.125.68.0-255,1484,3252,33,323744
10755,7.2e-05,172.31.33.0-255,66,3318,33,323744
10756,7.4e-05,74.125.68.0-255,1484,4802,33,323744
10757,7.6e-05,172.31.33.0-255,66,4868,33,323744
10758,0.0001,74.125.68.0-255,1484,6352,33,323744
10759,0.000102,172.31.33.0-255,66,6418,33,323744
10760,0.000112,74.125.68.0-255,4320,10738,33,323744
10761,0.000114,172.31.33.0-255,66,10804,33,323744
10762,0.000136,74.125.68.0-255,1484,12288,33,323744
10763,0.000139,172.31.33.0-255,66,12354,33,323744
10764,0.000148,74.125.68.0-255,2057,14411,33,323744
10765,0.00015,172.31.33.0-255,66,14477,33,323744
10766,0.000864,74.125.68.0-255,1484,15961,33,323744
10767,0.000869,172.31.33.0-255,66,16027,33,323744
10768,0.000876,74.125.68.0-255,1484,17511,33,323744
10769,0.000878,172.31.33.0-255,66,17577,33,323744
10770,0.000889,74.125.68.0-255,2902,20479,33,323744
10771,0.000891,172.31.33.0-255,66,20545,33,323744
10772,0.000895,74.125.68.0-255,1484,22029,33,323744
10773,0.000896,172.31.33.0-255,66,22095,33,323744
10774,0.000931,74.125.68.0-255,4320,26415,33,323744
10775,0.000934,172.31.33.0-255,66,26481,33,323744
10776,0.00094,74.125.68.0-255,5379,31860,33,323744
10777,0.000943,172.31.33.0-255,66,31926,33,323744
10778,0.001073,74.125.68.0-255,1484,33410,33,323744
10779,0.001077,172.31.33.0-255,66,33476,33,323744
10780,0.001082,74.125.68.0-255,2902,36378,33,323744
10781,0.001083,172.31.33.0-255,66,36444,33,323744
10782,0.001109,74.125.68.0-255,2902,39346,33,323744
10783,0.001112,172.31.33.0-255,66,39412,33,323744
10784,0.00113,74.125.68.0-255,2902,42314,33,323744
10785,0.001132,172.31.33.0-255,66,42380,33,323744
10786,0.001136,74.125.68.0-255,2902,45282,33,323744
10787,0.001138,172.31.33.0-255,66,45348,33,323744
10788,0.001152,74.125.68.0-255,1484,46832,33,323744
10789,0.001171,74.125.68.0-255,2543,49375,33,323744
10790,0.001173,172.31.33.0-255,66,49441,33,323744
10791,0.001183,74.125.68.0-255,1484,50925,33,323744
10792,0.001203,74.125.68.0-255,2902,53827,33,323744
10793,0.001205,172.31.33.0-255,66,53893,33,323744
10794,0.001227,74.125.68.0-255,4320,58213,33,323744
10795,0.001229,172.31.33.0-255,66,58279,33,323744
10796,0.001249,74.125.68.0-255,1484,59763,33,323744
10797,0.001265,74.125.68.0-255,7067,66830,33,323744
10798,0.001267,172.31.33.0-255,66,66896,33,323744
10799,0.001378,74.125.68.0-255,135,67031,33,323744
10800,0.001686,74.125.68.0-255,1484,68515,33,323744
10801,0.001688,172.31.33.0-255,66,68581,33,323744
10802,0.00171,74.125.68.0-255,2902,71483,33,323744
10803,0.001712,172.31.33.0-255,66,71549,33,323744
10804,0.001715,74.125.68.0-255,1484,73033,33,323744
10805,0.001737,74.125.68.0-255,4320,77353,33,323744
10806,0.001739,172.31.33.0-255,66,77419,33,323744
10807,0.001745,74.125.68.0-255,5738,83157,33,323744
10808,0.001747,172.31.33.0-255,66,83223,33,323744
10809,0.00175,74.125.68.0-255,2902,86125,33,323744
10810,0.001756,172.31.33.0-255,66,86191,33,323744
10811,0.001774,74.125.68.0-255,4320,90511,33,323744
10812,0.001776,172.31.33.0-255,66,90577,33,323744
10813,0.001799,74.125.68.0-255,7156,97733,33,323744
10814,0.001801,172.31.33.0-255,66,97799,33,323744
10815,0.001823,74.125.68.0-255,3602,101401,33,323744
10816,0.001825,172.31.33.0-255,66,101467,33,323744
10817,0.001846,74.125.68.0-255,5738,107205,33,323744
10818,0.001848,172.31.33.0-255,66,107271,33,323744
10819,0.001852,74.125.68.0-255,2902,110173,33,323744
10820,0.001854,172.31.33.0-255,66,110239,33,323744
10821,0.001874,74.125.68.0-255,4320,114559,33,323744
10822,0.001876,172.31.33.0-255,66,114625,33,323744
10823,0.00189,74.125.68.0-255,1484,116109,33,323744
10824,0.001911,74.125.68.0-255,7156,123265,33,323744
10825,0.001913,172.31.33.0-255,66,123331,33,323744
10826,0.001949,172.31.33.0-255,66,123397,33,323744
10827,0.001959,74.125.68.0-255,2184,125581,33,323744
10828,0.001966,172.31.33.0-255,66,125647,33,323744
10829,0.001969,74.125.68.0-255,346,125993,33,323744
10830,0.003772,172.31.33.0-255,66,126059,33,323744
10831,0.004209,74.125.68.0-255,4320,130379,33,323744
10832,0.004215,172.31.33.0-255,66,130445,33,323744
10833,0.006027,74.125.68.0-255,1484,131929,33,323744
10834,0.006479,74.125.68.0-255,4320,136249,33,323744
10835,0.006485,172.31.33.0-255,66,136315,33,323744
10836,0.00875,74.125.68.0-255,5738,142053,33,323744
10837,0.008759,172.31.33.0-255,66,142119,33,323744
10838,0.011024,74.125.68.0-255,5738,147857,33,323744
10839,0.01103,172.31.33.0-255,66,147923,33,323744
10840,0.013305,74.125.68.0-255,5738,153661,33,323744
10841,0.013314,172.31.33.0-255,66,153727,33,323744
10842,0.015616,74.125.68.0-255,5738,159465,33,323744
10843,0.015621,172.31.33.0-255,66,159531,33,323744
10844,0.01649,172.31.33.0-255,172,159703,33,323744
10845,0.016513,172.31.33.0-255,1117,160820,33,323744
10846,0.016557,172.31.33.0-255,1514,162334,33,323744
10847,0.016558,172.31.33.0-255,1514,163848,33,323744
10848,0.016563,172.31.33.0-255,1514,165362,33,323744
10849,0.016564,172.31.33.0-255,1514,166876,33,323744
10850,0.01659,172.31.33.0-255,456,167332,33,323744
10851,0.017886,74.125.68.0-255,5738,173070,33,323744
10852,0.017893,172.31.33.0-255,66,173136,33,323744
10853,0.018029,104.244.42.0-255,66,173202,33,323744
10854,0.018035,104.244.42.0-255,66,173268,33,323744
10855,0.018149,104.244.42.0-255,66,173334,33,323744
10856,0.018154,104.244.42.0-255,66,173400,33,323744
10857,0.02014,74.125.68.0-255,5738,179138,33,323744
10858,0.020145,172.31.33.0-255,66,179204,33,323744
10859,0.022414,74.125.68.0-255,5738,184942,33,323744
10860,0.02242,172.31.33.0-255,66,185008,33,323744
10861,0.024684,74.125.68.0-255,5738,190746,33,323744
10862,0.02469,172.31.33.0-255,66,190812,33,323744
10863,0.026944,74.125.68.0-255,4320,195132,33,323744
10864,0.026948,172.31.33.0-255,66,195198,33,323744
10865,0.026973,74.125.68.0-255,1484,196682,33,323744
10866,0.029197,74.125.68.0-255,4320,201002,33,323744
10867,0.029202,172.31.33.0-255,66,201068,33,323744
10868,0.031455,74.125.68.0-255,4320,205388,33,323744
10869,0.03146,172.31.33.0-255,66,205454,33,323744
10870,0.03149,74.125.68.0-255,1484,206938,33,323744
10871,0.033718,74.125.68.0-255,4320,211258,33,323744
10872,0.033725,172.31.33.0-255,66,211324,33,323744
10873,0.035995,74.125.68.0-255,5738,217062,33,323744
10874,0.036,172.31.33.0-255,66,217128,33,323744
10875,0.038264,74.125.68.0-255,4320,221448,33,323744
10876,0.038269,172.31.33.0-255,66,221514,33,323744
10877,0.038306,74.125.68.0-255,1484,222998,33,323744
10878,0.040528,74.125.68.0-255,4320,227318,33,323744
10879,0.040534,172.31.33.0-255,66,227384,33,323744
10880,0.042789,74.125.68.0-255,2902,230286,33,323744
10881,0.042794,172.31.33.0-255,66,230352,33,323744
10882,0.042819,74.125.68.0-255,2902,233254,33,323744
10883,0.042822,172.31.33.0-255,66,233320,33,323744
10884,0.045061,74.125.68.0-255,4320,237640,33,323744
10885,0.045066,172.31.33.0-255,66,237706,33,323744
10886,0.045091,74.125.68.0-255,1484,239190,33,323744
10887,0.047337,74.125.68.0-255,4320,243510,33,323744
10888,0.047342,172.31.33.0-255,66,243576,33,323744
10889,0.049641,74.125.68.0-255,5738,249314,33,323744
10890,0.049646,172.31.33.0-255,66,249380,33,323744
10891,0.051912,74.125.68.0-255,5738,255118,33,323744
10892,0.051919,172.31.33.0-255,66,255184,33,323744
10893,0.054179,74.125.68.0-255,2902,258086,33,323744
10894,0.054185,172.31.33.0-255,66,258152,33,323744
10895,0.054214,74.125.68.0-255,2902,261054,33,323744
10896,0.054217,172.31.33.0-255,66,261120,33,323744
10897,0.05645,74.125.68.0-255,1484,262604,33,323744
10898,0.056488,74.125.68.0-255,4320,266924,33,323744
10899,0.056493,172.31.33.0-255,66,266990,33,323744
10900,0.058767,74.125.68.0-255,5738,272728,33,323744
10901,0.058771,172.31.33.0-255,66,272794,33,323744
10902,0.061026,74.125.68.0-255,4320,277114,33,323744
10903,0.061032,172.31.33.0-255,66,277180,33,323744
10904,0.061062,74.125.68.0-255,1484,278664,33,323744
10905,0.063303,74.125.68.0-255,4320,282984,33,323744
10906,0.06331,172.31.33.0-255,66,283050,33,323744
10907,0.065574,74.125.68.0-255,5738,288788,33,323744
10908,0.06558,172.31.33.0-255,66,288854,33,323744
10909,0.067848,74.125.68.0-255,5738,294592,33,323744
10910,0.067855,172.31.33.0-255,66,294658,33,323744
10911,0.070103,74.125.68.0-255,5738,300396,33,323744
10912,0.070107,172.31.33.0-255,66,300462,33,323744
10913,0.072373,74.125.68.0-255,5738,306200,33,323744
10914,0.072378,172.31.33.0-255,66,306266,33,323744
10915,0.074651,74.125.68.0-255,5738,312004,33,323744
10916,0.074657,172.31.33.0-255,66,312070,33,323744
10917,0.076921,74.125.68.0-255,5738,317808,33,323744
10918,0.076926,172.31.33.0-255,66,317874,33,323744
10919,0.079189,74.125.68.0-255,4320,322194,33,323744
10920,0.079194,172.31.33.0-255,66,322260,33,323744
10921,0.079215,74.125.68.0-255,1484,323744,33,323744
10922,0.0,104.244.42.0-255,439,439,33,505
10923,1.8e-05,172.31.33.0-255,66,505,33,505
10924,0.0,172.217.194.0-255,153,153,33,285679
10925,2.6e-05,172.31.33.0-255,66,219,33,285679
10926,3.1e-05,172.217.194.0-255,1484,1703,33,285679
10927,3.5e-05,172.31.33.0-255,66,1769,33,285679
10928,3.9e-05,172.217.194.0-255,2902,4671,33,285679
10929,5.1e-05,172.31.33.0-255,66,4737,33,285679
10930,5.4e-05,172.217.194.0-255,1484,6221,33,285679
10931,5.6e-05,172.31.33.0-255,66,6287,33,285679
10932,9.1e-05,172.217.194.0-255,5738,12025,33,285679
10933,9.4e-05,172.31.33.0-255,66,12091,33,285679
10934,9.8e-05,172.217.194.0-255,2019,14110,33,285679
10935,9.9e-05,172.31.33.0-255,66,14176,33,285679
10936,0.000455,172.217.194.0-255,1484,15660,33,285679
10937,0.00046,172.31.33.0-255,66,15726,33,285679
10938,0.000469,172.217.194.0-255,2902,18628,33,285679
10939,0.000471,172.31.33.0-255,66,18694,33,285679
10940,0.000483,172.217.194.0-255,5738,24432,33,285679
10941,0.000485,172.31.33.0-255,66,24498,33,285679
10942,0.000527,172.217.194.0-255,1484,25982,33,285679
10943,0.00053,172.31.33.0-255,66,26048,33,285679
10944,0.000558,172.217.194.0-255,5379,31427,33,285679
10945,0.000561,172.31.33.0-255,66,31493,33,285679
10946,0.000736,172.217.194.0-255,1484,32977,33,285679
10947,0.000741,172.31.33.0-255,66,33043,33,285679
10948,0.000747,172.217.194.0-255,2902,35945,33,285679
10949,0.000749,172.31.33.0-255,66,36011,33,285679
10950,0.000777,172.217.194.0-255,5738,41749,33,285679
10951,0.00078,172.31.33.0-255,66,41815,33,285679
10952,0.000786,172.217.194.0-255,6797,48612,33,285679
10953,0.000788,172.31.33.0-255,66,48678,33,285679
10954,0.000792,172.217.194.0-255,2902,51580,33,285679
10955,0.000799,172.31.33.0-255,66,51646,33,285679
10956,0.000831,172.217.194.0-255,4320,55966,33,285679
10957,0.000834,172.31.33.0-255,66,56032,33,285679
10958,0.000838,172.217.194.0-255,2902,58934,33,285679
10959,0.00084,172.31.33.0-255,66,59000,33,285679
10960,0.000869,172.217.194.0-255,7088,66088,33,285679
10961,0.000871,172.31.33.0-255,66,66154,33,285679
10962,0.001277,172.217.194.0-255,364,66518,33,285679
10963,0.001433,172.217.194.0-255,1484,68002,33,285679
10964,0.001435,172.31.33.0-255,66,68068,33,285679
10965,0.001439,172.217.194.0-255,2902,70970,33,285679
10966,0.001441,172.31.33.0-255,66,71036,33,285679
10967,0.001472,172.217.194.0-255,5738,76774,33,285679
10968,0.001475,172.31.33.0-255,66,76840,33,285679
10969,0.001478,172.217.194.0-255,2902,79742,33,285679
10970,0.00148,172.31.33.0-255,66,79808,33,285679
10971,0.001515,172.31.33.0-255,66,79874,33,285679
10972,0.001524,172.31.33.0-255,66,79940,33,285679
10973,0.001571,172.217.194.0-255,2184,82124,33,285679
10974,0.001573,172.31.33.0-255,66,82190,33,285679
10975,0.003699,172.217.194.0-255,2902,85092,33,285679
10976,0.003705,172.31.33.0-255,66,85158,33,285679
10977,0.003743,172.217.194.0-255,2902,88060,33,285679
10978,0.003746,172.31.33.0-255,66,88126,33,285679
10979,0.005914,172.217.194.0-255,2902,91028,33,285679
10980,0.00592,172.31.33.0-255,66,91094,33,285679
10981,0.00596,172.217.194.0-255,2902,93996,33,285679
10982,0.005963,172.31.33.0-255,66,94062,33,285679
10983,0.008117,172.217.194.0-255,2902,96964,33,285679
10984,0.008124,172.31.33.0-255,66,97030,33,285679
10985,0.008156,172.217.194.0-255,2902,99932,33,285679
10986,0.008159,172.31.33.0-255,66,99998,33,285679
10987,0.01032,172.217.194.0-255,2902,102900,33,285679
10988,0.010328,172.31.33.0-255,66,102966,33,285679
10989,0.010368,172.217.194.0-255,2902,105868,33,285679
10990,0.010372,172.31.33.0-255,66,105934,33,285679
10991,0.012498,172.217.194.0-255,2902,108836,33,285679
10992,0.012506,172.31.33.0-255,66,108902,33,285679
10993,0.012551,172.217.194.0-255,2902,111804,33,285679
10994,0.012555,172.31.33.0-255,66,111870,33,285679
10995,0.014702,172.217.194.0-255,2902,114772,33,285679
10996,0.014709,172.31.33.0-255,66,114838,33,285679
10997,0.014741,172.217.194.0-255,2902,117740,33,285679
10998,0.014743,172.31.33.0-255,66,117806,33,285679
10999,0.016876,172.217.194.0-255,2902,120708,33,285679
11000,0.016882,172.31.33.0-255,66,120774,33,285679
11001,0.016947,172.217.194.0-255,2902,123676,33,285679
11002,0.016951,172.31.33.0-255,66,123742,33,285679
11003,0.019073,172.217.194.0-255,2902,126644,33,285679
11004,0.019079,172.31.33.0-255,66,126710,33,285679
11005,0.019147,172.217.194.0-255,2902,129612,33,285679
11006,0.019152,172.31.33.0-255,66,129678,33,285679
11007,0.02129,172.217.194.0-255,2902,132580,33,285679
11008,0.021294,172.31.33.0-255,66,132646,33,285679
11009,0.021326,172.217.194.0-255,2902,135548,33,285679
11010,0.021328,172.31.33.0-255,66,135614,33,285679
11011,0.022893,172.31.33.0-255,176,135790,33,285679
11012,0.022918,172.31.33.0-255,1117,136907,33,285679
11013,0.022982,172.31.33.0-255,1514,138421,33,285679
11014,0.022984,172.31.33.0-255,1514,139935,33,285679
11015,0.023006,172.31.33.0-255,676,140611,33,285679
11016,0.023476,172.217.194.0-255,2902,143513,33,285679
11017,0.023482,172.31.33.0-255,66,143579,33,285679
11018,0.023513,172.217.194.0-255,2902,146481,33,285679
11019,0.023516,172.31.33.0-255,66,146547,33,285679
11020,0.024546,104.244.42.0-255,66,146613,33,285679
11021,0.024598,104.244.42.0-255,66,146679,33,285679
11022,0.02465,104.244.42.0-255,66,146745,33,285679
11023,0.024705,104.244.42.0-255,66,146811,33,285679
11024,0.025663,172.217.194.0-255,2902,149713,33,285679
11025,0.025667,172.31.33.0-255,66,149779,33,285679
11026,0.0257,172.217.194.0-255,2902,152681,33,285679
11027,0.025704,172.31.33.0-255,66,152747,33,285679
11028,0.027847,172.217.194.0-255,2902,155649,33,285679
11029,0.027852,172.31.33.0-255,66,155715,33,285679
11030,0.027882,172.217.194.0-255,2902,158617,33,285679
11031,0.027885,172.31.33.0-255,66,158683,33,285679
11032,0.030079,172.217.194.0-255,1484,160167,33,285679
11033,0.030107,172.217.194.0-255,4320,164487,33,285679
11034,0.030111,172.31.33.0-255,66,164553,33,285679
11035,0.032289,172.217.194.0-255,4320,168873,33,285679
11036,0.032295,172.31.33.0-255,66,168939,33,285679
11037,0.032326,172.217.194.0-255,1484,170423,33,285679
11038,0.034482,172.217.194.0-255,4320,174743,33,285679
11039,0.034486,172.31.33.0-255,66,174809,33,285679
11040,0.036694,172.217.194.0-255,5738,180547,33,285679
11041,0.0367,172.31.33.0-255,66,180613,33,285679
11042,0.038876,172.217.194.0-255,5738,186351,33,285679
11043,0.038882,172.31.33.0-255,66,186417,33,285679
11044,0.041065,172.217.194.0-255,5738,192155,33,285679
11045,0.041071,172.31.33.0-255,66,192221,33,285679
11046,0.043307,172.217.194.0-255,4320,196541,33,285679
11047,0.043312,172.31.33.0-255,66,196607,33,285679
11048,0.04334,172.217.194.0-255,1484,198091,33,285679
11049,0.045512,172.217.194.0-255,4320,202411,33,285679
11050,0.045517,172.31.33.0-255,66,202477,33,285679
11051,0.0477,172.217.194.0-255,5738,208215,33,285679
11052,0.047705,172.31.33.0-255,66,208281,33,285679
11053,0.049899,172.217.194.0-255,5738,214019,33,285679
11054,0.049904,172.31.33.0-255,66,214085,33,285679
11055,0.05212,172.217.194.0-255,5738,219823,33,285679
11056,0.052125,172.31.33.0-255,66,219889,33,285679
11057,0.054297,172.217.194.0-255,5738,225627,33,285679
11058,0.054302,172.31.33.0-255,66,225693,33,285679
11059,0.056521,172.217.194.0-255,5738,231431,33,285679
11060,0.056527,172.31.33.0-255,66,231497,33,285679
11061,0.058756,172.217.194.0-255,5738,237235,33,285679
11062,0.05876,172.31.33.0-255,66,237301,33,285679
11063,0.060951,172.217.194.0-255,5738,243039,33,285679
11064,0.060955,172.31.33.0-255,66,243105,33,285679
11065,0.063168,172.217.194.0-255,2902,246007,33,285679
11066,0.063174,172.31.33.0-255,66,246073,33,285679
11067,0.063203,172.217.194.0-255,2902,248975,33,285679
11068,0.063207,172.31.33.0-255,66,249041,33,285679
11069,0.0654,172.217.194.0-255,5738,254779,33,285679
11070,0.065405,172.31.33.0-255,66,254845,33,285679
11071,0.067623,172.217.194.0-255,4320,259165,33,285679
11072,0.067628,172.31.33.0-255,66,259231,33,285679
11073,0.067659,172.217.194.0-255,1484,260715,33,285679
11074,0.069892,172.217.194.0-255,2902,263617,33,285679
11075,0.069897,172.31.33.0-255,66,263683,33,285679
11076,0.069922,172.217.194.0-255,1484,265167,33,285679
11077,0.072139,172.217.194.0-255,4320,269487,33,285679
11078,0.072143,172.31.33.0-255,66,269553,33,285679
11079,0.074341,172.217.194.0-255,4320,273873,33,285679
11080,0.074346,172.31.33.0-255,66,273939,33,285679
11081,0.074373,172.217.194.0-255,1484,275423,33,285679
11082,0.076546,172.217.194.0-255,4320,279743,33,285679
11083,0.076552,172.31.33.0-255,66,279809,33,285679
11084,0.078761,172.217.194.0-255,4320,284129,33,285679
11085,0.078765,172.31.33.0-255,66,284195,33,285679
11086,0.078796,172.217.194.0-255,1484,285679,33,285679
11087,0.0,74.125.68.0-255,152,152,33,345923
11088,2.3e-05,172.31.33.0-255,66,218,33,345923
11089,3e-05,74.125.68.0-255,1484,1702,33,345923
11090,3.5e-05,172.31.33.0-255,66,1768,33,345923
11091,3.8e-05,74.125.68.0-255,1484,3252,33,345923
11092,4e-05,172.31.33.0-255,66,3318,33,345923
11093,6.7e-05,74.125.68.0-255,1484,4802,33,345923
11094,6.9e-05,172.31.33.0-255,66,4868,33,345923
11095,7.7e-05,74.125.68.0-255,5738,10606,33,345923
11096,7.9e-05,172.31.33.0-255,66,10672,33,345923
11097,8.2e-05,74.125.68.0-255,1484,12156,33,345923
11098,8.4e-05,172.31.33.0-255,66,12222,33,345923
11099,0.000108,74.125.68.0-255,2094,14316,33,345923
11100,0.000111,172.31.33.0-255,66,14382,33,345923
11101,0.000245,74.125.68.0-255,1484,15866,33,345923
11102,0.00025,172.31.33.0-255,66,15932,33,345923
11103,0.000256,74.125.68.0-255,2902,18834,33,345923
11104,0.000258,172.31.33.0-255,66,18900,33,345923
11105,0.000311,74.125.68.0-255,5738,24638,33,345923
11106,0.000315,172.31.33.0-255,66,24704,33,345923
11107,0.00032,74.125.68.0-255,2902,27606,33,345923
11108,0.000321,172.31.33.0-255,66,27672,33,345923
11109,0.000328,74.125.68.0-255,3961,31633,33,345923
11110,0.00033,172.31.33.0-255,66,31699,33,345923
11111,0.000356,74.125.68.0-255,4320,36019,33,345923
11112,0.000359,172.31.33.0-255,66,36085,33,345923
11113,0.000366,74.125.68.0-255,5738,41823,33,345923
11114,0.000368,172.31.33.0-255,66,41889,33,345923
11115,0.000393,74.125.68.0-255,4320,46209,33,345923
11116,0.000395,172.31.33.0-255,66,46275,33,345923
11117,0.000416,74.125.68.0-255,4320,50595,33,345923
11118,0.000419,172.31.33.0-255,66,50661,33,345923
11119,0.000432,74.125.68.0-255,1484,52145,33,345923
11120,0.000448,74.125.68.0-255,3602,55747,33,345923
11121,0.000461,74.125.68.0-255,362,56109,33,345923
11122,0.000503,74.125.68.0-255,127,56236,33,345923
11123,0.00054,172.31.33.0-255,66,56302,33,345923
11124,0.000548,74.125.68.0-255,1484,57786,33,345923
11125,0.000561,74.125.68.0-255,2902,60688,33,345923
11126,0.000584,74.125.68.0-255,2902,63590,33,345923
11127,0.000606,74.125.68.0-255,4320,67910,33,345923
11128,0.000612,172.31.33.0-255,66,67976,33,345923
11129,0.000633,74.125.68.0-255,7156,75132,33,345923
11130,0.000649,74.125.68.0-255,1484,76616,33,345923
11131,0.000656,74.125.68.0-255,5738,82354,33,345923
11132,0.000661,172.31.33.0-255,66,82420,33,345923
11133,0.000694,74.125.68.0-255,7156,89576,33,345923
11134,0.000697,74.125.68.0-255,766,90342,33,345923
11135,0.000702,172.31.33.0-255,66,90408,33,345923
11136,0.000847,74.125.68.0-255,1484,91892,33,345923
11137,0.000863,74.125.68.0-255,2902,94794,33,345923
11138,0.000867,74.125.68.0-255,1484,96278,33,345923
11139,0.000872,172.31.33.0-255,66,96344,33,345923
11140,0.000885,74.125.68.0-255,4320,100664,33,345923
11141,0.000899,172.31.33.0-255,66,100730,33,345923
11142,0.000919,74.125.68.0-255,2902,103632,33,345923
11143,0.000937,172.31.33.0-255,66,103698,33,345923
11144,0.000951,74.125.68.0-255,7156,110854,33,345923
11145,0.000956,74.125.68.0-255,5020,115874,33,345923
11146,0.000972,172.31.33.0-255,66,115940,33,345923
11147,0.001059,74.125.68.0-255,1484,117424,33,345923
11148,0.001077,74.125.68.0-255,2902,120326,33,345923
11149,0.001094,172.31.33.0-255,66,120392,33,345923
11150,0.001102,74.125.68.0-255,5738,126130,33,345923
11151,0.001106,74.125.68.0-255,2902,129032,33,345923
11152,0.001111,74.125.68.0-255,4320,133352,33,345923
11153,0.001122,172.31.33.0-255,66,133418,33,345923
11154,0.001134,74.125.68.0-255,4320,137738,33,345923
11155,0.001158,74.125.68.0-255,4320,142058,33,345923
11156,0.001164,74.125.68.0-255,5738,147796,33,345923
11157,0.00118,172.31.33.0-255,66,147862,33,345923
11158,0.001193,74.125.68.0-255,2184,150046,33,345923
11159,0.001208,172.31.33.0-255,66,150112,33,345923
11160,0.001236,74.125.68.0-255,2902,153014,33,345923
11161,0.00124,74.125.68.0-255,2902,155916,33,345923
11162,0.001247,172.31.33.0-255,66,155982,33,345923
11163,0.001267,74.125.68.0-255,4320,160302,33,345923
11164,0.001274,172.31.33.0-255,66,160368,33,345923
11165,0.001284,74.125.68.0-255,2902,163270,33,345923
11166,0.001297,74.125.68.0-255,5738,169008,33,345923
11167,0.001299,74.125.68.0-255,1484,170492,33,345923
11168,0.001314,74.125.68.0-255,2902,173394,33,345923
11169,0.00132,74.125.68.0-255,5738,179132,33,345923
11170,0.001323,172.31.33.0-255,66,179198,33,345923
11171,0.001332,172.31.33.0-255,66,179264,33,345923
11172,0.001363,74.125.68.0-255,6438,185702,33,345923
11173,0.001409,74.125.68.0-255,7156,192858,33,345923
11174,0.001422,172.31.33.0-255,66,192924,33,345923
11175,0.001425,74.125.68.0-255,1484,194408,33,345923
11176,0.001438,74.125.68.0-255,5738,200146,33,345923
11177,0.001448,172.31.33.0-255,66,200212,33,345923
11178,0.001461,74.125.68.0-255,5738,205950,33,345923
11179,0.001485,74.125.68.0-255,2902,208852,33,345923
11180,0.001504,74.125.68.0-255,353,209205,33,345923
11181,0.001506,172.31.33.0-255,66,209271,33,345923
11182,0.001512,172.31.33.0-255,66,209337,33,345923
11183,0.001545,74.125.68.0-255,1484,210821,33,345923
11184,0.001559,74.125.68.0-255,4320,215141,33,345923
11185,0.001568,172.31.33.0-255,66,215207,33,345923
11186,0.001587,74.125.68.0-255,1484,216691,33,345923
11187,0.001636,74.125.68.0-255,1484,218175,33,345923
11188,0.001649,74.125.68.0-255,4320,222495,33,345923
11189,0.001653,172.31.33.0-255,66,222561,33,345923
11190,0.001662,74.125.68.0-255,4320,226881,33,345923
11191,0.00167,172.31.33.0-255,66,226947,33,345923
11192,0.001673,74.125.68.0-255,1484,228431,33,345923
11193,0.001677,74.125.68.0-255,4320,232751,33,345923
11194,0.001688,74.125.68.0-255,2184,234935,33,345923
11195,0.001704,172.31.33.0-255,66,235001,33,345923
11196,0.001748,74.125.68.0-255,1484,236485,33,345923
11197,0.001752,74.125.68.0-255,1484,237969,33,345923
11198,0.001758,172.31.33.0-255,66,238035,33,345923
11199,0.001765,74.125.68.0-255,1484,239519,33,345923
11200,0.001788,74.125.68.0-255,5738,245257,33,345923
11201,0.001792,172.31.33.0-255,66,245323,33,345923
11202,0.00181,74.125.68.0-255,5738,251061,33,345923
11203,0.00182,74.125.68.0-255,1484,252545,33,345923
11204,0.001828,172.31.33.0-255,66,252611,33,345923
11205,0.001835,74.125.68.0-255,5738,258349,33,345923
11206,0.001839,172.31.33.0-255,66,258415,33,345923
11207,0.001848,74.125.68.0-255,2902,261317,33,345923
11208,0.001863,74.125.68.0-255,7156,268473,33,345923
11209,0.001872,74.125.68.0-255,766,269239,33,345923
11210,0.001881,172.31.33.0-255,66,269305,33,345923
11211,0.001988,74.125.68.0-255,1484,270789,33,345923
11212,0.002007,74.125.68.0-255,2902,273691,33,345923
11213,0.00201,74.125.68.0-255,1484,275175,33,345923
11214,0.002013,74.125.68.0-255,2902,278077,33,345923
11215,0.002017,172.31.33.0-255,66,278143,33,345923
11216,0.002033,74.125.68.0-255,4320,282463,33,345923
11217,0.002046,74.125.68.0-255,1484,283947,33,345923
11218,0.002056,172.31.33.0-255,66,284013,33,345923
11219,0.002067,74.125.68.0-255,2902,286915,33,345923
11220,0.002083,74.125.68.0-255,7156,294071,33,345923
11221,0.002094,172.31.33.0-255,66,294137,33,345923
11222,0.00212,74.125.68.0-255,2902,297039,33,345923
11223,0.002131,74.125.68.0-255,2902,299941,33,345923
11224,0.00214,74.125.68.0-255,1484,301425,33,345923
11225,0.002145,172.31.33.0-255,66,301491,33,345923
11226,0.002152,74.125.68.0-255,2184,303675,33,345923
11227,0.002161,172.31.33.0-255,66,303741,33,345923
11228,0.002197,74.125.68.0-255,7156,310897,33,345923
11229,0.002209,74.125.68.0-255,1484,312381,33,345923
11230,0.002243,172.31.33.0-255,66,312447,33,345923
11231,0.002259,74.125.68.0-255,1484,313931,33,345923
11232,0.00228,172.31.33.0-255,66,313997,33,345923
11233,0.0023,74.125.68.0-255,7156,321153,33,345923
11234,0.002304,172.31.33.0-255,66,321219,33,345923
11235,0.002316,74.125.68.0-255,4320,325539,33,345923
11236,0.002321,74.125.68.0-255,5738,331277,33,345923
11237,0.002369,74.125.68.0-255,7156,338433,33,345923
11238,0.002372,74.125.68.0-255,2145,340578,33,345923
11239,0.002375,172.31.33.0-255,66,340644,33,345923
11240,0.00238,172.31.33.0-255,66,340710,33,345923
11241,0.002412,74.125.68.0-255,105,340815,33,345923
11242,0.002472,74.125.68.0-255,129,340944,33,345923
11243,0.004343,172.31.33.0-255,105,341049,33,345923
11244,0.004374,172.31.33.0-255,105,341154,33,345923
11245,0.006911,74.125.68.0-255,66,341220,33,345923
11246,0.006918,74.125.68.0-255,66,341286,33,345923
11247,0.018548,172.31.33.0-255,90,341376,33,345923
11248,0.01858,172.31.33.0-255,66,341442,33,345923
11249,0.021097,74.125.68.0-255,66,341508,33,345923
11250,0.021123,74.125.68.0-255,66,341574,33,345923
11251,0.021131,172.31.33.0-255,66,341640,33,345923
11252,0.039035,172.31.33.0-255,172,341812,33,345923
11253,0.039066,172.31.33.0-255,1117,342929,33,345923
11254,0.039137,172.31.33.0-255,1514,344443,33,345923
11255,0.039138,172.31.33.0-255,1282,345725,33,345923
11256,0.040574,104.244.42.0-255,66,345791,33,345923
11257,0.040626,104.244.42.0-255,66,345857,33,345923
11258,0.04071,104.244.42.0-255,66,345923,33,345923
11259,0.0,74.125.24.0-255,147,147,33,199497
11260,2.2e-05,172.31.33.0-255,66,213,33,199497
11261,2.9e-05,74.125.24.0-255,1484,1697,33,199497
11262,3.3e-05,172.31.33.0-255,66,1763,33,199497
11263,3.8e-05,74.125.24.0-255,2902,4665,33,199497
11264,4e-05,172.31.33.0-255,66,4731,33,199497
11265,5.7e-05,74.125.24.0-255,7156,11887,33,199497
11266,6e-05,172.31.33.0-255,66,11953,33,199497
11267,0.000109,172.31.33.0-255,66,12019,33,199497
11268,0.000113,74.125.24.0-255,1484,13503,33,199497
11269,0.000115,172.31.33.0-255,66,13569,33,199497
11270,0.00014,74.125.24.0-255,3961,17530,33,199497
11271,0.000142,172.31.33.0-255,66,17596,33,199497
11272,0.000231,74.125.24.0-255,1484,19080,33,199497
11273,0.000236,172.31.33.0-255,66,19146,33,199497
11274,0.000261,74.125.24.0-255,2902,22048,33,199497
11275,0.000265,172.31.33.0-255,66,22114,33,199497
11276,0.000271,74.125.24.0-255,5738,27852,33,199497
11277,0.000273,172.31.33.0-255,66,27918,33,199497
11278,0.000278,74.125.24.0-255,5738,33656,33,199497
11279,0.00028,172.31.33.0-255,66,33722,33,199497
11280,0.000314,74.125.24.0-255,2543,36265,33,199497
11281,0.000319,172.31.33.0-255,66,36331,33,199497
11282,0.000323,172.31.33.0-255,66,36397,33,199497
11283,0.00033,74.125.24.0-255,6797,43194,33,199497
11284,0.000338,172.31.33.0-255,66,43260,33,199497
11285,0.000366,74.125.24.0-255,361,43621,33,199497
11286,0.000369,172.31.33.0-255,66,43687,33,199497
11287,0.000424,74.125.24.0-255,385,44072,33,199497
11288,0.000428,172.31.33.0-255,66,44138,33,199497
11289,0.000557,74.125.24.0-255,1484,45622,33,199497
11290,0.000562,74.125.24.0-255,1484,47106,33,199497
11291,0.000565,172.31.33.0-255,66,47172,33,199497
11292,0.00059,74.125.24.0-255,1484,48656,33,199497
11293,0.000598,74.125.24.0-255,5738,54394,33,199497
11294,0.000601,172.31.33.0-255,66,54460,33,199497
11295,0.000631,74.125.24.0-255,6797,61257,33,199497
11296,0.000634,172.31.33.0-255,66,61323,33,199497
11297,0.000678,74.125.24.0-255,1484,62807,33,199497
11298,0.000684,74.125.24.0-255,2902,65709,33,199497
11299,0.000687,172.31.33.0-255,66,65775,33,199497
11300,0.000691,74.125.24.0-255,2902,68677,33,199497
11301,0.000693,172.31.33.0-255,66,68743,33,199497
11302,0.000714,74.125.24.0-255,2902,71645,33,199497
11303,0.000717,172.31.33.0-255,66,71711,33,199497
11304,0.000721,74.125.24.0-255,2902,74613,33,199497
11305,0.000723,172.31.33.0-255,66,74679,33,199497
11306,0.000752,74.125.24.0-255,3961,78640,33,199497
11307,0.000755,172.31.33.0-255,66,78706,33,199497
11308,0.001335,74.125.24.0-255,1484,80190,33,199497
11309,0.001344,74.125.24.0-255,1484,81674,33,199497
11310,0.001349,172.31.33.0-255,66,81740,33,199497
11311,0.001378,74.125.24.0-255,1484,83224,33,199497
11312,0.001385,74.125.24.0-255,5738,88962,33,199497
11313,0.001388,172.31.33.0-255,66,89028,33,199497
11314,0.001401,172.31.33.0-255,66,89094,33,199497
11315,0.001411,172.31.33.0-255,66,89160,33,199497
11316,0.001439,74.125.24.0-255,2184,91344,33,199497
11317,0.001441,172.31.33.0-255,66,91410,33,199497
11318,0.001446,74.125.24.0-255,2902,94312,33,199497
11319,0.001449,172.31.33.0-255,66,94378,33,199497
11320,0.001454,74.125.24.0-255,4320,98698,33,199497
11321,0.001456,172.31.33.0-255,66,98764,33,199497
11322,0.001481,74.125.24.0-255,2902,101666,33,199497
11323,0.001483,172.31.33.0-255,66,101732,33,199497
11324,0.001496,172.31.33.0-255,66,101798,33,199497
11325,0.00153,74.125.24.0-255,4320,106118,33,199497
11326,0.001533,172.31.33.0-255,66,106184,33,199497
11327,0.001543,172.31.33.0-255,66,106250,33,199497
11328,0.001584,74.125.24.0-255,5738,111988,33,199497
11329,0.001588,172.31.33.0-255,66,112054,33,199497
11330,0.001619,74.125.24.0-255,2902,114956,33,199497
11331,0.001622,172.31.33.0-255,66,115022,33,199497
11332,0.001633,172.31.33.0-255,66,115088,33,199497
11333,0.001648,172.31.33.0-255,66,115154,33,199497
11334,0.001654,74.125.24.0-255,5738,120892,33,199497
11335,0.001656,172.31.33.0-255,66,120958,33,199497
11336,0.001684,74.125.24.0-255,4320,125278,33,199497
11337,0.001687,172.31.33.0-255,66,125344,33,199497
11338,0.0017,172.31.33.0-255,66,125410,33,199497
11339,0.001709,172.31.33.0-255,66,125476,33,199497
11340,0.001738,74.125.24.0-255,3602,129078,33,199497
11341,0.001741,172.31.33.0-255,66,129144,33,199497
11342,0.001752,74.125.24.0-255,1484,130628,33,199497
11343,0.00176,74.125.24.0-255,2902,133530,33,199497
11344,0.001762,172.31.33.0-255,66,133596,33,199497
11345,0.001784,74.125.24.0-255,5738,139334,33,199497
11346,0.001787,172.31.33.0-255,66,139400,33,199497
11347,0.001791,74.125.24.0-255,2902,142302,33,199497
11348,0.001793,172.31.33.0-255,66,142368,33,199497
11349,0.001836,172.31.33.0-255,66,142434,33,199497
11350,0.00184,74.125.24.0-255,2902,145336,33,199497
11351,0.001842,172.31.33.0-255,66,145402,33,199497
11352,0.001865,172.31.33.0-255,66,145468,33,199497
11353,0.001948,74.125.24.0-255,1484,146952,33,199497
11354,0.001953,74.125.24.0-255,2902,149854,33,199497
11355,0.001955,172.31.33.0-255,66,149920,33,199497
11356,0.001983,74.125.24.0-255,5738,155658,33,199497
11357,0.001986,172.31.33.0-255,66,155724,33,199497
11358,0.001996,172.31.33.0-255,66,155790,33,199497
11359,0.002024,74.125.24.0-255,2902,158692,33,199497
11360,0.002027,172.31.33.0-255,66,158758,33,199497
11361,0.002033,74.125.24.0-255,7156,165914,33,199497
11362,0.002035,172.31.33.0-255,66,165980,33,199497
11363,0.002039,74.125.24.0-255,2902,168882,33,199497
11364,0.002041,172.31.33.0-255,66,168948,33,199497
11365,0.002071,74.125.24.0-255,766,169714,33,199497
11366,0.002093,74.125.24.0-255,4320,174034,33,199497
11367,0.002096,172.31.33.0-255,66,174100,33,199497
11368,0.002099,74.125.24.0-255,1484,175584,33,199497
11369,0.002123,74.125.24.0-255,7156,182740,33,199497
11370,0.002127,172.31.33.0-255,66,182806,33,199497
11371,0.002154,74.125.24.0-255,5738,188544,33,199497
11372,0.002157,172.31.33.0-255,66,188610,33,199497
11373,0.002192,172.31.33.0-255,66,188676,33,199497
11374,0.002205,172.31.33.0-255,66,188742,33,199497
11375,0.002233,74.125.24.0-255,2184,190926,33,199497
11376,0.002235,172.31.33.0-255,66,190992,33,199497
11377,0.002244,172.31.33.0-255,66,191058,33,199497
11378,0.002323,172.31.33.0-255,66,191124,33,199497
11379,0.002335,172.31.33.0-255,66,191190,33,199497
11380,0.00234,74.125.24.0-255,3444,194634,33,199497
11381,0.002342,172.31.33.0-255,66,194700,33,199497
11382,0.004551,74.125.24.0-255,105,194805,33,199497
11383,0.012838,172.31.33.0-255,66,194871,33,199497
11384,0.012866,172.31.33.0-255,105,194976,33,199497
11385,0.015114,74.125.24.0-255,66,195042,33,199497
11386,0.038897,172.31.33.0-255,172,195214,33,199497
11387,0.038927,172.31.33.0-255,1117,196331,33,199497
11388,0.038965,172.31.33.0-255,1514,197845,33,199497
11389,0.038966,172.31.33.0-255,1280,199125,33,199497
11390,0.040467,104.244.42.0-255,66,199191,33,199497
11391,0.040486,104.244.42.0-255,66,199257,33,199497
11392,0.040529,104.244.42.0-255,66,199323,33,199497
11393,0.041237,104.244.42.0-255,108,199431,33,199497
11394,0.041255,172.31.33.0-255,66,199497,33,199497
11395,0.0,172.31.33.0-255,105,105,33,918
11396,7.6e-05,172.31.33.0-255,105,210,33,918
11397,0.000404,172.31.33.0-255,90,300,33,918
11398,0.000412,172.31.33.0-255,66,366,33,918
11399,0.000574,172.31.33.0-255,90,456,33,918
11400,0.00058,172.31.33.0-255,66,522,33,918
11401,0.002717,74.125.24.0-255,66,588,33,918
11402,0.002739,74.125.24.0-255,66,654,33,918
11403,0.002755,172.31.33.0-255,66,720,33,918
11404,0.002861,74.125.24.0-255,66,786,33,918
11405,0.002875,74.125.24.0-255,66,852,33,918
11406,0.002886,172.31.33.0-255,66,918,33,918
11407,0.0,74.125.24.0-255,152,152,33,277451
11408,3.3e-05,172.31.33.0-255,66,218,33,277451
11409,4e-05,74.125.24.0-255,1484,1702,33,277451
11410,4.4e-05,172.31.33.0-255,66,1768,33,277451
11411,4.9e-05,74.125.24.0-255,2902,4670,33,277451
11412,5.2e-05,172.31.33.0-255,66,4736,33,277451
11413,5.9e-05,74.125.24.0-255,7156,11892,33,277451
11414,6.2e-05,172.31.33.0-255,66,11958,33,277451
11415,0.000102,172.31.33.0-255,66,12024,33,277451
11416,0.000114,172.31.33.0-255,66,12090,33,277451
11417,0.000148,172.31.33.0-255,66,12156,33,277451
11418,0.000176,172.31.33.0-255,66,12222,33,277451
11419,0.000192,172.31.33.0-255,66,12288,33,277451
11420,0.000214,74.125.24.0-255,2857,15145,33,277451
11421,0.000216,172.31.33.0-255,66,15211,33,277451
11422,0.000343,74.125.24.0-255,110,15321,33,277451
11423,0.000348,172.31.33.0-255,66,15387,33,277451
11424,0.000544,74.125.24.0-255,1484,16871,33,277451
11425,0.000548,172.31.33.0-255,66,16937,33,277451
11426,0.000552,74.125.24.0-255,1484,18421,33,277451
11427,0.000554,172.31.33.0-255,66,18487,33,277451
11428,0.000569,74.125.24.0-255,1484,19971,33,277451
11429,0.000571,172.31.33.0-255,66,20037,33,277451
11430,0.000577,74.125.24.0-255,5738,25775,33,277451
11431,0.000579,172.31.33.0-255,66,25841,33,277451
11432,0.000602,74.125.24.0-255,2902,28743,33,277451
11433,0.000605,172.31.33.0-255,66,28809,33,277451
11434,0.000628,74.125.24.0-255,7156,35965,33,277451
11435,0.000639,172.31.33.0-255,66,36031,33,277451
11436,0.000654,74.125.24.0-255,5738,41769,33,277451
11437,0.000664,172.31.33.0-255,66,41835,33,277451
11438,0.000681,172.31.33.0-255,66,41901,33,277451
11439,0.001524,74.125.24.0-255,1484,43385,33,277451
11440,0.001535,74.125.24.0-255,2902,46287,33,277451
11441,0.001539,172.31.33.0-255,66,46353,33,277451
11442,0.001546,74.125.24.0-255,4320,50673,33,277451
11443,0.00156,74.125.24.0-255,1484,52157,33,277451
11444,0.001563,74.125.24.0-255,1484,53641,33,277451
11445,0.001567,74.125.24.0-255,1484,55125,33,277451
11446,0.00159,74.125.24.0-255,7156,62281,33,277451
11447,0.001631,74.125.24.0-255,5020,67301,33,277451
11448,0.001689,74.125.24.0-255,1484,68785,33,277451
11449,0.001705,74.125.24.0-255,2902,71687,33,277451
11450,0.001709,74.125.24.0-255,2902,74589,33,277451
11451,0.001724,74.125.24.0-255,2902,77491,33,277451
11452,0.001727,74.125.24.0-255,2902,80393,33,277451
11453,0.001744,74.125.24.0-255,7156,87549,33,277451
11454,0.001763,74.125.24.0-255,2902,90451,33,277451
11455,0.001951,74.125.24.0-255,1484,91935,33,277451
11456,0.001958,74.125.24.0-255,1484,93419,33,277451
11457,0.001969,74.125.24.0-255,1484,94903,33,277451
11458,0.001984,74.125.24.0-255,5738,100641,33,277451
11459,0.00206,74.125.24.0-255,2902,103543,33,277451
11460,0.002206,74.125.24.0-255,1484,105027,33,277451
11461,0.00221,74.125.24.0-255,1484,106511,33,277451
11462,0.00222,74.125.24.0-255,1484,107995,33,277451
11463,0.002238,74.125.24.0-255,2902,110897,33,277451
11464,0.002257,74.125.24.0-255,2902,113799,33,277451
11465,0.002262,74.125.24.0-255,4320,118119,33,277451
11466,0.002277,74.125.24.0-255,2902,121021,33,277451
11467,0.002317,74.125.24.0-255,1484,122505,33,277451
11468,0.002327,74.125.24.0-255,2902,125407,33,277451
11469,0.002341,74.125.24.0-255,1484,126891,33,277451
11470,0.002363,74.125.24.0-255,7156,134047,33,277451
11471,0.002395,74.125.24.0-255,7156,141203,33,277451
11472,0.011021,172.31.33.0-255,66,141269,33,277451
11473,0.011693,74.125.24.0-255,1484,142753,33,277451
11474,0.01333,74.125.24.0-255,4320,147073,33,277451
11475,0.01334,172.31.33.0-255,66,147139,33,277451
11476,0.015633,74.125.24.0-255,5738,152877,33,277451
11477,0.015979,172.31.33.0-255,66,152943,33,277451
11478,0.018272,74.125.24.0-255,5738,158681,33,277451
11479,0.018279,172.31.33.0-255,66,158747,33,277451
11480,0.02057,74.125.24.0-255,5738,164485,33,277451
11481,0.02058,172.31.33.0-255,66,164551,33,277451
11482,0.022844,74.125.24.0-255,5738,170289,33,277451
11483,0.022852,172.31.33.0-255,66,170355,33,277451
11484,0.025151,74.125.24.0-255,5738,176093,33,277451
11485,0.025171,172.31.33.0-255,66,176159,33,277451
11486,0.027451,74.125.24.0-255,5738,181897,33,277451
11487,0.02746,172.31.33.0-255,66,181963,33,277451
11488,0.029737,74.125.24.0-255,5738,187701,33,277451
11489,0.029743,172.31.33.0-255,66,187767,33,277451
11490,0.032026,74.125.24.0-255,5738,193505,33,277451
11491,0.032035,172.31.33.0-255,66,193571,33,277451
11492,0.034352,74.125.24.0-255,5738,199309,33,277451
11493,0.034357,172.31.33.0-255,66,199375,33,277451
11494,0.036669,74.125.24.0-255,5738,205113,33,277451
11495,0.036693,172.31.33.0-255,66,205179,33,277451
11496,0.03897,74.125.24.0-255,5738,210917,33,277451
11497,0.038981,172.31.33.0-255,66,210983,33,277451
11498,0.041268,74.125.24.0-255,5738,216721,33,277451
11499,0.041276,172.31.33.0-255,66,216787,33,277451
11500,0.042522,172.31.33.0-255,200,216987,33,277451
11501,0.042548,172.31.33.0-255,1117,218104,33,277451
11502,0.042589,172.31.33.0-255,1514,219618,33,277451
11503,0.042591,172.31.33.0-255,1280,220898,33,277451
11504,0.043581,74.125.24.0-255,5738,226636,33,277451
11505,0.043587,172.31.33.0-255,66,226702,33,277451
11506,0.044061,104.244.42.0-255,66,226768,33,277451
11507,0.044285,104.244.42.0-255,66,226834,33,277451
11508,0.04429,104.244.42.0-255,66,226900,33,277451
11509,0.045919,74.125.24.0-255,5738,232638,33,277451
11510,0.045925,172.31.33.0-255,66,232704,33,277451
11511,0.048207,74.125.24.0-255,5738,238442,33,277451
11512,0.048213,172.31.33.0-255,66,238508,33,277451
11513,0.050512,74.125.24.0-255,5738,244246,33,277451
11514,0.050517,172.31.33.0-255,66,244312,33,277451
11515,0.052779,74.125.24.0-255,5738,250050,33,277451
11516,0.052785,172.31.33.0-255,66,250116,33,277451
11517,0.055063,74.125.24.0-255,5738,255854,33,277451
11518,0.055071,172.31.33.0-255,66,255920,33,277451
11519,0.05736,74.125.24.0-255,5738,261658,33,277451
11520,0.057368,172.31.33.0-255,66,261724,33,277451
11521,0.059674,74.125.24.0-255,5738,267462,33,277451
11522,0.059679,172.31.33.0-255,66,267528,33,277451
11523,0.061987,74.125.24.0-255,5738,273266,33,277451
11524,0.061993,172.31.33.0-255,66,273332,33,277451
11525,0.064262,74.125.24.0-255,3882,277214,33,277451
11526,0.064267,172.31.33.0-255,66,277280,33,277451
11527,0.064459,172.31.33.0-255,105,277385,33,277451
11528,0.066746,74.125.24.0-255,66,277451,33,277451
11529,0.0,74.125.68.0-255,150,150,33,194763
11530,2.2e-05,172.31.33.0-255,66,216,33,194763
11531,2.8e-05,74.125.68.0-255,1484,1700,33,194763
11532,3.1e-05,172.31.33.0-255,66,1766,33,194763
11533,3.6e-05,74.125.68.0-255,2902,4668,33,194763
11534,3.8e-05,172.31.33.0-255,66,4734,33,194763
11535,6e-05,74.125.68.0-255,1484,6218,33,194763
11536,6.1e-05,172.31.33.0-255,66,6284,33,194763
11537,6.5e-05,74.125.68.0-255,2902,9186,33,194763
11538,6.8e-05,172.31.33.0-255,66,9252,33,194763
11539,8.6e-05,74.125.68.0-255,2902,12154,33,194763
11540,8.8e-05,172.31.33.0-255,66,12220,33,194763
11541,0.000111,74.125.68.0-255,3476,15696,33,194763
11542,0.000114,172.31.33.0-255,66,15762,33,194763
11543,0.000158,74.125.68.0-255,2902,18664,33,194763
11544,0.000161,172.31.33.0-255,66,18730,33,194763
11545,0.000176,74.125.68.0-255,1484,20214,33,194763
11546,0.000178,172.31.33.0-255,66,20280,33,194763
11547,0.00019,74.125.68.0-255,2902,23182,33,194763
11548,0.000193,172.31.33.0-255,66,23248,33,194763
11549,0.000225,172.31.33.0-255,66,23314,33,194763
11550,0.000287,74.125.68.0-255,4320,27634,33,194763
11551,0.00029,172.31.33.0-255,66,27700,33,194763
11552,0.000314,74.125.68.0-255,7156,34856,33,194763
11553,0.000317,172.31.33.0-255,66,34922,33,194763
11554,0.000394,74.125.68.0-255,4320,39242,33,194763
11555,0.000398,172.31.33.0-255,66,39308,33,194763
11556,0.00043,74.125.68.0-255,2902,42210,33,194763
11557,0.000432,172.31.33.0-255,66,42276,33,194763
11558,0.000455,172.31.33.0-255,66,42342,33,194763
11559,0.000475,74.125.68.0-255,2902,45244,33,194763
11560,0.000483,172.31.33.0-255,66,45310,33,194763
11561,0.000571,74.125.68.0-255,1122,46432,33,194763
11562,0.000599,74.125.68.0-255,1484,47916,33,194763
11563,0.000602,172.31.33.0-255,66,47982,33,194763
11564,0.000636,74.125.68.0-255,1484,49466,33,194763
11565,0.000649,74.125.68.0-255,2902,52368,33,194763
11566,0.000656,74.125.68.0-255,7156,59524,33,194763
11567,0.000658,172.31.33.0-255,66,59590,33,194763
11568,0.000662,172.31.33.0-255,66,59656,33,194763
11569,0.000676,74.125.68.0-255,2902,62558,33,194763
11570,0.000682,172.31.33.0-255,66,62624,33,194763
11571,0.000736,74.125.68.0-255,2902,65526,33,194763
11572,0.000746,172.31.33.0-255,66,65592,33,194763
11573,0.000766,172.31.33.0-255,66,65658,33,194763
11574,0.000772,74.125.68.0-255,766,66424,33,194763
11575,0.000944,172.31.33.0-255,66,66490,33,194763
11576,0.001181,74.125.68.0-255,1484,67974,33,194763
11577,0.00119,74.125.68.0-255,2902,70876,33,194763
11578,0.001207,74.125.68.0-255,2902,73778,33,194763
11579,0.001218,74.125.68.0-255,2902,76680,33,194763
11580,0.001262,74.125.68.0-255,1484,78164,33,194763
11581,0.001283,74.125.68.0-255,5738,83902,33,194763
11582,0.001318,74.125.68.0-255,1484,85386,33,194763
11583,0.001432,74.125.68.0-255,1484,86870,33,194763
11584,0.001449,74.125.68.0-255,2184,89054,33,194763
11585,0.001463,74.125.68.0-255,2902,91956,33,194763
11586,0.001475,74.125.68.0-255,1484,93440,33,194763
11587,0.001508,74.125.68.0-255,1484,94924,33,194763
11588,0.001525,74.125.68.0-255,5738,100662,33,194763
11589,0.00157,74.125.68.0-255,1484,102146,33,194763
11590,0.001604,74.125.68.0-255,1484,103630,33,194763
11591,0.001685,74.125.68.0-255,1484,105114,33,194763
11592,0.001706,74.125.68.0-255,1484,106598,33,194763
11593,0.001746,74.125.68.0-255,3602,110200,33,194763
11594,0.001848,74.125.68.0-255,1484,111684,33,194763
11595,0.001872,74.125.68.0-255,7156,118840,33,194763
11596,0.001931,74.125.68.0-255,2902,121742,33,194763
11597,0.00213,74.125.68.0-255,4320,126062,33,194763
11598,0.002146,74.125.68.0-255,4320,130382,33,194763
11599,0.002162,74.125.68.0-255,2902,133284,33,194763
11600,0.00217,74.125.68.0-255,1484,134768,33,194763
11601,0.00225,74.125.68.0-255,4320,139088,33,194763
11602,0.002277,74.125.68.0-255,2184,141272,33,194763
11603,0.002399,74.125.68.0-255,4320,145592,33,194763
11604,0.00249,74.125.68.0-255,2902,148494,33,194763
11605,0.002673,74.125.68.0-255,1484,149978,33,194763
11606,0.00269,74.125.68.0-255,4320,154298,33,194763
11607,0.002709,74.125.68.0-255,5738,160036,33,194763
11608,0.00272,74.125.68.0-255,2902,162938,33,194763
11609,0.002742,74.125.68.0-255,7156,170094,33,194763
11610,0.002779,172.31.33.0-255,66,170160,33,194763
11611,0.002807,172.31.33.0-255,66,170226,33,194763
11612,0.003097,74.125.68.0-255,7156,177382,33,194763
11613,0.003106,172.31.33.0-255,66,177448,33,194763
11614,0.003147,172.31.33.0-255,66,177514,33,194763
11615,0.00335,74.125.68.0-255,1484,178998,33,194763
11616,0.003369,74.125.68.0-255,7156,186154,33,194763
11617,0.003382,172.31.33.0-255,66,186220,33,194763
11618,0.00343,172.31.33.0-255,66,186286,33,194763
11619,0.003449,172.31.33.0-255,66,186352,33,194763
11620,0.003851,74.125.68.0-255,105,186457,33,194763
11621,0.004747,172.31.33.0-255,66,186523,33,194763
11622,0.00477,172.31.33.0-255,105,186628,33,194763
11623,0.007362,74.125.68.0-255,66,186694,33,194763
11624,0.024542,172.31.33.0-255,172,186866,33,194763
11625,0.024573,172.31.33.0-255,1117,187983,33,194763
11626,0.024611,172.31.33.0-255,1514,189497,33,194763
11627,0.024613,172.31.33.0-255,1514,191011,33,194763
11628,0.024614,172.31.33.0-255,1514,192525,33,194763
11629,0.024615,172.31.33.0-255,1514,194039,33,194763
11630,0.024643,172.31.33.0-255,460,194499,33,194763
11631,0.026141,104.244.42.0-255,66,194565,33,194763
11632,0.026166,104.244.42.0-255,66,194631,33,194763
11633,0.026235,104.244.42.0-255,66,194697,33,194763
11634,0.026242,104.244.42.0-255,66,194763,33,194763
11635,0.0,74.125.24.0-255,146,146,33,354773
11636,2.1e-05,172.31.33.0-255,66,212,33,354773
11637,2.6e-05,74.125.24.0-255,1484,1696,33,354773
11638,3e-05,172.31.33.0-255,66,1762,33,354773
11639,3.4e-05,74.125.24.0-255,2902,4664,33,354773
11640,3.7e-05,172.31.33.0-255,66,4730,33,354773
11641,4e-05,74.125.24.0-255,1484,6214,33,354773
11642,4.2e-05,172.31.33.0-255,66,6280,33,354773
11643,6.7e-05,74.125.24.0-255,2902,9182,33,354773
11644,7e-05,172.31.33.0-255,66,9248,33,354773
11645,7.6e-05,74.125.24.0-255,4320,13568,33,354773
11646,7.7e-05,172.31.33.0-255,66,13634,33,354773
11647,9.2e-05,74.125.24.0-255,4904,18538,33,354773
11648,9.5e-05,172.31.33.0-255,66,18604,33,354773
11649,0.000102,74.125.24.0-255,7156,25760,33,354773
11650,0.000104,172.31.33.0-255,66,25826,33,354773
11651,0.000119,74.125.24.0-255,2902,28728,33,354773
11652,0.000121,172.31.33.0-255,66,28794,33,354773
11653,0.000155,74.125.24.0-255,2543,31337,33,354773
11654,0.000158,172.31.33.0-255,66,31403,33,354773
11655,0.00024,74.125.24.0-255,2902,34305,33,354773
11656,0.000244,172.31.33.0-255,66,34371,33,354773
11657,0.000247,74.125.24.0-255,1484,35855,33,354773
11658,0.000249,172.31.33.0-255,66,35921,33,354773
11659,0.000263,74.125.24.0-255,2902,38823,33,354773
11660,0.000266,172.31.33.0-255,66,38889,33,354773
11661,0.000276,172.31.33.0-255,66,38955,33,354773
11662,0.00028,74.125.24.0-255,2543,41498,33,354773
11663,0.000282,172.31.33.0-255,66,41564,33,354773
11664,0.000287,74.125.24.0-255,2902,44466,33,354773
11665,0.000289,172.31.33.0-255,66,44532,33,354773
11666,0.000295,74.125.24.0-255,7156,51688,33,354773
11667,0.000298,172.31.33.0-255,66,51754,33,354773
11668,0.000301,74.125.24.0-255,1484,53238,33,354773
11669,0.000327,74.125.24.0-255,4235,57473,33,354773
11670,0.00033,172.31.33.0-255,66,57539,33,354773
11671,0.000333,74.125.24.0-255,131,57670,33,354773
11672,0.000562,74.125.24.0-255,1484,59154,33,354773
11673,0.000566,172.31.33.0-255,66,59220,33,354773
11674,0.000588,74.125.24.0-255,2902,62122,33,354773
11675,0.000591,172.31.33.0-255,66,62188,33,354773
11676,0.000597,74.125.24.0-255,5738,67926,33,354773
11677,0.000599,172.31.33.0-255,66,67992,33,354773
11678,0.000615,74.125.24.0-255,4320,72312,33,354773
11679,0.000618,172.31.33.0-255,66,72378,33,354773
11680,0.000633,74.125.24.0-255,2543,74921,33,354773
11681,0.000635,172.31.33.0-255,66,74987,33,354773
11682,0.000642,74.125.24.0-255,7156,82143,33,354773
11683,0.000644,172.31.33.0-255,66,82209,33,354773
11684,0.000694,74.125.24.0-255,2902,85111,33,354773
11685,0.000698,172.31.33.0-255,66,85177,33,354773
11686,0.000712,74.125.24.0-255,6797,91974,33,354773
11687,0.000715,172.31.33.0-255,66,92040,33,354773
11688,0.001412,74.125.24.0-255,1484,93524,33,354773
11689,0.00142,74.125.24.0-255,2902,96426,33,354773
11690,0.001424,172.31.33.0-255,66,96492,33,354773
11691,0.001428,74.125.24.0-255,1484,97976,33,354773
11692,0.001442,74.125.24.0-255,4320,102296,33,354773
11693,0.001443,172.31.33.0-255,66,102362,33,354773
11694,0.001466,74.125.24.0-255,5738,108100,33,354773
11695,0.001467,172.31.33.0-255,66,108166,33,354773
11696,0.001481,74.125.24.0-255,7156,115322,33,354773
11697,0.001482,172.31.33.0-255,66,115388,33,354773
11698,0.001492,172.31.33.0-255,66,115454,33,354773
11699,0.001709,74.125.24.0-255,1484,116938,33,354773
11700,0.001712,74.125.24.0-255,1484,118422,33,354773
11701,0.001714,172.31.33.0-255,66,118488,33,354773
11702,0.001724,74.125.24.0-255,1484,119972,33,354773
11703,0.00174,74.125.24.0-255,5738,125710,33,354773
11704,0.001742,172.31.33.0-255,66,125776,33,354773
11705,0.001764,74.125.24.0-255,1484,127260,33,354773
11706,0.001784,172.31.33.0-255,66,127326,33,354773
11707,0.001808,74.125.24.0-255,2902,130228,33,354773
11708,0.001809,172.31.33.0-255,66,130294,33,354773
11709,0.001819,172.31.33.0-255,66,130360,33,354773
11710,0.001821,74.125.24.0-255,766,131126,33,354773
11711,0.001928,74.125.24.0-255,1484,132610,33,354773
11712,0.00193,172.31.33.0-255,66,132676,33,354773
11713,0.001934,74.125.24.0-255,2902,135578,33,354773
11714,0.001937,172.31.33.0-255,66,135644,33,354773
11715,0.001948,74.125.24.0-255,2902,138546,33,354773
11716,0.001951,172.31.33.0-255,66,138612,33,354773
11717,0.001964,74.125.24.0-255,2902,141514,33,354773
11718,0.001966,172.31.33.0-255,66,141580,33,354773
11719,0.001969,74.125.24.0-255,1484,143064,33,354773
11720,0.002001,172.31.33.0-255,66,143130,33,354773
11721,0.002006,74.125.24.0-255,5738,148868,33,354773
11722,0.002008,172.31.33.0-255,66,148934,33,354773
11723,0.002024,74.125.24.0-255,5020,153954,33,354773
11724,0.002026,172.31.33.0-255,66,154020,33,354773
11725,0.002143,74.125.24.0-255,1484,155504,33,354773
11726,0.002158,74.125.24.0-255,2902,158406,33,354773
11727,0.00216,172.31.33.0-255,66,158472,33,354773
11728,0.002163,74.125.24.0-255,2902,161374,33,354773
11729,0.002166,172.31.33.0-255,66,161440,33,354773
11730,0.002179,74.125.24.0-255,2902,164342,33,354773
11731,0.00218,172.31.33.0-255,66,164408,33,354773
11732,0.002192,74.125.24.0-255,2902,167310,33,354773
11733,0.002194,172.31.33.0-255,66,167376,33,354773
11734,0.00222,172.31.33.0-255,66,167442,33,354773
11735,0.002256,74.125.24.0-255,2902,170344,33,354773
11736,0.002258,172.31.33.0-255,66,170410,33,354773
11737,0.002273,74.125.24.0-255,5738,176148,33,354773
11738,0.002276,172.31.33.0-255,66,176214,33,354773
11739,0.002287,74.125.24.0-255,3602,179816,33,354773
11740,0.002289,172.31.33.0-255,66,179882,33,354773
11741,0.004518,74.125.24.0-255,2902,182784,33,354773
11742,0.004524,172.31.33.0-255,66,182850,33,354773
11743,0.004538,74.125.24.0-255,2902,185752,33,354773
11744,0.004542,172.31.33.0-255,66,185818,33,354773
11745,0.006769,74.125.24.0-255,2902,188720,33,354773
11746,0.006774,172.31.33.0-255,66,188786,33,354773
11747,0.006802,74.125.24.0-255,2902,191688,33,354773
11748,0.006805,172.31.33.0-255,66,191754,33,354773
11749,0.009021,74.125.24.0-255,2902,194656,33,354773
11750,0.009029,172.31.33.0-255,66,194722,33,354773
11751,0.00906,74.125.24.0-255,2902,197624,33,354773
11752,0.009063,172.31.33.0-255,66,197690,33,354773
11753,0.011264,74.125.24.0-255,2902,200592,33,354773
11754,0.011273,172.31.33.0-255,66,200658,33,354773
11755,0.011302,74.125.24.0-255,2902,203560,33,354773
11756,0.011305,172.31.33.0-255,66,203626,33,354773
11757,0.013513,74.125.24.0-255,2902,206528,33,354773
11758,0.013525,172.31.33.0-255,66,206594,33,354773
11759,0.013549,74.125.24.0-255,2902,209496,33,354773
11760,0.013552,172.31.33.0-255,66,209562,33,354773
11761,0.015774,74.125.24.0-255,5738,215300,33,354773
11762,0.015781,172.31.33.0-255,66,215366,33,354773
11763,0.018067,74.125.24.0-255,5738,221104,33,354773
11764,0.018074,172.31.33.0-255,66,221170,33,354773
11765,0.020345,74.125.24.0-255,5738,226908,33,354773
11766,0.020349,172.31.33.0-255,66,226974,33,354773
11767,0.020789,172.31.33.0-255,172,227146,33,354773
11768,0.020823,172.31.33.0-255,1117,228263,33,354773
11769,0.020886,172.31.33.0-255,1514,229777,33,354773
11770,0.020888,172.31.33.0-255,1514,231291,33,354773
11771,0.020912,172.31.33.0-255,677,231968,33,354773
11772,0.022336,104.244.42.0-255,66,232034,33,354773
11773,0.022411,104.244.42.0-255,66,232100,33,354773
11774,0.022454,104.244.42.0-255,66,232166,33,354773
11775,0.022467,104.244.42.0-255,66,232232,33,354773
11776,0.022593,74.125.24.0-255,2902,235134,33,354773
11777,0.022599,172.31.33.0-255,66,235200,33,354773
11778,0.022619,74.125.24.0-255,2902,238102,33,354773
11779,0.022621,172.31.33.0-255,66,238168,33,354773
11780,0.024842,74.125.24.0-255,2902,241070,33,354773
11781,0.024849,172.31.33.0-255,66,241136,33,354773
11782,0.024873,74.125.24.0-255,2902,244038,33,354773
11783,0.024875,172.31.33.0-255,66,244104,33,354773
11784,0.027106,74.125.24.0-255,2902,247006,33,354773
11785,0.027112,172.31.33.0-255,66,247072,33,354773
11786,0.027128,74.125.24.0-255,2902,249974,33,354773
11787,0.027131,172.31.33.0-255,66,250040,33,354773
11788,0.029353,74.125.24.0-255,2902,252942,33,354773
11789,0.029359,172.31.33.0-255,66,253008,33,354773
11790,0.029383,74.125.24.0-255,2902,255910,33,354773
11791,0.029385,172.31.33.0-255,66,255976,33,354773
11792,0.031607,74.125.24.0-255,2902,258878,33,354773
11793,0.031613,172.31.33.0-255,66,258944,33,354773
11794,0.031634,74.125.24.0-255,2902,261846,33,354773
11795,0.031636,172.31.33.0-255,66,261912,33,354773
11796,0.033852,74.125.24.0-255,2902,264814,33,354773
11797,0.033858,172.31.33.0-255,66,264880,33,354773
11798,0.03388,74.125.24.0-255,2902,267782,33,354773
11799,0.033882,172.31.33.0-255,66,267848,33,354773
11800,0.036107,74.125.24.0-255,2902,270750,33,354773
11801,0.036113,172.31.33.0-255,66,270816,33,354773
11802,0.036135,74.125.24.0-255,2902,273718,33,354773
11803,0.036137,172.31.33.0-255,66,273784,33,354773
11804,0.038361,74.125.24.0-255,5738,279522,33,354773
11805,0.038366,172.31.33.0-255,66,279588,33,354773
11806,0.040599,74.125.24.0-255,5738,285326,33,354773
11807,0.040606,172.31.33.0-255,66,285392,33,354773
11808,0.04286,74.125.24.0-255,5738,291130,33,354773
11809,0.042866,172.31.33.0-255,66,291196,33,354773
11810,0.045127,74.125.24.0-255,5738,296934,33,354773
11811,0.045133,172.31.33.0-255,66,297000,33,354773
11812,0.047449,74.125.24.0-255,5738,302738,33,354773
11813,0.047454,172.31.33.0-255,66,302804,33,354773
11814,0.049725,74.125.24.0-255,5738,308542,33,354773
11815,0.049732,172.31.33.0-255,66,308608,33,354773
11816,0.052006,74.125.24.0-255,5738,314346,33,354773
11817,0.052012,172.31.33.0-255,66,314412,33,354773
11818,0.054245,74.125.24.0-255,5738,320150,33,354773
11819,0.054251,172.31.33.0-255,66,320216,33,354773
11820,0.056509,74.125.24.0-255,5738,325954,33,354773
11821,0.056515,172.31.33.0-255,66,326020,33,354773
11822,0.058791,74.125.24.0-255,5738,331758,33,354773
11823,0.058796,172.31.33.0-255,66,331824,33,354773
11824,0.061034,74.125.24.0-255,5738,337562,33,354773
11825,0.06104,172.31.33.0-255,66,337628,33,354773
11826,0.063302,74.125.24.0-255,5738,343366,33,354773
11827,0.063307,172.31.33.0-255,66,343432,33,354773
11828,0.065549,74.125.24.0-255,5738,349170,33,354773
11829,0.065554,172.31.33.0-255,66,349236,33,354773
11830,0.067791,74.125.24.0-255,5300,354536,33,354773
11831,0.067797,172.31.33.0-255,66,354602,33,354773
11832,0.067986,172.31.33.0-255,105,354707,33,354773
11833,0.07022,74.125.24.0-255,66,354773,33,354773
11834,0.0,172.217.194.0-255,152,152,33,292025
11835,1.8e-05,172.31.33.0-255,66,218,33,292025
11836,2.5e-05,172.217.194.0-255,1484,1702,33,292025
11837,2.9e-05,172.31.33.0-255,66,1768,33,292025
11838,3.4e-05,172.217.194.0-255,2902,4670,33,292025
11839,3.7e-05,172.31.33.0-255,66,4736,33,292025
11840,5.3e-05,172.217.194.0-255,7156,11892,33,292025
11841,5.6e-05,172.31.33.0-255,66,11958,33,292025
11842,0.000109,172.217.194.0-255,2078,14036,33,292025
11843,0.000113,172.31.33.0-255,66,14102,33,292025
11844,0.000327,172.217.194.0-255,1484,15586,33,292025
11845,0.000332,172.31.33.0-255,66,15652,33,292025
11846,0.000339,172.217.194.0-255,2902,18554,33,292025
11847,0.000342,172.31.33.0-255,66,18620,33,292025
11848,0.000361,172.217.194.0-255,5738,24358,33,292025
11849,0.000364,172.31.33.0-255,66,24424,33,292025
11850,0.000401,172.217.194.0-255,6797,31221,33,292025
11851,0.000404,172.31.33.0-255,66,31287,33,292025
11852,0.000444,172.217.194.0-255,1484,32771,33,292025
11853,0.000447,172.31.33.0-255,66,32837,33,292025
11854,0.000453,172.217.194.0-255,2902,35739,33,292025
11855,0.000455,172.31.33.0-255,66,35805,33,292025
11856,0.000489,172.217.194.0-255,5738,41543,33,292025
11857,0.000492,172.31.33.0-255,66,41609,33,292025
11858,0.0005,172.217.194.0-255,6797,48406,33,292025
11859,0.000502,172.31.33.0-255,66,48472,33,292025
11860,0.000538,172.31.33.0-255,66,48538,33,292025
11861,0.000564,172.217.194.0-255,1484,50022,33,292025
11862,0.000569,172.31.33.0-255,66,50088,33,292025
11863,0.000602,172.31.33.0-255,66,50154,33,292025
11864,0.000794,172.217.194.0-255,1484,51638,33,292025
11865,0.0008,172.217.194.0-255,1484,53122,33,292025
11866,0.000803,172.31.33.0-255,66,53188,33,292025
11867,0.00083,172.217.194.0-255,1484,54672,33,292025
11868,0.000837,172.217.194.0-255,5738,60410,33,292025
11869,0.000853,172.31.33.0-255,66,60476,33,292025
11870,0.000857,172.31.33.0-255,66,60542,33,292025
11871,0.000898,172.217.194.0-255,7156,67698,33,292025
11872,0.0009,172.31.33.0-255,66,67764,33,292025
11873,0.000925,172.217.194.0-255,6438,74202,33,292025
11874,0.000927,172.31.33.0-255,66,74268,33,292025
11875,0.001186,172.217.194.0-255,1484,75752,33,292025
11876,0.001193,172.217.194.0-255,2902,78654,33,292025
11877,0.001196,172.31.33.0-255,66,78720,33,292025
11878,0.001203,172.217.194.0-255,5738,84458,33,292025
11879,0.001205,172.31.33.0-255,66,84524,33,292025
11880,0.001227,172.217.194.0-255,1484,86008,33,292025
11881,0.001258,172.31.33.0-255,66,86074,33,292025
11882,0.00127,172.31.33.0-255,66,86140,33,292025
11883,0.001273,172.217.194.0-255,766,86906,33,292025
11884,0.001912,172.31.33.0-255,66,86972,33,292025
11885,0.00215,172.217.194.0-255,1484,88456,33,292025
11886,0.002161,172.217.194.0-255,2902,91358,33,292025
11887,0.002165,172.31.33.0-255,66,91424,33,292025
11888,0.002169,172.217.194.0-255,1484,92908,33,292025
11889,0.002195,172.217.194.0-255,4320,97228,33,292025
11890,0.002198,172.31.33.0-255,66,97294,33,292025
11891,0.002213,172.31.33.0-255,66,97360,33,292025
11892,0.002216,172.217.194.0-255,1484,98844,33,292025
11893,0.002261,172.31.33.0-255,66,98910,33,292025
11894,0.004575,172.217.194.0-255,5738,104648,33,292025
11895,0.004583,172.31.33.0-255,66,104714,33,292025
11896,0.006905,172.217.194.0-255,4320,109034,33,292025
11897,0.006908,172.31.33.0-255,66,109100,33,292025
11898,0.006934,172.217.194.0-255,1484,110584,33,292025
11899,0.009246,172.217.194.0-255,4320,114904,33,292025
11900,0.009252,172.31.33.0-255,66,114970,33,292025
11901,0.011597,172.217.194.0-255,5738,120708,33,292025
11902,0.011605,172.31.33.0-255,66,120774,33,292025
11903,0.013986,172.217.194.0-255,5738,126512,33,292025
11904,0.013995,172.31.33.0-255,66,126578,33,292025
11905,0.016347,172.217.194.0-255,5738,132316,33,292025
11906,0.016356,172.31.33.0-255,66,132382,33,292025
11907,0.018688,172.217.194.0-255,5738,138120,33,292025
11908,0.018696,172.31.33.0-255,66,138186,33,292025
11909,0.021021,172.217.194.0-255,5738,143924,33,292025
11910,0.02103,172.31.33.0-255,66,143990,33,292025
11911,0.023346,172.217.194.0-255,5738,149728,33,292025
11912,0.023354,172.31.33.0-255,66,149794,33,292025
11913,0.025667,172.217.194.0-255,5738,155532,33,292025
11914,0.025676,172.31.33.0-255,66,155598,33,292025
11915,0.027817,172.31.33.0-255,176,155774,33,292025
11916,0.027848,172.31.33.0-255,1117,156891,33,292025
11917,0.027911,172.31.33.0-255,1514,158405,33,292025
11918,0.027913,172.31.33.0-255,1282,159687,33,292025
11919,0.027995,172.217.194.0-255,4320,164007,33,292025
11920,0.028001,172.31.33.0-255,66,164073,33,292025
11921,0.028026,172.217.194.0-255,1484,165557,33,292025
11922,0.029357,104.244.42.0-255,66,165623,33,292025
11923,0.029384,104.244.42.0-255,66,165689,33,292025
11924,0.029444,104.244.42.0-255,66,165755,33,292025
11925,0.030332,172.217.194.0-255,4320,170075,33,292025
11926,0.030339,172.31.33.0-255,66,170141,33,292025
11927,0.032695,172.217.194.0-255,5738,175879,33,292025
11928,0.032702,172.31.33.0-255,66,175945,33,292025
11929,0.035057,172.217.194.0-255,5738,181683,33,292025
11930,0.035064,172.31.33.0-255,66,181749,33,292025
11931,0.037405,172.217.194.0-255,5738,187487,33,292025
11932,0.037411,172.31.33.0-255,66,187553,33,292025
11933,0.039755,172.217.194.0-255,5738,193291,33,292025
11934,0.039772,172.31.33.0-255,66,193357,33,292025
11935,0.042107,172.217.194.0-255,5738,199095,33,292025
11936,0.042125,172.31.33.0-255,66,199161,33,292025
11937,0.044462,172.217.194.0-255,5738,204899,33,292025
11938,0.044471,172.31.33.0-255,66,204965,33,292025
11939,0.046831,172.217.194.0-255,5738,210703,33,292025
11940,0.04685,172.31.33.0-255,66,210769,33,292025
11941,0.049202,172.217.194.0-255,5738,216507,33,292025
11942,0.049211,172.31.33.0-255,66,216573,33,292025
11943,0.051563,172.217.194.0-255,5738,222311,33,292025
11944,0.05157,172.31.33.0-255,66,222377,33,292025
11945,0.053887,172.217.194.0-255,5738,228115,33,292025
11946,0.053894,172.31.33.0-255,66,228181,33,292025
11947,0.056202,172.217.194.0-255,5738,233919,33,292025
11948,0.056208,172.31.33.0-255,66,233985,33,292025
11949,0.058553,172.217.194.0-255,5738,239723,33,292025
11950,0.058559,172.31.33.0-255,66,239789,33,292025
11951,0.060919,172.217.194.0-255,5738,245527,33,292025
11952,0.060926,172.31.33.0-255,66,245593,33,292025
11953,0.063288,172.217.194.0-255,5738,251331,33,292025
11954,0.063293,172.31.33.0-255,66,251397,33,292025
11955,0.065616,172.217.194.0-255,5738,257135,33,292025
11956,0.065622,172.31.33.0-255,66,257201,33,292025
11957,0.06796,172.217.194.0-255,5738,262939,33,292025
11958,0.067969,172.31.33.0-255,66,263005,33,292025
11959,0.070275,172.217.194.0-255,5738,268743,33,292025
11960,0.070282,172.31.33.0-255,66,268809,33,292025
11961,0.072611,172.217.194.0-255,5738,274547,33,292025
11962,0.072617,172.31.33.0-255,66,274613,33,292025
11963,0.074938,172.217.194.0-255,5738,280351,33,292025
11964,0.074944,172.31.33.0-255,66,280417,33,292025
11965,0.077293,172.217.194.0-255,5738,286155,33,292025
11966,0.077299,172.31.33.0-255,66,286221,33,292025
11967,0.079627,172.217.194.0-255,5738,291959,33,292025
11968,0.079633,172.31.33.0-255,66,292025,33,292025
11969,0.0,74.125.68.0-255,153,153,33,344934
11970,1.3e-05,172.31.33.0-255,66,219,33,344934
11971,3.9e-05,74.125.68.0-255,1484,1703,33,344934
11972,4.3e-05,172.31.33.0-255,66,1769,33,344934
11973,4.9e-05,74.125.68.0-255,2902,4671,33,344934
11974,5.2e-05,172.31.33.0-255,66,4737,33,344934
11975,5.4e-05,74.125.68.0-255,1484,6221,33,344934
11976,5.7e-05,172.31.33.0-255,66,6287,33,344934
11977,6.2e-05,74.125.68.0-255,2902,9189,33,344934
11978,6.4e-05,172.31.33.0-255,66,9255,33,344934
11979,9.5e-05,74.125.68.0-255,1484,10739,33,344934
11980,9.7e-05,172.31.33.0-255,66,10805,33,344934
11981,0.000117,74.125.68.0-255,3449,14254,33,344934
11982,0.000119,172.31.33.0-255,66,14320,33,344934
11983,0.000151,74.125.68.0-255,1484,15804,33,344934
11984,0.000153,172.31.33.0-255,66,15870,33,344934
11985,0.000172,74.125.68.0-255,2902,18772,33,344934
11986,0.000175,172.31.33.0-255,66,18838,33,344934
11987,0.000179,74.125.68.0-255,1484,20322,33,344934
11988,0.000181,172.31.33.0-255,66,20388,33,344934
11989,0.000208,74.125.68.0-255,4320,24708,33,344934
11990,0.000211,172.31.33.0-255,66,24774,33,344934
11991,0.00023,74.125.68.0-255,2902,27676,33,344934
11992,0.000233,172.31.33.0-255,66,27742,33,344934
11993,0.000249,74.125.68.0-255,1484,29226,33,344934
11994,0.000252,172.31.33.0-255,66,29292,33,344934
11995,0.000274,74.125.68.0-255,2543,31835,33,344934
11996,0.000277,172.31.33.0-255,66,31901,33,344934
11997,0.000535,74.125.68.0-255,1484,33385,33,344934
11998,0.00054,172.31.33.0-255,66,33451,33,344934
11999,0.000546,74.125.68.0-255,2902,36353,33,344934
12000,0.000549,172.31.33.0-255,66,36419,33,344934
12001,0.000577,74.125.68.0-255,5738,42157,33,344934
12002,0.000581,172.31.33.0-255,66,42223,33,344934
12003,0.00062,74.125.68.0-255,6797,49020,33,344934
12004,0.000624,172.31.33.0-255,66,49086,33,344934
12005,0.000664,74.125.68.0-255,4320,53406,33,344934
12006,0.000667,172.31.33.0-255,66,53472,33,344934
12007,0.000681,74.125.68.0-255,2902,56374,33,344934
12008,0.000683,172.31.33.0-255,66,56440,33,344934
12009,0.000738,172.31.33.0-255,66,56506,33,344934
12010,0.000788,74.125.68.0-255,1125,57631,33,344934
12011,0.000791,74.125.68.0-255,646,58277,33,344934
12012,0.000794,172.31.33.0-255,66,58343,33,344934
12013,0.000862,74.125.68.0-255,2902,61245,33,344934
12014,0.000865,172.31.33.0-255,66,61311,33,344934
12015,0.000884,74.125.68.0-255,1484,62795,33,344934
12016,0.000891,74.125.68.0-255,5738,68533,33,344934
12017,0.000893,172.31.33.0-255,66,68599,33,344934
12018,0.000937,74.125.68.0-255,6797,75396,33,344934
12019,0.000941,172.31.33.0-255,66,75462,33,344934
12020,0.000976,74.125.68.0-255,1484,76946,33,344934
12021,0.000992,74.125.68.0-255,2902,79848,33,344934
12022,0.000995,172.31.33.0-255,66,79914,33,344934
12023,0.001018,74.125.68.0-255,5738,85652,33,344934
12024,0.001021,172.31.33.0-255,66,85718,33,344934
12025,0.001072,74.125.68.0-255,4320,90038,33,344934
12026,0.001075,172.31.33.0-255,66,90104,33,344934
12027,0.001093,74.125.68.0-255,2543,92647,33,344934
12028,0.001096,172.31.33.0-255,66,92713,33,344934
12029,0.001264,74.125.68.0-255,1484,94197,33,344934
12030,0.001268,74.125.68.0-255,1484,95681,33,344934
12031,0.001271,172.31.33.0-255,66,95747,33,344934
12032,0.001289,74.125.68.0-255,1484,97231,33,344934
12033,0.001304,74.125.68.0-255,5738,102969,33,344934
12034,0.001306,172.31.33.0-255,66,103035,33,344934
12035,0.001336,74.125.68.0-255,5738,108773,33,344934
12036,0.001339,172.31.33.0-255,66,108839,33,344934
12037,0.001353,74.125.68.0-255,4320,113159,33,344934
12038,0.001357,172.31.33.0-255,66,113225,33,344934
12039,0.001443,172.31.33.0-255,66,113291,33,344934
12040,0.001447,74.125.68.0-255,1484,114775,33,344934
12041,0.001523,74.125.68.0-255,2184,116959,33,344934
12042,0.001526,172.31.33.0-255,66,117025,33,344934
12043,0.001788,74.125.68.0-255,1484,118509,33,344934
12044,0.001795,74.125.68.0-255,2902,121411,33,344934
12045,0.001798,172.31.33.0-255,66,121477,33,344934
12046,0.001818,74.125.68.0-255,5738,127215,33,344934
12047,0.001821,172.31.33.0-255,66,127281,33,344934
12048,0.001853,74.125.68.0-255,1484,128765,33,344934
12049,0.001871,74.125.68.0-255,2902,131667,33,344934
12050,0.001874,172.31.33.0-255,66,131733,33,344934
12051,0.001888,74.125.68.0-255,2902,134635,33,344934
12052,0.001892,172.31.33.0-255,66,134701,33,344934
12053,0.001901,74.125.68.0-255,2902,137603,33,344934
12054,0.001903,172.31.33.0-255,66,137669,33,344934
12055,0.00196,172.31.33.0-255,66,137735,33,344934
12056,0.002054,74.125.68.0-255,2184,139919,33,344934
12057,0.002058,172.31.33.0-255,66,139985,33,344934
12058,0.002063,74.125.68.0-255,2902,142887,33,344934
12059,0.002065,172.31.33.0-255,66,142953,33,344934
12060,0.002087,172.31.33.0-255,66,143019,33,344934
12061,0.002102,74.125.68.0-255,2902,145921,33,344934
12062,0.002104,172.31.33.0-255,66,145987,33,344934
12063,0.002205,74.125.68.0-255,4320,150307,33,344934
12064,0.002209,172.31.33.0-255,66,150373,33,344934
12065,0.002231,74.125.68.0-255,1484,151857,33,344934
12066,0.002259,172.31.33.0-255,66,151923,33,344934
12067,0.002279,74.125.68.0-255,3602,155525,33,344934
12068,0.002281,172.31.33.0-255,66,155591,33,344934
12069,0.00236,74.125.68.0-255,2902,158493,33,344934
12070,0.002363,172.31.33.0-255,66,158559,33,344934
12071,0.002399,172.31.33.0-255,66,158625,33,344934
12072,0.002548,74.125.68.0-255,7156,165781,33,344934
12073,0.002552,172.31.33.0-255,66,165847,33,344934
12074,0.002576,74.125.68.0-255,6438,172285,33,344934
12075,0.002579,172.31.33.0-255,66,172351,33,344934
12076,0.004935,74.125.68.0-255,4320,176671,33,344934
12077,0.004942,172.31.33.0-255,66,176737,33,344934
12078,0.004962,74.125.68.0-255,1484,178221,33,344934
12079,0.007299,74.125.68.0-255,4320,182541,33,344934
12080,0.007304,172.31.33.0-255,66,182607,33,344934
12081,0.00967,74.125.68.0-255,5738,188345,33,344934
12082,0.009676,172.31.33.0-255,66,188411,33,344934
12083,0.012051,74.125.68.0-255,5738,194149,33,344934
12084,0.012062,172.31.33.0-255,66,194215,33,344934
12085,0.014442,74.125.68.0-255,5738,199953,33,344934
12086,0.014452,172.31.33.0-255,66,200019,33,344934
12087,0.016816,74.125.68.0-255,5738,205757,33,344934
12088,0.016824,172.31.33.0-255,66,205823,33,344934
12089,0.019227,74.125.68.0-255,5738,211561,33,344934
12090,0.019233,172.31.33.0-255,66,211627,33,344934
12091,0.021608,74.125.68.0-255,5738,217365,33,344934
12092,0.021614,172.31.33.0-255,66,217431,33,344934
12093,0.023976,74.125.68.0-255,4320,221751,33,344934
12094,0.023983,172.31.33.0-255,66,221817,33,344934
12095,0.024001,74.125.68.0-255,1484,223301,33,344934
12096,0.02635,74.125.68.0-255,4320,227621,33,344934
12097,0.026357,172.31.33.0-255,66,227687,33,344934
12098,0.0279,172.31.33.0-255,171,227858,33,344934
12099,0.027931,172.31.33.0-255,1141,228999,33,344934
12100,0.027991,172.31.33.0-255,1514,230513,33,344934
12101,0.027993,172.31.33.0-255,1514,232027,33,344934
12102,0.028016,172.31.33.0-255,653,232680,33,344934
12103,0.028726,74.125.68.0-255,5738,238418,33,344934
12104,0.028732,172.31.33.0-255,66,238484,33,344934
12105,0.02949,104.244.42.0-255,66,238550,33,344934
12106,0.029509,104.244.42.0-255,66,238616,33,344934
12107,0.029577,104.244.42.0-255,66,238682,33,344934
12108,0.029582,104.244.42.0-255,66,238748,33,344934
12109,0.031105,74.125.68.0-255,2902,241650,33,344934
12110,0.031111,172.31.33.0-255,66,241716,33,344934
12111,0.031128,74.125.68.0-255,2902,244618,33,344934
12112,0.031131,172.31.33.0-255,66,244684,33,344934
12113,0.033478,74.125.68.0-255,2902,247586,33,344934
12114,0.033485,172.31.33.0-255,66,247652,33,344934
12115,0.033507,74.125.68.0-255,2902,250554,33,344934
12116,0.03351,172.31.33.0-255,66,250620,33,344934
12117,0.035862,74.125.68.0-255,5738,256358,33,344934
12118,0.035868,172.31.33.0-255,66,256424,33,344934
12119,0.038245,74.125.68.0-255,5738,262162,33,344934
12120,0.03825,172.31.33.0-255,66,262228,33,344934
12121,0.040652,74.125.68.0-255,5738,267966,33,344934
12122,0.040657,172.31.33.0-255,66,268032,33,344934
12123,0.043029,74.125.68.0-255,5738,273770,33,344934
12124,0.043035,172.31.33.0-255,66,273836,33,344934
12125,0.045436,74.125.68.0-255,5738,279574,33,344934
12126,0.045441,172.31.33.0-255,66,279640,33,344934
12127,0.047824,74.125.68.0-255,5738,285378,33,344934
12128,0.047831,172.31.33.0-255,66,285444,33,344934
12129,0.050195,74.125.68.0-255,5738,291182,33,344934
12130,0.0502,172.31.33.0-255,66,291248,33,344934
12131,0.052571,74.125.68.0-255,5738,296986,33,344934
12132,0.052577,172.31.33.0-255,66,297052,33,344934
12133,0.054933,74.125.68.0-255,1484,298536,33,344934
12134,0.054957,74.125.68.0-255,4320,302856,33,344934
12135,0.054963,172.31.33.0-255,66,302922,33,344934
12136,0.057338,74.125.68.0-255,5738,308660,33,344934
12137,0.057344,172.31.33.0-255,66,308726,33,344934
12138,0.059698,74.125.68.0-255,4320,313046,33,344934
12139,0.059703,172.31.33.0-255,66,313112,33,344934
12140,0.05972,74.125.68.0-255,1484,314596,33,344934
12141,0.062095,74.125.68.0-255,4320,318916,33,344934
12142,0.0621,172.31.33.0-255,66,318982,33,344934
12143,0.064475,74.125.68.0-255,5738,324720,33,344934
12144,0.064481,172.31.33.0-255,66,324786,33,344934
12145,0.066864,74.125.68.0-255,5738,330524,33,344934
12146,0.066871,172.31.33.0-255,66,330590,33,344934
12147,0.069262,74.125.68.0-255,5738,336328,33,344934
12148,0.069269,172.31.33.0-255,66,336394,33,344934
12149,0.071637,74.125.68.0-255,5738,342132,33,344934
12150,0.071643,172.31.33.0-255,66,342198,33,344934
12151,0.074005,74.125.68.0-255,2499,344697,33,344934
12152,0.074012,172.31.33.0-255,66,344763,33,344934
12153,0.074156,172.31.33.0-255,105,344868,33,344934
12154,0.076483,74.125.68.0-255,66,344934,33,344934
12155,0.0,172.31.33.0-255,105,105,33,276
12156,0.002082,157.240.7.0-255,105,210,33,276
12157,0.002091,172.31.33.0-255,66,276,33,276
12158,0.0,172.253.118.0-255,153,153,33,220371
12159,2.4e-05,172.31.33.0-255,66,219,33,220371
12160,4.5e-05,172.253.118.0-255,1484,1703,33,220371
12161,4.9e-05,172.31.33.0-255,66,1769,33,220371
12162,6.5e-05,172.253.118.0-255,2902,4671,33,220371
12163,7e-05,172.31.33.0-255,66,4737,33,220371
12164,7.4e-05,172.253.118.0-255,2902,7639,33,220371
12165,7.7e-05,172.31.33.0-255,66,7705,33,220371
12166,0.00011,172.253.118.0-255,6311,14016,33,220371
12167,0.000113,172.31.33.0-255,66,14082,33,220371
12168,0.000322,172.253.118.0-255,1484,15566,33,220371
12169,0.000329,172.31.33.0-255,66,15632,33,220371
12170,0.000335,172.253.118.0-255,2902,18534,33,220371
12171,0.000338,172.31.33.0-255,66,18600,33,220371
12172,0.000345,172.253.118.0-255,5738,24338,33,220371
12173,0.000348,172.31.33.0-255,66,24404,33,220371
12174,0.000405,172.31.33.0-255,66,24470,33,220371
12175,0.000418,172.31.33.0-255,66,24536,33,220371
12176,0.000464,172.253.118.0-255,3961,28497,33,220371
12177,0.000466,172.31.33.0-255,66,28563,33,220371
12178,0.000489,172.253.118.0-255,4320,32883,33,220371
12179,0.000492,172.31.33.0-255,66,32949,33,220371
12180,0.000495,172.253.118.0-255,1484,34433,33,220371
12181,0.000498,172.31.33.0-255,66,34499,33,220371
12182,0.000518,172.253.118.0-255,4320,38819,33,220371
12183,0.000521,172.31.33.0-255,66,38885,33,220371
12184,0.000544,172.253.118.0-255,6797,45682,33,220371
12185,0.000547,172.31.33.0-255,66,45748,33,220371
12186,0.000595,172.253.118.0-255,416,46164,33,220371
12187,0.000598,172.31.33.0-255,66,46230,33,220371
12188,0.000631,172.253.118.0-255,1484,47714,33,220371
12189,0.000636,172.253.118.0-255,2902,50616,33,220371
12190,0.000639,172.31.33.0-255,66,50682,33,220371
12191,0.000643,172.253.118.0-255,1484,52166,33,220371
12192,0.000662,172.253.118.0-255,4320,56486,33,220371
12193,0.000665,172.31.33.0-255,66,56552,33,220371
12194,0.000677,172.253.118.0-255,2902,59454,33,220371
12195,0.000681,172.31.33.0-255,66,59520,33,220371
12196,0.000714,172.253.118.0-255,5738,65258,33,220371
12197,0.000719,172.31.33.0-255,66,65324,33,220371
12198,0.000722,172.31.33.0-255,66,65390,33,220371
12199,0.000748,172.253.118.0-255,4320,69710,33,220371
12200,0.000751,172.31.33.0-255,66,69776,33,220371
12201,0.000767,172.253.118.0-255,447,70223,33,220371
12202,0.00094,172.253.118.0-255,1484,71707,33,220371
12203,0.000945,172.31.33.0-255,66,71773,33,220371
12204,0.000949,172.253.118.0-255,1484,73257,33,220371
12205,0.000971,172.253.118.0-255,1484,74741,33,220371
12206,0.000974,172.31.33.0-255,66,74807,33,220371
12207,0.000981,172.253.118.0-255,5738,80545,33,220371
12208,0.000984,172.31.33.0-255,66,80611,33,220371
12209,0.000992,172.253.118.0-255,7156,87767,33,220371
12210,0.000994,172.31.33.0-255,66,87833,33,220371
12211,0.001021,172.253.118.0-255,5738,93571,33,220371
12212,0.001023,172.31.33.0-255,66,93637,33,220371
12213,0.001031,172.253.118.0-255,7156,100793,33,220371
12214,0.001035,172.31.33.0-255,66,100859,33,220371
12215,0.001039,172.253.118.0-255,2902,103761,33,220371
12216,0.001041,172.31.33.0-255,66,103827,33,220371
12217,0.001061,172.253.118.0-255,766,104593,33,220371
12218,0.001092,172.253.118.0-255,1484,106077,33,220371
12219,0.001094,172.31.33.0-255,66,106143,33,220371
12220,0.0011,172.253.118.0-255,2902,109045,33,220371
12221,0.001102,172.31.33.0-255,66,109111,33,220371
12222,0.001122,172.253.118.0-255,5738,114849,33,220371
12223,0.001125,172.31.33.0-255,66,114915,33,220371
12224,0.001146,172.31.33.0-255,66,114981,33,220371
12225,0.001171,172.253.118.0-255,2902,117883,33,220371
12226,0.001174,172.31.33.0-255,66,117949,33,220371
12227,0.001181,172.253.118.0-255,7156,125105,33,220371
12228,0.001184,172.31.33.0-255,66,125171,33,220371
12229,0.0012,172.253.118.0-255,4320,129491,33,220371
12230,0.001202,172.31.33.0-255,66,129557,33,220371
12231,0.001227,172.31.33.0-255,66,129623,33,220371
12232,0.001255,172.253.118.0-255,3602,133225,33,220371
12233,0.001258,172.31.33.0-255,66,133291,33,220371
12234,0.001269,172.31.33.0-255,66,133357,33,220371
12235,0.001275,172.253.118.0-255,5020,138377,33,220371
12236,0.001278,172.31.33.0-255,66,138443,33,220371
12237,0.001306,172.253.118.0-255,5738,144181,33,220371
12238,0.001309,172.31.33.0-255,66,144247,33,220371
12239,0.001323,172.31.33.0-255,66,144313,33,220371
12240,0.001412,172.31.33.0-255,66,144379,33,220371
12241,0.001429,172.253.118.0-255,5020,149399,33,220371
12242,0.001431,172.31.33.0-255,66,149465,33,220371
12243,0.001443,172.31.33.0-255,66,149531,33,220371
12244,0.001461,172.31.33.0-255,66,149597,33,220371
12245,0.001491,172.31.33.0-255,66,149663,33,220371
12246,0.001562,172.253.118.0-255,1484,151147,33,220371
12247,0.001565,172.253.118.0-255,1484,152631,33,220371
12248,0.001579,172.253.118.0-255,1484,154115,33,220371
12249,0.001589,172.31.33.0-255,66,154181,33,220371
12250,0.001597,172.253.118.0-255,5738,159919,33,220371
12251,0.001599,172.31.33.0-255,66,159985,33,220371
12252,0.001666,172.31.33.0-255,66,160051,33,220371
12253,0.001757,172.253.118.0-255,1484,161535,33,220371
12254,0.001763,172.253.118.0-255,2902,164437,33,220371
12255,0.001773,172.31.33.0-255,66,164503,33,220371
12256,0.001789,172.253.118.0-255,5738,170241,33,220371
12257,0.001801,172.253.118.0-255,1484,171725,33,220371
12258,0.001809,172.31.33.0-255,66,171791,33,220371
12259,0.001835,172.253.118.0-255,5738,177529,33,220371
12260,0.001854,172.31.33.0-255,66,177595,33,220371
12261,0.001866,172.253.118.0-255,5020,182615,33,220371
12262,0.00187,172.31.33.0-255,66,182681,33,220371
12263,0.001914,172.253.118.0-255,4320,187001,33,220371
12264,0.001918,172.253.118.0-255,1484,188485,33,220371
12265,0.001923,172.31.33.0-255,66,188551,33,220371
12266,0.001944,172.253.118.0-255,4320,192871,33,220371
12267,0.001968,172.31.33.0-255,66,192937,33,220371
12268,0.001971,172.253.118.0-255,1484,194421,33,220371
12269,0.001976,172.253.118.0-255,4320,198741,33,220371
12270,0.001987,172.31.33.0-255,66,198807,33,220371
12271,0.002022,172.253.118.0-255,5738,204545,33,220371
12272,0.00207,172.31.33.0-255,66,204611,33,220371
12273,0.002078,172.31.33.0-255,66,204677,33,220371
12274,0.0021,172.253.118.0-255,7156,211833,33,220371
12275,0.002113,172.253.118.0-255,3913,215746,33,220371
12276,0.002116,172.253.118.0-255,105,215851,33,220371
12277,0.002125,172.31.33.0-255,66,215917,33,220371
12278,0.004525,172.31.33.0-255,105,216022,33,220371
12279,0.006803,172.253.118.0-255,66,216088,33,220371
12280,0.042183,172.31.33.0-255,172,216260,33,220371
12281,0.042229,172.31.33.0-255,1117,217377,33,220371
12282,0.042286,172.31.33.0-255,1514,218891,33,220371
12283,0.042288,172.31.33.0-255,1282,220173,33,220371
12284,0.043735,104.244.42.0-255,66,220239,33,220371
12285,0.043807,104.244.42.0-255,66,220305,33,220371
12286,0.043872,104.244.42.0-255,66,220371,33,220371
12287,0.0,74.125.130.0-255,153,153,33,253613
12288,2.7e-05,172.31.33.0-255,66,219,33,253613
12289,0.000158,74.125.130.0-255,1484,1703,33,253613
12290,0.000163,172.31.33.0-255,66,1769,33,253613
12291,0.000194,74.125.130.0-255,2902,4671,33,253613
12292,0.000198,172.31.33.0-255,66,4737,33,253613
12293,0.000204,74.125.130.0-255,5738,10475,33,253613
12294,0.000206,172.31.33.0-255,66,10541,33,253613
12295,0.000216,74.125.130.0-255,3438,13979,33,253613
12296,0.000219,172.31.33.0-255,66,14045,33,253613
12297,0.000244,74.125.130.0-255,4320,18365,33,253613
12298,0.000247,172.31.33.0-255,66,18431,33,253613
12299,0.000256,74.125.130.0-255,1484,19915,33,253613
12300,0.000258,172.31.33.0-255,66,19981,33,253613
12301,0.000282,74.125.130.0-255,1484,21465,33,253613
12302,0.000285,172.31.33.0-255,66,21531,33,253613
12303,0.000294,74.125.130.0-255,4320,25851,33,253613
12304,0.000296,172.31.33.0-255,66,25917,33,253613
12305,0.00033,74.125.130.0-255,5379,31296,33,253613
12306,0.000333,172.31.33.0-255,66,31362,33,253613
12307,0.000748,74.125.130.0-255,1484,32846,33,253613
12308,0.000753,172.31.33.0-255,66,32912,33,253613
12309,0.00076,74.125.130.0-255,1484,34396,33,253613
12310,0.000762,172.31.33.0-255,66,34462,33,253613
12311,0.000789,74.125.130.0-255,2902,37364,33,253613
12312,0.000791,172.31.33.0-255,66,37430,33,253613
12313,0.000797,74.125.130.0-255,5738,43168,33,253613
12314,0.000799,172.31.33.0-255,66,43234,33,253613
12315,0.000817,74.125.130.0-255,5379,48613,33,253613
12316,0.000819,172.31.33.0-255,66,48679,33,253613
12317,0.000866,74.125.130.0-255,1484,50163,33,253613
12318,0.000869,172.31.33.0-255,66,50229,33,253613
12319,0.000891,74.125.130.0-255,2902,53131,33,253613
12320,0.000893,172.31.33.0-255,66,53197,33,253613
12321,0.000924,74.125.130.0-255,4320,57517,33,253613
12322,0.000927,172.31.33.0-255,66,57583,33,253613
12323,0.000953,74.125.130.0-255,1484,59067,33,253613
12324,0.000975,74.125.130.0-255,4320,63387,33,253613
12325,0.000978,172.31.33.0-255,66,63453,33,253613
12326,0.000981,74.125.130.0-255,1484,64937,33,253613
12327,0.001013,74.125.130.0-255,1416,66353,33,253613
12328,0.001014,172.31.33.0-255,66,66419,33,253613
12329,0.003343,74.125.130.0-255,363,66782,33,253613
12330,0.003947,74.125.130.0-255,1484,68266,33,253613
12331,0.003951,172.31.33.0-255,66,68332,33,253613
12332,0.003955,74.125.130.0-255,2902,71234,33,253613
12333,0.003957,172.31.33.0-255,66,71300,33,253613
12334,0.006354,74.125.130.0-255,5738,77038,33,253613
12335,0.006361,172.31.33.0-255,66,77104,33,253613
12336,0.008786,74.125.130.0-255,5738,82842,33,253613
12337,0.008793,172.31.33.0-255,66,82908,33,253613
12338,0.011201,74.125.130.0-255,5738,88646,33,253613
12339,0.011208,172.31.33.0-255,66,88712,33,253613
12340,0.01362,74.125.130.0-255,5738,94450,33,253613
12341,0.013626,172.31.33.0-255,66,94516,33,253613
12342,0.016037,74.125.130.0-255,5738,100254,33,253613
12343,0.016047,172.31.33.0-255,66,100320,33,253613
12344,0.01847,74.125.130.0-255,5738,106058,33,253613
12345,0.018477,172.31.33.0-255,66,106124,33,253613
12346,0.020883,74.125.130.0-255,5738,111862,33,253613
12347,0.02089,172.31.33.0-255,66,111928,33,253613
12348,0.023296,74.125.130.0-255,1484,113412,33,253613
12349,0.023324,74.125.130.0-255,4320,117732,33,253613
12350,0.023329,172.31.33.0-255,66,117798,33,253613
12351,0.023669,172.31.33.0-255,172,117970,33,253613
12352,0.023693,172.31.33.0-255,1117,119087,33,253613
12353,0.023723,172.31.33.0-255,1514,120601,33,253613
12354,0.023725,172.31.33.0-255,1514,122115,33,253613
12355,0.023745,172.31.33.0-255,676,122791,33,253613
12356,0.025328,104.244.42.0-255,66,122857,33,253613
12357,0.025376,104.244.42.0-255,66,122923,33,253613
12358,0.025421,104.244.42.0-255,66,122989,33,253613
12359,0.025425,104.244.42.0-255,66,123055,33,253613
12360,0.025717,74.125.130.0-255,1484,124539,33,253613
12361,0.02575,74.125.130.0-255,4320,128859,33,253613
12362,0.025755,172.31.33.0-255,66,128925,33,253613
12363,0.028164,74.125.130.0-255,5738,134663,33,253613
12364,0.028171,172.31.33.0-255,66,134729,33,253613
12365,0.030587,74.125.130.0-255,5738,140467,33,253613
12366,0.030594,172.31.33.0-255,66,140533,33,253613
12367,0.032997,74.125.130.0-255,5738,146271,33,253613
12368,0.033003,172.31.33.0-255,66,146337,33,253613
12369,0.03541,74.125.130.0-255,1484,147821,33,253613
12370,0.035434,74.125.130.0-255,4320,152141,33,253613
12371,0.035438,172.31.33.0-255,66,152207,33,253613
12372,0.037842,74.125.130.0-255,5738,157945,33,253613
12373,0.037849,172.31.33.0-255,66,158011,33,253613
12374,0.040286,74.125.130.0-255,2902,160913,33,253613
12375,0.040292,172.31.33.0-255,66,160979,33,253613
12376,0.040328,74.125.130.0-255,2902,163881,33,253613
12377,0.040331,172.31.33.0-255,66,163947,33,253613
12378,0.042698,74.125.130.0-255,2902,166849,33,253613
12379,0.042703,172.31.33.0-255,66,166915,33,253613
12380,0.042731,74.125.130.0-255,2902,169817,33,253613
12381,0.042733,172.31.33.0-255,66,169883,33,253613
12382,0.045099,74.125.130.0-255,1484,171367,33,253613
12383,0.045128,74.125.130.0-255,1484,172851,33,253613
12384,0.045132,172.31.33.0-255,66,172917,33,253613
12385,0.045147,74.125.130.0-255,1484,174401,33,253613
12386,0.045156,74.125.130.0-255,1484,175885,33,253613
12387,0.045158,172.31.33.0-255,66,175951,33,253613
12388,0.047543,74.125.130.0-255,4320,180271,33,253613
12389,0.047549,172.31.33.0-255,66,180337,33,253613
12390,0.047586,74.125.130.0-255,1484,181821,33,253613
12391,0.049954,74.125.130.0-255,4320,186141,33,253613
12392,0.049959,172.31.33.0-255,66,186207,33,253613
12393,0.052374,74.125.130.0-255,1484,187691,33,253613
12394,0.052396,74.125.130.0-255,4320,192011,33,253613
12395,0.052401,172.31.33.0-255,66,192077,33,253613
12396,0.054804,74.125.130.0-255,4320,196397,33,253613
12397,0.054809,172.31.33.0-255,66,196463,33,253613
12398,0.054824,74.125.130.0-255,1484,197947,33,253613
12399,0.057216,74.125.130.0-255,4320,202267,33,253613
12400,0.057224,172.31.33.0-255,66,202333,33,253613
12401,0.059635,74.125.130.0-255,5738,208071,33,253613
12402,0.059641,172.31.33.0-255,66,208137,33,253613
12403,0.062058,74.125.130.0-255,5738,213875,33,253613
12404,0.062064,172.31.33.0-255,66,213941,33,253613
12405,0.064462,74.125.130.0-255,4320,218261,33,253613
12406,0.064467,172.31.33.0-255,66,218327,33,253613
12407,0.064498,74.125.130.0-255,1484,219811,33,253613
12408,0.06687,74.125.130.0-255,1484,221295,33,253613
12409,0.066875,172.31.33.0-255,66,221361,33,253613
12410,0.066907,74.125.130.0-255,2902,224263,33,253613
12411,0.06691,172.31.33.0-255,66,224329,33,253613
12412,0.069281,74.125.130.0-255,2902,227231,33,253613
12413,0.069287,172.31.33.0-255,66,227297,33,253613
12414,0.069321,74.125.130.0-255,2902,230199,33,253613
12415,0.069323,172.31.33.0-255,66,230265,33,253613
12416,0.071695,74.125.130.0-255,1484,231749,33,253613
12417,0.071727,74.125.130.0-255,4320,236069,33,253613
12418,0.071731,172.31.33.0-255,66,236135,33,253613
12419,0.074129,74.125.130.0-255,5738,241873,33,253613
12420,0.074135,172.31.33.0-255,66,241939,33,253613
12421,0.076539,74.125.130.0-255,5738,247677,33,253613
12422,0.076545,172.31.33.0-255,66,247743,33,253613
12423,0.078969,74.125.130.0-255,4320,252063,33,253613
12424,0.078976,172.31.33.0-255,66,252129,33,253613
12425,0.079004,74.125.130.0-255,1484,253613,33,253613
12426,0.0,172.31.33.0-255,105,105,33,1011
12427,4.6e-05,172.31.33.0-255,105,210,33,1011
12428,0.001476,157.240.7.0-255,105,315,33,1011
12429,0.001488,172.31.33.0-255,66,381,33,1011
12430,0.002098,157.240.7.0-255,105,486,33,1011
12431,0.002102,172.31.33.0-255,66,552,33,1011
12432,0.048153,172.31.33.0-255,105,657,33,1011
12433,0.048339,172.31.33.0-255,90,747,33,1011
12434,0.048347,172.31.33.0-255,66,813,33,1011
12435,0.050616,74.125.24.0-255,66,879,33,1011
12436,0.050627,74.125.24.0-255,66,945,33,1011
12437,0.050636,172.31.33.0-255,66,1011,33,1011
12438,0.0,74.125.24.0-255,152,152,33,224165
12439,2.1e-05,172.31.33.0-255,66,218,33,224165
12440,2.6e-05,74.125.24.0-255,1484,1702,33,224165
12441,3e-05,172.31.33.0-255,66,1768,33,224165
12442,3.5e-05,74.125.24.0-255,2902,4670,33,224165
12443,4.4e-05,172.31.33.0-255,66,4736,33,224165
12444,4.6e-05,74.125.24.0-255,1484,6220,33,224165
12445,4.9e-05,172.31.33.0-255,66,6286,33,224165
12446,8.2e-05,74.125.24.0-255,4320,10606,33,224165
12447,8.4e-05,172.31.33.0-255,66,10672,33,224165
12448,0.00012,172.31.33.0-255,66,10738,33,224165
12449,0.000154,74.125.24.0-255,539,11277,33,224165
12450,0.000157,172.31.33.0-255,66,11343,33,224165
12451,0.000164,74.125.24.0-255,6797,18140,33,224165
12452,0.000166,172.31.33.0-255,66,18206,33,224165
12453,0.000198,74.125.24.0-255,7156,25362,33,224165
12454,0.000201,172.31.33.0-255,66,25428,33,224165
12455,0.000207,74.125.24.0-255,7156,32584,33,224165
12456,0.000209,172.31.33.0-255,66,32650,33,224165
12457,0.000233,74.125.24.0-255,2543,35193,33,224165
12458,0.00024,172.31.33.0-255,66,35259,33,224165
12459,0.000357,74.125.24.0-255,1484,36743,33,224165
12460,0.000361,172.31.33.0-255,66,36809,33,224165
12461,0.000366,74.125.24.0-255,2902,39711,33,224165
12462,0.000369,172.31.33.0-255,66,39777,33,224165
12463,0.000405,74.125.24.0-255,5738,45515,33,224165
12464,0.000412,74.125.24.0-255,6797,52312,33,224165
12465,0.000413,172.31.33.0-255,66,52378,33,224165
12466,0.000417,172.31.33.0-255,66,52444,33,224165
12467,0.000474,74.125.24.0-255,412,52856,33,224165
12468,0.000479,172.31.33.0-255,66,52922,33,224165
12469,0.00095,74.125.24.0-255,331,53253,33,224165
12470,0.00098,74.125.24.0-255,1484,54737,33,224165
12471,0.000985,172.31.33.0-255,66,54803,33,224165
12472,0.00099,74.125.24.0-255,1484,56287,33,224165
12473,0.001014,74.125.24.0-255,2902,59189,33,224165
12474,0.001018,172.31.33.0-255,66,59255,33,224165
12475,0.001024,74.125.24.0-255,4320,63575,33,224165
12476,0.001026,172.31.33.0-255,66,63641,33,224165
12477,0.001038,74.125.24.0-255,4320,67961,33,224165
12478,0.001041,172.31.33.0-255,66,68027,33,224165
12479,0.001068,74.125.24.0-255,5738,73765,33,224165
12480,0.001072,172.31.33.0-255,66,73831,33,224165
12481,0.001092,172.31.33.0-255,66,73897,33,224165
12482,0.00113,74.125.24.0-255,1484,75381,33,224165
12483,0.001136,74.125.24.0-255,2902,78283,33,224165
12484,0.001138,172.31.33.0-255,66,78349,33,224165
12485,0.001142,74.125.24.0-255,1484,79833,33,224165
12486,0.001173,74.125.24.0-255,4320,84153,33,224165
12487,0.001176,172.31.33.0-255,66,84219,33,224165
12488,0.001181,74.125.24.0-255,4320,88539,33,224165
12489,0.001184,172.31.33.0-255,66,88605,33,224165
12490,0.00121,74.125.24.0-255,1484,90089,33,224165
12491,0.001232,172.31.33.0-255,66,90155,33,224165
12492,0.001235,74.125.24.0-255,1484,91639,33,224165
12493,0.00126,74.125.24.0-255,1484,93123,33,224165
12494,0.001262,172.31.33.0-255,66,93189,33,224165
12495,0.001294,74.125.24.0-255,5020,98209,33,224165
12496,0.001298,172.31.33.0-255,66,98275,33,224165
12497,0.001752,74.125.24.0-255,1484,99759,33,224165
12498,0.001757,74.125.24.0-255,2902,102661,33,224165
12499,0.001761,172.31.33.0-255,66,102727,33,224165
12500,0.001786,74.125.24.0-255,5738,108465,33,224165
12501,0.001788,172.31.33.0-255,66,108531,33,224165
12502,0.001791,74.125.24.0-255,1484,110015,33,224165
12503,0.001823,172.31.33.0-255,66,110081,33,224165
12504,0.001826,74.125.24.0-255,1484,111565,33,224165
12505,0.00185,172.31.33.0-255,66,111631,33,224165
12506,0.001879,74.125.24.0-255,1484,113115,33,224165
12507,0.001882,74.125.24.0-255,2902,116017,33,224165
12508,0.001884,172.31.33.0-255,66,116083,33,224165
12509,0.001888,74.125.24.0-255,2902,118985,33,224165
12510,0.00189,172.31.33.0-255,66,119051,33,224165
12511,0.001908,74.125.24.0-255,2902,121953,33,224165
12512,0.001909,172.31.33.0-255,66,122019,33,224165
12513,0.001912,74.125.24.0-255,1484,123503,33,224165
12514,0.001949,172.31.33.0-255,66,123569,33,224165
12515,0.001958,172.31.33.0-255,66,123635,33,224165
12516,0.001987,74.125.24.0-255,5738,129373,33,224165
12517,0.001989,172.31.33.0-255,66,129439,33,224165
12518,0.002023,172.31.33.0-255,66,129505,33,224165
12519,0.002044,74.125.24.0-255,2184,131689,33,224165
12520,0.002046,172.31.33.0-255,66,131755,33,224165
12521,0.002055,172.31.33.0-255,66,131821,33,224165
12522,0.002078,74.125.24.0-255,1484,133305,33,224165
12523,0.002089,74.125.24.0-255,1484,134789,33,224165
12524,0.002091,172.31.33.0-255,66,134855,33,224165
12525,0.002102,74.125.24.0-255,1484,136339,33,224165
12526,0.002111,74.125.24.0-255,5738,142077,33,224165
12527,0.002113,172.31.33.0-255,66,142143,33,224165
12528,0.002168,172.31.33.0-255,66,142209,33,224165
12529,0.002196,74.125.24.0-255,2902,145111,33,224165
12530,0.002198,172.31.33.0-255,66,145177,33,224165
12531,0.002207,172.31.33.0-255,66,145243,33,224165
12532,0.002231,74.125.24.0-255,1484,146727,33,224165
12533,0.002235,74.125.24.0-255,2902,149629,33,224165
12534,0.002237,172.31.33.0-255,66,149695,33,224165
12535,0.002241,74.125.24.0-255,2902,152597,33,224165
12536,0.002242,172.31.33.0-255,66,152663,33,224165
12537,0.002266,74.125.24.0-255,2902,155565,33,224165
12538,0.002268,172.31.33.0-255,66,155631,33,224165
12539,0.002278,74.125.24.0-255,2902,158533,33,224165
12540,0.00228,172.31.33.0-255,66,158599,33,224165
12541,0.002317,172.31.33.0-255,66,158665,33,224165
12542,0.002326,172.31.33.0-255,66,158731,33,224165
12543,0.002329,74.125.24.0-255,2902,161633,33,224165
12544,0.002336,172.31.33.0-255,66,161699,33,224165
12545,0.002371,172.31.33.0-255,66,161765,33,224165
12546,0.002387,74.125.24.0-255,3602,165367,33,224165
12547,0.002389,172.31.33.0-255,66,165433,33,224165
12548,0.002398,172.31.33.0-255,66,165499,33,224165
12549,0.002401,74.125.24.0-255,2902,168401,33,224165
12550,0.002405,172.31.33.0-255,66,168467,33,224165
12551,0.002439,172.31.33.0-255,66,168533,33,224165
12552,0.004749,74.125.24.0-255,5738,174271,33,224165
12553,0.004755,172.31.33.0-255,66,174337,33,224165
12554,0.004881,172.31.33.0-255,101,174438,33,224165
12555,0.007076,74.125.24.0-255,5738,180176,33,224165
12556,0.00708,172.31.33.0-255,66,180242,33,224165
12557,0.007156,74.125.24.0-255,66,180308,33,224165
12558,0.009422,74.125.24.0-255,5738,186046,33,224165
12559,0.009429,172.31.33.0-255,66,186112,33,224165
12560,0.011773,74.125.24.0-255,5738,191850,33,224165
12561,0.01178,172.31.33.0-255,66,191916,33,224165
12562,0.014113,74.125.24.0-255,5738,197654,33,224165
12563,0.014118,172.31.33.0-255,66,197720,33,224165
12564,0.016433,74.125.24.0-255,5738,203458,33,224165
12565,0.016443,172.31.33.0-255,66,203524,33,224165
12566,0.01873,74.125.24.0-255,5738,209262,33,224165
12567,0.018738,172.31.33.0-255,66,209328,33,224165
12568,0.021078,74.125.24.0-255,5738,215066,33,224165
12569,0.021085,172.31.33.0-255,66,215132,33,224165
12570,0.023408,74.125.24.0-255,3537,218669,33,224165
12571,0.023419,172.31.33.0-255,66,218735,33,224165
12572,0.023682,172.31.33.0-255,105,218840,33,224165
12573,0.030899,74.125.24.0-255,66,218906,33,224165
12574,0.033086,172.31.33.0-255,172,219078,33,224165
12575,0.033116,172.31.33.0-255,1113,220191,33,224165
12576,0.033155,172.31.33.0-255,1514,221705,33,224165
12577,0.033157,172.31.33.0-255,1514,223219,33,224165
12578,0.033179,172.31.33.0-255,682,223901,33,224165
12579,0.034564,104.244.42.0-255,66,223967,33,224165
12580,0.034601,104.244.42.0-255,66,224033,33,224165
12581,0.034662,104.244.42.0-255,66,224099,33,224165
12582,0.034665,104.244.42.0-255,66,224165,33,224165
12583,0.0,172.217.27.0-255,150,150,33,359630
12584,2e-05,172.31.33.0-255,66,216,33,359630
12585,2.6e-05,172.217.27.0-255,1484,1700,33,359630
12586,3e-05,172.31.33.0-255,66,1766,33,359630
12587,3.5e-05,172.217.27.0-255,2902,4668,33,359630
12588,4.7e-05,172.31.33.0-255,66,4734,33,359630
12589,5e-05,172.217.27.0-255,1484,6218,33,359630
12590,5.3e-05,172.31.33.0-255,66,6284,33,359630
12591,5.7e-05,172.217.27.0-255,1484,7768,33,359630
12592,5.9e-05,172.31.33.0-255,66,7834,33,359630
12593,9.3e-05,172.217.27.0-255,1484,9318,33,359630
12594,9.7e-05,172.31.33.0-255,66,9384,33,359630
12595,0.000103,172.217.27.0-255,2902,12286,33,359630
12596,0.000105,172.31.33.0-255,66,12352,33,359630
12597,0.000136,172.217.27.0-255,2021,14373,33,359630
12598,0.000139,172.31.33.0-255,66,14439,33,359630
12599,0.000166,172.217.27.0-255,5738,20177,33,359630
12600,0.000169,172.31.33.0-255,66,20243,33,359630
12601,0.000176,172.217.27.0-255,7156,27399,33,359630
12602,0.000178,172.31.33.0-255,66,27465,33,359630
12603,0.000203,172.217.27.0-255,3961,31426,33,359630
12604,0.000206,172.31.33.0-255,66,31492,33,359630
12605,0.000257,172.217.27.0-255,1484,32976,33,359630
12606,0.00026,172.31.33.0-255,66,33042,33,359630
12607,0.000266,172.217.27.0-255,2902,35944,33,359630
12608,0.000268,172.31.33.0-255,66,36010,33,359630
12609,0.000304,172.217.27.0-255,5738,41748,33,359630
12610,0.000307,172.31.33.0-255,66,41814,33,359630
12611,0.000315,172.217.27.0-255,6797,48611,33,359630
12612,0.000318,172.31.33.0-255,66,48677,33,359630
12613,0.000383,172.217.27.0-255,1484,50161,33,359630
12614,0.000386,172.31.33.0-255,66,50227,33,359630
12615,0.000394,172.217.27.0-255,2902,53129,33,359630
12616,0.000396,172.31.33.0-255,66,53195,33,359630
12617,0.000405,172.217.27.0-255,1484,54679,33,359630
12618,0.000418,172.217.27.0-255,2902,57581,33,359630
12619,0.000425,172.31.33.0-255,66,57647,33,359630
12620,0.000454,172.31.33.0-255,66,57713,33,359630
12621,0.000498,172.217.27.0-255,392,58105,33,359630
12622,0.000979,172.217.27.0-255,350,58455,33,359630
12623,0.001146,172.217.27.0-255,1484,59939,33,359630
12624,0.001152,172.31.33.0-255,66,60005,33,359630
12625,0.001158,172.217.27.0-255,2902,62907,33,359630
12626,0.00116,172.31.33.0-255,66,62973,33,359630
12627,0.001191,172.217.27.0-255,4320,67293,33,359630
12628,0.001193,172.31.33.0-255,66,67359,33,359630
12629,0.001199,172.217.27.0-255,5738,73097,33,359630
12630,0.001201,172.31.33.0-255,66,73163,33,359630
12631,0.001233,172.31.33.0-255,66,73229,33,359630
12632,0.001261,172.217.27.0-255,3961,77190,33,359630
12633,0.001264,172.31.33.0-255,66,77256,33,359630
12634,0.001271,172.217.27.0-255,6797,84053,33,359630
12635,0.001273,172.31.33.0-255,66,84119,33,359630
12636,0.002912,172.217.27.0-255,5738,89857,33,359630
12637,0.002919,172.31.33.0-255,66,89923,33,359630
12638,0.004572,172.217.27.0-255,5738,95661,33,359630
12639,0.004579,172.31.33.0-255,66,95727,33,359630
12640,0.006237,172.217.27.0-255,5738,101465,33,359630
12641,0.006245,172.31.33.0-255,66,101531,33,359630
12642,0.007885,172.217.27.0-255,4320,105851,33,359630
12643,0.007891,172.31.33.0-255,66,105917,33,359630
12644,0.007912,172.217.27.0-255,1484,107401,33,359630
12645,0.009569,172.217.27.0-255,4320,111721,33,359630
12646,0.009575,172.31.33.0-255,66,111787,33,359630
12647,0.011219,172.217.27.0-255,5738,117525,33,359630
12648,0.011225,172.31.33.0-255,66,117591,33,359630
12649,0.012877,172.217.27.0-255,5738,123329,33,359630
12650,0.012885,172.31.33.0-255,66,123395,33,359630
12651,0.014527,172.217.27.0-255,5738,129133,33,359630
12652,0.014533,172.31.33.0-255,66,129199,33,359630
12653,0.016177,172.217.27.0-255,5738,134937,33,359630
12654,0.016184,172.31.33.0-255,66,135003,33,359630
12655,0.017831,172.217.27.0-255,5738,140741,33,359630
12656,0.017837,172.31.33.0-255,66,140807,33,359630
12657,0.01948,172.217.27.0-255,5738,146545,33,359630
12658,0.019486,172.31.33.0-255,66,146611,33,359630
12659,0.021142,172.217.27.0-255,5738,152349,33,359630
12660,0.021152,172.31.33.0-255,66,152415,33,359630
12661,0.022801,172.217.27.0-255,5738,158153,33,359630
12662,0.022809,172.31.33.0-255,66,158219,33,359630
12663,0.024459,172.217.27.0-255,5738,163957,33,359630
12664,0.024465,172.31.33.0-255,66,164023,33,359630
12665,0.026111,172.217.27.0-255,5738,169761,33,359630
12666,0.026119,172.31.33.0-255,66,169827,33,359630
12667,0.027767,172.217.27.0-255,5738,175565,33,359630
12668,0.027774,172.31.33.0-255,66,175631,33,359630
12669,0.029438,172.217.27.0-255,5738,181369,33,359630
12670,0.029444,172.31.33.0-255,66,181435,33,359630
12671,0.031093,172.217.27.0-255,5738,187173,33,359630
12672,0.031099,172.31.33.0-255,66,187239,33,359630
12673,0.031773,172.31.33.0-255,172,187411,33,359630
12674,0.031802,172.31.33.0-255,1117,188528,33,359630
12675,0.031852,172.31.33.0-255,1514,190042,33,359630
12676,0.031853,172.31.33.0-255,1514,191556,33,359630
12677,0.031858,172.31.33.0-255,1514,193070,33,359630
12678,0.031859,172.31.33.0-255,1514,194584,33,359630
12679,0.031877,172.31.33.0-255,456,195040,33,359630
12680,0.032745,172.217.27.0-255,5738,200778,33,359630
12681,0.032751,172.31.33.0-255,66,200844,33,359630
12682,0.033326,104.244.42.0-255,66,200910,33,359630
12683,0.03337,104.244.42.0-255,66,200976,33,359630
12684,0.033433,104.244.42.0-255,66,201042,33,359630
12685,0.033438,104.244.42.0-255,66,201108,33,359630
12686,0.0344,172.217.27.0-255,5738,206846,33,359630
12687,0.034405,172.31.33.0-255,66,206912,33,359630
12688,0.036058,172.217.27.0-255,5738,212650,33,359630
12689,0.036065,172.31.33.0-255,66,212716,33,359630
12690,0.03772,172.217.27.0-255,5738,218454,33,359630
12691,0.037725,172.31.33.0-255,66,218520,33,359630
12692,0.039385,172.217.27.0-255,5738,224258,33,359630
12693,0.03939,172.31.33.0-255,66,224324,33,359630
12694,0.041042,172.217.27.0-255,5738,230062,33,359630
12695,0.041048,172.31.33.0-255,66,230128,33,359630
12696,0.042712,172.217.27.0-255,5738,235866,33,359630
12697,0.042717,172.31.33.0-255,66,235932,33,359630
12698,0.044417,172.217.27.0-255,5738,241670,33,359630
12699,0.044423,172.31.33.0-255,66,241736,33,359630
12700,0.046081,172.217.27.0-255,5738,247474,33,359630
12701,0.04609,172.31.33.0-255,66,247540,33,359630
12702,0.047757,172.217.27.0-255,4320,251860,33,359630
12703,0.047762,172.31.33.0-255,66,251926,33,359630
12704,0.047787,172.217.27.0-255,1484,253410,33,359630
12705,0.04943,172.217.27.0-255,4320,257730,33,359630
12706,0.049435,172.31.33.0-255,66,257796,33,359630
12707,0.051099,172.217.27.0-255,5738,263534,33,359630
12708,0.051104,172.31.33.0-255,66,263600,33,359630
12709,0.052749,172.217.27.0-255,5738,269338,33,359630
12710,0.052754,172.31.33.0-255,66,269404,33,359630
12711,0.05441,172.217.27.0-255,5738,275142,33,359630
12712,0.054416,172.31.33.0-255,66,275208,33,359630
12713,0.056065,172.217.27.0-255,5738,280946,33,359630
12714,0.056071,172.31.33.0-255,66,281012,33,359630
12715,0.057724,172.217.27.0-255,5738,286750,33,359630
12716,0.057729,172.31.33.0-255,66,286816,33,359630
12717,0.059379,172.217.27.0-255,5738,292554,33,359630
12718,0.059385,172.31.33.0-255,66,292620,33,359630
12719,0.061033,172.217.27.0-255,5738,298358,33,359630
12720,0.061038,172.31.33.0-255,66,298424,33,359630
12721,0.062685,172.217.27.0-255,5738,304162,33,359630
12722,0.062691,172.31.33.0-255,66,304228,33,359630
12723,0.064361,172.217.27.0-255,5738,309966,33,359630
12724,0.064367,172.31.33.0-255,66,310032,33,359630
12725,0.066004,172.217.27.0-255,4320,314352,33,359630
12726,0.066009,172.31.33.0-255,66,314418,33,359630
12727,0.066043,172.217.27.0-255,1484,315902,33,359630
12728,0.067661,172.217.27.0-255,4320,320222,33,359630
12729,0.067666,172.31.33.0-255,66,320288,33,359630
12730,0.069325,172.217.27.0-255,5738,326026,33,359630
12731,0.06933,172.31.33.0-255,66,326092,33,359630
12732,0.070973,172.217.27.0-255,5738,331830,33,359630
12733,0.070978,172.31.33.0-255,66,331896,33,359630
12734,0.072644,172.217.27.0-255,4320,336216,33,359630
12735,0.072649,172.31.33.0-255,66,336282,33,359630
12736,0.072671,172.217.27.0-255,1484,337766,33,359630
12737,0.074294,172.217.27.0-255,4320,342086,33,359630
12738,0.0743,172.31.33.0-255,66,342152,33,359630
12739,0.075945,172.217.27.0-255,5738,347890,33,359630
12740,0.075951,172.31.33.0-255,66,347956,33,359630
12741,0.077597,172.217.27.0-255,5738,353694,33,359630
12742,0.077602,172.31.33.0-255,66,353760,33,359630
12743,0.079247,172.217.27.0-255,4320,358080,33,359630
12744,0.079252,172.31.33.0-255,66,358146,33,359630
12745,0.079282,172.217.27.0-255,1484,359630,33,359630
12746,0.0,172.31.33.0-255,105,105,33,459
12747,0.000156,172.31.33.0-255,90,195,33,459
12748,0.000164,172.31.33.0-255,66,261,33,459
12749,0.002295,172.217.194.0-255,66,327,33,459
12750,0.002316,172.217.194.0-255,66,393,33,459
12751,0.002333,172.31.33.0-255,66,459,33,459
12752,0.0,74.125.130.0-255,143,143,33,382827
12753,2.4e-05,172.31.33.0-255,66,209,33,382827
12754,3e-05,74.125.130.0-255,1484,1693,33,382827
12755,3.4e-05,172.31.33.0-255,66,1759,33,382827
12756,3.8e-05,74.125.130.0-255,2902,4661,33,382827
12757,4e-05,172.31.33.0-255,66,4727,33,382827
12758,6.9e-05,74.125.130.0-255,7156,11883,33,382827
12759,7.2e-05,74.125.130.0-255,1994,13877,33,382827
12760,7.4e-05,172.31.33.0-255,66,13943,33,382827
12761,7.7e-05,172.31.33.0-255,66,14009,33,382827
12762,8.7e-05,74.125.130.0-255,2902,16911,33,382827
12763,9e-05,172.31.33.0-255,66,16977,33,382827
12764,0.000127,74.125.130.0-255,7156,24133,33,382827
12765,0.000131,172.31.33.0-255,66,24199,33,382827
12766,0.000135,74.125.130.0-255,2902,27101,33,382827
12767,0.000137,172.31.33.0-255,66,27167,33,382827
12768,0.000177,74.125.130.0-255,3961,31128,33,382827
12769,0.000181,172.31.33.0-255,66,31194,33,382827
12770,0.00027,74.125.130.0-255,1484,32678,33,382827
12771,0.000275,172.31.33.0-255,66,32744,33,382827
12772,0.000289,74.125.130.0-255,2902,35646,33,382827
12773,0.000292,172.31.33.0-255,66,35712,33,382827
12774,0.00031,74.125.130.0-255,5738,41450,33,382827
12775,0.000313,172.31.33.0-255,66,41516,33,382827
12776,0.000332,74.125.130.0-255,5738,47254,33,382827
12777,0.000335,172.31.33.0-255,66,47320,33,382827
12778,0.000359,74.125.130.0-255,1125,48445,33,382827
12779,0.000361,172.31.33.0-255,66,48511,33,382827
12780,0.000368,74.125.130.0-255,7156,55667,33,382827
12781,0.000371,172.31.33.0-255,66,55733,33,382827
12782,0.000379,74.125.130.0-255,2902,58635,33,382827
12783,0.000382,172.31.33.0-255,66,58701,33,382827
12784,0.000401,74.125.130.0-255,6797,65498,33,382827
12785,0.000405,172.31.33.0-255,66,65564,33,382827
12786,0.000503,74.125.130.0-255,646,66210,33,382827
12787,0.000684,74.125.130.0-255,1484,67694,33,382827
12788,0.000687,172.31.33.0-255,66,67760,33,382827
12789,0.000692,74.125.130.0-255,2902,70662,33,382827
12790,0.000694,172.31.33.0-255,66,70728,33,382827
12791,0.000697,74.125.130.0-255,1484,72212,33,382827
12792,0.000713,74.125.130.0-255,4320,76532,33,382827
12793,0.000717,172.31.33.0-255,66,76598,33,382827
12794,0.000735,74.125.130.0-255,4320,80918,33,382827
12795,0.000737,172.31.33.0-255,66,80984,33,382827
12796,0.000755,74.125.130.0-255,7156,88140,33,382827
12797,0.000758,172.31.33.0-255,66,88206,33,382827
12798,0.000773,74.125.130.0-255,7156,95362,33,382827
12799,0.000775,172.31.33.0-255,66,95428,33,382827
12800,0.000793,74.125.130.0-255,4471,99899,33,382827
12801,0.000796,172.31.33.0-255,66,99965,33,382827
12802,0.000875,74.125.130.0-255,1484,101449,33,382827
12803,0.000896,74.125.130.0-255,2902,104351,33,382827
12804,0.000898,172.31.33.0-255,66,104417,33,382827
12805,0.000919,74.125.130.0-255,5738,110155,33,382827
12806,0.000921,172.31.33.0-255,66,110221,33,382827
12807,0.000937,74.125.130.0-255,2902,113123,33,382827
12808,0.00094,172.31.33.0-255,66,113189,33,382827
12809,0.000959,74.125.130.0-255,5738,118927,33,382827
12810,0.000961,172.31.33.0-255,66,118993,33,382827
12811,0.000966,74.125.130.0-255,4320,123313,33,382827
12812,0.000969,172.31.33.0-255,66,123379,33,382827
12813,0.00099,74.125.130.0-255,5738,129117,33,382827
12814,0.000993,172.31.33.0-255,66,129183,33,382827
12815,0.001024,74.125.130.0-255,4320,133503,33,382827
12816,0.001027,172.31.33.0-255,66,133569,33,382827
12817,0.001043,74.125.130.0-255,766,134335,33,382827
12818,0.001062,74.125.130.0-255,1484,135819,33,382827
12819,0.001065,172.31.33.0-255,66,135885,33,382827
12820,0.001069,74.125.130.0-255,2902,138787,33,382827
12821,0.001071,172.31.33.0-255,66,138853,33,382827
12822,0.001091,74.125.130.0-255,2902,141755,33,382827
12823,0.001093,172.31.33.0-255,66,141821,33,382827
12824,0.001098,74.125.130.0-255,4320,146141,33,382827
12825,0.0011,172.31.33.0-255,66,146207,33,382827
12826,0.001123,74.125.130.0-255,5738,151945,33,382827
12827,0.001125,172.31.33.0-255,66,152011,33,382827
12828,0.001141,74.125.130.0-255,2902,154913,33,382827
12829,0.001144,172.31.33.0-255,66,154979,33,382827
12830,0.001149,74.125.130.0-255,4320,159299,33,382827
12831,0.001151,172.31.33.0-255,66,159365,33,382827
12832,0.001156,74.125.130.0-255,5738,165103,33,382827
12833,0.001159,172.31.33.0-255,66,165169,33,382827
12834,0.00118,74.125.130.0-255,1484,166653,33,382827
12835,0.001199,74.125.130.0-255,2184,168837,33,382827
12836,0.001203,172.31.33.0-255,66,168903,33,382827
12837,0.00154,74.125.130.0-255,1484,170387,33,382827
12838,0.001548,74.125.130.0-255,2902,173289,33,382827
12839,0.001552,172.31.33.0-255,66,173355,33,382827
12840,0.001558,74.125.130.0-255,4320,177675,33,382827
12841,0.00156,172.31.33.0-255,66,177741,33,382827
12842,0.001572,74.125.130.0-255,1484,179225,33,382827
12843,0.001599,74.125.130.0-255,2902,182127,33,382827
12844,0.001602,172.31.33.0-255,66,182193,33,382827
12845,0.001628,172.31.33.0-255,66,182259,33,382827
12846,0.001651,74.125.130.0-255,5738,187997,33,382827
12847,0.001653,172.31.33.0-255,66,188063,33,382827
12848,0.001666,74.125.130.0-255,5020,193083,33,382827
12849,0.001669,172.31.33.0-255,66,193149,33,382827
12850,0.001739,74.125.130.0-255,1484,194633,33,382827
12851,0.001743,74.125.130.0-255,1484,196117,33,382827
12852,0.001746,172.31.33.0-255,66,196183,33,382827
12853,0.001763,74.125.130.0-255,1484,197667,33,382827
12854,0.001768,74.125.130.0-255,5738,203405,33,382827
12855,0.001771,172.31.33.0-255,66,203471,33,382827
12856,0.00181,172.31.33.0-255,66,203537,33,382827
12857,0.001836,172.31.33.0-255,66,203603,33,382827
12858,0.001855,74.125.130.0-255,2902,206505,33,382827
12859,0.001857,172.31.33.0-255,66,206571,33,382827
12860,0.00186,74.125.130.0-255,2184,208755,33,382827
12861,0.001862,172.31.33.0-255,66,208821,33,382827
12862,0.004062,74.125.130.0-255,4320,213141,33,382827
12863,0.004066,172.31.33.0-255,66,213207,33,382827
12864,0.004082,74.125.130.0-255,1484,214691,33,382827
12865,0.006277,74.125.130.0-255,4320,219011,33,382827
12866,0.006282,172.31.33.0-255,66,219077,33,382827
12867,0.008489,74.125.130.0-255,2902,221979,33,382827
12868,0.008495,172.31.33.0-255,66,222045,33,382827
12869,0.008519,74.125.130.0-255,2902,224947,33,382827
12870,0.008522,172.31.33.0-255,66,225013,33,382827
12871,0.010705,74.125.130.0-255,2902,227915,33,382827
12872,0.010712,172.31.33.0-255,66,227981,33,382827
12873,0.010733,74.125.130.0-255,2902,230883,33,382827
12874,0.010736,172.31.33.0-255,66,230949,33,382827
12875,0.01292,74.125.130.0-255,2902,233851,33,382827
12876,0.012926,172.31.33.0-255,66,233917,33,382827
12877,0.012954,74.125.130.0-255,2902,236819,33,382827
12878,0.012958,172.31.33.0-255,66,236885,33,382827
12879,0.015144,74.125.130.0-255,2902,239787,33,382827
12880,0.015151,172.31.33.0-255,66,239853,33,382827
12881,0.015185,74.125.130.0-255,2902,242755,33,382827
12882,0.015188,172.31.33.0-255,66,242821,33,382827
12883,0.017399,74.125.130.0-255,5738,248559,33,382827
12884,0.017405,172.31.33.0-255,66,248625,33,382827
12885,0.01962,74.125.130.0-255,5738,254363,33,382827
12886,0.019626,172.31.33.0-255,66,254429,33,382827
12887,0.021383,172.31.33.0-255,172,254601,33,382827
12888,0.02141,172.31.33.0-255,1113,255714,33,382827
12889,0.021436,172.31.33.0-255,1514,257228,33,382827
12890,0.021437,172.31.33.0-255,1171,258399,33,382827
12891,0.021844,74.125.130.0-255,5738,264137,33,382827
12892,0.021849,172.31.33.0-255,66,264203,33,382827
12893,0.022917,104.244.42.0-255,66,264269,33,382827
12894,0.022958,104.244.42.0-255,66,264335,33,382827
12895,0.022959,104.244.42.0-255,66,264401,33,382827
12896,0.02406,74.125.130.0-255,4320,268721,33,382827
12897,0.024064,172.31.33.0-255,66,268787,33,382827
12898,0.024091,74.125.130.0-255,1484,270271,33,382827
12899,0.026293,74.125.130.0-255,4320,274591,33,382827
12900,0.026298,172.31.33.0-255,66,274657,33,382827
12901,0.02853,74.125.130.0-255,5738,280395,33,382827
12902,0.028536,172.31.33.0-255,66,280461,33,382827
12903,0.030756,74.125.130.0-255,2902,283363,33,382827
12904,0.030761,172.31.33.0-255,66,283429,33,382827
12905,0.030793,74.125.130.0-255,2902,286331,33,382827
12906,0.030796,172.31.33.0-255,66,286397,33,382827
12907,0.032971,74.125.130.0-255,2902,289299,33,382827
12908,0.032976,172.31.33.0-255,66,289365,33,382827
12909,0.033008,74.125.130.0-255,2902,292267,33,382827
12910,0.033011,172.31.33.0-255,66,292333,33,382827
12911,0.035226,74.125.130.0-255,2902,295235,33,382827
12912,0.035231,172.31.33.0-255,66,295301,33,382827
12913,0.035263,74.125.130.0-255,2902,298203,33,382827
12914,0.035267,172.31.33.0-255,66,298269,33,382827
12915,0.03746,74.125.130.0-255,2902,301171,33,382827
12916,0.037465,172.31.33.0-255,66,301237,33,382827
12917,0.037495,74.125.130.0-255,2902,304139,33,382827
12918,0.037498,172.31.33.0-255,66,304205,33,382827
12919,0.039664,74.125.130.0-255,2902,307107,33,382827
12920,0.039669,172.31.33.0-255,66,307173,33,382827
12921,0.039707,74.125.130.0-255,2902,310075,33,382827
12922,0.03971,172.31.33.0-255,66,310141,33,382827
12923,0.041878,74.125.130.0-255,2902,313043,33,382827
12924,0.041883,172.31.33.0-255,66,313109,33,382827
12925,0.041913,74.125.130.0-255,2902,316011,33,382827
12926,0.041916,172.31.33.0-255,66,316077,33,382827
12927,0.044105,74.125.130.0-255,2902,318979,33,382827
12928,0.044111,172.31.33.0-255,66,319045,33,382827
12929,0.044144,74.125.130.0-255,2902,321947,33,382827
12930,0.044148,172.31.33.0-255,66,322013,33,382827
12931,0.046327,74.125.130.0-255,2902,324915,33,382827
12932,0.046332,172.31.33.0-255,66,324981,33,382827
12933,0.046348,74.125.130.0-255,2902,327883,33,382827
12934,0.046351,172.31.33.0-255,66,327949,33,382827
12935,0.048577,74.125.130.0-255,5738,333687,33,382827
12936,0.048584,172.31.33.0-255,66,333753,33,382827
12937,0.050808,74.125.130.0-255,5738,339491,33,382827
12938,0.050814,172.31.33.0-255,66,339557,33,382827
12939,0.053029,74.125.130.0-255,5738,345295,33,382827
12940,0.053033,172.31.33.0-255,66,345361,33,382827
12941,0.05524,74.125.130.0-255,5738,351099,33,382827
12942,0.055245,172.31.33.0-255,66,351165,33,382827
12943,0.057449,74.125.130.0-255,5738,356903,33,382827
12944,0.057454,172.31.33.0-255,66,356969,33,382827
12945,0.059667,74.125.130.0-255,5738,362707,33,382827
12946,0.059672,172.31.33.0-255,66,362773,33,382827
12947,0.0619,74.125.130.0-255,5738,368511,33,382827
12948,0.061904,172.31.33.0-255,66,368577,33,382827
12949,0.064119,74.125.130.0-255,5738,374315,33,382827
12950,0.064124,172.31.33.0-255,66,374381,33,382827
12951,0.066332,74.125.130.0-255,4320,378701,33,382827
12952,0.066336,172.31.33.0-255,66,378767,33,382827
12953,0.066364,74.125.130.0-255,1484,380251,33,382827
12954,0.068543,74.125.130.0-255,2339,382590,33,382827
12955,0.068549,172.31.33.0-255,66,382656,33,382827
12956,0.068722,172.31.33.0-255,105,382761,33,382827
12957,0.070887,74.125.130.0-255,66,382827,33,382827
12958,0.0,172.31.33.0-255,105,105,33,735
12959,0.000204,172.31.33.0-255,90,195,33,735
12960,0.000214,172.31.33.0-255,66,261,33,735
12961,0.002202,74.125.24.0-255,66,327,33,735
12962,0.002214,74.125.24.0-255,66,393,33,735
12963,0.002225,172.31.33.0-255,66,459,33,735
12964,0.042698,172.31.33.0-255,105,564,33,735
12965,0.044488,157.240.7.0-255,105,669,33,735
12966,0.044496,172.31.33.0-255,66,735,33,735
12967,0.0,172.217.194.0-255,150,150,33,263658
12968,2e-05,172.31.33.0-255,66,216,33,263658
12969,2.7e-05,172.217.194.0-255,1484,1700,33,263658
12970,3.1e-05,172.31.33.0-255,66,1766,33,263658
12971,3.7e-05,172.217.194.0-255,2902,4668,33,263658
12972,4e-05,172.31.33.0-255,66,4734,33,263658
12973,4.8e-05,172.217.194.0-255,7156,11890,33,263658
12974,5e-05,172.31.33.0-255,66,11956,33,263658
12975,6.9e-05,172.217.194.0-255,1972,13928,33,263658
12976,7.2e-05,172.31.33.0-255,66,13994,33,263658
12977,0.000346,172.217.194.0-255,1484,15478,33,263658
12978,0.000351,172.31.33.0-255,66,15544,33,263658
12979,0.000357,172.217.194.0-255,2902,18446,33,263658
12980,0.000359,172.31.33.0-255,66,18512,33,263658
12981,0.000364,172.217.194.0-255,2902,21414,33,263658
12982,0.000366,172.31.33.0-255,66,21480,33,263658
12983,0.000386,172.217.194.0-255,2902,24382,33,263658
12984,0.000388,172.31.33.0-255,66,24448,33,263658
12985,0.000395,172.217.194.0-255,5738,30186,33,263658
12986,0.000397,172.31.33.0-255,66,30252,33,263658
12987,0.000413,172.217.194.0-255,1125,31377,33,263658
12988,0.000415,172.31.33.0-255,66,31443,33,263658
12989,0.000423,172.217.194.0-255,7156,38599,33,263658
12990,0.000425,172.31.33.0-255,66,38665,33,263658
12991,0.000451,172.217.194.0-255,4320,42985,33,263658
12992,0.000454,172.31.33.0-255,66,43051,33,263658
12993,0.000472,172.217.194.0-255,5379,48430,33,263658
12994,0.000477,172.31.33.0-255,66,48496,33,263658
12995,0.001813,172.217.194.0-255,1484,49980,33,263658
12996,0.001819,172.31.33.0-255,66,50046,33,263658
12997,0.001828,172.217.194.0-255,2902,52948,33,263658
12998,0.00183,172.31.33.0-255,66,53014,33,263658
12999,0.001837,172.217.194.0-255,5738,58752,33,263658
13000,0.001838,172.31.33.0-255,66,58818,33,263658
13001,0.001867,172.217.194.0-255,2902,61720,33,263658
13002,0.001868,172.31.33.0-255,66,61786,33,263658
13003,0.001892,172.217.194.0-255,5379,67165,33,263658
13004,0.001894,172.31.33.0-255,66,67231,33,263658
13005,0.001903,172.31.33.0-255,66,67297,33,263658
13006,0.001926,172.31.33.0-255,66,67363,33,263658
13007,0.001939,172.217.194.0-255,4320,71683,33,263658
13008,0.001941,172.31.33.0-255,66,71749,33,263658
13009,0.001958,172.217.194.0-255,1484,73233,33,263658
13010,0.001981,172.31.33.0-255,66,73299,33,263658
13011,0.002498,172.217.194.0-255,1484,74783,33,263658
13012,0.002521,172.217.194.0-255,1484,76267,33,263658
13013,0.002524,172.31.33.0-255,66,76333,33,263658
13014,0.002544,172.217.194.0-255,1484,77817,33,263658
13015,0.002551,172.217.194.0-255,5738,83555,33,263658
13016,0.002553,172.31.33.0-255,66,83621,33,263658
13017,0.00256,172.217.194.0-255,7156,90777,33,263658
13018,0.002562,172.31.33.0-255,66,90843,33,263658
13019,0.005102,172.217.194.0-255,4320,95163,33,263658
13020,0.005107,172.31.33.0-255,66,95229,33,263658
13021,0.005124,172.217.194.0-255,1484,96713,33,263658
13022,0.007715,172.217.194.0-255,2902,99615,33,263658
13023,0.007722,172.31.33.0-255,66,99681,33,263658
13024,0.007737,172.217.194.0-255,1484,101165,33,263658
13025,0.010263,172.217.194.0-255,4320,105485,33,263658
13026,0.010271,172.31.33.0-255,66,105551,33,263658
13027,0.0128,172.217.194.0-255,5738,111289,33,263658
13028,0.012811,172.31.33.0-255,66,111355,33,263658
13029,0.015365,172.217.194.0-255,5738,117093,33,263658
13030,0.015373,172.31.33.0-255,66,117159,33,263658
13031,0.01792,172.217.194.0-255,5738,122897,33,263658
13032,0.017928,172.31.33.0-255,66,122963,33,263658
13033,0.020471,172.217.194.0-255,5738,128701,33,263658
13034,0.020478,172.31.33.0-255,66,128767,33,263658
13035,0.021568,172.31.33.0-255,172,128939,33,263658
13036,0.021598,172.31.33.0-255,1113,130052,33,263658
13037,0.021647,172.31.33.0-255,1514,131566,33,263658
13038,0.021648,172.31.33.0-255,1514,133080,33,263658
13039,0.021676,172.31.33.0-255,680,133760,33,263658
13040,0.023009,172.217.194.0-255,5738,139498,33,263658
13041,0.023015,172.31.33.0-255,66,139564,33,263658
13042,0.023097,104.244.42.0-255,66,139630,33,263658
13043,0.023157,104.244.42.0-255,66,139696,33,263658
13044,0.023205,104.244.42.0-255,66,139762,33,263658
13045,0.023208,104.244.42.0-255,66,139828,33,263658
13046,0.025553,172.217.194.0-255,5738,145566,33,263658
13047,0.025558,172.31.33.0-255,66,145632,33,263658
13048,0.028117,172.217.194.0-255,5738,151370,33,263658
13049,0.028124,172.31.33.0-255,66,151436,33,263658
13050,0.030625,172.217.194.0-255,5738,157174,33,263658
13051,0.030631,172.31.33.0-255,66,157240,33,263658
13052,0.03317,172.217.194.0-255,5738,162978,33,263658
13053,0.033177,172.31.33.0-255,66,163044,33,263658
13054,0.035693,172.217.194.0-255,5738,168782,33,263658
13055,0.035699,172.31.33.0-255,66,168848,33,263658
13056,0.038226,172.217.194.0-255,5738,174586,33,263658
13057,0.038233,172.31.33.0-255,66,174652,33,263658
13058,0.040771,172.217.194.0-255,5738,180390,33,263658
13059,0.040777,172.31.33.0-255,66,180456,33,263658
13060,0.043323,172.217.194.0-255,2902,183358,33,263658
13061,0.043328,172.31.33.0-255,66,183424,33,263658
13062,0.043345,172.217.194.0-255,2902,186326,33,263658
13063,0.043348,172.31.33.0-255,66,186392,33,263658
13064,0.045884,172.217.194.0-255,5738,192130,33,263658
13065,0.045899,172.31.33.0-255,66,192196,33,263658
13066,0.048446,172.217.194.0-255,5738,197934,33,263658
13067,0.048454,172.31.33.0-255,66,198000,33,263658
13068,0.050991,172.217.194.0-255,5738,203738,33,263658
13069,0.050996,172.31.33.0-255,66,203804,33,263658
13070,0.053514,172.217.194.0-255,4320,208124,33,263658
13071,0.053519,172.31.33.0-255,66,208190,33,263658
13072,0.053538,172.217.194.0-255,1484,209674,33,263658
13073,0.056028,172.217.194.0-255,4320,213994,33,263658
13074,0.056033,172.31.33.0-255,66,214060,33,263658
13075,0.058562,172.217.194.0-255,4320,218380,33,263658
13076,0.058568,172.31.33.0-255,66,218446,33,263658
13077,0.058586,172.217.194.0-255,1484,219930,33,263658
13078,0.061145,172.217.194.0-255,4320,224250,33,263658
13079,0.061153,172.31.33.0-255,66,224316,33,263658
13080,0.063683,172.217.194.0-255,5738,230054,33,263658
13081,0.063689,172.31.33.0-255,66,230120,33,263658
13082,0.066216,172.217.194.0-255,5738,235858,33,263658
13083,0.066223,172.31.33.0-255,66,235924,33,263658
13084,0.068767,172.217.194.0-255,1484,237408,33,263658
13085,0.068789,172.217.194.0-255,4320,241728,33,263658
13086,0.068794,172.31.33.0-255,66,241794,33,263658
13087,0.071339,172.217.194.0-255,5738,247532,33,263658
13088,0.071345,172.31.33.0-255,66,247598,33,263658
13089,0.073873,172.217.194.0-255,4320,251918,33,263658
13090,0.073879,172.31.33.0-255,66,251984,33,263658
13091,0.073899,172.217.194.0-255,1484,253468,33,263658
13092,0.076431,172.217.194.0-255,4320,257788,33,263658
13093,0.076438,172.31.33.0-255,66,257854,33,263658
13094,0.078972,172.217.194.0-255,5738,263592,33,263658
13095,0.078978,172.31.33.0-255,66,263658,33,263658
13096,0.0,172.31.33.0-255,66,66,33,66
13097,0.0,74.125.130.0-255,150,150,33,402633
13098,1.2e-05,172.31.33.0-255,66,216,33,402633
13099,1.8e-05,74.125.130.0-255,1484,1700,33,402633
13100,2.2e-05,172.31.33.0-255,66,1766,33,402633
13101,6.1e-05,74.125.130.0-255,2902,4668,33,402633
13102,6.4e-05,172.31.33.0-255,66,4734,33,402633
13103,7.4e-05,74.125.130.0-255,1484,6218,33,402633
13104,7.7e-05,172.31.33.0-255,66,6284,33,402633
13105,0.000115,74.125.130.0-255,2902,9186,33,402633
13106,0.000119,172.31.33.0-255,66,9252,33,402633
13107,0.000164,74.125.130.0-255,1484,10736,33,402633
13108,0.000166,172.31.33.0-255,66,10802,33,402633
13109,0.000184,74.125.130.0-255,2902,13704,33,402633
13110,0.000187,172.31.33.0-255,66,13770,33,402633
13111,0.000202,74.125.130.0-255,540,14310,33,402633
13112,0.000204,172.31.33.0-255,66,14376,33,402633
13113,0.000363,74.125.130.0-255,1484,15860,33,402633
13114,0.000368,172.31.33.0-255,66,15926,33,402633
13115,0.000383,74.125.130.0-255,2902,18828,33,402633
13116,0.000385,172.31.33.0-255,66,18894,33,402633
13117,0.000408,74.125.130.0-255,5738,24632,33,402633
13118,0.000411,172.31.33.0-255,66,24698,33,402633
13119,0.000413,74.125.130.0-255,1484,26182,33,402633
13120,0.000415,172.31.33.0-255,66,26248,33,402633
13121,0.000431,74.125.130.0-255,2902,29150,33,402633
13122,0.000433,172.31.33.0-255,66,29216,33,402633
13123,0.000465,74.125.130.0-255,5379,34595,33,402633
13124,0.000468,172.31.33.0-255,66,34661,33,402633
13125,0.000471,74.125.130.0-255,1484,36145,33,402633
13126,0.000472,172.31.33.0-255,66,36211,33,402633
13127,0.000496,74.125.130.0-255,2902,39113,33,402633
13128,0.000499,172.31.33.0-255,66,39179,33,402633
13129,0.000505,74.125.130.0-255,5738,44917,33,402633
13130,0.000507,172.31.33.0-255,66,44983,33,402633
13131,0.000522,74.125.130.0-255,5738,50721,33,402633
13132,0.000525,172.31.33.0-255,66,50787,33,402633
13133,0.000552,74.125.130.0-255,7156,57943,33,402633
13134,0.000555,172.31.33.0-255,66,58009,33,402633
13135,0.000575,74.125.130.0-255,5738,63747,33,402633
13136,0.000577,172.31.33.0-255,66,63813,33,402633
13137,0.000591,74.125.130.0-255,2184,65997,33,402633
13138,0.000593,172.31.33.0-255,66,66063,33,402633
13139,0.000596,74.125.130.0-255,380,66443,33,402633
13140,0.000646,74.125.130.0-255,364,66807,33,402633
13141,0.00086,74.125.130.0-255,1484,68291,33,402633
13142,0.000864,172.31.33.0-255,66,68357,33,402633
13143,0.000883,74.125.130.0-255,1484,69841,33,402633
13144,0.000887,74.125.130.0-255,2902,72743,33,402633
13145,0.000889,172.31.33.0-255,66,72809,33,402633
13146,0.000909,74.125.130.0-255,5738,78547,33,402633
13147,0.000912,172.31.33.0-255,66,78613,33,402633
13148,0.000935,74.125.130.0-255,7156,85769,33,402633
13149,0.000938,172.31.33.0-255,66,85835,33,402633
13150,0.000957,74.125.130.0-255,5738,91573,33,402633
13151,0.000959,172.31.33.0-255,66,91639,33,402633
13152,0.000983,74.125.130.0-255,2902,94541,33,402633
13153,0.000985,172.31.33.0-255,66,94607,33,402633
13154,0.000992,74.125.130.0-255,6438,101045,33,402633
13155,0.000994,172.31.33.0-255,66,101111,33,402633
13156,0.001013,74.125.130.0-255,4320,105431,33,402633
13157,0.001016,172.31.33.0-255,66,105497,33,402633
13158,0.001034,74.125.130.0-255,2902,108399,33,402633
13159,0.001037,172.31.33.0-255,66,108465,33,402633
13160,0.001041,74.125.130.0-255,2902,111367,33,402633
13161,0.001042,172.31.33.0-255,66,111433,33,402633
13162,0.001047,74.125.130.0-255,4320,115753,33,402633
13163,0.00105,172.31.33.0-255,66,115819,33,402633
13164,0.001069,74.125.130.0-255,5738,121557,33,402633
13165,0.001071,172.31.33.0-255,66,121623,33,402633
13166,0.001093,74.125.130.0-255,2902,124525,33,402633
13167,0.001096,172.31.33.0-255,66,124591,33,402633
13168,0.0011,74.125.130.0-255,2902,127493,33,402633
13169,0.001102,172.31.33.0-255,66,127559,33,402633
13170,0.001107,74.125.130.0-255,4320,131879,33,402633
13171,0.001108,172.31.33.0-255,66,131945,33,402633
13172,0.001134,74.125.130.0-255,3602,135547,33,402633
13173,0.001136,172.31.33.0-255,66,135613,33,402633
13174,0.001164,74.125.130.0-255,4320,139933,33,402633
13175,0.001168,172.31.33.0-255,66,139999,33,402633
13176,0.001181,74.125.130.0-255,5738,145737,33,402633
13177,0.001184,172.31.33.0-255,66,145803,33,402633
13178,0.001213,74.125.130.0-255,7156,152959,33,402633
13179,0.001216,172.31.33.0-255,66,153025,33,402633
13180,0.001257,172.31.33.0-255,66,153091,33,402633
13181,0.001274,74.125.130.0-255,1484,154575,33,402633
13182,0.001292,74.125.130.0-255,5020,159595,33,402633
13183,0.001295,172.31.33.0-255,66,159661,33,402633
13184,0.001434,74.125.130.0-255,1484,161145,33,402633
13185,0.001457,74.125.130.0-255,2902,164047,33,402633
13186,0.00146,172.31.33.0-255,66,164113,33,402633
13187,0.001477,74.125.130.0-255,1484,165597,33,402633
13188,0.001491,74.125.130.0-255,2902,168499,33,402633
13189,0.001494,172.31.33.0-255,66,168565,33,402633
13190,0.001541,74.125.130.0-255,5738,174303,33,402633
13191,0.001543,172.31.33.0-255,66,174369,33,402633
13192,0.001545,74.125.130.0-255,947,175316,33,402633
13193,0.001548,74.125.130.0-255,1484,176800,33,402633
13194,0.001549,172.31.33.0-255,66,176866,33,402633
13195,0.001583,74.125.130.0-255,4320,181186,33,402633
13196,0.001586,172.31.33.0-255,66,181252,33,402633
13197,0.001619,74.125.130.0-255,5738,186990,33,402633
13198,0.001621,172.31.33.0-255,66,187056,33,402633
13199,0.001634,74.125.130.0-255,5738,192794,33,402633
13200,0.001636,172.31.33.0-255,66,192860,33,402633
13201,0.001673,74.125.130.0-255,7156,200016,33,402633
13202,0.001676,172.31.33.0-255,66,200082,33,402633
13203,0.00168,74.125.130.0-255,2902,202984,33,402633
13204,0.001682,172.31.33.0-255,66,203050,33,402633
13205,0.001696,74.125.130.0-255,4320,207370,33,402633
13206,0.001699,172.31.33.0-255,66,207436,33,402633
13207,0.001732,74.125.130.0-255,2184,209620,33,402633
13208,0.001735,172.31.33.0-255,66,209686,33,402633
13209,0.001949,74.125.130.0-255,1484,211170,33,402633
13210,0.001953,74.125.130.0-255,1484,212654,33,402633
13211,0.001956,172.31.33.0-255,66,212720,33,402633
13212,0.001974,74.125.130.0-255,1484,214204,33,402633
13213,0.001978,74.125.130.0-255,4320,218524,33,402633
13214,0.001983,172.31.33.0-255,66,218590,33,402633
13215,0.001993,74.125.130.0-255,1484,220074,33,402633
13216,0.001996,74.125.130.0-255,2902,222976,33,402633
13217,0.001998,172.31.33.0-255,66,223042,33,402633
13218,0.002003,74.125.130.0-255,4320,227362,33,402633
13219,0.002005,172.31.33.0-255,66,227428,33,402633
13220,0.002041,74.125.130.0-255,7156,234584,33,402633
13221,0.002044,172.31.33.0-255,66,234650,33,402633
13222,0.002062,74.125.130.0-255,2902,237552,33,402633
13223,0.002064,172.31.33.0-255,66,237618,33,402633
13224,0.002084,74.125.130.0-255,5738,243356,33,402633
13225,0.002086,172.31.33.0-255,66,243422,33,402633
13226,0.002089,74.125.130.0-255,766,244188,33,402633
13227,0.002742,172.31.33.0-255,66,244254,33,402633
13228,0.004302,74.125.130.0-255,4320,248574,33,402633
13229,0.004309,172.31.33.0-255,66,248640,33,402633
13230,0.004954,74.125.130.0-255,1484,250124,33,402633
13231,0.006538,74.125.130.0-255,4320,254444,33,402633
13232,0.006541,172.31.33.0-255,66,254510,33,402633
13233,0.008802,74.125.130.0-255,5738,260248,33,402633
13234,0.008809,172.31.33.0-255,66,260314,33,402633
13235,0.011026,74.125.130.0-255,5738,266052,33,402633
13236,0.011035,172.31.33.0-255,66,266118,33,402633
13237,0.013266,74.125.130.0-255,5738,271856,33,402633
13238,0.013277,172.31.33.0-255,66,271922,33,402633
13239,0.015522,74.125.130.0-255,5738,277660,33,402633
13240,0.01553,172.31.33.0-255,66,277726,33,402633
13241,0.017748,74.125.130.0-255,5738,283464,33,402633
13242,0.017755,172.31.33.0-255,66,283530,33,402633
13243,0.019345,172.31.33.0-255,172,283702,33,402633
13244,0.019373,172.31.33.0-255,1113,284815,33,402633
13245,0.019421,172.31.33.0-255,1514,286329,33,402633
13246,0.019423,172.31.33.0-255,1514,287843,33,402633
13247,0.019424,172.31.33.0-255,682,288525,33,402633
13248,0.019984,74.125.130.0-255,5738,294263,33,402633
13249,0.01999,172.31.33.0-255,66,294329,33,402633
13250,0.020828,104.244.42.0-255,66,294395,33,402633
13251,0.020858,104.244.42.0-255,66,294461,33,402633
13252,0.020912,104.244.42.0-255,66,294527,33,402633
13253,0.020931,104.244.42.0-255,66,294593,33,402633
13254,0.022245,74.125.130.0-255,5738,300331,33,402633
13255,0.02225,172.31.33.0-255,66,300397,33,402633
13256,0.02449,74.125.130.0-255,5738,306135,33,402633
13257,0.024497,172.31.33.0-255,66,306201,33,402633
13258,0.026725,74.125.130.0-255,5738,311939,33,402633
13259,0.026731,172.31.33.0-255,66,312005,33,402633
13260,0.028964,74.125.130.0-255,1484,313489,33,402633
13261,0.028996,74.125.130.0-255,4320,317809,33,402633
13262,0.029,172.31.33.0-255,66,317875,33,402633
13263,0.031226,74.125.130.0-255,5738,323613,33,402633
13264,0.031232,172.31.33.0-255,66,323679,33,402633
13265,0.033504,74.125.130.0-255,5738,329417,33,402633
13266,0.033511,172.31.33.0-255,66,329483,33,402633
13267,0.035861,74.125.130.0-255,5738,335221,33,402633
13268,0.035867,172.31.33.0-255,66,335287,33,402633
13269,0.038092,74.125.130.0-255,5738,341025,33,402633
13270,0.038098,172.31.33.0-255,66,341091,33,402633
13271,0.040329,74.125.130.0-255,5738,346829,33,402633
13272,0.040334,172.31.33.0-255,66,346895,33,402633
13273,0.042566,74.125.130.0-255,5738,352633,33,402633
13274,0.042571,172.31.33.0-255,66,352699,33,402633
13275,0.044804,74.125.130.0-255,5738,358437,33,402633
13276,0.044811,172.31.33.0-255,66,358503,33,402633
13277,0.047072,74.125.130.0-255,5738,364241,33,402633
13278,0.047077,172.31.33.0-255,66,364307,33,402633
13279,0.049307,74.125.130.0-255,5738,370045,33,402633
13280,0.049313,172.31.33.0-255,66,370111,33,402633
13281,0.051547,74.125.130.0-255,5738,375849,33,402633
13282,0.051553,172.31.33.0-255,66,375915,33,402633
13283,0.053772,74.125.130.0-255,5738,381653,33,402633
13284,0.053778,172.31.33.0-255,66,381719,33,402633
13285,0.056007,74.125.130.0-255,5738,387457,33,402633
13286,0.056013,172.31.33.0-255,66,387523,33,402633
13287,0.058243,74.125.130.0-255,5738,393261,33,402633
13288,0.058248,172.31.33.0-255,66,393327,33,402633
13289,0.060481,74.125.130.0-255,5738,399065,33,402633
13290,0.060486,172.31.33.0-255,66,399131,33,402633
13291,0.062711,74.125.130.0-255,3265,402396,33,402633
13292,0.062715,172.31.33.0-255,66,402462,33,402633
13293,0.062852,172.31.33.0-255,105,402567,33,402633
13294,0.065043,74.125.130.0-255,66,402633,33,402633
13295,0.0,74.125.68.0-255,147,147,33,152298
13296,1.9e-05,172.31.33.0-255,66,213,33,152298
13297,2.6e-05,74.125.68.0-255,1484,1697,33,152298
13298,3.1e-05,172.31.33.0-255,66,1763,33,152298
13299,4.4e-05,74.125.68.0-255,2902,4665,33,152298
13300,4.7e-05,172.31.33.0-255,66,4731,33,152298
13301,8.2e-05,74.125.68.0-255,7156,11887,33,152298
13302,8.6e-05,172.31.33.0-255,66,11953,33,152298
13303,0.000167,74.125.68.0-255,2902,14855,33,152298
13304,0.000171,172.31.33.0-255,66,14921,33,152298
13305,0.000197,74.125.68.0-255,3431,18352,33,152298
13306,0.0002,172.31.33.0-255,66,18418,33,152298
13307,0.00027,74.125.68.0-255,7156,25574,33,152298
13308,0.000274,172.31.33.0-255,66,25640,33,152298
13309,0.000368,74.125.68.0-255,5379,31019,33,152298
13310,0.000373,172.31.33.0-255,66,31085,33,152298
13311,0.000446,74.125.68.0-255,5738,36823,33,152298
13312,0.000449,172.31.33.0-255,66,36889,33,152298
13313,0.000534,74.125.68.0-255,4320,41209,33,152298
13314,0.00054,172.31.33.0-255,66,41275,33,152298
13315,0.000575,172.31.33.0-255,66,41341,33,152298
13316,0.000721,74.125.68.0-255,4320,45661,33,152298
13317,0.000727,172.31.33.0-255,66,45727,33,152298
13318,0.000783,74.125.68.0-255,1484,47211,33,152298
13319,0.000786,172.31.33.0-255,66,47277,33,152298
13320,0.000815,172.31.33.0-255,66,47343,33,152298
13321,0.000924,74.125.68.0-255,645,47988,33,152298
13322,0.000928,172.31.33.0-255,66,48054,33,152298
13323,0.000952,74.125.68.0-255,1484,49538,33,152298
13324,0.000955,172.31.33.0-255,66,49604,33,152298
13325,0.000981,74.125.68.0-255,4320,53924,33,152298
13326,0.000984,172.31.33.0-255,66,53990,33,152298
13327,0.00104,74.125.68.0-255,7156,61146,33,152298
13328,0.001045,172.31.33.0-255,66,61212,33,152298
13329,0.00107,74.125.68.0-255,2902,64114,33,152298
13330,0.001073,172.31.33.0-255,66,64180,33,152298
13331,0.001194,74.125.68.0-255,4320,68500,33,152298
13332,0.001198,172.31.33.0-255,66,68566,33,152298
13333,0.001238,172.31.33.0-255,66,68632,33,152298
13334,0.001453,74.125.68.0-255,1484,70116,33,152298
13335,0.001468,74.125.68.0-255,4320,74436,33,152298
13336,0.001472,172.31.33.0-255,66,74502,33,152298
13337,0.001511,172.31.33.0-255,66,74568,33,152298
13338,0.001746,172.31.33.0-255,66,74634,33,152298
13339,0.001896,74.125.68.0-255,3602,78236,33,152298
13340,0.001901,172.31.33.0-255,66,78302,33,152298
13341,0.001946,74.125.68.0-255,1484,79786,33,152298
13342,0.001989,172.31.33.0-255,66,79852,33,152298
13343,0.002228,74.125.68.0-255,5738,85590,33,152298
13344,0.002234,172.31.33.0-255,66,85656,33,152298
13345,0.002263,172.31.33.0-255,66,85722,33,152298
13346,0.002459,74.125.68.0-255,7156,92878,33,152298
13347,0.002466,172.31.33.0-255,66,92944,33,152298
13348,0.002503,172.31.33.0-255,66,93010,33,152298
13349,0.002529,172.31.33.0-255,66,93076,33,152298
13350,0.002563,172.31.33.0-255,66,93142,33,152298
13351,0.003048,74.125.68.0-255,1484,94626,33,152298
13352,0.003095,172.31.33.0-255,66,94692,33,152298
13353,0.003484,74.125.68.0-255,2902,97594,33,152298
13354,0.003494,74.125.68.0-255,2902,100496,33,152298
13355,0.004424,74.125.68.0-255,2902,103398,33,152298
13356,0.004533,74.125.68.0-255,1484,104882,33,152298
13357,0.006452,172.31.33.0-255,66,104948,33,152298
13358,0.009024,74.125.68.0-255,5738,110686,33,152298
13359,0.00903,172.31.33.0-255,66,110752,33,152298
13360,0.011603,74.125.68.0-255,5738,116490,33,152298
13361,0.01161,172.31.33.0-255,66,116556,33,152298
13362,0.014176,74.125.68.0-255,4320,120876,33,152298
13363,0.014184,172.31.33.0-255,66,120942,33,152298
13364,0.014207,74.125.68.0-255,1484,122426,33,152298
13365,0.016749,74.125.68.0-255,4320,126746,33,152298
13366,0.016758,172.31.33.0-255,66,126812,33,152298
13367,0.019329,74.125.68.0-255,5738,132550,33,152298
13368,0.019339,172.31.33.0-255,66,132616,33,152298
13369,0.0219,74.125.68.0-255,5738,138354,33,152298
13370,0.021926,172.31.33.0-255,66,138420,33,152298
13371,0.024485,74.125.68.0-255,2902,141322,33,152298
13372,0.024492,172.31.33.0-255,66,141388,33,152298
13373,0.024515,74.125.68.0-255,2434,143822,33,152298
13374,0.024518,172.31.33.0-255,66,143888,33,152298
13375,0.024854,172.31.33.0-255,105,143993,33,152298
13376,0.027376,74.125.68.0-255,66,144059,33,152298
13377,0.03311,172.31.33.0-255,172,144231,33,152298
13378,0.033139,172.31.33.0-255,1113,145344,33,152298
13379,0.033193,172.31.33.0-255,1514,146858,33,152298
13380,0.033195,172.31.33.0-255,1514,148372,33,152298
13381,0.033196,172.31.33.0-255,1514,149886,33,152298
13382,0.033197,172.31.33.0-255,1514,151400,33,152298
13383,0.033198,172.31.33.0-255,460,151860,33,152298
13384,0.034629,104.244.42.0-255,66,151926,33,152298
13385,0.034683,104.244.42.0-255,66,151992,33,152298
13386,0.034768,104.244.42.0-255,66,152058,33,152298
13387,0.034786,104.244.42.0-255,66,152124,33,152298
13388,0.03552,104.244.42.0-255,108,152232,33,152298
13389,0.035526,172.31.33.0-255,66,152298,33,152298
13390,0.0,74.125.130.0-255,153,153,33,329048
13391,1.2e-05,172.31.33.0-255,66,219,33,329048
13392,1.9e-05,74.125.130.0-255,1484,1703,33,329048
13393,2.3e-05,172.31.33.0-255,66,1769,33,329048
13394,3e-05,74.125.130.0-255,2902,4671,33,329048
13395,3.4e-05,172.31.33.0-255,66,4737,33,329048
13396,5.8e-05,74.125.130.0-255,1484,6221,33,329048
13397,6.1e-05,172.31.33.0-255,66,6287,33,329048
13398,6.7e-05,74.125.130.0-255,2902,9189,33,329048
13399,7e-05,172.31.33.0-255,66,9255,33,329048
13400,9.3e-05,74.125.130.0-255,4826,14081,33,329048
13401,9.6e-05,172.31.33.0-255,66,14147,33,329048
13402,0.000147,74.125.130.0-255,1484,15631,33,329048
13403,0.00015,172.31.33.0-255,66,15697,33,329048
13404,0.000164,74.125.130.0-255,2902,18599,33,329048
13405,0.000167,172.31.33.0-255,66,18665,33,329048
13406,0.000195,74.125.130.0-255,5738,24403,33,329048
13407,0.000198,172.31.33.0-255,66,24469,33,329048
13408,0.000231,74.125.130.0-255,6797,31266,33,329048
13409,0.000234,172.31.33.0-255,66,31332,33,329048
13410,0.000358,74.125.130.0-255,1484,32816,33,329048
13411,0.000362,172.31.33.0-255,66,32882,33,329048
13412,0.000365,74.125.130.0-255,1484,34366,33,329048
13413,0.000367,172.31.33.0-255,66,34432,33,329048
13414,0.000381,74.125.130.0-255,1484,35916,33,329048
13415,0.000384,172.31.33.0-255,66,35982,33,329048
13416,0.000389,74.125.130.0-255,4320,40302,33,329048
13417,0.000391,172.31.33.0-255,66,40368,33,329048
13418,0.000413,74.125.130.0-255,1484,41852,33,329048
13419,0.000416,172.31.33.0-255,66,41918,33,329048
13420,0.000423,74.125.130.0-255,6797,48715,33,329048
13421,0.000426,172.31.33.0-255,66,48781,33,329048
13422,0.000442,74.125.130.0-255,5738,54519,33,329048
13423,0.000445,172.31.33.0-255,66,54585,33,329048
13424,0.000468,74.125.130.0-255,1484,56069,33,329048
13425,0.000474,74.125.130.0-255,4320,60389,33,329048
13426,0.000477,172.31.33.0-255,66,60455,33,329048
13427,0.000491,74.125.130.0-255,4320,64775,33,329048
13428,0.000494,172.31.33.0-255,66,64841,33,329048
13429,0.000507,74.125.130.0-255,1435,66276,33,329048
13430,0.000863,74.125.130.0-255,376,66652,33,329048
13431,0.000868,172.31.33.0-255,66,66718,33,329048
13432,0.000925,74.125.130.0-255,1484,68202,33,329048
13433,0.000928,74.125.130.0-255,1484,69686,33,329048
13434,0.000931,172.31.33.0-255,66,69752,33,329048
13435,0.000948,74.125.130.0-255,1484,71236,33,329048
13436,0.000954,74.125.130.0-255,5738,76974,33,329048
13437,0.000956,172.31.33.0-255,66,77040,33,329048
13438,0.000977,74.125.130.0-255,4320,81360,33,329048
13439,0.000979,172.31.33.0-255,66,81426,33,329048
13440,0.000985,74.125.130.0-255,5738,87164,33,329048
13441,0.000987,172.31.33.0-255,66,87230,33,329048
13442,0.001004,74.125.130.0-255,2902,90132,33,329048
13443,0.001006,172.31.33.0-255,66,90198,33,329048
13444,0.001021,74.125.130.0-255,7156,97354,33,329048
13445,0.001022,172.31.33.0-255,66,97420,33,329048
13446,0.001037,74.125.130.0-255,1484,98904,33,329048
13447,0.00104,74.125.130.0-255,2184,101088,33,329048
13448,0.001042,172.31.33.0-255,66,101154,33,329048
13449,0.001517,74.125.130.0-255,1484,102638,33,329048
13450,0.001525,74.125.130.0-255,1484,104122,33,329048
13451,0.001529,172.31.33.0-255,66,104188,33,329048
13452,0.001551,74.125.130.0-255,2902,107090,33,329048
13453,0.001554,172.31.33.0-255,66,107156,33,329048
13454,0.001559,74.125.130.0-255,4320,111476,33,329048
13455,0.001562,172.31.33.0-255,66,111542,33,329048
13456,0.001574,74.125.130.0-255,1484,113026,33,329048
13457,0.001578,74.125.130.0-255,1484,114510,33,329048
13458,0.00158,172.31.33.0-255,66,114576,33,329048
13459,0.001607,74.125.130.0-255,7156,121732,33,329048
13460,0.00161,172.31.33.0-255,66,121798,33,329048
13461,0.001618,74.125.130.0-255,7156,128954,33,329048
13462,0.00162,172.31.33.0-255,66,129020,33,329048
13463,0.001647,74.125.130.0-255,2902,131922,33,329048
13464,0.00165,172.31.33.0-255,66,131988,33,329048
13465,0.001657,74.125.130.0-255,3602,135590,33,329048
13466,0.001659,172.31.33.0-255,66,135656,33,329048
13467,0.003931,74.125.130.0-255,1484,137140,33,329048
13468,0.003953,74.125.130.0-255,4320,141460,33,329048
13469,0.003957,172.31.33.0-255,66,141526,33,329048
13470,0.006268,74.125.130.0-255,5738,147264,33,329048
13471,0.006275,172.31.33.0-255,66,147330,33,329048
13472,0.008571,74.125.130.0-255,5738,153068,33,329048
13473,0.008577,172.31.33.0-255,66,153134,33,329048
13474,0.010878,74.125.130.0-255,5738,158872,33,329048
13475,0.010885,172.31.33.0-255,66,158938,33,329048
13476,0.013177,74.125.130.0-255,5738,164676,33,329048
13477,0.013183,172.31.33.0-255,66,164742,33,329048
13478,0.015496,74.125.130.0-255,5738,170480,33,329048
13479,0.015503,172.31.33.0-255,66,170546,33,329048
13480,0.017809,74.125.130.0-255,5738,176284,33,329048
13481,0.017815,172.31.33.0-255,66,176350,33,329048
13482,0.020106,74.125.130.0-255,4320,180670,33,329048
13483,0.020111,172.31.33.0-255,66,180736,33,329048
13484,0.020129,74.125.130.0-255,1484,182220,33,329048
13485,0.020675,172.31.33.0-255,172,182392,33,329048
13486,0.020705,172.31.33.0-255,1113,183505,33,329048
13487,0.02075,172.31.33.0-255,1514,185019,33,329048
13488,0.020752,172.31.33.0-255,1171,186190,33,329048
13489,0.022221,104.244.42.0-255,66,186256,33,329048
13490,0.022266,104.244.42.0-255,66,186322,33,329048
13491,0.022319,104.244.42.0-255,66,186388,33,329048
13492,0.022415,74.125.130.0-255,4320,190708,33,329048
13493,0.022419,172.31.33.0-255,66,190774,33,329048
13494,0.024732,74.125.130.0-255,5738,196512,33,329048
13495,0.024738,172.31.33.0-255,66,196578,33,329048
13496,0.027043,74.125.130.0-255,5738,202316,33,329048
13497,0.027048,172.31.33.0-255,66,202382,33,329048
13498,0.029369,74.125.130.0-255,5738,208120,33,329048
13499,0.029375,172.31.33.0-255,66,208186,33,329048
13500,0.031674,74.125.130.0-255,5738,213924,33,329048
13501,0.03168,172.31.33.0-255,66,213990,33,329048
13502,0.033986,74.125.130.0-255,5738,219728,33,329048
13503,0.033991,172.31.33.0-255,66,219794,33,329048
13504,0.036295,74.125.130.0-255,5738,225532,33,329048
13505,0.036301,172.31.33.0-255,66,225598,33,329048
13506,0.038587,74.125.130.0-255,5738,231336,33,329048
13507,0.038592,172.31.33.0-255,66,231402,33,329048
13508,0.040896,74.125.130.0-255,5738,237140,33,329048
13509,0.040901,172.31.33.0-255,66,237206,33,329048
13510,0.043223,74.125.130.0-255,5738,242944,33,329048
13511,0.043229,172.31.33.0-255,66,243010,33,329048
13512,0.045539,74.125.130.0-255,5738,248748,33,329048
13513,0.045544,172.31.33.0-255,66,248814,33,329048
13514,0.047856,74.125.130.0-255,5738,254552,33,329048
13515,0.047861,172.31.33.0-255,66,254618,33,329048
13516,0.050154,74.125.130.0-255,5738,260356,33,329048
13517,0.05016,172.31.33.0-255,66,260422,33,329048
13518,0.052458,74.125.130.0-255,2902,263324,33,329048
13519,0.052465,172.31.33.0-255,66,263390,33,329048
13520,0.052482,74.125.130.0-255,2902,266292,33,329048
13521,0.052484,172.31.33.0-255,66,266358,33,329048
13522,0.054759,74.125.130.0-255,4320,270678,33,329048
13523,0.054765,172.31.33.0-255,66,270744,33,329048
13524,0.054783,74.125.130.0-255,1484,272228,33,329048
13525,0.057052,74.125.130.0-255,4320,276548,33,329048
13526,0.057057,172.31.33.0-255,66,276614,33,329048
13527,0.059358,74.125.130.0-255,5738,282352,33,329048
13528,0.059363,172.31.33.0-255,66,282418,33,329048
13529,0.061744,74.125.130.0-255,5738,288156,33,329048
13530,0.061751,172.31.33.0-255,66,288222,33,329048
13531,0.064042,74.125.130.0-255,2902,291124,33,329048
13532,0.064047,172.31.33.0-255,66,291190,33,329048
13533,0.064061,74.125.130.0-255,2902,294092,33,329048
13534,0.064064,172.31.33.0-255,66,294158,33,329048
13535,0.066327,74.125.130.0-255,1484,295642,33,329048
13536,0.06635,74.125.130.0-255,4320,299962,33,329048
13537,0.066354,172.31.33.0-255,66,300028,33,329048
13538,0.068663,74.125.130.0-255,5738,305766,33,329048
13539,0.068668,172.31.33.0-255,66,305832,33,329048
13540,0.070954,74.125.130.0-255,5738,311570,33,329048
13541,0.07096,172.31.33.0-255,66,311636,33,329048
13542,0.073261,74.125.130.0-255,5738,317374,33,329048
13543,0.073266,172.31.33.0-255,66,317440,33,329048
13544,0.075564,74.125.130.0-255,5738,323178,33,329048
13545,0.07557,172.31.33.0-255,66,323244,33,329048
13546,0.077865,74.125.130.0-255,5738,328982,33,329048
13547,0.07787,172.31.33.0-255,66,329048,33,329048
13548,0.0,74.125.68.0-255,153,153,33,353962
13549,2.8e-05,172.31.33.0-255,66,219,33,353962
13550,3.4e-05,74.125.68.0-255,1484,1703,33,353962
13551,3.7e-05,172.31.33.0-255,66,1769,33,353962
13552,4e-05,74.125.68.0-255,1484,3253,33,353962
13553,4.2e-05,172.31.33.0-255,66,3319,33,353962
13554,7.1e-05,74.125.68.0-255,1484,4803,33,353962
13555,7.4e-05,172.31.33.0-255,66,4869,33,353962
13556,8.2e-05,74.125.68.0-255,7156,12025,33,353962
13557,9.1e-05,172.31.33.0-255,66,12091,33,353962
13558,9.5e-05,74.125.68.0-255,1956,14047,33,353962
13559,9.7e-05,172.31.33.0-255,66,14113,33,353962
13560,0.000136,74.125.68.0-255,5738,19851,33,353962
13561,0.000139,172.31.33.0-255,66,19917,33,353962
13562,0.000163,74.125.68.0-255,5738,25655,33,353962
13563,0.000167,172.31.33.0-255,66,25721,33,353962
13564,0.000172,74.125.68.0-255,2902,28623,33,353962
13565,0.000174,172.31.33.0-255,66,28689,33,353962
13566,0.000195,74.125.68.0-255,2543,31232,33,353962
13567,0.000198,172.31.33.0-255,66,31298,33,353962
13568,0.000246,74.125.68.0-255,1484,32782,33,353962
13569,0.000249,172.31.33.0-255,66,32848,33,353962
13570,0.000253,74.125.68.0-255,1484,34332,33,353962
13571,0.000256,172.31.33.0-255,66,34398,33,353962
13572,0.000279,74.125.68.0-255,1484,35882,33,353962
13573,0.000282,172.31.33.0-255,66,35948,33,353962
13574,0.000288,74.125.68.0-255,4320,40268,33,353962
13575,0.00029,172.31.33.0-255,66,40334,33,353962
13576,0.000295,74.125.68.0-255,4320,44654,33,353962
13577,0.000303,172.31.33.0-255,66,44720,33,353962
13578,0.000325,74.125.68.0-255,1484,46204,33,353962
13579,0.000328,172.31.33.0-255,66,46270,33,353962
13580,0.000335,74.125.68.0-255,5738,52008,33,353962
13581,0.000337,172.31.33.0-255,66,52074,33,353962
13582,0.000374,74.125.68.0-255,3961,56035,33,353962
13583,0.000378,172.31.33.0-255,66,56101,33,353962
13584,0.000391,172.31.33.0-255,66,56167,33,353962
13585,0.000394,74.125.68.0-255,109,56276,33,353962
13586,0.000397,172.31.33.0-255,66,56342,33,353962
13587,0.000495,74.125.68.0-255,331,56673,33,353962
13588,0.000499,172.31.33.0-255,66,56739,33,353962
13589,0.000959,74.125.68.0-255,1484,58223,33,353962
13590,0.000965,172.31.33.0-255,66,58289,33,353962
13591,0.000976,74.125.68.0-255,2902,61191,33,353962
13592,0.000985,172.31.33.0-255,66,61257,33,353962
13593,0.000992,74.125.68.0-255,5738,66995,33,353962
13594,0.000995,172.31.33.0-255,66,67061,33,353962
13595,0.00102,74.125.68.0-255,4320,71381,33,353962
13596,0.001024,172.31.33.0-255,66,71447,33,353962
13597,0.001062,74.125.68.0-255,4320,75767,33,353962
13598,0.001065,172.31.33.0-255,66,75833,33,353962
13599,0.001077,172.31.33.0-255,66,75899,33,353962
13600,0.001083,74.125.68.0-255,5020,80919,33,353962
13601,0.001086,172.31.33.0-255,66,80985,33,353962
13602,0.001283,74.125.68.0-255,1484,82469,33,353962
13603,0.00129,172.31.33.0-255,66,82535,33,353962
13604,0.001295,74.125.68.0-255,1484,84019,33,353962
13605,0.001298,172.31.33.0-255,66,84085,33,353962
13606,0.001301,74.125.68.0-255,1484,85569,33,353962
13607,0.001311,172.31.33.0-255,66,85635,33,353962
13608,0.001336,74.125.68.0-255,1484,87119,33,353962
13609,0.00134,172.31.33.0-255,66,87185,33,353962
13610,0.001347,74.125.68.0-255,5738,92923,33,353962
13611,0.001349,172.31.33.0-255,66,92989,33,353962
13612,0.001353,74.125.68.0-255,2902,95891,33,353962
13613,0.001355,172.31.33.0-255,66,95957,33,353962
13614,0.00139,74.125.68.0-255,2902,98859,33,353962
13615,0.001398,74.125.68.0-255,7156,106015,33,353962
13616,0.001404,74.125.68.0-255,7156,113171,33,353962
13617,0.00141,172.31.33.0-255,66,113237,33,353962
13618,0.001428,74.125.68.0-255,1484,114721,33,353962
13619,0.001431,74.125.68.0-255,766,115487,33,353962
13620,0.001449,172.31.33.0-255,66,115553,33,353962
13621,0.001478,74.125.68.0-255,1484,117037,33,353962
13622,0.00149,74.125.68.0-255,2902,119939,33,353962
13623,0.001495,172.31.33.0-255,66,120005,33,353962
13624,0.001524,74.125.68.0-255,5738,125743,33,353962
13625,0.001538,74.125.68.0-255,4320,130063,33,353962
13626,0.001543,172.31.33.0-255,66,130129,33,353962
13627,0.001553,74.125.68.0-255,5738,135867,33,353962
13628,0.001565,74.125.68.0-255,1484,137351,33,353962
13629,0.001568,74.125.68.0-255,1484,138835,33,353962
13630,0.001578,172.31.33.0-255,66,138901,33,353962
13631,0.001621,172.31.33.0-255,66,138967,33,353962
13632,0.002263,74.125.68.0-255,1484,140451,33,353962
13633,0.002267,172.31.33.0-255,66,140517,33,353962
13634,0.002298,74.125.68.0-255,2902,143419,33,353962
13635,0.0023,172.31.33.0-255,66,143485,33,353962
13636,0.002303,74.125.68.0-255,1484,144969,33,353962
13637,0.002304,172.31.33.0-255,66,145035,33,353962
13638,0.002335,74.125.68.0-255,1484,146519,33,353962
13639,0.002337,172.31.33.0-255,66,146585,33,353962
13640,0.002358,74.125.68.0-255,1484,148069,33,353962
13641,0.00236,172.31.33.0-255,66,148135,33,353962
13642,0.002366,74.125.68.0-255,5738,153873,33,353962
13643,0.002367,172.31.33.0-255,66,153939,33,353962
13644,0.002372,74.125.68.0-255,5738,159677,33,353962
13645,0.002396,172.31.33.0-255,66,159743,33,353962
13646,0.004721,74.125.68.0-255,5738,165481,33,353962
13647,0.004725,172.31.33.0-255,66,165547,33,353962
13648,0.007059,74.125.68.0-255,4320,169867,33,353962
13649,0.007064,172.31.33.0-255,66,169933,33,353962
13650,0.007092,74.125.68.0-255,1484,171417,33,353962
13651,0.009399,74.125.68.0-255,4320,175737,33,353962
13652,0.009406,172.31.33.0-255,66,175803,33,353962
13653,0.011737,74.125.68.0-255,5738,181541,33,353962
13654,0.011788,172.31.33.0-255,66,181607,33,353962
13655,0.014123,74.125.68.0-255,5738,187345,33,353962
13656,0.014132,172.31.33.0-255,66,187411,33,353962
13657,0.016475,74.125.68.0-255,4320,191731,33,353962
13658,0.01648,172.31.33.0-255,66,191797,33,353962
13659,0.016509,74.125.68.0-255,1484,193281,33,353962
13660,0.018729,172.31.33.0-255,172,193453,33,353962
13661,0.018764,172.31.33.0-255,1113,194566,33,353962
13662,0.018809,74.125.68.0-255,4320,198886,33,353962
13663,0.018814,172.31.33.0-255,66,198952,33,353962
13664,0.018908,172.31.33.0-255,1514,200466,33,353962
13665,0.01891,172.31.33.0-255,1514,201980,33,353962
13666,0.018935,172.31.33.0-255,680,202660,33,353962
13667,0.020274,104.244.42.0-255,66,202726,33,353962
13668,0.020281,104.244.42.0-255,66,202792,33,353962
13669,0.020454,104.244.42.0-255,66,202858,33,353962
13670,0.020456,104.244.42.0-255,66,202924,33,353962
13671,0.021158,74.125.68.0-255,5738,208662,33,353962
13672,0.021216,172.31.33.0-255,66,208728,33,353962
13673,0.023566,74.125.68.0-255,5738,214466,33,353962
13674,0.023574,172.31.33.0-255,66,214532,33,353962
13675,0.025919,74.125.68.0-255,5738,220270,33,353962
13676,0.025924,172.31.33.0-255,66,220336,33,353962
13677,0.028259,74.125.68.0-255,1484,221820,33,353962
13678,0.028263,172.31.33.0-255,66,221886,33,353962
13679,0.028291,74.125.68.0-255,4320,226206,33,353962
13680,0.028301,172.31.33.0-255,66,226272,33,353962
13681,0.030581,74.125.68.0-255,1484,227756,33,353962
13682,0.030586,172.31.33.0-255,66,227822,33,353962
13683,0.030617,74.125.68.0-255,4320,232142,33,353962
13684,0.030634,172.31.33.0-255,66,232208,33,353962
13685,0.03293,74.125.68.0-255,1484,233692,33,353962
13686,0.032961,74.125.68.0-255,4320,238012,33,353962
13687,0.032974,172.31.33.0-255,66,238078,33,353962
13688,0.035307,74.125.68.0-255,5738,243816,33,353962
13689,0.035313,172.31.33.0-255,66,243882,33,353962
13690,0.037637,74.125.68.0-255,1484,245366,33,353962
13691,0.037666,74.125.68.0-255,4320,249686,33,353962
13692,0.03767,172.31.33.0-255,66,249752,33,353962
13693,0.040008,74.125.68.0-255,2902,252654,33,353962
13694,0.040012,172.31.33.0-255,66,252720,33,353962
13695,0.040048,74.125.68.0-255,2902,255622,33,353962
13696,0.040075,172.31.33.0-255,66,255688,33,353962
13697,0.042329,74.125.68.0-255,1484,257172,33,353962
13698,0.04235,74.125.68.0-255,1484,258656,33,353962
13699,0.042354,172.31.33.0-255,66,258722,33,353962
13700,0.0424,74.125.68.0-255,2902,261624,33,353962
13701,0.042405,172.31.33.0-255,66,261690,33,353962
13702,0.044683,74.125.68.0-255,2902,264592,33,353962
13703,0.044687,172.31.33.0-255,66,264658,33,353962
13704,0.044724,74.125.68.0-255,1484,266142,33,353962
13705,0.044734,74.125.68.0-255,1484,267626,33,353962
13706,0.04475,172.31.33.0-255,66,267692,33,353962
13707,0.047027,74.125.68.0-255,2902,270594,33,353962
13708,0.047031,172.31.33.0-255,66,270660,33,353962
13709,0.047069,74.125.68.0-255,2902,273562,33,353962
13710,0.047379,172.31.33.0-255,66,273628,33,353962
13711,0.049362,74.125.68.0-255,2902,276530,33,353962
13712,0.049367,172.31.33.0-255,66,276596,33,353962
13713,0.049712,74.125.68.0-255,2902,279498,33,353962
13714,0.049717,172.31.33.0-255,66,279564,33,353962
13715,0.0517,74.125.68.0-255,1484,281048,33,353962
13716,0.051726,74.125.68.0-255,1484,282532,33,353962
13717,0.051729,172.31.33.0-255,66,282598,33,353962
13718,0.052039,74.125.68.0-255,2902,285500,33,353962
13719,0.052043,172.31.33.0-255,66,285566,33,353962
13720,0.054103,74.125.68.0-255,2902,288468,33,353962
13721,0.054108,172.31.33.0-255,66,288534,33,353962
13722,0.054372,74.125.68.0-255,2902,291436,33,353962
13723,0.054376,172.31.33.0-255,66,291502,33,353962
13724,0.05643,74.125.68.0-255,2902,294404,33,353962
13725,0.056435,172.31.33.0-255,66,294470,33,353962
13726,0.056714,74.125.68.0-255,2902,297372,33,353962
13727,0.056719,172.31.33.0-255,66,297438,33,353962
13728,0.058774,74.125.68.0-255,2902,300340,33,353962
13729,0.058778,172.31.33.0-255,66,300406,33,353962
13730,0.059055,74.125.68.0-255,2902,303308,33,353962
13731,0.05906,172.31.33.0-255,66,303374,33,353962
13732,0.061095,74.125.68.0-255,2902,306276,33,353962
13733,0.061101,172.31.33.0-255,66,306342,33,353962
13734,0.061404,74.125.68.0-255,2902,309244,33,353962
13735,0.061411,172.31.33.0-255,66,309310,33,353962
13736,0.063427,74.125.68.0-255,2902,312212,33,353962
13737,0.063432,172.31.33.0-255,66,312278,33,353962
13738,0.063757,74.125.68.0-255,1484,313762,33,353962
13739,0.063778,74.125.68.0-255,1484,315246,33,353962
13740,0.063781,172.31.33.0-255,66,315312,33,353962
13741,0.065761,74.125.68.0-255,2902,318214,33,353962
13742,0.065765,172.31.33.0-255,66,318280,33,353962
13743,0.066109,74.125.68.0-255,2902,321182,33,353962
13744,0.066113,172.31.33.0-255,66,321248,33,353962
13745,0.068096,74.125.68.0-255,2902,324150,33,353962
13746,0.068101,172.31.33.0-255,66,324216,33,353962
13747,0.068438,74.125.68.0-255,2902,327118,33,353962
13748,0.068443,172.31.33.0-255,66,327184,33,353962
13749,0.07043,74.125.68.0-255,2902,330086,33,353962
13750,0.070435,172.31.33.0-255,66,330152,33,353962
13751,0.070789,74.125.68.0-255,2902,333054,33,353962
13752,0.070796,172.31.33.0-255,66,333120,33,353962
13753,0.072762,74.125.68.0-255,2902,336022,33,353962
13754,0.072767,172.31.33.0-255,66,336088,33,353962
13755,0.073126,74.125.68.0-255,2902,338990,33,353962
13756,0.073131,172.31.33.0-255,66,339056,33,353962
13757,0.075125,74.125.68.0-255,2902,341958,33,353962
13758,0.07513,172.31.33.0-255,66,342024,33,353962
13759,0.075469,74.125.68.0-255,2902,344926,33,353962
13760,0.075473,172.31.33.0-255,66,344992,33,353962
13761,0.077452,74.125.68.0-255,1484,346476,33,353962
13762,0.077478,74.125.68.0-255,1484,347960,33,353962
13763,0.077481,172.31.33.0-255,66,348026,33,353962
13764,0.077812,74.125.68.0-255,2902,350928,33,353962
13765,0.077816,172.31.33.0-255,66,350994,33,353962
13766,0.079899,74.125.68.0-255,2902,353896,33,353962
13767,0.079904,172.31.33.0-255,66,353962,33,353962
13768,0.0,172.217.194.0-255,153,153,33,272107
13769,2.4e-05,172.31.33.0-255,66,219,33,272107
13770,3.1e-05,172.217.194.0-255,1484,1703,33,272107
13771,3.5e-05,172.31.33.0-255,66,1769,33,272107
13772,4e-05,172.217.194.0-255,2902,4671,33,272107
13773,5.1e-05,172.31.33.0-255,66,4737,33,272107
13774,5.9e-05,172.217.194.0-255,7156,11893,33,272107
13775,6.1e-05,172.31.33.0-255,66,11959,33,272107
13776,6.5e-05,172.217.194.0-255,2027,13986,33,272107
13777,6.8e-05,172.31.33.0-255,66,14052,33,272107
13778,9.7e-05,172.217.194.0-255,1484,15536,33,272107
13779,9.9e-05,172.31.33.0-255,66,15602,33,272107
13780,0.000103,172.217.194.0-255,1484,17086,33,272107
13781,0.000105,172.31.33.0-255,66,17152,33,272107
13782,0.000129,172.217.194.0-255,1484,18636,33,272107
13783,0.000131,172.31.33.0-255,66,18702,33,272107
13784,0.000137,172.217.194.0-255,5738,24440,33,272107
13785,0.00014,172.31.33.0-255,66,24506,33,272107
13786,0.00015,172.217.194.0-255,6797,31303,33,272107
13787,0.000152,172.31.33.0-255,66,31369,33,272107
13788,0.000189,172.217.194.0-255,7156,38525,33,272107
13789,0.000191,172.31.33.0-255,66,38591,33,272107
13790,0.000196,172.217.194.0-255,4320,42911,33,272107
13791,0.000198,172.31.33.0-255,66,42977,33,272107
13792,0.000229,172.217.194.0-255,5379,48356,33,272107
13793,0.000231,172.31.33.0-255,66,48422,33,272107
13794,0.00027,172.217.194.0-255,1484,49906,33,272107
13795,0.000272,172.31.33.0-255,66,49972,33,272107
13796,0.000276,172.217.194.0-255,2902,52874,33,272107
13797,0.000278,172.31.33.0-255,66,52940,33,272107
13798,0.000287,172.217.194.0-255,5738,58678,33,272107
13799,0.000289,172.31.33.0-255,66,58744,33,272107
13800,0.000293,172.217.194.0-255,2902,61646,33,272107
13801,0.000295,172.31.33.0-255,66,61712,33,272107
13802,0.000321,172.217.194.0-255,3961,65673,33,272107
13803,0.000326,172.31.33.0-255,66,65739,33,272107
13804,0.000352,172.217.194.0-255,6318,72057,33,272107
13805,0.000355,172.31.33.0-255,66,72123,33,272107
13806,0.000359,172.217.194.0-255,2902,75025,33,272107
13807,0.000361,172.31.33.0-255,66,75091,33,272107
13808,0.000379,172.217.194.0-255,4320,79411,33,272107
13809,0.000382,172.31.33.0-255,66,79477,33,272107
13810,0.000402,172.217.194.0-255,3961,83438,33,272107
13811,0.000405,172.31.33.0-255,66,83504,33,272107
13812,0.000514,172.217.194.0-255,1484,84988,33,272107
13813,0.000521,172.217.194.0-255,2902,87890,33,272107
13814,0.000524,172.31.33.0-255,66,87956,33,272107
13815,0.000528,172.217.194.0-255,1484,89440,33,272107
13816,0.000552,172.217.194.0-255,4320,93760,33,272107
13817,0.000554,172.31.33.0-255,66,93826,33,272107
13818,0.000561,172.217.194.0-255,6797,100623,33,272107
13819,0.000563,172.31.33.0-255,66,100689,33,272107
13820,0.000596,172.31.33.0-255,66,100755,33,272107
13821,0.000622,172.217.194.0-255,4320,105075,33,272107
13822,0.000624,172.31.33.0-255,66,105141,33,272107
13823,0.000639,172.31.33.0-255,66,105207,33,272107
13824,0.000666,172.31.33.0-255,66,105273,33,272107
13825,0.000706,172.217.194.0-255,7156,112429,33,272107
13826,0.000708,172.31.33.0-255,66,112495,33,272107
13827,0.000734,172.217.194.0-255,1484,113979,33,272107
13828,0.000742,172.217.194.0-255,7156,121135,33,272107
13829,0.000744,172.31.33.0-255,66,121201,33,272107
13830,0.000764,172.31.33.0-255,66,121267,33,272107
13831,0.000766,172.217.194.0-255,766,122033,33,272107
13832,0.000884,172.217.194.0-255,1484,123517,33,272107
13833,0.000888,172.31.33.0-255,66,123583,33,272107
13834,0.000894,172.217.194.0-255,2902,126485,33,272107
13835,0.000896,172.31.33.0-255,66,126551,33,272107
13836,0.000914,172.217.194.0-255,1484,128035,33,272107
13837,0.000939,172.217.194.0-255,4320,132355,33,272107
13838,0.000942,172.31.33.0-255,66,132421,33,272107
13839,0.000947,172.217.194.0-255,5738,138159,33,272107
13840,0.000963,172.31.33.0-255,66,138225,33,272107
13841,0.000975,172.217.194.0-255,7156,145381,33,272107
13842,0.001011,172.217.194.0-255,2184,147565,33,272107
13843,0.001014,172.31.33.0-255,66,147631,33,272107
13844,0.001018,172.31.33.0-255,66,147697,33,272107
13845,0.001608,172.217.194.0-255,1484,149181,33,272107
13846,0.001615,172.217.194.0-255,2902,152083,33,272107
13847,0.001617,172.31.33.0-255,66,152149,33,272107
13848,0.001646,172.217.194.0-255,5738,157887,33,272107
13849,0.001648,172.31.33.0-255,66,157953,33,272107
13850,0.001673,172.217.194.0-255,1484,159437,33,272107
13851,0.001705,172.31.33.0-255,66,159503,33,272107
13852,0.001748,172.31.33.0-255,66,159569,33,272107
13853,0.001772,172.217.194.0-255,2184,161753,33,272107
13854,0.001775,172.31.33.0-255,66,161819,33,272107
13855,0.001804,172.217.194.0-255,1484,163303,33,272107
13856,0.001825,172.217.194.0-255,2902,166205,33,272107
13857,0.001828,172.31.33.0-255,66,166271,33,272107
13858,0.001834,172.217.194.0-255,4320,170591,33,272107
13859,0.001836,172.31.33.0-255,66,170657,33,272107
13860,0.001863,172.217.194.0-255,1484,172141,33,272107
13861,0.001868,172.217.194.0-255,2902,175043,33,272107
13862,0.001871,172.31.33.0-255,66,175109,33,272107
13863,0.001917,172.31.33.0-255,66,175175,33,272107
13864,0.001924,172.217.194.0-255,5738,180913,33,272107
13865,0.001926,172.31.33.0-255,66,180979,33,272107
13866,0.001936,172.217.194.0-255,5020,185999,33,272107
13867,0.001938,172.31.33.0-255,66,186065,33,272107
13868,0.002051,172.217.194.0-255,1484,187549,33,272107
13869,0.002057,172.217.194.0-255,2902,190451,33,272107
13870,0.00206,172.31.33.0-255,66,190517,33,272107
13871,0.002112,172.217.194.0-255,5738,196255,33,272107
13872,0.002116,172.31.33.0-255,66,196321,33,272107
13873,0.002122,172.217.194.0-255,5738,202059,33,272107
13874,0.002124,172.31.33.0-255,66,202125,33,272107
13875,0.002145,172.217.194.0-255,1484,203609,33,272107
13876,0.002165,172.217.194.0-255,3602,207211,33,272107
13877,0.002169,172.217.194.0-255,2902,210113,33,272107
13878,0.002191,172.217.194.0-255,2902,213015,33,272107
13879,0.002213,172.217.194.0-255,1484,214499,33,272107
13880,0.00226,172.217.194.0-255,2902,217401,33,272107
13881,0.002266,172.217.194.0-255,5020,222421,33,272107
13882,0.002285,172.217.194.0-255,2902,225323,33,272107
13883,0.002339,172.217.194.0-255,2902,228225,33,272107
13884,0.006572,172.31.33.0-255,66,228291,33,272107
13885,0.008837,172.217.194.0-255,5738,234029,33,272107
13886,0.008844,172.31.33.0-255,66,234095,33,272107
13887,0.011102,172.217.194.0-255,5738,239833,33,272107
13888,0.011109,172.31.33.0-255,66,239899,33,272107
13889,0.013389,172.217.194.0-255,5738,245637,33,272107
13890,0.013398,172.31.33.0-255,66,245703,33,272107
13891,0.015675,172.217.194.0-255,5738,251441,33,272107
13892,0.015684,172.31.33.0-255,66,251507,33,272107
13893,0.017948,172.217.194.0-255,5738,257245,33,272107
13894,0.017957,172.31.33.0-255,66,257311,33,272107
13895,0.020241,172.217.194.0-255,5738,263049,33,272107
13896,0.020249,172.31.33.0-255,66,263115,33,272107
13897,0.022527,172.217.194.0-255,3498,266613,33,272107
13898,0.022537,172.31.33.0-255,66,266679,33,272107
13899,0.022735,172.31.33.0-255,105,266784,33,272107
13900,0.024957,172.217.194.0-255,66,266850,33,272107
13901,0.045234,172.31.33.0-255,172,267022,33,272107
13902,0.045269,172.31.33.0-255,1117,268139,33,272107
13903,0.045334,172.31.33.0-255,1514,269653,33,272107
13904,0.045336,172.31.33.0-255,1514,271167,33,272107
13905,0.045359,172.31.33.0-255,676,271843,33,272107
13906,0.046777,104.244.42.0-255,66,271909,33,272107
13907,0.046786,104.244.42.0-255,66,271975,33,272107
13908,0.04688,104.244.42.0-255,66,272041,33,272107
13909,0.046884,104.244.42.0-255,66,272107,33,272107
13910,0.0,172.217.194.0-255,148,148,33,217846
13911,2.9e-05,172.31.33.0-255,66,214,33,217846
13912,3.5e-05,172.217.194.0-255,1484,1698,33,217846
13913,3.9e-05,172.31.33.0-255,66,1764,33,217846
13914,4.5e-05,172.217.194.0-255,2902,4666,33,217846
13915,4.8e-05,172.31.33.0-255,66,4732,33,217846
13916,5.3e-05,172.217.194.0-255,2902,7634,33,217846
13917,5.6e-05,172.31.33.0-255,66,7700,33,217846
13918,7.4e-05,172.217.194.0-255,4320,12020,33,217846
13919,7.7e-05,172.31.33.0-255,66,12086,33,217846
13920,0.000119,172.31.33.0-255,66,12152,33,217846
13921,0.00014,172.217.194.0-255,5379,17531,33,217846
13922,0.000143,172.31.33.0-255,66,17597,33,217846
13923,0.00025,172.217.194.0-255,1484,19081,33,217846
13924,0.000254,172.31.33.0-255,66,19147,33,217846
13925,0.00026,172.217.194.0-255,2902,22049,33,217846
13926,0.000262,172.31.33.0-255,66,22115,33,217846
13927,0.000269,172.217.194.0-255,5738,27853,33,217846
13928,0.000271,172.31.33.0-255,66,27919,33,217846
13929,0.000293,172.217.194.0-255,4320,32239,33,217846
13930,0.000296,172.31.33.0-255,66,32305,33,217846
13931,0.000322,172.217.194.0-255,5379,37684,33,217846
13932,0.000325,172.31.33.0-255,66,37750,33,217846
13933,0.000343,172.217.194.0-255,4320,42070,33,217846
13934,0.000345,172.31.33.0-255,66,42136,33,217846
13935,0.000372,172.31.33.0-255,66,42202,33,217846
13936,0.000631,172.217.194.0-255,380,42582,33,217846
13937,0.000636,172.31.33.0-255,66,42648,33,217846
13938,0.000757,172.217.194.0-255,1484,44132,33,217846
13939,0.000761,172.31.33.0-255,66,44198,33,217846
13940,0.000767,172.217.194.0-255,2902,47100,33,217846
13941,0.000769,172.31.33.0-255,66,47166,33,217846
13942,0.000772,172.217.194.0-255,1484,48650,33,217846
13943,0.0008,172.217.194.0-255,4320,52970,33,217846
13944,0.000803,172.31.33.0-255,66,53036,33,217846
13945,0.000808,172.217.194.0-255,4320,57356,33,217846
13946,0.000813,172.31.33.0-255,66,57422,33,217846
13947,0.000831,172.217.194.0-255,2543,59965,33,217846
13948,0.000834,172.31.33.0-255,66,60031,33,217846
13949,0.000849,172.217.194.0-255,2902,62933,33,217846
13950,0.000852,172.31.33.0-255,66,62999,33,217846
13951,0.000855,172.217.194.0-255,1484,64483,33,217846
13952,0.000882,172.217.194.0-255,5738,70221,33,217846
13953,0.000886,172.31.33.0-255,66,70287,33,217846
13954,0.000894,172.217.194.0-255,6797,77084,33,217846
13955,0.000897,172.31.33.0-255,66,77150,33,217846
13956,0.001124,172.217.194.0-255,1484,78634,33,217846
13957,0.001131,172.217.194.0-255,2902,81536,33,217846
13958,0.001135,172.31.33.0-255,66,81602,33,217846
13959,0.00114,172.217.194.0-255,2902,84504,33,217846
13960,0.001143,172.31.33.0-255,66,84570,33,217846
13961,0.001158,172.217.194.0-255,2902,87472,33,217846
13962,0.001161,172.31.33.0-255,66,87538,33,217846
13963,0.001178,172.217.194.0-255,7156,94694,33,217846
13964,0.001181,172.31.33.0-255,66,94760,33,217846
13965,0.001212,172.217.194.0-255,5738,100498,33,217846
13966,0.001216,172.31.33.0-255,66,100564,33,217846
13967,0.001228,172.31.33.0-255,66,100630,33,217846
13968,0.001417,172.217.194.0-255,1484,102114,33,217846
13969,0.001423,172.217.194.0-255,1484,103598,33,217846
13970,0.001427,172.31.33.0-255,66,103664,33,217846
13971,0.001447,172.217.194.0-255,1484,105148,33,217846
13972,0.001453,172.217.194.0-255,5738,110886,33,217846
13973,0.001457,172.31.33.0-255,66,110952,33,217846
13974,0.001467,172.31.33.0-255,66,111018,33,217846
13975,0.001482,172.217.194.0-255,1484,112502,33,217846
13976,0.001516,172.217.194.0-255,5738,118240,33,217846
13977,0.001519,172.31.33.0-255,66,118306,33,217846
13978,0.001544,172.31.33.0-255,66,118372,33,217846
13979,0.002171,172.217.194.0-255,1484,119856,33,217846
13980,0.002174,172.217.194.0-255,1484,121340,33,217846
13981,0.002176,172.31.33.0-255,66,121406,33,217846
13982,0.002188,172.217.194.0-255,1484,122890,33,217846
13983,0.002194,172.217.194.0-255,5738,128628,33,217846
13984,0.002196,172.31.33.0-255,66,128694,33,217846
13985,0.002226,172.31.33.0-255,66,128760,33,217846
13986,0.002249,172.217.194.0-255,2902,131662,33,217846
13987,0.002251,172.31.33.0-255,66,131728,33,217846
13988,0.002262,172.31.33.0-255,66,131794,33,217846
13989,0.002264,172.217.194.0-255,766,132560,33,217846
13990,0.002266,172.217.194.0-255,1484,134044,33,217846
13991,0.002268,172.31.33.0-255,66,134110,33,217846
13992,0.002281,172.217.194.0-255,2902,137012,33,217846
13993,0.002283,172.31.33.0-255,66,137078,33,217846
13994,0.002294,172.217.194.0-255,1484,138562,33,217846
13995,0.002297,172.217.194.0-255,1484,140046,33,217846
13996,0.0023,172.31.33.0-255,66,140112,33,217846
13997,0.00233,172.31.33.0-255,66,140178,33,217846
13998,0.002332,172.217.194.0-255,1484,141662,33,217846
13999,0.00235,172.217.194.0-255,5738,147400,33,217846
14000,0.002352,172.31.33.0-255,66,147466,33,217846
14001,0.00238,172.31.33.0-255,66,147532,33,217846
14002,0.002391,172.31.33.0-255,66,147598,33,217846
14003,0.002424,172.217.194.0-255,7156,154754,33,217846
14004,0.002426,172.31.33.0-255,66,154820,33,217846
14005,0.00244,172.31.33.0-255,66,154886,33,217846
14006,0.002443,172.217.194.0-255,2902,157788,33,217846
14007,0.002445,172.31.33.0-255,66,157854,33,217846
14008,0.002484,172.31.33.0-255,66,157920,33,217846
14009,0.002497,172.217.194.0-255,3602,161522,33,217846
14010,0.002499,172.31.33.0-255,66,161588,33,217846
14011,0.002514,172.217.194.0-255,5738,167326,33,217846
14012,0.002516,172.31.33.0-255,66,167392,33,217846
14013,0.002554,172.31.33.0-255,66,167458,33,217846
14014,0.002594,172.217.194.0-255,2902,170360,33,217846
14015,0.002596,172.31.33.0-255,66,170426,33,217846
14016,0.002624,172.31.33.0-255,66,170492,33,217846
14017,0.00264,172.217.194.0-255,5738,176230,33,217846
14018,0.002642,172.31.33.0-255,66,176296,33,217846
14019,0.002663,172.31.33.0-255,66,176362,33,217846
14020,0.002685,172.217.194.0-255,1484,177846,33,217846
14021,0.00269,172.217.194.0-255,3602,181448,33,217846
14022,0.002692,172.31.33.0-255,66,181514,33,217846
14023,0.00528,172.217.194.0-255,5738,187252,33,217846
14024,0.005289,172.31.33.0-255,66,187318,33,217846
14025,0.007899,172.217.194.0-255,5738,193056,33,217846
14026,0.00792,172.31.33.0-255,66,193122,33,217846
14027,0.010488,172.217.194.0-255,5738,198860,33,217846
14028,0.010502,172.31.33.0-255,66,198926,33,217846
14029,0.013053,172.217.194.0-255,5738,204664,33,217846
14030,0.013062,172.31.33.0-255,66,204730,33,217846
14031,0.015648,172.217.194.0-255,5724,210454,33,217846
14032,0.015661,172.31.33.0-255,66,210520,33,217846
14033,0.015876,172.31.33.0-255,105,210625,33,217846
14034,0.018396,172.217.194.0-255,66,210691,33,217846
14035,0.040575,172.31.33.0-255,172,210863,33,217846
14036,0.040609,172.31.33.0-255,1117,211980,33,217846
14037,0.040655,172.31.33.0-255,1514,213494,33,217846
14038,0.040657,172.31.33.0-255,1514,215008,33,217846
14039,0.040662,172.31.33.0-255,1514,216522,33,217846
14040,0.040663,172.31.33.0-255,1060,217582,33,217846
14041,0.042165,104.244.42.0-255,66,217648,33,217846
14042,0.042195,104.244.42.0-255,66,217714,33,217846
14043,0.042256,104.244.42.0-255,66,217780,33,217846
14044,0.042263,104.244.42.0-255,66,217846,33,217846
14045,0.0,172.31.33.0-255,105,105,33,1836
14046,4.5e-05,172.31.33.0-255,105,210,33,1836
14047,0.000102,172.31.33.0-255,105,315,33,1836
14048,0.000167,172.31.33.0-255,105,420,33,1836
14049,0.00049,172.31.33.0-255,90,510,33,1836
14050,0.000497,172.31.33.0-255,66,576,33,1836
14051,0.000657,172.31.33.0-255,90,666,33,1836
14052,0.000663,172.31.33.0-255,66,732,33,1836
14053,0.000819,172.31.33.0-255,90,822,33,1836
14054,0.000825,172.31.33.0-255,66,888,33,1836
14055,0.000972,172.31.33.0-255,90,978,33,1836
14056,0.000977,172.31.33.0-255,66,1044,33,1836
14057,0.003005,74.125.24.0-255,66,1110,33,1836
14058,0.003028,74.125.24.0-255,66,1176,33,1836
14059,0.003044,172.31.33.0-255,66,1242,33,1836
14060,0.003122,172.217.194.0-255,66,1308,33,1836
14061,0.00313,172.217.194.0-255,66,1374,33,1836
14062,0.003135,172.31.33.0-255,66,1440,33,1836
14063,0.003235,74.125.200.0-255,66,1506,33,1836
14064,0.00325,74.125.200.0-255,66,1572,33,1836
14065,0.003255,172.31.33.0-255,66,1638,33,1836
14066,0.00328,74.125.24.0-255,66,1704,33,1836
14067,0.0033,74.125.24.0-255,66,1770,33,1836
14068,0.003304,172.31.33.0-255,66,1836,33,1836
14069,0.0,172.217.194.0-255,153,153,33,145082
14070,1.5e-05,172.31.33.0-255,66,219,33,145082
14071,2.1e-05,172.217.194.0-255,1484,1703,33,145082
14072,2.5e-05,172.31.33.0-255,66,1769,33,145082
14073,3e-05,172.217.194.0-255,2902,4671,33,145082
14074,4.2e-05,172.31.33.0-255,66,4737,33,145082
14075,4.8e-05,172.217.194.0-255,5738,10475,33,145082
14076,5.2e-05,172.31.33.0-255,66,10541,33,145082
14077,9.6e-05,172.217.194.0-255,3414,13955,33,145082
14078,9.9e-05,172.31.33.0-255,66,14021,33,145082
14079,0.000105,172.217.194.0-255,4320,18341,33,145082
14080,0.000107,172.31.33.0-255,66,18407,33,145082
14081,0.000143,172.31.33.0-255,66,18473,33,145082
14082,0.000147,172.217.194.0-255,2543,21016,33,145082
14083,0.000149,172.31.33.0-255,66,21082,33,145082
14084,0.000193,172.31.33.0-255,66,21148,33,145082
14085,0.000197,172.217.194.0-255,2543,23691,33,145082
14086,0.000199,172.31.33.0-255,66,23757,33,145082
14087,0.000546,172.217.194.0-255,1484,25241,33,145082
14088,0.000551,172.31.33.0-255,66,25307,33,145082
14089,0.000557,172.217.194.0-255,2902,28209,33,145082
14090,0.00056,172.31.33.0-255,66,28275,33,145082
14091,0.000568,172.217.194.0-255,1484,29759,33,145082
14092,0.00057,172.31.33.0-255,66,29825,33,145082
14093,0.000604,172.217.194.0-255,4320,34145,33,145082
14094,0.000607,172.31.33.0-255,66,34211,33,145082
14095,0.000614,172.217.194.0-255,7091,41302,33,145082
14096,0.000617,172.31.33.0-255,66,41368,33,145082
14097,0.000649,172.217.194.0-255,7156,48524,33,145082
14098,0.000653,172.31.33.0-255,66,48590,33,145082
14099,0.000659,172.217.194.0-255,5738,54328,33,145082
14100,0.000661,172.31.33.0-255,66,54394,33,145082
14101,0.000698,172.217.194.0-255,5738,60132,33,145082
14102,0.000701,172.31.33.0-255,66,60198,33,145082
14103,0.000733,172.31.33.0-255,66,60264,33,145082
14104,0.000736,172.217.194.0-255,1484,61748,33,145082
14105,0.000744,172.217.194.0-255,5379,67127,33,145082
14106,0.000746,172.31.33.0-255,66,67193,33,145082
14107,0.000793,172.217.194.0-255,1484,68677,33,145082
14108,0.000797,172.217.194.0-255,1484,70161,33,145082
14109,0.0008,172.31.33.0-255,66,70227,33,145082
14110,0.000829,172.217.194.0-255,1484,71711,33,145082
14111,0.000835,172.217.194.0-255,5738,77449,33,145082
14112,0.000838,172.31.33.0-255,66,77515,33,145082
14113,0.000878,172.31.33.0-255,66,77581,33,145082
14114,0.000935,172.217.194.0-255,4320,81901,33,145082
14115,0.00094,172.31.33.0-255,66,81967,33,145082
14116,0.000952,172.217.194.0-255,6438,88405,33,145082
14117,0.000959,172.31.33.0-255,66,88471,33,145082
14118,0.000964,172.217.194.0-255,2902,91373,33,145082
14119,0.000967,172.31.33.0-255,66,91439,33,145082
14120,0.000973,172.217.194.0-255,4320,95759,33,145082
14121,0.000976,172.31.33.0-255,66,95825,33,145082
14122,0.000987,172.31.33.0-255,66,95891,33,145082
14123,0.001036,172.31.33.0-255,66,95957,33,145082
14124,0.001074,172.31.33.0-255,66,96023,33,145082
14125,0.001107,172.31.33.0-255,66,96089,33,145082
14126,0.001124,172.31.33.0-255,66,96155,33,145082
14127,0.001179,172.31.33.0-255,66,96221,33,145082
14128,0.001193,172.31.33.0-255,66,96287,33,145082
14129,0.001254,172.217.194.0-255,2902,99189,33,145082
14130,0.00126,172.31.33.0-255,66,99255,33,145082
14131,0.001264,172.31.33.0-255,66,99321,33,145082
14132,0.001267,172.31.33.0-255,66,99387,33,145082
14133,0.0013,172.31.33.0-255,66,99453,33,145082
14134,0.001353,172.217.194.0-255,1484,100937,33,145082
14135,0.001356,172.217.194.0-255,1484,102421,33,145082
14136,0.001365,172.31.33.0-255,66,102487,33,145082
14137,0.001369,172.217.194.0-255,1484,103971,33,145082
14138,0.001372,172.217.194.0-255,1484,105455,33,145082
14139,0.001375,172.31.33.0-255,66,105521,33,145082
14140,0.001402,172.217.194.0-255,4320,109841,33,145082
14141,0.001404,172.31.33.0-255,66,109907,33,145082
14142,0.001419,172.31.33.0-255,66,109973,33,145082
14143,0.001464,172.31.33.0-255,66,110039,33,145082
14144,0.001499,172.217.194.0-255,2902,112941,33,145082
14145,0.001502,172.31.33.0-255,66,113007,33,145082
14146,0.001532,172.217.194.0-255,4320,117327,33,145082
14147,0.001536,172.31.33.0-255,66,117393,33,145082
14148,0.001546,172.31.33.0-255,66,117459,33,145082
14149,0.001621,172.31.33.0-255,66,117525,33,145082
14150,0.001628,172.217.194.0-255,6438,123963,33,145082
14151,0.00163,172.31.33.0-255,66,124029,33,145082
14152,0.001669,172.217.194.0-255,1484,125513,33,145082
14153,0.001674,172.217.194.0-255,2902,128415,33,145082
14154,0.001677,172.31.33.0-255,66,128481,33,145082
14155,0.001683,172.217.194.0-255,5738,134219,33,145082
14156,0.001685,172.31.33.0-255,66,134285,33,145082
14157,0.001728,172.31.33.0-255,66,134351,33,145082
14158,0.001768,172.31.33.0-255,66,134417,33,145082
14159,0.001771,172.217.194.0-255,1484,135901,33,145082
14160,0.001791,172.217.194.0-255,1484,137385,33,145082
14161,0.001794,172.31.33.0-255,66,137451,33,145082
14162,0.001833,172.31.33.0-255,66,137517,33,145082
14163,0.001844,172.31.33.0-255,66,137583,33,145082
14164,0.001846,172.217.194.0-255,97,137680,33,145082
14165,0.001894,172.217.194.0-255,105,137785,33,145082
14166,0.00428,172.31.33.0-255,66,137851,33,145082
14167,0.004316,172.31.33.0-255,105,137956,33,145082
14168,0.00647,172.217.194.0-255,66,138022,33,145082
14169,0.025866,172.31.33.0-255,190,138212,33,145082
14170,0.025896,172.31.33.0-255,1113,139325,33,145082
14171,0.02595,172.31.33.0-255,1514,140839,33,145082
14172,0.02597,172.31.33.0-255,1514,142353,33,145082
14173,0.025974,172.31.33.0-255,1514,143867,33,145082
14174,0.025988,172.31.33.0-255,951,144818,33,145082
14175,0.027487,104.244.42.0-255,66,144884,33,145082
14176,0.027517,104.244.42.0-255,66,144950,33,145082
14177,0.027544,104.244.42.0-255,66,145016,33,145082
14178,0.027564,104.244.42.0-255,66,145082,33,145082
