,TIME,SRC,PACKET_SIZE,CUMULATIVE_PACKET_SIZE,PAGE_NUMBER,TOTAL_PACKET_SIZE
0,0.0,172.217.194.0-255,153,153,92,123175
1,2.2e-05,172.31.47.0-255,66,219,92,123175
2,2.9e-05,172.217.194.0-255,1484,1703,92,123175
3,3.2e-05,172.31.47.0-255,66,1769,92,123175
4,3.6e-05,172.217.194.0-255,2902,4671,92,123175
5,3.8e-05,172.31.47.0-255,66,4737,92,123175
6,5.3e-05,172.217.194.0-255,2902,7639,92,123175
7,5.4e-05,172.31.47.0-255,66,7705,92,123175
8,7.1e-05,172.217.194.0-255,4320,12025,92,123175
9,7.3e-05,172.31.47.0-255,66,12091,92,123175
10,7.6e-05,172.217.194.0-255,1987,14078,92,123175
11,7.8e-05,172.31.47.0-255,66,14144,92,123175
12,0.000114,172.217.194.0-255,1484,15628,92,123175
13,0.000116,172.31.47.0-255,66,15694,92,123175
14,0.000133,172.217.194.0-255,2902,18596,92,123175
15,0.000135,172.31.47.0-255,66,18662,92,123175
16,0.00014,172.217.194.0-255,4320,22982,92,123175
17,0.000142,172.31.47.0-255,66,23048,92,123175
18,0.000153,172.217.194.0-255,1484,24532,92,123175
19,0.000155,172.31.47.0-255,66,24598,92,123175
20,0.000171,172.217.194.0-255,4320,28918,92,123175
21,0.000173,172.31.47.0-255,66,28984,92,123175
22,0.000184,172.217.194.0-255,2543,31527,92,123175
23,0.000186,172.31.47.0-255,66,31593,92,123175
24,0.000624,172.217.194.0-255,1484,33077,92,123175
25,0.000629,172.31.47.0-255,66,33143,92,123175
26,0.000638,172.217.194.0-255,2902,36045,92,123175
27,0.00064,172.31.47.0-255,66,36111,92,123175
28,0.000643,172.217.194.0-255,1484,37595,92,123175
29,0.000645,172.31.47.0-255,66,37661,92,123175
30,0.000669,172.217.194.0-255,4320,41981,92,123175
31,0.000671,172.31.47.0-255,66,42047,92,123175
32,0.000692,172.217.194.0-255,2902,44949,92,123175
33,0.000694,172.31.47.0-255,66,45015,92,123175
34,0.000714,172.31.47.0-255,66,45081,92,123175
35,0.000754,172.31.47.0-255,66,45147,92,123175
36,0.001041,172.217.194.0-255,648,45795,92,123175
37,0.001047,172.31.47.0-255,66,45861,92,123175
38,0.001114,172.217.194.0-255,1484,47345,92,123175
39,0.001118,172.31.47.0-255,66,47411,92,123175
40,0.001126,172.217.194.0-255,2902,50313,92,123175
41,0.001148,172.217.194.0-255,5738,56051,92,123175
42,0.001157,172.31.47.0-255,66,56117,92,123175
43,0.001191,172.217.194.0-255,6797,62914,92,123175
44,0.001203,172.31.47.0-255,66,62980,92,123175
45,0.001207,172.217.194.0-255,2902,65882,92,123175
46,0.001211,172.31.47.0-255,66,65948,92,123175
47,0.001228,172.217.194.0-255,4320,70268,92,123175
48,0.001232,172.217.194.0-255,4320,74588,92,123175
49,0.001239,172.31.47.0-255,66,74654,92,123175
50,0.001247,172.217.194.0-255,1484,76138,92,123175
51,0.001286,172.217.194.0-255,3961,80099,92,123175
52,0.0013,172.31.47.0-255,66,80165,92,123175
53,0.001948,172.217.194.0-255,1484,81649,92,123175
54,0.001952,172.31.47.0-255,66,81715,92,123175
55,0.00196,172.217.194.0-255,2902,84617,92,123175
56,0.001963,172.217.194.0-255,1484,86101,92,123175
57,0.001984,172.217.194.0-255,4320,90421,92,123175
58,0.001988,172.217.194.0-255,4320,94741,92,123175
59,0.002015,172.217.194.0-255,7156,101897,92,123175
60,0.002017,172.31.47.0-255,66,101963,92,123175
61,0.002028,172.31.47.0-255,66,102029,92,123175
62,0.002074,172.217.194.0-255,3602,105631,92,123175
63,0.0021,172.31.47.0-255,66,105697,92,123175
64,0.002311,172.217.194.0-255,1484,107181,92,123175
65,0.004374,172.217.194.0-255,4320,111501,92,123175
66,0.004379,172.31.47.0-255,66,111567,92,123175
67,0.006685,172.217.194.0-255,5738,117305,92,123175
68,0.006723,172.31.47.0-255,66,117371,92,123175
69,0.009042,172.217.194.0-255,5738,123109,92,123175
70,0.009049,172.31.47.0-255,66,123175,92,123175
71,0.0,74.125.130.0-255,153,153,92,145960
72,1.7e-05,172.31.47.0-255,66,219,92,145960
73,2.5e-05,74.125.130.0-255,1484,1703,92,145960
74,2.8e-05,172.31.47.0-255,66,1769,92,145960
75,3.4e-05,74.125.130.0-255,2902,4671,92,145960
76,4.5e-05,172.31.47.0-255,66,4737,92,145960
77,5.2e-05,74.125.130.0-255,4320,9057,92,145960
78,5.5e-05,172.31.47.0-255,66,9123,92,145960
79,5.9e-05,74.125.130.0-255,2902,12025,92,145960
80,6.2e-05,172.31.47.0-255,66,12091,92,145960
81,8.5e-05,74.125.130.0-255,2079,14170,92,145960
82,8.8e-05,172.31.47.0-255,66,14236,92,145960
83,0.000105,172.31.47.0-255,66,14302,92,145960
84,0.000111,74.125.130.0-255,4320,18622,92,145960
85,0.000113,172.31.47.0-255,66,18688,92,145960
86,0.000134,74.125.130.0-255,1125,19813,92,145960
87,0.000137,172.31.47.0-255,66,19879,92,145960
88,0.000203,74.125.130.0-255,1484,21363,92,145960
89,0.000206,172.31.47.0-255,66,21429,92,145960
90,0.000209,74.125.130.0-255,1484,22913,92,145960
91,0.000212,172.31.47.0-255,66,22979,92,145960
92,0.000231,74.125.130.0-255,1484,24463,92,145960
93,0.000234,172.31.47.0-255,66,24529,92,145960
94,0.000241,74.125.130.0-255,5738,30267,92,145960
95,0.000243,172.31.47.0-255,66,30333,92,145960
96,0.000248,74.125.130.0-255,4320,34653,92,145960
97,0.000251,172.31.47.0-255,66,34719,92,145960
98,0.00031,74.125.130.0-255,5379,40098,92,145960
99,0.000313,172.31.47.0-255,66,40164,92,145960
100,0.000324,172.31.47.0-255,66,40230,92,145960
101,0.000358,74.125.130.0-255,5685,45915,92,145960
102,0.00036,172.31.47.0-255,66,45981,92,145960
103,0.000363,74.125.130.0-255,379,46360,92,145960
104,0.000615,74.125.130.0-255,1484,47844,92,145960
105,0.000621,172.31.47.0-255,66,47910,92,145960
106,0.000626,74.125.130.0-255,1484,49394,92,145960
107,0.000652,74.125.130.0-255,1484,50878,92,145960
108,0.000655,172.31.47.0-255,66,50944,92,145960
109,0.000661,74.125.130.0-255,5738,56682,92,145960
110,0.000664,172.31.47.0-255,66,56748,92,145960
111,0.000674,74.125.130.0-255,5738,62486,92,145960
112,0.000676,172.31.47.0-255,66,62552,92,145960
113,0.000683,74.125.130.0-255,7156,69708,92,145960
114,0.000686,172.31.47.0-255,66,69774,92,145960
115,0.00074,172.31.47.0-255,66,69840,92,145960
116,0.001118,74.125.130.0-255,1484,71324,92,145960
117,0.001123,74.125.130.0-255,1484,72808,92,145960
118,0.001127,172.31.47.0-255,66,72874,92,145960
119,0.001131,74.125.130.0-255,1484,74358,92,145960
120,0.001151,74.125.130.0-255,1484,75842,92,145960
121,0.001157,74.125.130.0-255,4320,80162,92,145960
122,0.00116,172.31.47.0-255,66,80228,92,145960
123,0.001168,172.31.47.0-255,66,80294,92,145960
124,0.001171,74.125.130.0-255,1484,81778,92,145960
125,0.001208,172.31.47.0-255,66,81844,92,145960
126,0.001231,74.125.130.0-255,1484,83328,92,145960
127,0.001255,172.31.47.0-255,66,83394,92,145960
128,0.001748,74.125.130.0-255,1484,84878,92,145960
129,0.001754,74.125.130.0-255,2902,87780,92,145960
130,0.001758,172.31.47.0-255,66,87846,92,145960
131,0.001765,74.125.130.0-255,5738,93584,92,145960
132,0.001768,172.31.47.0-255,66,93650,92,145960
133,0.001807,172.31.47.0-255,66,93716,92,145960
134,0.001844,172.31.47.0-255,66,93782,92,145960
135,0.001849,74.125.130.0-255,2184,95966,92,145960
136,0.001851,172.31.47.0-255,66,96032,92,145960
137,0.002006,74.125.130.0-255,1484,97516,92,145960
138,0.002026,74.125.130.0-255,2902,100418,92,145960
139,0.002029,172.31.47.0-255,66,100484,92,145960
140,0.002036,74.125.130.0-255,4320,104804,92,145960
141,0.002039,172.31.47.0-255,66,104870,92,145960
142,0.002066,74.125.130.0-255,1484,106354,92,145960
143,0.002073,74.125.130.0-255,7156,113510,92,145960
144,0.002075,172.31.47.0-255,66,113576,92,145960
145,0.002086,172.31.47.0-255,66,113642,92,145960
146,0.002126,172.31.47.0-255,66,113708,92,145960
147,0.002531,74.125.130.0-255,1484,115192,92,145960
148,0.002538,74.125.130.0-255,2902,118094,92,145960
149,0.002542,172.31.47.0-255,66,118160,92,145960
150,0.002571,74.125.130.0-255,2902,121062,92,145960
151,0.002573,172.31.47.0-255,66,121128,92,145960
152,0.002579,74.125.130.0-255,4320,125448,92,145960
153,0.002581,172.31.47.0-255,66,125514,92,145960
154,0.002585,74.125.130.0-255,2902,128416,92,145960
155,0.002587,172.31.47.0-255,66,128482,92,145960
156,0.002616,74.125.130.0-255,5738,134220,92,145960
157,0.002619,172.31.47.0-255,66,134286,92,145960
158,0.002629,172.31.47.0-255,66,134352,92,145960
159,0.005212,74.125.130.0-255,5738,140090,92,145960
160,0.005218,172.31.47.0-255,66,140156,92,145960
161,0.007802,74.125.130.0-255,5738,145894,92,145960
162,0.007808,172.31.47.0-255,66,145960,92,145960
163,0.0,172.217.194.0-255,153,153,92,219690
164,2.3e-05,172.31.47.0-255,66,219,92,219690
165,2.9e-05,172.217.194.0-255,1484,1703,92,219690
166,3.3e-05,172.31.47.0-255,66,1769,92,219690
167,5.4e-05,172.217.194.0-255,2902,4671,92,219690
168,5.6e-05,172.31.47.0-255,66,4737,92,219690
169,6.6e-05,172.217.194.0-255,4320,9057,92,219690
170,6.8e-05,172.31.47.0-255,66,9123,92,219690
171,9.6e-05,172.217.194.0-255,2902,12025,92,219690
172,9.8e-05,172.31.47.0-255,66,12091,92,219690
173,0.000102,172.217.194.0-255,2164,14255,92,219690
174,0.000104,172.31.47.0-255,66,14321,92,219690
175,0.000134,172.31.47.0-255,66,14387,92,219690
176,0.000181,172.217.194.0-255,5379,19766,92,219690
177,0.000184,172.31.47.0-255,66,19832,92,219690
178,0.000263,172.217.194.0-255,1484,21316,92,219690
179,0.000267,172.31.47.0-255,66,21382,92,219690
180,0.000292,172.217.194.0-255,2902,24284,92,219690
181,0.000295,172.31.47.0-255,66,24350,92,219690
182,0.0003,172.217.194.0-255,5738,30088,92,219690
183,0.000302,172.31.47.0-255,66,30154,92,219690
184,0.000329,172.217.194.0-255,6797,36951,92,219690
185,0.000332,172.31.47.0-255,66,37017,92,219690
186,0.000354,172.217.194.0-255,7156,44173,92,219690
187,0.000358,172.31.47.0-255,66,44239,92,219690
188,0.000396,172.31.47.0-255,66,44305,92,219690
189,0.000398,172.217.194.0-255,434,44739,92,219690
190,0.0004,172.31.47.0-255,66,44805,92,219690
191,0.000641,172.217.194.0-255,1484,46289,92,219690
192,0.000644,172.31.47.0-255,66,46355,92,219690
193,0.000649,172.217.194.0-255,2902,49257,92,219690
194,0.000651,172.31.47.0-255,66,49323,92,219690
195,0.000682,172.217.194.0-255,5738,55061,92,219690
196,0.000685,172.31.47.0-255,66,55127,92,219690
197,0.000691,172.217.194.0-255,7156,62283,92,219690
198,0.000693,172.31.47.0-255,66,62349,92,219690
199,0.000733,172.31.47.0-255,66,62415,92,219690
200,0.000737,172.217.194.0-255,2184,64599,92,219690
201,0.000739,172.31.47.0-255,66,64665,92,219690
202,0.000766,172.217.194.0-255,2902,67567,92,219690
203,0.000772,172.31.47.0-255,66,67633,92,219690
204,0.000777,172.217.194.0-255,4320,71953,92,219690
205,0.000779,172.31.47.0-255,66,72019,92,219690
206,0.000814,172.31.47.0-255,66,72085,92,219690
207,0.000837,172.217.194.0-255,2902,74987,92,219690
208,0.00084,172.31.47.0-255,66,75053,92,219690
209,0.00087,172.31.47.0-255,66,75119,92,219690
210,0.000891,172.217.194.0-255,1484,76603,92,219690
211,0.000896,172.217.194.0-255,2902,79505,92,219690
212,0.000898,172.31.47.0-255,66,79571,92,219690
213,0.000928,172.217.194.0-255,5738,85309,92,219690
214,0.000931,172.31.47.0-255,66,85375,92,219690
215,0.000943,172.31.47.0-255,66,85441,92,219690
216,0.000993,172.217.194.0-255,7156,92597,92,219690
217,0.000997,172.31.47.0-255,66,92663,92,219690
218,0.001015,172.217.194.0-255,6438,99101,92,219690
219,0.001018,172.31.47.0-255,66,99167,92,219690
220,0.00106,172.217.194.0-255,1484,100651,92,219690
221,0.001064,172.217.194.0-255,1484,102135,92,219690
222,0.001066,172.31.47.0-255,66,102201,92,219690
223,0.001092,172.217.194.0-255,1484,103685,92,219690
224,0.001099,172.217.194.0-255,5738,109423,92,219690
225,0.001101,172.31.47.0-255,66,109489,92,219690
226,0.001141,172.31.47.0-255,66,109555,92,219690
227,0.001175,172.217.194.0-255,4320,113875,92,219690
228,0.001179,172.31.47.0-255,66,113941,92,219690
229,0.001185,172.31.47.0-255,66,114007,92,219690
230,0.00122,172.217.194.0-255,1484,115491,92,219690
231,0.001225,172.217.194.0-255,2902,118393,92,219690
232,0.001227,172.31.47.0-255,66,118459,92,219690
233,0.00123,172.217.194.0-255,1484,119943,92,219690
234,0.001249,172.217.194.0-255,4320,124263,92,219690
235,0.001251,172.31.47.0-255,66,124329,92,219690
236,0.001292,172.31.47.0-255,66,124395,92,219690
237,0.001303,172.31.47.0-255,66,124461,92,219690
238,0.001327,172.217.194.0-255,2184,126645,92,219690
239,0.001335,172.31.47.0-255,66,126711,92,219690
240,0.001356,172.217.194.0-255,1484,128195,92,219690
241,0.001374,172.217.194.0-255,2902,131097,92,219690
242,0.001378,172.31.47.0-255,66,131163,92,219690
243,0.001382,172.217.194.0-255,2902,134065,92,219690
244,0.001386,172.31.47.0-255,66,134131,92,219690
245,0.001398,172.217.194.0-255,2902,137033,92,219690
246,0.001401,172.31.47.0-255,66,137099,92,219690
247,0.001448,172.31.47.0-255,66,137165,92,219690
248,0.001456,172.217.194.0-255,7156,144321,92,219690
249,0.001458,172.31.47.0-255,66,144387,92,219690
250,0.001488,172.217.194.0-255,2902,147289,92,219690
251,0.001492,172.31.47.0-255,66,147355,92,219690
252,0.00152,172.217.194.0-255,3602,150957,92,219690
253,0.001524,172.31.47.0-255,66,151023,92,219690
254,0.001552,172.217.194.0-255,1484,152507,92,219690
255,0.001555,172.217.194.0-255,1484,153991,92,219690
256,0.001558,172.31.47.0-255,66,154057,92,219690
257,0.001585,172.217.194.0-255,1484,155541,92,219690
258,0.001592,172.217.194.0-255,5738,161279,92,219690
259,0.001595,172.31.47.0-255,66,161345,92,219690
260,0.001621,172.217.194.0-255,4320,165665,92,219690
261,0.001625,172.31.47.0-255,66,165731,92,219690
262,0.001656,172.217.194.0-255,5738,171469,92,219690
263,0.00166,172.31.47.0-255,66,171535,92,219690
264,0.001676,172.217.194.0-255,7156,178691,92,219690
265,0.001684,172.31.47.0-255,66,178757,92,219690
266,0.001715,172.217.194.0-255,6438,185195,92,219690
267,0.001718,172.217.194.0-255,1484,186679,92,219690
268,0.001719,172.31.47.0-255,66,186745,92,219690
269,0.001728,172.217.194.0-255,2902,189647,92,219690
270,0.001731,172.31.47.0-255,66,189713,92,219690
271,0.001742,172.217.194.0-255,5738,195451,92,219690
272,0.001745,172.31.47.0-255,66,195517,92,219690
273,0.001753,172.217.194.0-255,7156,202673,92,219690
274,0.001755,172.31.47.0-255,66,202739,92,219690
275,0.001788,172.217.194.0-255,5738,208477,92,219690
276,0.001792,172.31.47.0-255,66,208543,92,219690
277,0.001817,172.31.47.0-255,66,208609,92,219690
278,0.001849,172.217.194.0-255,2184,210793,92,219690
279,0.001852,172.31.47.0-255,66,210859,92,219690
280,0.001865,172.31.47.0-255,66,210925,92,219690
281,0.001877,172.31.47.0-255,66,210991,92,219690
282,0.001905,172.217.194.0-255,2902,213893,92,219690
283,0.001908,172.31.47.0-255,66,213959,92,219690
284,0.001957,172.31.47.0-255,66,214025,92,219690
285,0.00198,172.31.47.0-255,66,214091,92,219690
286,0.001987,172.217.194.0-255,5020,219111,92,219690
287,0.001989,172.31.47.0-255,66,219177,92,219690
288,0.002074,172.31.47.0-255,66,219243,92,219690
289,0.002077,172.217.194.0-255,105,219348,92,219690
290,0.003476,172.31.47.0-255,66,219414,92,219690
291,0.003503,172.31.47.0-255,105,219519,92,219690
292,0.005768,172.217.194.0-255,66,219585,92,219690
293,0.009368,172.31.47.0-255,105,219690,92,219690
294,0.0,74.125.24.0-255,153,153,92,114202
295,3.1e-05,172.31.47.0-255,66,219,92,114202
296,3.8e-05,74.125.24.0-255,1484,1703,92,114202
297,4.2e-05,172.31.47.0-255,66,1769,92,114202
298,4.6e-05,74.125.24.0-255,2902,4671,92,114202
299,4.9e-05,172.31.47.0-255,66,4737,92,114202
300,6.1e-05,74.125.24.0-255,4320,9057,92,114202
301,6.3e-05,172.31.47.0-255,66,9123,92,114202
302,7.3e-05,172.31.47.0-255,66,9189,92,114202
303,0.000106,172.31.47.0-255,66,9255,92,114202
304,0.000156,74.125.24.0-255,1484,10739,92,114202
305,0.000159,172.31.47.0-255,66,10805,92,114202
306,0.000162,74.125.24.0-255,1484,12289,92,114202
307,0.000164,172.31.47.0-255,66,12355,92,114202
308,0.000186,74.125.24.0-255,1484,13839,92,114202
309,0.000188,172.31.47.0-255,66,13905,92,114202
310,0.000198,74.125.24.0-255,5738,19643,92,114202
311,0.000201,172.31.47.0-255,66,19709,92,114202
312,0.000207,74.125.24.0-255,6797,26506,92,114202
313,0.000209,172.31.47.0-255,66,26572,92,114202
314,0.000517,74.125.24.0-255,1484,28056,92,114202
315,0.000521,172.31.47.0-255,66,28122,92,114202
316,0.000546,74.125.24.0-255,2902,31024,92,114202
317,0.000549,172.31.47.0-255,66,31090,92,114202
318,0.000554,74.125.24.0-255,5738,36828,92,114202
319,0.000556,172.31.47.0-255,66,36894,92,114202
320,0.000594,74.125.24.0-255,5738,42632,92,114202
321,0.000597,172.31.47.0-255,66,42698,92,114202
322,0.000613,74.125.24.0-255,1705,44403,92,114202
323,0.000616,172.31.47.0-255,66,44469,92,114202
324,0.000707,74.125.24.0-255,1484,45953,92,114202
325,0.000711,172.31.47.0-255,66,46019,92,114202
326,0.000718,74.125.24.0-255,2902,48921,92,114202
327,0.00072,172.31.47.0-255,66,48987,92,114202
328,0.000749,74.125.24.0-255,5738,54725,92,114202
329,0.000752,172.31.47.0-255,66,54791,92,114202
330,0.000757,74.125.24.0-255,4320,59111,92,114202
331,0.000759,172.31.47.0-255,66,59177,92,114202
332,0.000761,74.125.24.0-255,1484,60661,92,114202
333,0.000792,74.125.24.0-255,2902,63563,92,114202
334,0.000793,172.31.47.0-255,66,63629,92,114202
335,0.000798,172.31.47.0-255,66,63695,92,114202
336,0.000811,74.125.24.0-255,3961,67656,92,114202
337,0.000818,172.31.47.0-255,66,67722,92,114202
338,0.001146,74.125.24.0-255,1484,69206,92,114202
339,0.00115,172.31.47.0-255,66,69272,92,114202
340,0.001159,74.125.24.0-255,2902,72174,92,114202
341,0.001161,172.31.47.0-255,66,72240,92,114202
342,0.001173,74.125.24.0-255,5738,77978,92,114202
343,0.001217,74.125.24.0-255,7156,85134,92,114202
344,0.001252,74.125.24.0-255,3602,88736,92,114202
345,0.002406,74.125.24.0-255,1484,90220,92,114202
346,0.002413,74.125.24.0-255,2902,93122,92,114202
347,0.002419,74.125.24.0-255,5738,98860,92,114202
348,0.002433,74.125.24.0-255,1484,100344,92,114202
349,0.002485,74.125.24.0-255,2184,102528,92,114202
350,0.004531,172.31.47.0-255,66,102594,92,114202
351,0.007105,74.125.24.0-255,5738,108332,92,114202
352,0.007111,172.31.47.0-255,66,108398,92,114202
353,0.009707,74.125.24.0-255,5738,114136,92,114202
354,0.009714,172.31.47.0-255,66,114202,92,114202
355,0.0,172.217.194.0-255,152,152,92,272391
356,1.8e-05,172.31.47.0-255,66,218,92,272391
357,2.4e-05,172.217.194.0-255,1484,1702,92,272391
358,2.8e-05,172.31.47.0-255,66,1768,92,272391
359,3.3e-05,172.217.194.0-255,2902,4670,92,272391
360,3.6e-05,172.31.47.0-255,66,4736,92,272391
361,4.1e-05,172.217.194.0-255,4320,9056,92,272391
362,4.3e-05,172.31.47.0-255,66,9122,92,272391
363,4.8e-05,172.217.194.0-255,4320,13442,92,272391
364,5e-05,172.31.47.0-255,66,13508,92,272391
365,7e-05,172.217.194.0-255,627,14135,92,272391
366,7.3e-05,172.31.47.0-255,66,14201,92,272391
367,7.6e-05,172.217.194.0-255,1484,15685,92,272391
368,7.8e-05,172.31.47.0-255,66,15751,92,272391
369,0.0001,172.31.47.0-255,66,15817,92,272391
370,0.000105,172.217.194.0-255,5738,21555,92,272391
371,0.000107,172.31.47.0-255,66,21621,92,272391
372,0.000136,172.217.194.0-255,7156,28777,92,272391
373,0.000138,172.31.47.0-255,66,28843,92,272391
374,0.000144,172.217.194.0-255,7156,35999,92,272391
375,0.000146,172.31.47.0-255,66,36065,92,272391
376,0.000156,172.217.194.0-255,2184,38249,92,272391
377,0.000158,172.31.47.0-255,66,38315,92,272391
378,0.000173,172.217.194.0-255,4320,42635,92,272391
379,0.000175,172.31.47.0-255,66,42701,92,272391
380,0.000192,172.217.194.0-255,5738,48439,92,272391
381,0.000194,172.31.47.0-255,66,48505,92,272391
382,0.0002,172.217.194.0-255,7085,55590,92,272391
383,0.000202,172.31.47.0-255,66,55656,92,272391
384,0.00078,172.217.194.0-255,99,55755,92,272391
385,0.000785,172.31.47.0-255,66,55821,92,272391
386,0.000845,172.217.194.0-255,1484,57305,92,272391
387,0.000858,172.217.194.0-255,2902,60207,92,272391
388,0.000861,172.31.47.0-255,66,60273,92,272391
389,0.000879,172.217.194.0-255,4320,64593,92,272391
390,0.000881,172.31.47.0-255,66,64659,92,272391
391,0.0009,172.217.194.0-255,1484,66143,92,272391
392,0.000903,172.217.194.0-255,2902,69045,92,272391
393,0.000905,172.31.47.0-255,66,69111,92,272391
394,0.000923,172.217.194.0-255,3961,73072,92,272391
395,0.000925,172.31.47.0-255,66,73138,92,272391
396,0.00094,172.217.194.0-255,2902,76040,92,272391
397,0.000942,172.31.47.0-255,66,76106,92,272391
398,0.000975,172.31.47.0-255,66,76172,92,272391
399,0.000989,172.217.194.0-255,2543,78715,92,272391
400,0.00099,172.31.47.0-255,66,78781,92,272391
401,0.001336,172.217.194.0-255,1484,80265,92,272391
402,0.001344,172.217.194.0-255,2902,83167,92,272391
403,0.001348,172.31.47.0-255,66,83233,92,272391
404,0.001355,172.217.194.0-255,5738,88971,92,272391
405,0.001356,172.31.47.0-255,66,89037,92,272391
406,0.001362,172.217.194.0-255,7156,96193,92,272391
407,0.001364,172.31.47.0-255,66,96259,92,272391
408,0.001411,172.31.47.0-255,66,96325,92,272391
409,0.001429,172.217.194.0-255,5738,102063,92,272391
410,0.001432,172.31.47.0-255,66,102129,92,272391
411,0.001455,172.217.194.0-255,2184,104313,92,272391
412,0.001458,172.31.47.0-255,66,104379,92,272391
413,0.001657,172.217.194.0-255,1484,105863,92,272391
414,0.001665,172.217.194.0-255,2902,108765,92,272391
415,0.001669,172.31.47.0-255,66,108831,92,272391
416,0.001676,172.217.194.0-255,5738,114569,92,272391
417,0.001678,172.31.47.0-255,66,114635,92,272391
418,0.001707,172.31.47.0-255,66,114701,92,272391
419,0.001739,172.31.47.0-255,66,114767,92,272391
420,0.001757,172.217.194.0-255,2184,116951,92,272391
421,0.001759,172.31.47.0-255,66,117017,92,272391
422,0.002036,172.217.194.0-255,1484,118501,92,272391
423,0.002044,172.217.194.0-255,2902,121403,92,272391
424,0.002049,172.31.47.0-255,66,121469,92,272391
425,0.002072,172.217.194.0-255,5738,127207,92,272391
426,0.002074,172.31.47.0-255,66,127273,92,272391
427,0.002079,172.217.194.0-255,4320,131593,92,272391
428,0.002082,172.31.47.0-255,66,131659,92,272391
429,0.002099,172.217.194.0-255,4320,135979,92,272391
430,0.002102,172.31.47.0-255,66,136045,92,272391
431,0.002139,172.217.194.0-255,4320,140365,92,272391
432,0.002142,172.31.47.0-255,66,140431,92,272391
433,0.00217,172.31.47.0-255,66,140497,92,272391
434,0.002195,172.217.194.0-255,7156,147653,92,272391
435,0.002198,172.31.47.0-255,66,147719,92,272391
436,0.002205,172.217.194.0-255,7156,154875,92,272391
437,0.002208,172.31.47.0-255,66,154941,92,272391
438,0.00222,172.217.194.0-255,1484,156425,92,272391
439,0.002226,172.217.194.0-255,4320,160745,92,272391
440,0.002228,172.31.47.0-255,66,160811,92,272391
441,0.002266,172.31.47.0-255,66,160877,92,272391
442,0.002268,172.217.194.0-255,766,161643,92,272391
443,0.002312,172.217.194.0-255,1484,163127,92,272391
444,0.002314,172.31.47.0-255,66,163193,92,272391
445,0.002318,172.217.194.0-255,2902,166095,92,272391
446,0.00232,172.31.47.0-255,66,166161,92,272391
447,0.002332,172.217.194.0-255,1484,167645,92,272391
448,0.00235,172.217.194.0-255,4320,171965,92,272391
449,0.002352,172.31.47.0-255,66,172031,92,272391
450,0.002357,172.217.194.0-255,2902,174933,92,272391
451,0.002359,172.31.47.0-255,66,174999,92,272391
452,0.002363,172.217.194.0-255,2902,177901,92,272391
453,0.00237,172.31.47.0-255,66,177967,92,272391
454,0.002373,172.217.194.0-255,1484,179451,92,272391
455,0.002393,172.217.194.0-255,1484,180935,92,272391
456,0.002395,172.31.47.0-255,66,181001,92,272391
457,0.002425,172.31.47.0-255,66,181067,92,272391
458,0.002428,172.217.194.0-255,1484,182551,92,272391
459,0.002431,172.217.194.0-255,766,183317,92,272391
460,0.002433,172.31.47.0-255,66,183383,92,272391
461,0.002525,172.217.194.0-255,1484,184867,92,272391
462,0.002537,172.217.194.0-255,2902,187769,92,272391
463,0.00254,172.31.47.0-255,66,187835,92,272391
464,0.002563,172.217.194.0-255,5738,193573,92,272391
465,0.002566,172.31.47.0-255,66,193639,92,272391
466,0.002569,172.217.194.0-255,1484,195123,92,272391
467,0.002596,172.31.47.0-255,66,195189,92,272391
468,0.002599,172.217.194.0-255,1484,196673,92,272391
469,0.002656,172.217.194.0-255,7156,203829,92,272391
470,0.002659,172.31.47.0-255,66,203895,92,272391
471,0.002674,172.217.194.0-255,1484,205379,92,272391
472,0.002676,172.217.194.0-255,766,206145,92,272391
473,0.002679,172.31.47.0-255,66,206211,92,272391
474,0.002681,172.217.194.0-255,1484,207695,92,272391
475,0.002685,172.217.194.0-255,1484,209179,92,272391
476,0.002687,172.31.47.0-255,66,209245,92,272391
477,0.002713,172.217.194.0-255,2902,212147,92,272391
478,0.002715,172.31.47.0-255,66,212213,92,272391
479,0.002721,172.217.194.0-255,4320,216533,92,272391
480,0.002723,172.31.47.0-255,66,216599,92,272391
481,0.002729,172.217.194.0-255,5738,222337,92,272391
482,0.002732,172.31.47.0-255,66,222403,92,272391
483,0.002755,172.217.194.0-255,4320,226723,92,272391
484,0.002757,172.31.47.0-255,66,226789,92,272391
485,0.002764,172.217.194.0-255,7156,233945,92,272391
486,0.002766,172.31.47.0-255,66,234011,92,272391
487,0.002789,172.217.194.0-255,6438,240449,92,272391
488,0.002791,172.31.47.0-255,66,240515,92,272391
489,0.002804,172.31.47.0-255,66,240581,92,272391
490,0.002823,172.217.194.0-255,2902,243483,92,272391
491,0.002826,172.31.47.0-255,66,243549,92,272391
492,0.002833,172.217.194.0-255,7156,250705,92,272391
493,0.002835,172.31.47.0-255,66,250771,92,272391
494,0.002865,172.217.194.0-255,2902,253673,92,272391
495,0.002867,172.31.47.0-255,66,253739,92,272391
496,0.002898,172.31.47.0-255,66,253805,92,272391
497,0.002902,172.217.194.0-255,2902,256707,92,272391
498,0.002905,172.31.47.0-255,66,256773,92,272391
499,0.002928,172.31.47.0-255,66,256839,92,272391
500,0.002948,172.217.194.0-255,7156,263995,92,272391
501,0.00295,172.31.47.0-255,66,264061,92,272391
502,0.002957,172.217.194.0-255,6438,270499,92,272391
503,0.002959,172.31.47.0-255,66,270565,92,272391
504,0.002962,172.217.194.0-255,1484,272049,92,272391
505,0.003001,172.31.47.0-255,66,272115,92,272391
506,0.003018,172.217.194.0-255,105,272220,92,272391
507,0.00948,172.31.47.0-255,66,272286,92,272391
508,0.009517,172.31.47.0-255,105,272391,92,272391
509,0.0,172.31.47.0-255,66,66,92,66
510,0.0,74.125.24.0-255,146,146,92,150182
511,7.9e-05,172.31.47.0-255,66,212,92,150182
512,8.7e-05,74.125.24.0-255,1484,1696,92,150182
513,9.1e-05,172.31.47.0-255,66,1762,92,150182
514,9.5e-05,74.125.24.0-255,2902,4664,92,150182
515,9.8e-05,172.31.47.0-255,66,4730,92,150182
516,0.000111,74.125.24.0-255,7156,11886,92,150182
517,0.000114,172.31.47.0-255,66,11952,92,150182
518,0.000123,172.31.47.0-255,66,12018,92,150182
519,0.000135,172.31.47.0-255,66,12084,92,150182
520,0.000163,74.125.24.0-255,1484,13568,92,150182
521,0.000166,172.31.47.0-255,66,13634,92,150182
522,0.00017,74.125.24.0-255,2902,16536,92,150182
523,0.000172,172.31.47.0-255,66,16602,92,150182
524,0.000177,74.125.24.0-255,2902,19504,92,150182
525,0.000179,172.31.47.0-255,66,19570,92,150182
526,0.000224,74.125.24.0-255,2902,22472,92,150182
527,0.000227,172.31.47.0-255,66,22538,92,150182
528,0.000237,172.31.47.0-255,66,22604,92,150182
529,0.000254,172.31.47.0-255,66,22670,92,150182
530,0.000287,74.125.24.0-255,7107,29777,92,150182
531,0.00029,172.31.47.0-255,66,29843,92,150182
532,0.000292,74.125.24.0-255,112,29955,92,150182
533,0.000294,172.31.47.0-255,66,30021,92,150182
534,0.000296,74.125.24.0-255,330,30351,92,150182
535,0.000299,172.31.47.0-255,66,30417,92,150182
536,0.00065,74.125.24.0-255,1484,31901,92,150182
537,0.000655,172.31.47.0-255,66,31967,92,150182
538,0.000661,74.125.24.0-255,2902,34869,92,150182
539,0.000663,172.31.47.0-255,66,34935,92,150182
540,0.000666,74.125.24.0-255,1484,36419,92,150182
541,0.000701,74.125.24.0-255,4320,40739,92,150182
542,0.000715,74.125.24.0-255,2902,43641,92,150182
543,0.00072,172.31.47.0-255,66,43707,92,150182
544,0.000726,172.31.47.0-255,66,43773,92,150182
545,0.000752,172.31.47.0-255,66,43839,92,150182
546,0.001024,74.125.24.0-255,1484,45323,92,150182
547,0.001029,74.125.24.0-255,2902,48225,92,150182
548,0.001033,172.31.47.0-255,66,48291,92,150182
549,0.001062,74.125.24.0-255,5738,54029,92,150182
550,0.001068,172.31.47.0-255,66,54095,92,150182
551,0.001086,172.31.47.0-255,66,54161,92,150182
552,0.001124,74.125.24.0-255,7156,61317,92,150182
553,0.001134,172.31.47.0-255,66,61383,92,150182
554,0.00114,74.125.24.0-255,6438,67821,92,150182
555,0.00115,172.31.47.0-255,66,67887,92,150182
556,0.001286,74.125.24.0-255,1484,69371,92,150182
557,0.001292,74.125.24.0-255,2902,72273,92,150182
558,0.001295,172.31.47.0-255,66,72339,92,150182
559,0.00136,74.125.24.0-255,5738,78077,92,150182
560,0.001368,172.31.47.0-255,66,78143,92,150182
561,0.001382,172.31.47.0-255,66,78209,92,150182
562,0.001402,74.125.24.0-255,1484,79693,92,150182
563,0.001406,74.125.24.0-255,2902,82595,92,150182
564,0.001408,172.31.47.0-255,66,82661,92,150182
565,0.001441,74.125.24.0-255,5738,88399,92,150182
566,0.001449,172.31.47.0-255,66,88465,92,150182
567,0.00146,172.31.47.0-255,66,88531,92,150182
568,0.001476,74.125.24.0-255,1484,90015,92,150182
569,0.001493,172.31.47.0-255,66,90081,92,150182
570,0.0015,74.125.24.0-255,2902,92983,92,150182
571,0.001525,172.31.47.0-255,66,93049,92,150182
572,0.00157,172.31.47.0-255,66,93115,92,150182
573,0.001582,172.31.47.0-255,66,93181,92,150182
574,0.001594,74.125.24.0-255,2902,96083,92,150182
575,0.001601,172.31.47.0-255,66,96149,92,150182
576,0.001642,74.125.24.0-255,3602,99751,92,150182
577,0.001646,172.31.47.0-255,66,99817,92,150182
578,0.001675,172.31.47.0-255,66,99883,92,150182
579,0.001713,172.31.47.0-255,66,99949,92,150182
580,0.001726,172.31.47.0-255,66,100015,92,150182
581,0.00174,74.125.24.0-255,2184,102199,92,150182
582,0.001747,172.31.47.0-255,66,102265,92,150182
583,0.001761,172.31.47.0-255,66,102331,92,150182
584,0.001765,172.31.47.0-255,66,102397,92,150182
585,0.001832,172.31.47.0-255,66,102463,92,150182
586,0.001856,74.125.24.0-255,1484,103947,92,150182
587,0.001873,74.125.24.0-255,2902,106849,92,150182
588,0.00188,172.31.47.0-255,66,106915,92,150182
589,0.001891,74.125.24.0-255,5738,112653,92,150182
590,0.001898,172.31.47.0-255,66,112719,92,150182
591,0.001933,172.31.47.0-255,66,112785,92,150182
592,0.001982,74.125.24.0-255,5738,118523,92,150182
593,0.001991,172.31.47.0-255,66,118589,92,150182
594,0.001999,74.125.24.0-255,5020,123609,92,150182
595,0.002006,172.31.47.0-255,66,123675,92,150182
596,0.002403,74.125.24.0-255,1484,125159,92,150182
597,0.002408,74.125.24.0-255,1484,126643,92,150182
598,0.002411,172.31.47.0-255,66,126709,92,150182
599,0.002434,74.125.24.0-255,1484,128193,92,150182
600,0.00244,74.125.24.0-255,5738,133931,92,150182
601,0.002447,172.31.47.0-255,66,133997,92,150182
602,0.002472,172.31.47.0-255,66,134063,92,150182
603,0.002512,172.31.47.0-255,66,134129,92,150182
604,0.002518,74.125.24.0-255,2184,136313,92,150182
605,0.002524,172.31.47.0-255,66,136379,92,150182
606,0.002543,74.125.24.0-255,1484,137863,92,150182
607,0.002555,74.125.24.0-255,2902,140765,92,150182
608,0.002561,172.31.47.0-255,66,140831,92,150182
609,0.002569,74.125.24.0-255,2902,143733,92,150182
610,0.00258,172.31.47.0-255,66,143799,92,150182
611,0.002586,74.125.24.0-255,2902,146701,92,150182
612,0.002588,74.125.24.0-255,1484,148185,92,150182
613,0.002593,172.31.47.0-255,66,148251,92,150182
614,0.002615,172.31.47.0-255,66,148317,92,150182
615,0.002636,74.125.24.0-255,1426,149743,92,150182
616,0.002638,74.125.24.0-255,97,149840,92,150182
617,0.003334,172.31.47.0-255,66,149906,92,150182
618,0.005141,74.125.24.0-255,105,150011,92,150182
619,0.008278,172.31.47.0-255,66,150077,92,150182
620,0.008307,172.31.47.0-255,105,150182,92,150182
621,0.0,172.217.194.0-255,152,152,92,77762
622,2.1e-05,172.31.47.0-255,66,218,92,77762
623,2.8e-05,172.217.194.0-255,1484,1702,92,77762
624,3.1e-05,172.31.47.0-255,66,1768,92,77762
625,3.7e-05,172.217.194.0-255,2902,4670,92,77762
626,4e-05,172.31.47.0-255,66,4736,92,77762
627,6.8e-05,172.217.194.0-255,5738,10474,92,77762
628,7e-05,172.31.47.0-255,66,10540,92,77762
629,7.3e-05,172.217.194.0-255,1484,12024,92,77762
630,7.5e-05,172.31.47.0-255,66,12090,92,77762
631,9.3e-05,172.217.194.0-255,2201,14291,92,77762
632,9.5e-05,172.31.47.0-255,66,14357,92,77762
633,0.0001,172.217.194.0-255,4320,18677,92,77762
634,0.000102,172.31.47.0-255,66,18743,92,77762
635,0.000124,172.217.194.0-255,5738,24481,92,77762
636,0.000127,172.31.47.0-255,66,24547,92,77762
637,0.000155,172.217.194.0-255,4320,28867,92,77762
638,0.000158,172.31.47.0-255,66,28933,92,77762
639,0.000163,172.217.194.0-255,5738,34671,92,77762
640,0.000165,172.31.47.0-255,66,34737,92,77762
641,0.000192,172.217.194.0-255,7156,41893,92,77762
642,0.000195,172.31.47.0-255,66,41959,92,77762
643,0.00021,172.217.194.0-255,2902,44861,92,77762
644,0.000212,172.31.47.0-255,66,44927,92,77762
645,0.000228,172.217.194.0-255,2902,47829,92,77762
646,0.00023,172.31.47.0-255,66,47895,92,77762
647,0.00025,172.217.194.0-255,766,48661,92,77762
648,0.000252,172.31.47.0-255,66,48727,92,77762
649,0.001541,172.217.194.0-255,1484,50211,92,77762
650,0.001547,172.31.47.0-255,66,50277,92,77762
651,0.001555,172.217.194.0-255,2902,53179,92,77762
652,0.001557,172.31.47.0-255,66,53245,92,77762
653,0.001579,172.217.194.0-255,4320,57565,92,77762
654,0.001604,172.217.194.0-255,5738,63303,92,77762
655,0.001622,172.217.194.0-255,2851,66154,92,77762
656,0.00538,172.31.47.0-255,66,66220,92,77762
657,0.007454,172.217.194.0-255,5738,71958,92,77762
658,0.007463,172.31.47.0-255,66,72024,92,77762
659,0.009542,172.217.194.0-255,5738,77762,92,77762
660,0.0,74.125.24.0-255,153,153,92,177029
661,3.4e-05,172.31.47.0-255,66,219,92,177029
662,4.1e-05,74.125.24.0-255,1484,1703,92,177029
663,4.6e-05,172.31.47.0-255,66,1769,92,177029
664,5.1e-05,74.125.24.0-255,2902,4671,92,177029
665,5.4e-05,172.31.47.0-255,66,4737,92,177029
666,6e-05,74.125.24.0-255,5738,10475,92,177029
667,6.3e-05,172.31.47.0-255,66,10541,92,177029
668,0.000101,172.31.47.0-255,66,10607,92,177029
669,0.000107,74.125.24.0-255,6797,17404,92,177029
670,0.000109,172.31.47.0-255,66,17470,92,177029
671,0.00021,74.125.24.0-255,1484,18954,92,177029
672,0.000214,172.31.47.0-255,66,19020,92,177029
673,0.000227,74.125.24.0-255,2902,21922,92,177029
674,0.000229,172.31.47.0-255,66,21988,92,177029
675,0.000252,74.125.24.0-255,2902,24890,92,177029
676,0.000255,172.31.47.0-255,66,24956,92,177029
677,0.000262,74.125.24.0-255,7156,32112,92,177029
678,0.000265,172.31.47.0-255,66,32178,92,177029
679,0.000287,74.125.24.0-255,2902,35080,92,177029
680,0.000291,172.31.47.0-255,66,35146,92,177029
681,0.000322,172.31.47.0-255,66,35212,92,177029
682,0.000326,74.125.24.0-255,2813,38025,92,177029
683,0.000329,172.31.47.0-255,66,38091,92,177029
684,0.000437,74.125.24.0-255,134,38225,92,177029
685,0.000441,172.31.47.0-255,66,38291,92,177029
686,0.00057,74.125.24.0-255,1484,39775,92,177029
687,0.000574,172.31.47.0-255,66,39841,92,177029
688,0.000579,74.125.24.0-255,2902,42743,92,177029
689,0.000582,172.31.47.0-255,66,42809,92,177029
690,0.000609,74.125.24.0-255,5738,48547,92,177029
691,0.000612,172.31.47.0-255,66,48613,92,177029
692,0.000616,74.125.24.0-255,1484,50097,92,177029
693,0.000636,74.125.24.0-255,5379,55476,92,177029
694,0.000639,172.31.47.0-255,66,55542,92,177029
695,0.000665,172.31.47.0-255,66,55608,92,177029
696,0.000685,74.125.24.0-255,2902,58510,92,177029
697,0.000687,172.31.47.0-255,66,58576,92,177029
698,0.000691,74.125.24.0-255,2543,61119,92,177029
699,0.000693,172.31.47.0-255,66,61185,92,177029
700,0.000725,74.125.24.0-255,1484,62669,92,177029
701,0.000739,74.125.24.0-255,2902,65571,92,177029
702,0.000743,172.31.47.0-255,66,65637,92,177029
703,0.00075,74.125.24.0-255,5738,71375,92,177029
704,0.000752,172.31.47.0-255,66,71441,92,177029
705,0.000755,74.125.24.0-255,1484,72925,92,177029
706,0.000791,74.125.24.0-255,5738,78663,92,177029
707,0.000795,172.31.47.0-255,66,78729,92,177029
708,0.00081,74.125.24.0-255,5738,84467,92,177029
709,0.000813,172.31.47.0-255,66,84533,92,177029
710,0.000824,74.125.24.0-255,4320,88853,92,177029
711,0.000826,172.31.47.0-255,66,88919,92,177029
712,0.000852,74.125.24.0-255,6438,95357,92,177029
713,0.000855,172.31.47.0-255,66,95423,92,177029
714,0.000885,172.31.47.0-255,66,95489,92,177029
715,0.000891,74.125.24.0-255,7156,102645,92,177029
716,0.000894,172.31.47.0-255,66,102711,92,177029
717,0.000921,74.125.24.0-255,4320,107031,92,177029
718,0.000924,172.31.47.0-255,66,107097,92,177029
719,0.000952,172.31.47.0-255,66,107163,92,177029
720,0.001408,74.125.24.0-255,1484,108647,92,177029
721,0.001432,74.125.24.0-255,2902,111549,92,177029
722,0.001436,172.31.47.0-255,66,111615,92,177029
723,0.001439,74.125.24.0-255,1484,113099,92,177029
724,0.001459,74.125.24.0-255,4320,117419,92,177029
725,0.001462,172.31.47.0-255,66,117485,92,177029
726,0.001493,172.31.47.0-255,66,117551,92,177029
727,0.001514,74.125.24.0-255,1484,119035,92,177029
728,0.001526,172.31.47.0-255,66,119101,92,177029
729,0.001547,74.125.24.0-255,2184,121285,92,177029
730,0.001551,172.31.47.0-255,66,121351,92,177029
731,0.001759,74.125.24.0-255,1484,122835,92,177029
732,0.001769,74.125.24.0-255,2902,125737,92,177029
733,0.001773,172.31.47.0-255,66,125803,92,177029
734,0.001797,74.125.24.0-255,5738,131541,92,177029
735,0.001801,172.31.47.0-255,66,131607,92,177029
736,0.001807,74.125.24.0-255,4320,135927,92,177029
737,0.001809,172.31.47.0-255,66,135993,92,177029
738,0.001822,74.125.24.0-255,2902,138895,92,177029
739,0.001826,172.31.47.0-255,66,138961,92,177029
740,0.001842,74.125.24.0-255,5738,144699,92,177029
741,0.001845,172.31.47.0-255,66,144765,92,177029
742,0.001875,172.31.47.0-255,66,144831,92,177029
743,0.001879,74.125.24.0-255,2184,147015,92,177029
744,0.001881,172.31.47.0-255,66,147081,92,177029
745,0.001898,74.125.24.0-255,5738,152819,92,177029
746,0.001901,172.31.47.0-255,66,152885,92,177029
747,0.001945,172.31.47.0-255,66,152951,92,177029
748,0.001956,172.31.47.0-255,66,153017,92,177029
749,0.00199,172.31.47.0-255,66,153083,92,177029
750,0.002019,172.31.47.0-255,66,153149,92,177029
751,0.002029,172.31.47.0-255,66,153215,92,177029
752,0.002056,172.31.47.0-255,66,153281,92,177029
753,0.002073,172.31.47.0-255,66,153347,92,177029
754,0.002125,172.31.47.0-255,66,153413,92,177029
755,0.002147,74.125.24.0-255,766,154179,92,177029
756,0.002167,172.31.47.0-255,66,154245,92,177029
757,0.002174,74.125.24.0-255,7156,161401,92,177029
758,0.002176,172.31.47.0-255,66,161467,92,177029
759,0.002206,74.125.24.0-255,5020,166487,92,177029
760,0.00221,172.31.47.0-255,66,166553,92,177029
761,0.002224,172.31.47.0-255,66,166619,92,177029
762,0.002241,172.31.47.0-255,66,166685,92,177029
763,0.002252,74.125.24.0-255,1484,168169,92,177029
764,0.002276,74.125.24.0-255,7156,175325,92,177029
765,0.002279,172.31.47.0-255,66,175391,92,177029
766,0.002303,172.31.47.0-255,66,175457,92,177029
767,0.002313,172.31.47.0-255,66,175523,92,177029
768,0.002316,74.125.24.0-255,1164,176687,92,177029
769,0.002345,74.125.24.0-255,105,176792,92,177029
770,0.004992,172.31.47.0-255,66,176858,92,177029
771,0.005015,172.31.47.0-255,105,176963,92,177029
772,0.007539,74.125.24.0-255,66,177029,92,177029
773,0.0,74.125.68.0-255,153,153,92,118713
774,2.1e-05,172.31.47.0-255,66,219,92,118713
775,2.9e-05,74.125.68.0-255,1484,1703,92,118713
776,3.3e-05,172.31.47.0-255,66,1769,92,118713
777,3.9e-05,74.125.68.0-255,2902,4671,92,118713
778,4.2e-05,172.31.47.0-255,66,4737,92,118713
779,5e-05,74.125.68.0-255,7156,11893,92,118713
780,5.3e-05,172.31.47.0-255,66,11959,92,118713
781,7.9e-05,74.125.68.0-255,1977,13936,92,118713
782,8.2e-05,172.31.47.0-255,66,14002,92,118713
783,8.6e-05,74.125.68.0-255,1484,15486,92,118713
784,8.8e-05,172.31.47.0-255,66,15552,92,118713
785,0.0001,74.125.68.0-255,1484,17036,92,118713
786,0.000103,172.31.47.0-255,66,17102,92,118713
787,0.000111,74.125.68.0-255,7156,24258,92,118713
788,0.000113,172.31.47.0-255,66,24324,92,118713
789,0.000119,74.125.68.0-255,5738,30062,92,118713
790,0.000121,172.31.47.0-255,66,30128,92,118713
791,0.000145,74.125.68.0-255,1125,31253,92,118713
792,0.000148,172.31.47.0-255,66,31319,92,118713
793,0.000201,74.125.68.0-255,1484,32803,92,118713
794,0.000204,172.31.47.0-255,66,32869,92,118713
795,0.000207,74.125.68.0-255,1484,34353,92,118713
796,0.000209,172.31.47.0-255,66,34419,92,118713
797,0.000224,74.125.68.0-255,1484,35903,92,118713
798,0.000227,172.31.47.0-255,66,35969,92,118713
799,0.000231,74.125.68.0-255,2902,38871,92,118713
800,0.000234,172.31.47.0-255,66,38937,92,118713
801,0.000259,74.125.68.0-255,2902,41839,92,118713
802,0.000261,172.31.47.0-255,66,41905,92,118713
803,0.000268,74.125.68.0-255,6797,48702,92,118713
804,0.000271,172.31.47.0-255,66,48768,92,118713
805,0.000601,74.125.68.0-255,1484,50252,92,118713
806,0.000607,172.31.47.0-255,66,50318,92,118713
807,0.000613,74.125.68.0-255,2902,53220,92,118713
808,0.000616,172.31.47.0-255,66,53286,92,118713
809,0.000622,74.125.68.0-255,5738,59024,92,118713
810,0.000625,172.31.47.0-255,66,59090,92,118713
811,0.000629,74.125.68.0-255,2902,61992,92,118713
812,0.000631,172.31.47.0-255,66,62058,92,118713
813,0.000685,74.125.68.0-255,4543,66601,92,118713
814,0.00069,172.31.47.0-255,66,66667,92,118713
815,0.001276,74.125.68.0-255,1484,68151,92,118713
816,0.001282,172.31.47.0-255,66,68217,92,118713
817,0.001292,74.125.68.0-255,2902,71119,92,118713
818,0.001294,172.31.47.0-255,66,71185,92,118713
819,0.001315,74.125.68.0-255,4320,75505,92,118713
820,0.001317,172.31.47.0-255,66,75571,92,118713
821,0.001324,74.125.68.0-255,5738,81309,92,118713
822,0.001326,172.31.47.0-255,66,81375,92,118713
823,0.001351,74.125.68.0-255,4320,85695,92,118713
824,0.001353,172.31.47.0-255,66,85761,92,118713
825,0.001377,74.125.68.0-255,5738,91499,92,118713
826,0.00138,172.31.47.0-255,66,91565,92,118713
827,0.001398,74.125.68.0-255,1484,93049,92,118713
828,0.0014,172.31.47.0-255,66,93115,92,118713
829,0.001408,74.125.68.0-255,5738,98853,92,118713
830,0.00141,172.31.47.0-255,66,98919,92,118713
831,0.001415,74.125.68.0-255,2184,101103,92,118713
832,0.001417,172.31.47.0-255,66,101169,92,118713
833,0.003687,74.125.68.0-255,5738,106907,92,118713
834,0.003694,172.31.47.0-255,66,106973,92,118713
835,0.00599,74.125.68.0-255,2902,109875,92,118713
836,0.005993,172.31.47.0-255,66,109941,92,118713
837,0.00601,74.125.68.0-255,2902,112843,92,118713
838,0.006012,172.31.47.0-255,66,112909,92,118713
839,0.008287,74.125.68.0-255,5738,118647,92,118713
840,0.008296,172.31.47.0-255,66,118713,92,118713
841,0.0,172.217.194.0-255,152,152,92,205362
842,2.3e-05,172.31.47.0-255,66,218,92,205362
843,3e-05,172.217.194.0-255,1484,1702,92,205362
844,3.6e-05,172.31.47.0-255,66,1768,92,205362
845,4.2e-05,172.217.194.0-255,2902,4670,92,205362
846,5.4e-05,172.31.47.0-255,66,4736,92,205362
847,6.3e-05,172.217.194.0-255,7156,11892,92,205362
848,6.6e-05,172.31.47.0-255,66,11958,92,205362
849,7.2e-05,172.217.194.0-255,4320,16278,92,205362
850,7.5e-05,172.31.47.0-255,66,16344,92,205362
851,0.000104,172.217.194.0-255,3482,19826,92,205362
852,0.000108,172.31.47.0-255,66,19892,92,205362
853,0.00012,172.31.47.0-255,66,19958,92,205362
854,0.000141,172.217.194.0-255,2543,22501,92,205362
855,0.000144,172.31.47.0-255,66,22567,92,205362
856,0.000229,172.217.194.0-255,1484,24051,92,205362
857,0.000234,172.31.47.0-255,66,24117,92,205362
858,0.000239,172.217.194.0-255,2902,27019,92,205362
859,0.000242,172.31.47.0-255,66,27085,92,205362
860,0.000262,172.217.194.0-255,5738,32823,92,205362
861,0.000266,172.31.47.0-255,66,32889,92,205362
862,0.000276,172.217.194.0-255,5738,38627,92,205362
863,0.000278,172.31.47.0-255,66,38693,92,205362
864,0.000283,172.217.194.0-255,4320,43013,92,205362
865,0.000285,172.31.47.0-255,66,43079,92,205362
866,0.000328,172.31.47.0-255,66,43145,92,205362
867,0.000334,172.217.194.0-255,5332,48477,92,205362
868,0.000337,172.31.47.0-255,66,48543,92,205362
869,0.000357,172.217.194.0-255,98,48641,92,205362
870,0.000359,172.31.47.0-255,66,48707,92,205362
871,0.000544,172.217.194.0-255,1484,50191,92,205362
872,0.000553,172.217.194.0-255,2902,53093,92,205362
873,0.000558,172.31.47.0-255,66,53159,92,205362
874,0.000566,172.217.194.0-255,5738,58897,92,205362
875,0.000568,172.31.47.0-255,66,58963,92,205362
876,0.000597,172.217.194.0-255,2902,61865,92,205362
877,0.0006,172.31.47.0-255,66,61931,92,205362
878,0.00062,172.217.194.0-255,7156,69087,92,205362
879,0.000623,172.31.47.0-255,66,69153,92,205362
880,0.000627,172.217.194.0-255,2902,72055,92,205362
881,0.000629,172.31.47.0-255,66,72121,92,205362
882,0.000675,172.31.47.0-255,66,72187,92,205362
883,0.000837,172.217.194.0-255,364,72551,92,205362
884,0.000898,172.217.194.0-255,1484,74035,92,205362
885,0.000903,172.31.47.0-255,66,74101,92,205362
886,0.000909,172.217.194.0-255,2902,77003,92,205362
887,0.000911,172.31.47.0-255,66,77069,92,205362
888,0.000948,172.217.194.0-255,5738,82807,92,205362
889,0.000956,172.217.194.0-255,7156,89963,92,205362
890,0.000961,172.31.47.0-255,66,90029,92,205362
891,0.000964,172.31.47.0-255,66,90095,92,205362
892,0.000999,172.31.47.0-255,66,90161,92,205362
893,0.001002,172.217.194.0-255,589,90750,92,205362
894,0.001042,172.217.194.0-255,5738,96488,92,205362
895,0.001045,172.31.47.0-255,66,96554,92,205362
896,0.001078,172.217.194.0-255,4320,100874,92,205362
897,0.001081,172.31.47.0-255,66,100940,92,205362
898,0.001094,172.31.47.0-255,66,101006,92,205362
899,0.001097,172.217.194.0-255,1484,102490,92,205362
900,0.00113,172.31.47.0-255,66,102556,92,205362
901,0.001174,172.217.194.0-255,1484,104040,92,205362
902,0.001178,172.217.194.0-255,2902,106942,92,205362
903,0.00118,172.31.47.0-255,66,107008,92,205362
904,0.001202,172.217.194.0-255,5738,112746,92,205362
905,0.001205,172.31.47.0-255,66,112812,92,205362
906,0.001242,172.217.194.0-255,5738,118550,92,205362
907,0.001245,172.31.47.0-255,66,118616,92,205362
908,0.001266,172.217.194.0-255,7156,125772,92,205362
909,0.001269,172.31.47.0-255,66,125838,92,205362
910,0.001306,172.31.47.0-255,66,125904,92,205362
911,0.001359,172.217.194.0-255,1484,127388,92,205362
912,0.001362,172.217.194.0-255,1484,128872,92,205362
913,0.001365,172.31.47.0-255,66,128938,92,205362
914,0.001386,172.217.194.0-255,1484,130422,92,205362
915,0.001392,172.217.194.0-255,5738,136160,92,205362
916,0.001395,172.31.47.0-255,66,136226,92,205362
917,0.001402,172.217.194.0-255,7156,143382,92,205362
918,0.001404,172.31.47.0-255,66,143448,92,205362
919,0.001441,172.31.47.0-255,66,143514,92,205362
920,0.001445,172.217.194.0-255,2184,145698,92,205362
921,0.001448,172.31.47.0-255,66,145764,92,205362
922,0.001876,172.217.194.0-255,1484,147248,92,205362
923,0.001883,172.217.194.0-255,2902,150150,92,205362
924,0.001887,172.31.47.0-255,66,150216,92,205362
925,0.001894,172.217.194.0-255,4320,154536,92,205362
926,0.001896,172.31.47.0-255,66,154602,92,205362
927,0.001917,172.217.194.0-255,1484,156086,92,205362
928,0.001928,172.217.194.0-255,5738,161824,92,205362
929,0.00193,172.31.47.0-255,66,161890,92,205362
930,0.00195,172.217.194.0-255,2902,164792,92,205362
931,0.001953,172.31.47.0-255,66,164858,92,205362
932,0.001983,172.31.47.0-255,66,164924,92,205362
933,0.001988,172.217.194.0-255,5020,169944,92,205362
934,0.00199,172.31.47.0-255,66,170010,92,205362
935,0.00206,172.217.194.0-255,1484,171494,92,205362
936,0.002066,172.217.194.0-255,2902,174396,92,205362
937,0.002069,172.31.47.0-255,66,174462,92,205362
938,0.002105,172.217.194.0-255,5738,180200,92,205362
939,0.002109,172.31.47.0-255,66,180266,92,205362
940,0.00212,172.31.47.0-255,66,180332,92,205362
941,0.002153,172.217.194.0-255,4320,184652,92,205362
942,0.002157,172.31.47.0-255,66,184718,92,205362
943,0.002176,172.31.47.0-255,66,184784,92,205362
944,0.002192,172.31.47.0-255,66,184850,92,205362
945,0.002213,172.217.194.0-255,2902,187752,92,205362
946,0.002215,172.31.47.0-255,66,187818,92,205362
947,0.002265,172.31.47.0-255,66,187884,92,205362
948,0.002277,172.31.47.0-255,66,187950,92,205362
949,0.004481,172.217.194.0-255,5738,193688,92,205362
950,0.004486,172.31.47.0-255,66,193754,92,205362
951,0.006718,172.217.194.0-255,5738,199492,92,205362
952,0.006723,172.31.47.0-255,66,199558,92,205362
953,0.00894,172.217.194.0-255,5738,205296,92,205362
954,0.008945,172.31.47.0-255,66,205362,92,205362
955,0.0,74.125.24.0-255,153,153,92,187305
956,2.3e-05,172.31.47.0-255,66,219,92,187305
957,3e-05,74.125.24.0-255,1484,1703,92,187305
958,3.4e-05,172.31.47.0-255,66,1769,92,187305
959,3.9e-05,74.125.24.0-255,2902,4671,92,187305
960,4.2e-05,172.31.47.0-255,66,4737,92,187305
961,5.5e-05,74.125.24.0-255,7156,11893,92,187305
962,5.9e-05,172.31.47.0-255,66,11959,92,187305
963,9.6e-05,172.31.47.0-255,66,12025,92,187305
964,0.000121,74.125.24.0-255,2173,14198,92,187305
965,0.000123,172.31.47.0-255,66,14264,92,187305
966,0.000135,172.31.47.0-255,66,14330,92,187305
967,0.000148,74.125.24.0-255,4320,18650,92,187305
968,0.00015,172.31.47.0-255,66,18716,92,187305
969,0.000177,74.125.24.0-255,6438,25154,92,187305
970,0.000179,172.31.47.0-255,66,25220,92,187305
971,0.000199,74.125.24.0-255,7156,32376,92,187305
972,0.000202,172.31.47.0-255,66,32442,92,187305
973,0.000226,172.31.47.0-255,66,32508,92,187305
974,0.000327,74.125.24.0-255,115,32623,92,187305
975,0.000331,172.31.47.0-255,66,32689,92,187305
976,0.000366,74.125.24.0-255,1484,34173,92,187305
977,0.000368,172.31.47.0-255,66,34239,92,187305
978,0.000373,74.125.24.0-255,2902,37141,92,187305
979,0.000375,172.31.47.0-255,66,37207,92,187305
980,0.000416,74.125.24.0-255,2902,40109,92,187305
981,0.000418,172.31.47.0-255,66,40175,92,187305
982,0.000445,74.125.24.0-255,4320,44495,92,187305
983,0.000447,172.31.47.0-255,66,44561,92,187305
984,0.000453,74.125.24.0-255,7156,51717,92,187305
985,0.000455,172.31.47.0-255,66,51783,92,187305
986,0.000487,74.125.24.0-255,4320,56103,92,187305
987,0.000954,172.31.47.0-255,66,56169,92,187305
988,0.001,74.125.24.0-255,1484,57653,92,187305
989,0.001021,74.125.24.0-255,2902,60555,92,187305
990,0.001043,74.125.24.0-255,5738,66293,92,187305
991,0.001047,74.125.24.0-255,1484,67777,92,187305
992,0.001088,74.125.24.0-255,1484,69261,92,187305
993,0.001093,74.125.24.0-255,4320,73581,92,187305
994,0.001122,74.125.24.0-255,2902,76483,92,187305
995,0.001141,74.125.24.0-255,3602,80085,92,187305
996,0.001248,172.31.47.0-255,66,80151,92,187305
997,0.001295,74.125.24.0-255,1484,81635,92,187305
998,0.001301,74.125.24.0-255,2902,84537,92,187305
999,0.001314,172.31.47.0-255,66,84603,92,187305
1000,0.001321,74.125.24.0-255,5738,90341,92,187305
1001,0.001371,74.125.24.0-255,1484,91825,92,187305
1002,0.001374,172.31.47.0-255,66,91891,92,187305
1003,0.001404,74.125.24.0-255,5738,97629,92,187305
1004,0.00142,74.125.24.0-255,2184,99813,92,187305
1005,0.001441,172.31.47.0-255,66,99879,92,187305
1006,0.00154,74.125.24.0-255,1484,101363,92,187305
1007,0.00156,74.125.24.0-255,2902,104265,92,187305
1008,0.001567,74.125.24.0-255,5738,110003,92,187305
1009,0.001588,74.125.24.0-255,4320,114323,92,187305
1010,0.001602,172.31.47.0-255,66,114389,92,187305
1011,0.001628,172.31.47.0-255,66,114455,92,187305
1012,0.001664,172.31.47.0-255,66,114521,92,187305
1013,0.001766,74.125.24.0-255,1484,116005,92,187305
1014,0.001786,74.125.24.0-255,2902,118907,92,187305
1015,0.001793,74.125.24.0-255,5738,124645,92,187305
1016,0.0018,172.31.47.0-255,66,124711,92,187305
1017,0.001851,74.125.24.0-255,7156,131867,92,187305
1018,0.001858,172.31.47.0-255,66,131933,92,187305
1019,0.001877,74.125.24.0-255,3602,135535,92,187305
1020,0.001897,74.125.24.0-255,2902,138437,92,187305
1021,0.001919,74.125.24.0-255,7156,145593,92,187305
1022,0.001925,172.31.47.0-255,66,145659,92,187305
1023,0.001974,74.125.24.0-255,1484,147143,92,187305
1024,0.001988,172.31.47.0-255,66,147209,92,187305
1025,0.001993,74.125.24.0-255,4320,151529,92,187305
1026,0.001998,172.31.47.0-255,66,151595,92,187305
1027,0.00202,74.125.24.0-255,5738,157333,92,187305
1028,0.002049,172.31.47.0-255,66,157399,92,187305
1029,0.002053,172.31.47.0-255,66,157465,92,187305
1030,0.002102,74.125.24.0-255,7156,164621,92,187305
1031,0.002138,172.31.47.0-255,66,164687,92,187305
1032,0.002204,172.31.47.0-255,66,164753,92,187305
1033,0.002284,172.31.47.0-255,66,164819,92,187305
1034,0.002327,74.125.24.0-255,4320,169139,92,187305
1035,0.002336,172.31.47.0-255,66,169205,92,187305
1036,0.002348,74.125.24.0-255,7156,176361,92,187305
1037,0.002358,172.31.47.0-255,66,176427,92,187305
1038,0.002405,172.31.47.0-255,66,176493,92,187305
1039,0.002441,172.31.47.0-255,66,176559,92,187305
1040,0.002526,74.125.24.0-255,7156,183715,92,187305
1041,0.002558,172.31.47.0-255,66,183781,92,187305
1042,0.002568,74.125.24.0-255,3182,186963,92,187305
1043,0.002575,74.125.24.0-255,105,187068,92,187305
1044,0.002597,172.31.47.0-255,66,187134,92,187305
1045,0.004986,172.31.47.0-255,105,187239,92,187305
1046,0.007168,74.125.24.0-255,66,187305,92,187305
1047,0.0,172.31.47.0-255,105,105,92,276
1048,0.002095,157.240.13.0-255,105,210,92,276
1049,0.002106,172.31.47.0-255,66,276,92,276
1050,0.0,74.125.24.0-255,153,153,92,209440
1051,2.5e-05,172.31.47.0-255,66,219,92,209440
1052,3.1e-05,74.125.24.0-255,1484,1703,92,209440
1053,3.5e-05,172.31.47.0-255,66,1769,92,209440
1054,3.9e-05,74.125.24.0-255,2902,4671,92,209440
1055,4.9e-05,172.31.47.0-255,66,4737,92,209440
1056,5.4e-05,74.125.24.0-255,2902,7639,92,209440
1057,5.6e-05,172.31.47.0-255,66,7705,92,209440
1058,6.6e-05,74.125.24.0-255,1484,9189,92,209440
1059,7e-05,172.31.47.0-255,66,9255,92,209440
1060,0.000106,74.125.24.0-255,5090,14345,92,209440
1061,0.00011,172.31.47.0-255,66,14411,92,209440
1062,0.000138,74.125.24.0-255,5738,20149,92,209440
1063,0.00014,172.31.47.0-255,66,20215,92,209440
1064,0.00016,74.125.24.0-255,4320,24535,92,209440
1065,0.000162,172.31.47.0-255,66,24601,92,209440
1066,0.000187,74.125.24.0-255,6797,31398,92,209440
1067,0.00019,172.31.47.0-255,66,31464,92,209440
1068,0.000315,74.125.24.0-255,1484,32948,92,209440
1069,0.000319,172.31.47.0-255,66,33014,92,209440
1070,0.000323,74.125.24.0-255,2902,35916,92,209440
1071,0.000326,172.31.47.0-255,66,35982,92,209440
1072,0.000331,74.125.24.0-255,5738,41720,92,209440
1073,0.000348,172.31.47.0-255,66,41786,92,209440
1074,0.000381,172.31.47.0-255,66,41852,92,209440
1075,0.000413,74.125.24.0-255,2902,44754,92,209440
1076,0.000416,172.31.47.0-255,66,44820,92,209440
1077,0.00045,172.31.47.0-255,66,44886,92,209440
1078,0.000453,74.125.24.0-255,382,45268,92,209440
1079,0.000455,172.31.47.0-255,66,45334,92,209440
1080,0.000601,74.125.24.0-255,1484,46818,92,209440
1081,0.000613,74.125.24.0-255,2902,49720,92,209440
1082,0.000616,172.31.47.0-255,66,49786,92,209440
1083,0.000628,74.125.24.0-255,2902,52688,92,209440
1084,0.000634,172.31.47.0-255,66,52754,92,209440
1085,0.000664,74.125.24.0-255,2902,55656,92,209440
1086,0.000667,172.31.47.0-255,66,55722,92,209440
1087,0.00068,172.31.47.0-255,66,55788,92,209440
1088,0.000691,74.125.24.0-255,5738,61526,92,209440
1089,0.000694,172.31.47.0-255,66,61592,92,209440
1090,0.000719,74.125.24.0-255,1484,63076,92,209440
1091,0.000755,172.31.47.0-255,66,63142,92,209440
1092,0.000783,74.125.24.0-255,3961,67103,92,209440
1093,0.000786,172.31.47.0-255,66,67169,92,209440
1094,0.000964,74.125.24.0-255,1484,68653,92,209440
1095,0.00099,74.125.24.0-255,2902,71555,92,209440
1096,0.000993,172.31.47.0-255,66,71621,92,209440
1097,0.001,74.125.24.0-255,5738,77359,92,209440
1098,0.001002,172.31.47.0-255,66,77425,92,209440
1099,0.001046,172.31.47.0-255,66,77491,92,209440
1100,0.001053,74.125.24.0-255,7156,84647,92,209440
1101,0.001055,172.31.47.0-255,66,84713,92,209440
1102,0.001141,172.31.47.0-255,66,84779,92,209440
1103,0.001173,172.31.47.0-255,66,84845,92,209440
1104,0.001179,74.125.24.0-255,3602,88447,92,209440
1105,0.001181,172.31.47.0-255,66,88513,92,209440
1106,0.001185,74.125.24.0-255,4320,92833,92,209440
1107,0.001187,172.31.47.0-255,66,92899,92,209440
1108,0.001192,74.125.24.0-255,4320,97219,92,209440
1109,0.001195,172.31.47.0-255,66,97285,92,209440
1110,0.001225,74.125.24.0-255,1484,98769,92,209440
1111,0.00123,74.125.24.0-255,2902,101671,92,209440
1112,0.001233,172.31.47.0-255,66,101737,92,209440
1113,0.001252,74.125.24.0-255,3961,105698,92,209440
1114,0.001256,172.31.47.0-255,66,105764,92,209440
1115,0.00131,74.125.24.0-255,1484,107248,92,209440
1116,0.001316,74.125.24.0-255,2902,110150,92,209440
1117,0.001318,172.31.47.0-255,66,110216,92,209440
1118,0.001324,74.125.24.0-255,4320,114536,92,209440
1119,0.001327,172.31.47.0-255,66,114602,92,209440
1120,0.00135,74.125.24.0-255,1484,116086,92,209440
1121,0.00136,74.125.24.0-255,4320,120406,92,209440
1122,0.001364,172.31.47.0-255,66,120472,92,209440
1123,0.001377,172.31.47.0-255,66,120538,92,209440
1124,0.001383,74.125.24.0-255,4320,124858,92,209440
1125,0.001385,172.31.47.0-255,66,124924,92,209440
1126,0.001416,74.125.24.0-255,3602,128526,92,209440
1127,0.001419,172.31.47.0-255,66,128592,92,209440
1128,0.00143,172.31.47.0-255,66,128658,92,209440
1129,0.001474,172.31.47.0-255,66,128724,92,209440
1130,0.001497,74.125.24.0-255,7156,135880,92,209440
1131,0.001501,172.31.47.0-255,66,135946,92,209440
1132,0.001531,74.125.24.0-255,3602,139548,92,209440
1133,0.001534,172.31.47.0-255,66,139614,92,209440
1134,0.001549,74.125.24.0-255,1484,141098,92,209440
1135,0.00157,74.125.24.0-255,2902,144000,92,209440
1136,0.001572,172.31.47.0-255,66,144066,92,209440
1137,0.001578,74.125.24.0-255,5738,149804,92,209440
1138,0.001581,172.31.47.0-255,66,149870,92,209440
1139,0.001585,74.125.24.0-255,2902,152772,92,209440
1140,0.001587,172.31.47.0-255,66,152838,92,209440
1141,0.001619,74.125.24.0-255,7156,159994,92,209440
1142,0.001623,172.31.47.0-255,66,160060,92,209440
1143,0.001628,74.125.24.0-255,4320,164380,92,209440
1144,0.00163,172.31.47.0-255,66,164446,92,209440
1145,0.001673,172.31.47.0-255,66,164512,92,209440
1146,0.001718,74.125.24.0-255,1484,165996,92,209440
1147,0.001744,74.125.24.0-255,2902,168898,92,209440
1148,0.001746,172.31.47.0-255,66,168964,92,209440
1149,0.001768,74.125.24.0-255,5738,174702,92,209440
1150,0.001771,172.31.47.0-255,66,174768,92,209440
1151,0.001774,74.125.24.0-255,2902,177670,92,209440
1152,0.001776,172.31.47.0-255,66,177736,92,209440
1153,0.001808,74.125.24.0-255,4320,182056,92,209440
1154,0.00181,172.31.47.0-255,66,182122,92,209440
1155,0.001818,172.31.47.0-255,66,182188,92,209440
1156,0.001848,74.125.24.0-255,1484,183672,92,209440
1157,0.00187,74.125.24.0-255,6438,190110,92,209440
1158,0.001872,172.31.47.0-255,66,190176,92,209440
1159,0.001896,74.125.24.0-255,1484,191660,92,209440
1160,0.001908,74.125.24.0-255,2902,194562,92,209440
1161,0.00191,172.31.47.0-255,66,194628,92,209440
1162,0.001913,74.125.24.0-255,1484,196112,92,209440
1163,0.001934,74.125.24.0-255,4320,200432,92,209440
1164,0.001935,172.31.47.0-255,66,200498,92,209440
1165,0.001945,172.31.47.0-255,66,200564,92,209440
1166,0.00196,172.31.47.0-255,66,200630,92,209440
1167,0.001976,74.125.24.0-255,1484,202114,92,209440
1168,0.00201,172.31.47.0-255,66,202180,92,209440
1169,0.002033,74.125.24.0-255,4320,206500,92,209440
1170,0.002035,172.31.47.0-255,66,206566,92,209440
1171,0.002053,172.31.47.0-255,66,206632,92,209440
1172,0.002062,172.31.47.0-255,66,206698,92,209440
1173,0.002087,74.125.24.0-255,2400,209098,92,209440
1174,0.002089,172.31.47.0-255,66,209164,92,209440
1175,0.002114,74.125.24.0-255,105,209269,92,209440
1176,0.008456,172.31.47.0-255,66,209335,92,209440
1177,0.008479,172.31.47.0-255,105,209440,92,209440
1178,0.0,172.217.194.0-255,153,153,92,197347
1179,2.9e-05,172.31.47.0-255,66,219,92,197347
1180,3.6e-05,172.217.194.0-255,1484,1703,92,197347
1181,4.1e-05,172.31.47.0-255,66,1769,92,197347
1182,5.2e-05,172.217.194.0-255,2902,4671,92,197347
1183,5.5e-05,172.31.47.0-255,66,4737,92,197347
1184,6.1e-05,172.217.194.0-255,5738,10475,92,197347
1185,6.3e-05,172.31.47.0-255,66,10541,92,197347
1186,0.000103,172.31.47.0-255,66,10607,92,197347
1187,0.000135,172.31.47.0-255,66,10673,92,197347
1188,0.000158,172.217.194.0-255,1484,12157,92,197347
1189,0.00016,172.31.47.0-255,66,12223,92,197347
1190,0.000187,172.217.194.0-255,2902,15125,92,197347
1191,0.00019,172.31.47.0-255,66,15191,92,197347
1192,0.000196,172.217.194.0-255,5738,20929,92,197347
1193,0.000199,172.31.47.0-255,66,20995,92,197347
1194,0.000229,172.217.194.0-255,6797,27792,92,197347
1195,0.000232,172.31.47.0-255,66,27858,92,197347
1196,0.000238,172.217.194.0-255,7156,35014,92,197347
1197,0.00024,172.31.47.0-255,66,35080,92,197347
1198,0.000296,172.31.47.0-255,66,35146,92,197347
1199,0.000299,172.217.194.0-255,363,35509,92,197347
1200,0.000303,172.31.47.0-255,66,35575,92,197347
1201,0.000446,172.217.194.0-255,381,35956,92,197347
1202,0.000449,172.31.47.0-255,66,36022,92,197347
1203,0.000545,172.217.194.0-255,1484,37506,92,197347
1204,0.000549,172.31.47.0-255,66,37572,92,197347
1205,0.000567,172.217.194.0-255,2902,40474,92,197347
1206,0.00057,172.31.47.0-255,66,40540,92,197347
1207,0.000576,172.217.194.0-255,5738,46278,92,197347
1208,0.000578,172.31.47.0-255,66,46344,92,197347
1209,0.000582,172.217.194.0-255,2902,49246,92,197347
1210,0.000583,172.31.47.0-255,66,49312,92,197347
1211,0.000603,172.31.47.0-255,66,49378,92,197347
1212,0.000645,172.31.47.0-255,66,49444,92,197347
1213,0.000685,172.217.194.0-255,1484,50928,92,197347
1214,0.000695,172.217.194.0-255,2902,53830,92,197347
1215,0.000701,172.31.47.0-255,66,53896,92,197347
1216,0.000727,172.217.194.0-255,5738,59634,92,197347
1217,0.00073,172.31.47.0-255,66,59700,92,197347
1218,0.000735,172.217.194.0-255,5738,65438,92,197347
1219,0.000746,172.217.194.0-255,7156,72594,92,197347
1220,0.000745,172.31.47.0-255,66,72660,92,197347
1221,0.000761,172.31.47.0-255,66,72726,92,197347
1222,0.000777,172.217.194.0-255,2902,75628,92,197347
1223,0.000781,172.31.47.0-255,66,75694,92,197347
1224,0.000818,172.31.47.0-255,66,75760,92,197347
1225,0.00125,172.217.194.0-255,1484,77244,92,197347
1226,0.001275,172.217.194.0-255,2902,80146,92,197347
1227,0.001279,172.31.47.0-255,66,80212,92,197347
1228,0.001284,172.217.194.0-255,4320,84532,92,197347
1229,0.001286,172.31.47.0-255,66,84598,92,197347
1230,0.001317,172.217.194.0-255,1484,86082,92,197347
1231,0.001322,172.217.194.0-255,1484,87566,92,197347
1232,0.001325,172.31.47.0-255,66,87632,92,197347
1233,0.001336,172.31.47.0-255,66,87698,92,197347
1234,0.00135,172.31.47.0-255,66,87764,92,197347
1235,0.001382,172.217.194.0-255,1484,89248,92,197347
1236,0.001387,172.217.194.0-255,2902,92150,92,197347
1237,0.001389,172.31.47.0-255,66,92216,92,197347
1238,0.001393,172.217.194.0-255,1484,93700,92,197347
1239,0.001418,172.217.194.0-255,4320,98020,92,197347
1240,0.001421,172.31.47.0-255,66,98086,92,197347
1241,0.001426,172.217.194.0-255,2902,100988,92,197347
1242,0.001428,172.31.47.0-255,66,101054,92,197347
1243,0.00147,172.217.194.0-255,4320,105374,92,197347
1244,0.001495,172.217.194.0-255,4320,109694,92,197347
1245,0.001511,172.217.194.0-255,2184,111878,92,197347
1246,0.001568,172.217.194.0-255,1484,113362,92,197347
1247,0.001573,172.217.194.0-255,2902,116264,92,197347
1248,0.001594,172.217.194.0-255,5738,122002,92,197347
1249,0.001641,172.217.194.0-255,4320,126322,92,197347
1250,0.001662,172.217.194.0-255,6438,132760,92,197347
1251,0.001728,172.217.194.0-255,1484,134244,92,197347
1252,0.001733,172.217.194.0-255,1484,135728,92,197347
1253,0.001746,172.217.194.0-255,1484,137212,92,197347
1254,0.001752,172.217.194.0-255,5738,142950,92,197347
1255,0.001772,172.217.194.0-255,7156,150106,92,197347
1256,0.001801,172.217.194.0-255,5738,155844,92,197347
1257,0.001833,172.217.194.0-255,1484,157328,92,197347
1258,0.00185,172.217.194.0-255,2902,160230,92,197347
1259,0.001854,172.217.194.0-255,2902,163132,92,197347
1260,0.001868,172.217.194.0-255,2902,166034,92,197347
1261,0.001879,172.217.194.0-255,2902,168936,92,197347
1262,0.001909,172.217.194.0-255,4320,173256,92,197347
1263,0.001924,172.217.194.0-255,4320,177576,92,197347
1264,0.001937,172.217.194.0-255,4320,181896,92,197347
1265,0.001988,172.217.194.0-255,2184,184080,92,197347
1266,0.00202,172.217.194.0-255,7156,191236,92,197347
1267,0.002062,172.217.194.0-255,5738,196974,92,197347
1268,0.002172,172.217.194.0-255,97,197071,92,197347
1269,0.002174,172.217.194.0-255,105,197176,92,197347
1270,0.005629,172.31.47.0-255,66,197242,92,197347
1271,0.007853,172.31.47.0-255,105,197347,92,197347
1272,0.0,74.125.68.0-255,153,153,92,242058
1273,1.2e-05,172.31.47.0-255,66,219,92,242058
1274,1.7e-05,74.125.68.0-255,1484,1703,92,242058
1275,2.2e-05,172.31.47.0-255,66,1769,92,242058
1276,5.3e-05,74.125.68.0-255,2902,4671,92,242058
1277,5.7e-05,172.31.47.0-255,66,4737,92,242058
1278,6.4e-05,74.125.68.0-255,7156,11893,92,242058
1279,6.7e-05,172.31.47.0-255,66,11959,92,242058
1280,9.4e-05,74.125.68.0-255,3447,15406,92,242058
1281,9.6e-05,172.31.47.0-255,66,15472,92,242058
1282,0.000102,74.125.68.0-255,4320,19792,92,242058
1283,0.000104,172.31.47.0-255,66,19858,92,242058
1284,0.000132,74.125.68.0-255,4320,24178,92,242058
1285,0.000135,172.31.47.0-255,66,24244,92,242058
1286,0.000155,74.125.68.0-255,5738,29982,92,242058
1287,0.000157,172.31.47.0-255,66,30048,92,242058
1288,0.00016,74.125.68.0-255,1125,31173,92,242058
1289,0.000162,172.31.47.0-255,66,31239,92,242058
1290,0.000229,74.125.68.0-255,1484,32723,92,242058
1291,0.000233,172.31.47.0-255,66,32789,92,242058
1292,0.000243,74.125.68.0-255,2902,35691,92,242058
1293,0.000245,172.31.47.0-255,66,35757,92,242058
1294,0.000274,74.125.68.0-255,5738,41495,92,242058
1295,0.000276,172.31.47.0-255,66,41561,92,242058
1296,0.000308,74.125.68.0-255,6797,48358,92,242058
1297,0.00031,172.31.47.0-255,66,48424,92,242058
1298,0.000315,74.125.68.0-255,4320,52744,92,242058
1299,0.000317,172.31.47.0-255,66,52810,92,242058
1300,0.000342,74.125.68.0-255,2902,55712,92,242058
1301,0.000345,172.31.47.0-255,66,55778,92,242058
1302,0.00036,172.31.47.0-255,66,55844,92,242058
1303,0.000363,74.125.68.0-255,108,55952,92,242058
1304,0.000367,74.125.68.0-255,332,56284,92,242058
1305,0.000556,74.125.68.0-255,1484,57768,92,242058
1306,0.000561,74.125.68.0-255,2902,60670,92,242058
1307,0.000566,172.31.47.0-255,66,60736,92,242058
1308,0.000571,172.31.47.0-255,66,60802,92,242058
1309,0.000582,74.125.68.0-255,5738,66540,92,242058
1310,0.000584,172.31.47.0-255,66,66606,92,242058
1311,0.000593,74.125.68.0-255,2902,69508,92,242058
1312,0.000595,172.31.47.0-255,66,69574,92,242058
1313,0.0006,74.125.68.0-255,2902,72476,92,242058
1314,0.000603,172.31.47.0-255,66,72542,92,242058
1315,0.00063,74.125.68.0-255,1484,74026,92,242058
1316,0.000646,172.31.47.0-255,66,74092,92,242058
1317,0.000652,74.125.68.0-255,5738,79830,92,242058
1318,0.000654,172.31.47.0-255,66,79896,92,242058
1319,0.000684,74.125.68.0-255,2184,82080,92,242058
1320,0.000687,172.31.47.0-255,66,82146,92,242058
1321,0.0008,74.125.68.0-255,1484,83630,92,242058
1322,0.000804,74.125.68.0-255,1484,85114,92,242058
1323,0.000807,172.31.47.0-255,66,85180,92,242058
1324,0.000833,74.125.68.0-255,1484,86664,92,242058
1325,0.00084,74.125.68.0-255,5738,92402,92,242058
1326,0.000842,172.31.47.0-255,66,92468,92,242058
1327,0.000848,74.125.68.0-255,4320,96788,92,242058
1328,0.00085,172.31.47.0-255,66,96854,92,242058
1329,0.000885,74.125.68.0-255,5738,102592,92,242058
1330,0.000897,172.31.47.0-255,66,102658,92,242058
1331,0.000901,172.31.47.0-255,66,102724,92,242058
1332,0.000922,74.125.68.0-255,1484,104208,92,242058
1333,0.00093,74.125.68.0-255,2184,106392,92,242058
1334,0.000933,172.31.47.0-255,66,106458,92,242058
1335,0.000957,74.125.68.0-255,1484,107942,92,242058
1336,0.000961,74.125.68.0-255,2902,110844,92,242058
1337,0.000964,172.31.47.0-255,66,110910,92,242058
1338,0.000994,74.125.68.0-255,5738,116648,92,242058
1339,0.000997,172.31.47.0-255,66,116714,92,242058
1340,0.001003,74.125.68.0-255,5738,122452,92,242058
1341,0.001006,172.31.47.0-255,66,122518,92,242058
1342,0.001031,74.125.68.0-255,7156,129674,92,242058
1343,0.001034,172.31.47.0-255,66,129740,92,242058
1344,0.00106,74.125.68.0-255,5738,135478,92,242058
1345,0.001064,172.31.47.0-255,66,135544,92,242058
1346,0.001091,74.125.68.0-255,5020,140564,92,242058
1347,0.001094,172.31.47.0-255,66,140630,92,242058
1348,0.001216,74.125.68.0-255,1484,142114,92,242058
1349,0.001234,74.125.68.0-255,2902,145016,92,242058
1350,0.001238,172.31.47.0-255,66,145082,92,242058
1351,0.001241,74.125.68.0-255,1484,146566,92,242058
1352,0.001277,74.125.68.0-255,4320,150886,92,242058
1353,0.00128,172.31.47.0-255,66,150952,92,242058
1354,0.001287,74.125.68.0-255,7156,158108,92,242058
1355,0.001289,172.31.47.0-255,66,158174,92,242058
1356,0.001326,172.31.47.0-255,66,158240,92,242058
1357,0.001354,74.125.68.0-255,5020,163260,92,242058
1358,0.001375,172.31.47.0-255,66,163326,92,242058
1359,0.001386,74.125.68.0-255,5738,169064,92,242058
1360,0.001407,74.125.68.0-255,5738,174802,92,242058
1361,0.00145,172.31.47.0-255,66,174868,92,242058
1362,0.001478,74.125.68.0-255,7156,182024,92,242058
1363,0.001493,74.125.68.0-255,766,182790,92,242058
1364,0.001499,172.31.47.0-255,66,182856,92,242058
1365,0.001947,74.125.68.0-255,1484,184340,92,242058
1366,0.001966,74.125.68.0-255,2902,187242,92,242058
1367,0.00197,172.31.47.0-255,66,187308,92,242058
1368,0.001976,74.125.68.0-255,4320,191628,92,242058
1369,0.001978,172.31.47.0-255,66,191694,92,242058
1370,0.002028,172.31.47.0-255,66,191760,92,242058
1371,0.002034,74.125.68.0-255,5738,197498,92,242058
1372,0.002036,172.31.47.0-255,66,197564,92,242058
1373,0.002048,74.125.68.0-255,7156,204720,92,242058
1374,0.00205,172.31.47.0-255,66,204786,92,242058
1375,0.002062,74.125.68.0-255,1484,206270,92,242058
1376,0.002087,74.125.68.0-255,2184,208454,92,242058
1377,0.002107,172.31.47.0-255,66,208520,92,242058
1378,0.002246,74.125.68.0-255,1484,210004,92,242058
1379,0.002252,74.125.68.0-255,2902,212906,92,242058
1380,0.002271,172.31.47.0-255,66,212972,92,242058
1381,0.002281,74.125.68.0-255,2902,215874,92,242058
1382,0.002287,172.31.47.0-255,66,215940,92,242058
1383,0.002307,74.125.68.0-255,4320,220260,92,242058
1384,0.002317,74.125.68.0-255,4320,224580,92,242058
1385,0.002339,172.31.47.0-255,66,224646,92,242058
1386,0.004643,74.125.68.0-255,5738,230384,92,242058
1387,0.00465,172.31.47.0-255,66,230450,92,242058
1388,0.006955,74.125.68.0-255,5738,236188,92,242058
1389,0.006962,172.31.47.0-255,66,236254,92,242058
1390,0.009265,74.125.68.0-255,5738,241992,92,242058
1391,0.009271,172.31.47.0-255,66,242058,92,242058
1392,0.0,74.125.68.0-255,153,153,92,138521
1393,3.1e-05,172.31.47.0-255,66,219,92,138521
1394,3.8e-05,74.125.68.0-255,1484,1703,92,138521
1395,4.2e-05,172.31.47.0-255,66,1769,92,138521
1396,7.9e-05,74.125.68.0-255,2902,4671,92,138521
1397,8.3e-05,172.31.47.0-255,66,4737,92,138521
1398,8.9e-05,74.125.68.0-255,7156,11893,92,138521
1399,9.2e-05,172.31.47.0-255,66,11959,92,138521
1400,0.000115,74.125.68.0-255,2217,14176,92,138521
1401,0.000118,172.31.47.0-255,66,14242,92,138521
1402,0.000164,74.125.68.0-255,1484,15726,92,138521
1403,0.000167,172.31.47.0-255,66,15792,92,138521
1404,0.000196,74.125.68.0-255,2902,18694,92,138521
1405,0.000203,172.31.47.0-255,66,18760,92,138521
1406,0.000211,74.125.68.0-255,5738,24498,92,138521
1407,0.000213,172.31.47.0-255,66,24564,92,138521
1408,0.00022,74.125.68.0-255,5738,30302,92,138521
1409,0.000223,172.31.47.0-255,66,30368,92,138521
1410,0.00026,74.125.68.0-255,1125,31493,92,138521
1411,0.000263,172.31.47.0-255,66,31559,92,138521
1412,0.000317,74.125.68.0-255,1484,33043,92,138521
1413,0.000321,172.31.47.0-255,66,33109,92,138521
1414,0.000327,74.125.68.0-255,2902,36011,92,138521
1415,0.000329,172.31.47.0-255,66,36077,92,138521
1416,0.000355,74.125.68.0-255,5738,41815,92,138521
1417,0.000358,172.31.47.0-255,66,41881,92,138521
1418,0.000362,74.125.68.0-255,2902,44783,92,138521
1419,0.000364,172.31.47.0-255,66,44849,92,138521
1420,0.000383,74.125.68.0-255,2902,47751,92,138521
1421,0.000391,172.31.47.0-255,66,47817,92,138521
1422,0.000398,74.125.68.0-255,5738,53555,92,138521
1423,0.0004,172.31.47.0-255,66,53621,92,138521
1424,0.000427,74.125.68.0-255,1125,54746,92,138521
1425,0.00043,172.31.47.0-255,66,54812,92,138521
1426,0.000445,172.31.47.0-255,66,54878,92,138521
1427,0.000473,74.125.68.0-255,1480,56358,92,138521
1428,0.000489,74.125.68.0-255,331,56689,92,138521
1429,0.000492,172.31.47.0-255,66,56755,92,138521
1430,0.000724,74.125.68.0-255,1484,58239,92,138521
1431,0.000729,74.125.68.0-255,2902,61141,92,138521
1432,0.000731,172.31.47.0-255,66,61207,92,138521
1433,0.000757,74.125.68.0-255,5738,66945,92,138521
1434,0.000761,172.31.47.0-255,66,67011,92,138521
1435,0.000791,74.125.68.0-255,7156,74167,92,138521
1436,0.000794,172.31.47.0-255,66,74233,92,138521
1437,0.000803,172.31.47.0-255,66,74299,92,138521
1438,0.000824,74.125.68.0-255,4320,78619,92,138521
1439,0.000827,172.31.47.0-255,66,78685,92,138521
1440,0.000835,74.125.68.0-255,3602,82287,92,138521
1441,0.000838,172.31.47.0-255,66,82353,92,138521
1442,0.001471,74.125.68.0-255,1484,83837,92,138521
1443,0.001489,74.125.68.0-255,2902,86739,92,138521
1444,0.001493,172.31.47.0-255,66,86805,92,138521
1445,0.001524,74.125.68.0-255,2902,89707,92,138521
1446,0.001527,172.31.47.0-255,66,89773,92,138521
1447,0.001532,74.125.68.0-255,4320,94093,92,138521
1448,0.001533,172.31.47.0-255,66,94159,92,138521
1449,0.001538,74.125.68.0-255,4320,98479,92,138521
1450,0.001541,172.31.47.0-255,66,98545,92,138521
1451,0.001574,74.125.68.0-255,4320,102865,92,138521
1452,0.001576,172.31.47.0-255,66,102931,92,138521
1453,0.001582,74.125.68.0-255,5738,108669,92,138521
1454,0.001584,172.31.47.0-255,66,108735,92,138521
1455,0.00159,74.125.68.0-255,7156,115891,92,138521
1456,0.001591,172.31.47.0-255,66,115957,92,138521
1457,0.001594,74.125.68.0-255,766,116723,92,138521
1458,0.003525,74.125.68.0-255,4320,121043,92,138521
1459,0.003527,172.31.47.0-255,66,121109,92,138521
1460,0.005476,74.125.68.0-255,5738,126847,92,138521
1461,0.00548,172.31.47.0-255,66,126913,92,138521
1462,0.007425,74.125.68.0-255,5738,132651,92,138521
1463,0.007431,172.31.47.0-255,66,132717,92,138521
1464,0.009366,74.125.68.0-255,5738,138455,92,138521
1465,0.009374,172.31.47.0-255,66,138521,92,138521
1466,0.0,74.125.130.0-255,153,153,92,336683
1467,1.7e-05,172.31.47.0-255,66,219,92,336683
1468,2.3e-05,74.125.130.0-255,1484,1703,92,336683
1469,2.7e-05,172.31.47.0-255,66,1769,92,336683
1470,3.2e-05,74.125.130.0-255,2902,4671,92,336683
1471,3.5e-05,172.31.47.0-255,66,4737,92,336683
1472,6.2e-05,74.125.130.0-255,5738,10475,92,336683
1473,6.5e-05,172.31.47.0-255,66,10541,92,336683
1474,7e-05,74.125.130.0-255,3426,13967,92,336683
1475,7.2e-05,172.31.47.0-255,66,14033,92,336683
1476,0.000115,74.125.130.0-255,1484,15517,92,336683
1477,0.000117,172.31.47.0-255,66,15583,92,336683
1478,0.000133,74.125.130.0-255,2902,18485,92,336683
1479,0.000135,172.31.47.0-255,66,18551,92,336683
1480,0.000138,74.125.130.0-255,1484,20035,92,336683
1481,0.00014,172.31.47.0-255,66,20101,92,336683
1482,0.000163,74.125.130.0-255,4320,24421,92,336683
1483,0.000165,172.31.47.0-255,66,24487,92,336683
1484,0.000171,74.125.130.0-255,5738,30225,92,336683
1485,0.000173,172.31.47.0-255,66,30291,92,336683
1486,0.000212,74.125.130.0-255,1125,31416,92,336683
1487,0.000214,172.31.47.0-255,66,31482,92,336683
1488,0.000599,74.125.130.0-255,1484,32966,92,336683
1489,0.000604,172.31.47.0-255,66,33032,92,336683
1490,0.000608,74.125.130.0-255,1484,34516,92,336683
1491,0.00061,172.31.47.0-255,66,34582,92,336683
1492,0.00069,74.125.130.0-255,2902,37484,92,336683
1493,0.000693,172.31.47.0-255,66,37550,92,336683
1494,0.000699,74.125.130.0-255,1484,39034,92,336683
1495,0.0007,172.31.47.0-255,66,39100,92,336683
1496,0.000705,74.125.130.0-255,2902,42002,92,336683
1497,0.000707,172.31.47.0-255,66,42068,92,336683
1498,0.000713,74.125.130.0-255,5738,47806,92,336683
1499,0.000715,172.31.47.0-255,66,47872,92,336683
1500,0.000748,74.125.130.0-255,3961,51833,92,336683
1501,0.00075,172.31.47.0-255,66,51899,92,336683
1502,0.000769,74.125.130.0-255,4320,56219,92,336683
1503,0.000771,172.31.47.0-255,66,56285,92,336683
1504,0.000789,74.125.130.0-255,2902,59187,92,336683
1505,0.000791,172.31.47.0-255,66,59253,92,336683
1506,0.000811,74.125.130.0-255,5738,64991,92,336683
1507,0.000813,172.31.47.0-255,66,65057,92,336683
1508,0.000828,74.125.130.0-255,1125,66182,92,336683
1509,0.000845,74.125.130.0-255,367,66549,92,336683
1510,0.001012,74.125.130.0-255,1484,68033,92,336683
1511,0.001016,172.31.47.0-255,66,68099,92,336683
1512,0.001035,74.125.130.0-255,2902,71001,92,336683
1513,0.001038,172.31.47.0-255,66,71067,92,336683
1514,0.001046,74.125.130.0-255,5738,76805,92,336683
1515,0.001048,172.31.47.0-255,66,76871,92,336683
1516,0.001077,74.125.130.0-255,5738,82609,92,336683
1517,0.00108,172.31.47.0-255,66,82675,92,336683
1518,0.001093,74.125.130.0-255,4320,86995,92,336683
1519,0.001095,172.31.47.0-255,66,87061,92,336683
1520,0.001134,172.31.47.0-255,66,87127,92,336683
1521,0.00115,74.125.130.0-255,1484,88611,92,336683
1522,0.001162,74.125.130.0-255,2495,91106,92,336683
1523,0.001164,172.31.47.0-255,66,91172,92,336683
1524,0.002111,74.125.130.0-255,1484,92656,92,336683
1525,0.002118,74.125.130.0-255,2902,95558,92,336683
1526,0.002122,172.31.47.0-255,66,95624,92,336683
1527,0.00216,74.125.130.0-255,4320,99944,92,336683
1528,0.002163,172.31.47.0-255,66,100010,92,336683
1529,0.002176,74.125.130.0-255,1484,101494,92,336683
1530,0.002188,74.125.130.0-255,2902,104396,92,336683
1531,0.00219,172.31.47.0-255,66,104462,92,336683
1532,0.002208,74.125.130.0-255,4320,108782,92,336683
1533,0.00221,172.31.47.0-255,66,108848,92,336683
1534,0.00222,74.125.130.0-255,1484,110332,92,336683
1535,0.002238,74.125.130.0-255,5738,116070,92,336683
1536,0.00224,172.31.47.0-255,66,116136,92,336683
1537,0.002272,74.125.130.0-255,1484,117620,92,336683
1538,0.002289,74.125.130.0-255,2902,120522,92,336683
1539,0.002291,172.31.47.0-255,66,120588,92,336683
1540,0.002296,74.125.130.0-255,5020,125608,92,336683
1541,0.002298,172.31.47.0-255,66,125674,92,336683
1542,0.002923,74.125.130.0-255,1484,127158,92,336683
1543,0.002944,74.125.130.0-255,1484,128642,92,336683
1544,0.002946,172.31.47.0-255,66,128708,92,336683
1545,0.00295,74.125.130.0-255,1484,130192,92,336683
1546,0.002968,74.125.130.0-255,1484,131676,92,336683
1547,0.00297,172.31.47.0-255,66,131742,92,336683
1548,0.002972,74.125.130.0-255,1484,133226,92,336683
1549,0.003007,74.125.130.0-255,2902,136128,92,336683
1550,0.003009,172.31.47.0-255,66,136194,92,336683
1551,0.003031,74.125.130.0-255,7156,143350,92,336683
1552,0.003034,172.31.47.0-255,66,143416,92,336683
1553,0.003036,74.125.130.0-255,1484,144900,92,336683
1554,0.00304,74.125.130.0-255,2902,147802,92,336683
1555,0.003042,172.31.47.0-255,66,147868,92,336683
1556,0.003045,74.125.130.0-255,1484,149352,92,336683
1557,0.003092,74.125.130.0-255,5738,155090,92,336683
1558,0.003094,172.31.47.0-255,66,155156,92,336683
1559,0.003099,74.125.130.0-255,4320,159476,92,336683
1560,0.0031,172.31.47.0-255,66,159542,92,336683
1561,0.003103,74.125.130.0-255,766,160308,92,336683
1562,0.003122,74.125.130.0-255,4320,164628,92,336683
1563,0.003124,172.31.47.0-255,66,164694,92,336683
1564,0.003144,74.125.130.0-255,2902,167596,92,336683
1565,0.003146,172.31.47.0-255,66,167662,92,336683
1566,0.00315,74.125.130.0-255,4320,171982,92,336683
1567,0.003152,172.31.47.0-255,66,172048,92,336683
1568,0.003158,74.125.130.0-255,5738,177786,92,336683
1569,0.00316,172.31.47.0-255,66,177852,92,336683
1570,0.003173,74.125.130.0-255,1484,179336,92,336683
1571,0.003196,172.31.47.0-255,66,179402,92,336683
1572,0.003201,74.125.130.0-255,4320,183722,92,336683
1573,0.003202,172.31.47.0-255,66,183788,92,336683
1574,0.003225,74.125.130.0-255,766,184554,92,336683
1575,0.003271,74.125.130.0-255,1484,186038,92,336683
1576,0.003273,172.31.47.0-255,66,186104,92,336683
1577,0.003287,74.125.130.0-255,1484,187588,92,336683
1578,0.00329,74.125.130.0-255,1484,189072,92,336683
1579,0.003292,172.31.47.0-255,66,189138,92,336683
1580,0.003309,74.125.130.0-255,1484,190622,92,336683
1581,0.003312,74.125.130.0-255,2902,193524,92,336683
1582,0.003314,172.31.47.0-255,66,193590,92,336683
1583,0.003331,74.125.130.0-255,2902,196492,92,336683
1584,0.003333,172.31.47.0-255,66,196558,92,336683
1585,0.003337,74.125.130.0-255,2902,199460,92,336683
1586,0.003338,172.31.47.0-255,66,199526,92,336683
1587,0.003354,74.125.130.0-255,2902,202428,92,336683
1588,0.003356,172.31.47.0-255,66,202494,92,336683
1589,0.003358,74.125.130.0-255,1484,203978,92,336683
1590,0.003379,74.125.130.0-255,5738,209716,92,336683
1591,0.003381,172.31.47.0-255,66,209782,92,336683
1592,0.003384,74.125.130.0-255,1484,211266,92,336683
1593,0.003399,74.125.130.0-255,4320,215586,92,336683
1594,0.003401,172.31.47.0-255,66,215652,92,336683
1595,0.003405,74.125.130.0-255,2902,218554,92,336683
1596,0.003407,172.31.47.0-255,66,218620,92,336683
1597,0.003459,74.125.130.0-255,766,219386,92,336683
1598,0.003543,74.125.130.0-255,1484,220870,92,336683
1599,0.003545,172.31.47.0-255,66,220936,92,336683
1600,0.003558,74.125.130.0-255,2902,223838,92,336683
1601,0.00356,172.31.47.0-255,66,223904,92,336683
1602,0.003578,74.125.130.0-255,5738,229642,92,336683
1603,0.00358,172.31.47.0-255,66,229708,92,336683
1604,0.003606,74.125.130.0-255,2902,232610,92,336683
1605,0.003608,172.31.47.0-255,66,232676,92,336683
1606,0.003611,74.125.130.0-255,1484,234160,92,336683
1607,0.003627,74.125.130.0-255,2902,237062,92,336683
1608,0.003629,172.31.47.0-255,66,237128,92,336683
1609,0.003646,74.125.130.0-255,2902,240030,92,336683
1610,0.003648,172.31.47.0-255,66,240096,92,336683
1611,0.003664,74.125.130.0-255,1484,241580,92,336683
1612,0.00367,74.125.130.0-255,5738,247318,92,336683
1613,0.003672,172.31.47.0-255,66,247384,92,336683
1614,0.003688,74.125.130.0-255,1484,248868,92,336683
1615,0.003709,74.125.130.0-255,5020,253888,92,336683
1616,0.003712,172.31.47.0-255,66,253954,92,336683
1617,0.003734,74.125.130.0-255,7156,261110,92,336683
1618,0.003737,172.31.47.0-255,66,261176,92,336683
1619,0.00374,74.125.130.0-255,1484,262660,92,336683
1620,0.003754,74.125.130.0-255,5738,268398,92,336683
1621,0.003757,172.31.47.0-255,66,268464,92,336683
1622,0.003782,74.125.130.0-255,2902,271366,92,336683
1623,0.003784,172.31.47.0-255,66,271432,92,336683
1624,0.003796,172.31.47.0-255,66,271498,92,336683
1625,0.003802,74.125.130.0-255,5020,276518,92,336683
1626,0.003804,172.31.47.0-255,66,276584,92,336683
1627,0.003864,74.125.130.0-255,2902,279486,92,336683
1628,0.003867,172.31.47.0-255,66,279552,92,336683
1629,0.003872,74.125.130.0-255,4320,283872,92,336683
1630,0.003875,172.31.47.0-255,66,283938,92,336683
1631,0.003911,172.31.47.0-255,66,284004,92,336683
1632,0.003916,74.125.130.0-255,4320,288324,92,336683
1633,0.003918,172.31.47.0-255,66,288390,92,336683
1634,0.003954,74.125.130.0-255,2902,291292,92,336683
1635,0.003957,172.31.47.0-255,66,291358,92,336683
1636,0.003986,172.31.47.0-255,66,291424,92,336683
1637,0.004032,74.125.130.0-255,1484,292908,92,336683
1638,0.004058,172.31.47.0-255,66,292974,92,336683
1639,0.004071,172.31.47.0-255,66,293040,92,336683
1640,0.004073,74.125.130.0-255,1484,294524,92,336683
1641,0.004077,74.125.130.0-255,2902,297426,92,336683
1642,0.004079,172.31.47.0-255,66,297492,92,336683
1643,0.0041,74.125.130.0-255,4320,301812,92,336683
1644,0.004103,172.31.47.0-255,66,301878,92,336683
1645,0.004122,74.125.130.0-255,2184,304062,92,336683
1646,0.004124,172.31.47.0-255,66,304128,92,336683
1647,0.00413,74.125.130.0-255,7156,311284,92,336683
1648,0.004132,172.31.47.0-255,66,311350,92,336683
1649,0.004169,172.31.47.0-255,66,311416,92,336683
1650,0.004187,74.125.130.0-255,4320,315736,92,336683
1651,0.00419,172.31.47.0-255,66,315802,92,336683
1652,0.004216,74.125.130.0-255,2902,318704,92,336683
1653,0.004219,172.31.47.0-255,66,318770,92,336683
1654,0.004247,74.125.130.0-255,6438,325208,92,336683
1655,0.00425,172.31.47.0-255,66,325274,92,336683
1656,0.004259,172.31.47.0-255,66,325340,92,336683
1657,0.00427,74.125.130.0-255,1484,326824,92,336683
1658,0.004275,74.125.130.0-255,4320,331144,92,336683
1659,0.004278,172.31.47.0-255,66,331210,92,336683
1660,0.004314,74.125.130.0-255,4320,335530,92,336683
1661,0.004325,74.125.130.0-255,811,336341,92,336683
1662,0.004379,74.125.130.0-255,105,336446,92,336683
1663,0.004436,172.31.47.0-255,66,336512,92,336683
1664,0.007093,172.31.47.0-255,105,336617,92,336683
1665,0.009315,74.125.130.0-255,66,336683,92,336683
1666,0.0,74.125.130.0-255,153,153,92,201979
1667,2.5e-05,172.31.47.0-255,66,219,92,201979
1668,6e-05,74.125.130.0-255,1484,1703,92,201979
1669,6.5e-05,172.31.47.0-255,66,1769,92,201979
1670,7e-05,74.125.130.0-255,2902,4671,92,201979
1671,7.5e-05,172.31.47.0-255,66,4737,92,201979
1672,0.000104,74.125.130.0-255,5738,10475,92,201979
1673,0.000107,172.31.47.0-255,66,10541,92,201979
1674,0.000113,74.125.130.0-255,3472,14013,92,201979
1675,0.000115,172.31.47.0-255,66,14079,92,201979
1676,0.000178,74.125.130.0-255,1484,15563,92,201979
1677,0.000182,172.31.47.0-255,66,15629,92,201979
1678,0.000187,74.125.130.0-255,2902,18531,92,201979
1679,0.000189,172.31.47.0-255,66,18597,92,201979
1680,0.000215,74.125.130.0-255,1484,20081,92,201979
1681,0.000218,172.31.47.0-255,66,20147,92,201979
1682,0.000246,74.125.130.0-255,2902,23049,92,201979
1683,0.000249,172.31.47.0-255,66,23115,92,201979
1684,0.000253,74.125.130.0-255,2902,26017,92,201979
1685,0.000255,172.31.47.0-255,66,26083,92,201979
1686,0.000287,74.125.130.0-255,2902,28985,92,201979
1687,0.000291,172.31.47.0-255,66,29051,92,201979
1688,0.000312,74.125.130.0-255,2543,31594,92,201979
1689,0.000315,172.31.47.0-255,66,31660,92,201979
1690,0.000417,74.125.130.0-255,1484,33144,92,201979
1691,0.000421,172.31.47.0-255,66,33210,92,201979
1692,0.000425,74.125.130.0-255,1484,34694,92,201979
1693,0.000427,172.31.47.0-255,66,34760,92,201979
1694,0.000461,74.125.130.0-255,2902,37662,92,201979
1695,0.000464,172.31.47.0-255,66,37728,92,201979
1696,0.000471,74.125.130.0-255,5738,43466,92,201979
1697,0.000473,172.31.47.0-255,66,43532,92,201979
1698,0.000478,74.125.130.0-255,5379,48911,92,201979
1699,0.000481,172.31.47.0-255,66,48977,92,201979
1700,0.000592,74.125.130.0-255,1484,50461,92,201979
1701,0.000596,172.31.47.0-255,66,50527,92,201979
1702,0.00062,74.125.130.0-255,2902,53429,92,201979
1703,0.000623,172.31.47.0-255,66,53495,92,201979
1704,0.000629,74.125.130.0-255,5738,59233,92,201979
1705,0.000632,172.31.47.0-255,66,59299,92,201979
1706,0.000636,74.125.130.0-255,2902,62201,92,201979
1707,0.000638,172.31.47.0-255,66,62267,92,201979
1708,0.000644,74.125.130.0-255,3961,66228,92,201979
1709,0.000646,172.31.47.0-255,66,66294,92,201979
1710,0.000683,74.125.130.0-255,645,66939,92,201979
1711,0.000686,172.31.47.0-255,66,67005,92,201979
1712,0.00081,74.125.130.0-255,1484,68489,92,201979
1713,0.000814,172.31.47.0-255,66,68555,92,201979
1714,0.000831,74.125.130.0-255,2902,71457,92,201979
1715,0.000836,172.31.47.0-255,66,71523,92,201979
1716,0.000856,74.125.130.0-255,4320,75843,92,201979
1717,0.00086,172.31.47.0-255,66,75909,92,201979
1718,0.000894,74.125.130.0-255,5738,81647,92,201979
1719,0.000897,172.31.47.0-255,66,81713,92,201979
1720,0.000925,74.125.130.0-255,2543,84256,92,201979
1721,0.000927,172.31.47.0-255,66,84322,92,201979
1722,0.000931,74.125.130.0-255,1484,85806,92,201979
1723,0.000934,172.31.47.0-255,66,85872,92,201979
1724,0.000961,74.125.130.0-255,7156,93028,92,201979
1725,0.000964,172.31.47.0-255,66,93094,92,201979
1726,0.000967,74.125.130.0-255,1484,94578,92,201979
1727,0.000969,172.31.47.0-255,66,94644,92,201979
1728,0.001002,74.125.130.0-255,1484,96128,92,201979
1729,0.001005,172.31.47.0-255,66,96194,92,201979
1730,0.001011,74.125.130.0-255,2902,99096,92,201979
1731,0.001013,172.31.47.0-255,66,99162,92,201979
1732,0.001055,74.125.130.0-255,2543,101705,92,201979
1733,0.001059,172.31.47.0-255,66,101771,92,201979
1734,0.001442,74.125.130.0-255,1484,103255,92,201979
1735,0.001448,172.31.47.0-255,66,103321,92,201979
1736,0.001458,74.125.130.0-255,2902,106223,92,201979
1737,0.00146,172.31.47.0-255,66,106289,92,201979
1738,0.001473,74.125.130.0-255,5738,112027,92,201979
1739,0.001475,172.31.47.0-255,66,112093,92,201979
1740,0.00151,74.125.130.0-255,4320,116413,92,201979
1741,0.001513,172.31.47.0-255,66,116479,92,201979
1742,0.001542,74.125.130.0-255,1484,117963,92,201979
1743,0.001546,172.31.47.0-255,66,118029,92,201979
1744,0.001553,74.125.130.0-255,7156,125185,92,201979
1745,0.001555,172.31.47.0-255,66,125251,92,201979
1746,0.001561,74.125.130.0-255,5738,130989,92,201979
1747,0.001563,172.31.47.0-255,66,131055,92,201979
1748,0.00161,74.125.130.0-255,2902,133957,92,201979
1749,0.001614,172.31.47.0-255,66,134023,92,201979
1750,0.001642,74.125.130.0-255,2184,136207,92,201979
1751,0.001646,172.31.47.0-255,66,136273,92,201979
1752,0.001698,74.125.130.0-255,1484,137757,92,201979
1753,0.001704,172.31.47.0-255,66,137823,92,201979
1754,0.001708,74.125.130.0-255,2902,140725,92,201979
1755,0.001747,74.125.130.0-255,5738,146463,92,201979
1756,0.001778,74.125.130.0-255,5738,152201,92,201979
1757,0.001798,74.125.130.0-255,2902,155103,92,201979
1758,0.001828,74.125.130.0-255,5020,160123,92,201979
1759,0.001842,172.31.47.0-255,66,160189,92,201979
1760,0.001845,74.125.130.0-255,1484,161673,92,201979
1761,0.001869,74.125.130.0-255,1484,163157,92,201979
1762,0.001898,74.125.130.0-255,4320,167477,92,201979
1763,0.001903,172.31.47.0-255,66,167543,92,201979
1764,0.001916,74.125.130.0-255,5738,173281,92,201979
1765,0.001934,172.31.47.0-255,66,173347,92,201979
1766,0.001939,74.125.130.0-255,2902,176249,92,201979
1767,0.001979,74.125.130.0-255,2902,179151,92,201979
1768,0.001989,172.31.47.0-255,66,179217,92,201979
1769,0.002019,74.125.130.0-255,2902,182119,92,201979
1770,0.002031,74.125.130.0-255,1484,183603,92,201979
1771,0.002044,74.125.130.0-255,2184,185787,92,201979
1772,0.002046,172.31.47.0-255,66,185853,92,201979
1773,0.00205,172.31.47.0-255,66,185919,92,201979
1774,0.004348,74.125.130.0-255,4320,190239,92,201979
1775,0.004354,172.31.47.0-255,66,190305,92,201979
1776,0.00438,74.125.130.0-255,1484,191789,92,201979
1777,0.006654,74.125.130.0-255,4320,196109,92,201979
1778,0.006661,172.31.47.0-255,66,196175,92,201979
1779,0.009018,74.125.130.0-255,5738,201913,92,201979
1780,0.009068,172.31.47.0-255,66,201979,92,201979
1781,0.0,74.125.24.0-255,153,153,92,146843
1782,2.1e-05,172.31.47.0-255,66,219,92,146843
1783,2.8e-05,74.125.24.0-255,1484,1703,92,146843
1784,3.1e-05,172.31.47.0-255,66,1769,92,146843
1785,3.6e-05,74.125.24.0-255,2902,4671,92,146843
1786,3.9e-05,172.31.47.0-255,66,4737,92,146843
1787,6.8e-05,74.125.24.0-255,1484,6221,92,146843
1788,7.1e-05,172.31.47.0-255,66,6287,92,146843
1789,0.000101,74.125.24.0-255,4320,10607,92,146843
1790,0.000105,172.31.47.0-255,66,10673,92,146843
1791,0.000109,74.125.24.0-255,3384,14057,92,146843
1792,0.000111,172.31.47.0-255,66,14123,92,146843
1793,0.000146,74.125.24.0-255,1484,15607,92,146843
1794,0.000148,172.31.47.0-255,66,15673,92,146843
1795,0.000162,74.125.24.0-255,2902,18575,92,146843
1796,0.000164,172.31.47.0-255,66,18641,92,146843
1797,0.000167,74.125.24.0-255,1484,20125,92,146843
1798,0.000169,172.31.47.0-255,66,20191,92,146843
1799,0.000194,74.125.24.0-255,4320,24511,92,146843
1800,0.000198,74.125.24.0-255,4320,28831,92,146843
1801,0.000201,172.31.47.0-255,66,28897,92,146843
1802,0.000204,172.31.47.0-255,66,28963,92,146843
1803,0.000241,74.125.24.0-255,2543,31506,92,146843
1804,0.000243,172.31.47.0-255,66,31572,92,146843
1805,0.000347,74.125.24.0-255,1484,33056,92,146843
1806,0.000352,172.31.47.0-255,66,33122,92,146843
1807,0.000357,74.125.24.0-255,2902,36024,92,146843
1808,0.000359,172.31.47.0-255,66,36090,92,146843
1809,0.000376,74.125.24.0-255,1484,37574,92,146843
1810,0.000379,172.31.47.0-255,66,37640,92,146843
1811,0.000404,74.125.24.0-255,4320,41960,92,146843
1812,0.000407,172.31.47.0-255,66,42026,92,146843
1813,0.000413,74.125.24.0-255,6797,48823,92,146843
1814,0.000415,172.31.47.0-255,66,48889,92,146843
1815,0.000417,74.125.24.0-255,1484,50373,92,146843
1816,0.000447,74.125.24.0-255,5738,56111,92,146843
1817,0.00045,172.31.47.0-255,66,56177,92,146843
1818,0.000455,74.125.24.0-255,4320,60497,92,146843
1819,0.000458,172.31.47.0-255,66,60563,92,146843
1820,0.000492,74.125.24.0-255,4320,64883,92,146843
1821,0.000495,172.31.47.0-255,66,64949,92,146843
1822,0.000509,74.125.24.0-255,1125,66074,92,146843
1823,0.000512,74.125.24.0-255,409,66483,92,146843
1824,0.000798,74.125.24.0-255,334,66817,92,146843
1825,0.000802,172.31.47.0-255,66,66883,92,146843
1826,0.000837,74.125.24.0-255,1484,68367,92,146843
1827,0.000842,74.125.24.0-255,4320,72687,92,146843
1828,0.000846,172.31.47.0-255,66,72753,92,146843
1829,0.000858,74.125.24.0-255,5738,78491,92,146843
1830,0.00086,172.31.47.0-255,66,78557,92,146843
1831,0.000877,74.125.24.0-255,2902,81459,92,146843
1832,0.000879,172.31.47.0-255,66,81525,92,146843
1833,0.000902,172.31.47.0-255,66,81591,92,146843
1834,0.000922,74.125.24.0-255,766,82357,92,146843
1835,0.000926,172.31.47.0-255,66,82423,92,146843
1836,0.00101,74.125.24.0-255,1484,83907,92,146843
1837,0.001015,172.31.47.0-255,66,83973,92,146843
1838,0.00102,74.125.24.0-255,2902,86875,92,146843
1839,0.001022,172.31.47.0-255,66,86941,92,146843
1840,0.00104,74.125.24.0-255,5738,92679,92,146843
1841,0.001043,172.31.47.0-255,66,92745,92,146843
1842,0.001048,74.125.24.0-255,5738,98483,92,146843
1843,0.00105,172.31.47.0-255,66,98549,92,146843
1844,0.001053,74.125.24.0-255,1484,100033,92,146843
1845,0.001084,172.31.47.0-255,66,100099,92,146843
1846,0.001103,74.125.24.0-255,5020,105119,92,146843
1847,0.001107,172.31.47.0-255,66,105185,92,146843
1848,0.002261,74.125.24.0-255,1484,106669,92,146843
1849,0.00227,74.125.24.0-255,2902,109571,92,146843
1850,0.002275,172.31.47.0-255,66,109637,92,146843
1851,0.002283,74.125.24.0-255,5738,115375,92,146843
1852,0.002284,172.31.47.0-255,66,115441,92,146843
1853,0.002289,74.125.24.0-255,4320,119761,92,146843
1854,0.002291,172.31.47.0-255,66,119827,92,146843
1855,0.002294,74.125.24.0-255,1484,121311,92,146843
1856,0.002327,172.31.47.0-255,66,121377,92,146843
1857,0.002332,74.125.24.0-255,4320,125697,92,146843
1858,0.002334,172.31.47.0-255,66,125763,92,146843
1859,0.002349,74.125.24.0-255,3602,129365,92,146843
1860,0.002351,172.31.47.0-255,66,129431,92,146843
1861,0.004692,74.125.24.0-255,5738,135169,92,146843
1862,0.004698,172.31.47.0-255,66,135235,92,146843
1863,0.007091,74.125.24.0-255,5738,140973,92,146843
1864,0.007102,172.31.47.0-255,66,141039,92,146843
1865,0.009499,74.125.24.0-255,5738,146777,92,146843
1866,0.009507,172.31.47.0-255,66,146843,92,146843
1867,0.0,74.125.200.0-255,298,298,92,251696
1868,2.7e-05,172.31.47.0-255,66,364,92,251696
1869,3.3e-05,74.125.200.0-255,1484,1848,92,251696
1870,3.7e-05,172.31.47.0-255,66,1914,92,251696
1871,4e-05,74.125.200.0-255,1484,3398,92,251696
1872,4.2e-05,172.31.47.0-255,66,3464,92,251696
1873,6e-05,74.125.200.0-255,2902,6366,92,251696
1874,6.3e-05,172.31.47.0-255,66,6432,92,251696
1875,6.6e-05,74.125.200.0-255,1484,7916,92,251696
1876,6.8e-05,172.31.47.0-255,66,7982,92,251696
1877,9.3e-05,74.125.200.0-255,6272,14254,92,251696
1878,9.6e-05,172.31.47.0-255,66,14320,92,251696
1879,0.00014,74.125.200.0-255,1484,15804,92,251696
1880,0.000143,172.31.47.0-255,66,15870,92,251696
1881,0.000146,74.125.200.0-255,1484,17354,92,251696
1882,0.000148,172.31.47.0-255,66,17420,92,251696
1883,0.00016,74.125.200.0-255,1484,18904,92,251696
1884,0.000162,172.31.47.0-255,66,18970,92,251696
1885,0.000165,74.125.200.0-255,1484,20454,92,251696
1886,0.000168,172.31.47.0-255,66,20520,92,251696
1887,0.000179,74.125.200.0-255,1484,22004,92,251696
1888,0.000181,172.31.47.0-255,66,22070,92,251696
1889,0.000198,74.125.200.0-255,4320,26390,92,251696
1890,0.000201,172.31.47.0-255,66,26456,92,251696
1891,0.000219,74.125.200.0-255,4320,30776,92,251696
1892,0.000221,172.31.47.0-255,66,30842,92,251696
1893,0.000241,74.125.200.0-255,1125,31967,92,251696
1894,0.000243,172.31.47.0-255,66,32033,92,251696
1895,0.000273,74.125.200.0-255,4320,36353,92,251696
1896,0.000277,172.31.47.0-255,66,36419,92,251696
1897,0.000297,74.125.200.0-255,2902,39321,92,251696
1898,0.000299,172.31.47.0-255,66,39387,92,251696
1899,0.000316,74.125.200.0-255,2902,42289,92,251696
1900,0.000318,74.125.200.0-255,1484,43773,92,251696
1901,0.000321,172.31.47.0-255,66,43839,92,251696
1902,0.000324,172.31.47.0-255,66,43905,92,251696
1903,0.000344,74.125.200.0-255,4320,48225,92,251696
1904,0.000347,172.31.47.0-255,66,48291,92,251696
1905,0.000365,74.125.200.0-255,1125,49416,92,251696
1906,0.000368,172.31.47.0-255,66,49482,92,251696
1907,0.000435,74.125.200.0-255,1484,50966,92,251696
1908,0.000439,172.31.47.0-255,66,51032,92,251696
1909,0.000453,74.125.200.0-255,2902,53934,92,251696
1910,0.000456,172.31.47.0-255,66,54000,92,251696
1911,0.000472,74.125.200.0-255,1484,55484,92,251696
1912,0.000475,172.31.47.0-255,66,55550,92,251696
1913,0.000494,74.125.200.0-255,2902,58452,92,251696
1914,0.000497,172.31.47.0-255,66,58518,92,251696
1915,0.000501,74.125.200.0-255,2902,61420,92,251696
1916,0.000504,172.31.47.0-255,66,61486,92,251696
1917,0.000522,74.125.200.0-255,2902,64388,92,251696
1918,0.000525,172.31.47.0-255,66,64454,92,251696
1919,0.00053,74.125.200.0-255,2543,66997,92,251696
1920,0.000531,172.31.47.0-255,66,67063,92,251696
1921,0.000562,74.125.200.0-255,647,67710,92,251696
1922,0.000565,172.31.47.0-255,66,67776,92,251696
1923,0.000653,74.125.200.0-255,1484,69260,92,251696
1924,0.000657,172.31.47.0-255,66,69326,92,251696
1925,0.000668,74.125.200.0-255,2902,72228,92,251696
1926,0.000671,172.31.47.0-255,66,72294,92,251696
1927,0.000691,74.125.200.0-255,2902,75196,92,251696
1928,0.000694,172.31.47.0-255,66,75262,92,251696
1929,0.00071,74.125.200.0-255,1484,76746,92,251696
1930,0.000713,172.31.47.0-255,66,76812,92,251696
1931,0.000728,74.125.200.0-255,1484,78296,92,251696
1932,0.00073,172.31.47.0-255,66,78362,92,251696
1933,0.000751,74.125.200.0-255,6797,85159,92,251696
1934,0.000753,172.31.47.0-255,66,85225,92,251696
1935,0.00082,74.125.200.0-255,1484,86709,92,251696
1936,0.000842,74.125.200.0-255,2902,89611,92,251696
1937,0.000845,172.31.47.0-255,66,89677,92,251696
1938,0.000887,74.125.200.0-255,5738,95415,92,251696
1939,0.00089,172.31.47.0-255,66,95481,92,251696
1940,0.000894,74.125.200.0-255,2902,98383,92,251696
1941,0.000896,172.31.47.0-255,66,98449,92,251696
1942,0.000912,74.125.200.0-255,3961,102410,92,251696
1943,0.000916,172.31.47.0-255,66,102476,92,251696
1944,0.001337,74.125.200.0-255,1484,103960,92,251696
1945,0.001356,74.125.200.0-255,2902,106862,92,251696
1946,0.001361,172.31.47.0-255,66,106928,92,251696
1947,0.001385,74.125.200.0-255,5738,112666,92,251696
1948,0.001389,172.31.47.0-255,66,112732,92,251696
1949,0.001392,74.125.200.0-255,1484,114216,92,251696
1950,0.001405,74.125.200.0-255,2902,117118,92,251696
1951,0.001408,172.31.47.0-255,66,117184,92,251696
1952,0.001431,74.125.200.0-255,5738,122922,92,251696
1953,0.001434,172.31.47.0-255,66,122988,92,251696
1954,0.001437,74.125.200.0-255,1484,124472,92,251696
1955,0.001453,74.125.200.0-255,4320,128792,92,251696
1956,0.001456,172.31.47.0-255,66,128858,92,251696
1957,0.001502,74.125.200.0-255,2902,131760,92,251696
1958,0.001506,172.31.47.0-255,66,131826,92,251696
1959,0.001521,74.125.200.0-255,4320,136146,92,251696
1960,0.001523,172.31.47.0-255,66,136212,92,251696
1961,0.001526,74.125.200.0-255,766,136978,92,251696
1962,0.001564,74.125.200.0-255,1484,138462,92,251696
1963,0.001567,172.31.47.0-255,66,138528,92,251696
1964,0.001571,74.125.200.0-255,1484,140012,92,251696
1965,0.001587,74.125.200.0-255,1484,141496,92,251696
1966,0.00159,172.31.47.0-255,66,141562,92,251696
1967,0.001595,74.125.200.0-255,5738,147300,92,251696
1968,0.001597,172.31.47.0-255,66,147366,92,251696
1969,0.001601,74.125.200.0-255,2902,150268,92,251696
1970,0.001603,172.31.47.0-255,66,150334,92,251696
1971,0.001626,74.125.200.0-255,4320,154654,92,251696
1972,0.001628,172.31.47.0-255,66,154720,92,251696
1973,0.00165,74.125.200.0-255,5738,160458,92,251696
1974,0.001653,172.31.47.0-255,66,160524,92,251696
1975,0.001659,74.125.200.0-255,5738,166262,92,251696
1976,0.001662,172.31.47.0-255,66,166328,92,251696
1977,0.001691,74.125.200.0-255,5020,171348,92,251696
1978,0.001694,172.31.47.0-255,66,171414,92,251696
1979,0.001822,74.125.200.0-255,1484,172898,92,251696
1980,0.001837,74.125.200.0-255,2902,175800,92,251696
1981,0.001842,172.31.47.0-255,66,175866,92,251696
1982,0.001845,74.125.200.0-255,1484,177350,92,251696
1983,0.001848,74.125.200.0-255,1484,178834,92,251696
1984,0.00185,172.31.47.0-255,66,178900,92,251696
1985,0.001867,74.125.200.0-255,1484,180384,92,251696
1986,0.001886,74.125.200.0-255,4320,184704,92,251696
1987,0.00189,172.31.47.0-255,66,184770,92,251696
1988,0.001909,74.125.200.0-255,1484,186254,92,251696
1989,0.001915,74.125.200.0-255,2902,189156,92,251696
1990,0.001919,172.31.47.0-255,66,189222,92,251696
1991,0.001924,74.125.200.0-255,4320,193542,92,251696
1992,0.001943,74.125.200.0-255,2902,196444,92,251696
1993,0.00196,74.125.200.0-255,1484,197928,92,251696
1994,0.00198,74.125.200.0-255,2902,200830,92,251696
1995,0.002001,74.125.200.0-255,5020,205850,92,251696
1996,0.002353,74.125.200.0-255,1484,207334,92,251696
1997,0.002374,74.125.200.0-255,2902,210236,92,251696
1998,0.002386,74.125.200.0-255,2902,213138,92,251696
1999,0.002402,74.125.200.0-255,2902,216040,92,251696
2000,0.002405,74.125.200.0-255,1484,217524,92,251696
2001,0.002407,74.125.200.0-255,1484,219008,92,251696
2002,0.002424,74.125.200.0-255,1484,220492,92,251696
2003,0.002427,74.125.200.0-255,1484,221976,92,251696
2004,0.002448,74.125.200.0-255,4320,226296,92,251696
2005,0.002451,74.125.200.0-255,2902,229198,92,251696
2006,0.002467,74.125.200.0-255,4320,233518,92,251696
2007,0.002502,74.125.200.0-255,2902,236420,92,251696
2008,0.002513,74.125.200.0-255,3602,240022,92,251696
2009,0.003466,172.31.47.0-255,66,240088,92,251696
2010,0.005971,74.125.200.0-255,5738,245826,92,251696
2011,0.005977,172.31.47.0-255,66,245892,92,251696
2012,0.008493,74.125.200.0-255,5738,251630,92,251696
2013,0.008499,172.31.47.0-255,66,251696,92,251696
2014,0.0,172.217.194.0-255,153,153,92,209337
2015,2.6e-05,172.31.47.0-255,66,219,92,209337
2016,3.2e-05,172.217.194.0-255,1484,1703,92,209337
2017,3.5e-05,172.31.47.0-255,66,1769,92,209337
2018,3.9e-05,172.217.194.0-255,2902,4671,92,209337
2019,4.1e-05,172.31.47.0-255,66,4737,92,209337
2020,4.8e-05,172.217.194.0-255,7156,11893,92,209337
2021,5e-05,172.31.47.0-255,66,11959,92,209337
2022,7.6e-05,172.217.194.0-255,2130,14089,92,209337
2023,7.8e-05,172.31.47.0-255,66,14155,92,209337
2024,9.1e-05,172.217.194.0-255,2902,17057,92,209337
2025,9.3e-05,172.31.47.0-255,66,17123,92,209337
2026,9.6e-05,172.217.194.0-255,1484,18607,92,209337
2027,9.7e-05,172.31.47.0-255,66,18673,92,209337
2028,0.000117,172.217.194.0-255,5738,24411,92,209337
2029,0.000119,172.31.47.0-255,66,24477,92,209337
2030,0.000133,172.217.194.0-255,6797,31274,92,209337
2031,0.000136,172.31.47.0-255,66,31340,92,209337
2032,0.000206,172.217.194.0-255,1484,32824,92,209337
2033,0.000209,172.31.47.0-255,66,32890,92,209337
2034,0.000213,172.217.194.0-255,2902,35792,92,209337
2035,0.000215,172.31.47.0-255,66,35858,92,209337
2036,0.000229,172.217.194.0-255,4320,40178,92,209337
2037,0.000232,172.31.47.0-255,66,40244,92,209337
2038,0.000243,172.217.194.0-255,1484,41728,92,209337
2039,0.000245,172.31.47.0-255,66,41794,92,209337
2040,0.000289,172.31.47.0-255,66,41860,92,209337
2041,0.000298,172.31.47.0-255,66,41926,92,209337
2042,0.000329,172.217.194.0-255,1419,43345,92,209337
2043,0.000332,172.31.47.0-255,66,43411,92,209337
2044,0.000362,172.217.194.0-255,383,43794,92,209337
2045,0.0004,172.217.194.0-255,1484,45278,92,209337
2046,0.000402,172.31.47.0-255,66,45344,92,209337
2047,0.000414,172.217.194.0-255,1484,46828,92,209337
2048,0.000431,172.217.194.0-255,2902,49730,92,209337
2049,0.000433,172.31.47.0-255,66,49796,92,209337
2050,0.000445,172.31.47.0-255,66,49862,92,209337
2051,0.000462,172.217.194.0-255,1484,51346,92,209337
2052,0.000478,172.31.47.0-255,66,51412,92,209337
2053,0.000513,172.217.194.0-255,6438,57850,92,209337
2054,0.000515,172.31.47.0-255,66,57916,92,209337
2055,0.00053,172.217.194.0-255,2902,60818,92,209337
2056,0.000537,172.31.47.0-255,66,60884,92,209337
2057,0.000556,172.217.194.0-255,4320,65204,92,209337
2058,0.000561,172.217.194.0-255,5738,70942,92,209337
2059,0.000561,172.31.47.0-255,66,71008,92,209337
2060,0.000564,172.217.194.0-255,2902,73910,92,209337
2061,0.000574,172.31.47.0-255,66,73976,92,209337
2062,0.000577,172.217.194.0-255,2902,76878,92,209337
2063,0.000586,172.31.47.0-255,66,76944,92,209337
2064,0.00061,172.31.47.0-255,66,77010,92,209337
2065,0.000624,172.217.194.0-255,1484,78494,92,209337
2066,0.000644,172.217.194.0-255,5020,83514,92,209337
2067,0.000653,172.31.47.0-255,66,83580,92,209337
2068,0.00066,172.217.194.0-255,1484,85064,92,209337
2069,0.000673,172.217.194.0-255,5738,90802,92,209337
2070,0.000676,172.31.47.0-255,66,90868,92,209337
2071,0.000679,172.217.194.0-255,2902,93770,92,209337
2072,0.000689,172.31.47.0-255,66,93836,92,209337
2073,0.000702,172.217.194.0-255,5738,99574,92,209337
2074,0.000716,172.217.194.0-255,2902,102476,92,209337
2075,0.000717,172.31.47.0-255,66,102542,92,209337
2076,0.000721,172.31.47.0-255,66,102608,92,209337
2077,0.00075,172.31.47.0-255,66,102674,92,209337
2078,0.000756,172.217.194.0-255,1484,104158,92,209337
2079,0.000759,172.217.194.0-255,766,104924,92,209337
2080,0.000762,172.31.47.0-255,66,104990,92,209337
2081,0.000769,172.217.194.0-255,1484,106474,92,209337
2082,0.000773,172.217.194.0-255,2902,109376,92,209337
2083,0.000778,172.217.194.0-255,5738,115114,92,209337
2084,0.000784,172.31.47.0-255,66,115180,92,209337
2085,0.000798,172.217.194.0-255,4320,119500,92,209337
2086,0.000802,172.31.47.0-255,66,119566,92,209337
2087,0.000828,172.217.194.0-255,2902,122468,92,209337
2088,0.000829,172.31.47.0-255,66,122534,92,209337
2089,0.000833,172.31.47.0-255,66,122600,92,209337
2090,0.000855,172.217.194.0-255,2902,125502,92,209337
2091,0.000866,172.31.47.0-255,66,125568,92,209337
2092,0.000871,172.217.194.0-255,4471,130039,92,209337
2093,0.000878,172.31.47.0-255,66,130105,92,209337
2094,0.000907,172.217.194.0-255,4320,134425,92,209337
2095,0.000915,172.31.47.0-255,66,134491,92,209337
2096,0.000917,172.217.194.0-255,1484,135975,92,209337
2097,0.000935,172.217.194.0-255,4320,140295,92,209337
2098,0.000944,172.31.47.0-255,66,140361,92,209337
2099,0.000948,172.31.47.0-255,66,140427,92,209337
2100,0.000988,172.31.47.0-255,66,140493,92,209337
2101,0.001001,172.217.194.0-255,1484,141977,92,209337
2102,0.001043,172.31.47.0-255,66,142043,92,209337
2103,0.001066,172.217.194.0-255,5738,147781,92,209337
2104,0.001074,172.31.47.0-255,66,147847,92,209337
2105,0.001085,172.31.47.0-255,66,147913,92,209337
2106,0.001088,172.31.47.0-255,66,147979,92,209337
2107,0.001299,172.217.194.0-255,1484,149463,92,209337
2108,0.001303,172.217.194.0-255,1484,150947,92,209337
2109,0.001306,172.31.47.0-255,66,151013,92,209337
2110,0.001316,172.217.194.0-255,1484,152497,92,209337
2111,0.001333,172.217.194.0-255,5738,158235,92,209337
2112,0.00134,172.31.47.0-255,66,158301,92,209337
2113,0.001379,172.31.47.0-255,66,158367,92,209337
2114,0.001424,172.31.47.0-255,66,158433,92,209337
2115,0.001435,172.31.47.0-255,66,158499,92,209337
2116,0.001487,172.217.194.0-255,7156,165655,92,209337
2117,0.001494,172.31.47.0-255,66,165721,92,209337
2118,0.001508,172.217.194.0-255,5020,170741,92,209337
2119,0.001513,172.31.47.0-255,66,170807,92,209337
2120,0.001523,172.217.194.0-255,2902,173709,92,209337
2121,0.001531,172.31.47.0-255,66,173775,92,209337
2122,0.001546,172.31.47.0-255,66,173841,92,209337
2123,0.001551,172.217.194.0-255,4320,178161,92,209337
2124,0.001554,172.31.47.0-255,66,178227,92,209337
2125,0.001582,172.31.47.0-255,66,178293,92,209337
2126,0.001598,172.217.194.0-255,2902,181195,92,209337
2127,0.001604,172.31.47.0-255,66,181261,92,209337
2128,0.001611,172.217.194.0-255,5738,186999,92,209337
2129,0.001615,172.31.47.0-255,66,187065,92,209337
2130,0.001621,172.217.194.0-255,1484,188549,92,209337
2131,0.001624,172.217.194.0-255,1484,190033,92,209337
2132,0.00163,172.31.47.0-255,66,190099,92,209337
2133,0.001637,172.217.194.0-255,7156,197255,92,209337
2134,0.001642,172.31.47.0-255,66,197321,92,209337
2135,0.00165,172.217.194.0-255,2902,200223,92,209337
2136,0.001653,172.31.47.0-255,66,200289,92,209337
2137,0.001683,172.217.194.0-255,1484,201773,92,209337
2138,0.001702,172.217.194.0-255,7156,208929,92,209337
2139,0.001713,172.31.47.0-255,66,208995,92,209337
2140,0.001719,172.217.194.0-255,105,209100,92,209337
2141,0.001725,172.31.47.0-255,66,209166,92,209337
2142,0.002975,172.31.47.0-255,105,209271,92,209337
2143,0.005016,172.217.194.0-255,66,209337,92,209337
2144,0.0,172.31.47.0-255,105,105,92,276
2145,0.001483,157.240.13.0-255,105,210,92,276
2146,0.001492,172.31.47.0-255,66,276,92,276
2147,0.0,172.217.26.0-255,152,152,92,104522
2148,2e-05,172.31.47.0-255,66,218,92,104522
2149,2.7e-05,172.217.26.0-255,1484,1702,92,104522
2150,3.1e-05,172.31.47.0-255,66,1768,92,104522
2151,3.7e-05,172.217.26.0-255,2902,4670,92,104522
2152,4.8e-05,172.31.47.0-255,66,4736,92,104522
2153,5.6e-05,172.217.26.0-255,7156,11892,92,104522
2154,5.9e-05,172.31.47.0-255,66,11958,92,104522
2155,6.3e-05,172.217.26.0-255,2044,14002,92,104522
2156,6.5e-05,172.31.47.0-255,66,14068,92,104522
2157,0.000135,172.217.26.0-255,1484,15552,92,104522
2158,0.000139,172.31.47.0-255,66,15618,92,104522
2159,0.000144,172.217.26.0-255,2902,18520,92,104522
2160,0.000147,172.31.47.0-255,66,18586,92,104522
2161,0.000178,172.217.26.0-255,5738,24324,92,104522
2162,0.00018,172.31.47.0-255,66,24390,92,104522
2163,0.000215,172.217.26.0-255,6797,31187,92,104522
2164,0.000218,172.31.47.0-255,66,31253,92,104522
2165,0.000262,172.217.26.0-255,1484,32737,92,104522
2166,0.000264,172.31.47.0-255,66,32803,92,104522
2167,0.000269,172.217.26.0-255,2902,35705,92,104522
2168,0.000271,172.31.47.0-255,66,35771,92,104522
2169,0.000277,172.217.26.0-255,4320,40091,92,104522
2170,0.000283,172.31.47.0-255,66,40157,92,104522
2171,0.000318,172.217.26.0-255,1484,41641,92,104522
2172,0.000321,172.31.47.0-255,66,41707,92,104522
2173,0.000328,172.217.26.0-255,6797,48504,92,104522
2174,0.000331,172.31.47.0-255,66,48570,92,104522
2175,0.001362,172.217.26.0-255,1484,50054,92,104522
2176,0.00137,172.31.47.0-255,66,50120,92,104522
2177,0.001379,172.217.26.0-255,2902,53022,92,104522
2178,0.001381,172.31.47.0-255,66,53088,92,104522
2179,0.001393,172.217.26.0-255,5738,58826,92,104522
2180,0.001395,172.31.47.0-255,66,58892,92,104522
2181,0.001424,172.217.26.0-255,5738,64630,92,104522
2182,0.001427,172.31.47.0-255,66,64696,92,104522
2183,0.001461,172.31.47.0-255,66,64762,92,104522
2184,0.001473,172.31.47.0-255,66,64828,92,104522
2185,0.001501,172.217.26.0-255,7156,71984,92,104522
2186,0.001504,172.31.47.0-255,66,72050,92,104522
2187,0.001516,172.217.26.0-255,2902,74952,92,104522
2188,0.001522,172.31.47.0-255,66,75018,92,104522
2189,0.001529,172.217.26.0-255,4320,79338,92,104522
2190,0.001531,172.31.47.0-255,66,79404,92,104522
2191,0.001557,172.217.26.0-255,3122,82526,92,104522
2192,0.00156,172.31.47.0-255,66,82592,92,104522
2193,0.003412,172.217.26.0-255,1484,84076,92,104522
2194,0.003444,172.217.26.0-255,2902,86978,92,104522
2195,0.00345,172.31.47.0-255,66,87044,92,104522
2196,0.003478,172.217.26.0-255,1484,88528,92,104522
2197,0.005353,172.217.26.0-255,4320,92848,92,104522
2198,0.005359,172.31.47.0-255,66,92914,92,104522
2199,0.007278,172.217.26.0-255,5738,98652,92,104522
2200,0.007284,172.31.47.0-255,66,98718,92,104522
2201,0.009279,172.217.26.0-255,5738,104456,92,104522
2202,0.009289,172.31.47.0-255,66,104522,92,104522
2203,0.0,172.217.194.0-255,153,153,92,197301
2204,2.6e-05,172.31.47.0-255,66,219,92,197301
2205,3.3e-05,172.217.194.0-255,1484,1703,92,197301
2206,3.6e-05,172.31.47.0-255,66,1769,92,197301
2207,4.1e-05,172.217.194.0-255,2902,4671,92,197301
2208,4.3e-05,172.31.47.0-255,66,4737,92,197301
2209,5.6e-05,172.217.194.0-255,4320,9057,92,197301
2210,5.9e-05,172.31.47.0-255,66,9123,92,197301
2211,9.3e-05,172.217.194.0-255,2902,12025,92,197301
2212,9.6e-05,172.31.47.0-255,66,12091,92,197301
2213,0.000102,172.217.194.0-255,3592,15683,92,197301
2214,0.000104,172.31.47.0-255,66,15749,92,197301
2215,0.000123,172.31.47.0-255,66,15815,92,197301
2216,0.000127,172.217.194.0-255,2543,18358,92,197301
2217,0.00013,172.31.47.0-255,66,18424,92,197301
2218,0.000202,172.217.194.0-255,1484,19908,92,197301
2219,0.000205,172.31.47.0-255,66,19974,92,197301
2220,0.000222,172.217.194.0-255,2902,22876,92,197301
2221,0.000225,172.31.47.0-255,66,22942,92,197301
2222,0.000231,172.217.194.0-255,5738,28680,92,197301
2223,0.000233,172.31.47.0-255,66,28746,92,197301
2224,0.000277,172.217.194.0-255,7156,35902,92,197301
2225,0.000282,172.31.47.0-255,66,35968,92,197301
2226,0.000299,172.217.194.0-255,6797,42765,92,197301
2227,0.000306,172.31.47.0-255,66,42831,92,197301
2228,0.000317,172.31.47.0-255,66,42897,92,197301
2229,0.000338,172.217.194.0-255,1746,44643,92,197301
2230,0.000341,172.31.47.0-255,66,44709,92,197301
2231,0.000681,172.217.194.0-255,1484,46193,92,197301
2232,0.000685,172.217.194.0-255,1484,47677,92,197301
2233,0.000687,172.31.47.0-255,66,47743,92,197301
2234,0.000701,172.217.194.0-255,1484,49227,92,197301
2235,0.000708,172.31.47.0-255,66,49293,92,197301
2236,0.000714,172.217.194.0-255,5738,55031,92,197301
2237,0.000717,172.31.47.0-255,66,55097,92,197301
2238,0.000722,172.217.194.0-255,2902,57999,92,197301
2239,0.000724,172.31.47.0-255,66,58065,92,197301
2240,0.000761,172.31.47.0-255,66,58131,92,197301
2241,0.000774,172.31.47.0-255,66,58197,92,197301
2242,0.000808,172.31.47.0-255,66,58263,92,197301
2243,0.000843,172.31.47.0-255,66,58329,92,197301
2244,0.000846,172.217.194.0-255,1484,59813,92,197301
2245,0.00085,172.217.194.0-255,2902,62715,92,197301
2246,0.000852,172.31.47.0-255,66,62781,92,197301
2247,0.000857,172.217.194.0-255,2902,65683,92,197301
2248,0.000859,172.31.47.0-255,66,65749,92,197301
2249,0.000888,172.217.194.0-255,2902,68651,92,197301
2250,0.000892,172.31.47.0-255,66,68717,92,197301
2251,0.000898,172.217.194.0-255,5738,74455,92,197301
2252,0.000903,172.31.47.0-255,66,74521,92,197301
2253,0.000937,172.217.194.0-255,7156,81677,92,197301
2254,0.00094,172.31.47.0-255,66,81743,92,197301
2255,0.000951,172.31.47.0-255,66,81809,92,197301
2256,0.00096,172.217.194.0-255,766,82575,92,197301
2257,0.001029,172.217.194.0-255,1484,84059,92,197301
2258,0.001033,172.31.47.0-255,66,84125,92,197301
2259,0.001038,172.217.194.0-255,2902,87027,92,197301
2260,0.001041,172.31.47.0-255,66,87093,92,197301
2261,0.001076,172.217.194.0-255,5738,92831,92,197301
2262,0.001079,172.31.47.0-255,66,92897,92,197301
2263,0.001082,172.217.194.0-255,1484,94381,92,197301
2264,0.001107,172.217.194.0-255,5379,99760,92,197301
2265,0.00111,172.31.47.0-255,66,99826,92,197301
2266,0.001137,172.217.194.0-255,4320,104146,92,197301
2267,0.00114,172.31.47.0-255,66,104212,92,197301
2268,0.001167,172.217.194.0-255,1484,105696,92,197301
2269,0.001182,172.31.47.0-255,66,105762,92,197301
2270,0.001187,172.217.194.0-255,4320,110082,92,197301
2271,0.001189,172.31.47.0-255,66,110148,92,197301
2272,0.00123,172.217.194.0-255,766,110914,92,197301
2273,0.001233,172.31.47.0-255,66,110980,92,197301
2274,0.001456,172.217.194.0-255,1484,112464,92,197301
2275,0.00146,172.31.47.0-255,66,112530,92,197301
2276,0.001466,172.217.194.0-255,2902,115432,92,197301
2277,0.001468,172.31.47.0-255,66,115498,92,197301
2278,0.001498,172.217.194.0-255,5738,121236,92,197301
2279,0.001501,172.31.47.0-255,66,121302,92,197301
2280,0.00153,172.217.194.0-255,6797,128099,92,197301
2281,0.001533,172.31.47.0-255,66,128165,92,197301
2282,0.00163,172.217.194.0-255,1484,129649,92,197301
2283,0.001636,172.217.194.0-255,2902,132551,92,197301
2284,0.001639,172.31.47.0-255,66,132617,92,197301
2285,0.001643,172.217.194.0-255,1484,134101,92,197301
2286,0.001672,172.217.194.0-255,4320,138421,92,197301
2287,0.001676,172.31.47.0-255,66,138487,92,197301
2288,0.001682,172.217.194.0-255,7156,145643,92,197301
2289,0.001685,172.31.47.0-255,66,145709,92,197301
2290,0.001713,172.217.194.0-255,5738,151447,92,197301
2291,0.001716,172.31.47.0-255,66,151513,92,197301
2292,0.00175,172.31.47.0-255,66,151579,92,197301
2293,0.00176,172.217.194.0-255,2184,153763,92,197301
2294,0.001762,172.31.47.0-255,66,153829,92,197301
2295,0.002011,172.217.194.0-255,1484,155313,92,197301
2296,0.00203,172.217.194.0-255,2902,158215,92,197301
2297,0.002035,172.31.47.0-255,66,158281,92,197301
2298,0.002056,172.217.194.0-255,5738,164019,92,197301
2299,0.002058,172.31.47.0-255,66,164085,92,197301
2300,0.002079,172.217.194.0-255,7156,171241,92,197301
2301,0.002082,172.31.47.0-255,66,171307,92,197301
2302,0.002117,172.217.194.0-255,5738,177045,92,197301
2303,0.002121,172.31.47.0-255,66,177111,92,197301
2304,0.00213,172.31.47.0-255,66,177177,92,197301
2305,0.002138,172.217.194.0-255,2184,179361,92,197301
2306,0.00214,172.31.47.0-255,66,179427,92,197301
2307,0.004463,172.217.194.0-255,2902,182329,92,197301
2308,0.004469,172.31.47.0-255,66,182395,92,197301
2309,0.004494,172.217.194.0-255,2902,185297,92,197301
2310,0.004496,172.31.47.0-255,66,185363,92,197301
2311,0.006783,172.217.194.0-255,2902,188265,92,197301
2312,0.006786,172.31.47.0-255,66,188331,92,197301
2313,0.00681,172.217.194.0-255,1484,189815,92,197301
2314,0.006822,172.217.194.0-255,1484,191299,92,197301
2315,0.006825,172.31.47.0-255,66,191365,92,197301
2316,0.009094,172.217.194.0-255,2902,194267,92,197301
2317,0.009101,172.31.47.0-255,66,194333,92,197301
2318,0.009146,172.217.194.0-255,2902,197235,92,197301
2319,0.00915,172.31.47.0-255,66,197301,92,197301
2320,0.0,74.125.24.0-255,152,152,92,129234
2321,1.4e-05,172.31.47.0-255,66,218,92,129234
2322,2.1e-05,74.125.24.0-255,1484,1702,92,129234
2323,2.5e-05,172.31.47.0-255,66,1768,92,129234
2324,3.6e-05,74.125.24.0-255,2902,4670,92,129234
2325,3.9e-05,172.31.47.0-255,66,4736,92,129234
2326,4.7e-05,74.125.24.0-255,7156,11892,92,129234
2327,4.9e-05,172.31.47.0-255,66,11958,92,129234
2328,5.9e-05,172.31.47.0-255,66,12024,92,129234
2329,0.000107,74.125.24.0-255,4320,16344,92,129234
2330,0.00011,172.31.47.0-255,66,16410,92,129234
2331,0.000136,74.125.24.0-255,2902,19312,92,129234
2332,0.000138,172.31.47.0-255,66,19378,92,129234
2333,0.000143,74.125.24.0-255,3961,23339,92,129234
2334,0.000145,172.31.47.0-255,66,23405,92,129234
2335,0.000204,74.125.24.0-255,1484,24889,92,129234
2336,0.000207,172.31.47.0-255,66,24955,92,129234
2337,0.000211,74.125.24.0-255,2902,27857,92,129234
2338,0.000213,172.31.47.0-255,66,27923,92,129234
2339,0.000235,74.125.24.0-255,5738,33661,92,129234
2340,0.000237,172.31.47.0-255,66,33727,92,129234
2341,0.00027,172.31.47.0-255,66,33793,92,129234
2342,0.000296,74.125.24.0-255,5379,39172,92,129234
2343,0.000298,172.31.47.0-255,66,39238,92,129234
2344,0.000323,172.31.47.0-255,66,39304,92,129234
2345,0.000737,74.125.24.0-255,129,39433,92,129234
2346,0.000742,172.31.47.0-255,66,39499,92,129234
2347,0.000768,74.125.24.0-255,343,39842,92,129234
2348,0.000771,172.31.47.0-255,66,39908,92,129234
2349,0.000932,74.125.24.0-255,1484,41392,92,129234
2350,0.000945,74.125.24.0-255,1484,42876,92,129234
2351,0.000948,172.31.47.0-255,66,42942,92,129234
2352,0.000965,74.125.24.0-255,1484,44426,92,129234
2353,0.000971,74.125.24.0-255,4320,48746,92,129234
2354,0.000973,172.31.47.0-255,66,48812,92,129234
2355,0.000984,74.125.24.0-255,1484,50296,92,129234
2356,0.000994,74.125.24.0-255,5738,56034,92,129234
2357,0.000997,172.31.47.0-255,66,56100,92,129234
2358,0.001026,74.125.24.0-255,5738,61838,92,129234
2359,0.001028,172.31.47.0-255,66,61904,92,129234
2360,0.001061,172.31.47.0-255,66,61970,92,129234
2361,0.00109,74.125.24.0-255,2184,64154,92,129234
2362,0.001093,172.31.47.0-255,66,64220,92,129234
2363,0.001187,74.125.24.0-255,1484,65704,92,129234
2364,0.001201,74.125.24.0-255,2902,68606,92,129234
2365,0.001204,172.31.47.0-255,66,68672,92,129234
2366,0.001211,74.125.24.0-255,5738,74410,92,129234
2367,0.001213,172.31.47.0-255,66,74476,92,129234
2368,0.001233,74.125.24.0-255,4320,78796,92,129234
2369,0.001235,172.31.47.0-255,66,78862,92,129234
2370,0.001274,172.31.47.0-255,66,78928,92,129234
2371,0.001278,74.125.24.0-255,2902,81830,92,129234
2372,0.00128,172.31.47.0-255,66,81896,92,129234
2373,0.00131,74.125.24.0-255,7156,89052,92,129234
2374,0.001312,172.31.47.0-255,66,89118,92,129234
2375,0.001315,74.125.24.0-255,766,89884,92,129234
2376,0.001568,74.125.24.0-255,1484,91368,92,129234
2377,0.001572,172.31.47.0-255,66,91434,92,129234
2378,0.001576,74.125.24.0-255,1484,92918,92,129234
2379,0.001598,74.125.24.0-255,1484,94402,92,129234
2380,0.0016,172.31.47.0-255,66,94468,92,129234
2381,0.001606,74.125.24.0-255,5738,100206,92,129234
2382,0.001608,172.31.47.0-255,66,100272,92,129234
2383,0.001639,74.125.24.0-255,7156,107428,92,129234
2384,0.001642,172.31.47.0-255,66,107494,92,129234
2385,0.00167,74.125.24.0-255,2902,110396,92,129234
2386,0.001672,172.31.47.0-255,66,110462,92,129234
2387,0.001693,172.31.47.0-255,66,110528,92,129234
2388,0.001709,74.125.24.0-255,766,111294,92,129234
2389,0.002128,172.31.47.0-255,66,111360,92,129234
2390,0.003756,74.125.24.0-255,2902,114262,92,129234
2391,0.003763,172.31.47.0-255,66,114328,92,129234
2392,0.003791,74.125.24.0-255,1484,115812,92,129234
2393,0.004165,74.125.24.0-255,1484,117296,92,129234
2394,0.004168,172.31.47.0-255,66,117362,92,129234
2395,0.005907,74.125.24.0-255,2902,120264,92,129234
2396,0.00591,172.31.47.0-255,66,120330,92,129234
2397,0.006256,74.125.24.0-255,2902,123232,92,129234
2398,0.006258,172.31.47.0-255,66,123298,92,129234
2399,0.007977,74.125.24.0-255,2902,126200,92,129234
2400,0.007984,172.31.47.0-255,66,126266,92,129234
2401,0.008311,74.125.24.0-255,2902,129168,92,129234
2402,0.008317,172.31.47.0-255,66,129234,92,129234
2403,0.0,172.217.194.0-255,298,298,92,180245
2404,3.4e-05,172.31.47.0-255,66,364,92,180245
2405,4e-05,172.217.194.0-255,1484,1848,92,180245
2406,4.5e-05,172.31.47.0-255,66,1914,92,180245
2407,5e-05,172.217.194.0-255,4320,6234,92,180245
2408,5.3e-05,172.31.47.0-255,66,6300,92,180245
2409,0.0001,172.31.47.0-255,66,6366,92,180245
2410,0.000162,172.217.194.0-255,1484,7850,92,180245
2411,0.000166,172.31.47.0-255,66,7916,92,180245
2412,0.000171,172.217.194.0-255,2902,10818,92,180245
2413,0.000173,172.31.47.0-255,66,10884,92,180245
2414,0.000176,172.217.194.0-255,1484,12368,92,180245
2415,0.000179,172.31.47.0-255,66,12434,92,180245
2416,0.0002,172.217.194.0-255,4320,16754,92,180245
2417,0.000202,172.31.47.0-255,66,16820,92,180245
2418,0.000221,172.217.194.0-255,4320,21140,92,180245
2419,0.000224,172.31.47.0-255,66,21206,92,180245
2420,0.000237,172.217.194.0-255,2543,23749,92,180245
2421,0.00024,172.31.47.0-255,66,23815,92,180245
2422,0.000328,172.217.194.0-255,1484,25299,92,180245
2423,0.000332,172.31.47.0-255,66,25365,92,180245
2424,0.000338,172.217.194.0-255,2902,28267,92,180245
2425,0.000341,172.31.47.0-255,66,28333,92,180245
2426,0.000347,172.217.194.0-255,4320,32653,92,180245
2427,0.000349,172.31.47.0-255,66,32719,92,180245
2428,0.000366,172.217.194.0-255,1484,34203,92,180245
2429,0.000368,172.31.47.0-255,66,34269,92,180245
2430,0.000387,172.217.194.0-255,4320,38589,92,180245
2431,0.00039,172.31.47.0-255,66,38655,92,180245
2432,0.000419,172.31.47.0-255,66,38721,92,180245
2433,0.000423,172.217.194.0-255,2902,41623,92,180245
2434,0.00043,172.217.194.0-255,4320,45943,92,180245
2435,0.00044,172.31.47.0-255,66,46009,92,180245
2436,0.000449,172.217.194.0-255,2862,48871,92,180245
2437,0.000457,172.31.47.0-255,66,48937,92,180245
2438,0.00069,172.217.194.0-255,366,49303,92,180245
2439,0.000848,172.31.47.0-255,66,49369,92,180245
2440,0.000909,172.217.194.0-255,1484,50853,92,180245
2441,0.000913,172.31.47.0-255,66,50919,92,180245
2442,0.00092,172.217.194.0-255,2902,53821,92,180245
2443,0.000945,172.217.194.0-255,5738,59559,92,180245
2444,0.000952,172.217.194.0-255,7156,66715,92,180245
2445,0.000962,172.217.194.0-255,1484,68199,92,180245
2446,0.000991,172.217.194.0-255,2184,70383,92,180245
2447,0.001873,172.217.194.0-255,1484,71867,92,180245
2448,0.001881,172.217.194.0-255,2902,74769,92,180245
2449,0.001911,172.217.194.0-255,5738,80507,92,180245
2450,0.001919,172.217.194.0-255,7156,87663,92,180245
2451,0.001941,172.217.194.0-255,5738,93401,92,180245
2452,0.001944,172.217.194.0-255,1484,94885,92,180245
2453,0.001956,172.217.194.0-255,766,95651,92,180245
2454,0.001974,172.217.194.0-255,2902,98553,92,180245
2455,0.001977,172.217.194.0-255,1484,100037,92,180245
2456,0.002,172.217.194.0-255,5738,105775,92,180245
2457,0.002003,172.217.194.0-255,1484,107259,92,180245
2458,0.002028,172.217.194.0-255,7156,114415,92,180245
2459,0.002062,172.217.194.0-255,4320,118735,92,180245
2460,0.002117,172.217.194.0-255,5738,124473,92,180245
2461,0.002129,172.217.194.0-255,4320,128793,92,180245
2462,0.002145,172.217.194.0-255,5738,134531,92,180245
2463,0.002148,172.217.194.0-255,1484,136015,92,180245
2464,0.002199,172.217.194.0-255,7156,143171,92,180245
2465,0.002217,172.217.194.0-255,766,143937,92,180245
2466,0.002236,172.217.194.0-255,1484,145421,92,180245
2467,0.00224,172.217.194.0-255,2902,148323,92,180245
2468,0.002245,172.217.194.0-255,5738,154061,92,180245
2469,0.002248,172.217.194.0-255,1484,155545,92,180245
2470,0.00226,172.217.194.0-255,1484,157029,92,180245
2471,0.002276,172.217.194.0-255,2902,159931,92,180245
2472,0.002294,172.217.194.0-255,7156,167087,92,180245
2473,0.002306,172.217.194.0-255,1484,168571,92,180245
2474,0.004479,172.31.47.0-255,66,168637,92,180245
2475,0.006816,172.217.194.0-255,5738,174375,92,180245
2476,0.006823,172.31.47.0-255,66,174441,92,180245
2477,0.009126,172.217.194.0-255,5738,180179,92,180245
2478,0.009131,172.31.47.0-255,66,180245,92,180245
2479,0.0,172.31.47.0-255,105,105,92,105
2480,0.0,172.31.47.0-255,105,105,92,276
2481,0.001802,157.240.13.0-255,105,210,92,276
2482,0.001816,172.31.47.0-255,66,276,92,276
2483,0.0,172.217.194.0-255,153,153,92,200135
2484,2.7e-05,172.31.47.0-255,66,219,92,200135
2485,3.4e-05,172.217.194.0-255,1484,1703,92,200135
2486,3.8e-05,172.31.47.0-255,66,1769,92,200135
2487,4.3e-05,172.217.194.0-255,2902,4671,92,200135
2488,4.6e-05,172.31.47.0-255,66,4737,92,200135
2489,5.4e-05,172.217.194.0-255,7156,11893,92,200135
2490,5.6e-05,172.31.47.0-255,66,11959,92,200135
2491,8.3e-05,172.217.194.0-255,6264,18223,92,200135
2492,8.6e-05,172.31.47.0-255,66,18289,92,200135
2493,0.000121,172.217.194.0-255,2902,21191,92,200135
2494,0.000126,172.31.47.0-255,66,21257,92,200135
2495,0.000152,172.31.47.0-255,66,21323,92,200135
2496,0.000169,172.217.194.0-255,4320,25643,92,200135
2497,0.000171,172.31.47.0-255,66,25709,92,200135
2498,0.000178,172.217.194.0-255,5738,31447,92,200135
2499,0.000181,172.31.47.0-255,66,31513,92,200135
2500,0.000184,172.217.194.0-255,1484,32997,92,200135
2501,0.000186,172.31.47.0-255,66,33063,92,200135
2502,0.000208,172.31.47.0-255,66,33129,92,200135
2503,0.000248,172.31.47.0-255,66,33195,92,200135
2504,0.000609,172.217.194.0-255,118,33313,92,200135
2505,0.000613,172.31.47.0-255,66,33379,92,200135
2506,0.000679,172.217.194.0-255,1484,34863,92,200135
2507,0.000682,172.31.47.0-255,66,34929,92,200135
2508,0.000702,172.217.194.0-255,2902,37831,92,200135
2509,0.000704,172.31.47.0-255,66,37897,92,200135
2510,0.000708,172.217.194.0-255,1484,39381,92,200135
2511,0.00071,172.31.47.0-255,66,39447,92,200135
2512,0.000727,172.217.194.0-255,4320,43767,92,200135
2513,0.000734,172.217.194.0-255,7088,50855,92,200135
2514,0.000738,172.31.47.0-255,66,50921,92,200135
2515,0.000882,172.217.194.0-255,1484,52405,92,200135
2516,0.000889,172.217.194.0-255,2902,55307,92,200135
2517,0.000892,172.31.47.0-255,66,55373,92,200135
2518,0.000898,172.217.194.0-255,5738,61111,92,200135
2519,0.000942,172.217.194.0-255,1484,62595,92,200135
2520,0.000997,172.217.194.0-255,4320,66915,92,200135
2521,0.001011,172.217.194.0-255,5020,71935,92,200135
2522,0.00104,172.217.194.0-255,1484,73419,92,200135
2523,0.001089,172.217.194.0-255,5738,79157,92,200135
2524,0.001103,172.217.194.0-255,3602,82759,92,200135
2525,0.001141,172.217.194.0-255,1484,84243,92,200135
2526,0.001147,172.217.194.0-255,2902,87145,92,200135
2527,0.001166,172.217.194.0-255,5738,92883,92,200135
2528,0.001194,172.217.194.0-255,2902,95785,92,200135
2529,0.001217,172.217.194.0-255,5738,101523,92,200135
2530,0.001239,172.217.194.0-255,1484,103007,92,200135
2531,0.00125,172.217.194.0-255,3602,106609,92,200135
2532,0.001331,172.217.194.0-255,1484,108093,92,200135
2533,0.001336,172.217.194.0-255,2902,110995,92,200135
2534,0.001352,172.217.194.0-255,5738,116733,92,200135
2535,0.001375,172.217.194.0-255,5738,122471,92,200135
2536,0.001396,172.217.194.0-255,7156,129627,92,200135
2537,0.001443,172.217.194.0-255,2902,132529,92,200135
2538,0.001468,172.217.194.0-255,7156,139685,92,200135
2539,0.001513,172.217.194.0-255,5738,145423,92,200135
2540,0.001525,172.217.194.0-255,5738,151161,92,200135
2541,0.001612,172.217.194.0-255,2902,154063,92,200135
2542,0.001674,172.217.194.0-255,4320,158383,92,200135
2543,0.00168,172.217.194.0-255,5738,164121,92,200135
2544,0.001745,172.217.194.0-255,6438,170559,92,200135
2545,0.001752,172.217.194.0-255,7156,177715,92,200135
2546,0.001769,172.217.194.0-255,5020,182735,92,200135
2547,0.001809,172.217.194.0-255,4320,187055,92,200135
2548,0.001855,172.217.194.0-255,1484,188539,92,200135
2549,0.001862,172.217.194.0-255,7156,195695,92,200135
2550,0.00188,172.217.194.0-255,4098,199793,92,200135
2551,0.001883,172.217.194.0-255,105,199898,92,200135
2552,0.002082,172.31.47.0-255,66,199964,92,200135
2553,0.004416,172.31.47.0-255,105,200069,92,200135
2554,0.006657,172.217.194.0-255,66,200135,92,200135
2555,0.0,172.217.194.0-255,153,153,92,179310
2556,2.7e-05,172.31.47.0-255,66,219,92,179310
2557,3.4e-05,172.217.194.0-255,1484,1703,92,179310
2558,3.9e-05,172.31.47.0-255,66,1769,92,179310
2559,4.4e-05,172.217.194.0-255,2902,4671,92,179310
2560,4.6e-05,172.31.47.0-255,66,4737,92,179310
2561,5.2e-05,172.217.194.0-255,7156,11893,92,179310
2562,5.5e-05,172.31.47.0-255,66,11959,92,179310
2563,5.8e-05,172.217.194.0-255,1484,13443,92,179310
2564,6e-05,172.31.47.0-255,66,13509,92,179310
2565,9.7e-05,172.31.47.0-255,66,13575,92,179310
2566,0.000103,172.217.194.0-255,6797,20372,92,179310
2567,0.000106,172.31.47.0-255,66,20438,92,179310
2568,0.000202,172.217.194.0-255,1484,21922,92,179310
2569,0.000205,172.31.47.0-255,66,21988,92,179310
2570,0.000211,172.217.194.0-255,2902,24890,92,179310
2571,0.000213,172.31.47.0-255,66,24956,92,179310
2572,0.000216,172.217.194.0-255,1484,26440,92,179310
2573,0.000218,172.31.47.0-255,66,26506,92,179310
2574,0.000245,172.217.194.0-255,4320,30826,92,179310
2575,0.000251,172.31.47.0-255,66,30892,92,179310
2576,0.000252,172.217.194.0-255,6797,37689,92,179310
2577,0.000254,172.31.47.0-255,66,37755,92,179310
2578,0.000288,172.31.47.0-255,66,37821,92,179310
2579,0.000305,172.217.194.0-255,1484,39305,92,179310
2580,0.000309,172.31.47.0-255,66,39371,92,179310
2581,0.000313,172.217.194.0-255,2835,42206,92,179310
2582,0.000315,172.31.47.0-255,66,42272,92,179310
2583,0.000318,172.217.194.0-255,98,42370,92,179310
2584,0.00032,172.31.47.0-255,66,42436,92,179310
2585,0.000374,172.217.194.0-255,1484,43920,92,179310
2586,0.000381,172.217.194.0-255,2902,46822,92,179310
2587,0.000384,172.31.47.0-255,66,46888,92,179310
2588,0.000386,172.217.194.0-255,1484,48372,92,179310
2589,0.000426,172.217.194.0-255,5738,54110,92,179310
2590,0.00043,172.31.47.0-255,66,54176,92,179310
2591,0.000438,172.217.194.0-255,2902,57078,92,179310
2592,0.00044,172.31.47.0-255,66,57144,92,179310
2593,0.000471,172.31.47.0-255,66,57210,92,179310
2594,0.000486,172.217.194.0-255,5738,62948,92,179310
2595,0.000488,172.31.47.0-255,66,63014,92,179310
2596,0.00052,172.217.194.0-255,1484,64498,92,179310
2597,0.000534,172.217.194.0-255,3602,68100,92,179310
2598,0.000537,172.31.47.0-255,66,68166,92,179310
2599,0.000713,172.217.194.0-255,364,68530,92,179310
2600,0.000749,172.217.194.0-255,1484,70014,92,179310
2601,0.000752,172.31.47.0-255,66,70080,92,179310
2602,0.000757,172.217.194.0-255,4320,74400,92,179310
2603,0.000759,172.31.47.0-255,66,74466,92,179310
2604,0.000793,172.31.47.0-255,66,74532,92,179310
2605,0.000824,172.31.47.0-255,66,74598,92,179310
2606,0.000843,172.217.194.0-255,4320,78918,92,179310
2607,0.000846,172.31.47.0-255,66,78984,92,179310
2608,0.000848,172.217.194.0-255,766,79750,92,179310
2609,0.000928,172.217.194.0-255,1484,81234,92,179310
2610,0.000932,172.31.47.0-255,66,81300,92,179310
2611,0.000947,172.217.194.0-255,2902,84202,92,179310
2612,0.000949,172.31.47.0-255,66,84268,92,179310
2613,0.000952,172.217.194.0-255,1484,85752,92,179310
2614,0.000976,172.217.194.0-255,2902,88654,92,179310
2615,0.000978,172.31.47.0-255,66,88720,92,179310
2616,0.000983,172.217.194.0-255,5738,94458,92,179310
2617,0.000985,172.31.47.0-255,66,94524,92,179310
2618,0.001012,172.31.47.0-255,66,94590,92,179310
2619,0.001023,172.217.194.0-255,1484,96074,92,179310
2620,0.00103,172.217.194.0-255,6438,102512,92,179310
2621,0.001032,172.31.47.0-255,66,102578,92,179310
2622,0.001067,172.217.194.0-255,1484,104062,92,179310
2623,0.001082,172.217.194.0-255,2902,106964,92,179310
2624,0.001085,172.31.47.0-255,66,107030,92,179310
2625,0.001091,172.217.194.0-255,5738,112768,92,179310
2626,0.001092,172.31.47.0-255,66,112834,92,179310
2627,0.001108,172.217.194.0-255,2902,115736,92,179310
2628,0.00111,172.31.47.0-255,66,115802,92,179310
2629,0.001133,172.31.47.0-255,66,115868,92,179310
2630,0.001166,172.217.194.0-255,2902,118770,92,179310
2631,0.001169,172.31.47.0-255,66,118836,92,179310
2632,0.0012,172.31.47.0-255,66,118902,92,179310
2633,0.001327,172.217.194.0-255,1484,120386,92,179310
2634,0.00134,172.217.194.0-255,2902,123288,92,179310
2635,0.001343,172.31.47.0-255,66,123354,92,179310
2636,0.001346,172.217.194.0-255,1484,124838,92,179310
2637,0.00137,172.217.194.0-255,4320,129158,92,179310
2638,0.001374,172.31.47.0-255,66,129224,92,179310
2639,0.001374,172.217.194.0-255,5738,134962,92,179310
2640,0.001377,172.31.47.0-255,66,135028,92,179310
2641,0.001394,172.217.194.0-255,4320,139348,92,179310
2642,0.001397,172.31.47.0-255,66,139414,92,179310
2643,0.001426,172.31.47.0-255,66,139480,92,179310
2644,0.001435,172.31.47.0-255,66,139546,92,179310
2645,0.001462,172.217.194.0-255,2902,142448,92,179310
2646,0.001465,172.31.47.0-255,66,142514,92,179310
2647,0.001504,172.31.47.0-255,66,142580,92,179310
2648,0.00151,172.217.194.0-255,5738,148318,92,179310
2649,0.001517,172.31.47.0-255,66,148384,92,179310
2650,0.001524,172.217.194.0-255,2184,150568,92,179310
2651,0.001526,172.31.47.0-255,66,150634,92,179310
2652,0.001539,172.217.194.0-255,4320,154954,92,179310
2653,0.001541,172.31.47.0-255,66,155020,92,179310
2654,0.001601,172.31.47.0-255,66,155086,92,179310
2655,0.001633,172.217.194.0-255,1484,156570,92,179310
2656,0.001651,172.31.47.0-255,66,156636,92,179310
2657,0.001683,172.31.47.0-255,66,156702,92,179310
2658,0.001709,172.31.47.0-255,66,156768,92,179310
2659,0.001751,172.217.194.0-255,7156,163924,92,179310
2660,0.001754,172.31.47.0-255,66,163990,92,179310
2661,0.001778,172.217.194.0-255,766,164756,92,179310
2662,0.001797,172.31.47.0-255,66,164822,92,179310
2663,0.001816,172.217.194.0-255,6438,171260,92,179310
2664,0.001819,172.31.47.0-255,66,171326,92,179310
2665,0.001865,172.217.194.0-255,7156,178482,92,179310
2666,0.001868,172.31.47.0-255,66,178548,92,179310
2667,0.001914,172.31.47.0-255,66,178614,92,179310
2668,0.001986,172.31.47.0-255,66,178680,92,179310
2669,0.001989,172.217.194.0-255,105,178785,92,179310
2670,0.003083,172.31.47.0-255,105,178890,92,179310
2671,0.003267,172.31.47.0-255,90,178980,92,179310
2672,0.003275,172.31.47.0-255,66,179046,92,179310
2673,0.005659,172.217.194.0-255,66,179112,92,179310
2674,0.005816,172.217.194.0-255,66,179178,92,179310
2675,0.00585,172.217.194.0-255,66,179244,92,179310
2676,0.005855,172.31.47.0-255,66,179310,92,179310
2677,0.0,74.125.68.0-255,153,153,92,240853
2678,2.3e-05,172.31.47.0-255,66,219,92,240853
2679,3.1e-05,74.125.68.0-255,1484,1703,92,240853
2680,3.6e-05,172.31.47.0-255,66,1769,92,240853
2681,6.9e-05,74.125.68.0-255,2902,4671,92,240853
2682,7.2e-05,172.31.47.0-255,66,4737,92,240853
2683,7.7e-05,74.125.68.0-255,4320,9057,92,240853
2684,8.4e-05,172.31.47.0-255,66,9123,92,240853
2685,9.2e-05,74.125.68.0-255,4776,13899,92,240853
2686,9.5e-05,172.31.47.0-255,66,13965,92,240853
2687,0.000125,74.125.68.0-255,1484,15449,92,240853
2688,0.000128,172.31.47.0-255,66,15515,92,240853
2689,0.000132,74.125.68.0-255,2902,18417,92,240853
2690,0.000135,172.31.47.0-255,66,18483,92,240853
2691,0.000157,74.125.68.0-255,5738,24221,92,240853
2692,0.00016,172.31.47.0-255,66,24287,92,240853
2693,0.000169,74.125.68.0-255,4320,28607,92,240853
2694,0.000172,172.31.47.0-255,66,28673,92,240853
2695,0.000217,74.125.68.0-255,2543,31216,92,240853
2696,0.00022,172.31.47.0-255,66,31282,92,240853
2697,0.000287,74.125.68.0-255,1484,32766,92,240853
2698,0.000289,172.31.47.0-255,66,32832,92,240853
2699,0.000315,74.125.68.0-255,2902,35734,92,240853
2700,0.000318,172.31.47.0-255,66,35800,92,240853
2701,0.00032,74.125.68.0-255,1484,37284,92,240853
2702,0.000322,172.31.47.0-255,66,37350,92,240853
2703,0.000326,74.125.68.0-255,2902,40252,92,240853
2704,0.000329,172.31.47.0-255,66,40318,92,240853
2705,0.000365,74.125.68.0-255,5738,46056,92,240853
2706,0.000368,172.31.47.0-255,66,46122,92,240853
2707,0.000372,74.125.68.0-255,2902,49024,92,240853
2708,0.000374,172.31.47.0-255,66,49090,92,240853
2709,0.000407,74.125.68.0-255,2543,51633,92,240853
2710,0.00043,74.125.68.0-255,5738,57371,92,240853
2711,0.000441,74.125.68.0-255,109,57480,92,240853
2712,0.000573,74.125.68.0-255,1484,58964,92,240853
2713,0.000585,172.31.47.0-255,66,59030,92,240853
2714,0.00059,74.125.68.0-255,2902,61932,92,240853
2715,0.000596,172.31.47.0-255,66,61998,92,240853
2716,0.000637,74.125.68.0-255,5738,67736,92,240853
2717,0.000644,74.125.68.0-255,4320,72056,92,240853
2718,0.00065,74.125.68.0-255,5379,77435,92,240853
2719,0.000674,74.125.68.0-255,2902,80337,92,240853
2720,0.000692,74.125.68.0-255,4320,84657,92,240853
2721,0.000728,74.125.68.0-255,5738,90395,92,240853
2722,0.000743,74.125.68.0-255,1370,91765,92,240853
2723,0.000943,172.31.47.0-255,66,91831,92,240853
2724,0.000993,74.125.68.0-255,1484,93315,92,240853
2725,0.001014,74.125.68.0-255,2902,96217,92,240853
2726,0.001019,74.125.68.0-255,2902,99119,92,240853
2727,0.001034,172.31.47.0-255,66,99185,92,240853
2728,0.001062,74.125.68.0-255,4320,103505,92,240853
2729,0.001066,74.125.68.0-255,1484,104989,92,240853
2730,0.001079,172.31.47.0-255,66,105055,92,240853
2731,0.001088,74.125.68.0-255,2902,107957,92,240853
2732,0.001094,172.31.47.0-255,66,108023,92,240853
2733,0.001118,74.125.68.0-255,5738,113761,92,240853
2734,0.001126,74.125.68.0-255,7156,120917,92,240853
2735,0.001145,172.31.47.0-255,66,120983,92,240853
2736,0.001183,74.125.68.0-255,4320,125303,92,240853
2737,0.001192,172.31.47.0-255,66,125369,92,240853
2738,0.001196,74.125.68.0-255,766,126135,92,240853
2739,0.001388,74.125.68.0-255,1484,127619,92,240853
2740,0.001398,172.31.47.0-255,66,127685,92,240853
2741,0.001404,74.125.68.0-255,2902,130587,92,240853
2742,0.001408,172.31.47.0-255,66,130653,92,240853
2743,0.001427,74.125.68.0-255,5738,136391,92,240853
2744,0.001429,74.125.68.0-255,1484,137875,92,240853
2745,0.001452,74.125.68.0-255,2902,140777,92,240853
2746,0.00146,74.125.68.0-255,5738,146515,92,240853
2747,0.001484,74.125.68.0-255,4320,150835,92,240853
2748,0.00149,172.31.47.0-255,66,150901,92,240853
2749,0.0015,74.125.68.0-255,1484,152385,92,240853
2750,0.001533,74.125.68.0-255,7156,159541,92,240853
2751,0.001536,74.125.68.0-255,766,160307,92,240853
2752,0.001551,172.31.47.0-255,66,160373,92,240853
2753,0.00158,74.125.68.0-255,4320,164693,92,240853
2754,0.001591,172.31.47.0-255,66,164759,92,240853
2755,0.001602,74.125.68.0-255,5738,170497,92,240853
2756,0.001617,74.125.68.0-255,4320,174817,92,240853
2757,0.001624,172.31.47.0-255,66,174883,92,240853
2758,0.001647,74.125.68.0-255,2902,177785,92,240853
2759,0.001652,172.31.47.0-255,66,177851,92,240853
2760,0.001695,172.31.47.0-255,66,177917,92,240853
2761,0.00172,74.125.68.0-255,3602,181519,92,240853
2762,0.001728,172.31.47.0-255,66,181585,92,240853
2763,0.00177,74.125.68.0-255,1484,183069,92,240853
2764,0.001774,74.125.68.0-255,1484,184553,92,240853
2765,0.00179,172.31.47.0-255,66,184619,92,240853
2766,0.001793,74.125.68.0-255,1484,186103,92,240853
2767,0.001796,74.125.68.0-255,1484,187587,92,240853
2768,0.001799,74.125.68.0-255,2902,190489,92,240853
2769,0.001845,172.31.47.0-255,66,190555,92,240853
2770,0.001874,74.125.68.0-255,5738,196293,92,240853
2771,0.00188,74.125.68.0-255,4320,200613,92,240853
2772,0.001893,74.125.68.0-255,2902,203515,92,240853
2773,0.001896,74.125.68.0-255,2902,206417,92,240853
2774,0.001899,172.31.47.0-255,66,206483,92,240853
2775,0.001905,172.31.47.0-255,66,206549,92,240853
2776,0.001926,74.125.68.0-255,4320,210869,92,240853
2777,0.001943,172.31.47.0-255,66,210935,92,240853
2778,0.001957,74.125.68.0-255,5020,215955,92,240853
2779,0.00198,172.31.47.0-255,66,216021,92,240853
2780,0.002044,74.125.68.0-255,1484,217505,92,240853
2781,0.002064,74.125.68.0-255,2902,220407,92,240853
2782,0.002068,74.125.68.0-255,1484,221891,92,240853
2783,0.002079,74.125.68.0-255,1484,223375,92,240853
2784,0.00209,172.31.47.0-255,66,223441,92,240853
2785,0.00415,74.125.68.0-255,5738,229179,92,240853
2786,0.004157,172.31.47.0-255,66,229245,92,240853
2787,0.00621,74.125.68.0-255,5738,234983,92,240853
2788,0.00661,172.31.47.0-255,66,235049,92,240853
2789,0.008666,74.125.68.0-255,5738,240787,92,240853
2790,0.008672,172.31.47.0-255,66,240853,92,240853
2791,0.0,74.125.200.0-255,298,298,92,107549
2792,2.2e-05,172.31.47.0-255,66,364,92,107549
2793,2.8e-05,74.125.200.0-255,1484,1848,92,107549
2794,3.1e-05,172.31.47.0-255,66,1914,92,107549
2795,3.6e-05,74.125.200.0-255,4320,6234,92,107549
2796,3.9e-05,172.31.47.0-255,66,6300,92,107549
2797,5.1e-05,74.125.200.0-255,2902,9202,92,107549
2798,5.3e-05,172.31.47.0-255,66,9268,92,107549
2799,5.8e-05,74.125.200.0-255,4320,13588,92,107549
2800,6.1e-05,172.31.47.0-255,66,13654,92,107549
2801,9.2e-05,74.125.200.0-255,358,14012,92,107549
2802,9.8e-05,172.31.47.0-255,66,14078,92,107549
2803,0.000317,74.125.200.0-255,1484,15562,92,107549
2804,0.000323,172.31.47.0-255,66,15628,92,107549
2805,0.000327,74.125.200.0-255,1484,17112,92,107549
2806,0.000329,172.31.47.0-255,66,17178,92,107549
2807,0.000351,74.125.200.0-255,1484,18662,92,107549
2808,0.000354,172.31.47.0-255,66,18728,92,107549
2809,0.000358,74.125.200.0-255,2902,21630,92,107549
2810,0.00036,172.31.47.0-255,66,21696,92,107549
2811,0.000364,74.125.200.0-255,2902,24598,92,107549
2812,0.000366,172.31.47.0-255,66,24664,92,107549
2813,0.000394,74.125.200.0-255,1484,26148,92,107549
2814,0.000397,172.31.47.0-255,66,26214,92,107549
2815,0.000403,74.125.200.0-255,5379,31593,92,107549
2816,0.000405,172.31.47.0-255,66,31659,92,107549
2817,0.00102,74.125.200.0-255,1484,33143,92,107549
2818,0.001027,172.31.47.0-255,66,33209,92,107549
2819,0.001035,74.125.200.0-255,2902,36111,92,107549
2820,0.001037,172.31.47.0-255,66,36177,92,107549
2821,0.00105,74.125.200.0-255,5738,41915,92,107549
2822,0.001053,172.31.47.0-255,66,41981,92,107549
2823,0.001057,74.125.200.0-255,2902,44883,92,107549
2824,0.001059,172.31.47.0-255,66,44949,92,107549
2825,0.001084,74.125.200.0-255,2902,47851,92,107549
2826,0.001087,172.31.47.0-255,66,47917,92,107549
2827,0.001096,74.125.200.0-255,1484,49401,92,107549
2828,0.001115,74.125.200.0-255,5379,54780,92,107549
2829,0.001117,172.31.47.0-255,66,54846,92,107549
2830,0.001122,74.125.200.0-255,2902,57748,92,107549
2831,0.001124,172.31.47.0-255,66,57814,92,107549
2832,0.001177,74.125.200.0-255,5738,63552,92,107549
2833,0.001181,172.31.47.0-255,66,63618,92,107549
2834,0.001208,74.125.200.0-255,2856,66474,92,107549
2835,0.001211,172.31.47.0-255,66,66540,92,107549
2836,0.001214,74.125.200.0-255,109,66649,92,107549
2837,0.001249,74.125.200.0-255,330,66979,92,107549
2838,0.001482,74.125.200.0-255,1484,68463,92,107549
2839,0.001488,172.31.47.0-255,66,68529,92,107549
2840,0.001495,74.125.200.0-255,2902,71431,92,107549
2841,0.001497,172.31.47.0-255,66,71497,92,107549
2842,0.0015,74.125.200.0-255,1484,72981,92,107549
2843,0.001539,74.125.200.0-255,4320,77301,92,107549
2844,0.001543,172.31.47.0-255,66,77367,92,107549
2845,0.001549,74.125.200.0-255,4320,81687,92,107549
2846,0.001551,172.31.47.0-255,66,81753,92,107549
2847,0.001571,74.125.200.0-255,3961,85714,92,107549
2848,0.001574,172.31.47.0-255,66,85780,92,107549
2849,0.001605,74.125.200.0-255,4320,90100,92,107549
2850,0.001609,172.31.47.0-255,66,90166,92,107549
2851,0.001622,172.31.47.0-255,66,90232,92,107549
2852,0.001625,74.125.200.0-255,1125,91357,92,107549
2853,0.001985,172.31.47.0-255,66,91423,92,107549
2854,0.003891,74.125.200.0-255,4320,95743,92,107549
2855,0.003896,172.31.47.0-255,66,95809,92,107549
2856,0.004236,74.125.200.0-255,1484,97293,92,107549
2857,0.006165,74.125.200.0-255,4320,101613,92,107549
2858,0.006169,172.31.47.0-255,66,101679,92,107549
2859,0.00842,74.125.200.0-255,4320,105999,92,107549
2860,0.008426,172.31.47.0-255,66,106065,92,107549
2861,0.008454,74.125.200.0-255,1484,107549,92,107549
2862,0.0,74.125.24.0-255,153,153,92,116909
2863,2.9e-05,172.31.47.0-255,66,219,92,116909
2864,3.6e-05,74.125.24.0-255,1484,1703,92,116909
2865,4e-05,172.31.47.0-255,66,1769,92,116909
2866,6.2e-05,74.125.24.0-255,1484,3253,92,116909
2867,6.9e-05,172.31.47.0-255,66,3319,92,116909
2868,7.6e-05,74.125.24.0-255,2902,6221,92,116909
2869,8e-05,172.31.47.0-255,66,6287,92,116909
2870,8.7e-05,74.125.24.0-255,5738,12025,92,116909
2871,8.9e-05,172.31.47.0-255,66,12091,92,116909
2872,9.3e-05,74.125.24.0-255,2140,14231,92,116909
2873,9.5e-05,172.31.47.0-255,66,14297,92,116909
2874,0.000684,74.125.24.0-255,1484,15781,92,116909
2875,0.00069,172.31.47.0-255,66,15847,92,116909
2876,0.0007,74.125.24.0-255,2902,18749,92,116909
2877,0.000703,172.31.47.0-255,66,18815,92,116909
2878,0.000735,74.125.24.0-255,5738,24553,92,116909
2879,0.000738,172.31.47.0-255,66,24619,92,116909
2880,0.000778,172.31.47.0-255,66,24685,92,116909
2881,0.000806,74.125.24.0-255,1125,25810,92,116909
2882,0.000808,172.31.47.0-255,66,25876,92,116909
2883,0.000828,172.31.47.0-255,66,25942,92,116909
2884,0.000841,172.31.47.0-255,66,26008,92,116909
2885,0.000864,74.125.24.0-255,2184,28192,92,116909
2886,0.000867,172.31.47.0-255,66,28258,92,116909
2887,0.000925,74.125.24.0-255,357,28615,92,116909
2888,0.000928,172.31.47.0-255,66,28681,92,116909
2889,0.000939,74.125.24.0-255,386,29067,92,116909
2890,0.000946,172.31.47.0-255,66,29133,92,116909
2891,0.001163,74.125.24.0-255,1484,30617,92,116909
2892,0.00117,74.125.24.0-255,2902,33519,92,116909
2893,0.001175,172.31.47.0-255,66,33585,92,116909
2894,0.00118,74.125.24.0-255,2902,36487,92,116909
2895,0.001182,172.31.47.0-255,66,36553,92,116909
2896,0.001203,74.125.24.0-255,2902,39455,92,116909
2897,0.001205,172.31.47.0-255,66,39521,92,116909
2898,0.001216,74.125.24.0-255,7156,46677,92,116909
2899,0.001218,172.31.47.0-255,66,46743,92,116909
2900,0.001252,74.125.24.0-255,5738,52481,92,116909
2901,0.001255,172.31.47.0-255,66,52547,92,116909
2902,0.001262,74.125.24.0-255,7156,59703,92,116909
2903,0.001265,172.31.47.0-255,66,59769,92,116909
2904,0.001268,74.125.24.0-255,1484,61253,92,116909
2905,0.001288,74.125.24.0-255,2184,63437,92,116909
2906,0.00129,172.31.47.0-255,66,63503,92,116909
2907,0.001649,74.125.24.0-255,1484,64987,92,116909
2908,0.001654,74.125.24.0-255,2902,67889,92,116909
2909,0.001656,172.31.47.0-255,66,67955,92,116909
2910,0.001683,74.125.24.0-255,1484,69439,92,116909
2911,0.001702,74.125.24.0-255,4320,73759,92,116909
2912,0.001704,172.31.47.0-255,66,73825,92,116909
2913,0.001709,74.125.24.0-255,4320,78145,92,116909
2914,0.001711,172.31.47.0-255,66,78211,92,116909
2915,0.001752,172.31.47.0-255,66,78277,92,116909
2916,0.001756,74.125.24.0-255,2902,81179,92,116909
2917,0.001758,172.31.47.0-255,66,81245,92,116909
2918,0.001802,74.125.24.0-255,2902,84147,92,116909
2919,0.001804,172.31.47.0-255,66,84213,92,116909
2920,0.001822,74.125.24.0-255,2184,86397,92,116909
2921,0.001824,172.31.47.0-255,66,86463,92,116909
2922,0.002218,74.125.24.0-255,1484,87947,92,116909
2923,0.002222,74.125.24.0-255,2902,90849,92,116909
2924,0.002224,172.31.47.0-255,66,90915,92,116909
2925,0.00225,74.125.24.0-255,5738,96653,92,116909
2926,0.002253,172.31.47.0-255,66,96719,92,116909
2927,0.002263,172.31.47.0-255,66,96785,92,116909
2928,0.002302,172.31.47.0-255,66,96851,92,116909
2929,0.002322,74.125.24.0-255,2184,99035,92,116909
2930,0.002324,172.31.47.0-255,66,99101,92,116909
2931,0.004545,74.125.24.0-255,2902,102003,92,116909
2932,0.004555,172.31.47.0-255,66,102069,92,116909
2933,0.004582,74.125.24.0-255,2902,104971,92,116909
2934,0.004585,172.31.47.0-255,66,105037,92,116909
2935,0.006805,74.125.24.0-255,2902,107939,92,116909
2936,0.006822,172.31.47.0-255,66,108005,92,116909
2937,0.006866,74.125.24.0-255,2902,110907,92,116909
2938,0.006871,172.31.47.0-255,66,110973,92,116909
2939,0.009089,74.125.24.0-255,2902,113875,92,116909
2940,0.009103,172.31.47.0-255,66,113941,92,116909
2941,0.009134,74.125.24.0-255,2902,116843,92,116909
2942,0.009136,172.31.47.0-255,66,116909,92,116909
2943,0.0,172.253.118.0-255,153,153,92,148465
2944,2.1e-05,172.31.47.0-255,66,219,92,148465
2945,2.8e-05,172.253.118.0-255,1484,1703,92,148465
2946,3.3e-05,172.31.47.0-255,66,1769,92,148465
2947,3.8e-05,172.253.118.0-255,2902,4671,92,148465
2948,4.2e-05,172.31.47.0-255,66,4737,92,148465
2949,6.8e-05,172.253.118.0-255,1484,6221,92,148465
2950,7.2e-05,172.31.47.0-255,66,6287,92,148465
2951,7.9e-05,172.253.118.0-255,5738,12025,92,148465
2952,8.1e-05,172.31.47.0-255,66,12091,92,148465
2953,8.5e-05,172.253.118.0-255,2057,14148,92,148465
2954,8.8e-05,172.31.47.0-255,66,14214,92,148465
2955,0.00012,172.253.118.0-255,2902,17116,92,148465
2956,0.000123,172.31.47.0-255,66,17182,92,148465
2957,0.00014,172.253.118.0-255,2902,20084,92,148465
2958,0.000143,172.31.47.0-255,66,20150,92,148465
2959,0.00015,172.253.118.0-255,7156,27306,92,148465
2960,0.000152,172.31.47.0-255,66,27372,92,148465
2961,0.000179,172.253.118.0-255,3961,31333,92,148465
2962,0.000181,172.31.47.0-255,66,31399,92,148465
2963,0.000428,172.253.118.0-255,1484,32883,92,148465
2964,0.000434,172.31.47.0-255,66,32949,92,148465
2965,0.00044,172.253.118.0-255,2902,35851,92,148465
2966,0.000442,172.31.47.0-255,66,35917,92,148465
2967,0.000471,172.253.118.0-255,5738,41655,92,148465
2968,0.000474,172.31.47.0-255,66,41721,92,148465
2969,0.000503,172.253.118.0-255,5738,47459,92,148465
2970,0.000507,172.31.47.0-255,66,47525,92,148465
2971,0.000527,172.31.47.0-255,66,47591,92,148465
2972,0.000544,172.253.118.0-255,5738,53329,92,148465
2973,0.000546,172.31.47.0-255,66,53395,92,148465
2974,0.00057,172.253.118.0-255,3961,57356,92,148465
2975,0.000573,172.31.47.0-255,66,57422,92,148465
2976,0.000576,172.253.118.0-255,410,57832,92,148465
2977,0.000639,172.253.118.0-255,333,58165,92,148465
2978,0.001015,172.253.118.0-255,1484,59649,92,148465
2979,0.00102,172.31.47.0-255,66,59715,92,148465
2980,0.001039,172.253.118.0-255,2902,62617,92,148465
2981,0.001042,172.31.47.0-255,66,62683,92,148465
2982,0.001075,172.253.118.0-255,5738,68421,92,148465
2983,0.001078,172.31.47.0-255,66,68487,92,148465
2984,0.001085,172.253.118.0-255,5738,74225,92,148465
2985,0.001087,172.31.47.0-255,66,74291,92,148465
2986,0.00111,172.253.118.0-255,2902,77193,92,148465
2987,0.001112,172.31.47.0-255,66,77259,92,148465
2988,0.001136,172.253.118.0-255,7156,84415,92,148465
2989,0.001138,172.31.47.0-255,66,84481,92,148465
2990,0.001163,172.253.118.0-255,7156,91637,92,148465
2991,0.001165,172.31.47.0-255,66,91703,92,148465
2992,0.001179,172.253.118.0-255,766,92469,92,148465
2993,0.001371,172.31.47.0-255,66,92535,92,148465
2994,0.001489,172.253.118.0-255,1484,94019,92,148465
2995,0.001497,172.253.118.0-255,2902,96921,92,148465
2996,0.0015,172.31.47.0-255,66,96987,92,148465
2997,0.001505,172.253.118.0-255,2902,99889,92,148465
2998,0.001506,172.31.47.0-255,66,99955,92,148465
2999,0.001519,172.253.118.0-255,2902,102857,92,148465
3000,0.001521,172.31.47.0-255,66,102923,92,148465
3001,0.001541,172.253.118.0-255,4320,107243,92,148465
3002,0.001543,172.31.47.0-255,66,107309,92,148465
3003,0.00157,172.31.47.0-255,66,107375,92,148465
3004,0.001581,172.31.47.0-255,66,107441,92,148465
3005,0.001727,172.253.118.0-255,1484,108925,92,148465
3006,0.001732,172.253.118.0-255,1484,110409,92,148465
3007,0.001735,172.31.47.0-255,66,110475,92,148465
3008,0.001753,172.253.118.0-255,1484,111959,92,148465
3009,0.001759,172.253.118.0-255,5738,117697,92,148465
3010,0.001761,172.31.47.0-255,66,117763,92,148465
3011,0.001766,172.253.118.0-255,4320,122083,92,148465
3012,0.001768,172.31.47.0-255,66,122149,92,148465
3013,0.001816,172.253.118.0-255,2902,125051,92,148465
3014,0.001818,172.31.47.0-255,66,125117,92,148465
3015,0.001842,172.31.47.0-255,66,125183,92,148465
3016,0.001851,172.31.47.0-255,66,125249,92,148465
3017,0.00385,172.253.118.0-255,5738,130987,92,148465
3018,0.003857,172.31.47.0-255,66,131053,92,148465
3019,0.005883,172.253.118.0-255,5738,136791,92,148465
3020,0.005887,172.31.47.0-255,66,136857,92,148465
3021,0.007886,172.253.118.0-255,5738,142595,92,148465
3022,0.007893,172.31.47.0-255,66,142661,92,148465
3023,0.009905,172.253.118.0-255,5738,148399,92,148465
3024,0.009915,172.31.47.0-255,66,148465,92,148465
3025,0.0,74.125.24.0-255,153,153,92,188140
3026,3.4e-05,172.31.47.0-255,66,219,92,188140
3027,3.9e-05,74.125.24.0-255,1484,1703,92,188140
3028,4.4e-05,172.31.47.0-255,66,1769,92,188140
3029,4.9e-05,74.125.24.0-255,2902,4671,92,188140
3030,5.2e-05,172.31.47.0-255,66,4737,92,188140
3031,5.7e-05,74.125.24.0-255,4320,9057,92,188140
3032,5.9e-05,172.31.47.0-255,66,9123,92,188140
3033,6.6e-05,74.125.24.0-255,4923,14046,92,188140
3034,6.9e-05,172.31.47.0-255,66,14112,92,188140
3035,0.000257,74.125.24.0-255,1484,15596,92,188140
3036,0.000261,172.31.47.0-255,66,15662,92,188140
3037,0.000266,74.125.24.0-255,2902,18564,92,188140
3038,0.000268,172.31.47.0-255,66,18630,92,188140
3039,0.000292,74.125.24.0-255,5738,24368,92,188140
3040,0.000295,172.31.47.0-255,66,24434,92,188140
3041,0.000298,74.125.24.0-255,1484,25918,92,188140
3042,0.0003,172.31.47.0-255,66,25984,92,188140
3043,0.00032,74.125.24.0-255,5379,31363,92,188140
3044,0.000323,172.31.47.0-255,66,31429,92,188140
3045,0.000328,74.125.24.0-255,4320,35749,92,188140
3046,0.000331,172.31.47.0-255,66,35815,92,188140
3047,0.000358,74.125.24.0-255,2902,38717,92,188140
3048,0.000361,172.31.47.0-255,66,38783,92,188140
3049,0.000372,172.31.47.0-255,66,38849,92,188140
3050,0.000423,74.125.24.0-255,1484,40333,92,188140
3051,0.000426,172.31.47.0-255,66,40399,92,188140
3052,0.000444,74.125.24.0-255,2902,43301,92,188140
3053,0.000446,172.31.47.0-255,66,43367,92,188140
3054,0.000452,74.125.24.0-255,5738,49105,92,188140
3055,0.000454,172.31.47.0-255,66,49171,92,188140
3056,0.000457,74.125.24.0-255,1484,50655,92,188140
3057,0.000459,172.31.47.0-255,66,50721,92,188140
3058,0.000482,74.125.24.0-255,5658,56379,92,188140
3059,0.000485,172.31.47.0-255,66,56445,92,188140
3060,0.000488,74.125.24.0-255,127,56572,92,188140
3061,0.000489,172.31.47.0-255,66,56638,92,188140
3062,0.000508,74.125.24.0-255,346,56984,92,188140
3063,0.000512,172.31.47.0-255,66,57050,92,188140
3064,0.000819,74.125.24.0-255,1484,58534,92,188140
3065,0.000823,172.31.47.0-255,66,58600,92,188140
3066,0.000832,74.125.24.0-255,2902,61502,92,188140
3067,0.000834,172.31.47.0-255,66,61568,92,188140
3068,0.000838,74.125.24.0-255,2902,64470,92,188140
3069,0.00084,172.31.47.0-255,66,64536,92,188140
3070,0.000865,74.125.24.0-255,2902,67438,92,188140
3071,0.000868,172.31.47.0-255,66,67504,92,188140
3072,0.000879,172.31.47.0-255,66,67570,92,188140
3073,0.000897,74.125.24.0-255,1484,69054,92,188140
3074,0.000908,172.31.47.0-255,66,69120,92,188140
3075,0.00096,74.125.24.0-255,2184,71304,92,188140
3076,0.000964,172.31.47.0-255,66,71370,92,188140
3077,0.000982,74.125.24.0-255,2902,74272,92,188140
3078,0.000985,172.31.47.0-255,66,74338,92,188140
3079,0.00099,74.125.24.0-255,4320,78658,92,188140
3080,0.000992,172.31.47.0-255,66,78724,92,188140
3081,0.000995,74.125.24.0-255,2902,81626,92,188140
3082,0.000997,172.31.47.0-255,66,81692,92,188140
3083,0.001023,74.125.24.0-255,5738,87430,92,188140
3084,0.001025,172.31.47.0-255,66,87496,92,188140
3085,0.00104,74.125.24.0-255,5738,93234,92,188140
3086,0.001043,172.31.47.0-255,66,93300,92,188140
3087,0.001062,172.31.47.0-255,66,93366,92,188140
3088,0.001087,172.31.47.0-255,66,93432,92,188140
3089,0.001113,172.31.47.0-255,66,93498,92,188140
3090,0.001129,74.125.24.0-255,1484,94982,92,188140
3091,0.001145,74.125.24.0-255,7156,102138,92,188140
3092,0.001148,172.31.47.0-255,66,102204,92,188140
3093,0.001171,74.125.24.0-255,6438,108642,92,188140
3094,0.001174,172.31.47.0-255,66,108708,92,188140
3095,0.001366,74.125.24.0-255,1484,110192,92,188140
3096,0.001373,74.125.24.0-255,2902,113094,92,188140
3097,0.001378,172.31.47.0-255,66,113160,92,188140
3098,0.001383,74.125.24.0-255,1484,114644,92,188140
3099,0.001397,74.125.24.0-255,4320,118964,92,188140
3100,0.0014,172.31.47.0-255,66,119030,92,188140
3101,0.001428,172.31.47.0-255,66,119096,92,188140
3102,0.001465,74.125.24.0-255,4320,123416,92,188140
3103,0.001467,172.31.47.0-255,66,123482,92,188140
3104,0.001485,74.125.24.0-255,6438,129920,92,188140
3105,0.001487,172.31.47.0-255,66,129986,92,188140
3106,0.001567,74.125.24.0-255,1484,131470,92,188140
3107,0.001569,74.125.24.0-255,1484,132954,92,188140
3108,0.001571,172.31.47.0-255,66,133020,92,188140
3109,0.001587,74.125.24.0-255,1484,134504,92,188140
3110,0.001592,74.125.24.0-255,5738,140242,92,188140
3111,0.001594,172.31.47.0-255,66,140308,92,188140
3112,0.001597,74.125.24.0-255,1484,141792,92,188140
3113,0.001621,74.125.24.0-255,4320,146112,92,188140
3114,0.001636,74.125.24.0-255,2902,149014,92,188140
3115,0.001668,74.125.24.0-255,3602,152616,92,188140
3116,0.001936,74.125.24.0-255,1484,154100,92,188140
3117,0.001951,74.125.24.0-255,2902,157002,92,188140
3118,0.001965,74.125.24.0-255,5738,162740,92,188140
3119,0.001982,74.125.24.0-255,4320,167060,92,188140
3120,0.001995,74.125.24.0-255,1484,168544,92,188140
3121,0.002022,74.125.24.0-255,1484,170028,92,188140
3122,0.00204,74.125.24.0-255,6438,176466,92,188140
3123,0.00496,172.31.47.0-255,66,176532,92,188140
3124,0.00719,74.125.24.0-255,5738,182270,92,188140
3125,0.007198,172.31.47.0-255,66,182336,92,188140
3126,0.009417,74.125.24.0-255,5738,188074,92,188140
3127,0.009427,172.31.47.0-255,66,188140,92,188140
3128,0.0,172.217.194.0-255,153,153,92,307407
3129,2.6e-05,172.31.47.0-255,66,219,92,307407
3130,3.3e-05,172.217.194.0-255,1484,1703,92,307407
3131,3.6e-05,172.31.47.0-255,66,1769,92,307407
3132,4e-05,172.217.194.0-255,2902,4671,92,307407
3133,4.2e-05,172.31.47.0-255,66,4737,92,307407
3134,5.5e-05,172.217.194.0-255,7156,11893,92,307407
3135,5.7e-05,172.31.47.0-255,66,11959,92,307407
3136,7.9e-05,172.217.194.0-255,1484,13443,92,307407
3137,8.1e-05,172.31.47.0-255,66,13509,92,307407
3138,0.000119,172.31.47.0-255,66,13575,92,307407
3139,0.000123,172.217.194.0-255,2902,16477,92,307407
3140,0.000124,172.31.47.0-255,66,16543,92,307407
3141,0.000145,172.217.194.0-255,2543,19086,92,307407
3142,0.000148,172.31.47.0-255,66,19152,92,307407
3143,0.000188,172.217.194.0-255,1484,20636,92,307407
3144,0.00019,172.31.47.0-255,66,20702,92,307407
3145,0.000195,172.217.194.0-255,2902,23604,92,307407
3146,0.000197,172.31.47.0-255,66,23670,92,307407
3147,0.000199,172.217.194.0-255,1484,25154,92,307407
3148,0.000201,172.31.47.0-255,66,25220,92,307407
3149,0.000222,172.217.194.0-255,4320,29540,92,307407
3150,0.000224,172.31.47.0-255,66,29606,92,307407
3151,0.000252,172.217.194.0-255,4320,33926,92,307407
3152,0.000256,172.31.47.0-255,66,33992,92,307407
3153,0.000285,172.217.194.0-255,3961,37953,92,307407
3154,0.000287,172.31.47.0-255,66,38019,92,307407
3155,0.000296,172.31.47.0-255,66,38085,92,307407
3156,0.000307,172.217.194.0-255,7085,45170,92,307407
3157,0.000312,172.31.47.0-255,66,45236,92,307407
3158,0.000347,172.217.194.0-255,366,45602,92,307407
3159,0.000435,172.217.194.0-255,1484,47086,92,307407
3160,0.000438,172.31.47.0-255,66,47152,92,307407
3161,0.000443,172.217.194.0-255,2902,50054,92,307407
3162,0.000446,172.31.47.0-255,66,50120,92,307407
3163,0.000474,172.217.194.0-255,5738,55858,92,307407
3164,0.000477,172.31.47.0-255,66,55924,92,307407
3165,0.00051,172.31.47.0-255,66,55990,92,307407
3166,0.000538,172.217.194.0-255,3961,59951,92,307407
3167,0.00054,172.31.47.0-255,66,60017,92,307407
3168,0.000544,172.217.194.0-255,1484,61501,92,307407
3169,0.000567,172.217.194.0-255,5738,67239,92,307407
3170,0.000569,172.31.47.0-255,66,67305,92,307407
3171,0.000591,172.217.194.0-255,3961,71266,92,307407
3172,0.000594,172.31.47.0-255,66,71332,92,307407
3173,0.000676,172.217.194.0-255,1484,72816,92,307407
3174,0.000679,172.217.194.0-255,1484,74300,92,307407
3175,0.000682,172.31.47.0-255,66,74366,92,307407
3176,0.000692,172.217.194.0-255,1484,75850,92,307407
3177,0.000702,172.217.194.0-255,5738,81588,92,307407
3178,0.000704,172.31.47.0-255,66,81654,92,307407
3179,0.000742,172.31.47.0-255,66,81720,92,307407
3180,0.000747,172.217.194.0-255,5738,87458,92,307407
3181,0.000749,172.31.47.0-255,66,87524,92,307407
3182,0.000777,172.217.194.0-255,5020,92544,92,307407
3183,0.00078,172.31.47.0-255,66,92610,92,307407
3184,0.000859,172.217.194.0-255,1484,94094,92,307407
3185,0.000882,172.217.194.0-255,2902,96996,92,307407
3186,0.000885,172.31.47.0-255,66,97062,92,307407
3187,0.000897,172.217.194.0-255,4320,101382,92,307407
3188,0.000899,172.31.47.0-255,66,101448,92,307407
3189,0.000923,172.217.194.0-255,1484,102932,92,307407
3190,0.000929,172.217.194.0-255,7156,110088,92,307407
3191,0.000931,172.31.47.0-255,66,110154,92,307407
3192,0.000959,172.217.194.0-255,5738,115892,92,307407
3193,0.000962,172.31.47.0-255,66,115958,92,307407
3194,0.000989,172.31.47.0-255,66,116024,92,307407
3195,0.001295,172.217.194.0-255,1484,117508,92,307407
3196,0.001299,172.217.194.0-255,1484,118992,92,307407
3197,0.001302,172.31.47.0-255,66,119058,92,307407
3198,0.00132,172.217.194.0-255,1484,120542,92,307407
3199,0.001327,172.217.194.0-255,5738,126280,92,307407
3200,0.001329,172.31.47.0-255,66,126346,92,307407
3201,0.001355,172.217.194.0-255,2902,129248,92,307407
3202,0.001358,172.31.47.0-255,66,129314,92,307407
3203,0.001384,172.217.194.0-255,7156,136470,92,307407
3204,0.001387,172.31.47.0-255,66,136536,92,307407
3205,0.00139,172.217.194.0-255,1484,138020,92,307407
3206,0.001427,172.31.47.0-255,66,138086,92,307407
3207,0.00143,172.217.194.0-255,2184,140270,92,307407
3208,0.001432,172.31.47.0-255,66,140336,92,307407
3209,0.001893,172.217.194.0-255,1484,141820,92,307407
3210,0.001901,172.217.194.0-255,2902,144722,92,307407
3211,0.001905,172.31.47.0-255,66,144788,92,307407
3212,0.00191,172.217.194.0-255,2902,147690,92,307407
3213,0.001912,172.31.47.0-255,66,147756,92,307407
3214,0.001931,172.217.194.0-255,2902,150658,92,307407
3215,0.001937,172.31.47.0-255,66,150724,92,307407
3216,0.001956,172.217.194.0-255,7156,157880,92,307407
3217,0.001958,172.31.47.0-255,66,157946,92,307407
3218,0.001983,172.217.194.0-255,5738,163684,92,307407
3219,0.001986,172.31.47.0-255,66,163750,92,307407
3220,0.001992,172.217.194.0-255,7156,170906,92,307407
3221,0.001993,172.31.47.0-255,66,170972,92,307407
3222,0.002059,172.217.194.0-255,3602,174574,92,307407
3223,0.002063,172.31.47.0-255,66,174640,92,307407
3224,0.002557,172.217.194.0-255,1484,176124,92,307407
3225,0.002572,172.217.194.0-255,2902,179026,92,307407
3226,0.002573,172.31.47.0-255,66,179092,92,307407
3227,0.002598,172.217.194.0-255,5738,184830,92,307407
3228,0.0026,172.31.47.0-255,66,184896,92,307407
3229,0.002639,172.217.194.0-255,5738,190634,92,307407
3230,0.002641,172.31.47.0-255,66,190700,92,307407
3231,0.002667,172.217.194.0-255,4320,195020,92,307407
3232,0.002669,172.31.47.0-255,66,195086,92,307407
3233,0.002679,172.31.47.0-255,66,195152,92,307407
3234,0.002686,172.217.194.0-255,2184,197336,92,307407
3235,0.002687,172.31.47.0-255,66,197402,92,307407
3236,0.003054,172.217.194.0-255,1484,198886,92,307407
3237,0.003064,172.217.194.0-255,2902,201788,92,307407
3238,0.003066,172.31.47.0-255,66,201854,92,307407
3239,0.003087,172.217.194.0-255,2902,204756,92,307407
3240,0.00309,172.31.47.0-255,66,204822,92,307407
3241,0.003099,172.217.194.0-255,2902,207724,92,307407
3242,0.003101,172.31.47.0-255,66,207790,92,307407
3243,0.003107,172.217.194.0-255,2902,210692,92,307407
3244,0.003109,172.31.47.0-255,66,210758,92,307407
3245,0.003133,172.217.194.0-255,1484,212242,92,307407
3246,0.003139,172.217.194.0-255,5738,217980,92,307407
3247,0.00314,172.31.47.0-255,66,218046,92,307407
3248,0.003163,172.217.194.0-255,7156,225202,92,307407
3249,0.003165,172.31.47.0-255,66,225268,92,307407
3250,0.003176,172.217.194.0-255,2902,228170,92,307407
3251,0.003178,172.31.47.0-255,66,228236,92,307407
3252,0.0032,172.217.194.0-255,3602,231838,92,307407
3253,0.003202,172.31.47.0-255,66,231904,92,307407
3254,0.003223,172.217.194.0-255,5738,237642,92,307407
3255,0.003225,172.31.47.0-255,66,237708,92,307407
3256,0.003246,172.217.194.0-255,1484,239192,92,307407
3257,0.003255,172.31.47.0-255,66,239258,92,307407
3258,0.003265,172.217.194.0-255,1484,240742,92,307407
3259,0.003288,172.217.194.0-255,4320,245062,92,307407
3260,0.00329,172.31.47.0-255,66,245128,92,307407
3261,0.003323,172.31.47.0-255,66,245194,92,307407
3262,0.003343,172.217.194.0-255,1484,246678,92,307407
3263,0.003346,172.217.194.0-255,1484,248162,92,307407
3264,0.003347,172.31.47.0-255,66,248228,92,307407
3265,0.003366,172.217.194.0-255,1484,249712,92,307407
3266,0.003371,172.217.194.0-255,5738,255450,92,307407
3267,0.003373,172.31.47.0-255,66,255516,92,307407
3268,0.003378,172.217.194.0-255,5738,261254,92,307407
3269,0.00338,172.31.47.0-255,66,261320,92,307407
3270,0.003412,172.217.194.0-255,7156,268476,92,307407
3271,0.003414,172.31.47.0-255,66,268542,92,307407
3272,0.003449,172.217.194.0-255,1484,270026,92,307407
3273,0.003462,172.217.194.0-255,1484,271510,92,307407
3274,0.003482,172.217.194.0-255,1484,272994,92,307407
3275,0.003488,172.217.194.0-255,5738,278732,92,307407
3276,0.003492,172.217.194.0-255,4320,283052,92,307407
3277,0.003514,172.217.194.0-255,1484,284536,92,307407
3278,0.003518,172.217.194.0-255,5738,290274,92,307407
3279,0.003537,172.217.194.0-255,3602,293876,92,307407
3280,0.003539,172.217.194.0-255,1484,295360,92,307407
3281,0.003557,172.217.194.0-255,1484,296844,92,307407
3282,0.003568,172.217.194.0-255,1484,298328,92,307407
3283,0.0036,172.217.194.0-255,4320,302648,92,307407
3284,0.003612,172.217.194.0-255,1484,304132,92,307407
3285,0.003615,172.217.194.0-255,2902,307034,92,307407
3286,0.003624,172.217.194.0-255,97,307131,92,307407
3287,0.003664,172.217.194.0-255,105,307236,92,307407
3288,0.006458,172.31.47.0-255,66,307302,92,307407
3289,0.008266,172.31.47.0-255,105,307407,92,307407
3290,0.0,172.217.194.0-255,298,298,92,122659
3291,2.4e-05,172.31.47.0-255,66,364,92,122659
3292,2.9e-05,172.217.194.0-255,1484,1848,92,122659
3293,3.2e-05,172.31.47.0-255,66,1914,92,122659
3294,3.7e-05,172.217.194.0-255,4320,6234,92,122659
3295,3.9e-05,172.31.47.0-255,66,6300,92,122659
3296,4.1e-05,172.217.194.0-255,1484,7784,92,122659
3297,4.4e-05,172.31.47.0-255,66,7850,92,122659
3298,6.5e-05,172.217.194.0-255,6034,13884,92,122659
3299,6.7e-05,172.31.47.0-255,66,13950,92,122659
3300,7e-05,172.217.194.0-255,1484,15434,92,122659
3301,7.1e-05,172.31.47.0-255,66,15500,92,122659
3302,9.6e-05,172.31.47.0-255,66,15566,92,122659
3303,0.000108,172.217.194.0-255,2902,18468,92,122659
3304,0.00011,172.31.47.0-255,66,18534,92,122659
3305,0.000114,172.217.194.0-255,2543,21077,92,122659
3306,0.000116,172.31.47.0-255,66,21143,92,122659
3307,0.00017,172.217.194.0-255,1484,22627,92,122659
3308,0.000173,172.31.47.0-255,66,22693,92,122659
3309,0.000177,172.217.194.0-255,2902,25595,92,122659
3310,0.000179,172.31.47.0-255,66,25661,92,122659
3311,0.000183,172.217.194.0-255,4320,29981,92,122659
3312,0.000185,172.31.47.0-255,66,30047,92,122659
3313,0.000199,172.217.194.0-255,1484,31531,92,122659
3314,0.000201,172.31.47.0-255,66,31597,92,122659
3315,0.000206,172.217.194.0-255,5738,37335,92,122659
3316,0.000208,172.31.47.0-255,66,37401,92,122659
3317,0.000229,172.217.194.0-255,1125,38526,92,122659
3318,0.00023,172.31.47.0-255,66,38592,92,122659
3319,0.00034,172.217.194.0-255,1484,40076,92,122659
3320,0.000343,172.31.47.0-255,66,40142,92,122659
3321,0.000348,172.217.194.0-255,2902,43044,92,122659
3322,0.00035,172.31.47.0-255,66,43110,92,122659
3323,0.000354,172.217.194.0-255,4320,47430,92,122659
3324,0.000356,172.31.47.0-255,66,47496,92,122659
3325,0.000378,172.217.194.0-255,1484,48980,92,122659
3326,0.000422,172.217.194.0-255,6797,55777,92,122659
3327,0.000425,172.31.47.0-255,66,55843,92,122659
3328,0.000693,172.217.194.0-255,648,56491,92,122659
3329,0.000727,172.31.47.0-255,66,56557,92,122659
3330,0.000897,172.217.194.0-255,1484,58041,92,122659
3331,0.000905,172.217.194.0-255,2902,60943,92,122659
3332,0.000909,172.31.47.0-255,66,61009,92,122659
3333,0.000931,172.217.194.0-255,5738,66747,92,122659
3334,0.000934,172.31.47.0-255,66,66813,92,122659
3335,0.00095,172.217.194.0-255,1484,68297,92,122659
3336,0.000966,172.217.194.0-255,7156,75453,92,122659
3337,0.000968,172.31.47.0-255,66,75519,92,122659
3338,0.000994,172.217.194.0-255,1484,77003,92,122659
3339,0.001005,172.31.47.0-255,66,77069,92,122659
3340,0.001008,172.217.194.0-255,2184,79253,92,122659
3341,0.00101,172.31.47.0-255,66,79319,92,122659
3342,0.001823,172.217.194.0-255,1484,80803,92,122659
3343,0.001829,172.217.194.0-255,2902,83705,92,122659
3344,0.001832,172.31.47.0-255,66,83771,92,122659
3345,0.001837,172.217.194.0-255,2902,86673,92,122659
3346,0.001839,172.31.47.0-255,66,86739,92,122659
3347,0.001855,172.217.194.0-255,2902,89641,92,122659
3348,0.001857,172.31.47.0-255,66,89707,92,122659
3349,0.001914,172.31.47.0-255,66,89773,92,122659
3350,0.001919,172.217.194.0-255,5738,95511,92,122659
3351,0.001921,172.31.47.0-255,66,95577,92,122659
3352,0.001942,172.217.194.0-255,5020,100597,92,122659
3353,0.001944,172.31.47.0-255,66,100663,92,122659
3354,0.002643,172.217.194.0-255,1484,102147,92,122659
3355,0.00265,172.217.194.0-255,2902,105049,92,122659
3356,0.002654,172.31.47.0-255,66,105115,92,122659
3357,0.002657,172.217.194.0-255,1484,106599,92,122659
3358,0.002679,172.217.194.0-255,4320,110919,92,122659
3359,0.002682,172.31.47.0-255,66,110985,92,122659
3360,0.002685,172.217.194.0-255,1484,112469,92,122659
3361,0.005315,172.217.194.0-255,4320,116789,92,122659
3362,0.00532,172.31.47.0-255,66,116855,92,122659
3363,0.007952,172.217.194.0-255,5738,122593,92,122659
3364,0.007959,172.31.47.0-255,66,122659,92,122659
3365,0.0,172.217.194.0-255,153,153,92,170965
3366,4.3e-05,172.31.47.0-255,66,219,92,170965
3367,5e-05,172.217.194.0-255,1484,1703,92,170965
3368,5.3e-05,172.31.47.0-255,66,1769,92,170965
3369,8.7e-05,172.217.194.0-255,2902,4671,92,170965
3370,9e-05,172.31.47.0-255,66,4737,92,170965
3371,9.6e-05,172.217.194.0-255,4320,9057,92,170965
3372,0.0001,172.31.47.0-255,66,9123,92,170965
3373,0.000108,172.217.194.0-255,4945,14068,92,170965
3374,0.000109,172.31.47.0-255,66,14134,92,170965
3375,0.000119,172.31.47.0-255,66,14200,92,170965
3376,0.000132,172.31.47.0-255,66,14266,92,170965
3377,0.000164,172.31.47.0-255,66,14332,92,170965
3378,0.000194,172.217.194.0-255,5020,19352,92,170965
3379,0.000198,172.31.47.0-255,66,19418,92,170965
3380,0.000255,172.217.194.0-255,1484,20902,92,170965
3381,0.000258,172.31.47.0-255,66,20968,92,170965
3382,0.000262,172.217.194.0-255,2902,23870,92,170965
3383,0.000264,172.31.47.0-255,66,23936,92,170965
3384,0.000268,172.217.194.0-255,2902,26838,92,170965
3385,0.000275,172.31.47.0-255,66,26904,92,170965
3386,0.000303,172.217.194.0-255,1484,28388,92,170965
3387,0.000309,172.31.47.0-255,66,28454,92,170965
3388,0.000315,172.217.194.0-255,5738,34192,92,170965
3389,0.000317,172.31.47.0-255,66,34258,92,170965
3390,0.000322,172.217.194.0-255,3123,37381,92,170965
3391,0.000323,172.31.47.0-255,66,37447,92,170965
3392,0.000352,172.217.194.0-255,4320,41767,92,170965
3393,0.000359,172.31.47.0-255,66,41833,92,170965
3394,0.000364,172.217.194.0-255,4320,46153,92,170965
3395,0.000366,172.31.47.0-255,66,46219,92,170965
3396,0.000394,172.217.194.0-255,5738,51957,92,170965
3397,0.000397,172.31.47.0-255,66,52023,92,170965
3398,0.000407,172.217.194.0-255,5738,57761,92,170965
3399,0.000409,172.31.47.0-255,66,57827,92,170965
3400,0.000437,172.217.194.0-255,2902,60729,92,170965
3401,0.000445,172.31.47.0-255,66,60795,92,170965
3402,0.000492,172.31.47.0-255,66,60861,92,170965
3403,0.000535,172.217.194.0-255,1484,62345,92,170965
3404,0.000555,172.217.194.0-255,2902,65247,92,170965
3405,0.000568,172.31.47.0-255,66,65313,92,170965
3406,0.000597,172.217.194.0-255,5738,71051,92,170965
3407,0.000605,172.31.47.0-255,66,71117,92,170965
3408,0.000653,172.31.47.0-255,66,71183,92,170965
3409,0.000677,172.217.194.0-255,2902,74085,92,170965
3410,0.00068,172.31.47.0-255,66,74151,92,170965
3411,0.000684,172.217.194.0-255,1484,75635,92,170965
3412,0.000713,172.31.47.0-255,66,75701,92,170965
3413,0.000845,172.217.194.0-255,1484,77185,92,170965
3414,0.000851,172.217.194.0-255,2902,80087,92,170965
3415,0.000854,172.31.47.0-255,66,80153,92,170965
3416,0.000857,172.217.194.0-255,1484,81637,92,170965
3417,0.000883,172.217.194.0-255,4320,85957,92,170965
3418,0.000891,172.31.47.0-255,66,86023,92,170965
3419,0.000896,172.31.47.0-255,66,86089,92,170965
3420,0.00092,172.217.194.0-255,4320,90409,92,170965
3421,0.000934,172.31.47.0-255,66,90475,92,170965
3422,0.000948,172.217.194.0-255,2902,93377,92,170965
3423,0.000958,172.31.47.0-255,66,93443,92,170965
3424,0.000987,172.31.47.0-255,66,93509,92,170965
3425,0.001079,172.217.194.0-255,1484,94993,92,170965
3426,0.001093,172.217.194.0-255,2902,97895,92,170965
3427,0.001097,172.31.47.0-255,66,97961,92,170965
3428,0.001125,172.217.194.0-255,2902,100863,92,170965
3429,0.001132,172.31.47.0-255,66,100929,92,170965
3430,0.00114,172.217.194.0-255,2902,103831,92,170965
3431,0.001148,172.31.47.0-255,66,103897,92,170965
3432,0.00115,172.217.194.0-255,5738,109635,92,170965
3433,0.001163,172.31.47.0-255,66,109701,92,170965
3434,0.001173,172.217.194.0-255,4320,114021,92,170965
3435,0.001184,172.31.47.0-255,66,114087,92,170965
3436,0.001197,172.217.194.0-255,5738,119825,92,170965
3437,0.001207,172.31.47.0-255,66,119891,92,170965
3438,0.001215,172.217.194.0-255,2902,122793,92,170965
3439,0.001223,172.31.47.0-255,66,122859,92,170965
3440,0.001242,172.217.194.0-255,5020,127879,92,170965
3441,0.001245,172.31.47.0-255,66,127945,92,170965
3442,0.001249,172.217.194.0-255,2902,130847,92,170965
3443,0.001261,172.31.47.0-255,66,130913,92,170965
3444,0.001307,172.31.47.0-255,66,130979,92,170965
3445,0.001351,172.217.194.0-255,5738,136717,92,170965
3446,0.00137,172.31.47.0-255,66,136783,92,170965
3447,0.001372,172.217.194.0-255,7156,143939,92,170965
3448,0.001376,172.31.47.0-255,66,144005,92,170965
3449,0.001425,172.31.47.0-255,66,144071,92,170965
3450,0.001453,172.31.47.0-255,66,144137,92,170965
3451,0.001521,172.31.47.0-255,66,144203,92,170965
3452,0.001537,172.217.194.0-255,5020,149223,92,170965
3453,0.001548,172.31.47.0-255,66,149289,92,170965
3454,0.0016,172.31.47.0-255,66,149355,92,170965
3455,0.00161,172.217.194.0-255,5738,155093,92,170965
3456,0.001617,172.31.47.0-255,66,155159,92,170965
3457,0.001661,172.217.194.0-255,5738,160897,92,170965
3458,0.001668,172.31.47.0-255,66,160963,92,170965
3459,0.001711,172.31.47.0-255,66,161029,92,170965
3460,0.001803,172.31.47.0-255,66,161095,92,170965
3461,0.001953,172.31.47.0-255,66,161161,92,170965
3462,0.001988,172.31.47.0-255,66,161227,92,170965
3463,0.002096,172.217.194.0-255,5738,166965,92,170965
3464,0.00211,172.31.47.0-255,66,167031,92,170965
3465,0.002173,172.31.47.0-255,66,167097,92,170965
3466,0.002342,172.217.194.0-255,3631,170728,92,170965
3467,0.002349,172.31.47.0-255,66,170794,92,170965
3468,0.003895,172.31.47.0-255,105,170899,92,170965
3469,0.006135,172.217.194.0-255,66,170965,92,170965
3470,0.0,172.217.194.0-255,153,153,92,222025
3471,2.4e-05,172.31.47.0-255,66,219,92,222025
3472,3e-05,172.217.194.0-255,1484,1703,92,222025
3473,3.4e-05,172.31.47.0-255,66,1769,92,222025
3474,3.8e-05,172.217.194.0-255,2902,4671,92,222025
3475,4e-05,172.31.47.0-255,66,4737,92,222025
3476,5.3e-05,172.217.194.0-255,7156,11893,92,222025
3477,5.6e-05,172.31.47.0-255,66,11959,92,222025
3478,6e-05,172.217.194.0-255,2065,14024,92,222025
3479,6.2e-05,172.31.47.0-255,66,14090,92,222025
3480,9.1e-05,172.217.194.0-255,1484,15574,92,222025
3481,9.4e-05,172.31.47.0-255,66,15640,92,222025
3482,0.000124,172.217.194.0-255,1484,17124,92,222025
3483,0.000127,172.31.47.0-255,66,17190,92,222025
3484,0.000134,172.217.194.0-255,7156,24346,92,222025
3485,0.000136,172.31.47.0-255,66,24412,92,222025
3486,0.000145,172.217.194.0-255,1484,25896,92,222025
3487,0.000147,172.31.47.0-255,66,25962,92,222025
3488,0.000178,172.217.194.0-255,2902,28864,92,222025
3489,0.000182,172.31.47.0-255,66,28930,92,222025
3490,0.000206,172.217.194.0-255,2543,31473,92,222025
3491,0.000209,172.31.47.0-255,66,31539,92,222025
3492,0.000212,172.217.194.0-255,1484,33023,92,222025
3493,0.000214,172.31.47.0-255,66,33089,92,222025
3494,0.000234,172.217.194.0-255,1484,34573,92,222025
3495,0.000238,172.31.47.0-255,66,34639,92,222025
3496,0.000269,172.217.194.0-255,1484,36123,92,222025
3497,0.000273,172.31.47.0-255,66,36189,92,222025
3498,0.000279,172.217.194.0-255,5738,41927,92,222025
3499,0.000283,172.31.47.0-255,66,41993,92,222025
3500,0.000302,172.31.47.0-255,66,42059,92,222025
3501,0.000315,172.31.47.0-255,66,42125,92,222025
3502,0.000319,172.217.194.0-255,3961,46086,92,222025
3503,0.000322,172.31.47.0-255,66,46152,92,222025
3504,0.00035,172.217.194.0-255,677,46829,92,222025
3505,0.000598,172.217.194.0-255,1484,48313,92,222025
3506,0.000602,172.31.47.0-255,66,48379,92,222025
3507,0.000607,172.217.194.0-255,2902,51281,92,222025
3508,0.00061,172.31.47.0-255,66,51347,92,222025
3509,0.000641,172.217.194.0-255,5738,57085,92,222025
3510,0.000645,172.31.47.0-255,66,57151,92,222025
3511,0.000648,172.217.194.0-255,1484,58635,92,222025
3512,0.000654,172.217.194.0-255,5738,64373,92,222025
3513,0.000663,172.31.47.0-255,66,64439,92,222025
3514,0.000681,172.217.194.0-255,2902,67341,92,222025
3515,0.000684,172.31.47.0-255,66,67407,92,222025
3516,0.000689,172.217.194.0-255,4320,71727,92,222025
3517,0.000691,172.31.47.0-255,66,71793,92,222025
3518,0.000725,172.31.47.0-255,66,71859,92,222025
3519,0.001069,172.217.194.0-255,1484,73343,92,222025
3520,0.001076,172.217.194.0-255,2902,76245,92,222025
3521,0.001079,172.31.47.0-255,66,76311,92,222025
3522,0.001085,172.217.194.0-255,4320,80631,92,222025
3523,0.001087,172.31.47.0-255,66,80697,92,222025
3524,0.001107,172.217.194.0-255,1484,82181,92,222025
3525,0.001124,172.31.47.0-255,66,82247,92,222025
3526,0.00115,172.217.194.0-255,7156,89403,92,222025
3527,0.001153,172.31.47.0-255,66,89469,92,222025
3528,0.001171,172.217.194.0-255,3602,93071,92,222025
3529,0.001173,172.31.47.0-255,66,93137,92,222025
3530,0.001286,172.217.194.0-255,1484,94621,92,222025
3531,0.001306,172.217.194.0-255,2902,97523,92,222025
3532,0.001309,172.31.47.0-255,66,97589,92,222025
3533,0.001313,172.217.194.0-255,2902,100491,92,222025
3534,0.001315,172.31.47.0-255,66,100557,92,222025
3535,0.001341,172.217.194.0-255,2902,103459,92,222025
3536,0.001343,172.31.47.0-255,66,103525,92,222025
3537,0.001358,172.31.47.0-255,66,103591,92,222025
3538,0.001363,172.217.194.0-255,4320,107911,92,222025
3539,0.001365,172.31.47.0-255,66,107977,92,222025
3540,0.001386,172.217.194.0-255,6438,114415,92,222025
3541,0.001393,172.31.47.0-255,66,114481,92,222025
3542,0.001413,172.217.194.0-255,1484,115965,92,222025
3543,0.001417,172.217.194.0-255,2902,118867,92,222025
3544,0.001419,172.31.47.0-255,66,118933,92,222025
3545,0.00145,172.217.194.0-255,5738,124671,92,222025
3546,0.001453,172.31.47.0-255,66,124737,92,222025
3547,0.001461,172.217.194.0-255,7156,131893,92,222025
3548,0.001462,172.31.47.0-255,66,131959,92,222025
3549,0.001481,172.217.194.0-255,2902,134861,92,222025
3550,0.001487,172.31.47.0-255,66,134927,92,222025
3551,0.001525,172.31.47.0-255,66,134993,92,222025
3552,0.001528,172.217.194.0-255,2184,137177,92,222025
3553,0.00153,172.31.47.0-255,66,137243,92,222025
3554,0.001547,172.217.194.0-255,2902,140145,92,222025
3555,0.001548,172.31.47.0-255,66,140211,92,222025
3556,0.001584,172.31.47.0-255,66,140277,92,222025
3557,0.001638,172.31.47.0-255,66,140343,92,222025
3558,0.001641,172.217.194.0-255,2184,142527,92,222025
3559,0.001643,172.31.47.0-255,66,142593,92,222025
3560,0.001662,172.217.194.0-255,1484,144077,92,222025
3561,0.001684,172.217.194.0-255,2902,146979,92,222025
3562,0.001686,172.31.47.0-255,66,147045,92,222025
3563,0.001691,172.217.194.0-255,5738,152783,92,222025
3564,0.001692,172.31.47.0-255,66,152849,92,222025
3565,0.001714,172.217.194.0-255,5738,158587,92,222025
3566,0.001717,172.31.47.0-255,66,158653,92,222025
3567,0.001741,172.217.194.0-255,7156,165809,92,222025
3568,0.001743,172.31.47.0-255,66,165875,92,222025
3569,0.001754,172.217.194.0-255,1484,167359,92,222025
3570,0.001776,172.217.194.0-255,5738,173097,92,222025
3571,0.001778,172.31.47.0-255,66,173163,92,222025
3572,0.001798,172.217.194.0-255,6438,179601,92,222025
3573,0.0018,172.31.47.0-255,66,179667,92,222025
3574,0.001804,172.217.194.0-255,4320,183987,92,222025
3575,0.001806,172.31.47.0-255,66,184053,92,222025
3576,0.00184,172.31.47.0-255,66,184119,92,222025
3577,0.001871,172.31.47.0-255,66,184185,92,222025
3578,0.001893,172.217.194.0-255,3602,187787,92,222025
3579,0.001895,172.31.47.0-255,66,187853,92,222025
3580,0.00192,172.217.194.0-255,1484,189337,92,222025
3581,0.00193,172.217.194.0-255,2902,192239,92,222025
3582,0.001932,172.31.47.0-255,66,192305,92,222025
3583,0.001954,172.217.194.0-255,5738,198043,92,222025
3584,0.001993,172.217.194.0-255,1484,199527,92,222025
3585,0.001995,172.217.194.0-255,1484,201011,92,222025
3586,0.002019,172.217.194.0-255,2902,203913,92,222025
3587,0.002033,172.217.194.0-255,6438,210351,92,222025
3588,0.004362,172.31.47.0-255,66,210417,92,222025
3589,0.006383,172.217.194.0-255,5738,216155,92,222025
3590,0.006388,172.31.47.0-255,66,216221,92,222025
3591,0.008406,172.217.194.0-255,5738,221959,92,222025
3592,0.008413,172.31.47.0-255,66,222025,92,222025
3593,0.0,74.125.24.0-255,153,153,92,229281
3594,2.4e-05,172.31.47.0-255,66,219,92,229281
3595,3e-05,74.125.24.0-255,1484,1703,92,229281
3596,3.3e-05,172.31.47.0-255,66,1769,92,229281
3597,3.7e-05,74.125.24.0-255,2902,4671,92,229281
3598,4e-05,172.31.47.0-255,66,4737,92,229281
3599,5.2e-05,74.125.24.0-255,7156,11893,92,229281
3600,5.5e-05,172.31.47.0-255,66,11959,92,229281
3601,8.6e-05,74.125.24.0-255,2136,14095,92,229281
3602,8.8e-05,172.31.47.0-255,66,14161,92,229281
3603,0.000146,74.125.24.0-255,1484,15645,92,229281
3604,0.00015,172.31.47.0-255,66,15711,92,229281
3605,0.000154,74.125.24.0-255,2902,18613,92,229281
3606,0.000157,172.31.47.0-255,66,18679,92,229281
3607,0.00018,74.125.24.0-255,5738,24417,92,229281
3608,0.000183,172.31.47.0-255,66,24483,92,229281
3609,0.000217,74.125.24.0-255,2902,27385,92,229281
3610,0.000219,172.31.47.0-255,66,27451,92,229281
3611,0.000246,74.125.24.0-255,3961,31412,92,229281
3612,0.000249,172.31.47.0-255,66,31478,92,229281
3613,0.000394,74.125.24.0-255,1484,32962,92,229281
3614,0.000398,172.31.47.0-255,66,33028,92,229281
3615,0.000415,74.125.24.0-255,2902,35930,92,229281
3616,0.000418,172.31.47.0-255,66,35996,92,229281
3617,0.000423,74.125.24.0-255,5738,41734,92,229281
3618,0.000425,172.31.47.0-255,66,41800,92,229281
3619,0.00043,74.125.24.0-255,4320,46120,92,229281
3620,0.000432,172.31.47.0-255,66,46186,92,229281
3621,0.000456,74.125.24.0-255,2543,48729,92,229281
3622,0.000463,172.31.47.0-255,66,48795,92,229281
3623,0.000748,74.125.24.0-255,1484,50279,92,229281
3624,0.000753,172.31.47.0-255,66,50345,92,229281
3625,0.000763,74.125.24.0-255,2902,53247,92,229281
3626,0.000772,172.31.47.0-255,66,53313,92,229281
3627,0.000778,74.125.24.0-255,2902,56215,92,229281
3628,0.000781,172.31.47.0-255,66,56281,92,229281
3629,0.000801,74.125.24.0-255,2902,59183,92,229281
3630,0.000804,172.31.47.0-255,66,59249,92,229281
3631,0.000818,74.125.24.0-255,7147,66396,92,229281
3632,0.00082,172.31.47.0-255,66,66462,92,229281
3633,0.001084,74.125.24.0-255,329,66791,92,229281
3634,0.001115,172.31.47.0-255,66,66857,92,229281
3635,0.0013,74.125.24.0-255,1484,68341,92,229281
3636,0.001319,74.125.24.0-255,2902,71243,92,229281
3637,0.001324,172.31.47.0-255,66,71309,92,229281
3638,0.00133,74.125.24.0-255,5738,77047,92,229281
3639,0.001332,172.31.47.0-255,66,77113,92,229281
3640,0.001389,74.125.24.0-255,5738,82851,92,229281
3641,0.001392,172.31.47.0-255,66,82917,92,229281
3642,0.001416,74.125.24.0-255,1125,84042,92,229281
3643,0.001453,74.125.24.0-255,1484,85526,92,229281
3644,0.001456,172.31.47.0-255,66,85592,92,229281
3645,0.00146,74.125.24.0-255,1484,87076,92,229281
3646,0.001483,74.125.24.0-255,1484,88560,92,229281
3647,0.001486,172.31.47.0-255,66,88626,92,229281
3648,0.001492,74.125.24.0-255,5738,94364,92,229281
3649,0.001494,172.31.47.0-255,66,94430,92,229281
3650,0.001498,74.125.24.0-255,2902,97332,92,229281
3651,0.001504,172.31.47.0-255,66,97398,92,229281
3652,0.001535,74.125.24.0-255,3961,101359,92,229281
3653,0.001539,172.31.47.0-255,66,101425,92,229281
3654,0.002524,74.125.24.0-255,1484,102909,92,229281
3655,0.002531,74.125.24.0-255,2902,105811,92,229281
3656,0.002534,172.31.47.0-255,66,105877,92,229281
3657,0.00254,74.125.24.0-255,5738,111615,92,229281
3658,0.002542,172.31.47.0-255,66,111681,92,229281
3659,0.002571,74.125.24.0-255,2902,114583,92,229281
3660,0.002573,172.31.47.0-255,66,114649,92,229281
3661,0.002609,172.31.47.0-255,66,114715,92,229281
3662,0.002614,74.125.24.0-255,3602,118317,92,229281
3663,0.002615,172.31.47.0-255,66,118383,92,229281
3664,0.004814,74.125.24.0-255,1484,119867,92,229281
3665,0.004823,74.125.24.0-255,2902,122769,92,229281
3666,0.004826,172.31.47.0-255,66,122835,92,229281
3667,0.004834,74.125.24.0-255,5738,128573,92,229281
3668,0.004835,172.31.47.0-255,66,128639,92,229281
3669,0.004881,172.31.47.0-255,66,128705,92,229281
3670,0.004898,172.31.47.0-255,66,128771,92,229281
3671,0.005049,74.125.24.0-255,1484,130255,92,229281
3672,0.005075,74.125.24.0-255,2902,133157,92,229281
3673,0.005078,172.31.47.0-255,66,133223,92,229281
3674,0.005084,74.125.24.0-255,5738,138961,92,229281
3675,0.005087,172.31.47.0-255,66,139027,92,229281
3676,0.005111,172.31.47.0-255,66,139093,92,229281
3677,0.005141,74.125.24.0-255,2902,141995,92,229281
3678,0.005144,172.31.47.0-255,66,142061,92,229281
3679,0.005148,74.125.24.0-255,2902,144963,92,229281
3680,0.005151,172.31.47.0-255,66,145029,92,229281
3681,0.005154,74.125.24.0-255,1484,146513,92,229281
3682,0.00516,74.125.24.0-255,1484,147997,92,229281
3683,0.005162,172.31.47.0-255,66,148063,92,229281
3684,0.005185,74.125.24.0-255,2902,150965,92,229281
3685,0.005187,172.31.47.0-255,66,151031,92,229281
3686,0.005211,74.125.24.0-255,2184,153215,92,229281
3687,0.005213,172.31.47.0-255,66,153281,92,229281
3688,0.00525,74.125.24.0-255,1484,154765,92,229281
3689,0.005255,74.125.24.0-255,2902,157667,92,229281
3690,0.005257,172.31.47.0-255,66,157733,92,229281
3691,0.005263,74.125.24.0-255,4320,162053,92,229281
3692,0.005265,172.31.47.0-255,66,162119,92,229281
3693,0.00529,74.125.24.0-255,1484,163603,92,229281
3694,0.005295,74.125.24.0-255,4320,167923,92,229281
3695,0.0053,74.125.24.0-255,7156,175079,92,229281
3696,0.005309,172.31.47.0-255,66,175145,92,229281
3697,0.005311,172.31.47.0-255,66,175211,92,229281
3698,0.005316,74.125.24.0-255,4320,179531,92,229281
3699,0.005319,172.31.47.0-255,66,179597,92,229281
3700,0.005365,172.31.47.0-255,66,179663,92,229281
3701,0.005421,74.125.24.0-255,1484,181147,92,229281
3702,0.005428,74.125.24.0-255,2902,184049,92,229281
3703,0.005432,172.31.47.0-255,66,184115,92,229281
3704,0.005438,74.125.24.0-255,5738,189853,92,229281
3705,0.00544,172.31.47.0-255,66,189919,92,229281
3706,0.005511,172.31.47.0-255,66,189985,92,229281
3707,0.005528,172.31.47.0-255,66,190051,92,229281
3708,0.005617,74.125.24.0-255,1484,191535,92,229281
3709,0.005623,74.125.24.0-255,2902,194437,92,229281
3710,0.005626,172.31.47.0-255,66,194503,92,229281
3711,0.005633,74.125.24.0-255,5738,200241,92,229281
3712,0.005636,172.31.47.0-255,66,200307,92,229281
3713,0.005656,74.125.24.0-255,5738,206045,92,229281
3714,0.00566,172.31.47.0-255,66,206111,92,229281
3715,0.005685,74.125.24.0-255,7156,213267,92,229281
3716,0.005704,74.125.24.0-255,5738,219005,92,229281
3717,0.00571,172.31.47.0-255,66,219071,92,229281
3718,0.005718,172.31.47.0-255,66,219137,92,229281
3719,0.005721,172.31.47.0-255,66,219203,92,229281
3720,0.005733,74.125.24.0-255,5738,224941,92,229281
3721,0.005736,172.31.47.0-255,66,225007,92,229281
3722,0.005786,172.31.47.0-255,66,225073,92,229281
3723,0.005832,172.31.47.0-255,66,225139,92,229281
3724,0.005848,172.31.47.0-255,66,225205,92,229281
3725,0.005858,172.31.47.0-255,66,225271,92,229281
3726,0.00588,172.31.47.0-255,66,225337,92,229281
3727,0.005916,74.125.24.0-255,3602,228939,92,229281
3728,0.005977,74.125.24.0-255,105,229044,92,229281
3729,0.005982,172.31.47.0-255,66,229110,92,229281
3730,0.008342,172.31.47.0-255,66,229176,92,229281
3731,0.008409,172.31.47.0-255,105,229281,92,229281
3732,0.0,74.125.24.0-255,153,153,92,220534
3733,2.8e-05,172.31.47.0-255,66,219,92,220534
3734,3.5e-05,74.125.24.0-255,1484,1703,92,220534
3735,4.1e-05,172.31.47.0-255,66,1769,92,220534
3736,5.3e-05,74.125.24.0-255,2902,4671,92,220534
3737,5.7e-05,172.31.47.0-255,66,4737,92,220534
3738,6.5e-05,74.125.24.0-255,7156,11893,92,220534
3739,6.8e-05,172.31.47.0-255,66,11959,92,220534
3740,7.1e-05,74.125.24.0-255,1484,13443,92,220534
3741,7.4e-05,172.31.47.0-255,66,13509,92,220534
3742,0.000123,172.31.47.0-255,66,13575,92,220534
3743,0.000127,74.125.24.0-255,2543,16118,92,220534
3744,0.000129,172.31.47.0-255,66,16184,92,220534
3745,0.000202,74.125.24.0-255,1484,17668,92,220534
3746,0.000205,172.31.47.0-255,66,17734,92,220534
3747,0.00021,74.125.24.0-255,2902,20636,92,220534
3748,0.000213,172.31.47.0-255,66,20702,92,220534
3749,0.000239,74.125.24.0-255,2902,23604,92,220534
3750,0.000241,172.31.47.0-255,66,23670,92,220534
3751,0.000246,74.125.24.0-255,4320,27990,92,220534
3752,0.000249,172.31.47.0-255,66,28056,92,220534
3753,0.000307,74.125.24.0-255,4320,32376,92,220534
3754,0.000311,172.31.47.0-255,66,32442,92,220534
3755,0.000328,74.125.24.0-255,1125,33567,92,220534
3756,0.000331,172.31.47.0-255,66,33633,92,220534
3757,0.000359,74.125.24.0-255,1484,35117,92,220534
3758,0.000364,172.31.47.0-255,66,35183,92,220534
3759,0.000371,74.125.24.0-255,2902,38085,92,220534
3760,0.000373,172.31.47.0-255,66,38151,92,220534
3761,0.000382,74.125.24.0-255,1484,39635,92,220534
3762,0.000385,172.31.47.0-255,66,39701,92,220534
3763,0.000416,74.125.24.0-255,4320,44021,92,220534
3764,0.00042,172.31.47.0-255,66,44087,92,220534
3765,0.000432,74.125.24.0-255,2902,46989,92,220534
3766,0.000439,172.31.47.0-255,66,47055,92,220534
3767,0.000465,74.125.24.0-255,4258,51313,92,220534
3768,0.000467,74.125.24.0-255,381,51694,92,220534
3769,0.00047,172.31.47.0-255,66,51760,92,220534
3770,0.000531,74.125.24.0-255,1484,53244,92,220534
3771,0.000535,172.31.47.0-255,66,53310,92,220534
3772,0.00054,74.125.24.0-255,2902,56212,92,220534
3773,0.000543,172.31.47.0-255,66,56278,92,220534
3774,0.000576,74.125.24.0-255,5738,62016,92,220534
3775,0.00058,172.31.47.0-255,66,62082,92,220534
3776,0.000618,74.125.24.0-255,4320,66402,92,220534
3777,0.000621,172.31.47.0-255,66,66468,92,220534
3778,0.000646,74.125.24.0-255,1993,68461,92,220534
3779,0.000649,172.31.47.0-255,66,68527,92,220534
3780,0.000708,74.125.24.0-255,1484,70011,92,220534
3781,0.000712,74.125.24.0-255,1484,71495,92,220534
3782,0.000715,172.31.47.0-255,66,71561,92,220534
3783,0.00074,74.125.24.0-255,1484,73045,92,220534
3784,0.000749,74.125.24.0-255,5738,78783,92,220534
3785,0.000751,172.31.47.0-255,66,78849,92,220534
3786,0.000757,74.125.24.0-255,4320,83169,92,220534
3787,0.000759,172.31.47.0-255,66,83235,92,220534
3788,0.000788,74.125.24.0-255,7156,90391,92,220534
3789,0.000791,172.31.47.0-255,66,90457,92,220534
3790,0.00082,74.125.24.0-255,4320,94777,92,220534
3791,0.000824,172.31.47.0-255,66,94843,92,220534
3792,0.00083,74.125.24.0-255,7156,101999,92,220534
3793,0.000833,172.31.47.0-255,66,102065,92,220534
3794,0.00087,172.31.47.0-255,66,102131,92,220534
3795,0.000897,74.125.24.0-255,6438,108569,92,220534
3796,0.000901,172.31.47.0-255,66,108635,92,220534
3797,0.000905,74.125.24.0-255,2543,111178,92,220534
3798,0.000908,172.31.47.0-255,66,111244,92,220534
3799,0.000911,74.125.24.0-255,2902,114146,92,220534
3800,0.000913,172.31.47.0-255,66,114212,92,220534
3801,0.000922,74.125.24.0-255,1484,115696,92,220534
3802,0.000946,74.125.24.0-255,5738,121434,92,220534
3803,0.000949,172.31.47.0-255,66,121500,92,220534
3804,0.000957,74.125.24.0-255,7156,128656,92,220534
3805,0.000964,172.31.47.0-255,66,128722,92,220534
3806,0.001009,74.125.24.0-255,766,129488,92,220534
3807,0.001012,172.31.47.0-255,66,129554,92,220534
3808,0.001416,74.125.24.0-255,1484,131038,92,220534
3809,0.00142,172.31.47.0-255,66,131104,92,220534
3810,0.001426,74.125.24.0-255,2902,134006,92,220534
3811,0.001429,172.31.47.0-255,66,134072,92,220534
3812,0.001454,74.125.24.0-255,2902,136974,92,220534
3813,0.001457,172.31.47.0-255,66,137040,92,220534
3814,0.001462,74.125.24.0-255,4320,141360,92,220534
3815,0.001464,172.31.47.0-255,66,141426,92,220534
3816,0.001491,74.125.24.0-255,2902,144328,92,220534
3817,0.001494,74.125.24.0-255,2902,147230,92,220534
3818,0.001495,172.31.47.0-255,66,147296,92,220534
3819,0.001498,172.31.47.0-255,66,147362,92,220534
3820,0.001512,74.125.24.0-255,5738,153100,92,220534
3821,0.001515,172.31.47.0-255,66,153166,92,220534
3822,0.001533,74.125.24.0-255,2902,156068,92,220534
3823,0.001536,172.31.47.0-255,66,156134,92,220534
3824,0.001559,172.31.47.0-255,66,156200,92,220534
3825,0.0016,74.125.24.0-255,1484,157684,92,220534
3826,0.001616,74.125.24.0-255,2902,160586,92,220534
3827,0.001618,172.31.47.0-255,66,160652,92,220534
3828,0.001622,74.125.24.0-255,1484,162136,92,220534
3829,0.001643,74.125.24.0-255,4320,166456,92,220534
3830,0.001645,172.31.47.0-255,66,166522,92,220534
3831,0.00165,74.125.24.0-255,4320,170842,92,220534
3832,0.001652,172.31.47.0-255,66,170908,92,220534
3833,0.001655,74.125.24.0-255,2902,173810,92,220534
3834,0.001657,172.31.47.0-255,66,173876,92,220534
3835,0.001687,74.125.24.0-255,2902,176778,92,220534
3836,0.00169,172.31.47.0-255,66,176844,92,220534
3837,0.0017,172.31.47.0-255,66,176910,92,220534
3838,0.001713,172.31.47.0-255,66,176976,92,220534
3839,0.001723,172.31.47.0-255,66,177042,92,220534
3840,0.001805,74.125.24.0-255,766,177808,92,220534
3841,0.001806,172.31.47.0-255,66,177874,92,220534
3842,0.001847,74.125.24.0-255,1484,179358,92,220534
3843,0.00185,172.31.47.0-255,66,179424,92,220534
3844,0.001853,74.125.24.0-255,1484,180908,92,220534
3845,0.001874,74.125.24.0-255,1484,182392,92,220534
3846,0.001877,172.31.47.0-255,66,182458,92,220534
3847,0.001883,74.125.24.0-255,5738,188196,92,220534
3848,0.001885,172.31.47.0-255,66,188262,92,220534
3849,0.001925,172.31.47.0-255,66,188328,92,220534
3850,0.001934,172.31.47.0-255,66,188394,92,220534
3851,0.00196,74.125.24.0-255,2184,190578,92,220534
3852,0.001963,172.31.47.0-255,66,190644,92,220534
3853,0.002013,74.125.24.0-255,1484,192128,92,220534
3854,0.002018,74.125.24.0-255,2902,195030,92,220534
3855,0.00202,172.31.47.0-255,66,195096,92,220534
3856,0.002047,74.125.24.0-255,5738,200834,92,220534
3857,0.00205,172.31.47.0-255,66,200900,92,220534
3858,0.002055,74.125.24.0-255,5738,206638,92,220534
3859,0.002058,172.31.47.0-255,66,206704,92,220534
3860,0.00209,74.125.24.0-255,7156,213860,92,220534
3861,0.002093,172.31.47.0-255,66,213926,92,220534
3862,0.002106,172.31.47.0-255,66,213992,92,220534
3863,0.002129,74.125.24.0-255,5738,219730,92,220534
3864,0.002134,172.31.47.0-255,66,219796,92,220534
3865,0.002175,172.31.47.0-255,66,219862,92,220534
3866,0.002188,172.31.47.0-255,66,219928,92,220534
3867,0.002217,172.31.47.0-255,66,219994,92,220534
3868,0.002246,172.31.47.0-255,66,220060,92,220534
3869,0.002284,172.31.47.0-255,66,220126,92,220534
3870,0.002318,74.125.24.0-255,105,220231,92,220534
3871,0.002318,172.31.47.0-255,66,220297,92,220534
3872,0.003331,172.31.47.0-255,66,220363,92,220534
3873,0.003358,172.31.47.0-255,105,220468,92,220534
3874,0.00557,74.125.24.0-255,66,220534,92,220534
3875,0.0,172.217.194.0-255,153,153,92,282502
3876,2.5e-05,172.31.47.0-255,66,219,92,282502
3877,3.1e-05,172.217.194.0-255,1484,1703,92,282502
3878,3.5e-05,172.31.47.0-255,66,1769,92,282502
3879,4e-05,172.217.194.0-255,2902,4671,92,282502
3880,4.3e-05,172.31.47.0-255,66,4737,92,282502
3881,5.5e-05,172.217.194.0-255,7156,11893,92,282502
3882,5.7e-05,172.31.47.0-255,66,11959,92,282502
3883,8.5e-05,172.217.194.0-255,5011,16970,92,282502
3884,8.8e-05,172.31.47.0-255,66,17036,92,282502
3885,9.3e-05,172.217.194.0-255,5738,22774,92,282502
3886,9.4e-05,172.31.47.0-255,66,22840,92,282502
3887,0.000122,172.217.194.0-255,5738,28578,92,282502
3888,0.000125,172.31.47.0-255,66,28644,92,282502
3889,0.00014,172.217.194.0-255,2543,31187,92,282502
3890,0.000143,172.31.47.0-255,66,31253,92,282502
3891,0.000165,172.217.194.0-255,1484,32737,92,282502
3892,0.000167,172.31.47.0-255,66,32803,92,282502
3893,0.000171,172.217.194.0-255,2902,35705,92,282502
3894,0.000173,172.31.47.0-255,66,35771,92,282502
3895,0.000198,172.217.194.0-255,4320,40091,92,282502
3896,0.000201,172.31.47.0-255,66,40157,92,282502
3897,0.000232,172.217.194.0-255,1484,41641,92,282502
3898,0.000235,172.31.47.0-255,66,41707,92,282502
3899,0.000249,172.31.47.0-255,66,41773,92,282502
3900,0.000254,172.217.194.0-255,5738,47511,92,282502
3901,0.000256,172.31.47.0-255,66,47577,92,282502
3902,0.000299,172.217.194.0-255,4251,51828,92,282502
3903,0.000302,172.31.47.0-255,66,51894,92,282502
3904,0.000462,172.217.194.0-255,98,51992,92,282502
3905,0.000467,172.31.47.0-255,66,52058,92,282502
3906,0.000495,172.217.194.0-255,1484,53542,92,282502
3907,0.0005,172.217.194.0-255,2902,56444,92,282502
3908,0.000502,172.31.47.0-255,66,56510,92,282502
3909,0.000534,172.217.194.0-255,7156,63666,92,282502
3910,0.000538,172.217.194.0-255,5379,69045,92,282502
3911,0.000538,172.31.47.0-255,66,69111,92,282502
3912,0.000541,172.31.47.0-255,66,69177,92,282502
3913,0.000582,172.217.194.0-255,7156,76333,92,282502
3914,0.000586,172.31.47.0-255,66,76399,92,282502
3915,0.000614,172.217.194.0-255,7156,83555,92,282502
3916,0.000617,172.31.47.0-255,66,83621,92,282502
3917,0.000621,172.217.194.0-255,2543,86164,92,282502
3918,0.000623,172.31.47.0-255,66,86230,92,282502
3919,0.001027,172.217.194.0-255,1484,87714,92,282502
3920,0.001034,172.217.194.0-255,1484,89198,92,282502
3921,0.001038,172.31.47.0-255,66,89264,92,282502
3922,0.001054,172.217.194.0-255,1484,90748,92,282502
3923,0.001064,172.217.194.0-255,5738,96486,92,282502
3924,0.001067,172.31.47.0-255,66,96552,92,282502
3925,0.001071,172.217.194.0-255,2902,99454,92,282502
3926,0.001073,172.31.47.0-255,66,99520,92,282502
3927,0.001114,172.217.194.0-255,7156,106676,92,282502
3928,0.001118,172.31.47.0-255,66,106742,92,282502
3929,0.001128,172.31.47.0-255,66,106808,92,282502
3930,0.001131,172.217.194.0-255,2184,108992,92,282502
3931,0.001133,172.31.47.0-255,66,109058,92,282502
3932,0.001169,172.217.194.0-255,1484,110542,92,282502
3933,0.001184,172.217.194.0-255,2902,113444,92,282502
3934,0.001187,172.31.47.0-255,66,113510,92,282502
3935,0.001192,172.217.194.0-255,4320,117830,92,282502
3936,0.001194,172.31.47.0-255,66,117896,92,282502
3937,0.001215,172.217.194.0-255,1484,119380,92,282502
3938,0.001245,172.31.47.0-255,66,119446,92,282502
3939,0.001251,172.217.194.0-255,5738,125184,92,282502
3940,0.001253,172.31.47.0-255,66,125250,92,282502
3941,0.001289,172.217.194.0-255,5738,130988,92,282502
3942,0.001292,172.31.47.0-255,66,131054,92,282502
3943,0.001296,172.217.194.0-255,2184,133238,92,282502
3944,0.001299,172.31.47.0-255,66,133304,92,282502
3945,0.001302,172.217.194.0-255,2902,136206,92,282502
3946,0.001304,172.31.47.0-255,66,136272,92,282502
3947,0.00134,172.217.194.0-255,7156,143428,92,282502
3948,0.001343,172.31.47.0-255,66,143494,92,282502
3949,0.001359,172.31.47.0-255,66,143560,92,282502
3950,0.001362,172.217.194.0-255,1484,145044,92,282502
3951,0.001399,172.217.194.0-255,6438,151482,92,282502
3952,0.001403,172.31.47.0-255,66,151548,92,282502
3953,0.001406,172.217.194.0-255,1484,153032,92,282502
3954,0.001431,172.217.194.0-255,5738,158770,92,282502
3955,0.001435,172.31.47.0-255,66,158836,92,282502
3956,0.001459,172.217.194.0-255,2902,161738,92,282502
3957,0.001464,172.217.194.0-255,4320,166058,92,282502
3958,0.001486,172.217.194.0-255,7156,173214,92,282502
3959,0.001523,172.217.194.0-255,5738,178952,92,282502
3960,0.001541,172.217.194.0-255,2902,181854,92,282502
3961,0.001546,172.217.194.0-255,3602,185456,92,282502
3962,0.001695,172.217.194.0-255,1484,186940,92,282502
3963,0.001701,172.217.194.0-255,2902,189842,92,282502
3964,0.001727,172.217.194.0-255,5738,195580,92,282502
3965,0.001766,172.217.194.0-255,1484,197064,92,282502
3966,0.001797,172.217.194.0-255,5738,202802,92,282502
3967,0.001814,172.217.194.0-255,5020,207822,92,282502
3968,0.001869,172.217.194.0-255,1484,209306,92,282502
3969,0.001885,172.217.194.0-255,2902,212208,92,282502
3970,0.001888,172.217.194.0-255,1484,213692,92,282502
3971,0.001906,172.217.194.0-255,4320,218012,92,282502
3972,0.001922,172.217.194.0-255,2902,220914,92,282502
3973,0.001934,172.217.194.0-255,2902,223816,92,282502
3974,0.001948,172.217.194.0-255,7156,230972,92,282502
3975,0.001967,172.217.194.0-255,4320,235292,92,282502
3976,0.001985,172.217.194.0-255,4320,239612,92,282502
3977,0.002005,172.217.194.0-255,2184,241796,92,282502
3978,0.002011,172.217.194.0-255,5738,247534,92,282502
3979,0.002028,172.217.194.0-255,5738,253272,92,282502
3980,0.002043,172.217.194.0-255,2902,256174,92,282502
3981,0.002064,172.217.194.0-255,2902,259076,92,282502
3982,0.002103,172.217.194.0-255,4320,263396,92,282502
3983,0.002152,172.217.194.0-255,4320,267716,92,282502
3984,0.002215,172.217.194.0-255,2902,270618,92,282502
3985,0.002226,172.217.194.0-255,2902,273520,92,282502
3986,0.002239,172.217.194.0-255,4320,277840,92,282502
3987,0.002266,172.217.194.0-255,4320,282160,92,282502
3988,0.002347,172.217.194.0-255,105,282265,92,282502
3989,0.003705,172.31.47.0-255,66,282331,92,282502
3990,0.005987,172.31.47.0-255,105,282436,92,282502
3991,0.008281,172.217.194.0-255,66,282502,92,282502
3992,0.0,172.217.26.0-255,152,152,92,150033
3993,1.4e-05,172.31.47.0-255,66,218,92,150033
3994,2.1e-05,172.217.26.0-255,1484,1702,92,150033
3995,2.5e-05,172.31.47.0-255,66,1768,92,150033
3996,2.8e-05,172.217.26.0-255,1484,3252,92,150033
3997,3.1e-05,172.31.47.0-255,66,3318,92,150033
3998,7.6e-05,172.217.26.0-255,1484,4802,92,150033
3999,7.8e-05,172.31.47.0-255,66,4868,92,150033
4000,8.6e-05,172.217.26.0-255,5738,10606,92,150033
4001,8.8e-05,172.31.47.0-255,66,10672,92,150033
4002,0.000115,172.217.26.0-255,1484,12156,92,150033
4003,0.000117,172.31.47.0-255,66,12222,92,150033
4004,0.000122,172.217.26.0-255,2174,14396,92,150033
4005,0.000124,172.31.47.0-255,66,14462,92,150033
4006,0.000127,172.217.26.0-255,2902,17364,92,150033
4007,0.000133,172.31.47.0-255,66,17430,92,150033
4008,0.000135,172.217.26.0-255,1484,18914,92,150033
4009,0.000137,172.31.47.0-255,66,18980,92,150033
4010,0.00014,172.217.26.0-255,1484,20464,92,150033
4011,0.000142,172.31.47.0-255,66,20530,92,150033
4012,0.000146,172.217.26.0-255,2902,23432,92,150033
4013,0.000149,172.31.47.0-255,66,23498,92,150033
4014,0.000154,172.217.26.0-255,5738,29236,92,150033
4015,0.000157,172.31.47.0-255,66,29302,92,150033
4016,0.00016,172.217.26.0-255,2543,31845,92,150033
4017,0.000163,172.31.47.0-255,66,31911,92,150033
4018,0.000225,172.217.26.0-255,1484,33395,92,150033
4019,0.000228,172.31.47.0-255,66,33461,92,150033
4020,0.000232,172.217.26.0-255,2902,36363,92,150033
4021,0.000234,172.31.47.0-255,66,36429,92,150033
4022,0.000238,172.217.26.0-255,4320,40749,92,150033
4023,0.00024,172.31.47.0-255,66,40815,92,150033
4024,0.00027,172.217.26.0-255,1484,42299,92,150033
4025,0.000277,172.217.26.0-255,6797,49096,92,150033
4026,0.000279,172.31.47.0-255,66,49162,92,150033
4027,0.000517,172.217.26.0-255,1484,50646,92,150033
4028,0.000531,172.217.26.0-255,2902,53548,92,150033
4029,0.000534,172.31.47.0-255,66,53614,92,150033
4030,0.000539,172.217.26.0-255,2902,56516,92,150033
4031,0.000542,172.31.47.0-255,66,56582,92,150033
4032,0.000562,172.217.26.0-255,2902,59484,92,150033
4033,0.000564,172.31.47.0-255,66,59550,92,150033
4034,0.000591,172.217.26.0-255,5738,65288,92,150033
4035,0.000594,172.31.47.0-255,66,65354,92,150033
4036,0.000596,172.217.26.0-255,1125,66479,92,150033
4037,0.00064,172.217.26.0-255,392,66871,92,150033
4038,0.001016,172.31.47.0-255,66,66937,92,150033
4039,0.001502,172.217.26.0-255,1484,68421,92,150033
4040,0.001513,172.217.26.0-255,2902,71323,92,150033
4041,0.001517,172.31.47.0-255,66,71389,92,150033
4042,0.001525,172.217.26.0-255,5738,77127,92,150033
4043,0.001527,172.31.47.0-255,66,77193,92,150033
4044,0.001549,172.217.26.0-255,4320,81513,92,150033
4045,0.001551,172.31.47.0-255,66,81579,92,150033
4046,0.001574,172.217.26.0-255,2543,84122,92,150033
4047,0.001576,172.31.47.0-255,66,84188,92,150033
4048,0.001583,172.217.26.0-255,5738,89926,92,150033
4049,0.001585,172.31.47.0-255,66,89992,92,150033
4050,0.001625,172.31.47.0-255,66,90058,92,150033
4051,0.001629,172.217.26.0-255,2248,92306,92,150033
4052,0.001631,172.31.47.0-255,66,92372,92,150033
4053,0.00164,172.217.26.0-255,5738,98110,92,150033
4054,0.001641,172.31.47.0-255,66,98176,92,150033
4055,0.00168,172.217.26.0-255,5738,103914,92,150033
4056,0.001683,172.31.47.0-255,66,103980,92,150033
4057,0.001686,172.217.26.0-255,1484,105464,92,150033
4058,0.00171,172.217.26.0-255,3847,109311,92,150033
4059,0.001713,172.31.47.0-255,66,109377,92,150033
4060,0.001867,172.217.26.0-255,1484,110861,92,150033
4061,0.001874,172.217.26.0-255,2902,113763,92,150033
4062,0.001878,172.31.47.0-255,66,113829,92,150033
4063,0.001886,172.217.26.0-255,5738,119567,92,150033
4064,0.001888,172.31.47.0-255,66,119633,92,150033
4065,0.001935,172.217.26.0-255,1484,121117,92,150033
4066,0.00194,172.217.26.0-255,2902,124019,92,150033
4067,0.001943,172.31.47.0-255,66,124085,92,150033
4068,0.001948,172.217.26.0-255,2666,126751,92,150033
4069,0.00195,172.31.47.0-255,66,126817,92,150033
4070,0.00391,172.217.26.0-255,5738,132555,92,150033
4071,0.003917,172.31.47.0-255,66,132621,92,150033
4072,0.005881,172.217.26.0-255,5738,138359,92,150033
4073,0.005886,172.31.47.0-255,66,138425,92,150033
4074,0.007861,172.217.26.0-255,5738,144163,92,150033
4075,0.007867,172.31.47.0-255,66,144229,92,150033
4076,0.009843,172.217.26.0-255,5738,149967,92,150033
4077,0.00985,172.31.47.0-255,66,150033,92,150033
4078,0.0,172.31.47.0-255,105,105,92,276
4079,0.001876,157.240.13.0-255,105,210,92,276
4080,0.001886,172.31.47.0-255,66,276,92,276
4081,0.0,74.125.24.0-255,153,153,92,202150
4082,3.1e-05,172.31.47.0-255,66,219,92,202150
4083,3.8e-05,74.125.24.0-255,1484,1703,92,202150
4084,4.2e-05,172.31.47.0-255,66,1769,92,202150
4085,4.6e-05,74.125.24.0-255,2902,4671,92,202150
4086,4.9e-05,172.31.47.0-255,66,4737,92,202150
4087,5.4e-05,74.125.24.0-255,2902,7639,92,202150
4088,5.7e-05,172.31.47.0-255,66,7705,92,202150
4089,7.3e-05,74.125.24.0-255,2902,10607,92,202150
4090,7.6e-05,172.31.47.0-255,66,10673,92,202150
4091,8.3e-05,74.125.24.0-255,6236,16909,92,202150
4092,8.5e-05,172.31.47.0-255,66,16975,92,202150
4093,0.000118,172.31.47.0-255,66,17041,92,202150
4094,0.00053,74.125.24.0-255,1484,18525,92,202150
4095,0.000536,172.31.47.0-255,66,18591,92,202150
4096,0.000542,74.125.24.0-255,2902,21493,92,202150
4097,0.000544,172.31.47.0-255,66,21559,92,202150
4098,0.000548,74.125.24.0-255,2902,24461,92,202150
4099,0.00055,172.31.47.0-255,66,24527,92,202150
4100,0.000568,74.125.24.0-255,2902,27429,92,202150
4101,0.000571,172.31.47.0-255,66,27495,92,202150
4102,0.000579,74.125.24.0-255,6797,34292,92,202150
4103,0.000584,172.31.47.0-255,66,34358,92,202150
4104,0.000586,74.125.24.0-255,7156,41514,92,202150
4105,0.000588,172.31.47.0-255,66,41580,92,202150
4106,0.000635,172.31.47.0-255,66,41646,92,202150
4107,0.000652,74.125.24.0-255,127,41773,92,202150
4108,0.000654,172.31.47.0-255,66,41839,92,202150
4109,0.000691,74.125.24.0-255,1484,43323,92,202150
4110,0.000695,172.31.47.0-255,66,43389,92,202150
4111,0.0007,74.125.24.0-255,2902,46291,92,202150
4112,0.000705,172.31.47.0-255,66,46357,92,202150
4113,0.000717,74.125.24.0-255,5738,52095,92,202150
4114,0.000733,172.31.47.0-255,66,52161,92,202150
4115,0.000736,74.125.24.0-255,5738,57899,92,202150
4116,0.000748,172.31.47.0-255,66,57965,92,202150
4117,0.000751,74.125.24.0-255,4320,62285,92,202150
4118,0.000754,172.31.47.0-255,66,62351,92,202150
4119,0.000806,172.31.47.0-255,66,62417,92,202150
4120,0.000815,74.125.24.0-255,3602,66019,92,202150
4121,0.00082,172.31.47.0-255,66,66085,92,202150
4122,0.000878,74.125.24.0-255,1484,67569,92,202150
4123,0.000883,74.125.24.0-255,2902,70471,92,202150
4124,0.000887,74.125.24.0-255,1484,71955,92,202150
4125,0.000894,172.31.47.0-255,66,72021,92,202150
4126,0.000914,74.125.24.0-255,5738,77759,92,202150
4127,0.000919,172.31.47.0-255,66,77825,92,202150
4128,0.000965,172.31.47.0-255,66,77891,92,202150
4129,0.000967,74.125.24.0-255,5738,83629,92,202150
4130,0.00097,172.31.47.0-255,66,83695,92,202150
4131,0.001022,74.125.24.0-255,3602,87297,92,202150
4132,0.001028,74.125.24.0-255,4320,91617,92,202150
4133,0.001034,74.125.24.0-255,5738,97355,92,202150
4134,0.001034,172.31.47.0-255,66,97421,92,202150
4135,0.001039,172.31.47.0-255,66,97487,92,202150
4136,0.001056,74.125.24.0-255,4320,101807,92,202150
4137,0.001063,74.125.24.0-255,7156,108963,92,202150
4138,0.001063,172.31.47.0-255,66,109029,92,202150
4139,0.001067,172.31.47.0-255,66,109095,92,202150
4140,0.001092,74.125.24.0-255,5738,114833,92,202150
4141,0.001102,172.31.47.0-255,66,114899,92,202150
4142,0.001111,74.125.24.0-255,4320,119219,92,202150
4143,0.001114,172.31.47.0-255,66,119285,92,202150
4144,0.001122,74.125.24.0-255,2184,121469,92,202150
4145,0.001126,172.31.47.0-255,66,121535,92,202150
4146,0.00136,74.125.24.0-255,1484,123019,92,202150
4147,0.001376,74.125.24.0-255,2902,125921,92,202150
4148,0.001379,172.31.47.0-255,66,125987,92,202150
4149,0.001401,74.125.24.0-255,5738,131725,92,202150
4150,0.001409,172.31.47.0-255,66,131791,92,202150
4151,0.001421,74.125.24.0-255,5738,137529,92,202150
4152,0.001427,172.31.47.0-255,66,137595,92,202150
4153,0.001452,74.125.24.0-255,7156,144751,92,202150
4154,0.001454,172.31.47.0-255,66,144817,92,202150
4155,0.001458,74.125.24.0-255,2902,147719,92,202150
4156,0.001471,172.31.47.0-255,66,147785,92,202150
4157,0.00149,74.125.24.0-255,5738,153523,92,202150
4158,0.001494,172.31.47.0-255,66,153589,92,202150
4159,0.0015,74.125.24.0-255,2184,155773,92,202150
4160,0.001505,172.31.47.0-255,66,155839,92,202150
4161,0.001702,74.125.24.0-255,1484,157323,92,202150
4162,0.001706,74.125.24.0-255,1484,158807,92,202150
4163,0.001708,172.31.47.0-255,66,158873,92,202150
4164,0.001728,74.125.24.0-255,1484,160357,92,202150
4165,0.001734,74.125.24.0-255,5738,166095,92,202150
4166,0.001736,172.31.47.0-255,66,166161,92,202150
4167,0.00174,74.125.24.0-255,2902,169063,92,202150
4168,0.001749,172.31.47.0-255,66,169129,92,202150
4169,0.001762,74.125.24.0-255,5738,174867,92,202150
4170,0.001767,172.31.47.0-255,66,174933,92,202150
4171,0.001781,74.125.24.0-255,4320,179253,92,202150
4172,0.001789,172.31.47.0-255,66,179319,92,202150
4173,0.001837,172.31.47.0-255,66,179385,92,202150
4174,0.001841,74.125.24.0-255,1484,180869,92,202150
4175,0.001848,172.31.47.0-255,66,180935,92,202150
4176,0.001877,172.31.47.0-255,66,181001,92,202150
4177,0.001906,74.125.24.0-255,4320,185321,92,202150
4178,0.00191,172.31.47.0-255,66,185387,92,202150
4179,0.001937,74.125.24.0-255,7156,192543,92,202150
4180,0.001941,74.125.24.0-255,1484,194027,92,202150
4181,0.001941,172.31.47.0-255,66,194093,92,202150
4182,0.001989,172.31.47.0-255,66,194159,92,202150
4183,0.002029,172.31.47.0-255,66,194225,92,202150
4184,0.002037,74.125.24.0-255,7156,201381,92,202150
4185,0.002044,172.31.47.0-255,66,201447,92,202150
4186,0.002061,172.31.47.0-255,66,201513,92,202150
4187,0.002066,172.31.47.0-255,66,201579,92,202150
4188,0.00211,172.31.47.0-255,66,201645,92,202150
4189,0.002135,172.31.47.0-255,66,201711,92,202150
4190,0.002151,172.31.47.0-255,66,201777,92,202150
4191,0.002189,74.125.24.0-255,97,201874,92,202150
4192,0.002202,74.125.24.0-255,105,201979,92,202150
4193,0.007568,172.31.47.0-255,66,202045,92,202150
4194,0.00905,172.31.47.0-255,105,202150,92,202150
4195,0.0,172.217.194.0-255,152,152,92,254060
4196,3.9e-05,172.31.47.0-255,66,218,92,254060
4197,4.6e-05,172.217.194.0-255,1484,1702,92,254060
4198,5.1e-05,172.31.47.0-255,66,1768,92,254060
4199,5.6e-05,172.217.194.0-255,2902,4670,92,254060
4200,5.8e-05,172.31.47.0-255,66,4736,92,254060
4201,6.3e-05,172.217.194.0-255,2902,7638,92,254060
4202,6.6e-05,172.31.47.0-255,66,7704,92,254060
4203,7.1e-05,172.217.194.0-255,4320,12024,92,254060
4204,7.3e-05,172.31.47.0-255,66,12090,92,254060
4205,0.0001,172.217.194.0-255,2145,14235,92,254060
4206,0.000103,172.31.47.0-255,66,14301,92,254060
4207,0.000164,172.217.194.0-255,1484,15785,92,254060
4208,0.000168,172.31.47.0-255,66,15851,92,254060
4209,0.000173,172.217.194.0-255,2902,18753,92,254060
4210,0.000175,172.31.47.0-255,66,18819,92,254060
4211,0.00019,172.217.194.0-255,5738,24557,92,254060
4212,0.000192,172.31.47.0-255,66,24623,92,254060
4213,0.000222,172.217.194.0-255,5738,30361,92,254060
4214,0.000226,172.31.47.0-255,66,30427,92,254060
4215,0.000252,172.217.194.0-255,1125,31552,92,254060
4216,0.000255,172.31.47.0-255,66,31618,92,254060
4217,0.000661,172.217.194.0-255,1484,33102,92,254060
4218,0.000666,172.31.47.0-255,66,33168,92,254060
4219,0.000675,172.217.194.0-255,2902,36070,92,254060
4220,0.000677,172.31.47.0-255,66,36136,92,254060
4221,0.00068,172.217.194.0-255,1484,37620,92,254060
4222,0.000682,172.31.47.0-255,66,37686,92,254060
4223,0.000705,172.217.194.0-255,4320,42006,92,254060
4224,0.000708,172.31.47.0-255,66,42072,92,254060
4225,0.000715,172.217.194.0-255,7156,49228,92,254060
4226,0.000717,172.31.47.0-255,66,49294,92,254060
4227,0.000741,172.217.194.0-255,2543,51837,92,254060
4228,0.000744,172.31.47.0-255,66,51903,92,254060
4229,0.000773,172.31.47.0-255,66,51969,92,254060
4230,0.000792,172.217.194.0-255,5653,57622,92,254060
4231,0.000795,172.31.47.0-255,66,57688,92,254060
4232,0.000883,172.217.194.0-255,120,57808,92,254060
4233,0.000887,172.31.47.0-255,66,57874,92,254060
4234,0.001248,172.217.194.0-255,1484,59358,92,254060
4235,0.001254,172.31.47.0-255,66,59424,92,254060
4236,0.00126,172.217.194.0-255,2902,62326,92,254060
4237,0.001263,172.31.47.0-255,66,62392,92,254060
4238,0.001269,172.217.194.0-255,5738,68130,92,254060
4239,0.001271,172.31.47.0-255,66,68196,92,254060
4240,0.001276,172.217.194.0-255,4320,72516,92,254060
4241,0.001279,172.31.47.0-255,66,72582,92,254060
4242,0.001294,172.217.194.0-255,2543,75125,92,254060
4243,0.001296,172.31.47.0-255,66,75191,92,254060
4244,0.001416,172.217.194.0-255,1484,76675,92,254060
4245,0.001419,172.31.47.0-255,66,76741,92,254060
4246,0.001423,172.217.194.0-255,2902,79643,92,254060
4247,0.001426,172.217.194.0-255,1484,81127,92,254060
4248,0.001459,172.217.194.0-255,4320,85447,92,254060
4249,0.001474,172.217.194.0-255,2902,88349,92,254060
4250,0.00149,172.217.194.0-255,3961,92310,92,254060
4251,0.001704,172.217.194.0-255,1484,93794,92,254060
4252,0.001708,172.217.194.0-255,2902,96696,92,254060
4253,0.001729,172.217.194.0-255,5738,102434,92,254060
4254,0.001732,172.217.194.0-255,1484,103918,92,254060
4255,0.001749,172.217.194.0-255,7156,111074,92,254060
4256,0.001772,172.217.194.0-255,5738,116812,92,254060
4257,0.001855,172.217.194.0-255,4320,121132,92,254060
4258,0.001879,172.217.194.0-255,3602,124734,92,254060
4259,0.001926,172.217.194.0-255,1484,126218,92,254060
4260,0.001943,172.217.194.0-255,2902,129120,92,254060
4261,0.001948,172.217.194.0-255,2902,132022,92,254060
4262,0.001963,172.217.194.0-255,2902,134924,92,254060
4263,0.001966,172.217.194.0-255,1484,136408,92,254060
4264,0.001979,172.217.194.0-255,7156,143564,92,254060
4265,0.001992,172.217.194.0-255,4320,147884,92,254060
4266,0.001998,172.217.194.0-255,5738,153622,92,254060
4267,0.002016,172.217.194.0-255,5020,158642,92,254060
4268,0.002059,172.217.194.0-255,1484,160126,92,254060
4269,0.002072,172.217.194.0-255,2902,163028,92,254060
4270,0.002076,172.217.194.0-255,2902,165930,92,254060
4271,0.002086,172.217.194.0-255,2902,168832,92,254060
4272,0.002156,172.217.194.0-255,1484,170316,92,254060
4273,0.002169,172.217.194.0-255,4320,174636,92,254060
4274,0.002207,172.217.194.0-255,1484,176120,92,254060
4275,0.002224,172.217.194.0-255,2902,179022,92,254060
4276,0.002226,172.217.194.0-255,1484,180506,92,254060
4277,0.002239,172.217.194.0-255,4320,184826,92,254060
4278,0.002262,172.217.194.0-255,7156,191982,92,254060
4279,0.002283,172.217.194.0-255,2902,194884,92,254060
4280,0.002296,172.217.194.0-255,1484,196368,92,254060
4281,0.002328,172.217.194.0-255,5020,201388,92,254060
4282,0.002334,172.217.194.0-255,5738,207126,92,254060
4283,0.002381,172.217.194.0-255,4320,211446,92,254060
4284,0.002478,172.217.194.0-255,1484,212930,92,254060
4285,0.002492,172.217.194.0-255,2902,215832,92,254060
4286,0.002514,172.217.194.0-255,5738,221570,92,254060
4287,0.002518,172.217.194.0-255,2902,224472,92,254060
4288,0.002529,172.217.194.0-255,2902,227374,92,254060
4289,0.002539,172.217.194.0-255,1484,228858,92,254060
4290,0.002612,172.217.194.0-255,5020,233878,92,254060
4291,0.002619,172.217.194.0-255,5738,239616,92,254060
4292,0.002621,172.217.194.0-255,1484,241100,92,254060
4293,0.002636,172.217.194.0-255,4320,245420,92,254060
4294,0.002638,172.217.194.0-255,1484,246904,92,254060
4295,0.002671,172.217.194.0-255,7156,254060,92,254060
4296,0.0,74.125.24.0-255,152,152,92,218057
4297,1.7e-05,172.31.47.0-255,66,218,92,218057
4298,2.3e-05,74.125.24.0-255,1484,1702,92,218057
4299,2.7e-05,172.31.47.0-255,66,1768,92,218057
4300,3.1e-05,74.125.24.0-255,2902,4670,92,218057
4301,3.4e-05,172.31.47.0-255,66,4736,92,218057
4302,5.7e-05,74.125.24.0-255,7156,11892,92,218057
4303,6e-05,172.31.47.0-255,66,11958,92,218057
4304,6.3e-05,74.125.24.0-255,3502,15460,92,218057
4305,6.5e-05,172.31.47.0-255,66,15526,92,218057
4306,8.4e-05,74.125.24.0-255,5738,21264,92,218057
4307,8.6e-05,172.31.47.0-255,66,21330,92,218057
4308,0.000112,74.125.24.0-255,7156,28486,92,218057
4309,0.000114,172.31.47.0-255,66,28552,92,218057
4310,0.000117,74.125.24.0-255,2543,31095,92,218057
4311,0.000118,172.31.47.0-255,66,31161,92,218057
4312,0.000153,74.125.24.0-255,2902,34063,92,218057
4313,0.000155,172.31.47.0-255,66,34129,92,218057
4314,0.000173,74.125.24.0-255,4320,38449,92,218057
4315,0.000175,172.31.47.0-255,66,38515,92,218057
4316,0.000201,172.31.47.0-255,66,38581,92,218057
4317,0.000219,74.125.24.0-255,1484,40065,92,218057
4318,0.000221,172.31.47.0-255,66,40131,92,218057
4319,0.00025,172.31.47.0-255,66,40197,92,218057
4320,0.000272,74.125.24.0-255,3897,44094,92,218057
4321,0.000273,172.31.47.0-255,66,44160,92,218057
4322,0.000276,74.125.24.0-255,131,44291,92,218057
4323,0.000278,172.31.47.0-255,66,44357,92,218057
4324,0.0004,74.125.24.0-255,1484,45841,92,218057
4325,0.000405,172.31.47.0-255,66,45907,92,218057
4326,0.000409,74.125.24.0-255,2902,48809,92,218057
4327,0.000411,172.31.47.0-255,66,48875,92,218057
4328,0.000434,74.125.24.0-255,2902,51777,92,218057
4329,0.000437,172.31.47.0-255,66,51843,92,218057
4330,0.000452,74.125.24.0-255,2902,54745,92,218057
4331,0.000454,172.31.47.0-255,66,54811,92,218057
4332,0.000472,74.125.24.0-255,7156,61967,92,218057
4333,0.000475,172.31.47.0-255,66,62033,92,218057
4334,0.000493,74.125.24.0-255,5738,67771,92,218057
4335,0.000496,172.31.47.0-255,66,67837,92,218057
4336,0.000498,74.125.24.0-255,1484,69321,92,218057
4337,0.00052,74.125.24.0-255,4320,73641,92,218057
4338,0.000522,172.31.47.0-255,66,73707,92,218057
4339,0.000539,74.125.24.0-255,5020,78727,92,218057
4340,0.000542,172.31.47.0-255,66,78793,92,218057
4341,0.00058,74.125.24.0-255,1484,80277,92,218057
4342,0.000584,74.125.24.0-255,2902,83179,92,218057
4343,0.000586,172.31.47.0-255,66,83245,92,218057
4344,0.000607,74.125.24.0-255,5738,88983,92,218057
4345,0.00061,172.31.47.0-255,66,89049,92,218057
4346,0.000612,74.125.24.0-255,1484,90533,92,218057
4347,0.00063,74.125.24.0-255,4320,94853,92,218057
4348,0.000632,172.31.47.0-255,66,94919,92,218057
4349,0.000645,74.125.24.0-255,2902,97821,92,218057
4350,0.000647,172.31.47.0-255,66,97887,92,218057
4351,0.000677,172.31.47.0-255,66,97953,92,218057
4352,0.000682,74.125.24.0-255,5020,102973,92,218057
4353,0.000683,172.31.47.0-255,66,103039,92,218057
4354,0.000714,74.125.24.0-255,4320,107359,92,218057
4355,0.000716,172.31.47.0-255,66,107425,92,218057
4356,0.000728,74.125.24.0-255,1484,108909,92,218057
4357,0.000736,172.31.47.0-255,66,108975,92,218057
4358,0.000755,74.125.24.0-255,5738,114713,92,218057
4359,0.000757,172.31.47.0-255,66,114779,92,218057
4360,0.000802,74.125.24.0-255,7156,121935,92,218057
4361,0.000804,172.31.47.0-255,66,122001,92,218057
4362,0.000823,74.125.24.0-255,2902,124903,92,218057
4363,0.000825,172.31.47.0-255,66,124969,92,218057
4364,0.00083,74.125.24.0-255,5020,129989,92,218057
4365,0.000832,172.31.47.0-255,66,130055,92,218057
4366,0.000836,74.125.24.0-255,5738,135793,92,218057
4367,0.000838,172.31.47.0-255,66,135859,92,218057
4368,0.000847,172.31.47.0-255,66,135925,92,218057
4369,0.000857,172.31.47.0-255,66,135991,92,218057
4370,0.000961,74.125.24.0-255,1484,137475,92,218057
4371,0.000965,74.125.24.0-255,2902,140377,92,218057
4372,0.000968,172.31.47.0-255,66,140443,92,218057
4373,0.000986,74.125.24.0-255,5738,146181,92,218057
4374,0.000988,172.31.47.0-255,66,146247,92,218057
4375,0.001022,172.31.47.0-255,66,146313,92,218057
4376,0.001052,74.125.24.0-255,5738,152051,92,218057
4377,0.001055,172.31.47.0-255,66,152117,92,218057
4378,0.001072,74.125.24.0-255,5020,157137,92,218057
4379,0.001074,172.31.47.0-255,66,157203,92,218057
4380,0.001227,74.125.24.0-255,1484,158687,92,218057
4381,0.001241,74.125.24.0-255,2902,161589,92,218057
4382,0.001245,172.31.47.0-255,66,161655,92,218057
4383,0.001258,74.125.24.0-255,5738,167393,92,218057
4384,0.00126,172.31.47.0-255,66,167459,92,218057
4385,0.001277,74.125.24.0-255,4320,171779,92,218057
4386,0.001279,172.31.47.0-255,66,171845,92,218057
4387,0.001317,172.31.47.0-255,66,171911,92,218057
4388,0.001327,172.31.47.0-255,66,171977,92,218057
4389,0.001339,74.125.24.0-255,2184,174161,92,218057
4390,0.001342,172.31.47.0-255,66,174227,92,218057
4391,0.001402,74.125.24.0-255,1484,175711,92,218057
4392,0.001407,74.125.24.0-255,2902,178613,92,218057
4393,0.001411,172.31.47.0-255,66,178679,92,218057
4394,0.001424,74.125.24.0-255,1484,180163,92,218057
4395,0.00144,74.125.24.0-255,4320,184483,92,218057
4396,0.001444,172.31.47.0-255,66,184549,92,218057
4397,0.001449,74.125.24.0-255,5738,190287,92,218057
4398,0.001452,172.31.47.0-255,66,190353,92,218057
4399,0.001465,74.125.24.0-255,2902,193255,92,218057
4400,0.001467,172.31.47.0-255,66,193321,92,218057
4401,0.001483,74.125.24.0-255,2902,196223,92,218057
4402,0.001488,172.31.47.0-255,66,196289,92,218057
4403,0.00152,172.31.47.0-255,66,196355,92,218057
4404,0.00153,172.31.47.0-255,66,196421,92,218057
4405,0.001589,172.31.47.0-255,66,196487,92,218057
4406,0.001624,172.31.47.0-255,66,196553,92,218057
4407,0.00166,172.31.47.0-255,66,196619,92,218057
4408,0.001681,74.125.24.0-255,4320,200939,92,218057
4409,0.001683,172.31.47.0-255,66,201005,92,218057
4410,0.001693,172.31.47.0-255,66,201071,92,218057
4411,0.001703,172.31.47.0-255,66,201137,92,218057
4412,0.001708,74.125.24.0-255,7156,208293,92,218057
4413,0.001711,172.31.47.0-255,66,208359,92,218057
4414,0.001737,74.125.24.0-255,7156,215515,92,218057
4415,0.001741,172.31.47.0-255,66,215581,92,218057
4416,0.001754,172.31.47.0-255,66,215647,92,218057
4417,0.001767,172.31.47.0-255,66,215713,92,218057
4418,0.001791,74.125.24.0-255,1484,217197,92,218057
4419,0.001794,74.125.24.0-255,452,217649,92,218057
4420,0.001796,172.31.47.0-255,66,217715,92,218057
4421,0.001815,74.125.24.0-255,105,217820,92,218057
4422,0.003764,172.31.47.0-255,66,217886,92,218057
4423,0.003794,172.31.47.0-255,105,217991,92,218057
4424,0.006022,74.125.24.0-255,66,218057,92,218057
4425,0.0,172.31.47.0-255,105,105,92,105
4426,0.0,74.125.24.0-255,146,146,92,137002
4427,3.6e-05,172.31.47.0-255,66,212,92,137002
4428,4.4e-05,74.125.24.0-255,1484,1696,92,137002
4429,4.8e-05,172.31.47.0-255,66,1762,92,137002
4430,5.3e-05,74.125.24.0-255,2902,4664,92,137002
4431,5.6e-05,172.31.47.0-255,66,4730,92,137002
4432,6.4e-05,74.125.24.0-255,7156,11886,92,137002
4433,6.8e-05,172.31.47.0-255,66,11952,92,137002
4434,0.000111,74.125.24.0-255,2171,14123,92,137002
4435,0.000113,172.31.47.0-255,66,14189,92,137002
4436,0.000211,74.125.24.0-255,1484,15673,92,137002
4437,0.000216,172.31.47.0-255,66,15739,92,137002
4438,0.000231,74.125.24.0-255,2902,18641,92,137002
4439,0.000234,172.31.47.0-255,66,18707,92,137002
4440,0.00024,74.125.24.0-255,4320,23027,92,137002
4441,0.000243,172.31.47.0-255,66,23093,92,137002
4442,0.000262,74.125.24.0-255,1484,24577,92,137002
4443,0.000265,172.31.47.0-255,66,24643,92,137002
4444,0.000303,74.125.24.0-255,6797,31440,92,137002
4445,0.000306,172.31.47.0-255,66,31506,92,137002
4446,0.000465,74.125.24.0-255,1484,32990,92,137002
4447,0.000469,172.31.47.0-255,66,33056,92,137002
4448,0.00049,74.125.24.0-255,2902,35958,92,137002
4449,0.000494,172.31.47.0-255,66,36024,92,137002
4450,0.000514,74.125.24.0-255,5738,41762,92,137002
4451,0.000517,172.31.47.0-255,66,41828,92,137002
4452,0.000535,74.125.24.0-255,2902,44730,92,137002
4453,0.000538,172.31.47.0-255,66,44796,92,137002
4454,0.000568,74.125.24.0-255,5738,50534,92,137002
4455,0.000571,172.31.47.0-255,66,50600,92,137002
4456,0.000598,74.125.24.0-255,5379,55979,92,137002
4457,0.000601,172.31.47.0-255,66,56045,92,137002
4458,0.000611,172.31.47.0-255,66,56111,92,137002
4459,0.000614,74.125.24.0-255,401,56512,92,137002
4460,0.000616,172.31.47.0-255,66,56578,92,137002
4461,0.000656,74.125.24.0-255,108,56686,92,137002
4462,0.00066,172.31.47.0-255,66,56752,92,137002
4463,0.000686,74.125.24.0-255,330,57082,92,137002
4464,0.00069,172.31.47.0-255,66,57148,92,137002
4465,0.001788,74.125.24.0-255,1484,58632,92,137002
4466,0.001795,172.31.47.0-255,66,58698,92,137002
4467,0.001806,74.125.24.0-255,2902,61600,92,137002
4468,0.001808,172.31.47.0-255,66,61666,92,137002
4469,0.001814,74.125.24.0-255,5738,67404,92,137002
4470,0.001815,172.31.47.0-255,66,67470,92,137002
4471,0.001835,74.125.24.0-255,1484,68954,92,137002
4472,0.001837,172.31.47.0-255,66,69020,92,137002
4473,0.001861,172.31.47.0-255,66,69086,92,137002
4474,0.001872,74.125.24.0-255,2902,71988,92,137002
4475,0.001874,172.31.47.0-255,66,72054,92,137002
4476,0.00191,74.125.24.0-255,1484,73538,92,137002
4477,0.001913,172.31.47.0-255,66,73604,92,137002
4478,0.001939,172.31.47.0-255,66,73670,92,137002
4479,0.002195,74.125.24.0-255,1484,75154,92,137002
4480,0.002197,172.31.47.0-255,66,75220,92,137002
4481,0.002214,74.125.24.0-255,2902,78122,92,137002
4482,0.002216,172.31.47.0-255,66,78188,92,137002
4483,0.002221,74.125.24.0-255,4320,82508,92,137002
4484,0.002223,172.31.47.0-255,66,82574,92,137002
4485,0.002235,74.125.24.0-255,1484,84058,92,137002
4486,0.002237,172.31.47.0-255,66,84124,92,137002
4487,0.002249,74.125.24.0-255,4320,88444,92,137002
4488,0.002252,172.31.47.0-255,66,88510,92,137002
4489,0.002276,172.31.47.0-255,66,88576,92,137002
4490,0.002285,172.31.47.0-255,66,88642,92,137002
4491,0.002309,74.125.24.0-255,2184,90826,92,137002
4492,0.002311,172.31.47.0-255,66,90892,92,137002
4493,0.002492,74.125.24.0-255,1484,92376,92,137002
4494,0.002494,172.31.47.0-255,66,92442,92,137002
4495,0.002508,74.125.24.0-255,1484,93926,92,137002
4496,0.00251,172.31.47.0-255,66,93992,92,137002
4497,0.002524,74.125.24.0-255,1484,95476,92,137002
4498,0.002526,172.31.47.0-255,66,95542,92,137002
4499,0.002532,74.125.24.0-255,5738,101280,92,137002
4500,0.002534,172.31.47.0-255,66,101346,92,137002
4501,0.002575,74.125.24.0-255,5738,107084,92,137002
4502,0.002578,172.31.47.0-255,66,107150,92,137002
4503,0.002598,74.125.24.0-255,7156,114306,92,137002
4504,0.0026,172.31.47.0-255,66,114372,92,137002
4505,0.002616,74.125.24.0-255,4320,118692,92,137002
4506,0.002618,172.31.47.0-255,66,118758,92,137002
4507,0.002639,74.125.24.0-255,6438,125196,92,137002
4508,0.002641,172.31.47.0-255,66,125262,92,137002
4509,0.00523,74.125.24.0-255,4320,129582,92,137002
4510,0.005233,172.31.47.0-255,66,129648,92,137002
4511,0.005249,74.125.24.0-255,1484,131132,92,137002
4512,0.00525,172.31.47.0-255,66,131198,92,137002
4513,0.007864,74.125.24.0-255,5738,136936,92,137002
4514,0.007873,172.31.47.0-255,66,137002,92,137002
4515,0.0,172.31.47.0-255,66,66,92,66
4516,0.0,74.125.24.0-255,153,153,92,140753
4517,2.2e-05,172.31.47.0-255,66,219,92,140753
4518,2.9e-05,74.125.24.0-255,1484,1703,92,140753
4519,3.2e-05,172.31.47.0-255,66,1769,92,140753
4520,5.1e-05,74.125.24.0-255,2902,4671,92,140753
4521,5.3e-05,172.31.47.0-255,66,4737,92,140753
4522,5.5e-05,74.125.24.0-255,1484,6221,92,140753
4523,5.7e-05,172.31.47.0-255,66,6287,92,140753
4524,9e-05,74.125.24.0-255,4320,10607,92,140753
4525,9.3e-05,172.31.47.0-255,66,10673,92,140753
4526,0.000109,74.125.24.0-255,1484,12157,92,140753
4527,0.00011,172.31.47.0-255,66,12223,92,140753
4528,0.000113,74.125.24.0-255,1484,13707,92,140753
4529,0.000115,172.31.47.0-255,66,13773,92,140753
4530,0.000156,172.31.47.0-255,66,13839,92,140753
4531,0.000162,74.125.24.0-255,5738,19577,92,140753
4532,0.000163,172.31.47.0-255,66,19643,92,140753
4533,0.000173,74.125.24.0-255,1484,21127,92,140753
4534,0.000175,172.31.47.0-255,66,21193,92,140753
4535,0.000206,74.125.24.0-255,1125,22318,92,140753
4536,0.000208,172.31.47.0-255,66,22384,92,140753
4537,0.000323,74.125.24.0-255,1484,23868,92,140753
4538,0.000327,172.31.47.0-255,66,23934,92,140753
4539,0.00033,74.125.24.0-255,1484,25418,92,140753
4540,0.000332,172.31.47.0-255,66,25484,92,140753
4541,0.000344,74.125.24.0-255,1484,26968,92,140753
4542,0.000346,172.31.47.0-255,66,27034,92,140753
4543,0.000353,74.125.24.0-255,5738,32772,92,140753
4544,0.000355,172.31.47.0-255,66,32838,92,140753
4545,0.000358,74.125.24.0-255,2902,35740,92,140753
4546,0.00036,172.31.47.0-255,66,35806,92,140753
4547,0.000379,74.125.24.0-255,1484,37290,92,140753
4548,0.000402,74.125.24.0-255,2902,40192,92,140753
4549,0.000406,172.31.47.0-255,66,40258,92,140753
4550,0.000421,172.31.47.0-255,66,40324,92,140753
4551,0.000427,74.125.24.0-255,7106,47430,92,140753
4552,0.000428,172.31.47.0-255,66,47496,92,140753
4553,0.000506,74.125.24.0-255,112,47608,92,140753
4554,0.000524,74.125.24.0-255,331,47939,92,140753
4555,0.000688,172.31.47.0-255,66,48005,92,140753
4556,0.00091,74.125.24.0-255,1484,49489,92,140753
4557,0.000921,74.125.24.0-255,2902,52391,92,140753
4558,0.000924,172.31.47.0-255,66,52457,92,140753
4559,0.000942,74.125.24.0-255,5738,58195,92,140753
4560,0.000944,172.31.47.0-255,66,58261,92,140753
4561,0.00098,74.125.24.0-255,5738,63999,92,140753
4562,0.000983,172.31.47.0-255,66,64065,92,140753
4563,0.001007,74.125.24.0-255,7156,71221,92,140753
4564,0.00101,172.31.47.0-255,66,71287,92,140753
4565,0.001014,74.125.24.0-255,2902,74189,92,140753
4566,0.001015,172.31.47.0-255,66,74255,92,140753
4567,0.001035,172.31.47.0-255,66,74321,92,140753
4568,0.001401,74.125.24.0-255,1484,75805,92,140753
4569,0.00141,74.125.24.0-255,1484,77289,92,140753
4570,0.001413,172.31.47.0-255,66,77355,92,140753
4571,0.001435,74.125.24.0-255,1484,78839,92,140753
4572,0.001442,74.125.24.0-255,5738,84577,92,140753
4573,0.001444,172.31.47.0-255,66,84643,92,140753
4574,0.001448,74.125.24.0-255,4320,88963,92,140753
4575,0.00145,172.31.47.0-255,66,89029,92,140753
4576,0.001475,74.125.24.0-255,1484,90513,92,140753
4577,0.001499,172.31.47.0-255,66,90579,92,140753
4578,0.001503,74.125.24.0-255,5738,96317,92,140753
4579,0.001505,172.31.47.0-255,66,96383,92,140753
4580,0.001542,74.125.24.0-255,2184,98567,92,140753
4581,0.001545,172.31.47.0-255,66,98633,92,140753
4582,0.001896,74.125.24.0-255,1484,100117,92,140753
4583,0.001911,74.125.24.0-255,2902,103019,92,140753
4584,0.001914,172.31.47.0-255,66,103085,92,140753
4585,0.001933,74.125.24.0-255,5738,108823,92,140753
4586,0.001935,172.31.47.0-255,66,108889,92,140753
4587,0.001947,74.125.24.0-255,1484,110373,92,140753
4588,0.001968,74.125.24.0-255,7156,117529,92,140753
4589,0.00197,172.31.47.0-255,66,117595,92,140753
4590,0.001978,172.31.47.0-255,66,117661,92,140753
4591,0.002002,74.125.24.0-255,4320,121981,92,140753
4592,0.002004,172.31.47.0-255,66,122047,92,140753
4593,0.002019,74.125.24.0-255,766,122813,92,140753
4594,0.002184,172.31.47.0-255,66,122879,92,140753
4595,0.004321,74.125.24.0-255,2902,125781,92,140753
4596,0.004326,172.31.47.0-255,66,125847,92,140753
4597,0.004342,74.125.24.0-255,1484,127331,92,140753
4598,0.004482,74.125.24.0-255,1484,128815,92,140753
4599,0.004487,172.31.47.0-255,66,128881,92,140753
4600,0.00663,74.125.24.0-255,2902,131783,92,140753
4601,0.006635,172.31.47.0-255,66,131849,92,140753
4602,0.006811,74.125.24.0-255,2902,134751,92,140753
4603,0.006816,172.31.47.0-255,66,134817,92,140753
4604,0.009066,74.125.24.0-255,2902,137719,92,140753
4605,0.009119,172.31.47.0-255,66,137785,92,140753
4606,0.009364,74.125.24.0-255,2902,140687,92,140753
4607,0.009409,172.31.47.0-255,66,140753,92,140753
4608,0.0,74.125.24.0-255,153,153,92,179852
4609,1.3e-05,172.31.47.0-255,66,219,92,179852
4610,1.9e-05,74.125.24.0-255,1484,1703,92,179852
4611,2.3e-05,172.31.47.0-255,66,1769,92,179852
4612,3e-05,74.125.24.0-255,2902,4671,92,179852
4613,3.3e-05,172.31.47.0-255,66,4737,92,179852
4614,5.9e-05,74.125.24.0-255,5738,10475,92,179852
4615,6.2e-05,172.31.47.0-255,66,10541,92,179852
4616,8.1e-05,74.125.24.0-255,1484,12025,92,179852
4617,8.3e-05,172.31.47.0-255,66,12091,92,179852
4618,9.5e-05,172.31.47.0-255,66,12157,92,179852
4619,0.00011,74.125.24.0-255,2902,15059,92,179852
4620,0.000112,172.31.47.0-255,66,15125,92,179852
4621,0.000135,172.31.47.0-255,66,15191,92,179852
4622,0.000219,74.125.24.0-255,1484,16675,92,179852
4623,0.000223,172.31.47.0-255,66,16741,92,179852
4624,0.000228,74.125.24.0-255,2902,19643,92,179852
4625,0.000231,172.31.47.0-255,66,19709,92,179852
4626,0.000235,74.125.24.0-255,4320,24029,92,179852
4627,0.000238,172.31.47.0-255,66,24095,92,179852
4628,0.000258,74.125.24.0-255,1484,25579,92,179852
4629,0.00026,172.31.47.0-255,66,25645,92,179852
4630,0.000265,74.125.24.0-255,2902,28547,92,179852
4631,0.000267,172.31.47.0-255,66,28613,92,179852
4632,0.000291,172.31.47.0-255,66,28679,92,179852
4633,0.000295,74.125.24.0-255,2902,31581,92,179852
4634,0.000297,172.31.47.0-255,66,31647,92,179852
4635,0.000326,172.31.47.0-255,66,31713,92,179852
4636,0.000329,74.125.24.0-255,1434,33147,92,179852
4637,0.000346,74.125.24.0-255,379,33526,92,179852
4638,0.000348,172.31.47.0-255,66,33592,92,179852
4639,0.000822,74.125.24.0-255,1484,35076,92,179852
4640,0.000829,74.125.24.0-255,2902,37978,92,179852
4641,0.000832,172.31.47.0-255,66,38044,92,179852
4642,0.000839,74.125.24.0-255,5738,43782,92,179852
4643,0.000841,172.31.47.0-255,66,43848,92,179852
4644,0.000863,74.125.24.0-255,5738,49586,92,179852
4645,0.000866,172.31.47.0-255,66,49652,92,179852
4646,0.000888,74.125.24.0-255,7156,56808,92,179852
4647,0.000891,172.31.47.0-255,66,56874,92,179852
4648,0.000898,74.125.24.0-255,7156,64030,92,179852
4649,0.000901,172.31.47.0-255,66,64096,92,179852
4650,0.000919,74.125.24.0-255,1484,65580,92,179852
4651,0.000938,74.125.24.0-255,2184,67764,92,179852
4652,0.000941,172.31.47.0-255,66,67830,92,179852
4653,0.001049,74.125.24.0-255,1484,69314,92,179852
4654,0.001055,74.125.24.0-255,2902,72216,92,179852
4655,0.001058,172.31.47.0-255,66,72282,92,179852
4656,0.001078,74.125.24.0-255,2902,75184,92,179852
4657,0.001081,172.31.47.0-255,66,75250,92,179852
4658,0.001087,74.125.24.0-255,4320,79570,92,179852
4659,0.001089,172.31.47.0-255,66,79636,92,179852
4660,0.00112,172.31.47.0-255,66,79702,92,179852
4661,0.001126,74.125.24.0-255,4320,84022,92,179852
4662,0.001128,172.31.47.0-255,66,84088,92,179852
4663,0.00115,172.31.47.0-255,66,84154,92,179852
4664,0.001163,74.125.24.0-255,766,84920,92,179852
4665,0.001182,74.125.24.0-255,1484,86404,92,179852
4666,0.001185,172.31.47.0-255,66,86470,92,179852
4667,0.00119,74.125.24.0-255,4320,90790,92,179852
4668,0.001193,172.31.47.0-255,66,90856,92,179852
4669,0.001212,74.125.24.0-255,5738,96594,92,179852
4670,0.001216,172.31.47.0-255,66,96660,92,179852
4671,0.001226,74.125.24.0-255,4320,100980,92,179852
4672,0.001228,172.31.47.0-255,66,101046,92,179852
4673,0.001255,74.125.24.0-255,1484,102530,92,179852
4674,0.001283,172.31.47.0-255,66,102596,92,179852
4675,0.00129,74.125.24.0-255,6438,109034,92,179852
4676,0.001293,172.31.47.0-255,66,109100,92,179852
4677,0.001347,74.125.24.0-255,1484,110584,92,179852
4678,0.001353,74.125.24.0-255,2902,113486,92,179852
4679,0.001356,172.31.47.0-255,66,113552,92,179852
4680,0.001361,74.125.24.0-255,2902,116454,92,179852
4681,0.001364,172.31.47.0-255,66,116520,92,179852
4682,0.001395,74.125.24.0-255,2902,119422,92,179852
4683,0.001401,74.125.24.0-255,5738,125160,92,179852
4684,0.001417,172.31.47.0-255,66,125226,92,179852
4685,0.00142,172.31.47.0-255,66,125292,92,179852
4686,0.001423,172.31.47.0-255,66,125358,92,179852
4687,0.001433,74.125.24.0-255,5020,130378,92,179852
4688,0.001436,172.31.47.0-255,66,130444,92,179852
4689,0.001535,74.125.24.0-255,1484,131928,92,179852
4690,0.001541,74.125.24.0-255,2902,134830,92,179852
4691,0.001544,172.31.47.0-255,66,134896,92,179852
4692,0.00155,74.125.24.0-255,4320,139216,92,179852
4693,0.001552,172.31.47.0-255,66,139282,92,179852
4694,0.001564,74.125.24.0-255,1484,140766,92,179852
4695,0.001567,74.125.24.0-255,1484,142250,92,179852
4696,0.001569,172.31.47.0-255,66,142316,92,179852
4697,0.001609,74.125.24.0-255,7156,149472,92,179852
4698,0.001613,172.31.47.0-255,66,149538,92,179852
4699,0.00162,172.31.47.0-255,66,149604,92,179852
4700,0.00164,74.125.24.0-255,3602,153206,92,179852
4701,0.001643,172.31.47.0-255,66,153272,92,179852
4702,0.001754,74.125.24.0-255,1484,154756,92,179852
4703,0.00178,74.125.24.0-255,2902,157658,92,179852
4704,0.001783,172.31.47.0-255,66,157724,92,179852
4705,0.001786,74.125.24.0-255,1484,159208,92,179852
4706,0.001803,74.125.24.0-255,2902,162110,92,179852
4707,0.001806,172.31.47.0-255,66,162176,92,179852
4708,0.00184,172.31.47.0-255,66,162242,92,179852
4709,0.00185,172.31.47.0-255,66,162308,92,179852
4710,0.001874,172.31.47.0-255,66,162374,92,179852
4711,0.004124,74.125.24.0-255,5738,168112,92,179852
4712,0.004132,172.31.47.0-255,66,168178,92,179852
4713,0.006416,74.125.24.0-255,5738,173916,92,179852
4714,0.006423,172.31.47.0-255,66,173982,92,179852
4715,0.00868,74.125.24.0-255,4320,178302,92,179852
4716,0.008684,172.31.47.0-255,66,178368,92,179852
4717,0.008703,74.125.24.0-255,1484,179852,92,179852
4718,0.0,172.217.194.0-255,152,152,92,100667
4719,2.3e-05,172.31.47.0-255,66,218,92,100667
4720,3.1e-05,172.217.194.0-255,1484,1702,92,100667
4721,3.5e-05,172.31.47.0-255,66,1768,92,100667
4722,4.2e-05,172.217.194.0-255,2902,4670,92,100667
4723,4.5e-05,172.31.47.0-255,66,4736,92,100667
4724,7.6e-05,172.217.194.0-255,1484,6220,92,100667
4725,7.9e-05,172.31.47.0-255,66,6286,92,100667
4726,0.000104,172.217.194.0-255,5738,12024,92,100667
4727,0.000107,172.31.47.0-255,66,12090,92,100667
4728,0.00023,172.217.194.0-255,2042,14132,92,100667
4729,0.000234,172.31.47.0-255,66,14198,92,100667
4730,0.000274,172.217.194.0-255,7156,21354,92,100667
4731,0.000278,172.31.47.0-255,66,21420,92,100667
4732,0.000295,172.217.194.0-255,2902,24322,92,100667
4733,0.000298,172.31.47.0-255,66,24388,92,100667
4734,0.000487,172.217.194.0-255,5738,30126,92,100667
4735,0.000493,172.31.47.0-255,66,30192,92,100667
4736,0.00051,172.217.194.0-255,1125,31317,92,100667
4737,0.000514,172.31.47.0-255,66,31383,92,100667
4738,0.000634,172.217.194.0-255,5738,37121,92,100667
4739,0.000638,172.31.47.0-255,66,37187,92,100667
4740,0.000651,172.217.194.0-255,1484,38671,92,100667
4741,0.000653,172.31.47.0-255,66,38737,92,100667
4742,0.00079,172.31.47.0-255,66,38803,92,100667
4743,0.000964,172.217.194.0-255,1484,40287,92,100667
4744,0.000968,172.31.47.0-255,66,40353,92,100667
4745,0.001011,172.217.194.0-255,2902,43255,92,100667
4746,0.001014,172.31.47.0-255,66,43321,92,100667
4747,0.001069,172.217.194.0-255,5738,49059,92,100667
4748,0.001073,172.31.47.0-255,66,49125,92,100667
4749,0.001193,172.217.194.0-255,6797,55922,92,100667
4750,0.001197,172.31.47.0-255,66,55988,92,100667
4751,0.001305,172.217.194.0-255,365,56353,92,100667
4752,0.001423,172.217.194.0-255,380,56733,92,100667
4753,0.001617,172.217.194.0-255,1484,58217,92,100667
4754,0.001624,172.31.47.0-255,66,58283,92,100667
4755,0.00163,172.217.194.0-255,1484,59767,92,100667
4756,0.001644,172.217.194.0-255,1484,61251,92,100667
4757,0.001646,172.31.47.0-255,66,61317,92,100667
4758,0.001677,172.217.194.0-255,2902,64219,92,100667
4759,0.00168,172.31.47.0-255,66,64285,92,100667
4760,0.001699,172.217.194.0-255,2902,67187,92,100667
4761,0.001701,172.31.47.0-255,66,67253,92,100667
4762,0.001815,172.217.194.0-255,4320,71573,92,100667
4763,0.001819,172.31.47.0-255,66,71639,92,100667
4764,0.001837,172.217.194.0-255,2543,74182,92,100667
4765,0.001839,172.31.47.0-255,66,74248,92,100667
4766,0.00195,172.217.194.0-255,2902,77150,92,100667
4767,0.001954,172.31.47.0-255,66,77216,92,100667
4768,0.002,172.217.194.0-255,2902,80118,92,100667
4769,0.002002,172.31.47.0-255,66,80184,92,100667
4770,0.002019,172.31.47.0-255,66,80250,92,100667
4771,0.00224,172.217.194.0-255,2543,82793,92,100667
4772,0.002244,172.31.47.0-255,66,82859,92,100667
4773,0.004122,172.217.194.0-255,2902,85761,92,100667
4774,0.004127,172.31.47.0-255,66,85827,92,100667
4775,0.004357,172.217.194.0-255,2902,88729,92,100667
4776,0.00436,172.31.47.0-255,66,88795,92,100667
4777,0.006207,172.217.194.0-255,2902,91697,92,100667
4778,0.00621,172.31.47.0-255,66,91763,92,100667
4779,0.006445,172.217.194.0-255,2902,94665,92,100667
4780,0.006451,172.31.47.0-255,66,94731,92,100667
4781,0.008312,172.217.194.0-255,2902,97633,92,100667
4782,0.008318,172.31.47.0-255,66,97699,92,100667
4783,0.008556,172.217.194.0-255,2902,100601,92,100667
4784,0.00856,172.31.47.0-255,66,100667,92,100667
4785,0.0,74.125.24.0-255,153,153,92,110820
4786,2.9e-05,172.31.47.0-255,66,219,92,110820
4787,3.5e-05,74.125.24.0-255,1484,1703,92,110820
4788,4e-05,172.31.47.0-255,66,1769,92,110820
4789,5.2e-05,74.125.24.0-255,2902,4671,92,110820
4790,5.6e-05,172.31.47.0-255,66,4737,92,110820
4791,6.1e-05,74.125.24.0-255,5738,10475,92,110820
4792,6.4e-05,172.31.47.0-255,66,10541,92,110820
4793,9.8e-05,74.125.24.0-255,3556,14097,92,110820
4794,0.000101,172.31.47.0-255,66,14163,92,110820
4795,0.001175,74.125.24.0-255,1484,15647,92,110820
4796,0.001182,172.31.47.0-255,66,15713,92,110820
4797,0.001192,74.125.24.0-255,2902,18615,92,110820
4798,0.001194,172.31.47.0-255,66,18681,92,110820
4799,0.001205,74.125.24.0-255,5738,24419,92,110820
4800,0.001207,172.31.47.0-255,66,24485,92,110820
4801,0.001211,74.125.24.0-255,2902,27387,92,110820
4802,0.001213,172.31.47.0-255,66,27453,92,110820
4803,0.00124,74.125.24.0-255,2902,30355,92,110820
4804,0.001246,172.31.47.0-255,66,30421,92,110820
4805,0.001283,172.31.47.0-255,66,30487,92,110820
4806,0.001289,74.125.24.0-255,5738,36225,92,110820
4807,0.001291,172.31.47.0-255,66,36291,92,110820
4808,0.001295,74.125.24.0-255,2902,39193,92,110820
4809,0.001297,172.31.47.0-255,66,39259,92,110820
4810,0.001344,172.31.47.0-255,66,39325,92,110820
4811,0.001348,74.125.24.0-255,2184,41509,92,110820
4812,0.00135,172.31.47.0-255,66,41575,92,110820
4813,0.001352,74.125.24.0-255,363,41938,92,110820
4814,0.001354,172.31.47.0-255,66,42004,92,110820
4815,0.001519,74.125.24.0-255,380,42384,92,110820
4816,0.001716,74.125.24.0-255,1484,43868,92,110820
4817,0.00172,172.31.47.0-255,66,43934,92,110820
4818,0.001724,74.125.24.0-255,1484,45418,92,110820
4819,0.001748,74.125.24.0-255,1484,46902,92,110820
4820,0.001752,74.125.24.0-255,4320,51222,92,110820
4821,0.001757,172.31.47.0-255,66,51288,92,110820
4822,0.00176,172.31.47.0-255,66,51354,92,110820
4823,0.00178,74.125.24.0-255,1484,52838,92,110820
4824,0.001785,74.125.24.0-255,4320,57158,92,110820
4825,0.001787,172.31.47.0-255,66,57224,92,110820
4826,0.001798,172.31.47.0-255,66,57290,92,110820
4827,0.00184,172.31.47.0-255,66,57356,92,110820
4828,0.00193,74.125.24.0-255,1484,58840,92,110820
4829,0.001951,74.125.24.0-255,2902,61742,92,110820
4830,0.001955,172.31.47.0-255,66,61808,92,110820
4831,0.001958,74.125.24.0-255,1484,63292,92,110820
4832,0.001986,74.125.24.0-255,4320,67612,92,110820
4833,0.001988,172.31.47.0-255,66,67678,92,110820
4834,0.001993,74.125.24.0-255,5738,73416,92,110820
4835,0.001995,172.31.47.0-255,66,73482,92,110820
4836,0.001999,74.125.24.0-255,4320,77802,92,110820
4837,0.002007,172.31.47.0-255,66,77868,92,110820
4838,0.002049,172.31.47.0-255,66,77934,92,110820
4839,0.002054,74.125.24.0-255,5020,82954,92,110820
4840,0.002056,172.31.47.0-255,66,83020,92,110820
4841,0.002254,74.125.24.0-255,1484,84504,92,110820
4842,0.00228,74.125.24.0-255,2902,87406,92,110820
4843,0.002283,172.31.47.0-255,66,87472,92,110820
4844,0.002289,74.125.24.0-255,5738,93210,92,110820
4845,0.002291,172.31.47.0-255,66,93276,92,110820
4846,0.002373,172.31.47.0-255,66,93342,92,110820
4847,0.002384,172.31.47.0-255,66,93408,92,110820
4848,0.004729,74.125.24.0-255,5738,99146,92,110820
4849,0.004736,172.31.47.0-255,66,99212,92,110820
4850,0.00709,74.125.24.0-255,5738,104950,92,110820
4851,0.007097,172.31.47.0-255,66,105016,92,110820
4852,0.00951,74.125.24.0-255,5738,110754,92,110820
4853,0.009519,172.31.47.0-255,66,110820,92,110820
4854,0.0,74.125.24.0-255,153,153,92,233470
4855,1.6e-05,172.31.47.0-255,66,219,92,233470
4856,2.4e-05,74.125.24.0-255,1484,1703,92,233470
4857,2.8e-05,172.31.47.0-255,66,1769,92,233470
4858,3.3e-05,74.125.24.0-255,2902,4671,92,233470
4859,3.6e-05,172.31.47.0-255,66,4737,92,233470
4860,4.3e-05,74.125.24.0-255,7156,11893,92,233470
4861,4.6e-05,172.31.47.0-255,66,11959,92,233470
4862,7.4e-05,74.125.24.0-255,1983,13942,92,233470
4863,7.6e-05,172.31.47.0-255,66,14008,92,233470
4864,0.000125,74.125.24.0-255,1484,15492,92,233470
4865,0.000127,172.31.47.0-255,66,15558,92,233470
4866,0.000132,74.125.24.0-255,2902,18460,92,233470
4867,0.000134,172.31.47.0-255,66,18526,92,233470
4868,0.000164,74.125.24.0-255,5738,24264,92,233470
4869,0.000167,172.31.47.0-255,66,24330,92,233470
4870,0.000172,74.125.24.0-255,4320,28650,92,233470
4871,0.000174,172.31.47.0-255,66,28716,92,233470
4872,0.000191,74.125.24.0-255,1484,30200,92,233470
4873,0.000194,172.31.47.0-255,66,30266,92,233470
4874,0.000233,172.31.47.0-255,66,30332,92,233470
4875,0.00024,74.125.24.0-255,6797,37129,92,233470
4876,0.000242,172.31.47.0-255,66,37195,92,233470
4877,0.000767,74.125.24.0-255,1484,38679,92,233470
4878,0.000774,172.31.47.0-255,66,38745,92,233470
4879,0.00078,74.125.24.0-255,2902,41647,92,233470
4880,0.000782,172.31.47.0-255,66,41713,92,233470
4881,0.000785,74.125.24.0-255,1484,43197,92,233470
4882,0.000787,172.31.47.0-255,66,43263,92,233470
4883,0.000791,74.125.24.0-255,2902,46165,92,233470
4884,0.000794,172.31.47.0-255,66,46231,92,233470
4885,0.000814,74.125.24.0-255,1484,47715,92,233470
4886,0.000834,74.125.24.0-255,4320,52035,92,233470
4887,0.000837,172.31.47.0-255,66,52101,92,233470
4888,0.000858,74.125.24.0-255,2543,54644,92,233470
4889,0.000861,172.31.47.0-255,66,54710,92,233470
4890,0.000865,74.125.24.0-255,2902,57612,92,233470
4891,0.000867,172.31.47.0-255,66,57678,92,233470
4892,0.000878,74.125.24.0-255,1484,59162,92,233470
4893,0.000895,74.125.24.0-255,5738,64900,92,233470
4894,0.000898,172.31.47.0-255,66,64966,92,233470
4895,0.000903,74.125.24.0-255,4320,69286,92,233470
4896,0.000906,172.31.47.0-255,66,69352,92,233470
4897,0.000908,74.125.24.0-255,1484,70836,92,233470
4898,0.000943,172.31.47.0-255,66,70902,92,233470
4899,0.000952,74.125.24.0-255,6438,77340,92,233470
4900,0.000954,172.31.47.0-255,66,77406,92,233470
4901,0.001645,74.125.24.0-255,647,78053,92,233470
4902,0.001683,74.125.24.0-255,1484,79537,92,233470
4903,0.001688,172.31.47.0-255,66,79603,92,233470
4904,0.001693,74.125.24.0-255,1484,81087,92,233470
4905,0.001708,74.125.24.0-255,1484,82571,92,233470
4906,0.00171,172.31.47.0-255,66,82637,92,233470
4907,0.001716,74.125.24.0-255,2902,85539,92,233470
4908,0.001718,172.31.47.0-255,66,85605,92,233470
4909,0.00173,74.125.24.0-255,2902,88507,92,233470
4910,0.001733,172.31.47.0-255,66,88573,92,233470
4911,0.001767,74.125.24.0-255,1484,90057,92,233470
4912,0.001795,172.31.47.0-255,66,90123,92,233470
4913,0.001851,172.31.47.0-255,66,90189,92,233470
4914,0.003193,74.125.24.0-255,1484,91673,92,233470
4915,0.003201,74.125.24.0-255,2902,94575,92,233470
4916,0.003205,172.31.47.0-255,66,94641,92,233470
4917,0.003211,74.125.24.0-255,2902,97543,92,233470
4918,0.003212,172.31.47.0-255,66,97609,92,233470
4919,0.003218,74.125.24.0-255,4320,101929,92,233470
4920,0.00322,172.31.47.0-255,66,101995,92,233470
4921,0.003255,172.31.47.0-255,66,102061,92,233470
4922,0.003261,74.125.24.0-255,4320,106381,92,233470
4923,0.003263,172.31.47.0-255,66,106447,92,233470
4924,0.00331,172.31.47.0-255,66,106513,92,233470
4925,0.003593,74.125.24.0-255,1484,107997,92,233470
4926,0.003598,74.125.24.0-255,2902,110899,92,233470
4927,0.0036,172.31.47.0-255,66,110965,92,233470
4928,0.003622,74.125.24.0-255,5738,116703,92,233470
4929,0.003625,172.31.47.0-255,66,116769,92,233470
4930,0.003656,172.31.47.0-255,66,116835,92,233470
4931,0.003671,74.125.24.0-255,1484,118319,92,233470
4932,0.003682,172.31.47.0-255,66,118385,92,233470
4933,0.003699,74.125.24.0-255,1484,119869,92,233470
4934,0.003706,74.125.24.0-255,5738,125607,92,233470
4935,0.003709,172.31.47.0-255,66,125673,92,233470
4936,0.003729,74.125.24.0-255,5020,130693,92,233470
4937,0.003732,172.31.47.0-255,66,130759,92,233470
4938,0.003735,74.125.24.0-255,1484,132243,92,233470
4939,0.00376,172.31.47.0-255,66,132309,92,233470
4940,0.003762,74.125.24.0-255,1484,133793,92,233470
4941,0.003786,172.31.47.0-255,66,133859,92,233470
4942,0.003804,74.125.24.0-255,2902,136761,92,233470
4943,0.003806,172.31.47.0-255,66,136827,92,233470
4944,0.00383,74.125.24.0-255,4320,141147,92,233470
4945,0.003832,172.31.47.0-255,66,141213,92,233470
4946,0.003859,74.125.24.0-255,1484,142697,92,233470
4947,0.003888,74.125.24.0-255,7156,149853,92,233470
4948,0.003892,172.31.47.0-255,66,149919,92,233470
4949,0.003902,172.31.47.0-255,66,149985,92,233470
4950,0.003913,172.31.47.0-255,66,150051,92,233470
4951,0.00393,74.125.24.0-255,4320,154371,92,233470
4952,0.003933,172.31.47.0-255,66,154437,92,233470
4953,0.003954,172.31.47.0-255,66,154503,92,233470
4954,0.003961,74.125.24.0-255,7156,161659,92,233470
4955,0.003964,172.31.47.0-255,66,161725,92,233470
4956,0.003997,172.31.47.0-255,66,161791,92,233470
4957,0.004042,74.125.24.0-255,7156,168947,92,233470
4958,0.004045,172.31.47.0-255,66,169013,92,233470
4959,0.004061,74.125.24.0-255,2902,171915,92,233470
4960,0.004063,172.31.47.0-255,66,171981,92,233470
4961,0.004083,172.31.47.0-255,66,172047,92,233470
4962,0.004087,74.125.24.0-255,2184,174231,92,233470
4963,0.004089,172.31.47.0-255,66,174297,92,233470
4964,0.004093,74.125.24.0-255,2902,177199,92,233470
4965,0.004095,172.31.47.0-255,66,177265,92,233470
4966,0.004097,74.125.24.0-255,1484,178749,92,233470
4967,0.004104,74.125.24.0-255,5738,184487,92,233470
4968,0.004106,172.31.47.0-255,66,184553,92,233470
4969,0.004124,74.125.24.0-255,1484,186037,92,233470
4970,0.00415,74.125.24.0-255,7156,193193,92,233470
4971,0.004152,172.31.47.0-255,66,193259,92,233470
4972,0.004158,74.125.24.0-255,5738,198997,92,233470
4973,0.00416,172.31.47.0-255,66,199063,92,233470
4974,0.004176,74.125.24.0-255,4320,203383,92,233470
4975,0.004179,172.31.47.0-255,66,203449,92,233470
4976,0.004181,74.125.24.0-255,1484,204933,92,233470
4977,0.004203,74.125.24.0-255,3602,208535,92,233470
4978,0.004206,172.31.47.0-255,66,208601,92,233470
4979,0.004222,74.125.24.0-255,1484,210085,92,233470
4980,0.004226,74.125.24.0-255,2902,212987,92,233470
4981,0.004228,172.31.47.0-255,66,213053,92,233470
4982,0.004254,74.125.24.0-255,5738,218791,92,233470
4983,0.004257,172.31.47.0-255,66,218857,92,233470
4984,0.004262,74.125.24.0-255,4320,223177,92,233470
4985,0.004264,172.31.47.0-255,66,223243,92,233470
4986,0.004282,172.31.47.0-255,66,223309,92,233470
4987,0.004288,74.125.24.0-255,5738,229047,92,233470
4988,0.00429,172.31.47.0-255,66,229113,92,233470
4989,0.004305,74.125.24.0-255,1484,230597,92,233470
4990,0.00432,74.125.24.0-255,1484,232081,92,233470
4991,0.004322,172.31.47.0-255,66,232147,92,233470
4992,0.004353,172.31.47.0-255,66,232213,92,233470
4993,0.00438,172.31.47.0-255,66,232279,92,233470
4994,0.004382,74.125.24.0-255,849,233128,92,233470
4995,0.004386,74.125.24.0-255,105,233233,92,233470
4996,0.006689,172.31.47.0-255,66,233299,92,233470
4997,0.006723,172.31.47.0-255,105,233404,92,233470
4998,0.008769,74.125.24.0-255,66,233470,92,233470
4999,0.0,74.125.68.0-255,152,152,92,170179
5000,3.8e-05,172.31.47.0-255,66,218,92,170179
5001,4.5e-05,74.125.68.0-255,1484,1702,92,170179
5002,5.1e-05,172.31.47.0-255,66,1768,92,170179
5003,5.7e-05,74.125.68.0-255,2902,4670,92,170179
5004,5.9e-05,172.31.47.0-255,66,4736,92,170179
5005,8.4e-05,74.125.68.0-255,1484,6220,92,170179
5006,8.6e-05,172.31.47.0-255,66,6286,92,170179
5007,9.1e-05,74.125.68.0-255,2902,9188,92,170179
5008,9.3e-05,172.31.47.0-255,66,9254,92,170179
5009,0.000142,74.125.68.0-255,4964,14218,92,170179
5010,0.000145,172.31.47.0-255,66,14284,92,170179
5011,0.000186,74.125.68.0-255,1484,15768,92,170179
5012,0.000188,172.31.47.0-255,66,15834,92,170179
5013,0.000219,74.125.68.0-255,2902,18736,92,170179
5014,0.000222,172.31.47.0-255,66,18802,92,170179
5015,0.000226,74.125.68.0-255,1484,20286,92,170179
5016,0.000228,172.31.47.0-255,66,20352,92,170179
5017,0.000244,74.125.68.0-255,2902,23254,92,170179
5018,0.000247,172.31.47.0-255,66,23320,92,170179
5019,0.000263,74.125.68.0-255,1484,24804,92,170179
5020,0.000265,172.31.47.0-255,66,24870,92,170179
5021,0.000291,74.125.68.0-255,4320,29190,92,170179
5022,0.000293,172.31.47.0-255,66,29256,92,170179
5023,0.000298,74.125.68.0-255,2543,31799,92,170179
5024,0.000301,172.31.47.0-255,66,31865,92,170179
5025,0.000433,74.125.68.0-255,1484,33349,92,170179
5026,0.000438,172.31.47.0-255,66,33415,92,170179
5027,0.000457,74.125.68.0-255,2902,36317,92,170179
5028,0.00046,172.31.47.0-255,66,36383,92,170179
5029,0.000488,74.125.68.0-255,5738,42121,92,170179
5030,0.000491,172.31.47.0-255,66,42187,92,170179
5031,0.000495,74.125.68.0-255,2902,45089,92,170179
5032,0.000497,172.31.47.0-255,66,45155,92,170179
5033,0.000501,74.125.68.0-255,1484,46639,92,170179
5034,0.000527,74.125.68.0-255,2543,49182,92,170179
5035,0.00053,172.31.47.0-255,66,49248,92,170179
5036,0.000634,74.125.68.0-255,1484,50732,92,170179
5037,0.000639,74.125.68.0-255,1484,52216,92,170179
5038,0.000644,172.31.47.0-255,66,52282,92,170179
5039,0.000655,74.125.68.0-255,1484,53766,92,170179
5040,0.000671,74.125.68.0-255,4320,58086,92,170179
5041,0.000674,172.31.47.0-255,66,58152,92,170179
5042,0.00069,74.125.68.0-255,1484,59636,92,170179
5043,0.000699,74.125.68.0-255,6797,66433,92,170179
5044,0.000702,172.31.47.0-255,66,66499,92,170179
5045,0.000724,74.125.68.0-255,676,67175,92,170179
5046,0.000867,74.125.68.0-255,1484,68659,92,170179
5047,0.000872,172.31.47.0-255,66,68725,92,170179
5048,0.000881,74.125.68.0-255,2902,71627,92,170179
5049,0.000883,172.31.47.0-255,66,71693,92,170179
5050,0.00091,74.125.68.0-255,4320,76013,92,170179
5051,0.000914,172.31.47.0-255,66,76079,92,170179
5052,0.000918,74.125.68.0-255,4320,80399,92,170179
5053,0.00092,172.31.47.0-255,66,80465,92,170179
5054,0.000934,74.125.68.0-255,1484,81949,92,170179
5055,0.000949,74.125.68.0-255,1484,83433,92,170179
5056,0.000952,172.31.47.0-255,66,83499,92,170179
5057,0.000984,172.31.47.0-255,66,83565,92,170179
5058,0.001022,172.31.47.0-255,66,83631,92,170179
5059,0.001427,74.125.68.0-255,1484,85115,92,170179
5060,0.001439,74.125.68.0-255,2902,88017,92,170179
5061,0.001443,172.31.47.0-255,66,88083,92,170179
5062,0.00145,74.125.68.0-255,4320,92403,92,170179
5063,0.001453,172.31.47.0-255,66,92469,92,170179
5064,0.001471,74.125.68.0-255,1484,93953,92,170179
5065,0.00149,74.125.68.0-255,5738,99691,92,170179
5066,0.001494,172.31.47.0-255,66,99757,92,170179
5067,0.001511,74.125.68.0-255,1484,101241,92,170179
5068,0.001525,74.125.68.0-255,1484,102725,92,170179
5069,0.001528,172.31.47.0-255,66,102791,92,170179
5070,0.001558,74.125.68.0-255,1484,104275,92,170179
5071,0.001572,74.125.68.0-255,1484,105759,92,170179
5072,0.001575,172.31.47.0-255,66,105825,92,170179
5073,0.00159,74.125.68.0-255,1484,107309,92,170179
5074,0.001614,74.125.68.0-255,5738,113047,92,170179
5075,0.001617,172.31.47.0-255,66,113113,92,170179
5076,0.001622,74.125.68.0-255,2902,116015,92,170179
5077,0.001624,172.31.47.0-255,66,116081,92,170179
5078,0.001655,74.125.68.0-255,2184,118265,92,170179
5079,0.001657,172.31.47.0-255,66,118331,92,170179
5080,0.001769,74.125.68.0-255,1484,119815,92,170179
5081,0.001791,74.125.68.0-255,2902,122717,92,170179
5082,0.001794,172.31.47.0-255,66,122783,92,170179
5083,0.001801,74.125.68.0-255,4320,127103,92,170179
5084,0.001803,172.31.47.0-255,66,127169,92,170179
5085,0.001815,74.125.68.0-255,1484,128653,92,170179
5086,0.00182,74.125.68.0-255,2902,131555,92,170179
5087,0.001823,172.31.47.0-255,66,131621,92,170179
5088,0.001828,74.125.68.0-255,4320,135941,92,170179
5089,0.001832,172.31.47.0-255,66,136007,92,170179
5090,0.00186,74.125.68.0-255,2902,138909,92,170179
5091,0.001863,172.31.47.0-255,66,138975,92,170179
5092,0.001883,74.125.68.0-255,5738,144713,92,170179
5093,0.001887,172.31.47.0-255,66,144779,92,170179
5094,0.001916,74.125.68.0-255,1484,146263,92,170179
5095,0.001947,74.125.68.0-255,6438,152701,92,170179
5096,0.001952,172.31.47.0-255,66,152767,92,170179
5097,0.003929,74.125.68.0-255,5738,158505,92,170179
5098,0.003948,172.31.47.0-255,66,158571,92,170179
5099,0.005937,74.125.68.0-255,5738,164309,92,170179
5100,0.005948,172.31.47.0-255,66,164375,92,170179
5101,0.007966,74.125.68.0-255,5738,170113,92,170179
5102,0.007982,172.31.47.0-255,66,170179,92,170179
5103,0.0,172.253.118.0-255,97,97,92,163
5104,0.007217,172.253.118.0-255,66,163,92,163
5105,0.0,74.125.68.0-255,152,152,92,143152
5106,4.1e-05,172.31.47.0-255,66,218,92,143152
5107,4.7e-05,74.125.68.0-255,1484,1702,92,143152
5108,5.1e-05,172.31.47.0-255,66,1768,92,143152
5109,5.6e-05,74.125.68.0-255,2902,4670,92,143152
5110,5.9e-05,172.31.47.0-255,66,4736,92,143152
5111,6.5e-05,74.125.68.0-255,7156,11892,92,143152
5112,6.8e-05,172.31.47.0-255,66,11958,92,143152
5113,8.8e-05,74.125.68.0-255,2067,14025,92,143152
5114,9.1e-05,172.31.47.0-255,66,14091,92,143152
5115,0.000123,74.125.68.0-255,1484,15575,92,143152
5116,0.000125,172.31.47.0-255,66,15641,92,143152
5117,0.000141,74.125.68.0-255,2902,18543,92,143152
5118,0.000144,172.31.47.0-255,66,18609,92,143152
5119,0.000149,74.125.68.0-255,1484,20093,92,143152
5120,0.00015,172.31.47.0-255,66,20159,92,143152
5121,0.00017,74.125.68.0-255,4320,24479,92,143152
5122,0.000173,172.31.47.0-255,66,24545,92,143152
5123,0.000177,74.125.68.0-255,2902,27447,92,143152
5124,0.000179,172.31.47.0-255,66,27513,92,143152
5125,0.000183,74.125.68.0-255,3961,31474,92,143152
5126,0.000186,172.31.47.0-255,66,31540,92,143152
5127,0.00036,74.125.68.0-255,1484,33024,92,143152
5128,0.000365,172.31.47.0-255,66,33090,92,143152
5129,0.000368,74.125.68.0-255,1484,34574,92,143152
5130,0.000369,172.31.47.0-255,66,34640,92,143152
5131,0.000388,74.125.68.0-255,2902,37542,92,143152
5132,0.000391,172.31.47.0-255,66,37608,92,143152
5133,0.000412,74.125.68.0-255,5738,43346,92,143152
5134,0.000417,172.31.47.0-255,66,43412,92,143152
5135,0.000423,74.125.68.0-255,2902,46314,92,143152
5136,0.000425,172.31.47.0-255,66,46380,92,143152
5137,0.000443,74.125.68.0-255,2543,48923,92,143152
5138,0.000446,172.31.47.0-255,66,48989,92,143152
5139,0.000451,74.125.68.0-255,5738,54727,92,143152
5140,0.000454,172.31.47.0-255,66,54793,92,143152
5141,0.000496,74.125.68.0-255,4320,59113,92,143152
5142,0.000499,172.31.47.0-255,66,59179,92,143152
5143,0.00052,74.125.68.0-255,7071,66250,92,143152
5144,0.000523,172.31.47.0-255,66,66316,92,143152
5145,0.000526,74.125.68.0-255,132,66448,92,143152
5146,0.00066,172.31.47.0-255,66,66514,92,143152
5147,0.00097,74.125.68.0-255,346,66860,92,143152
5148,0.001003,172.31.47.0-255,66,66926,92,143152
5149,0.001263,74.125.68.0-255,1484,68410,92,143152
5150,0.00127,74.125.68.0-255,1484,69894,92,143152
5151,0.001273,172.31.47.0-255,66,69960,92,143152
5152,0.001294,74.125.68.0-255,1484,71444,92,143152
5153,0.001299,74.125.68.0-255,4320,75764,92,143152
5154,0.001301,172.31.47.0-255,66,75830,92,143152
5155,0.001331,172.31.47.0-255,66,75896,92,143152
5156,0.001336,74.125.68.0-255,5738,81634,92,143152
5157,0.001337,172.31.47.0-255,66,81700,92,143152
5158,0.001366,74.125.68.0-255,7156,88856,92,143152
5159,0.001369,172.31.47.0-255,66,88922,92,143152
5160,0.001389,74.125.68.0-255,3602,92524,92,143152
5161,0.001391,172.31.47.0-255,66,92590,92,143152
5162,0.001703,74.125.68.0-255,1484,94074,92,143152
5163,0.001729,74.125.68.0-255,2902,96976,92,143152
5164,0.001732,172.31.47.0-255,66,97042,92,143152
5165,0.001736,74.125.68.0-255,2902,99944,92,143152
5166,0.001737,172.31.47.0-255,66,100010,92,143152
5167,0.00174,74.125.68.0-255,1484,101494,92,143152
5168,0.001751,74.125.68.0-255,2902,104396,92,143152
5169,0.001753,172.31.47.0-255,66,104462,92,143152
5170,0.001786,74.125.68.0-255,4320,108782,92,143152
5171,0.001788,172.31.47.0-255,66,108848,92,143152
5172,0.001809,74.125.68.0-255,4320,113168,92,143152
5173,0.001811,172.31.47.0-255,66,113234,92,143152
5174,0.001832,74.125.68.0-255,7156,120390,92,143152
5175,0.001834,172.31.47.0-255,66,120456,92,143152
5176,0.001854,74.125.68.0-255,5738,126194,92,143152
5177,0.001856,172.31.47.0-255,66,126260,92,143152
5178,0.001876,74.125.68.0-255,766,127026,92,143152
5179,0.002031,172.31.47.0-255,66,127092,92,143152
5180,0.003891,74.125.68.0-255,4320,131412,92,143152
5181,0.003896,172.31.47.0-255,66,131478,92,143152
5182,0.004073,74.125.68.0-255,1484,132962,92,143152
5183,0.00595,74.125.68.0-255,4320,137282,92,143152
5184,0.005957,172.31.47.0-255,66,137348,92,143152
5185,0.008014,74.125.68.0-255,5738,143086,92,143152
5186,0.008039,172.31.47.0-255,66,143152,92,143152
5187,0.0,74.125.24.0-255,298,298,92,181307
5188,2.9e-05,172.31.47.0-255,66,364,92,181307
5189,3.5e-05,74.125.24.0-255,1484,1848,92,181307
5190,3.9e-05,172.31.47.0-255,66,1914,92,181307
5191,4.1e-05,74.125.24.0-255,1484,3398,92,181307
5192,4.3e-05,172.31.47.0-255,66,3464,92,181307
5193,4.9e-05,74.125.24.0-255,2902,6366,92,181307
5194,5.2e-05,172.31.47.0-255,66,6432,92,181307
5195,7.4e-05,74.125.24.0-255,1484,7916,92,181307
5196,7.5e-05,172.31.47.0-255,66,7982,92,181307
5197,8e-05,74.125.24.0-255,2902,10884,92,181307
5198,8.4e-05,172.31.47.0-255,66,10950,92,181307
5199,9.8e-05,74.125.24.0-255,3243,14193,92,181307
5200,0.000101,172.31.47.0-255,66,14259,92,181307
5201,0.000119,74.125.24.0-255,1484,15743,92,181307
5202,0.000121,172.31.47.0-255,66,15809,92,181307
5203,0.000141,74.125.24.0-255,5738,21547,92,181307
5204,0.000144,172.31.47.0-255,66,21613,92,181307
5205,0.000147,74.125.24.0-255,1484,23097,92,181307
5206,0.000149,172.31.47.0-255,66,23163,92,181307
5207,0.000194,74.125.24.0-255,2902,26065,92,181307
5208,0.000197,172.31.47.0-255,66,26131,92,181307
5209,0.000221,74.125.24.0-255,5379,31510,92,181307
5210,0.000224,172.31.47.0-255,66,31576,92,181307
5211,0.000535,74.125.24.0-255,1484,33060,92,181307
5212,0.000539,172.31.47.0-255,66,33126,92,181307
5213,0.000544,74.125.24.0-255,1484,34610,92,181307
5214,0.000546,172.31.47.0-255,66,34676,92,181307
5215,0.000558,74.125.24.0-255,1484,36160,92,181307
5216,0.000561,172.31.47.0-255,66,36226,92,181307
5217,0.000565,74.125.24.0-255,2902,39128,92,181307
5218,0.000567,172.31.47.0-255,66,39194,92,181307
5219,0.000591,74.125.24.0-255,2902,42096,92,181307
5220,0.000595,172.31.47.0-255,66,42162,92,181307
5221,0.000602,74.125.24.0-255,5738,47900,92,181307
5222,0.000604,172.31.47.0-255,66,47966,92,181307
5223,0.00062,74.125.24.0-255,3961,51927,92,181307
5224,0.000623,172.31.47.0-255,66,51993,92,181307
5225,0.000652,74.125.24.0-255,5738,57731,92,181307
5226,0.000655,172.31.47.0-255,66,57797,92,181307
5227,0.00068,172.31.47.0-255,66,57863,92,181307
5228,0.001023,74.125.24.0-255,646,58509,92,181307
5229,0.001152,74.125.24.0-255,1484,59993,92,181307
5230,0.001157,172.31.47.0-255,66,60059,92,181307
5231,0.001162,74.125.24.0-255,1484,61543,92,181307
5232,0.001176,74.125.24.0-255,1484,63027,92,181307
5233,0.001178,172.31.47.0-255,66,63093,92,181307
5234,0.001184,74.125.24.0-255,2902,65995,92,181307
5235,0.001186,172.31.47.0-255,66,66061,92,181307
5236,0.001202,74.125.24.0-255,2902,68963,92,181307
5237,0.001204,172.31.47.0-255,66,69029,92,181307
5238,0.001212,74.125.24.0-255,7156,76185,92,181307
5239,0.001214,172.31.47.0-255,66,76251,92,181307
5240,0.001235,74.125.24.0-255,2902,79153,92,181307
5241,0.001237,172.31.47.0-255,66,79219,92,181307
5242,0.001268,172.31.47.0-255,66,79285,92,181307
5243,0.001272,74.125.24.0-255,2184,81469,92,181307
5244,0.001274,172.31.47.0-255,66,81535,92,181307
5245,0.001473,74.125.24.0-255,1484,83019,92,181307
5246,0.00148,74.125.24.0-255,2902,85921,92,181307
5247,0.001484,172.31.47.0-255,66,85987,92,181307
5248,0.001508,74.125.24.0-255,5738,91725,92,181307
5249,0.001511,172.31.47.0-255,66,91791,92,181307
5250,0.001516,74.125.24.0-255,4320,96111,92,181307
5251,0.001518,172.31.47.0-255,66,96177,92,181307
5252,0.001535,74.125.24.0-255,2902,99079,92,181307
5253,0.001537,172.31.47.0-255,66,99145,92,181307
5254,0.001553,74.125.24.0-255,1484,100629,92,181307
5255,0.001566,74.125.24.0-255,4320,104949,92,181307
5256,0.00157,172.31.47.0-255,66,105015,92,181307
5257,0.001588,74.125.24.0-255,2902,107917,92,181307
5258,0.001591,172.31.47.0-255,66,107983,92,181307
5259,0.001619,172.31.47.0-255,66,108049,92,181307
5260,0.001775,74.125.24.0-255,1484,109533,92,181307
5261,0.001782,74.125.24.0-255,2902,112435,92,181307
5262,0.001787,172.31.47.0-255,66,112501,92,181307
5263,0.001791,74.125.24.0-255,1484,113985,92,181307
5264,0.001806,74.125.24.0-255,4320,118305,92,181307
5265,0.001808,172.31.47.0-255,66,118371,92,181307
5266,0.001836,74.125.24.0-255,7156,125527,92,181307
5267,0.001838,172.31.47.0-255,66,125593,92,181307
5268,0.001841,74.125.24.0-255,1484,127077,92,181307
5269,0.001858,74.125.24.0-255,5738,132815,92,181307
5270,0.00186,172.31.47.0-255,66,132881,92,181307
5271,0.001877,74.125.24.0-255,7156,140037,92,181307
5272,0.001879,172.31.47.0-255,66,140103,92,181307
5273,0.001882,74.125.24.0-255,2184,142287,92,181307
5274,0.001884,172.31.47.0-255,66,142353,92,181307
5275,0.002152,74.125.24.0-255,1484,143837,92,181307
5276,0.002157,74.125.24.0-255,2902,146739,92,181307
5277,0.002159,172.31.47.0-255,66,146805,92,181307
5278,0.002185,74.125.24.0-255,2902,149707,92,181307
5279,0.002187,172.31.47.0-255,66,149773,92,181307
5280,0.002202,74.125.24.0-255,2902,152675,92,181307
5281,0.002204,172.31.47.0-255,66,152741,92,181307
5282,0.002207,74.125.24.0-255,1484,154225,92,181307
5283,0.00224,172.31.47.0-255,66,154291,92,181307
5284,0.002247,74.125.24.0-255,7156,161447,92,181307
5285,0.002249,172.31.47.0-255,66,161513,92,181307
5286,0.002268,74.125.24.0-255,3602,165115,92,181307
5287,0.002271,172.31.47.0-255,66,165181,92,181307
5288,0.004559,74.125.24.0-255,1484,166665,92,181307
5289,0.004631,74.125.24.0-255,4320,170985,92,181307
5290,0.004637,172.31.47.0-255,66,171051,92,181307
5291,0.006963,74.125.24.0-255,4320,175371,92,181307
5292,0.006967,172.31.47.0-255,66,175437,92,181307
5293,0.00698,74.125.24.0-255,1484,176921,92,181307
5294,0.009286,74.125.24.0-255,4320,181241,92,181307
5295,0.009293,172.31.47.0-255,66,181307,92,181307
5296,0.0,74.125.68.0-255,153,153,92,281627
5297,2.8e-05,172.31.47.0-255,66,219,92,281627
5298,3.5e-05,74.125.68.0-255,1484,1703,92,281627
5299,3.9e-05,172.31.47.0-255,66,1769,92,281627
5300,4.5e-05,74.125.68.0-255,2902,4671,92,281627
5301,4.9e-05,172.31.47.0-255,66,4737,92,281627
5302,8.1e-05,74.125.68.0-255,7156,11893,92,281627
5303,8.4e-05,172.31.47.0-255,66,11959,92,281627
5304,0.000111,74.125.68.0-255,2044,14003,92,281627
5305,0.000114,172.31.47.0-255,66,14069,92,281627
5306,0.000133,74.125.68.0-255,2902,16971,92,281627
5307,0.000136,172.31.47.0-255,66,17037,92,281627
5308,0.000163,74.125.68.0-255,7156,24193,92,281627
5309,0.000166,172.31.47.0-255,66,24259,92,281627
5310,0.000171,74.125.68.0-255,4320,28579,92,281627
5311,0.000173,172.31.47.0-255,66,28645,92,281627
5312,0.000234,74.125.68.0-255,2543,31188,92,281627
5313,0.000237,172.31.47.0-255,66,31254,92,281627
5314,0.000274,74.125.68.0-255,1484,32738,92,281627
5315,0.000278,172.31.47.0-255,66,32804,92,281627
5316,0.000294,74.125.68.0-255,2902,35706,92,281627
5317,0.000298,172.31.47.0-255,66,35772,92,281627
5318,0.000332,74.125.68.0-255,5738,41510,92,281627
5319,0.000335,172.31.47.0-255,66,41576,92,281627
5320,0.000338,74.125.68.0-255,1484,43060,92,281627
5321,0.00034,172.31.47.0-255,66,43126,92,281627
5322,0.000356,74.125.68.0-255,4320,47446,92,281627
5323,0.000359,172.31.47.0-255,66,47512,92,281627
5324,0.000385,74.125.68.0-255,1484,48996,92,281627
5325,0.000388,172.31.47.0-255,66,49062,92,281627
5326,0.00041,74.125.68.0-255,5379,54441,92,281627
5327,0.000413,172.31.47.0-255,66,54507,92,281627
5328,0.000424,172.31.47.0-255,66,54573,92,281627
5329,0.000427,74.125.68.0-255,1439,56012,92,281627
5330,0.000555,74.125.68.0-255,111,56123,92,281627
5331,0.000659,74.125.68.0-255,1484,57607,92,281627
5332,0.000664,172.31.47.0-255,66,57673,92,281627
5333,0.000668,74.125.68.0-255,1484,59157,92,281627
5334,0.000682,74.125.68.0-255,2902,62059,92,281627
5335,0.000685,172.31.47.0-255,66,62125,92,281627
5336,0.000689,74.125.68.0-255,2902,65027,92,281627
5337,0.000691,172.31.47.0-255,66,65093,92,281627
5338,0.000709,74.125.68.0-255,2902,67995,92,281627
5339,0.000713,172.31.47.0-255,66,68061,92,281627
5340,0.00073,74.125.68.0-255,5379,73440,92,281627
5341,0.000733,172.31.47.0-255,66,73506,92,281627
5342,0.000774,74.125.68.0-255,1484,74990,92,281627
5343,0.000789,74.125.68.0-255,2902,77892,92,281627
5344,0.000792,172.31.47.0-255,66,77958,92,281627
5345,0.00081,74.125.68.0-255,5738,83696,92,281627
5346,0.000814,172.31.47.0-255,66,83762,92,281627
5347,0.000821,74.125.68.0-255,5738,89500,92,281627
5348,0.000823,172.31.47.0-255,66,89566,92,281627
5349,0.00084,74.125.68.0-255,1125,90691,92,281627
5350,0.000985,74.125.68.0-255,1484,92175,92,281627
5351,0.000991,172.31.47.0-255,66,92241,92,281627
5352,0.000997,74.125.68.0-255,2902,95143,92,281627
5353,0.001,172.31.47.0-255,66,95209,92,281627
5354,0.001022,74.125.68.0-255,5738,100947,92,281627
5355,0.001025,172.31.47.0-255,66,101013,92,281627
5356,0.001029,74.125.68.0-255,2902,103915,92,281627
5357,0.001031,172.31.47.0-255,66,103981,92,281627
5358,0.001034,74.125.68.0-255,1484,105465,92,281627
5359,0.00106,74.125.68.0-255,2902,108367,92,281627
5360,0.001063,172.31.47.0-255,66,108433,92,281627
5361,0.00107,74.125.68.0-255,7156,115589,92,281627
5362,0.001072,172.31.47.0-255,66,115655,92,281627
5363,0.001096,74.125.68.0-255,1484,117139,92,281627
5364,0.001102,74.125.68.0-255,5738,122877,92,281627
5365,0.001105,172.31.47.0-255,66,122943,92,281627
5366,0.001128,74.125.68.0-255,6438,129381,92,281627
5367,0.001131,172.31.47.0-255,66,129447,92,281627
5368,0.001151,74.125.68.0-255,7156,136603,92,281627
5369,0.001153,172.31.47.0-255,66,136669,92,281627
5370,0.001186,74.125.68.0-255,4320,140989,92,281627
5371,0.001189,172.31.47.0-255,66,141055,92,281627
5372,0.001217,172.31.47.0-255,66,141121,92,281627
5373,0.001246,172.31.47.0-255,66,141187,92,281627
5374,0.001278,74.125.68.0-255,2902,144089,92,281627
5375,0.00128,172.31.47.0-255,66,144155,92,281627
5376,0.001297,74.125.68.0-255,4320,148475,92,281627
5377,0.001299,172.31.47.0-255,66,148541,92,281627
5378,0.001321,74.125.68.0-255,4320,152861,92,281627
5379,0.001323,172.31.47.0-255,66,152927,92,281627
5380,0.001342,74.125.68.0-255,4320,157247,92,281627
5381,0.001343,172.31.47.0-255,66,157313,92,281627
5382,0.001348,74.125.68.0-255,5738,163051,92,281627
5383,0.00135,172.31.47.0-255,66,163117,92,281627
5384,0.001359,74.125.68.0-255,1484,164601,92,281627
5385,0.001374,74.125.68.0-255,5738,170339,92,281627
5386,0.001376,172.31.47.0-255,66,170405,92,281627
5387,0.00139,74.125.68.0-255,1484,171889,92,281627
5388,0.001405,74.125.68.0-255,3602,175491,92,281627
5389,0.001406,172.31.47.0-255,66,175557,92,281627
5390,0.001443,74.125.68.0-255,2902,178459,92,281627
5391,0.001445,172.31.47.0-255,66,178525,92,281627
5392,0.001449,74.125.68.0-255,4320,182845,92,281627
5393,0.001451,172.31.47.0-255,66,182911,92,281627
5394,0.001502,74.125.68.0-255,5738,188649,92,281627
5395,0.001504,172.31.47.0-255,66,188715,92,281627
5396,0.00152,74.125.68.0-255,2902,191617,92,281627
5397,0.001522,172.31.47.0-255,66,191683,92,281627
5398,0.001526,74.125.68.0-255,4320,196003,92,281627
5399,0.001528,172.31.47.0-255,66,196069,92,281627
5400,0.001532,74.125.68.0-255,5738,201807,92,281627
5401,0.001595,74.125.68.0-255,1484,203291,92,281627
5402,0.001613,74.125.68.0-255,2902,206193,92,281627
5403,0.001635,74.125.68.0-255,5738,211931,92,281627
5404,0.001643,74.125.68.0-255,4320,216251,92,281627
5405,0.001645,74.125.68.0-255,1484,217735,92,281627
5406,0.001659,74.125.68.0-255,4320,222055,92,281627
5407,0.001682,74.125.68.0-255,2902,224957,92,281627
5408,0.0017,74.125.68.0-255,2184,227141,92,281627
5409,0.001784,74.125.68.0-255,1484,228625,92,281627
5410,0.001798,74.125.68.0-255,2902,231527,92,281627
5411,0.001818,74.125.68.0-255,4320,235847,92,281627
5412,0.00183,74.125.68.0-255,1484,237331,92,281627
5413,0.001844,74.125.68.0-255,5738,243069,92,281627
5414,0.001857,74.125.68.0-255,1484,244553,92,281627
5415,0.001861,74.125.68.0-255,5738,250291,92,281627
5416,0.001875,74.125.68.0-255,1484,251775,92,281627
5417,0.001877,74.125.68.0-255,1484,253259,92,281627
5418,0.001891,74.125.68.0-255,7156,260415,92,281627
5419,0.001893,74.125.68.0-255,766,261181,92,281627
5420,0.002015,74.125.68.0-255,1484,262665,92,281627
5421,0.002033,74.125.68.0-255,2902,265567,92,281627
5422,0.002049,74.125.68.0-255,2902,268469,92,281627
5423,0.002058,74.125.68.0-255,1484,269953,92,281627
5424,0.004967,172.31.47.0-255,66,270019,92,281627
5425,0.007008,74.125.68.0-255,5738,275757,92,281627
5426,0.007013,172.31.47.0-255,66,275823,92,281627
5427,0.009024,74.125.68.0-255,5738,281561,92,281627
5428,0.009029,172.31.47.0-255,66,281627,92,281627
5429,0.0,74.125.24.0-255,153,153,92,108067
5430,2.5e-05,172.31.47.0-255,66,219,92,108067
5431,3e-05,74.125.24.0-255,1484,1703,92,108067
5432,3.4e-05,172.31.47.0-255,66,1769,92,108067
5433,3.7e-05,74.125.24.0-255,2902,4671,92,108067
5434,4.1e-05,172.31.47.0-255,66,4737,92,108067
5435,4.6e-05,74.125.24.0-255,7156,11893,92,108067
5436,4.9e-05,172.31.47.0-255,66,11959,92,108067
5437,7.1e-05,74.125.24.0-255,1985,13944,92,108067
5438,7.3e-05,172.31.47.0-255,66,14010,92,108067
5439,0.00021,74.125.24.0-255,1484,15494,92,108067
5440,0.000214,172.31.47.0-255,66,15560,92,108067
5441,0.000218,74.125.24.0-255,1484,17044,92,108067
5442,0.000221,172.31.47.0-255,66,17110,92,108067
5443,0.000234,74.125.24.0-255,1484,18594,92,108067
5444,0.000236,172.31.47.0-255,66,18660,92,108067
5445,0.000242,74.125.24.0-255,5738,24398,92,108067
5446,0.000244,172.31.47.0-255,66,24464,92,108067
5447,0.000281,74.125.24.0-255,7156,31620,92,108067
5448,0.000284,172.31.47.0-255,66,31686,92,108067
5449,0.000303,74.125.24.0-255,1125,32811,92,108067
5450,0.000305,172.31.47.0-255,66,32877,92,108067
5451,0.000314,172.31.47.0-255,66,32943,92,108067
5452,0.000341,74.125.24.0-255,4320,37263,92,108067
5453,0.000344,172.31.47.0-255,66,37329,92,108067
5454,0.000362,74.125.24.0-255,2543,39872,92,108067
5455,0.000364,172.31.47.0-255,66,39938,92,108067
5456,0.001727,74.125.24.0-255,1484,41422,92,108067
5457,0.001734,172.31.47.0-255,66,41488,92,108067
5458,0.001744,74.125.24.0-255,2902,44390,92,108067
5459,0.001746,172.31.47.0-255,66,44456,92,108067
5460,0.001751,74.125.24.0-255,2902,47358,92,108067
5461,0.001753,172.31.47.0-255,66,47424,92,108067
5462,0.001782,74.125.24.0-255,2902,50326,92,108067
5463,0.001784,172.31.47.0-255,66,50392,92,108067
5464,0.001791,74.125.24.0-255,6797,57189,92,108067
5465,0.001793,172.31.47.0-255,66,57255,92,108067
5466,0.00186,74.125.24.0-255,1484,58739,92,108067
5467,0.001877,74.125.24.0-255,2902,61641,92,108067
5468,0.00188,172.31.47.0-255,66,61707,92,108067
5469,0.001886,74.125.24.0-255,5738,67445,92,108067
5470,0.001888,172.31.47.0-255,66,67511,92,108067
5471,0.001936,74.125.24.0-255,5738,73249,92,108067
5472,0.001939,172.31.47.0-255,66,73315,92,108067
5473,0.001959,74.125.24.0-255,6797,80112,92,108067
5474,0.001961,172.31.47.0-255,66,80178,92,108067
5475,0.001967,74.125.24.0-255,5738,85916,92,108067
5476,0.001969,172.31.47.0-255,66,85982,92,108067
5477,0.001989,74.125.24.0-255,5959,91941,92,108067
5478,0.001992,172.31.47.0-255,66,92007,92,108067
5479,0.004265,74.125.24.0-255,5738,97745,92,108067
5480,0.004272,172.31.47.0-255,66,97811,92,108067
5481,0.006547,74.125.24.0-255,4320,102131,92,108067
5482,0.006552,172.31.47.0-255,66,102197,92,108067
5483,0.00657,74.125.24.0-255,1484,103681,92,108067
5484,0.008832,74.125.24.0-255,4320,108001,92,108067
5485,0.008841,172.31.47.0-255,66,108067,92,108067
5486,0.0,172.217.194.0-255,153,153,92,156615
5487,2.2e-05,172.31.47.0-255,66,219,92,156615
5488,2.8e-05,172.217.194.0-255,1484,1703,92,156615
5489,3.1e-05,172.31.47.0-255,66,1769,92,156615
5490,3.5e-05,172.217.194.0-255,2902,4671,92,156615
5491,3.7e-05,172.31.47.0-255,66,4737,92,156615
5492,5.8e-05,172.217.194.0-255,7156,11893,92,156615
5493,6e-05,172.31.47.0-255,66,11959,92,156615
5494,6.5e-05,172.217.194.0-255,4320,16279,92,156615
5495,6.9e-05,172.31.47.0-255,66,16345,92,156615
5496,8.2e-05,172.217.194.0-255,2015,18360,92,156615
5497,8.5e-05,172.31.47.0-255,66,18426,92,156615
5498,0.000167,172.217.194.0-255,7156,25582,92,156615
5499,0.000171,172.31.47.0-255,66,25648,92,156615
5500,0.000188,172.217.194.0-255,5379,31027,92,156615
5501,0.000191,172.31.47.0-255,66,31093,92,156615
5502,0.000223,172.217.194.0-255,1484,32577,92,156615
5503,0.000226,172.31.47.0-255,66,32643,92,156615
5504,0.00023,172.217.194.0-255,2902,35545,92,156615
5505,0.000232,172.31.47.0-255,66,35611,92,156615
5506,0.000237,172.217.194.0-255,5738,41349,92,156615
5507,0.000239,172.31.47.0-255,66,41415,92,156615
5508,0.000279,172.31.47.0-255,66,41481,92,156615
5509,0.000297,172.217.194.0-255,1125,42606,92,156615
5510,0.0003,172.31.47.0-255,66,42672,92,156615
5511,0.000309,172.31.47.0-255,66,42738,92,156615
5512,0.00033,172.217.194.0-255,1439,44177,92,156615
5513,0.000332,172.31.47.0-255,66,44243,92,156615
5514,0.000402,172.217.194.0-255,99,44342,92,156615
5515,0.000405,172.31.47.0-255,66,44408,92,156615
5516,0.000533,172.217.194.0-255,365,44773,92,156615
5517,0.000708,172.31.47.0-255,66,44839,92,156615
5518,0.000945,172.217.194.0-255,1484,46323,92,156615
5519,0.000953,172.217.194.0-255,2902,49225,92,156615
5520,0.000956,172.31.47.0-255,66,49291,92,156615
5521,0.000963,172.217.194.0-255,5738,55029,92,156615
5522,0.000964,172.31.47.0-255,66,55095,92,156615
5523,0.001002,172.31.47.0-255,66,55161,92,156615
5524,0.001032,172.31.47.0-255,66,55227,92,156615
5525,0.001134,172.217.194.0-255,1484,56711,92,156615
5526,0.001137,172.217.194.0-255,1484,58195,92,156615
5527,0.001148,172.31.47.0-255,66,58261,92,156615
5528,0.001152,172.217.194.0-255,1484,59745,92,156615
5529,0.001177,172.217.194.0-255,5738,65483,92,156615
5530,0.001181,172.31.47.0-255,66,65549,92,156615
5531,0.001185,172.217.194.0-255,4320,69869,92,156615
5532,0.001187,172.31.47.0-255,66,69935,92,156615
5533,0.001193,172.217.194.0-255,7156,77091,92,156615
5534,0.001194,172.31.47.0-255,66,77157,92,156615
5535,0.001221,172.217.194.0-255,4320,81477,92,156615
5536,0.001224,172.31.47.0-255,66,81543,92,156615
5537,0.001233,172.31.47.0-255,66,81609,92,156615
5538,0.001703,172.217.194.0-255,1484,83093,92,156615
5539,0.00171,172.217.194.0-255,2902,85995,92,156615
5540,0.001713,172.31.47.0-255,66,86061,92,156615
5541,0.001719,172.217.194.0-255,4320,90381,92,156615
5542,0.00172,172.31.47.0-255,66,90447,92,156615
5543,0.00173,172.217.194.0-255,1484,91931,92,156615
5544,0.001733,172.217.194.0-255,2902,94833,92,156615
5545,0.001735,172.31.47.0-255,66,94899,92,156615
5546,0.001751,172.217.194.0-255,4320,99219,92,156615
5547,0.001753,172.31.47.0-255,66,99285,92,156615
5548,0.001756,172.217.194.0-255,1484,100769,92,156615
5549,0.001791,172.31.47.0-255,66,100835,92,156615
5550,0.001794,172.217.194.0-255,2184,103019,92,156615
5551,0.001796,172.31.47.0-255,66,103085,92,156615
5552,0.001852,172.217.194.0-255,1484,104569,92,156615
5553,0.001857,172.217.194.0-255,2902,107471,92,156615
5554,0.001859,172.31.47.0-255,66,107537,92,156615
5555,0.001875,172.217.194.0-255,1484,109021,92,156615
5556,0.00189,172.217.194.0-255,4320,113341,92,156615
5557,0.001892,172.31.47.0-255,66,113407,92,156615
5558,0.001895,172.217.194.0-255,1484,114891,92,156615
5559,0.001923,172.31.47.0-255,66,114957,92,156615
5560,0.001933,172.217.194.0-255,1484,116441,92,156615
5561,0.001959,172.217.194.0-255,7156,123597,92,156615
5562,0.001962,172.31.47.0-255,66,123663,92,156615
5563,0.001972,172.217.194.0-255,3602,127265,92,156615
5564,0.001973,172.31.47.0-255,66,127331,92,156615
5565,0.002135,172.217.194.0-255,1484,128815,92,156615
5566,0.002151,172.217.194.0-255,2902,131717,92,156615
5567,0.002153,172.31.47.0-255,66,131783,92,156615
5568,0.002201,172.217.194.0-255,5738,137521,92,156615
5569,0.002203,172.31.47.0-255,66,137587,92,156615
5570,0.002212,172.31.47.0-255,66,137653,92,156615
5571,0.002226,172.217.194.0-255,1484,139137,92,156615
5572,0.002252,172.31.47.0-255,66,139203,92,156615
5573,0.004491,172.217.194.0-255,5738,144941,92,156615
5574,0.004496,172.31.47.0-255,66,145007,92,156615
5575,0.006755,172.217.194.0-255,5738,150745,92,156615
5576,0.006761,172.31.47.0-255,66,150811,92,156615
5577,0.009031,172.217.194.0-255,5738,156549,92,156615
5578,0.009039,172.31.47.0-255,66,156615,92,156615
5579,0.0,74.125.200.0-255,153,153,92,245943
5580,2.9e-05,172.31.47.0-255,66,219,92,245943
5581,3.6e-05,74.125.200.0-255,1484,1703,92,245943
5582,4e-05,172.31.47.0-255,66,1769,92,245943
5583,4.4e-05,74.125.200.0-255,2902,4671,92,245943
5584,4.6e-05,172.31.47.0-255,66,4737,92,245943
5585,7.1e-05,74.125.200.0-255,7156,11893,92,245943
5586,7.3e-05,172.31.47.0-255,66,11959,92,245943
5587,7.6e-05,74.125.200.0-255,1484,13443,92,245943
5588,8e-05,172.31.47.0-255,66,13509,92,245943
5589,9.8e-05,74.125.200.0-255,2083,15592,92,245943
5590,0.0001,172.31.47.0-255,66,15658,92,245943
5591,0.000124,74.125.200.0-255,4320,19978,92,245943
5592,0.000127,172.31.47.0-255,66,20044,92,245943
5593,0.000145,74.125.200.0-255,1484,21528,92,245943
5594,0.000147,172.31.47.0-255,66,21594,92,245943
5595,0.000151,74.125.200.0-255,4320,25914,92,245943
5596,0.000153,172.31.47.0-255,66,25980,92,245943
5597,0.000166,74.125.200.0-255,2902,28882,92,245943
5598,0.000168,172.31.47.0-255,66,28948,92,245943
5599,0.000191,74.125.200.0-255,2543,31491,92,245943
5600,0.000193,172.31.47.0-255,66,31557,92,245943
5601,0.000344,74.125.200.0-255,1484,33041,92,245943
5602,0.000349,172.31.47.0-255,66,33107,92,245943
5603,0.000367,74.125.200.0-255,1484,34591,92,245943
5604,0.000369,172.31.47.0-255,66,34657,92,245943
5605,0.000384,74.125.200.0-255,1484,36141,92,245943
5606,0.000387,172.31.47.0-255,66,36207,92,245943
5607,0.000416,74.125.200.0-255,1484,37691,92,245943
5608,0.000418,172.31.47.0-255,66,37757,92,245943
5609,0.000423,74.125.200.0-255,2902,40659,92,245943
5610,0.000425,172.31.47.0-255,66,40725,92,245943
5611,0.00046,74.125.200.0-255,1484,42209,92,245943
5612,0.000465,74.125.200.0-255,2902,45111,92,245943
5613,0.000468,172.31.47.0-255,66,45177,92,245943
5614,0.000475,74.125.200.0-255,1484,46661,92,245943
5615,0.000486,74.125.200.0-255,2543,49204,92,245943
5616,0.000488,172.31.47.0-255,66,49270,92,245943
5617,0.000491,74.125.200.0-255,1484,50754,92,245943
5618,0.000508,74.125.200.0-255,2902,53656,92,245943
5619,0.000511,172.31.47.0-255,66,53722,92,245943
5620,0.000547,74.125.200.0-255,1484,55206,92,245943
5621,0.00056,74.125.200.0-255,1484,56690,92,245943
5622,0.000563,172.31.47.0-255,66,56756,92,245943
5623,0.000574,74.125.200.0-255,1484,58240,92,245943
5624,0.000592,74.125.200.0-255,2902,61142,92,245943
5625,0.000595,172.31.47.0-255,66,61208,92,245943
5626,0.000598,74.125.200.0-255,1484,62692,92,245943
5627,0.000601,74.125.200.0-255,2902,65594,92,245943
5628,0.000603,172.31.47.0-255,66,65660,92,245943
5629,0.000631,74.125.200.0-255,1399,67059,92,245943
5630,0.000656,74.125.200.0-255,130,67189,92,245943
5631,0.000707,172.31.47.0-255,66,67255,92,245943
5632,0.000822,74.125.200.0-255,1484,68739,92,245943
5633,0.000847,74.125.200.0-255,2902,71641,92,245943
5634,0.000851,172.31.47.0-255,66,71707,92,245943
5635,0.000869,74.125.200.0-255,2902,74609,92,245943
5636,0.000872,172.31.47.0-255,66,74675,92,245943
5637,0.00089,74.125.200.0-255,2902,77577,92,245943
5638,0.000892,172.31.47.0-255,66,77643,92,245943
5639,0.000896,74.125.200.0-255,2902,80545,92,245943
5640,0.000898,172.31.47.0-255,66,80611,92,245943
5641,0.000901,74.125.200.0-255,2902,83513,92,245943
5642,0.000903,172.31.47.0-255,66,83579,92,245943
5643,0.000918,74.125.200.0-255,1484,85063,92,245943
5644,0.000939,74.125.200.0-255,4320,89383,92,245943
5645,0.000942,172.31.47.0-255,66,89449,92,245943
5646,0.00096,74.125.200.0-255,2902,92351,92,245943
5647,0.000963,172.31.47.0-255,66,92417,92,245943
5648,0.000967,74.125.200.0-255,2902,95319,92,245943
5649,0.000969,172.31.47.0-255,66,95385,92,245943
5650,0.000986,74.125.200.0-255,5738,101123,92,245943
5651,0.000988,172.31.47.0-255,66,101189,92,245943
5652,0.000991,74.125.200.0-255,766,101955,92,245943
5653,0.001038,74.125.200.0-255,348,102303,92,245943
5654,0.001089,74.125.200.0-255,1484,103787,92,245943
5655,0.001092,172.31.47.0-255,66,103853,92,245943
5656,0.001105,74.125.200.0-255,2902,106755,92,245943
5657,0.001108,172.31.47.0-255,66,106821,92,245943
5658,0.001133,74.125.200.0-255,4320,111141,92,245943
5659,0.001136,172.31.47.0-255,66,111207,92,245943
5660,0.001152,74.125.200.0-255,1484,112691,92,245943
5661,0.001156,74.125.200.0-255,2902,115593,92,245943
5662,0.001158,172.31.47.0-255,66,115659,92,245943
5663,0.001162,74.125.200.0-255,4320,119979,92,245943
5664,0.001163,172.31.47.0-255,66,120045,92,245943
5665,0.001187,74.125.200.0-255,2902,122947,92,245943
5666,0.001189,172.31.47.0-255,66,123013,92,245943
5667,0.001199,74.125.200.0-255,1484,124497,92,245943
5668,0.001209,74.125.200.0-255,1484,125981,92,245943
5669,0.001211,172.31.47.0-255,66,126047,92,245943
5670,0.001224,74.125.200.0-255,4320,130367,92,245943
5671,0.001227,172.31.47.0-255,66,130433,92,245943
5672,0.001255,74.125.200.0-255,6438,136871,92,245943
5673,0.001257,172.31.47.0-255,66,136937,92,245943
5674,0.001399,74.125.200.0-255,1484,138421,92,245943
5675,0.00142,74.125.200.0-255,2902,141323,92,245943
5676,0.001422,172.31.47.0-255,66,141389,92,245943
5677,0.001443,74.125.200.0-255,5738,147127,92,245943
5678,0.001446,172.31.47.0-255,66,147193,92,245943
5679,0.001449,74.125.200.0-255,2902,150095,92,245943
5680,0.00145,172.31.47.0-255,66,150161,92,245943
5681,0.001454,74.125.200.0-255,4320,154481,92,245943
5682,0.001456,172.31.47.0-255,66,154547,92,245943
5683,0.00147,74.125.200.0-255,1484,156031,92,245943
5684,0.001496,74.125.200.0-255,7156,163187,92,245943
5685,0.001498,172.31.47.0-255,66,163253,92,245943
5686,0.001504,74.125.200.0-255,7156,170409,92,245943
5687,0.001506,172.31.47.0-255,66,170475,92,245943
5688,0.001521,74.125.200.0-255,766,171241,92,245943
5689,0.001735,74.125.200.0-255,1484,172725,92,245943
5690,0.001737,172.31.47.0-255,66,172791,92,245943
5691,0.001748,74.125.200.0-255,2902,175693,92,245943
5692,0.00175,172.31.47.0-255,66,175759,92,245943
5693,0.001781,74.125.200.0-255,5738,181497,92,245943
5694,0.001782,172.31.47.0-255,66,181563,92,245943
5695,0.001797,74.125.200.0-255,1484,183047,92,245943
5696,0.001818,74.125.200.0-255,5738,188785,92,245943
5697,0.00182,172.31.47.0-255,66,188851,92,245943
5698,0.001853,172.31.47.0-255,66,188917,92,245943
5699,0.001904,172.31.47.0-255,66,188983,92,245943
5700,0.00205,74.125.200.0-255,1484,190467,92,245943
5701,0.00206,74.125.200.0-255,2902,193369,92,245943
5702,0.002062,172.31.47.0-255,66,193435,92,245943
5703,0.002086,74.125.200.0-255,1484,194919,92,245943
5704,0.002097,74.125.200.0-255,2902,197821,92,245943
5705,0.002099,172.31.47.0-255,66,197887,92,245943
5706,0.002114,74.125.200.0-255,1484,199371,92,245943
5707,0.002118,74.125.200.0-255,2902,202273,92,245943
5708,0.00212,172.31.47.0-255,66,202339,92,245943
5709,0.002138,74.125.200.0-255,4320,206659,92,245943
5710,0.00214,172.31.47.0-255,66,206725,92,245943
5711,0.002175,74.125.200.0-255,4320,211045,92,245943
5712,0.002177,172.31.47.0-255,66,211111,92,245943
5713,0.002195,74.125.200.0-255,1484,212595,92,245943
5714,0.002197,74.125.200.0-255,1484,214079,92,245943
5715,0.002198,172.31.47.0-255,66,214145,92,245943
5716,0.002211,74.125.200.0-255,2902,217047,92,245943
5717,0.002213,172.31.47.0-255,66,217113,92,245943
5718,0.002238,74.125.200.0-255,2902,220015,92,245943
5719,0.002239,172.31.47.0-255,66,220081,92,245943
5720,0.002256,74.125.200.0-255,2902,222983,92,245943
5721,0.002257,172.31.47.0-255,66,223049,92,245943
5722,0.002259,74.125.200.0-255,766,223815,92,245943
5723,0.002285,74.125.200.0-255,1484,225299,92,245943
5724,0.002287,172.31.47.0-255,66,225365,92,245943
5725,0.002296,74.125.200.0-255,1484,226849,92,245943
5726,0.002309,74.125.200.0-255,2902,229751,92,245943
5727,0.002311,172.31.47.0-255,66,229817,92,245943
5728,0.004572,74.125.200.0-255,1484,231301,92,245943
5729,0.004597,74.125.200.0-255,2902,234203,92,245943
5730,0.0046,172.31.47.0-255,66,234269,92,245943
5731,0.004618,74.125.200.0-255,1484,235753,92,245943
5732,0.006901,74.125.200.0-255,4320,240073,92,245943
5733,0.006907,172.31.47.0-255,66,240139,92,245943
5734,0.009205,74.125.200.0-255,5738,245877,92,245943
5735,0.009212,172.31.47.0-255,66,245943,92,245943
5736,0.0,74.125.200.0-255,153,153,92,74306
5737,2e-05,172.31.47.0-255,66,219,92,74306
5738,2.7e-05,74.125.200.0-255,1484,1703,92,74306
5739,3.2e-05,172.31.47.0-255,66,1769,92,74306
5740,3.6e-05,74.125.200.0-255,2902,4671,92,74306
5741,4e-05,172.31.47.0-255,66,4737,92,74306
5742,4.7e-05,74.125.200.0-255,7156,11893,92,74306
5743,5.8e-05,172.31.47.0-255,66,11959,92,74306
5744,6.2e-05,74.125.200.0-255,2063,14022,92,74306
5745,6.4e-05,172.31.47.0-255,66,14088,92,74306
5746,6.9e-05,74.125.200.0-255,2902,16990,92,74306
5747,7.1e-05,172.31.47.0-255,66,17056,92,74306
5748,9.4e-05,74.125.200.0-255,2902,19958,92,74306
5749,9.7e-05,172.31.47.0-255,66,20024,92,74306
5750,0.000119,74.125.200.0-255,4320,24344,92,74306
5751,0.000122,172.31.47.0-255,66,24410,92,74306
5752,0.000129,74.125.200.0-255,6797,31207,92,74306
5753,0.000131,172.31.47.0-255,66,31273,92,74306
5754,0.00022,74.125.200.0-255,1484,32757,92,74306
5755,0.000223,172.31.47.0-255,66,32823,92,74306
5756,0.000249,74.125.200.0-255,2902,35725,92,74306
5757,0.000251,172.31.47.0-255,66,35791,92,74306
5758,0.000276,74.125.200.0-255,4320,40111,92,74306
5759,0.000279,172.31.47.0-255,66,40177,92,74306
5760,0.000312,172.31.47.0-255,66,40243,92,74306
5761,0.000315,74.125.200.0-255,1484,41727,92,74306
5762,0.000316,172.31.47.0-255,66,41793,92,74306
5763,0.000342,74.125.200.0-255,7156,48949,92,74306
5764,0.000345,172.31.47.0-255,66,49015,92,74306
5765,0.000349,74.125.200.0-255,2902,51917,92,74306
5766,0.00035,172.31.47.0-255,66,51983,92,74306
5767,0.000385,74.125.200.0-255,5692,57675,92,74306
5768,0.000389,74.125.200.0-255,107,57782,92,74306
5769,0.000534,74.125.200.0-255,332,58114,92,74306
5770,0.000576,172.31.47.0-255,66,58180,92,74306
5771,0.00408,74.125.200.0-255,1484,59664,92,74306
5772,0.004097,74.125.200.0-255,2902,62566,92,74306
5773,0.004107,172.31.47.0-255,66,62632,92,74306
5774,0.004113,74.125.200.0-255,1484,64116,92,74306
5775,0.006657,74.125.200.0-255,4320,68436,92,74306
5776,0.006727,172.31.47.0-255,66,68502,92,74306
5777,0.009269,74.125.200.0-255,5738,74240,92,74306
5778,0.009282,172.31.47.0-255,66,74306,92,74306
5779,0.0,172.31.47.0-255,105,105,92,381
5780,6.2e-05,172.31.47.0-255,105,210,92,381
5781,0.002447,157.240.13.0-255,105,315,92,381
5782,0.00246,172.31.47.0-255,66,381,92,381
5783,0.0,172.31.47.0-255,105,105,92,105
5784,0.0,172.217.194.0-255,298,298,92,110945
5785,1.5e-05,172.31.47.0-255,66,364,92,110945
5786,2.1e-05,172.217.194.0-255,1484,1848,92,110945
5787,2.5e-05,172.31.47.0-255,66,1914,92,110945
5788,3.2e-05,172.217.194.0-255,4320,6234,92,110945
5789,3.6e-05,172.31.47.0-255,66,6300,92,110945
5790,6.3e-05,172.217.194.0-255,5738,12038,92,110945
5791,6.6e-05,172.31.47.0-255,66,12104,92,110945
5792,0.000113,172.217.194.0-255,1881,13985,92,110945
5793,0.000115,172.31.47.0-255,66,14051,92,110945
5794,0.000292,172.217.194.0-255,1484,15535,92,110945
5795,0.000298,172.31.47.0-255,66,15601,92,110945
5796,0.000304,172.217.194.0-255,2902,18503,92,110945
5797,0.000307,172.31.47.0-255,66,18569,92,110945
5798,0.00031,172.217.194.0-255,1484,20053,92,110945
5799,0.000312,172.31.47.0-255,66,20119,92,110945
5800,0.000338,172.217.194.0-255,4320,24439,92,110945
5801,0.000341,172.31.47.0-255,66,24505,92,110945
5802,0.000344,172.217.194.0-255,1484,25989,92,110945
5803,0.000346,172.31.47.0-255,66,26055,92,110945
5804,0.000373,172.31.47.0-255,66,26121,92,110945
5805,0.00038,172.217.194.0-255,7156,33277,92,110945
5806,0.000383,172.31.47.0-255,66,33343,92,110945
5807,0.0004,172.217.194.0-255,2902,36245,92,110945
5808,0.000402,172.31.47.0-255,66,36311,92,110945
5809,0.000447,172.31.47.0-255,66,36377,92,110945
5810,0.000451,172.217.194.0-255,2184,38561,92,110945
5811,0.000453,172.31.47.0-255,66,38627,92,110945
5812,0.000456,172.217.194.0-255,365,38992,92,110945
5813,0.000458,172.31.47.0-255,66,39058,92,110945
5814,0.000676,172.217.194.0-255,377,39435,92,110945
5815,0.000701,172.217.194.0-255,1484,40919,92,110945
5816,0.000707,172.31.47.0-255,66,40985,92,110945
5817,0.000753,172.217.194.0-255,2902,43887,92,110945
5818,0.000756,172.31.47.0-255,66,43953,92,110945
5819,0.000763,172.217.194.0-255,5738,49691,92,110945
5820,0.000765,172.31.47.0-255,66,49757,92,110945
5821,0.000777,172.31.47.0-255,66,49823,92,110945
5822,0.00079,172.217.194.0-255,4320,54143,92,110945
5823,0.000792,172.31.47.0-255,66,54209,92,110945
5824,0.000797,172.217.194.0-255,5738,59947,92,110945
5825,0.0008,172.31.47.0-255,66,60013,92,110945
5826,0.000835,172.217.194.0-255,5020,65033,92,110945
5827,0.000837,172.31.47.0-255,66,65099,92,110945
5828,0.001546,172.217.194.0-255,1484,66583,92,110945
5829,0.001566,172.217.194.0-255,2902,69485,92,110945
5830,0.00157,172.31.47.0-255,66,69551,92,110945
5831,0.001576,172.217.194.0-255,5738,75289,92,110945
5832,0.001578,172.31.47.0-255,66,75355,92,110945
5833,0.001603,172.31.47.0-255,66,75421,92,110945
5834,0.001646,172.217.194.0-255,5738,81159,92,110945
5835,0.001649,172.31.47.0-255,66,81225,92,110945
5836,0.001671,172.217.194.0-255,6438,87663,92,110945
5837,0.001673,172.31.47.0-255,66,87729,92,110945
5838,0.003662,172.217.194.0-255,5738,93467,92,110945
5839,0.003668,172.31.47.0-255,66,93533,92,110945
5840,0.005672,172.217.194.0-255,5738,99271,92,110945
5841,0.005677,172.31.47.0-255,66,99337,92,110945
5842,0.007704,172.217.194.0-255,5738,105075,92,110945
5843,0.007708,172.31.47.0-255,66,105141,92,110945
5844,0.009702,172.217.194.0-255,5738,110879,92,110945
5845,0.00971,172.31.47.0-255,66,110945,92,110945
5846,0.0,172.217.194.0-255,225,225,92,41154
5847,1.6e-05,172.31.47.0-255,66,291,92,41154
5848,2.3e-05,172.217.194.0-255,1484,1775,92,41154
5849,2.7e-05,172.31.47.0-255,66,1841,92,41154
5850,5.7e-05,172.217.194.0-255,4320,6161,92,41154
5851,6.5e-05,172.31.47.0-255,66,6227,92,41154
5852,0.000252,172.31.47.0-255,66,6293,92,41154
5853,0.000587,172.217.194.0-255,1484,7777,92,41154
5854,0.000593,172.31.47.0-255,66,7843,92,41154
5855,0.000658,172.217.194.0-255,2902,10745,92,41154
5856,0.000663,172.31.47.0-255,66,10811,92,41154
5857,0.000778,172.217.194.0-255,4320,15131,92,41154
5858,0.000783,172.31.47.0-255,66,15197,92,41154
5859,0.000799,172.217.194.0-255,1484,16681,92,41154
5860,0.000801,172.31.47.0-255,66,16747,92,41154
5861,0.001047,172.217.194.0-255,6797,23544,92,41154
5862,0.001053,172.31.47.0-255,66,23610,92,41154
5863,0.003398,172.217.194.0-255,5738,29348,92,41154
5864,0.003404,172.31.47.0-255,66,29414,92,41154
5865,0.005744,172.217.194.0-255,5738,35152,92,41154
5866,0.005751,172.31.47.0-255,66,35218,92,41154
5867,0.008081,172.217.194.0-255,2902,38120,92,41154
5868,0.008088,172.31.47.0-255,66,38186,92,41154
5869,0.00812,172.217.194.0-255,2902,41088,92,41154
5870,0.008123,172.31.47.0-255,66,41154,92,41154
5871,0.0,172.217.194.0-255,153,153,92,102923
5872,3.6e-05,172.31.47.0-255,66,219,92,102923
5873,4.4e-05,172.217.194.0-255,1484,1703,92,102923
5874,6.5e-05,172.31.47.0-255,66,1769,92,102923
5875,6.8e-05,172.217.194.0-255,1484,3253,92,102923
5876,7.1e-05,172.31.47.0-255,66,3319,92,102923
5877,7.6e-05,172.217.194.0-255,2902,6221,92,102923
5878,7.8e-05,172.31.47.0-255,66,6287,92,102923
5879,8.5e-05,172.217.194.0-255,5738,12025,92,102923
5880,8.7e-05,172.31.47.0-255,66,12091,92,102923
5881,9.1e-05,172.217.194.0-255,2064,14155,92,102923
5882,9.3e-05,172.31.47.0-255,66,14221,92,102923
5883,0.000126,172.217.194.0-255,2902,17123,92,102923
5884,0.000129,172.31.47.0-255,66,17189,92,102923
5885,0.000137,172.217.194.0-255,7156,24345,92,102923
5886,0.000139,172.31.47.0-255,66,24411,92,102923
5887,0.000188,172.217.194.0-255,4320,28731,92,102923
5888,0.000192,172.31.47.0-255,66,28797,92,102923
5889,0.000209,172.217.194.0-255,2543,31340,92,102923
5890,0.000211,172.31.47.0-255,66,31406,92,102923
5891,0.000449,172.217.194.0-255,1484,32890,92,102923
5892,0.000454,172.217.194.0-255,2902,35792,92,102923
5893,0.000457,172.31.47.0-255,66,35858,92,102923
5894,0.00046,172.217.194.0-255,5738,41596,92,102923
5895,0.000462,172.31.47.0-255,66,41662,92,102923
5896,0.000466,172.31.47.0-255,66,41728,92,102923
5897,0.000511,172.217.194.0-255,6797,48525,92,102923
5898,0.000516,172.31.47.0-255,66,48591,92,102923
5899,0.000552,172.217.194.0-255,1484,50075,92,102923
5900,0.000556,172.217.194.0-255,2902,52977,92,102923
5901,0.000558,172.31.47.0-255,66,53043,92,102923
5902,0.000562,172.31.47.0-255,66,53109,92,102923
5903,0.000569,172.217.194.0-255,2902,56011,92,102923
5904,0.000578,172.31.47.0-255,66,56077,92,102923
5905,0.000605,172.217.194.0-255,2902,58979,92,102923
5906,0.00061,172.31.47.0-255,66,59045,92,102923
5907,0.000613,172.217.194.0-255,7110,66155,92,102923
5908,0.000625,172.31.47.0-255,66,66221,92,102923
5909,0.000913,172.217.194.0-255,98,66319,92,102923
5910,0.00092,172.31.47.0-255,66,66385,92,102923
5911,0.001283,172.217.194.0-255,362,66747,92,102923
5912,0.001831,172.217.194.0-255,1484,68231,92,102923
5913,0.001839,172.217.194.0-255,2902,71133,92,102923
5914,0.001861,172.217.194.0-255,5738,76871,92,102923
5915,0.001866,172.217.194.0-255,4320,81191,92,102923
5916,0.001886,172.217.194.0-255,5738,86929,92,102923
5917,0.001919,172.217.194.0-255,4320,91249,92,102923
5918,0.004729,172.31.47.0-255,66,91315,92,102923
5919,0.007322,172.217.194.0-255,5738,97053,92,102923
5920,0.007329,172.31.47.0-255,66,97119,92,102923
5921,0.009927,172.217.194.0-255,5738,102857,92,102923
5922,0.00994,172.31.47.0-255,66,102923,92,102923
5923,0.0,74.125.200.0-255,153,153,92,199360
5924,2.3e-05,172.31.47.0-255,66,219,92,199360
5925,3.1e-05,74.125.200.0-255,1484,1703,92,199360
5926,3.5e-05,172.31.47.0-255,66,1769,92,199360
5927,4.9e-05,74.125.200.0-255,2902,4671,92,199360
5928,5.2e-05,172.31.47.0-255,66,4737,92,199360
5929,5.8e-05,74.125.200.0-255,5738,10475,92,199360
5930,6.1e-05,172.31.47.0-255,66,10541,92,199360
5931,6.6e-05,74.125.200.0-255,3393,13934,92,199360
5932,6.9e-05,172.31.47.0-255,66,14000,92,199360
5933,0.000118,74.125.200.0-255,1484,15484,92,199360
5934,0.000122,172.31.47.0-255,66,15550,92,199360
5935,0.000127,74.125.200.0-255,2902,18452,92,199360
5936,0.000129,172.31.47.0-255,66,18518,92,199360
5937,0.000134,74.125.200.0-255,2902,21420,92,199360
5938,0.00014,172.31.47.0-255,66,21486,92,199360
5939,0.000163,74.125.200.0-255,2902,24388,92,199360
5940,0.000165,172.31.47.0-255,66,24454,92,199360
5941,0.000177,74.125.200.0-255,6797,31251,92,199360
5942,0.000179,172.31.47.0-255,66,31317,92,199360
5943,0.000387,74.125.200.0-255,1484,32801,92,199360
5944,0.000393,172.31.47.0-255,66,32867,92,199360
5945,0.000398,74.125.200.0-255,1484,34351,92,199360
5946,0.0004,172.31.47.0-255,66,34417,92,199360
5947,0.000429,74.125.200.0-255,1484,35901,92,199360
5948,0.000432,172.31.47.0-255,66,35967,92,199360
5949,0.000437,74.125.200.0-255,2902,38869,92,199360
5950,0.000439,172.31.47.0-255,66,38935,92,199360
5951,0.000449,74.125.200.0-255,4320,43255,92,199360
5952,0.000451,172.31.47.0-255,66,43321,92,199360
5953,0.000482,74.125.200.0-255,6797,50118,92,199360
5954,0.000485,172.31.47.0-255,66,50184,92,199360
5955,0.000489,74.125.200.0-255,2902,53086,92,199360
5956,0.000491,172.31.47.0-255,66,53152,92,199360
5957,0.000523,74.125.200.0-255,4320,57472,92,199360
5958,0.000526,172.31.47.0-255,66,57538,92,199360
5959,0.000533,74.125.200.0-255,5738,63276,92,199360
5960,0.000535,172.31.47.0-255,66,63342,92,199360
5961,0.000552,74.125.200.0-255,2543,65885,92,199360
5962,0.000559,172.31.47.0-255,66,65951,92,199360
5963,0.000562,74.125.200.0-255,413,66364,92,199360
5964,0.000685,74.125.200.0-255,330,66694,92,199360
5965,0.000955,74.125.200.0-255,1484,68178,92,199360
5966,0.00096,172.31.47.0-255,66,68244,92,199360
5967,0.000965,74.125.200.0-255,2902,71146,92,199360
5968,0.000968,172.31.47.0-255,66,71212,92,199360
5969,0.000971,74.125.200.0-255,1484,72696,92,199360
5970,0.000996,74.125.200.0-255,1484,74180,92,199360
5971,0.000999,172.31.47.0-255,66,74246,92,199360
5972,0.001004,74.125.200.0-255,4320,78566,92,199360
5973,0.001005,172.31.47.0-255,66,78632,92,199360
5974,0.00101,74.125.200.0-255,4320,82952,92,199360
5975,0.001016,172.31.47.0-255,66,83018,92,199360
5976,0.001027,74.125.200.0-255,4320,87338,92,199360
5977,0.001029,172.31.47.0-255,66,87404,92,199360
5978,0.001033,74.125.200.0-255,2902,90306,92,199360
5979,0.001034,172.31.47.0-255,66,90372,92,199360
5980,0.001061,74.125.200.0-255,7156,97528,92,199360
5981,0.001063,172.31.47.0-255,66,97594,92,199360
5982,0.001084,74.125.200.0-255,1484,99078,92,199360
5983,0.001099,74.125.200.0-255,2184,101262,92,199360
5984,0.001102,172.31.47.0-255,66,101328,92,199360
5985,0.001128,74.125.200.0-255,4320,105648,92,199360
5986,0.001131,172.31.47.0-255,66,105714,92,199360
5987,0.001135,74.125.200.0-255,2902,108616,92,199360
5988,0.001136,172.31.47.0-255,66,108682,92,199360
5989,0.001178,172.31.47.0-255,66,108748,92,199360
5990,0.001207,74.125.200.0-255,1484,110232,92,199360
5991,0.001227,172.31.47.0-255,66,110298,92,199360
5992,0.001229,74.125.200.0-255,1484,111782,92,199360
5993,0.00125,74.125.200.0-255,2184,113966,92,199360
5994,0.001252,172.31.47.0-255,66,114032,92,199360
5995,0.00127,74.125.200.0-255,4320,118352,92,199360
5996,0.001272,172.31.47.0-255,66,118418,92,199360
5997,0.001276,74.125.200.0-255,2902,121320,92,199360
5998,0.001277,172.31.47.0-255,66,121386,92,199360
5999,0.001281,74.125.200.0-255,2902,124288,92,199360
6000,0.001283,172.31.47.0-255,66,124354,92,199360
6001,0.001304,74.125.200.0-255,1484,125838,92,199360
6002,0.001317,172.31.47.0-255,66,125904,92,199360
6003,0.00135,172.31.47.0-255,66,125970,92,199360
6004,0.001385,74.125.200.0-255,3602,129572,92,199360
6005,0.001388,172.31.47.0-255,66,129638,92,199360
6006,0.001427,74.125.200.0-255,1484,131122,92,199360
6007,0.001444,74.125.200.0-255,2902,134024,92,199360
6008,0.001447,172.31.47.0-255,66,134090,92,199360
6009,0.001464,74.125.200.0-255,5738,139828,92,199360
6010,0.001467,172.31.47.0-255,66,139894,92,199360
6011,0.001501,74.125.200.0-255,5738,145632,92,199360
6012,0.001504,172.31.47.0-255,66,145698,92,199360
6013,0.00151,74.125.200.0-255,7156,152854,92,199360
6014,0.001512,172.31.47.0-255,66,152920,92,199360
6015,0.00156,172.31.47.0-255,66,152986,92,199360
6016,0.001601,74.125.200.0-255,1484,154470,92,199360
6017,0.001615,74.125.200.0-255,2902,157372,92,199360
6018,0.001618,172.31.47.0-255,66,157438,92,199360
6019,0.001622,74.125.200.0-255,1484,158922,92,199360
6020,0.001644,74.125.200.0-255,2902,161824,92,199360
6021,0.001646,172.31.47.0-255,66,161890,92,199360
6022,0.001652,74.125.200.0-255,5738,167628,92,199360
6023,0.001654,172.31.47.0-255,66,167694,92,199360
6024,0.001692,172.31.47.0-255,66,167760,92,199360
6025,0.001697,74.125.200.0-255,4320,172080,92,199360
6026,0.001699,172.31.47.0-255,66,172146,92,199360
6027,0.001746,74.125.200.0-255,5738,177884,92,199360
6028,0.001751,172.31.47.0-255,66,177950,92,199360
6029,0.001792,172.31.47.0-255,66,178016,92,199360
6030,0.001806,172.31.47.0-255,66,178082,92,199360
6031,0.001831,74.125.200.0-255,4320,182402,92,199360
6032,0.001833,172.31.47.0-255,66,182468,92,199360
6033,0.001835,74.125.200.0-255,766,183234,92,199360
6034,0.003011,172.31.47.0-255,66,183300,92,199360
6035,0.004059,74.125.200.0-255,4320,187620,92,199360
6036,0.004065,172.31.47.0-255,66,187686,92,199360
6037,0.00522,74.125.200.0-255,1484,189170,92,199360
6038,0.006294,74.125.200.0-255,4320,193490,92,199360
6039,0.006298,172.31.47.0-255,66,193556,92,199360
6040,0.008536,74.125.200.0-255,5738,199294,92,199360
6041,0.008542,172.31.47.0-255,66,199360,92,199360
6042,0.0,172.31.47.0-255,105,105,92,276
6043,0.001773,157.240.13.0-255,105,210,92,276
6044,0.001782,172.31.47.0-255,66,276,92,276
6045,0.0,74.125.68.0-255,153,153,92,240651
6046,2.6e-05,172.31.47.0-255,66,219,92,240651
6047,3.3e-05,74.125.68.0-255,1484,1703,92,240651
6048,3.8e-05,172.31.47.0-255,66,1769,92,240651
6049,6e-05,74.125.68.0-255,2902,4671,92,240651
6050,6.8e-05,172.31.47.0-255,66,4737,92,240651
6051,7.5e-05,74.125.68.0-255,5738,10475,92,240651
6052,7.7e-05,172.31.47.0-255,66,10541,92,240651
6053,8e-05,74.125.68.0-255,1484,12025,92,240651
6054,8.2e-05,172.31.47.0-255,66,12091,92,240651
6055,0.000114,74.125.68.0-255,2136,14227,92,240651
6056,0.000116,172.31.47.0-255,66,14293,92,240651
6057,0.000164,74.125.68.0-255,1484,15777,92,240651
6058,0.000169,172.31.47.0-255,66,15843,92,240651
6059,0.000174,74.125.68.0-255,2902,18745,92,240651
6060,0.000176,172.31.47.0-255,66,18811,92,240651
6061,0.000203,74.125.68.0-255,4320,23131,92,240651
6062,0.000206,172.31.47.0-255,66,23197,92,240651
6063,0.000231,74.125.68.0-255,1484,24681,92,240651
6064,0.000234,172.31.47.0-255,66,24747,92,240651
6065,0.000268,74.125.68.0-255,6797,31544,92,240651
6066,0.000273,172.31.47.0-255,66,31610,92,240651
6067,0.00054,74.125.68.0-255,1484,33094,92,240651
6068,0.000545,172.31.47.0-255,66,33160,92,240651
6069,0.00055,74.125.68.0-255,2902,36062,92,240651
6070,0.000552,172.31.47.0-255,66,36128,92,240651
6071,0.000577,74.125.68.0-255,4320,40448,92,240651
6072,0.00058,172.31.47.0-255,66,40514,92,240651
6073,0.000607,74.125.68.0-255,1484,41998,92,240651
6074,0.000611,172.31.47.0-255,66,42064,92,240651
6075,0.000615,74.125.68.0-255,2902,44966,92,240651
6076,0.000617,172.31.47.0-255,66,45032,92,240651
6077,0.000623,74.125.68.0-255,3961,48993,92,240651
6078,0.000625,172.31.47.0-255,66,49059,92,240651
6079,0.000631,74.125.68.0-255,5738,54797,92,240651
6080,0.000635,172.31.47.0-255,66,54863,92,240651
6081,0.000669,74.125.68.0-255,2902,57765,92,240651
6082,0.000672,172.31.47.0-255,66,57831,92,240651
6083,0.000676,74.125.68.0-255,2902,60733,92,240651
6084,0.000679,172.31.47.0-255,66,60799,92,240651
6085,0.000691,74.125.68.0-255,4320,65119,92,240651
6086,0.000693,172.31.47.0-255,66,65185,92,240651
6087,0.000696,74.125.68.0-255,1125,66310,92,240651
6088,0.00088,74.125.68.0-255,414,66724,92,240651
6089,0.000917,74.125.68.0-255,329,67053,92,240651
6090,0.000922,172.31.47.0-255,66,67119,92,240651
6091,0.001251,74.125.68.0-255,1484,68603,92,240651
6092,0.001275,74.125.68.0-255,2902,71505,92,240651
6093,0.00128,172.31.47.0-255,66,71571,92,240651
6094,0.001284,74.125.68.0-255,1484,73055,92,240651
6095,0.001317,74.125.68.0-255,2902,75957,92,240651
6096,0.00132,172.31.47.0-255,66,76023,92,240651
6097,0.001326,74.125.68.0-255,5738,81761,92,240651
6098,0.001328,172.31.47.0-255,66,81827,92,240651
6099,0.001331,74.125.68.0-255,1484,83311,92,240651
6100,0.001358,74.125.68.0-255,2902,86213,92,240651
6101,0.00136,172.31.47.0-255,66,86279,92,240651
6102,0.001384,74.125.68.0-255,5738,92017,92,240651
6103,0.001387,172.31.47.0-255,66,92083,92,240651
6104,0.001389,74.125.68.0-255,1484,93567,92,240651
6105,0.00141,74.125.68.0-255,2902,96469,92,240651
6106,0.001412,172.31.47.0-255,66,96535,92,240651
6107,0.001438,74.125.68.0-255,2902,99437,92,240651
6108,0.00144,172.31.47.0-255,66,99503,92,240651
6109,0.001463,74.125.68.0-255,2184,101687,92,240651
6110,0.001466,172.31.47.0-255,66,101753,92,240651
6111,0.001788,74.125.68.0-255,1484,103237,92,240651
6112,0.001807,74.125.68.0-255,2902,106139,92,240651
6113,0.001809,172.31.47.0-255,66,106205,92,240651
6114,0.001839,74.125.68.0-255,5738,111943,92,240651
6115,0.001841,172.31.47.0-255,66,112009,92,240651
6116,0.001844,74.125.68.0-255,1484,113493,92,240651
6117,0.00187,74.125.68.0-255,2902,116395,92,240651
6118,0.001873,172.31.47.0-255,66,116461,92,240651
6119,0.001895,74.125.68.0-255,4320,120781,92,240651
6120,0.001898,172.31.47.0-255,66,120847,92,240651
6121,0.00192,74.125.68.0-255,1484,122331,92,240651
6122,0.001924,74.125.68.0-255,2902,125233,92,240651
6123,0.001926,172.31.47.0-255,66,125299,92,240651
6124,0.001953,172.31.47.0-255,66,125365,92,240651
6125,0.001956,74.125.68.0-255,766,126131,92,240651
6126,0.002035,74.125.68.0-255,1484,127615,92,240651
6127,0.002038,172.31.47.0-255,66,127681,92,240651
6128,0.002041,74.125.68.0-255,1484,129165,92,240651
6129,0.002065,74.125.68.0-255,1484,130649,92,240651
6130,0.002067,172.31.47.0-255,66,130715,92,240651
6131,0.002071,74.125.68.0-255,4320,135035,92,240651
6132,0.002073,172.31.47.0-255,66,135101,92,240651
6133,0.002076,74.125.68.0-255,1484,136585,92,240651
6134,0.002103,74.125.68.0-255,7156,143741,92,240651
6135,0.002106,172.31.47.0-255,66,143807,92,240651
6136,0.002112,74.125.68.0-255,5738,149545,92,240651
6137,0.002114,172.31.47.0-255,66,149611,92,240651
6138,0.002151,74.125.68.0-255,7156,156767,92,240651
6139,0.002154,172.31.47.0-255,66,156833,92,240651
6140,0.002158,74.125.68.0-255,3602,160435,92,240651
6141,0.00216,172.31.47.0-255,66,160501,92,240651
6142,0.00222,74.125.68.0-255,1484,161985,92,240651
6143,0.002238,74.125.68.0-255,2902,164887,92,240651
6144,0.00224,172.31.47.0-255,66,164953,92,240651
6145,0.002266,74.125.68.0-255,4320,169273,92,240651
6146,0.002268,172.31.47.0-255,66,169339,92,240651
6147,0.002274,74.125.68.0-255,5738,175077,92,240651
6148,0.002276,172.31.47.0-255,66,175143,92,240651
6149,0.002302,74.125.68.0-255,4320,179463,92,240651
6150,0.002304,172.31.47.0-255,66,179529,92,240651
6151,0.002329,74.125.68.0-255,7156,186685,92,240651
6152,0.002331,172.31.47.0-255,66,186751,92,240651
6153,0.002335,74.125.68.0-255,4320,191071,92,240651
6154,0.002337,172.31.47.0-255,66,191137,92,240651
6155,0.002363,74.125.68.0-255,1484,192621,92,240651
6156,0.002377,74.125.68.0-255,2184,194805,92,240651
6157,0.00238,172.31.47.0-255,66,194871,92,240651
6158,0.002448,74.125.68.0-255,1484,196355,92,240651
6159,0.00246,74.125.68.0-255,2902,199257,92,240651
6160,0.002462,172.31.47.0-255,66,199323,92,240651
6161,0.002489,74.125.68.0-255,5738,205061,92,240651
6162,0.002492,172.31.47.0-255,66,205127,92,240651
6163,0.002517,74.125.68.0-255,5738,210865,92,240651
6164,0.00252,172.31.47.0-255,66,210931,92,240651
6165,0.002551,74.125.68.0-255,7156,218087,92,240651
6166,0.002553,172.31.47.0-255,66,218153,92,240651
6167,0.002558,74.125.68.0-255,5738,223891,92,240651
6168,0.00256,172.31.47.0-255,66,223957,92,240651
6169,0.00258,74.125.68.0-255,5020,228977,92,240651
6170,0.002582,172.31.47.0-255,66,229043,92,240651
6171,0.005157,74.125.68.0-255,5738,234781,92,240651
6172,0.005163,172.31.47.0-255,66,234847,92,240651
6173,0.007742,74.125.68.0-255,5738,240585,92,240651
6174,0.00775,172.31.47.0-255,66,240651,92,240651
6175,0.0,74.125.200.0-255,153,153,92,318627
6176,1.5e-05,172.31.47.0-255,66,219,92,318627
6177,2e-05,74.125.200.0-255,1484,1703,92,318627
6178,2.4e-05,172.31.47.0-255,66,1769,92,318627
6179,4.4e-05,74.125.200.0-255,2902,4671,92,318627
6180,4.6e-05,172.31.47.0-255,66,4737,92,318627
6181,6e-05,74.125.200.0-255,5738,10475,92,318627
6182,6.3e-05,172.31.47.0-255,66,10541,92,318627
6183,8.1e-05,74.125.200.0-255,1484,12025,92,318627
6184,8.2e-05,172.31.47.0-255,66,12091,92,318627
6185,0.000106,74.125.200.0-255,2175,14266,92,318627
6186,0.000108,172.31.47.0-255,66,14332,92,318627
6187,0.000156,74.125.200.0-255,2902,17234,92,318627
6188,0.000158,172.31.47.0-255,66,17300,92,318627
6189,0.000164,74.125.200.0-255,4320,21620,92,318627
6190,0.000166,172.31.47.0-255,66,21686,92,318627
6191,0.000218,172.31.47.0-255,66,21752,92,318627
6192,0.000221,74.125.200.0-255,1125,22877,92,318627
6193,0.000224,172.31.47.0-255,66,22943,92,318627
6194,0.000227,74.125.200.0-255,1484,24427,92,318627
6195,0.000229,172.31.47.0-255,66,24493,92,318627
6196,0.000234,74.125.200.0-255,2902,27395,92,318627
6197,0.000236,172.31.47.0-255,66,27461,92,318627
6198,0.00026,74.125.200.0-255,1484,28945,92,318627
6199,0.000262,172.31.47.0-255,66,29011,92,318627
6200,0.000273,172.31.47.0-255,66,29077,92,318627
6201,0.000294,74.125.200.0-255,1125,30202,92,318627
6202,0.000296,172.31.47.0-255,66,30268,92,318627
6203,0.000352,74.125.200.0-255,1484,31752,92,318627
6204,0.000354,172.31.47.0-255,66,31818,92,318627
6205,0.000358,74.125.200.0-255,1484,33302,92,318627
6206,0.000374,74.125.200.0-255,2902,36204,92,318627
6207,0.000377,172.31.47.0-255,66,36270,92,318627
6208,0.000382,74.125.200.0-255,4320,40590,92,318627
6209,0.000384,172.31.47.0-255,66,40656,92,318627
6210,0.000395,74.125.200.0-255,1484,42140,92,318627
6211,0.000411,74.125.200.0-255,5379,47519,92,318627
6212,0.000413,172.31.47.0-255,66,47585,92,318627
6213,0.000448,74.125.200.0-255,680,48265,92,318627
6214,0.000659,74.125.200.0-255,1484,49749,92,318627
6215,0.000662,172.31.47.0-255,66,49815,92,318627
6216,0.000667,74.125.200.0-255,2902,52717,92,318627
6217,0.000669,172.31.47.0-255,66,52783,92,318627
6218,0.000695,74.125.200.0-255,5738,58521,92,318627
6219,0.000698,172.31.47.0-255,66,58587,92,318627
6220,0.000715,74.125.200.0-255,4320,62907,92,318627
6221,0.000717,172.31.47.0-255,66,62973,92,318627
6222,0.000748,172.31.47.0-255,66,63039,92,318627
6223,0.000766,74.125.200.0-255,2902,65941,92,318627
6224,0.000768,172.31.47.0-255,66,66007,92,318627
6225,0.000798,172.31.47.0-255,66,66073,92,318627
6226,0.000814,74.125.200.0-255,2902,68975,92,318627
6227,0.000817,172.31.47.0-255,66,69041,92,318627
6228,0.000832,74.125.200.0-255,4320,73361,92,318627
6229,0.000836,172.31.47.0-255,66,73427,92,318627
6230,0.000855,74.125.200.0-255,7156,80583,92,318627
6231,0.000857,172.31.47.0-255,66,80649,92,318627
6232,0.000886,74.125.200.0-255,1484,82133,92,318627
6233,0.00089,74.125.200.0-255,4320,86453,92,318627
6234,0.000893,172.31.47.0-255,66,86519,92,318627
6235,0.000899,74.125.200.0-255,5738,92257,92,318627
6236,0.000901,172.31.47.0-255,66,92323,92,318627
6237,0.000912,74.125.200.0-255,1484,93807,92,318627
6238,0.000933,74.125.200.0-255,6438,100245,92,318627
6239,0.000936,172.31.47.0-255,66,100311,92,318627
6240,0.000968,74.125.200.0-255,4320,104631,92,318627
6241,0.000971,172.31.47.0-255,66,104697,92,318627
6242,0.000974,74.125.200.0-255,1484,106181,92,318627
6243,0.000989,74.125.200.0-255,4320,110501,92,318627
6244,0.000993,172.31.47.0-255,66,110567,92,318627
6245,0.001006,74.125.200.0-255,1484,112051,92,318627
6246,0.00103,172.31.47.0-255,66,112117,92,318627
6247,0.001034,74.125.200.0-255,2902,115019,92,318627
6248,0.001036,172.31.47.0-255,66,115085,92,318627
6249,0.001047,74.125.200.0-255,1484,116569,92,318627
6250,0.001107,74.125.200.0-255,5738,122307,92,318627
6251,0.00111,172.31.47.0-255,66,122373,92,318627
6252,0.001126,74.125.200.0-255,2184,124557,92,318627
6253,0.001128,172.31.47.0-255,66,124623,92,318627
6254,0.001182,74.125.200.0-255,1484,126107,92,318627
6255,0.001186,74.125.200.0-255,1484,127591,92,318627
6256,0.001188,172.31.47.0-255,66,127657,92,318627
6257,0.0012,74.125.200.0-255,1484,129141,92,318627
6258,0.001202,74.125.200.0-255,1484,130625,92,318627
6259,0.001204,172.31.47.0-255,66,130691,92,318627
6260,0.001217,74.125.200.0-255,4320,135011,92,318627
6261,0.00122,172.31.47.0-255,66,135077,92,318627
6262,0.001228,74.125.200.0-255,2902,137979,92,318627
6263,0.00123,172.31.47.0-255,66,138045,92,318627
6264,0.001234,74.125.200.0-255,2902,140947,92,318627
6265,0.001236,172.31.47.0-255,66,141013,92,318627
6266,0.001261,74.125.200.0-255,1484,142497,92,318627
6267,0.001271,172.31.47.0-255,66,142563,92,318627
6268,0.001276,74.125.200.0-255,4320,146883,92,318627
6269,0.001278,172.31.47.0-255,66,146949,92,318627
6270,0.001325,74.125.200.0-255,3602,150551,92,318627
6271,0.001329,172.31.47.0-255,66,150617,92,318627
6272,0.001429,74.125.200.0-255,1484,152101,92,318627
6273,0.001435,74.125.200.0-255,2902,155003,92,318627
6274,0.001438,172.31.47.0-255,66,155069,92,318627
6275,0.001489,74.125.200.0-255,5738,160807,92,318627
6276,0.001492,172.31.47.0-255,66,160873,92,318627
6277,0.001499,74.125.200.0-255,7156,168029,92,318627
6278,0.001501,172.31.47.0-255,66,168095,92,318627
6279,0.001511,172.31.47.0-255,66,168161,92,318627
6280,0.001527,74.125.200.0-255,4320,172481,92,318627
6281,0.001529,172.31.47.0-255,66,172547,92,318627
6282,0.001544,74.125.200.0-255,3602,176149,92,318627
6283,0.001546,172.31.47.0-255,66,176215,92,318627
6284,0.001589,74.125.200.0-255,1484,177699,92,318627
6285,0.001592,74.125.200.0-255,1484,179183,92,318627
6286,0.001595,172.31.47.0-255,66,179249,92,318627
6287,0.00161,74.125.200.0-255,1484,180733,92,318627
6288,0.001616,74.125.200.0-255,5738,186471,92,318627
6289,0.001618,172.31.47.0-255,66,186537,92,318627
6290,0.001626,74.125.200.0-255,2902,189439,92,318627
6291,0.001628,172.31.47.0-255,66,189505,92,318627
6292,0.001631,74.125.200.0-255,1484,190989,92,318627
6293,0.001648,74.125.200.0-255,2902,193891,92,318627
6294,0.001651,172.31.47.0-255,66,193957,92,318627
6295,0.001664,74.125.200.0-255,4320,198277,92,318627
6296,0.001666,172.31.47.0-255,66,198343,92,318627
6297,0.001685,74.125.200.0-255,4320,202663,92,318627
6298,0.00169,74.125.200.0-255,5738,208401,92,318627
6299,0.001693,172.31.47.0-255,66,208467,92,318627
6300,0.0017,172.31.47.0-255,66,208533,92,318627
6301,0.001723,74.125.200.0-255,2184,210717,92,318627
6302,0.001726,172.31.47.0-255,66,210783,92,318627
6303,0.001785,74.125.200.0-255,1484,212267,92,318627
6304,0.001796,74.125.200.0-255,2902,215169,92,318627
6305,0.001799,172.31.47.0-255,66,215235,92,318627
6306,0.001823,74.125.200.0-255,5738,220973,92,318627
6307,0.001826,172.31.47.0-255,66,221039,92,318627
6308,0.00183,74.125.200.0-255,2902,223941,92,318627
6309,0.001832,172.31.47.0-255,66,224007,92,318627
6310,0.001836,74.125.200.0-255,4320,228327,92,318627
6311,0.001838,172.31.47.0-255,66,228393,92,318627
6312,0.001861,74.125.200.0-255,5738,234131,92,318627
6313,0.001864,172.31.47.0-255,66,234197,92,318627
6314,0.001881,74.125.200.0-255,2902,237099,92,318627
6315,0.001883,172.31.47.0-255,66,237165,92,318627
6316,0.001889,74.125.200.0-255,7156,244321,92,318627
6317,0.001891,172.31.47.0-255,66,244387,92,318627
6318,0.001907,74.125.200.0-255,2902,247289,92,318627
6319,0.001909,172.31.47.0-255,66,247355,92,318627
6320,0.001925,74.125.200.0-255,5020,252375,92,318627
6321,0.001927,172.31.47.0-255,66,252441,92,318627
6322,0.001934,74.125.200.0-255,7156,259597,92,318627
6323,0.001936,172.31.47.0-255,66,259663,92,318627
6324,0.001962,172.31.47.0-255,66,259729,92,318627
6325,0.001983,74.125.200.0-255,2902,262631,92,318627
6326,0.001985,172.31.47.0-255,66,262697,92,318627
6327,0.00201,172.31.47.0-255,66,262763,92,318627
6328,0.002045,74.125.200.0-255,1484,264247,92,318627
6329,0.002065,74.125.200.0-255,2902,267149,92,318627
6330,0.002067,172.31.47.0-255,66,267215,92,318627
6331,0.002072,74.125.200.0-255,2902,270117,92,318627
6332,0.002073,172.31.47.0-255,66,270183,92,318627
6333,0.002088,74.125.200.0-255,2902,273085,92,318627
6334,0.00209,172.31.47.0-255,66,273151,92,318627
6335,0.002094,74.125.200.0-255,2902,276053,92,318627
6336,0.002096,172.31.47.0-255,66,276119,92,318627
6337,0.002098,74.125.200.0-255,1484,277603,92,318627
6338,0.002127,172.31.47.0-255,66,277669,92,318627
6339,0.002156,172.31.47.0-255,66,277735,92,318627
6340,0.002179,74.125.200.0-255,1484,279219,92,318627
6341,0.002192,74.125.200.0-255,2902,282121,92,318627
6342,0.002195,172.31.47.0-255,66,282187,92,318627
6343,0.002211,74.125.200.0-255,4320,286507,92,318627
6344,0.002213,172.31.47.0-255,66,286573,92,318627
6345,0.002225,74.125.200.0-255,1484,288057,92,318627
6346,0.002228,74.125.200.0-255,1484,289541,92,318627
6347,0.00223,172.31.47.0-255,66,289607,92,318627
6348,0.002258,74.125.200.0-255,5738,295345,92,318627
6349,0.002261,172.31.47.0-255,66,295411,92,318627
6350,0.002267,74.125.200.0-255,5738,301149,92,318627
6351,0.002269,172.31.47.0-255,66,301215,92,318627
6352,0.004508,74.125.200.0-255,5738,306953,92,318627
6353,0.004513,172.31.47.0-255,66,307019,92,318627
6354,0.006748,74.125.200.0-255,5738,312757,92,318627
6355,0.006754,172.31.47.0-255,66,312823,92,318627
6356,0.008997,74.125.200.0-255,5738,318561,92,318627
6357,0.009003,172.31.47.0-255,66,318627,92,318627
6358,0.0,74.125.24.0-255,153,153,92,146043
6359,2.9e-05,172.31.47.0-255,66,219,92,146043
6360,3.5e-05,74.125.24.0-255,1484,1703,92,146043
6361,4e-05,172.31.47.0-255,66,1769,92,146043
6362,4.4e-05,74.125.24.0-255,2902,4671,92,146043
6363,5.3e-05,172.31.47.0-255,66,4737,92,146043
6364,6e-05,74.125.24.0-255,7156,11893,92,146043
6365,6.3e-05,172.31.47.0-255,66,11959,92,146043
6366,6.7e-05,74.125.24.0-255,1959,13918,92,146043
6367,6.9e-05,172.31.47.0-255,66,13984,92,146043
6368,0.000213,74.125.24.0-255,1484,15468,92,146043
6369,0.000217,172.31.47.0-255,66,15534,92,146043
6370,0.000222,74.125.24.0-255,2902,18436,92,146043
6371,0.000225,172.31.47.0-255,66,18502,92,146043
6372,0.000228,74.125.24.0-255,1484,19986,92,146043
6373,0.000229,172.31.47.0-255,66,20052,92,146043
6374,0.000263,74.125.24.0-255,4320,24372,92,146043
6375,0.000266,172.31.47.0-255,66,24438,92,146043
6376,0.000273,74.125.24.0-255,7156,31594,92,146043
6377,0.000274,172.31.47.0-255,66,31660,92,146043
6378,0.000303,74.125.24.0-255,6797,38457,92,146043
6379,0.000306,172.31.47.0-255,66,38523,92,146043
6380,0.000323,74.125.24.0-255,7156,45679,92,146043
6381,0.00033,172.31.47.0-255,66,45745,92,146043
6382,0.000352,74.125.24.0-255,2543,48288,92,146043
6383,0.000355,172.31.47.0-255,66,48354,92,146043
6384,0.00081,74.125.24.0-255,1484,49838,92,146043
6385,0.000815,172.31.47.0-255,66,49904,92,146043
6386,0.000823,74.125.24.0-255,2902,52806,92,146043
6387,0.000825,172.31.47.0-255,66,52872,92,146043
6388,0.000837,74.125.24.0-255,5738,58610,92,146043
6389,0.00084,172.31.47.0-255,66,58676,92,146043
6390,0.000882,172.31.47.0-255,66,58742,92,146043
6391,0.000887,74.125.24.0-255,4320,63062,92,146043
6392,0.000889,172.31.47.0-255,66,63128,92,146043
6393,0.000926,74.125.24.0-255,5960,69088,92,146043
6394,0.00093,172.31.47.0-255,66,69154,92,146043
6395,0.000978,74.125.24.0-255,1484,70638,92,146043
6396,0.000984,74.125.24.0-255,2902,73540,92,146043
6397,0.000989,74.125.24.0-255,4320,77860,92,146043
6398,0.001002,74.125.24.0-255,1484,79344,92,146043
6399,0.001018,74.125.24.0-255,2902,82246,92,146043
6400,0.001023,172.31.47.0-255,66,82312,92,146043
6401,0.001033,74.125.24.0-255,3961,86273,92,146043
6402,0.001047,172.31.47.0-255,66,86339,92,146043
6403,0.002051,74.125.24.0-255,1484,87823,92,146043
6404,0.002056,172.31.47.0-255,66,87889,92,146043
6405,0.002063,74.125.24.0-255,2902,90791,92,146043
6406,0.00208,172.31.47.0-255,66,90857,92,146043
6407,0.002106,74.125.24.0-255,5738,96595,92,146043
6408,0.002112,74.125.24.0-255,7156,103751,92,146043
6409,0.002136,172.31.47.0-255,66,103817,92,146043
6410,0.002149,74.125.24.0-255,2184,106001,92,146043
6411,0.002154,172.31.47.0-255,66,106067,92,146043
6412,0.002206,74.125.24.0-255,1484,107551,92,146043
6413,0.002233,74.125.24.0-255,2902,110453,92,146043
6414,0.002238,74.125.24.0-255,5738,116191,92,146043
6415,0.002286,172.31.47.0-255,66,116257,92,146043
6416,0.0023,74.125.24.0-255,7156,123413,92,146043
6417,0.002322,74.125.24.0-255,6438,129851,92,146043
6418,0.002325,172.31.47.0-255,66,129917,92,146043
6419,0.002329,172.31.47.0-255,66,129983,92,146043
6420,0.004561,74.125.24.0-255,4320,134303,92,146043
6421,0.004566,172.31.47.0-255,66,134369,92,146043
6422,0.004588,74.125.24.0-255,1484,135853,92,146043
6423,0.006831,74.125.24.0-255,4320,140173,92,146043
6424,0.006838,172.31.47.0-255,66,140239,92,146043
6425,0.009083,74.125.24.0-255,5738,145977,92,146043
6426,0.009125,172.31.47.0-255,66,146043,92,146043
6427,0.0,172.217.194.0-255,153,153,92,210886
6428,2.1e-05,172.31.47.0-255,66,219,92,210886
6429,2.7e-05,172.217.194.0-255,1484,1703,92,210886
6430,3.1e-05,172.31.47.0-255,66,1769,92,210886
6431,3.7e-05,172.217.194.0-255,2902,4671,92,210886
6432,4e-05,172.31.47.0-255,66,4737,92,210886
6433,4.7e-05,172.217.194.0-255,7156,11893,92,210886
6434,5e-05,172.31.47.0-255,66,11959,92,210886
6435,5.3e-05,172.217.194.0-255,2091,14050,92,210886
6436,5.6e-05,172.31.47.0-255,66,14116,92,210886
6437,0.000138,172.217.194.0-255,1484,15600,92,210886
6438,0.000141,172.31.47.0-255,66,15666,92,210886
6439,0.000152,172.217.194.0-255,1484,17150,92,210886
6440,0.000154,172.31.47.0-255,66,17216,92,210886
6441,0.000171,172.217.194.0-255,1484,18700,92,210886
6442,0.000173,172.31.47.0-255,66,18766,92,210886
6443,0.00018,172.217.194.0-255,5738,24504,92,210886
6444,0.000182,172.31.47.0-255,66,24570,92,210886
6445,0.000202,172.217.194.0-255,2902,27472,92,210886
6446,0.000204,172.31.47.0-255,66,27538,92,210886
6447,0.000223,172.217.194.0-255,3961,31499,92,210886
6448,0.000225,172.31.47.0-255,66,31565,92,210886
6449,0.000359,172.217.194.0-255,1484,33049,92,210886
6450,0.000363,172.31.47.0-255,66,33115,92,210886
6451,0.000382,172.217.194.0-255,2902,36017,92,210886
6452,0.000384,172.31.47.0-255,66,36083,92,210886
6453,0.000387,172.217.194.0-255,1484,37567,92,210886
6454,0.00039,172.31.47.0-255,66,37633,92,210886
6455,0.000415,172.217.194.0-255,4320,41953,92,210886
6456,0.000417,172.31.47.0-255,66,42019,92,210886
6457,0.000421,172.217.194.0-255,2902,44921,92,210886
6458,0.000422,172.31.47.0-255,66,44987,92,210886
6459,0.000452,172.217.194.0-255,4320,49307,92,210886
6460,0.000454,172.31.47.0-255,66,49373,92,210886
6461,0.000471,172.217.194.0-255,6797,56170,92,210886
6462,0.000474,172.31.47.0-255,66,56236,92,210886
6463,0.000479,172.217.194.0-255,4320,60556,92,210886
6464,0.000497,172.31.47.0-255,66,60622,92,210886
6465,0.000509,172.217.194.0-255,1484,62106,92,210886
6466,0.000522,172.217.194.0-255,4214,66320,92,210886
6467,0.000533,172.217.194.0-255,114,66434,92,210886
6468,0.000536,172.31.47.0-255,66,66500,92,210886
6469,0.000595,172.217.194.0-255,384,66884,92,210886
6470,0.000691,172.217.194.0-255,1484,68368,92,210886
6471,0.000721,172.31.47.0-255,66,68434,92,210886
6472,0.00073,172.217.194.0-255,2902,71336,92,210886
6473,0.000736,172.217.194.0-255,5738,77074,92,210886
6474,0.000742,172.31.47.0-255,66,77140,92,210886
6475,0.000771,172.217.194.0-255,4320,81460,92,210886
6476,0.000775,172.31.47.0-255,66,81526,92,210886
6477,0.000781,172.217.194.0-255,1484,83010,92,210886
6478,0.000796,172.217.194.0-255,4320,87330,92,210886
6479,0.000808,172.31.47.0-255,66,87396,92,210886
6480,0.000812,172.217.194.0-255,2902,90298,92,210886
6481,0.000817,172.217.194.0-255,5738,96036,92,210886
6482,0.000821,172.31.47.0-255,66,96102,92,210886
6483,0.000841,172.217.194.0-255,5020,101122,92,210886
6484,0.000847,172.31.47.0-255,66,101188,92,210886
6485,0.000987,172.217.194.0-255,1484,102672,92,210886
6486,0.000991,172.217.194.0-255,1484,104156,92,210886
6487,0.000998,172.31.47.0-255,66,104222,92,210886
6488,0.001006,172.217.194.0-255,1484,105706,92,210886
6489,0.00101,172.217.194.0-255,2902,108608,92,210886
6490,0.001013,172.31.47.0-255,66,108674,92,210886
6491,0.001024,172.217.194.0-255,2902,111576,92,210886
6492,0.001028,172.217.194.0-255,2902,114478,92,210886
6493,0.001048,172.217.194.0-255,4320,118798,92,210886
6494,0.001058,172.31.47.0-255,66,118864,92,210886
6495,0.001064,172.217.194.0-255,5738,124602,92,210886
6496,0.001077,172.217.194.0-255,2902,127504,92,210886
6497,0.00108,172.31.47.0-255,66,127570,92,210886
6498,0.001097,172.217.194.0-255,2902,130472,92,210886
6499,0.001115,172.31.47.0-255,66,130538,92,210886
6500,0.001132,172.217.194.0-255,5020,135558,92,210886
6501,0.001142,172.31.47.0-255,66,135624,92,210886
6502,0.001178,172.217.194.0-255,4320,139944,92,210886
6503,0.001185,172.31.47.0-255,66,140010,92,210886
6504,0.001194,172.217.194.0-255,1484,141494,92,210886
6505,0.001196,172.217.194.0-255,1484,142978,92,210886
6506,0.00121,172.217.194.0-255,5738,148716,92,210886
6507,0.001227,172.31.47.0-255,66,148782,92,210886
6508,0.001232,172.217.194.0-255,4320,153102,92,210886
6509,0.001237,172.31.47.0-255,66,153168,92,210886
6510,0.001253,172.217.194.0-255,5738,158906,92,210886
6511,0.001269,172.31.47.0-255,66,158972,92,210886
6512,0.001288,172.217.194.0-255,5738,164710,92,210886
6513,0.001299,172.31.47.0-255,66,164776,92,210886
6514,0.00131,172.217.194.0-255,5020,169796,92,210886
6515,0.001319,172.31.47.0-255,66,169862,92,210886
6516,0.001409,172.217.194.0-255,1484,171346,92,210886
6517,0.001412,172.217.194.0-255,1484,172830,92,210886
6518,0.001429,172.217.194.0-255,1484,174314,92,210886
6519,0.001436,172.217.194.0-255,5738,180052,92,210886
6520,0.001449,172.217.194.0-255,2902,182954,92,210886
6521,0.001453,172.31.47.0-255,66,183020,92,210886
6522,0.001464,172.217.194.0-255,4320,187340,92,210886
6523,0.001472,172.31.47.0-255,66,187406,92,210886
6524,0.001476,172.217.194.0-255,2902,190308,92,210886
6525,0.001504,172.217.194.0-255,4320,194628,92,210886
6526,0.001512,172.31.47.0-255,66,194694,92,210886
6527,0.001531,172.31.47.0-255,66,194760,92,210886
6528,0.004033,172.217.194.0-255,1484,196244,92,210886
6529,0.004043,172.217.194.0-255,2902,199146,92,210886
6530,0.004047,172.31.47.0-255,66,199212,92,210886
6531,0.004052,172.217.194.0-255,1484,200696,92,210886
6532,0.006544,172.217.194.0-255,4320,205016,92,210886
6533,0.006547,172.31.47.0-255,66,205082,92,210886
6534,0.009018,172.217.194.0-255,5738,210820,92,210886
6535,0.009025,172.31.47.0-255,66,210886,92,210886
6536,0.0,172.31.47.0-255,105,105,92,276
6537,0.001765,157.240.13.0-255,105,210,92,276
6538,0.001775,172.31.47.0-255,66,276,92,276
6539,0.0,74.125.130.0-255,153,153,92,119920
6540,3.1e-05,172.31.47.0-255,66,219,92,119920
6541,3.8e-05,74.125.130.0-255,1484,1703,92,119920
6542,4.2e-05,172.31.47.0-255,66,1769,92,119920
6543,4.6e-05,74.125.130.0-255,2902,4671,92,119920
6544,5.6e-05,172.31.47.0-255,66,4737,92,119920
6545,7.9e-05,74.125.130.0-255,4320,9057,92,119920
6546,8.2e-05,172.31.47.0-255,66,9123,92,119920
6547,0.000106,74.125.130.0-255,2902,12025,92,119920
6548,0.000108,172.31.47.0-255,66,12091,92,119920
6549,0.000185,74.125.130.0-255,2207,14298,92,119920
6550,0.000189,172.31.47.0-255,66,14364,92,119920
6551,0.000232,74.125.130.0-255,2902,17266,92,119920
6552,0.000235,172.31.47.0-255,66,17332,92,119920
6553,0.000268,74.125.130.0-255,5738,23070,92,119920
6554,0.000272,172.31.47.0-255,66,23136,92,119920
6555,0.000287,74.125.130.0-255,1484,24620,92,119920
6556,0.00029,172.31.47.0-255,66,24686,92,119920
6557,0.000378,74.125.130.0-255,1484,26170,92,119920
6558,0.000381,172.31.47.0-255,66,26236,92,119920
6559,0.000409,172.31.47.0-255,66,26302,92,119920
6560,0.000605,74.125.130.0-255,4320,30622,92,119920
6561,0.000609,172.31.47.0-255,66,30688,92,119920
6562,0.000651,74.125.130.0-255,6797,37485,92,119920
6563,0.000654,172.31.47.0-255,66,37551,92,119920
6564,0.000767,74.125.130.0-255,1484,39035,92,119920
6565,0.000771,172.31.47.0-255,66,39101,92,119920
6566,0.000803,172.31.47.0-255,66,39167,92,119920
6567,0.00105,172.31.47.0-255,66,39233,92,119920
6568,0.001172,74.125.130.0-255,4320,43553,92,119920
6569,0.001177,172.31.47.0-255,66,43619,92,119920
6570,0.001205,74.125.130.0-255,4831,48450,92,119920
6571,0.001209,172.31.47.0-255,66,48516,92,119920
6572,0.001319,74.125.130.0-255,1484,50000,92,119920
6573,0.001354,74.125.130.0-255,2902,52902,92,119920
6574,0.001356,172.31.47.0-255,66,52968,92,119920
6575,0.001384,74.125.130.0-255,4320,57288,92,119920
6576,0.001386,172.31.47.0-255,66,57354,92,119920
6577,0.001421,74.125.130.0-255,1484,58838,92,119920
6578,0.00143,74.125.130.0-255,1484,60322,92,119920
6579,0.001431,172.31.47.0-255,66,60388,92,119920
6580,0.001456,74.125.130.0-255,5738,66126,92,119920
6581,0.001458,172.31.47.0-255,66,66192,92,119920
6582,0.001605,74.125.130.0-255,2902,69094,92,119920
6583,0.001608,172.31.47.0-255,66,69160,92,119920
6584,0.001633,74.125.130.0-255,5738,74898,92,119920
6585,0.001635,172.31.47.0-255,66,74964,92,119920
6586,0.001713,74.125.130.0-255,5738,80702,92,119920
6587,0.001715,172.31.47.0-255,66,80768,92,119920
6588,0.00173,74.125.130.0-255,2184,82952,92,119920
6589,0.001732,172.31.47.0-255,66,83018,92,119920
6590,0.001827,74.125.130.0-255,1484,84502,92,119920
6591,0.001846,74.125.130.0-255,1484,85986,92,119920
6592,0.001848,172.31.47.0-255,66,86052,92,119920
6593,0.001867,74.125.130.0-255,1484,87536,92,119920
6594,0.001908,74.125.130.0-255,4320,91856,92,119920
6595,0.001911,172.31.47.0-255,66,91922,92,119920
6596,0.001934,74.125.130.0-255,1484,93406,92,119920
6597,0.001983,74.125.130.0-255,1484,94890,92,119920
6598,0.001985,172.31.47.0-255,66,94956,92,119920
6599,0.002023,172.31.47.0-255,66,95022,92,119920
6600,0.002198,74.125.130.0-255,2902,97924,92,119920
6601,0.0022,172.31.47.0-255,66,97990,92,119920
6602,0.002234,172.31.47.0-255,66,98056,92,119920
6603,0.002432,74.125.130.0-255,4320,102376,92,119920
6604,0.002434,172.31.47.0-255,66,102442,92,119920
6605,0.002475,172.31.47.0-255,66,102508,92,119920
6606,0.00447,74.125.130.0-255,5738,108246,92,119920
6607,0.004476,172.31.47.0-255,66,108312,92,119920
6608,0.006496,74.125.130.0-255,5738,114050,92,119920
6609,0.006501,172.31.47.0-255,66,114116,92,119920
6610,0.008506,74.125.130.0-255,5738,119854,92,119920
6611,0.008513,172.31.47.0-255,66,119920,92,119920
6612,0.0,172.31.47.0-255,105,105,92,276
6613,0.001758,157.240.13.0-255,105,210,92,276
6614,0.001769,172.31.47.0-255,66,276,92,276
6615,0.0,172.31.47.0-255,105,105,92,105
6616,0.0,74.125.200.0-255,153,153,92,244527
6617,2.4e-05,172.31.47.0-255,66,219,92,244527
6618,2.9e-05,74.125.200.0-255,1484,1703,92,244527
6619,3.3e-05,172.31.47.0-255,66,1769,92,244527
6620,4.3e-05,74.125.200.0-255,1484,3253,92,244527
6621,4.6e-05,172.31.47.0-255,66,3319,92,244527
6622,6.6e-05,74.125.200.0-255,1484,4803,92,244527
6623,6.9e-05,172.31.47.0-255,66,4869,92,244527
6624,7.5e-05,74.125.200.0-255,7156,12025,92,244527
6625,7.7e-05,172.31.47.0-255,66,12091,92,244527
6626,9.9e-05,74.125.200.0-255,2101,14192,92,244527
6627,0.0001,172.31.47.0-255,66,14258,92,244527
6628,0.000104,74.125.200.0-255,2902,17160,92,244527
6629,0.000106,172.31.47.0-255,66,17226,92,244527
6630,0.000109,74.125.200.0-255,2902,20128,92,244527
6631,0.000111,172.31.47.0-255,66,20194,92,244527
6632,0.000136,74.125.200.0-255,4320,24514,92,244527
6633,0.000138,172.31.47.0-255,66,24580,92,244527
6634,0.000142,74.125.200.0-255,2902,27482,92,244527
6635,0.000143,172.31.47.0-255,66,27548,92,244527
6636,0.000148,74.125.200.0-255,3961,31509,92,244527
6637,0.000151,172.31.47.0-255,66,31575,92,244527
6638,0.000447,74.125.200.0-255,1484,33059,92,244527
6639,0.000452,172.31.47.0-255,66,33125,92,244527
6640,0.000457,74.125.200.0-255,2902,36027,92,244527
6641,0.000459,172.31.47.0-255,66,36093,92,244527
6642,0.000482,74.125.200.0-255,2902,38995,92,244527
6643,0.000484,172.31.47.0-255,66,39061,92,244527
6644,0.000514,74.125.200.0-255,4320,43381,92,244527
6645,0.000517,172.31.47.0-255,66,43447,92,244527
6646,0.000532,74.125.200.0-255,1484,44931,92,244527
6647,0.000534,172.31.47.0-255,66,44997,92,244527
6648,0.000561,74.125.200.0-255,3961,48958,92,244527
6649,0.000564,172.31.47.0-255,66,49024,92,244527
6650,0.00057,74.125.200.0-255,5738,54762,92,244527
6651,0.000572,172.31.47.0-255,66,54828,92,244527
6652,0.000585,74.125.200.0-255,1484,56312,92,244527
6653,0.000603,74.125.200.0-255,7156,63468,92,244527
6654,0.000607,172.31.47.0-255,66,63534,92,244527
6655,0.000633,74.125.200.0-255,2543,66077,92,244527
6656,0.000635,172.31.47.0-255,66,66143,92,244527
6657,0.00066,74.125.200.0-255,413,66556,92,244527
6658,0.000701,74.125.200.0-255,1484,68040,92,244527
6659,0.000704,172.31.47.0-255,66,68106,92,244527
6660,0.000719,74.125.200.0-255,4320,72426,92,244527
6661,0.000722,172.31.47.0-255,66,72492,92,244527
6662,0.000742,74.125.200.0-255,4320,76812,92,244527
6663,0.000744,172.31.47.0-255,66,76878,92,244527
6664,0.00075,74.125.200.0-255,5738,82616,92,244527
6665,0.000752,172.31.47.0-255,66,82682,92,244527
6666,0.000775,74.125.200.0-255,4320,87002,92,244527
6667,0.000779,172.31.47.0-255,66,87068,92,244527
6668,0.0008,74.125.200.0-255,7156,94224,92,244527
6669,0.000803,172.31.47.0-255,66,94290,92,244527
6670,0.000808,74.125.200.0-255,4320,98610,92,244527
6671,0.000809,172.31.47.0-255,66,98676,92,244527
6672,0.000845,74.125.200.0-255,2449,101125,92,244527
6673,0.000847,172.31.47.0-255,66,101191,92,244527
6674,0.001043,74.125.200.0-255,1484,102675,92,244527
6675,0.001057,74.125.200.0-255,1484,104159,92,244527
6676,0.00106,172.31.47.0-255,66,104225,92,244527
6677,0.001077,74.125.200.0-255,1484,105709,92,244527
6678,0.001079,74.125.200.0-255,1484,107193,92,244527
6679,0.001081,172.31.47.0-255,66,107259,92,244527
6680,0.0011,74.125.200.0-255,4320,111579,92,244527
6681,0.001103,172.31.47.0-255,66,111645,92,244527
6682,0.001112,74.125.200.0-255,1484,113129,92,244527
6683,0.00114,74.125.200.0-255,7156,120285,92,244527
6684,0.001143,172.31.47.0-255,66,120351,92,244527
6685,0.001152,172.31.47.0-255,66,120417,92,244527
6686,0.001172,74.125.200.0-255,1484,121901,92,244527
6687,0.001178,74.125.200.0-255,4470,126371,92,244527
6688,0.00118,172.31.47.0-255,66,126437,92,244527
6689,0.001213,74.125.200.0-255,1484,127921,92,244527
6690,0.001217,74.125.200.0-255,2902,130823,92,244527
6691,0.001219,172.31.47.0-255,66,130889,92,244527
6692,0.001252,74.125.200.0-255,4320,135209,92,244527
6693,0.001254,172.31.47.0-255,66,135275,92,244527
6694,0.00127,74.125.200.0-255,1484,136759,92,244527
6695,0.00128,172.31.47.0-255,66,136825,92,244527
6696,0.001289,172.31.47.0-255,66,136891,92,244527
6697,0.001312,74.125.200.0-255,2902,139793,92,244527
6698,0.001314,172.31.47.0-255,66,139859,92,244527
6699,0.001318,74.125.200.0-255,2184,142043,92,244527
6700,0.001321,172.31.47.0-255,66,142109,92,244527
6701,0.00135,74.125.200.0-255,1484,143593,92,244527
6702,0.00136,74.125.200.0-255,1484,145077,92,244527
6703,0.001362,172.31.47.0-255,66,145143,92,244527
6704,0.001378,74.125.200.0-255,1484,146627,92,244527
6705,0.001383,74.125.200.0-255,5738,152365,92,244527
6706,0.001385,172.31.47.0-255,66,152431,92,244527
6707,0.001389,74.125.200.0-255,2902,155333,92,244527
6708,0.001391,172.31.47.0-255,66,155399,92,244527
6709,0.001426,74.125.200.0-255,5738,161137,92,244527
6710,0.00143,172.31.47.0-255,66,161203,92,244527
6711,0.001453,74.125.200.0-255,4320,165523,92,244527
6712,0.001456,172.31.47.0-255,66,165589,92,244527
6713,0.001461,74.125.200.0-255,5738,171327,92,244527
6714,0.001463,172.31.47.0-255,66,171393,92,244527
6715,0.001502,74.125.200.0-255,2902,174295,92,244527
6716,0.001506,172.31.47.0-255,66,174361,92,244527
6717,0.001512,74.125.200.0-255,2184,176545,92,244527
6718,0.001514,172.31.47.0-255,66,176611,92,244527
6719,0.001526,74.125.200.0-255,5738,182349,92,244527
6720,0.001528,172.31.47.0-255,66,182415,92,244527
6721,0.001552,74.125.200.0-255,5738,188153,92,244527
6722,0.001555,172.31.47.0-255,66,188219,92,244527
6723,0.00156,74.125.200.0-255,5738,193957,92,244527
6724,0.001562,172.31.47.0-255,66,194023,92,244527
6725,0.001572,74.125.200.0-255,1484,195507,92,244527
6726,0.001598,74.125.200.0-255,2902,198409,92,244527
6727,0.0016,172.31.47.0-255,66,198475,92,244527
6728,0.001625,172.31.47.0-255,66,198541,92,244527
6729,0.001648,74.125.200.0-255,3602,202143,92,244527
6730,0.001651,172.31.47.0-255,66,202209,92,244527
6731,0.001953,74.125.200.0-255,1484,203693,92,244527
6732,0.00198,74.125.200.0-255,2902,206595,92,244527
6733,0.001983,172.31.47.0-255,66,206661,92,244527
6734,0.001987,74.125.200.0-255,2902,209563,92,244527
6735,0.001989,172.31.47.0-255,66,209629,92,244527
6736,0.002003,74.125.200.0-255,2902,212531,92,244527
6737,0.002006,172.31.47.0-255,66,212597,92,244527
6738,0.002014,74.125.200.0-255,2902,215499,92,244527
6739,0.002016,172.31.47.0-255,66,215565,92,244527
6740,0.002038,74.125.200.0-255,4320,219885,92,244527
6741,0.00204,172.31.47.0-255,66,219951,92,244527
6742,0.002063,172.31.47.0-255,66,220017,92,244527
6743,0.002099,74.125.200.0-255,2902,222919,92,244527
6744,0.002101,172.31.47.0-255,66,222985,92,244527
6745,0.002118,74.125.200.0-255,3602,226587,92,244527
6746,0.00212,172.31.47.0-255,66,226653,92,244527
6747,0.004301,74.125.200.0-255,1484,228137,92,244527
6748,0.004315,74.125.200.0-255,1484,229621,92,244527
6749,0.004319,172.31.47.0-255,66,229687,92,244527
6750,0.004337,74.125.200.0-255,2902,232589,92,244527
6751,0.004338,172.31.47.0-255,66,232655,92,244527
6752,0.006532,74.125.200.0-255,2902,235557,92,244527
6753,0.006535,172.31.47.0-255,66,235623,92,244527
6754,0.006554,74.125.200.0-255,2902,238525,92,244527
6755,0.006556,172.31.47.0-255,66,238591,92,244527
6756,0.008749,74.125.200.0-255,2902,241493,92,244527
6757,0.008757,172.31.47.0-255,66,241559,92,244527
6758,0.00879,74.125.200.0-255,2902,244461,92,244527
6759,0.008793,172.31.47.0-255,66,244527,92,244527
6760,0.0,172.217.194.0-255,153,153,92,211508
6761,2.5e-05,172.31.47.0-255,66,219,92,211508
6762,3.2e-05,172.217.194.0-255,1484,1703,92,211508
6763,3.7e-05,172.31.47.0-255,66,1769,92,211508
6764,4.1e-05,172.217.194.0-255,2902,4671,92,211508
6765,5e-05,172.31.47.0-255,66,4737,92,211508
6766,5.6e-05,172.217.194.0-255,4320,9057,92,211508
6767,5.8e-05,172.31.47.0-255,66,9123,92,211508
6768,6.1e-05,172.217.194.0-255,1484,10607,92,211508
6769,6.2e-05,172.31.47.0-255,66,10673,92,211508
6770,0.000103,172.31.47.0-255,66,10739,92,211508
6771,0.000116,172.31.47.0-255,66,10805,92,211508
6772,0.000181,172.217.194.0-255,5738,16543,92,211508
6773,0.000185,172.31.47.0-255,66,16609,92,211508
6774,0.000221,172.31.47.0-255,66,16675,92,211508
6775,0.000254,172.217.194.0-255,1484,18159,92,211508
6776,0.000257,172.31.47.0-255,66,18225,92,211508
6777,0.000262,172.217.194.0-255,2902,21127,92,211508
6778,0.000267,172.31.47.0-255,66,21193,92,211508
6779,0.000289,172.217.194.0-255,5738,26931,92,211508
6780,0.000293,172.31.47.0-255,66,26997,92,211508
6781,0.000294,172.217.194.0-255,5738,32735,92,211508
6782,0.000297,172.31.47.0-255,66,32801,92,211508
6783,0.000328,172.217.194.0-255,1125,33926,92,211508
6784,0.000332,172.31.47.0-255,66,33992,92,211508
6785,0.000335,172.217.194.0-255,647,34639,92,211508
6786,0.000337,172.31.47.0-255,66,34705,92,211508
6787,0.000415,172.217.194.0-255,1484,36189,92,211508
6788,0.000418,172.31.47.0-255,66,36255,92,211508
6789,0.000425,172.217.194.0-255,2902,39157,92,211508
6790,0.000427,172.31.47.0-255,66,39223,92,211508
6791,0.00043,172.217.194.0-255,1484,40707,92,211508
6792,0.000432,172.31.47.0-255,66,40773,92,211508
6793,0.000469,172.217.194.0-255,4320,45093,92,211508
6794,0.000472,172.31.47.0-255,66,45159,92,211508
6795,0.000478,172.217.194.0-255,4320,49479,92,211508
6796,0.00048,172.31.47.0-255,66,49545,92,211508
6797,0.000493,172.31.47.0-255,66,49611,92,211508
6798,0.000497,172.217.194.0-255,2902,52513,92,211508
6799,0.000499,172.31.47.0-255,66,52579,92,211508
6800,0.000529,172.217.194.0-255,5020,57599,92,211508
6801,0.000533,172.31.47.0-255,66,57665,92,211508
6802,0.000641,172.217.194.0-255,1484,59149,92,211508
6803,0.000647,172.217.194.0-255,2902,62051,92,211508
6804,0.00065,172.31.47.0-255,66,62117,92,211508
6805,0.000653,172.217.194.0-255,1484,63601,92,211508
6806,0.000679,172.217.194.0-255,4320,67921,92,211508
6807,0.000683,172.31.47.0-255,66,67987,92,211508
6808,0.000684,172.217.194.0-255,4320,72307,92,211508
6809,0.000686,172.31.47.0-255,66,72373,92,211508
6810,0.000718,172.31.47.0-255,66,72439,92,211508
6811,0.000725,172.31.47.0-255,66,72505,92,211508
6812,0.00076,172.217.194.0-255,1484,73989,92,211508
6813,0.000801,172.31.47.0-255,66,74055,92,211508
6814,0.000805,172.217.194.0-255,4320,78375,92,211508
6815,0.000826,172.217.194.0-255,3602,81977,92,211508
6816,0.000827,172.31.47.0-255,66,82043,92,211508
6817,0.000831,172.31.47.0-255,66,82109,92,211508
6818,0.000855,172.217.194.0-255,1484,83593,92,211508
6819,0.000858,172.217.194.0-255,1484,85077,92,211508
6820,0.000862,172.31.47.0-255,66,85143,92,211508
6821,0.000869,172.217.194.0-255,1484,86627,92,211508
6822,0.000874,172.217.194.0-255,4320,90947,92,211508
6823,0.00088,172.31.47.0-255,66,91013,92,211508
6824,0.000886,172.217.194.0-255,1484,92497,92,211508
6825,0.000902,172.217.194.0-255,5738,98235,92,211508
6826,0.000905,172.31.47.0-255,66,98301,92,211508
6827,0.000919,172.217.194.0-255,7156,105457,92,211508
6828,0.000928,172.217.194.0-255,5738,111195,92,211508
6829,0.000928,172.31.47.0-255,66,111261,92,211508
6830,0.000931,172.31.47.0-255,66,111327,92,211508
6831,0.000953,172.217.194.0-255,5020,116347,92,211508
6832,0.000966,172.31.47.0-255,66,116413,92,211508
6833,0.000987,172.217.194.0-255,1484,117897,92,211508
6834,0.001005,172.217.194.0-255,2902,120799,92,211508
6835,0.00101,172.217.194.0-255,5738,126537,92,211508
6836,0.001011,172.31.47.0-255,66,126603,92,211508
6837,0.001015,172.31.47.0-255,66,126669,92,211508
6838,0.001047,172.217.194.0-255,7156,133825,92,211508
6839,0.001053,172.31.47.0-255,66,133891,92,211508
6840,0.00111,172.217.194.0-255,2184,136075,92,211508
6841,0.001111,172.31.47.0-255,66,136141,92,211508
6842,0.001113,172.217.194.0-255,4320,140461,92,211508
6843,0.001115,172.31.47.0-255,66,140527,92,211508
6844,0.001128,172.31.47.0-255,66,140593,92,211508
6845,0.001173,172.31.47.0-255,66,140659,92,211508
6846,0.001185,172.217.194.0-255,2902,143561,92,211508
6847,0.001189,172.31.47.0-255,66,143627,92,211508
6848,0.001225,172.31.47.0-255,66,143693,92,211508
6849,0.001277,172.217.194.0-255,1484,145177,92,211508
6850,0.00128,172.217.194.0-255,1484,146661,92,211508
6851,0.001282,172.31.47.0-255,66,146727,92,211508
6852,0.0013,172.217.194.0-255,1484,148211,92,211508
6853,0.001305,172.217.194.0-255,5738,153949,92,211508
6854,0.00131,172.217.194.0-255,4320,158269,92,211508
6855,0.001314,172.31.47.0-255,66,158335,92,211508
6856,0.001335,172.217.194.0-255,1484,159819,92,211508
6857,0.001347,172.31.47.0-255,66,159885,92,211508
6858,0.001367,172.31.47.0-255,66,159951,92,211508
6859,0.001376,172.217.194.0-255,2902,162853,92,211508
6860,0.001384,172.31.47.0-255,66,162919,92,211508
6861,0.001391,172.217.194.0-255,2902,165821,92,211508
6862,0.001395,172.31.47.0-255,66,165887,92,211508
6863,0.001424,172.31.47.0-255,66,165953,92,211508
6864,0.001437,172.217.194.0-255,5738,171691,92,211508
6865,0.00144,172.217.194.0-255,1484,173175,92,211508
6866,0.001445,172.31.47.0-255,66,173241,92,211508
6867,0.001472,172.217.194.0-255,5738,178979,92,211508
6868,0.001478,172.31.47.0-255,66,179045,92,211508
6869,0.00149,172.217.194.0-255,4320,183365,92,211508
6870,0.00149,172.31.47.0-255,66,183431,92,211508
6871,0.001494,172.31.47.0-255,66,183497,92,211508
6872,0.00152,172.217.194.0-255,1484,184981,92,211508
6873,0.001527,172.217.194.0-255,6438,191419,92,211508
6874,0.00153,172.31.47.0-255,66,191485,92,211508
6875,0.001552,172.217.194.0-255,4320,195805,92,211508
6876,0.001558,172.31.47.0-255,66,195871,92,211508
6877,0.001568,172.217.194.0-255,4320,200191,92,211508
6878,0.001571,172.31.47.0-255,66,200257,92,211508
6879,0.001616,172.217.194.0-255,1484,201741,92,211508
6880,0.001618,172.217.194.0-255,1484,203225,92,211508
6881,0.001618,172.31.47.0-255,66,203291,92,211508
6882,0.001622,172.217.194.0-255,2902,206193,92,211508
6883,0.001623,172.31.47.0-255,66,206259,92,211508
6884,0.001635,172.31.47.0-255,66,206325,92,211508
6885,0.001664,172.31.47.0-255,66,206391,92,211508
6886,0.001715,172.217.194.0-255,4643,211034,92,211508
6887,0.001715,172.31.47.0-255,66,211100,92,211508
6888,0.001717,172.217.194.0-255,105,211205,92,211508
6889,0.001718,172.31.47.0-255,66,211271,92,211508
6890,0.003242,172.31.47.0-255,66,211337,92,211508
6891,0.003266,172.31.47.0-255,105,211442,92,211508
6892,0.005294,172.217.194.0-255,66,211508,92,211508
6893,0.0,172.217.194.0-255,153,153,92,253328
6894,2e-05,172.31.47.0-255,66,219,92,253328
6895,2.8e-05,172.217.194.0-255,1484,1703,92,253328
6896,3.3e-05,172.31.47.0-255,66,1769,92,253328
6897,4.5e-05,172.217.194.0-255,2902,4671,92,253328
6898,4.9e-05,172.31.47.0-255,66,4737,92,253328
6899,5.8e-05,172.217.194.0-255,7156,11893,92,253328
6900,6.1e-05,172.31.47.0-255,66,11959,92,253328
6901,6.8e-05,172.217.194.0-255,6353,18312,92,253328
6902,7.1e-05,172.31.47.0-255,66,18378,92,253328
6903,0.000123,172.31.47.0-255,66,18444,92,253328
6904,0.000162,172.217.194.0-255,1484,19928,92,253328
6905,0.000164,172.31.47.0-255,66,19994,92,253328
6906,0.00017,172.217.194.0-255,2902,22896,92,253328
6907,0.000172,172.31.47.0-255,66,22962,92,253328
6908,0.000184,172.217.194.0-255,5738,28700,92,253328
6909,0.000186,172.31.47.0-255,66,28766,92,253328
6910,0.000227,172.31.47.0-255,66,28832,92,253328
6911,0.000269,172.217.194.0-255,4320,33152,92,253328
6912,0.000271,172.31.47.0-255,66,33218,92,253328
6913,0.000293,172.217.194.0-255,5669,38887,92,253328
6914,0.000296,172.31.47.0-255,66,38953,92,253328
6915,0.000299,172.217.194.0-255,98,39051,92,253328
6916,0.000301,172.31.47.0-255,66,39117,92,253328
6917,0.000351,172.217.194.0-255,1484,40601,92,253328
6918,0.000353,172.31.47.0-255,66,40667,92,253328
6919,0.000358,172.217.194.0-255,2902,43569,92,253328
6920,0.000361,172.31.47.0-255,66,43635,92,253328
6921,0.000371,172.217.194.0-255,5738,49373,92,253328
6922,0.000374,172.31.47.0-255,66,49439,92,253328
6923,0.000412,172.217.194.0-255,2902,52341,92,253328
6924,0.000414,172.31.47.0-255,66,52407,92,253328
6925,0.000447,172.217.194.0-255,3961,56368,92,253328
6926,0.000455,172.217.194.0-255,7156,63524,92,253328
6927,0.000484,172.217.194.0-255,5738,69262,92,253328
6928,0.000496,172.217.194.0-255,4320,73582,92,253328
6929,0.000501,172.217.194.0-255,2902,76484,92,253328
6930,0.000557,172.217.194.0-255,4320,80804,92,253328
6931,0.000576,172.217.194.0-255,5020,85824,92,253328
6932,0.000627,172.217.194.0-255,1484,87308,92,253328
6933,0.00064,172.217.194.0-255,2902,90210,92,253328
6934,0.000661,172.217.194.0-255,5738,95948,92,253328
6935,0.000668,172.217.194.0-255,5738,101686,92,253328
6936,0.000691,172.217.194.0-255,4320,106006,92,253328
6937,0.000723,172.217.194.0-255,5020,111026,92,253328
6938,0.000747,172.31.47.0-255,66,111092,92,253328
6939,0.000821,172.217.194.0-255,1484,112576,92,253328
6940,0.000827,172.217.194.0-255,2902,115478,92,253328
6941,0.000846,172.217.194.0-255,5738,121216,92,253328
6942,0.000913,172.217.194.0-255,7156,128372,92,253328
6943,0.000918,172.217.194.0-255,3602,131974,92,253328
6944,0.000928,172.31.47.0-255,66,132040,92,253328
6945,0.001472,172.217.194.0-255,1484,133524,92,253328
6946,0.00149,172.217.194.0-255,2902,136426,92,253328
6947,0.001496,172.217.194.0-255,4320,140746,92,253328
6948,0.001512,172.217.194.0-255,1484,142230,92,253328
6949,0.001525,172.217.194.0-255,2902,145132,92,253328
6950,0.001531,172.31.47.0-255,66,145198,92,253328
6951,0.001544,172.217.194.0-255,7156,152354,92,253328
6952,0.001566,172.217.194.0-255,2902,155256,92,253328
6953,0.001589,172.217.194.0-255,5738,160994,92,253328
6954,0.001592,172.31.47.0-255,66,161060,92,253328
6955,0.0016,172.31.47.0-255,66,161126,92,253328
6956,0.001611,172.217.194.0-255,5020,166146,92,253328
6957,0.001633,172.217.194.0-255,1484,167630,92,253328
6958,0.001637,172.217.194.0-255,2902,170532,92,253328
6959,0.001654,172.31.47.0-255,66,170598,92,253328
6960,0.001661,172.217.194.0-255,5738,176336,92,253328
6961,0.001665,172.31.47.0-255,66,176402,92,253328
6962,0.001705,172.217.194.0-255,2902,179304,92,253328
6963,0.001724,172.217.194.0-255,7156,186460,92,253328
6964,0.001738,172.217.194.0-255,766,187226,92,253328
6965,0.00174,172.31.47.0-255,66,187292,92,253328
6966,0.00184,172.217.194.0-255,1484,188776,92,253328
6967,0.001843,172.217.194.0-255,1484,190260,92,253328
6968,0.001852,172.31.47.0-255,66,190326,92,253328
6969,0.00186,172.217.194.0-255,1484,191810,92,253328
6970,0.001865,172.217.194.0-255,5738,197548,92,253328
6971,0.001874,172.31.47.0-255,66,197614,92,253328
6972,0.001881,172.217.194.0-255,1484,199098,92,253328
6973,0.001913,172.217.194.0-255,1484,200582,92,253328
6974,0.001924,172.31.47.0-255,66,200648,92,253328
6975,0.001929,172.31.47.0-255,66,200714,92,253328
6976,0.002126,172.217.194.0-255,1484,202198,92,253328
6977,0.002145,172.217.194.0-255,2902,205100,92,253328
6978,0.002148,172.31.47.0-255,66,205166,92,253328
6979,0.00216,172.217.194.0-255,2902,208068,92,253328
6980,0.00217,172.31.47.0-255,66,208134,92,253328
6981,0.002186,172.217.194.0-255,2902,211036,92,253328
6982,0.002211,172.31.47.0-255,66,211102,92,253328
6983,0.002221,172.217.194.0-255,2902,214004,92,253328
6984,0.002256,172.217.194.0-255,2184,216188,92,253328
6985,0.002261,172.31.47.0-255,66,216254,92,253328
6986,0.002266,172.217.194.0-255,1484,217738,92,253328
6987,0.00227,172.217.194.0-255,2902,220640,92,253328
6988,0.002275,172.31.47.0-255,66,220706,92,253328
6989,0.002287,172.217.194.0-255,2902,223608,92,253328
6990,0.002303,172.217.194.0-255,2902,226510,92,253328
6991,0.002309,172.217.194.0-255,5738,232248,92,253328
6992,0.002318,172.31.47.0-255,66,232314,92,253328
6993,0.002326,172.217.194.0-255,4320,236634,92,253328
6994,0.002331,172.31.47.0-255,66,236700,92,253328
6995,0.002364,172.217.194.0-255,5020,241720,92,253328
6996,0.002405,172.31.47.0-255,66,241786,92,253328
6997,0.004715,172.217.194.0-255,5738,247524,92,253328
6998,0.004722,172.31.47.0-255,66,247590,92,253328
6999,0.007092,172.217.194.0-255,5738,253328,92,253328
7000,0.0,172.31.47.0-255,105,105,92,210
7001,0.001473,157.240.13.0-255,105,210,92,210
7002,0.0,74.125.130.0-255,153,153,92,149739
7003,3.6e-05,172.31.47.0-255,66,219,92,149739
7004,4.5e-05,74.125.130.0-255,1484,1703,92,149739
7005,5.1e-05,172.31.47.0-255,66,1769,92,149739
7006,7.1e-05,74.125.130.0-255,2902,4671,92,149739
7007,7.4e-05,172.31.47.0-255,66,4737,92,149739
7008,8.4e-05,74.125.130.0-255,7156,11893,92,149739
7009,8.8e-05,172.31.47.0-255,66,11959,92,149739
7010,9.3e-05,74.125.130.0-255,2101,14060,92,149739
7011,9.6e-05,172.31.47.0-255,66,14126,92,149739
7012,0.000153,74.125.130.0-255,1484,15610,92,149739
7013,0.000158,172.31.47.0-255,66,15676,92,149739
7014,0.000164,74.125.130.0-255,2902,18578,92,149739
7015,0.000167,172.31.47.0-255,66,18644,92,149739
7016,0.000177,74.125.130.0-255,1484,20128,92,149739
7017,0.00018,172.31.47.0-255,66,20194,92,149739
7018,0.000187,74.125.130.0-255,2902,23096,92,149739
7019,0.000191,172.31.47.0-255,66,23162,92,149739
7020,0.000199,74.125.130.0-255,5738,28900,92,149739
7021,0.000202,172.31.47.0-255,66,28966,92,149739
7022,0.000229,74.125.130.0-255,2543,31509,92,149739
7023,0.000233,172.31.47.0-255,66,31575,92,149739
7024,0.000673,74.125.130.0-255,1484,33059,92,149739
7025,0.00068,172.31.47.0-255,66,33125,92,149739
7026,0.000687,74.125.130.0-255,2902,36027,92,149739
7027,0.00069,172.31.47.0-255,66,36093,92,149739
7028,0.000704,74.125.130.0-255,5738,41831,92,149739
7029,0.000708,172.31.47.0-255,66,41897,92,149739
7030,0.000713,74.125.130.0-255,4320,46217,92,149739
7031,0.000716,172.31.47.0-255,66,46283,92,149739
7032,0.000747,74.125.130.0-255,2543,48826,92,149739
7033,0.00075,172.31.47.0-255,66,48892,92,149739
7034,0.00076,74.125.130.0-255,7156,56048,92,149739
7035,0.000768,74.125.130.0-255,4320,60368,92,149739
7036,0.000771,74.125.130.0-255,1484,61852,92,149739
7037,0.000802,74.125.130.0-255,3961,65813,92,149739
7038,0.000812,172.31.47.0-255,66,65879,92,149739
7039,0.000856,74.125.130.0-255,364,66243,92,149739
7040,0.000919,74.125.130.0-255,378,66621,92,149739
7041,0.00107,74.125.130.0-255,1484,68105,92,149739
7042,0.001079,172.31.47.0-255,66,68171,92,149739
7043,0.001087,74.125.130.0-255,2902,71073,92,149739
7044,0.001091,172.31.47.0-255,66,71139,92,149739
7045,0.001103,74.125.130.0-255,1484,72623,92,149739
7046,0.00114,74.125.130.0-255,4320,76943,92,149739
7047,0.001147,74.125.130.0-255,2902,79845,92,149739
7048,0.001154,74.125.130.0-255,4320,84165,92,149739
7049,0.001174,74.125.130.0-255,4320,88485,92,149739
7050,0.00119,172.31.47.0-255,66,88551,92,149739
7051,0.001229,74.125.130.0-255,3602,92153,92,149739
7052,0.001267,172.31.47.0-255,66,92219,92,149739
7053,0.001301,74.125.130.0-255,1484,93703,92,149739
7054,0.001307,74.125.130.0-255,2902,96605,92,149739
7055,0.001325,74.125.130.0-255,4320,100925,92,149739
7056,0.00133,74.125.130.0-255,1484,102409,92,149739
7057,0.001349,74.125.130.0-255,4320,106729,92,149739
7058,0.00136,172.31.47.0-255,66,106795,92,149739
7059,0.001401,74.125.130.0-255,2902,109697,92,149739
7060,0.001421,172.31.47.0-255,66,109763,92,149739
7061,0.001457,74.125.130.0-255,5020,114783,92,149739
7062,0.001469,172.31.47.0-255,66,114849,92,149739
7063,0.002092,74.125.130.0-255,1484,116333,92,149739
7064,0.002119,74.125.130.0-255,2902,119235,92,149739
7065,0.002124,172.31.47.0-255,66,119301,92,149739
7066,0.00213,74.125.130.0-255,4320,123621,92,149739
7067,0.002136,172.31.47.0-255,66,123687,92,149739
7068,0.002155,74.125.130.0-255,1484,125171,92,149739
7069,0.002162,74.125.130.0-255,5738,130909,92,149739
7070,0.002168,172.31.47.0-255,66,130975,92,149739
7071,0.00219,74.125.130.0-255,7156,138131,92,149739
7072,0.002291,172.31.47.0-255,66,138197,92,149739
7073,0.004933,74.125.130.0-255,5738,143935,92,149739
7074,0.004954,172.31.47.0-255,66,144001,92,149739
7075,0.007595,74.125.130.0-255,5738,149739,92,149739
7076,0.0,74.125.24.0-255,153,153,92,315239
7077,1.7e-05,172.31.47.0-255,66,219,92,315239
7078,2.4e-05,74.125.24.0-255,1484,1703,92,315239
7079,2.9e-05,172.31.47.0-255,66,1769,92,315239
7080,3.5e-05,74.125.24.0-255,2902,4671,92,315239
7081,3.8e-05,172.31.47.0-255,66,4737,92,315239
7082,4.5e-05,74.125.24.0-255,7156,11893,92,315239
7083,4.8e-05,172.31.47.0-255,66,11959,92,315239
7084,8.8e-05,74.125.24.0-255,7156,19115,92,315239
7085,9.1e-05,172.31.47.0-255,66,19181,92,315239
7086,0.000121,172.31.47.0-255,66,19247,92,315239
7087,0.000125,74.125.24.0-255,2543,21790,92,315239
7088,0.000128,172.31.47.0-255,66,21856,92,315239
7089,0.000151,74.125.24.0-255,2902,24758,92,315239
7090,0.000153,172.31.47.0-255,66,24824,92,315239
7091,0.000156,74.125.24.0-255,1484,26308,92,315239
7092,0.000158,172.31.47.0-255,66,26374,92,315239
7093,0.000175,74.125.24.0-255,5738,32112,92,315239
7094,0.000177,172.31.47.0-255,66,32178,92,315239
7095,0.00019,74.125.24.0-255,4320,36498,92,315239
7096,0.000193,172.31.47.0-255,66,36564,92,315239
7097,0.000217,172.31.47.0-255,66,36630,92,315239
7098,0.000223,74.125.24.0-255,5738,42368,92,315239
7099,0.000225,172.31.47.0-255,66,42434,92,315239
7100,0.000245,74.125.24.0-255,5020,47454,92,315239
7101,0.000247,172.31.47.0-255,66,47520,92,315239
7102,0.000249,74.125.24.0-255,397,47917,92,315239
7103,0.000251,172.31.47.0-255,66,47983,92,315239
7104,0.000299,74.125.24.0-255,346,48329,92,315239
7105,0.000302,172.31.47.0-255,66,48395,92,315239
7106,0.000428,74.125.24.0-255,1484,49879,92,315239
7107,0.000446,74.125.24.0-255,2902,52781,92,315239
7108,0.00045,172.31.47.0-255,66,52847,92,315239
7109,0.000456,74.125.24.0-255,4320,57167,92,315239
7110,0.000459,172.31.47.0-255,66,57233,92,315239
7111,0.000483,74.125.24.0-255,1484,58717,92,315239
7112,0.000491,74.125.24.0-255,6797,65514,92,315239
7113,0.000493,172.31.47.0-255,66,65580,92,315239
7114,0.000513,74.125.24.0-255,2902,68482,92,315239
7115,0.000515,172.31.47.0-255,66,68548,92,315239
7116,0.000545,172.31.47.0-255,66,68614,92,315239
7117,0.000548,74.125.24.0-255,1994,70608,92,315239
7118,0.000551,172.31.47.0-255,66,70674,92,315239
7119,0.000649,74.125.24.0-255,1484,72158,92,315239
7120,0.000655,74.125.24.0-255,2902,75060,92,315239
7121,0.000659,172.31.47.0-255,66,75126,92,315239
7122,0.000662,74.125.24.0-255,1484,76610,92,315239
7123,0.000681,74.125.24.0-255,4320,80930,92,315239
7124,0.000684,172.31.47.0-255,66,80996,92,315239
7125,0.000689,74.125.24.0-255,4320,85316,92,315239
7126,0.000692,172.31.47.0-255,66,85382,92,315239
7127,0.000703,74.125.24.0-255,1484,86866,92,315239
7128,0.000735,74.125.24.0-255,2902,89768,92,315239
7129,0.000738,172.31.47.0-255,66,89834,92,315239
7130,0.000751,74.125.24.0-255,4320,94154,92,315239
7131,0.000754,172.31.47.0-255,66,94220,92,315239
7132,0.000771,74.125.24.0-255,5738,99958,92,315239
7133,0.000774,172.31.47.0-255,66,100024,92,315239
7134,0.000778,74.125.24.0-255,2902,102926,92,315239
7135,0.00078,172.31.47.0-255,66,102992,92,315239
7136,0.0008,74.125.24.0-255,2184,105176,92,315239
7137,0.000802,172.31.47.0-255,66,105242,92,315239
7138,0.000846,74.125.24.0-255,1484,106726,92,315239
7139,0.000863,74.125.24.0-255,2902,109628,92,315239
7140,0.000866,172.31.47.0-255,66,109694,92,315239
7141,0.000871,74.125.24.0-255,2902,112596,92,315239
7142,0.000873,172.31.47.0-255,66,112662,92,315239
7143,0.00089,74.125.24.0-255,2902,115564,92,315239
7144,0.000893,172.31.47.0-255,66,115630,92,315239
7145,0.0009,74.125.24.0-255,7156,122786,92,315239
7146,0.000902,172.31.47.0-255,66,122852,92,315239
7147,0.000931,172.31.47.0-255,66,122918,92,315239
7148,0.000956,74.125.24.0-255,5738,128656,92,315239
7149,0.000958,172.31.47.0-255,66,128722,92,315239
7150,0.000962,74.125.24.0-255,2184,130906,92,315239
7151,0.000964,172.31.47.0-255,66,130972,92,315239
7152,0.000991,74.125.24.0-255,2902,133874,92,315239
7153,0.000994,172.31.47.0-255,66,133940,92,315239
7154,0.001019,74.125.24.0-255,1484,135424,92,315239
7155,0.001023,172.31.47.0-255,66,135490,92,315239
7156,0.00104,172.31.47.0-255,66,135556,92,315239
7157,0.001054,74.125.24.0-255,4320,139876,92,315239
7158,0.001057,172.31.47.0-255,66,139942,92,315239
7159,0.001064,74.125.24.0-255,6438,146380,92,315239
7160,0.001066,172.31.47.0-255,66,146446,92,315239
7161,0.001114,74.125.24.0-255,1484,147930,92,315239
7162,0.001118,74.125.24.0-255,2902,150832,92,315239
7163,0.00112,172.31.47.0-255,66,150898,92,315239
7164,0.001126,74.125.24.0-255,5738,156636,92,315239
7165,0.001129,172.31.47.0-255,66,156702,92,315239
7166,0.001134,74.125.24.0-255,4320,161022,92,315239
7167,0.001137,172.31.47.0-255,66,161088,92,315239
7168,0.00116,172.31.47.0-255,66,161154,92,315239
7169,0.001178,74.125.24.0-255,7156,168310,92,315239
7170,0.001181,172.31.47.0-255,66,168376,92,315239
7171,0.001184,74.125.24.0-255,1484,169860,92,315239
7172,0.001202,74.125.24.0-255,2184,172044,92,315239
7173,0.001205,172.31.47.0-255,66,172110,92,315239
7174,0.00126,74.125.24.0-255,1484,173594,92,315239
7175,0.001266,74.125.24.0-255,2902,176496,92,315239
7176,0.001269,172.31.47.0-255,66,176562,92,315239
7177,0.001273,74.125.24.0-255,1484,178046,92,315239
7178,0.001298,74.125.24.0-255,4320,182366,92,315239
7179,0.001301,172.31.47.0-255,66,182432,92,315239
7180,0.001311,74.125.24.0-255,7156,189588,92,315239
7181,0.001313,172.31.47.0-255,66,189654,92,315239
7182,0.001337,74.125.24.0-255,4320,193974,92,315239
7183,0.00134,172.31.47.0-255,66,194040,92,315239
7184,0.001346,74.125.24.0-255,5738,199778,92,315239
7185,0.001349,172.31.47.0-255,66,199844,92,315239
7186,0.001378,74.125.24.0-255,6438,206282,92,315239
7187,0.001392,74.125.24.0-255,1484,207766,92,315239
7188,0.001413,74.125.24.0-255,2902,210668,92,315239
7189,0.001417,74.125.24.0-255,2902,213570,92,315239
7190,0.001432,74.125.24.0-255,2902,216472,92,315239
7191,0.001471,74.125.24.0-255,2902,219374,92,315239
7192,0.001499,74.125.24.0-255,7156,226530,92,315239
7193,0.001519,74.125.24.0-255,5020,231550,92,315239
7194,0.001531,74.125.24.0-255,1484,233034,92,315239
7195,0.001541,74.125.24.0-255,1484,234518,92,315239
7196,0.001575,74.125.24.0-255,5738,240256,92,315239
7197,0.001591,74.125.24.0-255,1484,241740,92,315239
7198,0.001611,74.125.24.0-255,7156,248896,92,315239
7199,0.001628,74.125.24.0-255,6438,255334,92,315239
7200,0.001651,74.125.24.0-255,4320,259654,92,315239
7201,0.001711,74.125.24.0-255,2902,262556,92,315239
7202,0.001731,74.125.24.0-255,6438,268994,92,315239
7203,0.001762,74.125.24.0-255,1484,270478,92,315239
7204,0.001766,74.125.24.0-255,1484,271962,92,315239
7205,0.001781,74.125.24.0-255,1484,273446,92,315239
7206,0.001789,74.125.24.0-255,5738,279184,92,315239
7207,0.001843,74.125.24.0-255,2902,282086,92,315239
7208,0.001867,74.125.24.0-255,7156,289242,92,315239
7209,0.001869,74.125.24.0-255,1484,290726,92,315239
7210,0.001887,74.125.24.0-255,2184,292910,92,315239
7211,0.001906,74.125.24.0-255,4320,297230,92,315239
7212,0.001912,74.125.24.0-255,4320,301550,92,315239
7213,0.001931,74.125.24.0-255,5738,307288,92,315239
7214,0.001936,74.125.24.0-255,4320,311608,92,315239
7215,0.001963,74.125.24.0-255,3355,314963,92,315239
7216,0.001992,74.125.24.0-255,105,315068,92,315239
7217,0.004527,172.31.47.0-255,66,315134,92,315239
7218,0.007622,172.31.47.0-255,105,315239,92,315239
7219,0.0,74.125.24.0-255,153,153,92,211488
7220,2.5e-05,172.31.47.0-255,66,219,92,211488
7221,3.2e-05,74.125.24.0-255,1484,1703,92,211488
7222,3.5e-05,172.31.47.0-255,66,1769,92,211488
7223,3.9e-05,74.125.24.0-255,2902,4671,92,211488
7224,4.1e-05,172.31.47.0-255,66,4737,92,211488
7225,4.7e-05,74.125.24.0-255,7156,11893,92,211488
7226,4.9e-05,172.31.47.0-255,66,11959,92,211488
7227,7.7e-05,172.31.47.0-255,66,12025,92,211488
7228,9.6e-05,74.125.24.0-255,6260,18285,92,211488
7229,9.8e-05,172.31.47.0-255,66,18351,92,211488
7230,0.000101,74.125.24.0-255,2543,20894,92,211488
7231,0.000103,172.31.47.0-255,66,20960,92,211488
7232,0.000162,74.125.24.0-255,1484,22444,92,211488
7233,0.000165,172.31.47.0-255,66,22510,92,211488
7234,0.00018,74.125.24.0-255,1484,23994,92,211488
7235,0.000182,172.31.47.0-255,66,24060,92,211488
7236,0.000186,74.125.24.0-255,2902,26962,92,211488
7237,0.000188,172.31.47.0-255,66,27028,92,211488
7238,0.00021,74.125.24.0-255,5738,32766,92,211488
7239,0.000212,172.31.47.0-255,66,32832,92,211488
7240,0.000227,74.125.24.0-255,2902,35734,92,211488
7241,0.000229,172.31.47.0-255,66,35800,92,211488
7242,0.000254,172.31.47.0-255,66,35866,92,211488
7243,0.000281,74.125.24.0-255,2902,38768,92,211488
7244,0.000284,172.31.47.0-255,66,38834,92,211488
7245,0.0003,74.125.24.0-255,5645,44479,92,211488
7246,0.000302,172.31.47.0-255,66,44545,92,211488
7247,0.000305,74.125.24.0-255,140,44685,92,211488
7248,0.000307,172.31.47.0-255,66,44751,92,211488
7249,0.000396,74.125.24.0-255,1484,46235,92,211488
7250,0.000412,74.125.24.0-255,2902,49137,92,211488
7251,0.000415,172.31.47.0-255,66,49203,92,211488
7252,0.00042,74.125.24.0-255,5738,54941,92,211488
7253,0.000423,172.31.47.0-255,66,55007,92,211488
7254,0.000447,74.125.24.0-255,4320,59327,92,211488
7255,0.00045,172.31.47.0-255,66,59393,92,211488
7256,0.000476,74.125.24.0-255,2543,61936,92,211488
7257,0.000478,172.31.47.0-255,66,62002,92,211488
7258,0.000493,74.125.24.0-255,2543,64545,92,211488
7259,0.000493,172.31.47.0-255,66,64611,92,211488
7260,0.000496,172.31.47.0-255,66,64677,92,211488
7261,0.000543,74.125.24.0-255,1484,66161,92,211488
7262,0.000548,74.125.24.0-255,2902,69063,92,211488
7263,0.00055,172.31.47.0-255,66,69129,92,211488
7264,0.00057,74.125.24.0-255,5738,74867,92,211488
7265,0.000573,172.31.47.0-255,66,74933,92,211488
7266,0.000578,74.125.24.0-255,4320,79253,92,211488
7267,0.00058,172.31.47.0-255,66,79319,92,211488
7268,0.000604,172.31.47.0-255,66,79385,92,211488
7269,0.00061,74.125.24.0-255,7156,86541,92,211488
7270,0.000612,172.31.47.0-255,66,86607,92,211488
7271,0.000637,74.125.24.0-255,1484,88091,92,211488
7272,0.000654,74.125.24.0-255,5020,93111,92,211488
7273,0.000657,172.31.47.0-255,66,93177,92,211488
7274,0.000662,74.125.24.0-255,7156,100333,92,211488
7275,0.000664,172.31.47.0-255,66,100399,92,211488
7276,0.000687,172.31.47.0-255,66,100465,92,211488
7277,0.0007,74.125.24.0-255,5738,106203,92,211488
7278,0.000703,172.31.47.0-255,66,106269,92,211488
7279,0.000733,172.31.47.0-255,66,106335,92,211488
7280,0.000737,74.125.24.0-255,4320,110655,92,211488
7281,0.000739,172.31.47.0-255,66,110721,92,211488
7282,0.000754,74.125.24.0-255,4320,115041,92,211488
7283,0.000757,172.31.47.0-255,66,115107,92,211488
7284,0.000763,74.125.24.0-255,7156,122263,92,211488
7285,0.000765,172.31.47.0-255,66,122329,92,211488
7286,0.000788,74.125.24.0-255,2902,125231,92,211488
7287,0.000791,74.125.24.0-255,2902,128133,92,211488
7288,0.000791,172.31.47.0-255,66,128199,92,211488
7289,0.000794,172.31.47.0-255,66,128265,92,211488
7290,0.000823,172.31.47.0-255,66,128331,92,211488
7291,0.000854,74.125.24.0-255,7156,135487,92,211488
7292,0.000857,172.31.47.0-255,66,135553,92,211488
7293,0.000881,74.125.24.0-255,2902,138455,92,211488
7294,0.000882,172.31.47.0-255,66,138521,92,211488
7295,0.000884,172.31.47.0-255,66,138587,92,211488
7296,0.0009,74.125.24.0-255,2902,141489,92,211488
7297,0.000903,172.31.47.0-255,66,141555,92,211488
7298,0.000937,172.31.47.0-255,66,141621,92,211488
7299,0.000975,74.125.24.0-255,1484,143105,92,211488
7300,0.000996,74.125.24.0-255,2902,146007,92,211488
7301,0.001,172.31.47.0-255,66,146073,92,211488
7302,0.001005,74.125.24.0-255,5738,151811,92,211488
7303,0.001007,172.31.47.0-255,66,151877,92,211488
7304,0.00101,74.125.24.0-255,1484,153361,92,211488
7305,0.001034,172.31.47.0-255,66,153427,92,211488
7306,0.001048,74.125.24.0-255,1484,154911,92,211488
7307,0.001092,172.31.47.0-255,66,154977,92,211488
7308,0.001106,74.125.24.0-255,2184,157161,92,211488
7309,0.001109,172.31.47.0-255,66,157227,92,211488
7310,0.001148,74.125.24.0-255,1484,158711,92,211488
7311,0.001153,74.125.24.0-255,2902,161613,92,211488
7312,0.001156,172.31.47.0-255,66,161679,92,211488
7313,0.001177,74.125.24.0-255,5738,167417,92,211488
7314,0.00118,172.31.47.0-255,66,167483,92,211488
7315,0.001209,172.31.47.0-255,66,167549,92,211488
7316,0.001215,74.125.24.0-255,5738,173287,92,211488
7317,0.001217,172.31.47.0-255,66,173353,92,211488
7318,0.001229,74.125.24.0-255,2902,176255,92,211488
7319,0.001231,172.31.47.0-255,66,176321,92,211488
7320,0.001246,74.125.24.0-255,1484,177805,92,211488
7321,0.001263,74.125.24.0-255,2184,179989,92,211488
7322,0.001267,172.31.47.0-255,66,180055,92,211488
7323,0.001267,74.125.24.0-255,4320,184375,92,211488
7324,0.00127,172.31.47.0-255,66,184441,92,211488
7325,0.001272,74.125.24.0-255,4320,188761,92,211488
7326,0.001274,172.31.47.0-255,66,188827,92,211488
7327,0.00129,74.125.24.0-255,5738,194565,92,211488
7328,0.001293,172.31.47.0-255,66,194631,92,211488
7329,0.001331,172.31.47.0-255,66,194697,92,211488
7330,0.001348,74.125.24.0-255,766,195463,92,211488
7331,0.001401,74.125.24.0-255,5738,201201,92,211488
7332,0.001451,74.125.24.0-255,4320,205521,92,211488
7333,0.001547,74.125.24.0-255,766,206287,92,211488
7334,0.001592,74.125.24.0-255,4859,211146,92,211488
7335,0.00163,74.125.24.0-255,105,211251,92,211488
7336,0.005681,172.31.47.0-255,66,211317,92,211488
7337,0.007526,172.31.47.0-255,105,211422,92,211488
7338,0.009765,74.125.24.0-255,66,211488,92,211488
7339,0.0,172.217.194.0-255,153,153,92,265694
7340,1.4e-05,172.31.47.0-255,66,219,92,265694
7341,2e-05,172.217.194.0-255,1484,1703,92,265694
7342,2.4e-05,172.31.47.0-255,66,1769,92,265694
7343,2.9e-05,172.217.194.0-255,2902,4671,92,265694
7344,3.7e-05,172.31.47.0-255,66,4737,92,265694
7345,4.3e-05,172.217.194.0-255,5738,10475,92,265694
7346,4.5e-05,172.31.47.0-255,66,10541,92,265694
7347,9.1e-05,172.217.194.0-255,3585,14126,92,265694
7348,9.4e-05,172.31.47.0-255,66,14192,92,265694
7349,0.000158,172.217.194.0-255,1484,15676,92,265694
7350,0.000162,172.31.47.0-255,66,15742,92,265694
7351,0.000173,172.217.194.0-255,2902,18644,92,265694
7352,0.000179,172.31.47.0-255,66,18710,92,265694
7353,0.000182,172.217.194.0-255,2902,21612,92,265694
7354,0.000184,172.31.47.0-255,66,21678,92,265694
7355,0.000204,172.217.194.0-255,2902,24580,92,265694
7356,0.000206,172.31.47.0-255,66,24646,92,265694
7357,0.000217,172.217.194.0-255,6797,31443,92,265694
7358,0.000219,172.31.47.0-255,66,31509,92,265694
7359,0.000238,172.217.194.0-255,2902,34411,92,265694
7360,0.00024,172.31.47.0-255,66,34477,92,265694
7361,0.000273,172.217.194.0-255,2902,37379,92,265694
7362,0.000275,172.31.47.0-255,66,37445,92,265694
7363,0.000282,172.217.194.0-255,7156,44601,92,265694
7364,0.000283,172.31.47.0-255,66,44667,92,265694
7365,0.000287,172.217.194.0-255,3961,48628,92,265694
7366,0.000289,172.31.47.0-255,66,48694,92,265694
7367,0.00056,172.217.194.0-255,1484,50178,92,265694
7368,0.000564,172.31.47.0-255,66,50244,92,265694
7369,0.000569,172.217.194.0-255,2902,53146,92,265694
7370,0.000571,172.31.47.0-255,66,53212,92,265694
7371,0.000574,172.217.194.0-255,1484,54696,92,265694
7372,0.000595,172.217.194.0-255,4320,59016,92,265694
7373,0.000603,172.217.194.0-255,6797,65813,92,265694
7374,0.000607,172.31.47.0-255,66,65879,92,265694
7375,0.000614,172.31.47.0-255,66,65945,92,265694
7376,0.000616,172.217.194.0-255,1484,67429,92,265694
7377,0.000647,172.31.47.0-255,66,67495,92,265694
7378,0.000662,172.31.47.0-255,66,67561,92,265694
7379,0.000681,172.217.194.0-255,5738,73299,92,265694
7380,0.000686,172.31.47.0-255,66,73365,92,265694
7381,0.000702,172.217.194.0-255,1377,74742,92,265694
7382,0.00079,172.217.194.0-255,1484,76226,92,265694
7383,0.000793,172.31.47.0-255,66,76292,92,265694
7384,0.000797,172.217.194.0-255,2902,79194,92,265694
7385,0.000799,172.31.47.0-255,66,79260,92,265694
7386,0.000834,172.217.194.0-255,5738,84998,92,265694
7387,0.000836,172.31.47.0-255,66,85064,92,265694
7388,0.000867,172.31.47.0-255,66,85130,92,265694
7389,0.000897,172.217.194.0-255,4320,89450,92,265694
7390,0.0009,172.31.47.0-255,66,89516,92,265694
7391,0.000914,172.31.47.0-255,66,89582,92,265694
7392,0.000939,172.217.194.0-255,1484,91066,92,265694
7393,0.000942,172.217.194.0-255,2902,93968,92,265694
7394,0.000944,172.31.47.0-255,66,94034,92,265694
7395,0.00095,172.217.194.0-255,5738,99772,92,265694
7396,0.000952,172.31.47.0-255,66,99838,92,265694
7397,0.000974,172.217.194.0-255,5738,105576,92,265694
7398,0.000976,172.31.47.0-255,66,105642,92,265694
7399,0.001026,172.31.47.0-255,66,105708,92,265694
7400,0.001031,172.217.194.0-255,5020,110728,92,265694
7401,0.001034,172.31.47.0-255,66,110794,92,265694
7402,0.001179,172.217.194.0-255,1484,112278,92,265694
7403,0.001194,172.217.194.0-255,2902,115180,92,265694
7404,0.001198,172.31.47.0-255,66,115246,92,265694
7405,0.001258,172.217.194.0-255,5738,120984,92,265694
7406,0.001261,172.31.47.0-255,66,121050,92,265694
7407,0.001266,172.217.194.0-255,4320,125370,92,265694
7408,0.001268,172.31.47.0-255,66,125436,92,265694
7409,0.001281,172.31.47.0-255,66,125502,92,265694
7410,0.001289,172.31.47.0-255,66,125568,92,265694
7411,0.001328,172.217.194.0-255,1484,127052,92,265694
7412,0.001347,172.217.194.0-255,2902,129954,92,265694
7413,0.00135,172.31.47.0-255,66,130020,92,265694
7414,0.001355,172.217.194.0-255,5738,135758,92,265694
7415,0.001358,172.31.47.0-255,66,135824,92,265694
7416,0.001374,172.217.194.0-255,2902,138726,92,265694
7417,0.001376,172.31.47.0-255,66,138792,92,265694
7418,0.001418,172.217.194.0-255,4320,143112,92,265694
7419,0.001422,172.31.47.0-255,66,143178,92,265694
7420,0.001431,172.31.47.0-255,66,143244,92,265694
7421,0.00144,172.31.47.0-255,66,143310,92,265694
7422,0.001474,172.217.194.0-255,1484,144794,92,265694
7423,0.001488,172.217.194.0-255,2902,147696,92,265694
7424,0.001491,172.31.47.0-255,66,147762,92,265694
7425,0.001495,172.217.194.0-255,2902,150664,92,265694
7426,0.001497,172.31.47.0-255,66,150730,92,265694
7427,0.001515,172.217.194.0-255,2902,153632,92,265694
7428,0.001518,172.31.47.0-255,66,153698,92,265694
7429,0.001525,172.217.194.0-255,2902,156600,92,265694
7430,0.001527,172.31.47.0-255,66,156666,92,265694
7431,0.001563,172.31.47.0-255,66,156732,92,265694
7432,0.001573,172.31.47.0-255,66,156798,92,265694
7433,0.001593,172.217.194.0-255,5020,161818,92,265694
7434,0.001595,172.31.47.0-255,66,161884,92,265694
7435,0.001604,172.31.47.0-255,66,161950,92,265694
7436,0.001644,172.217.194.0-255,4320,166270,92,265694
7437,0.001647,172.31.47.0-255,66,166336,92,265694
7438,0.001688,172.31.47.0-255,66,166402,92,265694
7439,0.001691,172.217.194.0-255,1484,167886,92,265694
7440,0.001712,172.217.194.0-255,2902,170788,92,265694
7441,0.001715,172.31.47.0-255,66,170854,92,265694
7442,0.00172,172.217.194.0-255,5738,176592,92,265694
7443,0.001722,172.31.47.0-255,66,176658,92,265694
7444,0.001752,172.217.194.0-255,4320,180978,92,265694
7445,0.001754,172.31.47.0-255,66,181044,92,265694
7446,0.001777,172.31.47.0-255,66,181110,92,265694
7447,0.001782,172.217.194.0-255,4320,185430,92,265694
7448,0.001783,172.31.47.0-255,66,185496,92,265694
7449,0.001813,172.217.194.0-255,6438,191934,92,265694
7450,0.001815,172.31.47.0-255,66,192000,92,265694
7451,0.00184,172.217.194.0-255,1484,193484,92,265694
7452,0.001854,172.217.194.0-255,2902,196386,92,265694
7453,0.001856,172.31.47.0-255,66,196452,92,265694
7454,0.001859,172.217.194.0-255,1484,197936,92,265694
7455,0.00188,172.217.194.0-255,4320,202256,92,265694
7456,0.001882,172.31.47.0-255,66,202322,92,265694
7457,0.001886,172.217.194.0-255,4320,206642,92,265694
7458,0.001888,172.31.47.0-255,66,206708,92,265694
7459,0.001902,172.217.194.0-255,1484,208192,92,265694
7460,0.001927,172.31.47.0-255,66,208258,92,265694
7461,0.001972,172.217.194.0-255,2902,211160,92,265694
7462,0.001974,172.31.47.0-255,66,211226,92,265694
7463,0.002,172.217.194.0-255,5020,216246,92,265694
7464,0.002002,172.31.47.0-255,66,216312,92,265694
7465,0.002005,172.217.194.0-255,1484,217796,92,265694
7466,0.002007,172.217.194.0-255,1484,219280,92,265694
7467,0.002009,172.31.47.0-255,66,219346,92,265694
7468,0.002035,172.217.194.0-255,1484,220830,92,265694
7469,0.00204,172.217.194.0-255,5738,226568,92,265694
7470,0.002042,172.31.47.0-255,66,226634,92,265694
7471,0.002047,172.217.194.0-255,4320,230954,92,265694
7472,0.002049,172.31.47.0-255,66,231020,92,265694
7473,0.002071,172.217.194.0-255,1484,232504,92,265694
7474,0.00209,172.217.194.0-255,2902,235406,92,265694
7475,0.002093,172.31.47.0-255,66,235472,92,265694
7476,0.002115,172.217.194.0-255,5738,241210,92,265694
7477,0.002118,172.31.47.0-255,66,241276,92,265694
7478,0.002127,172.31.47.0-255,66,241342,92,265694
7479,0.002152,172.217.194.0-255,1484,242826,92,265694
7480,0.002169,172.217.194.0-255,2902,245728,92,265694
7481,0.002172,172.31.47.0-255,66,245794,92,265694
7482,0.002176,172.217.194.0-255,4320,250114,92,265694
7483,0.002178,172.31.47.0-255,66,250180,92,265694
7484,0.002181,172.217.194.0-255,1484,251664,92,265694
7485,0.002203,172.217.194.0-255,2902,254566,92,265694
7486,0.002205,172.31.47.0-255,66,254632,92,265694
7487,0.002228,172.217.194.0-255,1484,256116,92,265694
7488,0.00223,172.217.194.0-255,1484,257600,92,265694
7489,0.002232,172.31.47.0-255,66,257666,92,265694
7490,0.002244,172.217.194.0-255,4320,261986,92,265694
7491,0.002247,172.31.47.0-255,66,262052,92,265694
7492,0.002259,172.217.194.0-255,3234,265286,92,265694
7493,0.002265,172.31.47.0-255,66,265352,92,265694
7494,0.002311,172.217.194.0-255,105,265457,92,265694
7495,0.007825,172.31.47.0-255,66,265523,92,265694
7496,0.007861,172.31.47.0-255,105,265628,92,265694
7497,0.00984,172.217.194.0-255,66,265694,92,265694
7498,0.0,74.125.24.0-255,153,153,92,63929
7499,3.3e-05,172.31.47.0-255,66,219,92,63929
7500,4e-05,74.125.24.0-255,1484,1703,92,63929
7501,4.5e-05,172.31.47.0-255,66,1769,92,63929
7502,5e-05,74.125.24.0-255,2902,4671,92,63929
7503,6e-05,172.31.47.0-255,66,4737,92,63929
7504,6.6e-05,74.125.24.0-255,4320,9057,92,63929
7505,6.9e-05,172.31.47.0-255,66,9123,92,63929
7506,9e-05,74.125.24.0-255,2902,12025,92,63929
7507,9.3e-05,172.31.47.0-255,66,12091,92,63929
7508,0.000117,74.125.24.0-255,2137,14228,92,63929
7509,0.00012,172.31.47.0-255,66,14294,92,63929
7510,0.000372,74.125.24.0-255,1484,15778,92,63929
7511,0.000377,172.31.47.0-255,66,15844,92,63929
7512,0.000381,74.125.24.0-255,1484,17328,92,63929
7513,0.000383,172.31.47.0-255,66,17394,92,63929
7514,0.000417,74.125.24.0-255,1484,18878,92,63929
7515,0.000428,74.125.24.0-255,5738,24616,92,63929
7516,0.000423,172.31.47.0-255,66,24682,92,63929
7517,0.000431,172.31.47.0-255,66,24748,92,63929
7518,0.000447,74.125.24.0-255,4320,29068,92,63929
7519,0.00045,172.31.47.0-255,66,29134,92,63929
7520,0.000472,74.125.24.0-255,2543,31677,92,63929
7521,0.000475,172.31.47.0-255,66,31743,92,63929
7522,0.000489,74.125.24.0-255,4320,36063,92,63929
7523,0.000497,172.31.47.0-255,66,36129,92,63929
7524,0.000521,74.125.24.0-255,2902,39031,92,63929
7525,0.000524,172.31.47.0-255,66,39097,92,63929
7526,0.000527,74.125.24.0-255,1484,40581,92,63929
7527,0.000529,172.31.47.0-255,66,40647,92,63929
7528,0.000558,172.31.47.0-255,66,40713,92,63929
7529,0.002689,74.125.24.0-255,5738,46451,92,63929
7530,0.002696,172.31.47.0-255,66,46517,92,63929
7531,0.004752,74.125.24.0-255,5738,52255,92,63929
7532,0.004756,172.31.47.0-255,66,52321,92,63929
7533,0.006803,74.125.24.0-255,5738,58059,92,63929
7534,0.00681,172.31.47.0-255,66,58125,92,63929
7535,0.008884,74.125.24.0-255,5738,63863,92,63929
7536,0.008893,172.31.47.0-255,66,63929,92,63929
7537,0.0,172.217.194.0-255,153,153,92,116902
7538,3e-05,172.31.47.0-255,66,219,92,116902
7539,3.7e-05,172.217.194.0-255,1484,1703,92,116902
7540,4.1e-05,172.31.47.0-255,66,1769,92,116902
7541,4.6e-05,172.217.194.0-255,2902,4671,92,116902
7542,4.8e-05,172.31.47.0-255,66,4737,92,116902
7543,6.3e-05,172.217.194.0-255,7156,11893,92,116902
7544,6.5e-05,172.31.47.0-255,66,11959,92,116902
7545,7.7e-05,172.31.47.0-255,66,12025,92,116902
7546,0.00012,172.31.47.0-255,66,12091,92,116902
7547,0.000157,172.217.194.0-255,7156,19247,92,116902
7548,0.00016,172.31.47.0-255,66,19313,92,116902
7549,0.000188,172.31.47.0-255,66,19379,92,116902
7550,0.000191,172.217.194.0-255,1125,20504,92,116902
7551,0.000193,172.31.47.0-255,66,20570,92,116902
7552,0.000268,172.217.194.0-255,1484,22054,92,116902
7553,0.000272,172.31.47.0-255,66,22120,92,116902
7554,0.000275,172.217.194.0-255,1484,23604,92,116902
7555,0.000277,172.31.47.0-255,66,23670,92,116902
7556,0.000315,172.217.194.0-255,1484,25154,92,116902
7557,0.000318,172.31.47.0-255,66,25220,92,116902
7558,0.000325,172.217.194.0-255,5738,30958,92,116902
7559,0.000328,172.31.47.0-255,66,31024,92,116902
7560,0.000346,172.217.194.0-255,2902,33926,92,116902
7561,0.000349,172.31.47.0-255,66,33992,92,116902
7562,0.000361,172.217.194.0-255,3961,37953,92,116902
7563,0.000368,172.31.47.0-255,66,38019,92,116902
7564,0.000654,172.217.194.0-255,645,38664,92,116902
7565,0.000659,172.31.47.0-255,66,38730,92,116902
7566,0.001134,172.217.194.0-255,1484,40214,92,116902
7567,0.001139,172.31.47.0-255,66,40280,92,116902
7568,0.001148,172.217.194.0-255,2902,43182,92,116902
7569,0.001151,172.31.47.0-255,66,43248,92,116902
7570,0.001165,172.217.194.0-255,5738,48986,92,116902
7571,0.001167,172.31.47.0-255,66,49052,92,116902
7572,0.001215,172.31.47.0-255,66,49118,92,116902
7573,0.001228,172.31.47.0-255,66,49184,92,116902
7574,0.001827,172.217.194.0-255,1484,50668,92,116902
7575,0.001834,172.31.47.0-255,66,50734,92,116902
7576,0.00184,172.217.194.0-255,2902,53636,92,116902
7577,0.001842,172.31.47.0-255,66,53702,92,116902
7578,0.001848,172.217.194.0-255,5738,59440,92,116902
7579,0.00185,172.31.47.0-255,66,59506,92,116902
7580,0.001854,172.217.194.0-255,2902,62408,92,116902
7581,0.001855,172.31.47.0-255,66,62474,92,116902
7582,0.001885,172.217.194.0-255,2902,65376,92,116902
7583,0.001887,172.31.47.0-255,66,65442,92,116902
7584,0.001904,172.31.47.0-255,66,65508,92,116902
7585,0.00191,172.217.194.0-255,4320,69828,92,116902
7586,0.001912,172.31.47.0-255,66,69894,92,116902
7587,0.001932,172.217.194.0-255,766,70660,92,116902
7588,0.001935,172.31.47.0-255,66,70726,92,116902
7589,0.002215,172.217.194.0-255,1484,72210,92,116902
7590,0.002217,172.31.47.0-255,66,72276,92,116902
7591,0.002243,172.217.194.0-255,2902,75178,92,116902
7592,0.002245,172.31.47.0-255,66,75244,92,116902
7593,0.002251,172.217.194.0-255,5738,80982,92,116902
7594,0.002253,172.31.47.0-255,66,81048,92,116902
7595,0.002291,172.217.194.0-255,5738,86786,92,116902
7596,0.002293,172.31.47.0-255,66,86852,92,116902
7597,0.002318,172.217.194.0-255,7156,94008,92,116902
7598,0.00232,172.31.47.0-255,66,94074,92,116902
7599,0.002331,172.31.47.0-255,66,94140,92,116902
7600,0.002336,172.217.194.0-255,5020,99160,92,116902
7601,0.002338,172.31.47.0-255,66,99226,92,116902
7602,0.004538,172.217.194.0-255,4320,103546,92,116902
7603,0.004541,172.31.47.0-255,66,103612,92,116902
7604,0.00456,172.217.194.0-255,1484,105096,92,116902
7605,0.004561,172.31.47.0-255,66,105162,92,116902
7606,0.00675,172.217.194.0-255,4320,109482,92,116902
7607,0.006755,172.31.47.0-255,66,109548,92,116902
7608,0.006781,172.217.194.0-255,1484,111032,92,116902
7609,0.006783,172.31.47.0-255,66,111098,92,116902
7610,0.009101,172.217.194.0-255,5738,116836,92,116902
7611,0.009114,172.31.47.0-255,66,116902,92,116902
7612,0.0,74.125.24.0-255,153,153,92,91586
7613,3e-05,172.31.47.0-255,66,219,92,91586
7614,3.6e-05,74.125.24.0-255,1484,1703,92,91586
7615,4e-05,172.31.47.0-255,66,1769,92,91586
7616,4.5e-05,74.125.24.0-255,2902,4671,92,91586
7617,4.7e-05,172.31.47.0-255,66,4737,92,91586
7618,6e-05,74.125.24.0-255,7156,11893,92,91586
7619,6.2e-05,172.31.47.0-255,66,11959,92,91586
7620,6.5e-05,74.125.24.0-255,2256,14215,92,91586
7621,6.7e-05,172.31.47.0-255,66,14281,92,91586
7622,0.000105,172.31.47.0-255,66,14347,92,91586
7623,0.00011,74.125.24.0-255,5379,19726,92,91586
7624,0.000112,172.31.47.0-255,66,19792,92,91586
7625,0.000649,74.125.24.0-255,1484,21276,92,91586
7626,0.000655,172.31.47.0-255,66,21342,92,91586
7627,0.000686,74.125.24.0-255,2902,24244,92,91586
7628,0.000691,172.31.47.0-255,66,24310,92,91586
7629,0.000698,74.125.24.0-255,5738,30048,92,91586
7630,0.0007,172.31.47.0-255,66,30114,92,91586
7631,0.000703,74.125.24.0-255,1484,31598,92,91586
7632,0.000711,172.31.47.0-255,66,31664,92,91586
7633,0.000754,172.31.47.0-255,66,31730,92,91586
7634,0.000759,74.125.24.0-255,2902,34632,92,91586
7635,0.000761,172.31.47.0-255,66,34698,92,91586
7636,0.000797,172.31.47.0-255,66,34764,92,91586
7637,0.000986,74.125.24.0-255,646,35410,92,91586
7638,0.000992,172.31.47.0-255,66,35476,92,91586
7639,0.001017,74.125.24.0-255,1484,36960,92,91586
7640,0.00102,172.31.47.0-255,66,37026,92,91586
7641,0.001027,74.125.24.0-255,4320,41346,92,91586
7642,0.001031,172.31.47.0-255,66,41412,92,91586
7643,0.001077,172.31.47.0-255,66,41478,92,91586
7644,0.001112,74.125.24.0-255,5738,47216,92,91586
7645,0.001118,172.31.47.0-255,66,47282,92,91586
7646,0.001154,172.31.47.0-255,66,47348,92,91586
7647,0.001156,74.125.24.0-255,766,48114,92,91586
7648,0.002072,74.125.24.0-255,1484,49598,92,91586
7649,0.002074,172.31.47.0-255,66,49664,92,91586
7650,0.002079,74.125.24.0-255,2902,52566,92,91586
7651,0.002081,172.31.47.0-255,66,52632,92,91586
7652,0.002115,74.125.24.0-255,5738,58370,92,91586
7653,0.002118,172.31.47.0-255,66,58436,92,91586
7654,0.002131,172.31.47.0-255,66,58502,92,91586
7655,0.002164,74.125.24.0-255,2902,61404,92,91586
7656,0.002167,172.31.47.0-255,66,61470,92,91586
7657,0.002188,74.125.24.0-255,5738,67208,92,91586
7658,0.00219,172.31.47.0-255,66,67274,92,91586
7659,0.002205,172.31.47.0-255,66,67340,92,91586
7660,0.002229,74.125.24.0-255,6438,73778,92,91586
7661,0.002232,172.31.47.0-255,66,73844,92,91586
7662,0.002235,74.125.24.0-255,1484,75328,92,91586
7663,0.002265,172.31.47.0-255,66,75394,92,91586
7664,0.004564,74.125.24.0-255,2902,78296,92,91586
7665,0.004567,172.31.47.0-255,66,78362,92,91586
7666,0.004583,74.125.24.0-255,2902,81264,92,91586
7667,0.004585,172.31.47.0-255,66,81330,92,91586
7668,0.006872,74.125.24.0-255,4320,85650,92,91586
7669,0.006879,172.31.47.0-255,66,85716,92,91586
7670,0.006913,74.125.24.0-255,1484,87200,92,91586
7671,0.009146,74.125.24.0-255,4320,91520,92,91586
7672,0.009152,172.31.47.0-255,66,91586,92,91586
7673,0.0,74.125.68.0-255,153,153,92,134745
7674,3.5e-05,172.31.47.0-255,66,219,92,134745
7675,4.2e-05,74.125.68.0-255,1484,1703,92,134745
7676,4.6e-05,172.31.47.0-255,66,1769,92,134745
7677,5.8e-05,74.125.68.0-255,2902,4671,92,134745
7678,6.1e-05,172.31.47.0-255,66,4737,92,134745
7679,6.7e-05,74.125.68.0-255,4320,9057,92,134745
7680,6.9e-05,172.31.47.0-255,66,9123,92,134745
7681,9.1e-05,74.125.68.0-255,2902,12025,92,134745
7682,9.4e-05,172.31.47.0-255,66,12091,92,134745
7683,0.000116,74.125.68.0-255,2217,14308,92,134745
7684,0.000119,172.31.47.0-255,66,14374,92,134745
7685,0.000121,74.125.68.0-255,1484,15858,92,134745
7686,0.000123,172.31.47.0-255,66,15924,92,134745
7687,0.00015,74.125.68.0-255,2902,18826,92,134745
7688,0.000154,172.31.47.0-255,66,18892,92,134745
7689,0.000158,74.125.68.0-255,1484,20376,92,134745
7690,0.00016,172.31.47.0-255,66,20442,92,134745
7691,0.00019,74.125.68.0-255,2902,23344,92,134745
7692,0.000193,172.31.47.0-255,66,23410,92,134745
7693,0.0002,74.125.68.0-255,5738,29148,92,134745
7694,0.000201,172.31.47.0-255,66,29214,92,134745
7695,0.000206,74.125.68.0-255,2543,31757,92,134745
7696,0.000208,172.31.47.0-255,66,31823,92,134745
7697,0.000495,74.125.68.0-255,1484,33307,92,134745
7698,0.000505,172.31.47.0-255,66,33373,92,134745
7699,0.00051,74.125.68.0-255,2902,36275,92,134745
7700,0.000512,172.31.47.0-255,66,36341,92,134745
7701,0.000516,74.125.68.0-255,1484,37825,92,134745
7702,0.000524,172.31.47.0-255,66,37891,92,134745
7703,0.000547,74.125.68.0-255,2902,40793,92,134745
7704,0.00055,172.31.47.0-255,66,40859,92,134745
7705,0.000586,74.125.68.0-255,2902,43761,92,134745
7706,0.000587,172.31.47.0-255,66,43827,92,134745
7707,0.000591,172.31.47.0-255,66,43893,92,134745
7708,0.000636,74.125.68.0-255,2902,46795,92,134745
7709,0.00064,172.31.47.0-255,66,46861,92,134745
7710,0.000682,172.31.47.0-255,66,46927,92,134745
7711,0.000704,74.125.68.0-255,134,47061,92,134745
7712,0.000816,172.31.47.0-255,66,47127,92,134745
7713,0.000817,74.125.68.0-255,1484,48611,92,134745
7714,0.000833,74.125.68.0-255,1484,50095,92,134745
7715,0.000836,172.31.47.0-255,66,50161,92,134745
7716,0.000861,74.125.68.0-255,2902,53063,92,134745
7717,0.000864,172.31.47.0-255,66,53129,92,134745
7718,0.00087,74.125.68.0-255,2902,56031,92,134745
7719,0.000873,172.31.47.0-255,66,56097,92,134745
7720,0.000903,74.125.68.0-255,4320,60417,92,134745
7721,0.000906,172.31.47.0-255,66,60483,92,134745
7722,0.000911,74.125.68.0-255,2902,63385,92,134745
7723,0.000913,172.31.47.0-255,66,63451,92,134745
7724,0.000936,74.125.68.0-255,5738,69189,92,134745
7725,0.000945,172.31.47.0-255,66,69255,92,134745
7726,0.000949,74.125.68.0-255,2902,72157,92,134745
7727,0.000951,172.31.47.0-255,66,72223,92,134745
7728,0.000955,74.125.68.0-255,2902,75125,92,134745
7729,0.00096,172.31.47.0-255,66,75191,92,134745
7730,0.000979,74.125.68.0-255,1484,76675,92,134745
7731,0.001006,74.125.68.0-255,4320,80995,92,134745
7732,0.001009,172.31.47.0-255,66,81061,92,134745
7733,0.001034,74.125.68.0-255,766,81827,92,134745
7734,0.001139,172.31.47.0-255,66,81893,92,134745
7735,0.002124,74.125.68.0-255,344,82237,92,134745
7736,0.002149,74.125.68.0-255,1484,83721,92,134745
7737,0.002154,172.31.47.0-255,66,83787,92,134745
7738,0.002177,74.125.68.0-255,4320,88107,92,134745
7739,0.00218,172.31.47.0-255,66,88173,92,134745
7740,0.002205,74.125.68.0-255,1484,89657,92,134745
7741,0.002209,74.125.68.0-255,2902,92559,92,134745
7742,0.002211,172.31.47.0-255,66,92625,92,134745
7743,0.002243,74.125.68.0-255,1484,94109,92,134745
7744,0.002255,74.125.68.0-255,2902,97011,92,134745
7745,0.002257,172.31.47.0-255,66,97077,92,134745
7746,0.002279,74.125.68.0-255,1484,98561,92,134745
7747,0.002286,74.125.68.0-255,7156,105717,92,134745
7748,0.002289,172.31.47.0-255,66,105783,92,134745
7749,0.002294,74.125.68.0-255,4320,110103,92,134745
7750,0.002295,172.31.47.0-255,66,110169,92,134745
7751,0.002321,74.125.68.0-255,4320,114489,92,134745
7752,0.002323,172.31.47.0-255,66,114555,92,134745
7753,0.002349,74.125.68.0-255,2184,116739,92,134745
7754,0.002352,172.31.47.0-255,66,116805,92,134745
7755,0.004642,74.125.68.0-255,2902,119707,92,134745
7756,0.004645,172.31.47.0-255,66,119773,92,134745
7757,0.004672,74.125.68.0-255,1484,121257,92,134745
7758,0.004687,74.125.68.0-255,1484,122741,92,134745
7759,0.004689,172.31.47.0-255,66,122807,92,134745
7760,0.006965,74.125.68.0-255,2902,125709,92,134745
7761,0.006971,172.31.47.0-255,66,125775,92,134745
7762,0.007002,74.125.68.0-255,2902,128677,92,134745
7763,0.007006,172.31.47.0-255,66,128743,92,134745
7764,0.009293,74.125.68.0-255,2902,131645,92,134745
7765,0.009299,172.31.47.0-255,66,131711,92,134745
7766,0.009323,74.125.68.0-255,1484,133195,92,134745
7767,0.009334,74.125.68.0-255,1484,134679,92,134745
7768,0.009336,172.31.47.0-255,66,134745,92,134745
7769,0.0,74.125.68.0-255,153,153,92,207719
7770,1.3e-05,172.31.47.0-255,66,219,92,207719
7771,1.9e-05,74.125.68.0-255,1484,1703,92,207719
7772,2.3e-05,172.31.47.0-255,66,1769,92,207719
7773,4.3e-05,74.125.68.0-255,2902,4671,92,207719
7774,4.9e-05,172.31.47.0-255,66,4737,92,207719
7775,7e-05,74.125.68.0-255,7156,11893,92,207719
7776,7.2e-05,172.31.47.0-255,66,11959,92,207719
7777,7.6e-05,74.125.68.0-255,2170,14129,92,207719
7778,7.9e-05,172.31.47.0-255,66,14195,92,207719
7779,0.000245,74.125.68.0-255,1484,15679,92,207719
7780,0.000249,172.31.47.0-255,66,15745,92,207719
7781,0.000254,74.125.68.0-255,1484,17229,92,207719
7782,0.000256,172.31.47.0-255,66,17295,92,207719
7783,0.000271,74.125.68.0-255,1484,18779,92,207719
7784,0.000273,172.31.47.0-255,66,18845,92,207719
7785,0.000278,74.125.68.0-255,4320,23165,92,207719
7786,0.00028,172.31.47.0-255,66,23231,92,207719
7787,0.000323,74.125.68.0-255,5738,28969,92,207719
7788,0.000326,172.31.47.0-255,66,29035,92,207719
7789,0.000351,74.125.68.0-255,2543,31578,92,207719
7790,0.000353,172.31.47.0-255,66,31644,92,207719
7791,0.000363,172.31.47.0-255,66,31710,92,207719
7792,0.00037,74.125.68.0-255,1484,33194,92,207719
7793,0.000371,172.31.47.0-255,66,33260,92,207719
7794,0.000398,74.125.68.0-255,6797,40057,92,207719
7795,0.000403,172.31.47.0-255,66,40123,92,207719
7796,0.001072,74.125.68.0-255,1484,41607,92,207719
7797,0.001079,172.31.47.0-255,66,41673,92,207719
7798,0.001088,74.125.68.0-255,2902,44575,92,207719
7799,0.00109,172.31.47.0-255,66,44641,92,207719
7800,0.001103,74.125.68.0-255,5738,50379,92,207719
7801,0.001105,172.31.47.0-255,66,50445,92,207719
7802,0.001138,74.125.68.0-255,6797,57242,92,207719
7803,0.00114,172.31.47.0-255,66,57308,92,207719
7804,0.001144,74.125.68.0-255,1484,58792,92,207719
7805,0.001172,74.125.68.0-255,5738,64530,92,207719
7806,0.001174,172.31.47.0-255,66,64596,92,207719
7807,0.001185,172.31.47.0-255,66,64662,92,207719
7808,0.001233,74.125.68.0-255,4320,68982,92,207719
7809,0.001236,172.31.47.0-255,66,69048,92,207719
7810,0.001262,74.125.68.0-255,1704,70752,92,207719
7811,0.001264,172.31.47.0-255,66,70818,92,207719
7812,0.001273,74.125.68.0-255,7156,77974,92,207719
7813,0.001279,172.31.47.0-255,66,78040,92,207719
7814,0.001305,74.125.68.0-255,5379,83419,92,207719
7815,0.001308,172.31.47.0-255,66,83485,92,207719
7816,0.001378,74.125.68.0-255,1484,84969,92,207719
7817,0.001395,74.125.68.0-255,2902,87871,92,207719
7818,0.001399,172.31.47.0-255,66,87937,92,207719
7819,0.001448,74.125.68.0-255,5738,93675,92,207719
7820,0.001451,172.31.47.0-255,66,93741,92,207719
7821,0.001457,74.125.68.0-255,5738,99479,92,207719
7822,0.001459,172.31.47.0-255,66,99545,92,207719
7823,0.001471,74.125.68.0-255,7156,106701,92,207719
7824,0.001474,172.31.47.0-255,66,106767,92,207719
7825,0.001477,74.125.68.0-255,1484,108251,92,207719
7826,0.001522,172.31.47.0-255,66,108317,92,207719
7827,0.001547,74.125.68.0-255,1484,109801,92,207719
7828,0.001552,74.125.68.0-255,2902,112703,92,207719
7829,0.001555,172.31.47.0-255,66,112769,92,207719
7830,0.001561,74.125.68.0-255,5738,118507,92,207719
7831,0.001563,172.31.47.0-255,66,118573,92,207719
7832,0.00159,74.125.68.0-255,7156,125729,92,207719
7833,0.001593,172.31.47.0-255,66,125795,92,207719
7834,0.001598,74.125.68.0-255,2902,128697,92,207719
7835,0.0016,172.31.47.0-255,66,128763,92,207719
7836,0.001635,74.125.68.0-255,5738,134501,92,207719
7837,0.001638,172.31.47.0-255,66,134567,92,207719
7838,0.001649,172.31.47.0-255,66,134633,92,207719
7839,0.001689,74.125.68.0-255,1484,136117,92,207719
7840,0.001711,74.125.68.0-255,2902,139019,92,207719
7841,0.001714,172.31.47.0-255,66,139085,92,207719
7842,0.001722,74.125.68.0-255,5738,144823,92,207719
7843,0.001725,172.31.47.0-255,66,144889,92,207719
7844,0.001735,74.125.68.0-255,4320,149209,92,207719
7845,0.001737,172.31.47.0-255,66,149275,92,207719
7846,0.001743,74.125.68.0-255,4320,153595,92,207719
7847,0.001748,172.31.47.0-255,66,153661,92,207719
7848,0.001755,74.125.68.0-255,1484,155145,92,207719
7849,0.001782,74.125.68.0-255,2902,158047,92,207719
7850,0.001785,172.31.47.0-255,66,158113,92,207719
7851,0.001812,172.31.47.0-255,66,158179,92,207719
7852,0.001815,74.125.68.0-255,1484,159663,92,207719
7853,0.001838,74.125.68.0-255,766,160429,92,207719
7854,0.001841,172.31.47.0-255,66,160495,92,207719
7855,0.001889,74.125.68.0-255,1484,161979,92,207719
7856,0.001904,74.125.68.0-255,2902,164881,92,207719
7857,0.001908,172.31.47.0-255,66,164947,92,207719
7858,0.001918,74.125.68.0-255,1484,166431,92,207719
7859,0.001936,74.125.68.0-255,4320,170751,92,207719
7860,0.001939,172.31.47.0-255,66,170817,92,207719
7861,0.001951,74.125.68.0-255,2902,173719,92,207719
7862,0.001958,172.31.47.0-255,66,173785,92,207719
7863,0.001977,74.125.68.0-255,5738,179523,92,207719
7864,0.00198,172.31.47.0-255,66,179589,92,207719
7865,0.001985,74.125.68.0-255,4320,183909,92,207719
7866,0.001987,172.31.47.0-255,66,183975,92,207719
7867,0.00392,74.125.68.0-255,2902,186877,92,207719
7868,0.003926,172.31.47.0-255,66,186943,92,207719
7869,0.003943,74.125.68.0-255,2902,189845,92,207719
7870,0.003958,172.31.47.0-255,66,189911,92,207719
7871,0.005891,74.125.68.0-255,2902,192813,92,207719
7872,0.005897,172.31.47.0-255,66,192879,92,207719
7873,0.005927,74.125.68.0-255,2902,195781,92,207719
7874,0.00593,172.31.47.0-255,66,195847,92,207719
7875,0.007847,74.125.68.0-255,2902,198749,92,207719
7876,0.007853,172.31.47.0-255,66,198815,92,207719
7877,0.007899,74.125.68.0-255,2902,201717,92,207719
7878,0.007902,172.31.47.0-255,66,201783,92,207719
7879,0.009804,74.125.68.0-255,2902,204685,92,207719
7880,0.009812,172.31.47.0-255,66,204751,92,207719
7881,0.009841,74.125.68.0-255,2902,207653,92,207719
7882,0.009843,172.31.47.0-255,66,207719,92,207719
7883,0.0,172.217.194.0-255,153,153,92,94179
7884,2.4e-05,172.31.47.0-255,66,219,92,94179
7885,3.1e-05,172.217.194.0-255,1484,1703,92,94179
7886,3.4e-05,172.31.47.0-255,66,1769,92,94179
7887,3.9e-05,172.217.194.0-255,2902,4671,92,94179
7888,4.1e-05,172.31.47.0-255,66,4737,92,94179
7889,4.5e-05,172.217.194.0-255,4320,9057,92,94179
7890,4.7e-05,172.31.47.0-255,66,9123,92,94179
7891,7.2e-05,172.217.194.0-255,2902,12025,92,94179
7892,7.4e-05,172.31.47.0-255,66,12091,92,94179
7893,7.8e-05,172.217.194.0-255,2208,14299,92,94179
7894,7.9e-05,172.31.47.0-255,66,14365,92,94179
7895,0.000107,172.217.194.0-255,2902,17267,92,94179
7896,0.000109,172.31.47.0-255,66,17333,92,94179
7897,0.000135,172.31.47.0-255,66,17399,92,94179
7898,0.000138,172.217.194.0-255,1484,18883,92,94179
7899,0.000139,172.31.47.0-255,66,18949,92,94179
7900,0.000178,172.217.194.0-255,3961,22910,92,94179
7901,0.000181,172.31.47.0-255,66,22976,92,94179
7902,0.000217,172.217.194.0-255,4320,27296,92,94179
7903,0.00022,172.31.47.0-255,66,27362,92,94179
7904,0.000223,172.217.194.0-255,2902,30264,92,94179
7905,0.000225,172.31.47.0-255,66,30330,92,94179
7906,0.000242,172.217.194.0-255,7156,37486,92,94179
7907,0.000244,172.31.47.0-255,66,37552,92,94179
7908,0.000247,172.217.194.0-255,1484,39036,92,94179
7909,0.000248,172.31.47.0-255,66,39102,92,94179
7910,0.000295,172.217.194.0-255,4320,43422,92,94179
7911,0.000298,172.31.47.0-255,66,43488,92,94179
7912,0.000329,172.31.47.0-255,66,43554,92,94179
7913,0.000357,172.217.194.0-255,119,43673,92,94179
7914,0.000425,172.217.194.0-255,380,44053,92,94179
7915,0.000644,172.31.47.0-255,66,44119,92,94179
7916,0.000654,172.217.194.0-255,1484,45603,92,94179
7917,0.000658,172.217.194.0-255,2902,48505,92,94179
7918,0.00066,172.31.47.0-255,66,48571,92,94179
7919,0.000686,172.217.194.0-255,1484,50055,92,94179
7920,0.0007,172.217.194.0-255,4320,54375,92,94179
7921,0.000702,172.31.47.0-255,66,54441,92,94179
7922,0.000713,172.31.47.0-255,66,54507,92,94179
7923,0.000736,172.217.194.0-255,4320,58827,92,94179
7924,0.000739,172.31.47.0-255,66,58893,92,94179
7925,0.000764,172.31.47.0-255,66,58959,92,94179
7926,0.001832,172.217.194.0-255,1484,60443,92,94179
7927,0.001841,172.217.194.0-255,2902,63345,92,94179
7928,0.001845,172.31.47.0-255,66,63411,92,94179
7929,0.001851,172.217.194.0-255,4320,67731,92,94179
7930,0.001853,172.31.47.0-255,66,67797,92,94179
7931,0.001864,172.217.194.0-255,1484,69281,92,94179
7932,0.001868,172.217.194.0-255,4320,73601,92,94179
7933,0.00187,172.31.47.0-255,66,73667,92,94179
7934,0.001894,172.31.47.0-255,66,73733,92,94179
7935,0.001931,172.217.194.0-255,2902,76635,92,94179
7936,0.001934,172.31.47.0-255,66,76701,92,94179
7937,0.001959,172.31.47.0-255,66,76767,92,94179
7938,0.004262,172.217.194.0-255,5738,82505,92,94179
7939,0.004266,172.31.47.0-255,66,82571,92,94179
7940,0.006555,172.217.194.0-255,5738,88309,92,94179
7941,0.00656,172.31.47.0-255,66,88375,92,94179
7942,0.008866,172.217.194.0-255,5738,94113,92,94179
7943,0.008872,172.31.47.0-255,66,94179,92,94179
7944,0.0,74.125.68.0-255,298,298,92,234914
7945,2e-05,172.31.47.0-255,66,364,92,234914
7946,2.7e-05,74.125.68.0-255,1484,1848,92,234914
7947,3.2e-05,172.31.47.0-255,66,1914,92,234914
7948,4.7e-05,74.125.68.0-255,4320,6234,92,234914
7949,5.1e-05,172.31.47.0-255,66,6300,92,234914
7950,6.3e-05,172.31.47.0-255,66,6366,92,234914
7951,0.000184,74.125.68.0-255,1484,7850,92,234914
7952,0.000189,172.31.47.0-255,66,7916,92,234914
7953,0.000195,74.125.68.0-255,2902,10818,92,234914
7954,0.000197,172.31.47.0-255,66,10884,92,234914
7955,0.000201,74.125.68.0-255,1484,12368,92,234914
7956,0.000208,172.31.47.0-255,66,12434,92,234914
7957,0.000241,74.125.68.0-255,4320,16754,92,234914
7958,0.000244,172.31.47.0-255,66,16820,92,234914
7959,0.000249,74.125.68.0-255,2902,19722,92,234914
7960,0.000251,172.31.47.0-255,66,19788,92,234914
7961,0.000283,74.125.68.0-255,3961,23749,92,234914
7962,0.000286,172.31.47.0-255,66,23815,92,234914
7963,0.000522,74.125.68.0-255,1484,25299,92,234914
7964,0.000528,172.31.47.0-255,66,25365,92,234914
7965,0.000558,74.125.68.0-255,1484,26849,92,234914
7966,0.000562,172.31.47.0-255,66,26915,92,234914
7967,0.000567,74.125.68.0-255,2902,29817,92,234914
7968,0.00057,172.31.47.0-255,66,29883,92,234914
7969,0.00058,74.125.68.0-255,5738,35621,92,234914
7970,0.000583,172.31.47.0-255,66,35687,92,234914
7971,0.000585,74.125.68.0-255,1484,37171,92,234914
7972,0.000587,172.31.47.0-255,66,37237,92,234914
7973,0.000621,74.125.68.0-255,3961,41198,92,234914
7974,0.000625,172.31.47.0-255,66,41264,92,234914
7975,0.000631,74.125.68.0-255,5738,47002,92,234914
7976,0.000669,74.125.68.0-255,1125,48127,92,234914
7977,0.000682,74.125.68.0-255,410,48537,92,234914
7978,0.000685,172.31.47.0-255,66,48603,92,234914
7979,0.001296,74.125.68.0-255,1484,50087,92,234914
7980,0.001304,74.125.68.0-255,2902,52989,92,234914
7981,0.001317,74.125.68.0-255,1484,54473,92,234914
7982,0.001333,74.125.68.0-255,4320,58793,92,234914
7983,0.001367,74.125.68.0-255,2902,61695,92,234914
7984,0.00138,74.125.68.0-255,2902,64597,92,234914
7985,0.001383,74.125.68.0-255,1484,66081,92,234914
7986,0.001405,74.125.68.0-255,5738,71819,92,234914
7987,0.001412,74.125.68.0-255,7156,78975,92,234914
7988,0.001431,74.125.68.0-255,3602,82577,92,234914
7989,0.001454,74.125.68.0-255,333,82910,92,234914
7990,0.001499,74.125.68.0-255,1484,84394,92,234914
7991,0.001504,74.125.68.0-255,2902,87296,92,234914
7992,0.001543,74.125.68.0-255,1484,88780,92,234914
7993,0.001559,74.125.68.0-255,4320,93100,92,234914
7994,0.001575,74.125.68.0-255,2902,96002,92,234914
7995,0.001589,74.125.68.0-255,5738,101740,92,234914
7996,0.001599,74.125.68.0-255,1484,103224,92,234914
7997,0.001604,74.125.68.0-255,4320,107544,92,234914
7998,0.001628,74.125.68.0-255,7156,114700,92,234914
7999,0.001632,74.125.68.0-255,2184,116884,92,234914
8000,0.001774,74.125.68.0-255,1484,118368,92,234914
8001,0.001799,74.125.68.0-255,2902,121270,92,234914
8002,0.001802,74.125.68.0-255,1484,122754,92,234914
8003,0.001818,74.125.68.0-255,4320,127074,92,234914
8004,0.001835,74.125.68.0-255,2902,129976,92,234914
8005,0.001856,74.125.68.0-255,1484,131460,92,234914
8006,0.001862,74.125.68.0-255,5738,137198,92,234914
8007,0.001877,74.125.68.0-255,2184,139382,92,234914
8008,0.001972,74.125.68.0-255,1484,140866,92,234914
8009,0.001996,74.125.68.0-255,2902,143768,92,234914
8010,0.002021,74.125.68.0-255,5738,149506,92,234914
8011,0.002028,74.125.68.0-255,5738,155244,92,234914
8012,0.002043,74.125.68.0-255,1484,156728,92,234914
8013,0.002057,74.125.68.0-255,1484,158212,92,234914
8014,0.002068,74.125.68.0-255,4320,162532,92,234914
8015,0.002117,74.125.68.0-255,2184,164716,92,234914
8016,0.002239,74.125.68.0-255,1484,166200,92,234914
8017,0.002264,74.125.68.0-255,2902,169102,92,234914
8018,0.002267,74.125.68.0-255,1484,170586,92,234914
8019,0.002271,74.125.68.0-255,2902,173488,92,234914
8020,0.002294,74.125.68.0-255,1484,174972,92,234914
8021,0.002309,74.125.68.0-255,4320,179292,92,234914
8022,0.002347,74.125.68.0-255,1484,180776,92,234914
8023,0.002373,74.125.68.0-255,6438,187214,92,234914
8024,0.002426,74.125.68.0-255,1484,188698,92,234914
8025,0.00245,74.125.68.0-255,2902,191600,92,234914
8026,0.002475,74.125.68.0-255,1484,193084,92,234914
8027,0.0025,74.125.68.0-255,4320,197404,92,234914
8028,0.002505,74.125.68.0-255,4320,201724,92,234914
8029,0.002516,74.125.68.0-255,5738,207462,92,234914
8030,0.00253,74.125.68.0-255,2184,209646,92,234914
8031,0.0026,74.125.68.0-255,2902,212548,92,234914
8032,0.002607,74.125.68.0-255,7156,219704,92,234914
8033,0.002636,74.125.68.0-255,2902,222606,92,234914
8034,0.002653,74.125.68.0-255,7156,229762,92,234914
8035,0.002679,74.125.68.0-255,3602,233364,92,234914
8036,0.002682,74.125.68.0-255,1484,234848,92,234914
8037,0.009475,172.31.47.0-255,66,234914,92,234914
8038,0.0,172.217.194.0-255,153,153,92,196739
8039,2.6e-05,172.31.47.0-255,66,219,92,196739
8040,3.2e-05,172.217.194.0-255,1484,1703,92,196739
8041,3.5e-05,172.31.47.0-255,66,1769,92,196739
8042,3.9e-05,172.217.194.0-255,2902,4671,92,196739
8043,4.1e-05,172.31.47.0-255,66,4737,92,196739
8044,7.4e-05,172.217.194.0-255,7156,11893,92,196739
8045,7.7e-05,172.31.47.0-255,66,11959,92,196739
8046,9e-05,172.31.47.0-255,66,12025,92,196739
8047,0.000119,172.217.194.0-255,3544,15569,92,196739
8048,0.000122,172.31.47.0-255,66,15635,92,196739
8049,0.000126,172.217.194.0-255,2543,18178,92,196739
8050,0.000128,172.31.47.0-255,66,18244,92,196739
8051,0.000152,172.217.194.0-255,1484,19728,92,196739
8052,0.000154,172.31.47.0-255,66,19794,92,196739
8053,0.000158,172.217.194.0-255,2902,22696,92,196739
8054,0.00016,172.31.47.0-255,66,22762,92,196739
8055,0.000181,172.217.194.0-255,5738,28500,92,196739
8056,0.000184,172.31.47.0-255,66,28566,92,196739
8057,0.000228,172.31.47.0-255,66,28632,92,196739
8058,0.000259,172.217.194.0-255,2902,31534,92,196739
8059,0.000261,172.31.47.0-255,66,31600,92,196739
8060,0.000298,172.31.47.0-255,66,31666,92,196739
8061,0.0003,172.217.194.0-255,364,32030,92,196739
8062,0.000301,172.31.47.0-255,66,32096,92,196739
8063,0.000335,172.217.194.0-255,1484,33580,92,196739
8064,0.000337,172.31.47.0-255,66,33646,92,196739
8065,0.000362,172.217.194.0-255,2902,36548,92,196739
8066,0.000365,172.31.47.0-255,66,36614,92,196739
8067,0.000371,172.217.194.0-255,5738,42352,92,196739
8068,0.000373,172.31.47.0-255,66,42418,92,196739
8069,0.000394,172.217.194.0-255,2902,45320,92,196739
8070,0.000397,172.31.47.0-255,66,45386,92,196739
8071,0.000421,172.217.194.0-255,3961,49347,92,196739
8072,0.000427,172.31.47.0-255,66,49413,92,196739
8073,0.000428,172.217.194.0-255,7156,56569,92,196739
8074,0.000439,172.31.47.0-255,66,56635,92,196739
8075,0.000468,172.31.47.0-255,66,56701,92,196739
8076,0.000636,172.217.194.0-255,1484,58185,92,196739
8077,0.000642,172.217.194.0-255,2902,61087,92,196739
8078,0.000644,172.31.47.0-255,66,61153,92,196739
8079,0.000647,172.217.194.0-255,1484,62637,92,196739
8080,0.00067,172.217.194.0-255,4320,66957,92,196739
8081,0.000679,172.31.47.0-255,66,67023,92,196739
8082,0.000692,172.31.47.0-255,66,67089,92,196739
8083,0.000706,172.217.194.0-255,4320,71409,92,196739
8084,0.000715,172.31.47.0-255,66,71475,92,196739
8085,0.000719,172.31.47.0-255,66,71541,92,196739
8086,0.000739,172.217.194.0-255,2184,73725,92,196739
8087,0.000747,172.31.47.0-255,66,73791,92,196739
8088,0.000898,172.217.194.0-255,1484,75275,92,196739
8089,0.000902,172.217.194.0-255,1484,76759,92,196739
8090,0.000904,172.31.47.0-255,66,76825,92,196739
8091,0.000929,172.217.194.0-255,1484,78309,92,196739
8092,0.000935,172.217.194.0-255,5738,84047,92,196739
8093,0.000938,172.217.194.0-255,1484,85531,92,196739
8094,0.000947,172.31.47.0-255,66,85597,92,196739
8095,0.000966,172.31.47.0-255,66,85663,92,196739
8096,0.000988,172.217.194.0-255,1484,87147,92,196739
8097,0.001003,172.31.47.0-255,66,87213,92,196739
8098,0.00101,172.217.194.0-255,1484,88697,92,196739
8099,0.001014,172.217.194.0-255,2902,91599,92,196739
8100,0.001022,172.31.47.0-255,66,91665,92,196739
8101,0.001035,172.217.194.0-255,5738,97403,92,196739
8102,0.001039,172.31.47.0-255,66,97469,92,196739
8103,0.001044,172.217.194.0-255,4320,101789,92,196739
8104,0.001051,172.31.47.0-255,66,101855,92,196739
8105,0.001087,172.31.47.0-255,66,101921,92,196739
8106,0.0011,172.31.47.0-255,66,101987,92,196739
8107,0.001144,172.217.194.0-255,1484,103471,92,196739
8108,0.001149,172.217.194.0-255,2902,106373,92,196739
8109,0.001159,172.31.47.0-255,66,106439,92,196739
8110,0.001176,172.217.194.0-255,1484,107923,92,196739
8111,0.001199,172.217.194.0-255,4320,112243,92,196739
8112,0.001203,172.217.194.0-255,1484,113727,92,196739
8113,0.001203,172.31.47.0-255,66,113793,92,196739
8114,0.00125,172.31.47.0-255,66,113859,92,196739
8115,0.001276,172.217.194.0-255,2902,116761,92,196739
8116,0.001278,172.31.47.0-255,66,116827,92,196739
8117,0.00131,172.217.194.0-255,6438,123265,92,196739
8118,0.001314,172.31.47.0-255,66,123331,92,196739
8119,0.001326,172.31.47.0-255,66,123397,92,196739
8120,0.001328,172.217.194.0-255,7156,130553,92,196739
8121,0.00134,172.31.47.0-255,66,130619,92,196739
8122,0.001369,172.217.194.0-255,4320,134939,92,196739
8123,0.001369,172.31.47.0-255,66,135005,92,196739
8124,0.001373,172.31.47.0-255,66,135071,92,196739
8125,0.001406,172.217.194.0-255,7156,142227,92,196739
8126,0.001417,172.217.194.0-255,1484,143711,92,196739
8127,0.001418,172.31.47.0-255,66,143777,92,196739
8128,0.001422,172.31.47.0-255,66,143843,92,196739
8129,0.001467,172.31.47.0-255,66,143909,92,196739
8130,0.001491,172.217.194.0-255,1484,145393,92,196739
8131,0.001496,172.217.194.0-255,2902,148295,92,196739
8132,0.001503,172.31.47.0-255,66,148361,92,196739
8133,0.001523,172.217.194.0-255,5738,154099,92,196739
8134,0.001529,172.217.194.0-255,5738,159837,92,196739
8135,0.00153,172.31.47.0-255,66,159903,92,196739
8136,0.001534,172.31.47.0-255,66,159969,92,196739
8137,0.001586,172.31.47.0-255,66,160035,92,196739
8138,0.001601,172.31.47.0-255,66,160101,92,196739
8139,0.001624,172.217.194.0-255,6438,166539,92,196739
8140,0.00163,172.217.194.0-255,7156,173695,92,196739
8141,0.001629,172.31.47.0-255,66,173761,92,196739
8142,0.001633,172.31.47.0-255,66,173827,92,196739
8143,0.001651,172.31.47.0-255,66,173893,92,196739
8144,0.001675,172.217.194.0-255,2184,176077,92,196739
8145,0.001685,172.31.47.0-255,66,176143,92,196739
8146,0.001697,172.31.47.0-255,66,176209,92,196739
8147,0.001701,172.31.47.0-255,66,176275,92,196739
8148,0.001727,172.217.194.0-255,5020,181295,92,196739
8149,0.00173,172.217.194.0-255,1484,182779,92,196739
8150,0.001733,172.217.194.0-255,2902,185681,92,196739
8151,0.001735,172.217.194.0-255,1484,187165,92,196739
8152,0.001735,172.31.47.0-255,66,187231,92,196739
8153,0.001741,172.31.47.0-255,66,187297,92,196739
8154,0.001751,172.217.194.0-255,4320,191617,92,196739
8155,0.001759,172.217.194.0-255,2902,194519,92,196739
8156,0.001761,172.31.47.0-255,66,194585,92,196739
8157,0.001765,172.31.47.0-255,66,194651,92,196739
8158,0.001801,172.217.194.0-255,1517,196168,92,196739
8159,0.001801,172.31.47.0-255,66,196234,92,196739
8160,0.001802,172.217.194.0-255,97,196331,92,196739
8161,0.001804,172.31.47.0-255,66,196397,92,196739
8162,0.00183,172.217.194.0-255,105,196502,92,196739
8163,0.003156,172.31.47.0-255,66,196568,92,196739
8164,0.003179,172.31.47.0-255,105,196673,92,196739
8165,0.005748,172.217.194.0-255,66,196739,92,196739
8166,0.0,172.217.194.0-255,153,153,92,227532
8167,2.3e-05,172.31.47.0-255,66,219,92,227532
8168,2.9e-05,172.217.194.0-255,1484,1703,92,227532
8169,3.2e-05,172.31.47.0-255,66,1769,92,227532
8170,3.7e-05,172.217.194.0-255,2902,4671,92,227532
8171,3.9e-05,172.31.47.0-255,66,4737,92,227532
8172,4.1e-05,172.217.194.0-255,1484,6221,92,227532
8173,4.4e-05,172.31.47.0-255,66,6287,92,227532
8174,6e-05,172.217.194.0-255,5738,12025,92,227532
8175,6.3e-05,172.31.47.0-255,66,12091,92,227532
8176,9.7e-05,172.217.194.0-255,1967,14058,92,227532
8177,0.0001,172.31.47.0-255,66,14124,92,227532
8178,0.000192,172.217.194.0-255,1484,15608,92,227532
8179,0.000196,172.31.47.0-255,66,15674,92,227532
8180,0.0002,172.217.194.0-255,2902,18576,92,227532
8181,0.000202,172.31.47.0-255,66,18642,92,227532
8182,0.000235,172.217.194.0-255,1484,20126,92,227532
8183,0.000239,172.31.47.0-255,66,20192,92,227532
8184,0.00026,172.217.194.0-255,4320,24512,92,227532
8185,0.000263,172.31.47.0-255,66,24578,92,227532
8186,0.000268,172.217.194.0-255,6797,31375,92,227532
8187,0.00027,172.31.47.0-255,66,31441,92,227532
8188,0.000323,172.217.194.0-255,1484,32925,92,227532
8189,0.000326,172.31.47.0-255,66,32991,92,227532
8190,0.000338,172.217.194.0-255,2902,35893,92,227532
8191,0.000341,172.31.47.0-255,66,35959,92,227532
8192,0.000343,172.217.194.0-255,1484,37443,92,227532
8193,0.000345,172.31.47.0-255,66,37509,92,227532
8194,0.000357,172.217.194.0-255,4320,41829,92,227532
8195,0.00036,172.31.47.0-255,66,41895,92,227532
8196,0.000364,172.217.194.0-255,2902,44797,92,227532
8197,0.000366,172.31.47.0-255,66,44863,92,227532
8198,0.000393,172.217.194.0-255,3961,48824,92,227532
8199,0.000396,172.31.47.0-255,66,48890,92,227532
8200,0.000409,172.31.47.0-255,66,48956,92,227532
8201,0.000414,172.217.194.0-255,2866,51822,92,227532
8202,0.000416,172.31.47.0-255,66,51888,92,227532
8203,0.000458,172.217.194.0-255,364,52252,92,227532
8204,0.000695,172.217.194.0-255,1484,53736,92,227532
8205,0.000699,172.31.47.0-255,66,53802,92,227532
8206,0.000702,172.217.194.0-255,1484,55286,92,227532
8207,0.000716,172.217.194.0-255,1484,56770,92,227532
8208,0.000719,172.31.47.0-255,66,56836,92,227532
8209,0.000723,172.217.194.0-255,2902,59738,92,227532
8210,0.000725,172.31.47.0-255,66,59804,92,227532
8211,0.000739,172.217.194.0-255,2902,62706,92,227532
8212,0.000741,172.31.47.0-255,66,62772,92,227532
8213,0.000747,172.217.194.0-255,7156,69928,92,227532
8214,0.000749,172.31.47.0-255,66,69994,92,227532
8215,0.000751,172.217.194.0-255,1484,71478,92,227532
8216,0.000788,172.31.47.0-255,66,71544,92,227532
8217,0.000791,172.217.194.0-255,2184,73728,92,227532
8218,0.000793,172.31.47.0-255,66,73794,92,227532
8219,0.001078,172.217.194.0-255,1484,75278,92,227532
8220,0.001089,172.217.194.0-255,2902,78180,92,227532
8221,0.001093,172.31.47.0-255,66,78246,92,227532
8222,0.0011,172.217.194.0-255,5738,83984,92,227532
8223,0.001102,172.31.47.0-255,66,84050,92,227532
8224,0.001106,172.217.194.0-255,2902,86952,92,227532
8225,0.001108,172.31.47.0-255,66,87018,92,227532
8226,0.001136,172.31.47.0-255,66,87084,92,227532
8227,0.001142,172.217.194.0-255,4320,91404,92,227532
8228,0.001144,172.31.47.0-255,66,91470,92,227532
8229,0.001167,172.217.194.0-255,5738,97208,92,227532
8230,0.001171,172.31.47.0-255,66,97274,92,227532
8231,0.001176,172.217.194.0-255,3602,100876,92,227532
8232,0.001178,172.31.47.0-255,66,100942,92,227532
8233,0.001204,172.217.194.0-255,4320,105262,92,227532
8234,0.001208,172.31.47.0-255,66,105328,92,227532
8235,0.001218,172.31.47.0-255,66,105394,92,227532
8236,0.001253,172.31.47.0-255,66,105460,92,227532
8237,0.001274,172.217.194.0-255,5020,110480,92,227532
8238,0.001278,172.31.47.0-255,66,110546,92,227532
8239,0.001282,172.217.194.0-255,2902,113448,92,227532
8240,0.001284,172.31.47.0-255,66,113514,92,227532
8241,0.001301,172.217.194.0-255,5738,119252,92,227532
8242,0.001304,172.31.47.0-255,66,119318,92,227532
8243,0.001314,172.31.47.0-255,66,119384,92,227532
8244,0.001353,172.31.47.0-255,66,119450,92,227532
8245,0.001421,172.217.194.0-255,1484,120934,92,227532
8246,0.001437,172.217.194.0-255,2902,123836,92,227532
8247,0.001442,172.31.47.0-255,66,123902,92,227532
8248,0.001448,172.217.194.0-255,4320,128222,92,227532
8249,0.001451,172.31.47.0-255,66,128288,92,227532
8250,0.001465,172.217.194.0-255,1484,129772,92,227532
8251,0.00147,172.217.194.0-255,5738,135510,92,227532
8252,0.001473,172.31.47.0-255,66,135576,92,227532
8253,0.001495,172.217.194.0-255,7156,142732,92,227532
8254,0.001498,172.31.47.0-255,66,142798,92,227532
8255,0.001512,172.31.47.0-255,66,142864,92,227532
8256,0.001611,172.217.194.0-255,1484,144348,92,227532
8257,0.001616,172.217.194.0-255,2902,147250,92,227532
8258,0.001618,172.31.47.0-255,66,147316,92,227532
8259,0.00164,172.217.194.0-255,5738,153054,92,227532
8260,0.001643,172.31.47.0-255,66,153120,92,227532
8261,0.001667,172.217.194.0-255,5738,158858,92,227532
8262,0.001669,172.31.47.0-255,66,158924,92,227532
8263,0.001675,172.217.194.0-255,7156,166080,92,227532
8264,0.001678,172.31.47.0-255,66,166146,92,227532
8265,0.001739,172.31.47.0-255,66,166212,92,227532
8266,0.001836,172.217.194.0-255,1484,167696,92,227532
8267,0.001839,172.217.194.0-255,1484,169180,92,227532
8268,0.001841,172.31.47.0-255,66,169246,92,227532
8269,0.00185,172.217.194.0-255,1484,170730,92,227532
8270,0.00187,172.217.194.0-255,5738,176468,92,227532
8271,0.001873,172.31.47.0-255,66,176534,92,227532
8272,0.001883,172.31.47.0-255,66,176600,92,227532
8273,0.001895,172.217.194.0-255,4320,180920,92,227532
8274,0.001898,172.31.47.0-255,66,180986,92,227532
8275,0.001904,172.217.194.0-255,5738,186724,92,227532
8276,0.001906,172.31.47.0-255,66,186790,92,227532
8277,0.001928,172.217.194.0-255,5020,191810,92,227532
8278,0.00193,172.31.47.0-255,66,191876,92,227532
8279,0.001952,172.217.194.0-255,1484,193360,92,227532
8280,0.001965,172.217.194.0-255,2902,196262,92,227532
8281,0.001967,172.31.47.0-255,66,196328,92,227532
8282,0.001973,172.217.194.0-255,5738,202066,92,227532
8283,0.001975,172.31.47.0-255,66,202132,92,227532
8284,0.00201,172.31.47.0-255,66,202198,92,227532
8285,0.002015,172.217.194.0-255,4320,206518,92,227532
8286,0.002032,172.217.194.0-255,6438,212956,92,227532
8287,0.002036,172.217.194.0-255,2902,215858,92,227532
8288,0.004001,172.31.47.0-255,66,215924,92,227532
8289,0.005997,172.217.194.0-255,5738,221662,92,227532
8290,0.006002,172.31.47.0-255,66,221728,92,227532
8291,0.008004,172.217.194.0-255,5738,227466,92,227532
8292,0.008009,172.31.47.0-255,66,227532,92,227532
8293,0.0,172.217.194.0-255,153,153,92,111248
8294,3.3e-05,172.31.47.0-255,66,219,92,111248
8295,4.1e-05,172.217.194.0-255,1484,1703,92,111248
8296,4.5e-05,172.31.47.0-255,66,1769,92,111248
8297,4.9e-05,172.217.194.0-255,2902,4671,92,111248
8298,5.2e-05,172.31.47.0-255,66,4737,92,111248
8299,5.4e-05,172.217.194.0-255,1484,6221,92,111248
8300,5.6e-05,172.31.47.0-255,66,6287,92,111248
8301,7.6e-05,172.217.194.0-255,5738,12025,92,111248
8302,7.8e-05,172.31.47.0-255,66,12091,92,111248
8303,8.2e-05,172.217.194.0-255,1998,14089,92,111248
8304,8.4e-05,172.31.47.0-255,66,14155,92,111248
8305,0.000137,172.217.194.0-255,1484,15639,92,111248
8306,0.000142,172.31.47.0-255,66,15705,92,111248
8307,0.000146,172.217.194.0-255,2902,18607,92,111248
8308,0.000149,172.31.47.0-255,66,18673,92,111248
8309,0.000163,172.217.194.0-255,5738,24411,92,111248
8310,0.000165,172.31.47.0-255,66,24477,92,111248
8311,0.000189,172.217.194.0-255,6797,31274,92,111248
8312,0.000192,172.31.47.0-255,66,31340,92,111248
8313,0.000227,172.217.194.0-255,5738,37078,92,111248
8314,0.00023,172.31.47.0-255,66,37144,92,111248
8315,0.000251,172.31.47.0-255,66,37210,92,111248
8316,0.000254,172.217.194.0-255,2543,39753,92,111248
8317,0.000256,172.31.47.0-255,66,39819,92,111248
8318,0.001379,172.217.194.0-255,1484,41303,92,111248
8319,0.001384,172.31.47.0-255,66,41369,92,111248
8320,0.001393,172.217.194.0-255,2902,44271,92,111248
8321,0.001394,172.31.47.0-255,66,44337,92,111248
8322,0.001412,172.217.194.0-255,4320,48657,92,111248
8323,0.001414,172.31.47.0-255,66,48723,92,111248
8324,0.001425,172.217.194.0-255,1484,50207,92,111248
8325,0.001427,172.31.47.0-255,66,50273,92,111248
8326,0.001463,172.217.194.0-255,6797,57070,92,111248
8327,0.001465,172.31.47.0-255,66,57136,92,111248
8328,0.001551,172.217.194.0-255,1484,58620,92,111248
8329,0.001554,172.31.47.0-255,66,58686,92,111248
8330,0.001558,172.217.194.0-255,2902,61588,92,111248
8331,0.00156,172.31.47.0-255,66,61654,92,111248
8332,0.001578,172.217.194.0-255,5738,67392,92,111248
8333,0.00158,172.31.47.0-255,66,67458,92,111248
8334,0.00161,172.217.194.0-255,4320,71778,92,111248
8335,0.001612,172.31.47.0-255,66,71844,92,111248
8336,0.001635,172.217.194.0-255,6797,78641,92,111248
8337,0.001637,172.31.47.0-255,66,78707,92,111248
8338,0.001647,172.31.47.0-255,66,78773,92,111248
8339,0.001651,172.217.194.0-255,1707,80480,92,111248
8340,0.001653,172.31.47.0-255,66,80546,92,111248
8341,0.002086,172.217.194.0-255,1484,82030,92,111248
8342,0.00209,172.31.47.0-255,66,82096,92,111248
8343,0.002117,172.217.194.0-255,2902,84998,92,111248
8344,0.00212,172.31.47.0-255,66,85064,92,111248
8345,0.002126,172.217.194.0-255,5738,90802,92,111248
8346,0.002127,172.31.47.0-255,66,90868,92,111248
8347,0.002131,172.217.194.0-255,2902,93770,92,111248
8348,0.002132,172.31.47.0-255,66,93836,92,111248
8349,0.004235,172.217.194.0-255,5738,99574,92,111248
8350,0.004239,172.31.47.0-255,66,99640,92,111248
8351,0.006378,172.217.194.0-255,5738,105378,92,111248
8352,0.006384,172.31.47.0-255,66,105444,92,111248
8353,0.008488,172.217.194.0-255,5738,111182,92,111248
8354,0.008494,172.31.47.0-255,66,111248,92,111248
8355,0.0,172.31.47.0-255,105,105,92,105
8356,0.0,172.31.47.0-255,105,105,92,105
8357,0.0,74.125.68.0-255,153,153,92,318288
8358,2.5e-05,172.31.47.0-255,66,219,92,318288
8359,3.3e-05,74.125.68.0-255,1484,1703,92,318288
8360,3.7e-05,172.31.47.0-255,66,1769,92,318288
8361,4.2e-05,74.125.68.0-255,2902,4671,92,318288
8362,4.4e-05,172.31.47.0-255,66,4737,92,318288
8363,5.1e-05,74.125.68.0-255,7156,11893,92,318288
8364,5.3e-05,172.31.47.0-255,66,11959,92,318288
8365,5.7e-05,74.125.68.0-255,2063,14022,92,318288
8366,6e-05,172.31.47.0-255,66,14088,92,318288
8367,9.6e-05,74.125.68.0-255,2902,16990,92,318288
8368,9.9e-05,172.31.47.0-255,66,17056,92,318288
8369,0.000102,74.125.68.0-255,1484,18540,92,318288
8370,0.000103,172.31.47.0-255,66,18606,92,318288
8371,0.000121,74.125.68.0-255,2902,21508,92,318288
8372,0.000123,172.31.47.0-255,66,21574,92,318288
8373,0.000129,74.125.68.0-255,5738,27312,92,318288
8374,0.000131,172.31.47.0-255,66,27378,92,318288
8375,0.00018,172.31.47.0-255,66,27444,92,318288
8376,0.00022,172.31.47.0-255,66,27510,92,318288
8377,0.000303,74.125.68.0-255,1484,28994,92,318288
8378,0.000307,172.31.47.0-255,66,29060,92,318288
8379,0.000331,74.125.68.0-255,2902,31962,92,318288
8380,0.000333,172.31.47.0-255,66,32028,92,318288
8381,0.000339,74.125.68.0-255,5738,37766,92,318288
8382,0.000341,172.31.47.0-255,66,37832,92,318288
8383,0.000397,172.31.47.0-255,66,37898,92,318288
8384,0.000416,74.125.68.0-255,1484,39382,92,318288
8385,0.000418,172.31.47.0-255,66,39448,92,318288
8386,0.000445,172.31.47.0-255,66,39514,92,318288
8387,0.000462,74.125.68.0-255,2902,42416,92,318288
8388,0.000478,74.125.68.0-255,2902,45318,92,318288
8389,0.000495,74.125.68.0-255,1484,46802,92,318288
8390,0.000499,74.125.68.0-255,2902,49704,92,318288
8391,0.000522,74.125.68.0-255,5738,55442,92,318288
8392,0.000526,74.125.68.0-255,2902,58344,92,318288
8393,0.000598,74.125.68.0-255,1484,59828,92,318288
8394,0.000602,74.125.68.0-255,2184,62012,92,318288
8395,0.000648,172.31.47.0-255,66,62078,92,318288
8396,0.000714,74.125.68.0-255,1484,63562,92,318288
8397,0.00072,74.125.68.0-255,2902,66464,92,318288
8398,0.000744,74.125.68.0-255,5738,72202,92,318288
8399,0.000748,172.31.47.0-255,66,72268,92,318288
8400,0.000758,74.125.68.0-255,1484,73752,92,318288
8401,0.000763,172.31.47.0-255,66,73818,92,318288
8402,0.000779,74.125.68.0-255,7156,80974,92,318288
8403,0.00079,74.125.68.0-255,1484,82458,92,318288
8404,0.000827,74.125.68.0-255,1484,83942,92,318288
8405,0.000833,172.31.47.0-255,66,84008,92,318288
8406,0.000848,74.125.68.0-255,3602,87610,92,318288
8407,0.000872,172.31.47.0-255,66,87676,92,318288
8408,0.001088,74.125.68.0-255,1484,89160,92,318288
8409,0.001094,74.125.68.0-255,2902,92062,92,318288
8410,0.001119,74.125.68.0-255,5738,97800,92,318288
8411,0.001125,74.125.68.0-255,4320,102120,92,318288
8412,0.001141,172.31.47.0-255,66,102186,92,318288
8413,0.001153,74.125.68.0-255,5738,107924,92,318288
8414,0.001158,172.31.47.0-255,66,107990,92,318288
8415,0.00118,74.125.68.0-255,7156,115146,92,318288
8416,0.001196,74.125.68.0-255,4320,119466,92,318288
8417,0.0012,74.125.68.0-255,2184,121650,92,318288
8418,0.001211,172.31.47.0-255,66,121716,92,318288
8419,0.00123,74.125.68.0-255,1484,123200,92,318288
8420,0.001248,74.125.68.0-255,5738,128938,92,318288
8421,0.001313,172.31.47.0-255,66,129004,92,318288
8422,0.001325,74.125.68.0-255,5738,134742,92,318288
8423,0.001328,74.125.68.0-255,766,135508,92,318288
8424,0.001334,172.31.47.0-255,66,135574,92,318288
8425,0.001343,74.125.68.0-255,1484,137058,92,318288
8426,0.001361,74.125.68.0-255,2902,139960,92,318288
8427,0.001382,74.125.68.0-255,5738,145698,92,318288
8428,0.001388,172.31.47.0-255,66,145764,92,318288
8429,0.001408,74.125.68.0-255,5738,151502,92,318288
8430,0.001416,74.125.68.0-255,7156,158658,92,318288
8431,0.001439,74.125.68.0-255,4320,162978,92,318288
8432,0.001444,172.31.47.0-255,66,163044,92,318288
8433,0.001457,74.125.68.0-255,6438,169482,92,318288
8434,0.001483,74.125.68.0-255,1484,170966,92,318288
8435,0.001493,172.31.47.0-255,66,171032,92,318288
8436,0.001506,74.125.68.0-255,2902,173934,92,318288
8437,0.001511,74.125.68.0-255,2902,176836,92,318288
8438,0.001518,172.31.47.0-255,66,176902,92,318288
8439,0.001529,74.125.68.0-255,2902,179804,92,318288
8440,0.001531,74.125.68.0-255,1484,181288,92,318288
8441,0.001561,74.125.68.0-255,7156,188444,92,318288
8442,0.001577,74.125.68.0-255,5738,194182,92,318288
8443,0.001583,172.31.47.0-255,66,194248,92,318288
8444,0.001596,74.125.68.0-255,4320,198568,92,318288
8445,0.0016,74.125.68.0-255,2902,201470,92,318288
8446,0.00163,172.31.47.0-255,66,201536,92,318288
8447,0.001672,172.31.47.0-255,66,201602,92,318288
8448,0.001679,74.125.68.0-255,3602,205204,92,318288
8449,0.001721,74.125.68.0-255,5738,210942,92,318288
8450,0.001728,172.31.47.0-255,66,211008,92,318288
8451,0.001741,74.125.68.0-255,7156,218164,92,318288
8452,0.001747,74.125.68.0-255,7156,225320,92,318288
8453,0.001753,74.125.68.0-255,5020,230340,92,318288
8454,0.001758,74.125.68.0-255,5738,236078,92,318288
8455,0.001807,172.31.47.0-255,66,236144,92,318288
8456,0.001822,74.125.68.0-255,4320,240464,92,318288
8457,0.00183,74.125.68.0-255,7156,247620,92,318288
8458,0.001856,74.125.68.0-255,6438,254058,92,318288
8459,0.001865,172.31.47.0-255,66,254124,92,318288
8460,0.002249,74.125.68.0-255,1484,255608,92,318288
8461,0.002256,74.125.68.0-255,2902,258510,92,318288
8462,0.002268,74.125.68.0-255,4320,262830,92,318288
8463,0.002278,74.125.68.0-255,1484,264314,92,318288
8464,0.002289,172.31.47.0-255,66,264380,92,318288
8465,0.002304,74.125.68.0-255,5738,270118,92,318288
8466,0.002316,172.31.47.0-255,66,270184,92,318288
8467,0.002333,74.125.68.0-255,7156,277340,92,318288
8468,0.002349,74.125.68.0-255,5738,283078,92,318288
8469,0.002364,74.125.68.0-255,5020,288098,92,318288
8470,0.002383,172.31.47.0-255,66,288164,92,318288
8471,0.002402,74.125.68.0-255,5738,293902,92,318288
8472,0.00241,172.31.47.0-255,66,293968,92,318288
8473,0.002419,74.125.68.0-255,4320,298288,92,318288
8474,0.002423,172.31.47.0-255,66,298354,92,318288
8475,0.002455,74.125.68.0-255,7156,305510,92,318288
8476,0.002464,172.31.47.0-255,66,305576,92,318288
8477,0.002495,74.125.68.0-255,2902,308478,92,318288
8478,0.002503,172.31.47.0-255,66,308544,92,318288
8479,0.002512,74.125.68.0-255,2184,310728,92,318288
8480,0.002534,172.31.47.0-255,66,310794,92,318288
8481,0.005017,74.125.68.0-255,2902,313696,92,318288
8482,0.005032,172.31.47.0-255,66,313762,92,318288
8483,0.005056,74.125.68.0-255,2902,316664,92,318288
8484,0.005077,172.31.47.0-255,66,316730,92,318288
8485,0.00756,74.125.68.0-255,1387,318117,92,318288
8486,0.007573,172.31.47.0-255,66,318183,92,318288
8487,0.007755,172.31.47.0-255,105,318288,92,318288
8488,0.0,172.217.160.0-255,153,153,92,99609
8489,2.2e-05,172.31.47.0-255,66,219,92,99609
8490,3e-05,172.217.160.0-255,1484,1703,92,99609
8491,3.4e-05,172.31.47.0-255,66,1769,92,99609
8492,4.6e-05,172.217.160.0-255,2902,4671,92,99609
8493,5e-05,172.31.47.0-255,66,4737,92,99609
8494,5.9e-05,172.217.160.0-255,7156,11893,92,99609
8495,6.3e-05,172.31.47.0-255,66,11959,92,99609
8496,7.6e-05,172.31.47.0-255,66,12025,92,99609
8497,8.3e-05,172.217.160.0-255,7156,19181,92,99609
8498,8.6e-05,172.31.47.0-255,66,19247,92,99609
8499,0.00012,172.217.160.0-255,2902,22149,92,99609
8500,0.000123,172.31.47.0-255,66,22215,92,99609
8501,0.000145,172.31.47.0-255,66,22281,92,99609
8502,0.000162,172.31.47.0-255,66,22347,92,99609
8503,0.000486,172.217.160.0-255,120,22467,92,99609
8504,0.000492,172.31.47.0-255,66,22533,92,99609
8505,0.000636,172.217.160.0-255,1484,24017,92,99609
8506,0.00064,172.31.47.0-255,66,24083,92,99609
8507,0.000646,172.217.160.0-255,2902,26985,92,99609
8508,0.000649,172.31.47.0-255,66,27051,92,99609
8509,0.000652,172.217.160.0-255,1484,28535,92,99609
8510,0.000659,172.31.47.0-255,66,28601,92,99609
8511,0.000697,172.217.160.0-255,4320,32921,92,99609
8512,0.000701,172.31.47.0-255,66,32987,92,99609
8513,0.000706,172.217.160.0-255,4320,37307,92,99609
8514,0.000709,172.31.47.0-255,66,37373,92,99609
8515,0.000725,172.31.47.0-255,66,37439,92,99609
8516,0.000757,172.217.160.0-255,5738,43177,92,99609
8517,0.00076,172.31.47.0-255,66,43243,92,99609
8518,0.000772,172.217.160.0-255,2184,45427,92,99609
8519,0.000774,172.31.47.0-255,66,45493,92,99609
8520,0.00127,172.217.160.0-255,1484,46977,92,99609
8521,0.001277,172.217.160.0-255,2902,49879,92,99609
8522,0.001279,172.31.47.0-255,66,49945,92,99609
8523,0.001284,172.217.160.0-255,2902,52847,92,99609
8524,0.001286,172.31.47.0-255,66,52913,92,99609
8525,0.00131,172.217.160.0-255,2902,55815,92,99609
8526,0.001312,172.31.47.0-255,66,55881,92,99609
8527,0.001317,172.217.160.0-255,4320,60201,92,99609
8528,0.001319,172.31.47.0-255,66,60267,92,99609
8529,0.00133,172.217.160.0-255,7156,67423,92,99609
8530,0.001331,172.31.47.0-255,66,67489,92,99609
8531,0.001354,172.217.160.0-255,4320,71809,92,99609
8532,0.00136,172.31.47.0-255,66,71875,92,99609
8533,0.001369,172.31.47.0-255,66,71941,92,99609
8534,0.003025,172.217.160.0-255,5738,77679,92,99609
8535,0.003031,172.31.47.0-255,66,77745,92,99609
8536,0.004682,172.217.160.0-255,4320,82065,92,99609
8537,0.004685,172.31.47.0-255,66,82131,92,99609
8538,0.004706,172.217.160.0-255,1484,83615,92,99609
8539,0.006356,172.217.160.0-255,4320,87935,92,99609
8540,0.006361,172.31.47.0-255,66,88001,92,99609
8541,0.008055,172.217.160.0-255,5738,93739,92,99609
8542,0.008062,172.31.47.0-255,66,93805,92,99609
8543,0.009748,172.217.160.0-255,5738,99543,92,99609
8544,0.009756,172.31.47.0-255,66,99609,92,99609
8545,0.0,172.31.47.0-255,105,105,92,105
8546,0.0,74.125.24.0-255,298,298,92,155133
8547,2.7e-05,172.31.47.0-255,66,364,92,155133
8548,3.3e-05,74.125.24.0-255,1484,1848,92,155133
8549,3.7e-05,172.31.47.0-255,66,1914,92,155133
8550,4.3e-05,74.125.24.0-255,4320,6234,92,155133
8551,4.5e-05,172.31.47.0-255,66,6300,92,155133
8552,4.8e-05,74.125.24.0-255,1484,7784,92,155133
8553,5.1e-05,172.31.47.0-255,66,7850,92,155133
8554,7.8e-05,74.125.24.0-255,5738,13588,92,155133
8555,8.2e-05,172.31.47.0-255,66,13654,92,155133
8556,0.000106,172.31.47.0-255,66,13720,92,155133
8557,0.000124,74.125.24.0-255,4667,18387,92,155133
8558,0.000127,172.31.47.0-255,66,18453,92,155133
8559,0.000145,172.31.47.0-255,66,18519,92,155133
8560,0.00015,74.125.24.0-255,3602,22121,92,155133
8561,0.000152,172.31.47.0-255,66,22187,92,155133
8562,0.000196,74.125.24.0-255,2902,25089,92,155133
8563,0.000199,172.31.47.0-255,66,25155,92,155133
8564,0.000227,172.31.47.0-255,66,25221,92,155133
8565,0.00025,74.125.24.0-255,2854,28075,92,155133
8566,0.000253,172.31.47.0-255,66,28141,92,155133
8567,0.000319,74.125.24.0-255,110,28251,92,155133
8568,0.000325,172.31.47.0-255,66,28317,92,155133
8569,0.000507,74.125.24.0-255,1484,29801,92,155133
8570,0.000511,172.31.47.0-255,66,29867,92,155133
8571,0.000526,74.125.24.0-255,2902,32769,92,155133
8572,0.000529,172.31.47.0-255,66,32835,92,155133
8573,0.000542,74.125.24.0-255,4320,37155,92,155133
8574,0.000545,172.31.47.0-255,66,37221,92,155133
8575,0.000551,74.125.24.0-255,4320,41541,92,155133
8576,0.000553,172.31.47.0-255,66,41607,92,155133
8577,0.00058,74.125.24.0-255,4320,45927,92,155133
8578,0.000584,172.31.47.0-255,66,45993,92,155133
8579,0.000587,74.125.24.0-255,1484,47477,92,155133
8580,0.000619,172.31.47.0-255,66,47543,92,155133
8581,0.000804,74.125.24.0-255,1484,49027,92,155133
8582,0.00082,74.125.24.0-255,2902,51929,92,155133
8583,0.000824,172.31.47.0-255,66,51995,92,155133
8584,0.000832,74.125.24.0-255,5738,57733,92,155133
8585,0.000835,172.31.47.0-255,66,57799,92,155133
8586,0.000854,74.125.24.0-255,4320,62119,92,155133
8587,0.000857,172.31.47.0-255,66,62185,92,155133
8588,0.000883,74.125.24.0-255,5738,67923,92,155133
8589,0.000885,172.31.47.0-255,66,67989,92,155133
8590,0.000903,74.125.24.0-255,1484,69473,92,155133
8591,0.000919,74.125.24.0-255,5738,75211,92,155133
8592,0.000923,172.31.47.0-255,66,75277,92,155133
8593,0.000946,74.125.24.0-255,6438,81715,92,155133
8594,0.00095,172.31.47.0-255,66,81781,92,155133
8595,0.001052,74.125.24.0-255,1484,83265,92,155133
8596,0.00107,74.125.24.0-255,2902,86167,92,155133
8597,0.001074,172.31.47.0-255,66,86233,92,155133
8598,0.001078,74.125.24.0-255,2902,89135,92,155133
8599,0.001081,172.31.47.0-255,66,89201,92,155133
8600,0.001109,74.125.24.0-255,2902,92103,92,155133
8601,0.001112,172.31.47.0-255,66,92169,92,155133
8602,0.001124,172.31.47.0-255,66,92235,92,155133
8603,0.001145,74.125.24.0-255,2902,95137,92,155133
8604,0.001148,172.31.47.0-255,66,95203,92,155133
8605,0.001178,172.31.47.0-255,66,95269,92,155133
8606,0.001184,74.125.24.0-255,5738,101007,92,155133
8607,0.001187,172.31.47.0-255,66,101073,92,155133
8608,0.001223,172.31.47.0-255,66,101139,92,155133
8609,0.00123,74.125.24.0-255,6438,107577,92,155133
8610,0.001232,172.31.47.0-255,66,107643,92,155133
8611,0.001315,74.125.24.0-255,1484,109127,92,155133
8612,0.00132,74.125.24.0-255,2902,112029,92,155133
8613,0.001324,172.31.47.0-255,66,112095,92,155133
8614,0.001329,74.125.24.0-255,2902,114997,92,155133
8615,0.001331,172.31.47.0-255,66,115063,92,155133
8616,0.001349,74.125.24.0-255,2902,117965,92,155133
8617,0.001351,172.31.47.0-255,66,118031,92,155133
8618,0.001356,74.125.24.0-255,5738,123769,92,155133
8619,0.001358,172.31.47.0-255,66,123835,92,155133
8620,0.001401,172.31.47.0-255,66,123901,92,155133
8621,0.001442,74.125.24.0-255,2902,126803,92,155133
8622,0.001446,172.31.47.0-255,66,126869,92,155133
8623,0.001462,74.125.24.0-255,2184,129053,92,155133
8624,0.001465,172.31.47.0-255,66,129119,92,155133
8625,0.001468,74.125.24.0-255,1484,130603,92,155133
8626,0.001473,74.125.24.0-255,2902,133505,92,155133
8627,0.001476,172.31.47.0-255,66,133571,92,155133
8628,0.001481,74.125.24.0-255,5738,139309,92,155133
8629,0.001484,172.31.47.0-255,66,139375,92,155133
8630,0.001524,172.31.47.0-255,66,139441,92,155133
8631,0.00154,74.125.24.0-255,1484,140925,92,155133
8632,0.001554,172.31.47.0-255,66,140991,92,155133
8633,0.001558,74.125.24.0-255,2902,143893,92,155133
8634,0.00156,172.31.47.0-255,66,143959,92,155133
8635,0.001614,172.31.47.0-255,66,144025,92,155133
8636,0.001625,172.31.47.0-255,66,144091,92,155133
8637,0.001643,74.125.24.0-255,2902,146993,92,155133
8638,0.001646,172.31.47.0-255,66,147059,92,155133
8639,0.001697,172.31.47.0-255,66,147125,92,155133
8640,0.001708,172.31.47.0-255,66,147191,92,155133
8641,0.001738,172.31.47.0-255,66,147257,92,155133
8642,0.001773,172.31.47.0-255,66,147323,92,155133
8643,0.001803,74.125.24.0-255,5020,152343,92,155133
8644,0.001807,172.31.47.0-255,66,152409,92,155133
8645,0.001825,172.31.47.0-255,66,152475,92,155133
8646,0.001827,74.125.24.0-255,766,153241,92,155133
8647,0.001846,74.125.24.0-255,1484,154725,92,155133
8648,0.001849,172.31.47.0-255,66,154791,92,155133
8649,0.001888,172.31.47.0-255,66,154857,92,155133
8650,0.001892,74.125.24.0-255,105,154962,92,155133
8651,0.008027,172.31.47.0-255,66,155028,92,155133
8652,0.008053,172.31.47.0-255,105,155133,92,155133
8653,0.0,172.31.47.0-255,105,105,92,105
8654,0.0,74.125.24.0-255,153,153,92,115884
8655,2.3e-05,172.31.47.0-255,66,219,92,115884
8656,2.9e-05,74.125.24.0-255,1484,1703,92,115884
8657,3.2e-05,172.31.47.0-255,66,1769,92,115884
8658,3.6e-05,74.125.24.0-255,2902,4671,92,115884
8659,3.9e-05,172.31.47.0-255,66,4737,92,115884
8660,7.2e-05,74.125.24.0-255,5738,10475,92,115884
8661,7.4e-05,172.31.47.0-255,66,10541,92,115884
8662,0.000101,74.125.24.0-255,3635,14176,92,115884
8663,0.000103,172.31.47.0-255,66,14242,92,115884
8664,0.000126,74.125.24.0-255,4320,18562,92,115884
8665,0.000128,172.31.47.0-255,66,18628,92,115884
8666,0.000159,172.31.47.0-255,66,18694,92,115884
8667,0.000177,74.125.24.0-255,1484,20178,92,115884
8668,0.000179,172.31.47.0-255,66,20244,92,115884
8669,0.000211,74.125.24.0-255,2543,22787,92,115884
8670,0.000213,172.31.47.0-255,66,22853,92,115884
8671,0.000276,74.125.24.0-255,1484,24337,92,115884
8672,0.000279,172.31.47.0-255,66,24403,92,115884
8673,0.000284,74.125.24.0-255,2902,27305,92,115884
8674,0.000286,172.31.47.0-255,66,27371,92,115884
8675,0.000302,74.125.24.0-255,2902,30273,92,115884
8676,0.000305,172.31.47.0-255,66,30339,92,115884
8677,0.000315,74.125.24.0-255,7156,37495,92,115884
8678,0.000317,172.31.47.0-255,66,37561,92,115884
8679,0.000351,74.125.24.0-255,2543,40104,92,115884
8680,0.000354,172.31.47.0-255,66,40170,92,115884
8681,0.000392,74.125.24.0-255,2902,43072,92,115884
8682,0.000394,172.31.47.0-255,66,43138,92,115884
8683,0.000421,74.125.24.0-255,4320,47458,92,115884
8684,0.000423,172.31.47.0-255,66,47524,92,115884
8685,0.000456,172.31.47.0-255,66,47590,92,115884
8686,0.000458,74.125.24.0-255,1456,49046,92,115884
8687,0.000472,74.125.24.0-255,377,49423,92,115884
8688,0.000474,172.31.47.0-255,66,49489,92,115884
8689,0.000624,74.125.24.0-255,1484,50973,92,115884
8690,0.000628,74.125.24.0-255,2902,53875,92,115884
8691,0.00063,172.31.47.0-255,66,53941,92,115884
8692,0.000658,74.125.24.0-255,5738,59679,92,115884
8693,0.00066,172.31.47.0-255,66,59745,92,115884
8694,0.000663,74.125.24.0-255,1484,61229,92,115884
8695,0.0007,74.125.24.0-255,2902,64131,92,115884
8696,0.000702,172.31.47.0-255,66,64197,92,115884
8697,0.000733,74.125.24.0-255,6797,70994,92,115884
8698,0.000736,172.31.47.0-255,66,71060,92,115884
8699,0.00074,74.125.24.0-255,1484,72544,92,115884
8700,0.000768,172.31.47.0-255,66,72610,92,115884
8701,0.001528,74.125.24.0-255,1484,74094,92,115884
8702,0.001537,74.125.24.0-255,2902,76996,92,115884
8703,0.001541,172.31.47.0-255,66,77062,92,115884
8704,0.001546,74.125.24.0-255,2902,79964,92,115884
8705,0.001548,172.31.47.0-255,66,80030,92,115884
8706,0.001575,74.125.24.0-255,7156,87186,92,115884
8707,0.001581,172.31.47.0-255,66,87252,92,115884
8708,0.001586,74.125.24.0-255,2902,90154,92,115884
8709,0.001588,172.31.47.0-255,66,90220,92,115884
8710,0.001626,172.31.47.0-255,66,90286,92,115884
8711,0.00163,74.125.24.0-255,3602,93888,92,115884
8712,0.001632,172.31.47.0-255,66,93954,92,115884
8713,0.003582,74.125.24.0-255,1484,95438,92,115884
8714,0.003599,74.125.24.0-255,4320,99758,92,115884
8715,0.003603,172.31.47.0-255,66,99824,92,115884
8716,0.005598,74.125.24.0-255,4320,104144,92,115884
8717,0.005601,172.31.47.0-255,66,104210,92,115884
8718,0.005624,74.125.24.0-255,1484,105694,92,115884
8719,0.007575,74.125.24.0-255,4320,110014,92,115884
8720,0.007583,172.31.47.0-255,66,110080,92,115884
8721,0.009531,74.125.24.0-255,5738,115818,92,115884
8722,0.009539,172.31.47.0-255,66,115884,92,115884
8723,0.0,74.125.24.0-255,153,153,92,105546
8724,3.1e-05,172.31.47.0-255,66,219,92,105546
8725,3.7e-05,74.125.24.0-255,1484,1703,92,105546
8726,4.1e-05,172.31.47.0-255,66,1769,92,105546
8727,4.5e-05,74.125.24.0-255,2902,4671,92,105546
8728,4.7e-05,172.31.47.0-255,66,4737,92,105546
8729,6.3e-05,74.125.24.0-255,7156,11893,92,105546
8730,6.6e-05,172.31.47.0-255,66,11959,92,105546
8731,6.9e-05,74.125.24.0-255,2172,14131,92,105546
8732,7.2e-05,172.31.47.0-255,66,14197,92,105546
8733,0.000112,74.125.24.0-255,7156,21353,92,105546
8734,0.000116,172.31.47.0-255,66,21419,92,105546
8735,0.000148,172.31.47.0-255,66,21485,92,105546
8736,0.000152,74.125.24.0-255,1484,22969,92,105546
8737,0.000154,172.31.47.0-255,66,23035,92,105546
8738,0.000157,74.125.24.0-255,2902,25937,92,105546
8739,0.000159,172.31.47.0-255,66,26003,92,105546
8740,0.000169,74.125.24.0-255,4320,30323,92,105546
8741,0.000171,172.31.47.0-255,66,30389,92,105546
8742,0.000196,74.125.24.0-255,1484,31873,92,105546
8743,0.000199,172.31.47.0-255,66,31939,92,105546
8744,0.000216,172.31.47.0-255,66,32005,92,105546
8745,0.000251,74.125.24.0-255,4320,36325,92,105546
8746,0.000255,172.31.47.0-255,66,36391,92,105546
8747,0.000281,74.125.24.0-255,5711,42102,92,105546
8748,0.000284,172.31.47.0-255,66,42168,92,105546
8749,0.000304,74.125.24.0-255,376,42544,92,105546
8750,0.000307,172.31.47.0-255,66,42610,92,105546
8751,0.000597,74.125.24.0-255,1484,44094,92,105546
8752,0.000601,172.31.47.0-255,66,44160,92,105546
8753,0.000627,74.125.24.0-255,2902,47062,92,105546
8754,0.00063,172.31.47.0-255,66,47128,92,105546
8755,0.000636,74.125.24.0-255,5738,52866,92,105546
8756,0.000638,172.31.47.0-255,66,52932,92,105546
8757,0.000641,74.125.24.0-255,2902,55834,92,105546
8758,0.000648,172.31.47.0-255,66,55900,92,105546
8759,0.000676,74.125.24.0-255,4320,60220,92,105546
8760,0.000679,172.31.47.0-255,66,60286,92,105546
8761,0.000718,172.31.47.0-255,66,60352,92,105546
8762,0.000725,74.125.24.0-255,6438,66790,92,105546
8763,0.000727,172.31.47.0-255,66,66856,92,105546
8764,0.001655,74.125.24.0-255,1484,68340,92,105546
8765,0.001665,74.125.24.0-255,2902,71242,92,105546
8766,0.001668,172.31.47.0-255,66,71308,92,105546
8767,0.001674,74.125.24.0-255,5738,77046,92,105546
8768,0.001676,172.31.47.0-255,66,77112,92,105546
8769,0.001725,172.31.47.0-255,66,77178,92,105546
8770,0.001762,74.125.24.0-255,7156,84334,92,105546
8771,0.001764,172.31.47.0-255,66,84400,92,105546
8772,0.00178,74.125.24.0-255,3602,88002,92,105546
8773,0.001782,172.31.47.0-255,66,88068,92,105546
8774,0.004271,74.125.24.0-255,1484,89552,92,105546
8775,0.004285,74.125.24.0-255,4320,93872,92,105546
8776,0.004287,172.31.47.0-255,66,93938,92,105546
8777,0.00679,74.125.24.0-255,5738,99676,92,105546
8778,0.006796,172.31.47.0-255,66,99742,92,105546
8779,0.009346,74.125.24.0-255,5738,105480,92,105546
8780,0.009354,172.31.47.0-255,66,105546,92,105546
8781,0.0,74.125.24.0-255,153,153,92,185444
8782,2.4e-05,172.31.47.0-255,66,219,92,185444
8783,2.9e-05,74.125.24.0-255,1484,1703,92,185444
8784,3.3e-05,172.31.47.0-255,66,1769,92,185444
8785,3.7e-05,74.125.24.0-255,2902,4671,92,185444
8786,3.9e-05,172.31.47.0-255,66,4737,92,185444
8787,6.4e-05,74.125.24.0-255,1484,6221,92,185444
8788,6.9e-05,172.31.47.0-255,66,6287,92,185444
8789,9.7e-05,74.125.24.0-255,2902,9189,92,185444
8790,0.0001,172.31.47.0-255,66,9255,92,185444
8791,0.000125,74.125.24.0-255,2902,12157,92,185444
8792,0.000127,172.31.47.0-255,66,12223,92,185444
8793,0.000158,74.125.24.0-255,2209,14432,92,185444
8794,0.000162,172.31.47.0-255,66,14498,92,185444
8795,0.000166,74.125.24.0-255,1484,15982,92,185444
8796,0.000168,172.31.47.0-255,66,16048,92,185444
8797,0.000172,74.125.24.0-255,2902,18950,92,185444
8798,0.000173,172.31.47.0-255,66,19016,92,185444
8799,0.000207,74.125.24.0-255,5738,24754,92,185444
8800,0.00021,172.31.47.0-255,66,24820,92,185444
8801,0.000216,74.125.24.0-255,6797,31617,92,185444
8802,0.000218,172.31.47.0-255,66,31683,92,185444
8803,0.00022,74.125.24.0-255,1484,33167,92,185444
8804,0.000222,172.31.47.0-255,66,33233,92,185444
8805,0.000251,74.125.24.0-255,5738,38971,92,185444
8806,0.000254,172.31.47.0-255,66,39037,92,185444
8807,0.00026,74.125.24.0-255,5738,44775,92,185444
8808,0.000262,172.31.47.0-255,66,44841,92,185444
8809,0.000287,74.125.24.0-255,3961,48802,92,185444
8810,0.00029,172.31.47.0-255,66,48868,92,185444
8811,0.000326,74.125.24.0-255,1484,50352,92,185444
8812,0.000329,172.31.47.0-255,66,50418,92,185444
8813,0.000333,74.125.24.0-255,2902,53320,92,185444
8814,0.000335,172.31.47.0-255,66,53386,92,185444
8815,0.000354,74.125.24.0-255,4320,57706,92,185444
8816,0.000357,172.31.47.0-255,66,57772,92,185444
8817,0.00038,74.125.24.0-255,4320,62092,92,185444
8818,0.000383,172.31.47.0-255,66,62158,92,185444
8819,0.000403,74.125.24.0-255,1484,63642,92,185444
8820,0.000405,172.31.47.0-255,66,63708,92,185444
8821,0.000408,74.125.24.0-255,2818,66526,92,185444
8822,0.000414,172.31.47.0-255,66,66592,92,185444
8823,0.000703,74.125.24.0-255,130,66722,92,185444
8824,0.000708,172.31.47.0-255,66,66788,92,185444
8825,0.000832,74.125.24.0-255,1484,68272,92,185444
8826,0.000837,172.31.47.0-255,66,68338,92,185444
8827,0.000846,74.125.24.0-255,2902,71240,92,185444
8828,0.000855,172.31.47.0-255,66,71306,92,185444
8829,0.00086,74.125.24.0-255,2902,74208,92,185444
8830,0.000862,172.31.47.0-255,66,74274,92,185444
8831,0.000895,74.125.24.0-255,2902,77176,92,185444
8832,0.000897,172.31.47.0-255,66,77242,92,185444
8833,0.000919,74.125.24.0-255,1484,78726,92,185444
8834,0.000939,172.31.47.0-255,66,78792,92,185444
8835,0.000944,74.125.24.0-255,2902,81694,92,185444
8836,0.000946,172.31.47.0-255,66,81760,92,185444
8837,0.000973,74.125.24.0-255,7156,88916,92,185444
8838,0.000977,172.31.47.0-255,66,88982,92,185444
8839,0.001004,74.125.24.0-255,2543,91525,92,185444
8840,0.001008,172.31.47.0-255,66,91591,92,185444
8841,0.001072,74.125.24.0-255,1484,93075,92,185444
8842,0.001079,74.125.24.0-255,2902,95977,92,185444
8843,0.001082,172.31.47.0-255,66,96043,92,185444
8844,0.001085,74.125.24.0-255,1484,97527,92,185444
8845,0.001112,74.125.24.0-255,4320,101847,92,185444
8846,0.001115,172.31.47.0-255,66,101913,92,185444
8847,0.001121,74.125.24.0-255,4320,106233,92,185444
8848,0.001123,172.31.47.0-255,66,106299,92,185444
8849,0.001148,74.125.24.0-255,4320,110619,92,185444
8850,0.001152,172.31.47.0-255,66,110685,92,185444
8851,0.001193,74.125.24.0-255,5301,115986,92,185444
8852,0.00122,172.31.47.0-255,66,116052,92,185444
8853,0.001476,74.125.24.0-255,1484,117536,92,185444
8854,0.001482,74.125.24.0-255,1484,119020,92,185444
8855,0.001486,172.31.47.0-255,66,119086,92,185444
8856,0.001504,74.125.24.0-255,1484,120570,92,185444
8857,0.001511,74.125.24.0-255,5738,126308,92,185444
8858,0.001513,172.31.47.0-255,66,126374,92,185444
8859,0.001555,74.125.24.0-255,2902,129276,92,185444
8860,0.001558,172.31.47.0-255,66,129342,92,185444
8861,0.001569,74.125.24.0-255,5738,135080,92,185444
8862,0.001576,172.31.47.0-255,66,135146,92,185444
8863,0.001588,74.125.24.0-255,1484,136630,92,185444
8864,0.001597,74.125.24.0-255,5020,141650,92,185444
8865,0.00161,172.31.47.0-255,66,141716,92,185444
8866,0.002301,74.125.24.0-255,1484,143200,92,185444
8867,0.00231,74.125.24.0-255,2902,146102,92,185444
8868,0.002313,172.31.47.0-255,66,146168,92,185444
8869,0.002345,74.125.24.0-255,5738,151906,92,185444
8870,0.002347,172.31.47.0-255,66,151972,92,185444
8871,0.002373,74.125.24.0-255,7156,159128,92,185444
8872,0.002375,172.31.47.0-255,66,159194,92,185444
8873,0.0024,74.125.24.0-255,5738,164932,92,185444
8874,0.002403,74.125.24.0-255,2902,167834,92,185444
8875,0.002406,172.31.47.0-255,66,167900,92,185444
8876,0.002408,172.31.47.0-255,66,167966,92,185444
8877,0.004759,74.125.24.0-255,1484,169450,92,185444
8878,0.004783,74.125.24.0-255,4320,173770,92,185444
8879,0.004787,172.31.47.0-255,66,173836,92,185444
8880,0.007173,74.125.24.0-255,5738,179574,92,185444
8881,0.007179,172.31.47.0-255,66,179640,92,185444
8882,0.009514,74.125.24.0-255,5738,185378,92,185444
8883,0.009527,172.31.47.0-255,66,185444,92,185444
8884,0.0,172.217.194.0-255,153,153,92,204684
8885,2.4e-05,172.31.47.0-255,66,219,92,204684
8886,3.1e-05,172.217.194.0-255,1484,1703,92,204684
8887,3.6e-05,172.31.47.0-255,66,1769,92,204684
8888,4.2e-05,172.217.194.0-255,2902,4671,92,204684
8889,4.5e-05,172.31.47.0-255,66,4737,92,204684
8890,5.3e-05,172.217.194.0-255,7156,11893,92,204684
8891,5.5e-05,172.31.47.0-255,66,11959,92,204684
8892,6e-05,172.217.194.0-255,2100,14059,92,204684
8893,6.2e-05,172.31.47.0-255,66,14125,92,204684
8894,0.000123,172.217.194.0-255,1484,15609,92,204684
8895,0.000125,172.31.47.0-255,66,15675,92,204684
8896,0.00013,172.217.194.0-255,2902,18577,92,204684
8897,0.000132,172.31.47.0-255,66,18643,92,204684
8898,0.000152,172.217.194.0-255,5738,24381,92,204684
8899,0.000154,172.31.47.0-255,66,24447,92,204684
8900,0.000193,172.217.194.0-255,2902,27349,92,204684
8901,0.000196,172.31.47.0-255,66,27415,92,204684
8902,0.000215,172.217.194.0-255,6797,34212,92,204684
8903,0.000218,172.31.47.0-255,66,34278,92,204684
8904,0.000229,172.31.47.0-255,66,34344,92,204684
8905,0.000256,172.217.194.0-255,3961,38305,92,204684
8906,0.000259,172.31.47.0-255,66,38371,92,204684
8907,0.000426,172.217.194.0-255,1484,39855,92,204684
8908,0.00043,172.31.47.0-255,66,39921,92,204684
8909,0.000447,172.217.194.0-255,2902,42823,92,204684
8910,0.00045,172.31.47.0-255,66,42889,92,204684
8911,0.000457,172.217.194.0-255,5738,48627,92,204684
8912,0.00046,172.31.47.0-255,66,48693,92,204684
8913,0.000511,172.217.194.0-255,4320,53013,92,204684
8914,0.000515,172.31.47.0-255,66,53079,92,204684
8915,0.000535,172.217.194.0-255,3124,56203,92,204684
8916,0.000539,172.217.194.0-255,1484,57687,92,204684
8917,0.000549,172.31.47.0-255,66,57753,92,204684
8918,0.000566,172.217.194.0-255,2902,60655,92,204684
8919,0.000572,172.217.194.0-255,5738,66393,92,204684
8920,0.000583,172.31.47.0-255,66,66459,92,204684
8921,0.000628,172.31.47.0-255,66,66525,92,204684
8922,0.000705,172.217.194.0-255,1484,68009,92,204684
8923,0.00071,172.217.194.0-255,2902,70911,92,204684
8924,0.000715,172.217.194.0-255,4320,75231,92,204684
8925,0.000739,172.31.47.0-255,66,75297,92,204684
8926,0.000743,172.217.194.0-255,1484,76781,92,204684
8927,0.00076,172.31.47.0-255,66,76847,92,204684
8928,0.000843,172.217.194.0-255,1484,78331,92,204684
8929,0.000847,172.217.194.0-255,2902,81233,92,204684
8930,0.000853,172.217.194.0-255,5738,86971,92,204684
8931,0.000858,172.217.194.0-255,2902,89873,92,204684
8932,0.000866,172.31.47.0-255,66,89939,92,204684
8933,0.000903,172.31.47.0-255,66,90005,92,204684
8934,0.000951,172.31.47.0-255,66,90071,92,204684
8935,0.000963,172.217.194.0-255,3602,93673,92,204684
8936,0.000965,172.217.194.0-255,1484,95157,92,204684
8937,0.000976,172.217.194.0-255,4320,99477,92,204684
8938,0.000988,172.217.194.0-255,4320,103797,92,204684
8939,0.000997,172.217.194.0-255,1484,105281,92,204684
8940,0.001001,172.217.194.0-255,2902,108183,92,204684
8941,0.001026,172.31.47.0-255,66,108249,92,204684
8942,0.001056,172.217.194.0-255,2902,111151,92,204684
8943,0.001059,172.217.194.0-255,2902,114053,92,204684
8944,0.001068,172.217.194.0-255,1484,115537,92,204684
8945,0.001081,172.31.47.0-255,66,115603,92,204684
8946,0.001105,172.217.194.0-255,5738,121341,92,204684
8947,0.001114,172.31.47.0-255,66,121407,92,204684
8948,0.001124,172.217.194.0-255,4320,125727,92,204684
8949,0.001142,172.31.47.0-255,66,125793,92,204684
8950,0.001158,172.217.194.0-255,5738,131531,92,204684
8951,0.00117,172.217.194.0-255,2184,133715,92,204684
8952,0.001179,172.31.47.0-255,66,133781,92,204684
8953,0.001815,172.217.194.0-255,1484,135265,92,204684
8954,0.001821,172.217.194.0-255,2902,138167,92,204684
8955,0.001824,172.31.47.0-255,66,138233,92,204684
8956,0.001848,172.217.194.0-255,5738,143971,92,204684
8957,0.001851,172.31.47.0-255,66,144037,92,204684
8958,0.001855,172.217.194.0-255,2902,146939,92,204684
8959,0.001863,172.31.47.0-255,66,147005,92,204684
8960,0.001875,172.217.194.0-255,2902,149907,92,204684
8961,0.001887,172.217.194.0-255,7156,157063,92,204684
8962,0.001904,172.31.47.0-255,66,157129,92,204684
8963,0.001912,172.217.194.0-255,2902,160031,92,204684
8964,0.001916,172.31.47.0-255,66,160097,92,204684
8965,0.001927,172.217.194.0-255,5738,165835,92,204684
8966,0.001947,172.217.194.0-255,2184,168019,92,204684
8967,0.001951,172.217.194.0-255,4320,172339,92,204684
8968,0.001961,172.31.47.0-255,66,172405,92,204684
8969,0.00198,172.217.194.0-255,7156,179561,92,204684
8970,0.001985,172.217.194.0-255,4320,183881,92,204684
8971,0.00199,172.31.47.0-255,66,183947,92,204684
8972,0.002087,172.31.47.0-255,66,184013,92,204684
8973,0.00211,172.217.194.0-255,766,184779,92,204684
8974,0.002116,172.217.194.0-255,5738,190517,92,204684
8975,0.002141,172.217.194.0-255,1484,192001,92,204684
8976,0.002191,172.31.47.0-255,66,192067,92,204684
8977,0.002227,172.31.47.0-255,66,192133,92,204684
8978,0.002265,172.217.194.0-255,7156,199289,92,204684
8979,0.002285,172.31.47.0-255,66,199355,92,204684
8980,0.002291,172.217.194.0-255,5158,204513,92,204684
8981,0.002294,172.217.194.0-255,105,204618,92,204684
8982,0.002305,172.31.47.0-255,66,204684,92,204684
8983,0.0,172.217.194.0-255,153,153,92,241298
8984,1.5e-05,172.31.47.0-255,66,219,92,241298
8985,2.1e-05,172.217.194.0-255,1484,1703,92,241298
8986,2.5e-05,172.31.47.0-255,66,1769,92,241298
8987,3.7e-05,172.217.194.0-255,2902,4671,92,241298
8988,4e-05,172.31.47.0-255,66,4737,92,241298
8989,7.7e-05,172.217.194.0-255,7156,11893,92,241298
8990,7.9e-05,172.31.47.0-255,66,11959,92,241298
8991,8.3e-05,172.217.194.0-255,2254,14213,92,241298
8992,8.5e-05,172.31.47.0-255,66,14279,92,241298
8993,0.000126,172.31.47.0-255,66,14345,92,241298
8994,0.000156,172.217.194.0-255,2902,17247,92,241298
8995,0.000158,172.31.47.0-255,66,17313,92,241298
8996,0.000179,172.217.194.0-255,2543,19856,92,241298
8997,0.000181,172.31.47.0-255,66,19922,92,241298
8998,0.000186,172.217.194.0-255,4320,24242,92,241298
8999,0.000188,172.31.47.0-255,66,24308,92,241298
9000,0.000218,172.217.194.0-255,1484,25792,92,241298
9001,0.00022,172.31.47.0-255,66,25858,92,241298
9002,0.000233,172.31.47.0-255,66,25924,92,241298
9003,0.000246,172.31.47.0-255,66,25990,92,241298
9004,0.000274,172.217.194.0-255,2902,28892,92,241298
9005,0.000276,172.31.47.0-255,66,28958,92,241298
9006,0.000282,172.217.194.0-255,5650,34608,92,241298
9007,0.000284,172.31.47.0-255,66,34674,92,241298
9008,0.000438,172.217.194.0-255,119,34793,92,241298
9009,0.000442,172.31.47.0-255,66,34859,92,241298
9010,0.000466,172.217.194.0-255,383,35242,92,241298
9011,0.000468,172.31.47.0-255,66,35308,92,241298
9012,0.000697,172.217.194.0-255,1484,36792,92,241298
9013,0.000703,172.217.194.0-255,2902,39694,92,241298
9014,0.000708,172.217.194.0-255,5738,45432,92,241298
9015,0.000741,172.31.47.0-255,66,45498,92,241298
9016,0.000748,172.217.194.0-255,7156,52654,92,241298
9017,0.00075,172.217.194.0-255,1484,54138,92,241298
9018,0.000755,172.31.47.0-255,66,54204,92,241298
9019,0.000795,172.217.194.0-255,2184,56388,92,241298
9020,0.000805,172.31.47.0-255,66,56454,92,241298
9021,0.001014,172.217.194.0-255,1484,57938,92,241298
9022,0.001027,172.217.194.0-255,2902,60840,92,241298
9023,0.00103,172.31.47.0-255,66,60906,92,241298
9024,0.001033,172.217.194.0-255,1484,62390,92,241298
9025,0.001055,172.217.194.0-255,4320,66710,92,241298
9026,0.001068,172.217.194.0-255,2902,69612,92,241298
9027,0.001071,172.31.47.0-255,66,69678,92,241298
9028,0.00111,172.31.47.0-255,66,69744,92,241298
9029,0.001119,172.217.194.0-255,4320,74064,92,241298
9030,0.001131,172.217.194.0-255,2902,76966,92,241298
9031,0.001143,172.217.194.0-255,3602,80568,92,241298
9032,0.001149,172.31.47.0-255,66,80634,92,241298
9033,0.001178,172.217.194.0-255,1484,82118,92,241298
9034,0.001181,172.217.194.0-255,1484,83602,92,241298
9035,0.001195,172.217.194.0-255,1484,85086,92,241298
9036,0.001197,172.31.47.0-255,66,85152,92,241298
9037,0.001213,172.217.194.0-255,2902,88054,92,241298
9038,0.00122,172.217.194.0-255,5738,93792,92,241298
9039,0.001225,172.31.47.0-255,66,93858,92,241298
9040,0.001231,172.217.194.0-255,1484,95342,92,241298
9041,0.001236,172.217.194.0-255,5738,101080,92,241298
9042,0.00126,172.217.194.0-255,3602,104682,92,241298
9043,0.001269,172.31.47.0-255,66,104748,92,241298
9044,0.001334,172.217.194.0-255,1484,106232,92,241298
9045,0.001345,172.217.194.0-255,1484,107716,92,241298
9046,0.001356,172.217.194.0-255,1484,109200,92,241298
9047,0.001359,172.217.194.0-255,2902,112102,92,241298
9048,0.001366,172.31.47.0-255,66,112168,92,241298
9049,0.001376,172.217.194.0-255,2902,115070,92,241298
9050,0.001388,172.31.47.0-255,66,115136,92,241298
9051,0.001416,172.31.47.0-255,66,115202,92,241298
9052,0.001423,172.217.194.0-255,2902,118104,92,241298
9053,0.00144,172.217.194.0-255,1484,119588,92,241298
9054,0.001444,172.31.47.0-255,66,119654,92,241298
9055,0.001482,172.217.194.0-255,1484,121138,92,241298
9056,0.001488,172.31.47.0-255,66,121204,92,241298
9057,0.001502,172.217.194.0-255,2902,124106,92,241298
9058,0.001505,172.217.194.0-255,1484,125590,92,241298
9059,0.001521,172.217.194.0-255,4320,129910,92,241298
9060,0.001524,172.31.47.0-255,66,129976,92,241298
9061,0.001532,172.217.194.0-255,2902,132878,92,241298
9062,0.001535,172.31.47.0-255,66,132944,92,241298
9063,0.001569,172.31.47.0-255,66,133010,92,241298
9064,0.001576,172.217.194.0-255,2902,135912,92,241298
9065,0.001579,172.31.47.0-255,66,135978,92,241298
9066,0.001599,172.217.194.0-255,7156,143134,92,241298
9067,0.001609,172.31.47.0-255,66,143200,92,241298
9068,0.001663,172.217.194.0-255,2184,145384,92,241298
9069,0.001669,172.31.47.0-255,66,145450,92,241298
9070,0.001731,172.217.194.0-255,1484,146934,92,241298
9071,0.001735,172.217.194.0-255,2902,149836,92,241298
9072,0.001737,172.217.194.0-255,1484,151320,92,241298
9073,0.001747,172.31.47.0-255,66,151386,92,241298
9074,0.001755,172.217.194.0-255,4320,155706,92,241298
9075,0.001759,172.217.194.0-255,4320,160026,92,241298
9076,0.001771,172.217.194.0-255,4320,164346,92,241298
9077,0.001788,172.217.194.0-255,7156,171502,92,241298
9078,0.001819,172.217.194.0-255,2902,174404,92,241298
9079,0.001831,172.217.194.0-255,5020,179424,92,241298
9080,0.001893,172.217.194.0-255,1484,180908,92,241298
9081,0.001905,172.217.194.0-255,2902,183810,92,241298
9082,0.001917,172.217.194.0-255,2902,186712,92,241298
9083,0.001935,172.217.194.0-255,2902,189614,92,241298
9084,0.001938,172.217.194.0-255,1484,191098,92,241298
9085,0.00207,172.217.194.0-255,5738,196836,92,241298
9086,0.002096,172.217.194.0-255,2184,199020,92,241298
9087,0.0021,172.217.194.0-255,1484,200504,92,241298
9088,0.002106,172.217.194.0-255,2902,203406,92,241298
9089,0.002115,172.217.194.0-255,5738,209144,92,241298
9090,0.002136,172.217.194.0-255,1484,210628,92,241298
9091,0.002156,172.217.194.0-255,5738,216366,92,241298
9092,0.002178,172.217.194.0-255,2902,219268,92,241298
9093,0.002182,172.217.194.0-255,766,220034,92,241298
9094,0.002236,172.217.194.0-255,1484,221518,92,241298
9095,0.002252,172.217.194.0-255,2902,224420,92,241298
9096,0.002257,172.217.194.0-255,4320,228740,92,241298
9097,0.002272,172.217.194.0-255,1484,230224,92,241298
9098,0.002281,172.217.194.0-255,7156,237380,92,241298
9099,0.002291,172.217.194.0-255,1484,238864,92,241298
9100,0.002371,172.217.194.0-255,2329,241193,92,241298
9101,0.002395,172.217.194.0-255,105,241298,92,241298
9102,0.0,172.31.47.0-255,105,105,92,276
9103,0.00149,157.240.13.0-255,105,210,92,276
9104,0.001504,172.31.47.0-255,66,276,92,276
9105,0.0,172.31.47.0-255,66,66,92,66
9106,0.0,74.125.68.0-255,153,153,92,298321
9107,2.3e-05,172.31.47.0-255,66,219,92,298321
9108,3.1e-05,74.125.68.0-255,1484,1703,92,298321
9109,3.5e-05,172.31.47.0-255,66,1769,92,298321
9110,4.1e-05,74.125.68.0-255,2902,4671,92,298321
9111,5.1e-05,172.31.47.0-255,66,4737,92,298321
9112,5.7e-05,74.125.68.0-255,4320,9057,92,298321
9113,5.9e-05,172.31.47.0-255,66,9123,92,298321
9114,6.7e-05,74.125.68.0-255,7156,16279,92,298321
9115,7e-05,172.31.47.0-255,66,16345,92,298321
9116,9e-05,74.125.68.0-255,2006,18351,92,298321
9117,9.3e-05,172.31.47.0-255,66,18417,92,298321
9118,0.000103,74.125.68.0-255,4320,22737,92,298321
9119,0.000105,172.31.47.0-255,66,22803,92,298321
9120,0.000149,172.31.47.0-255,66,22869,92,298321
9121,0.00021,74.125.68.0-255,1484,24353,92,298321
9122,0.000213,172.31.47.0-255,66,24419,92,298321
9123,0.000218,74.125.68.0-255,1484,25903,92,298321
9124,0.00022,172.31.47.0-255,66,25969,92,298321
9125,0.000248,74.125.68.0-255,2902,28871,92,298321
9126,0.00025,172.31.47.0-255,66,28937,92,298321
9127,0.000257,74.125.68.0-255,5738,34675,92,298321
9128,0.000259,172.31.47.0-255,66,34741,92,298321
9129,0.000286,74.125.68.0-255,6797,41538,92,298321
9130,0.000289,172.31.47.0-255,66,41604,92,298321
9131,0.000294,74.125.68.0-255,4320,45924,92,298321
9132,0.000297,172.31.47.0-255,66,45990,92,298321
9133,0.000318,74.125.68.0-255,2902,48892,92,298321
9134,0.000325,172.31.47.0-255,66,48958,92,298321
9135,0.000331,74.125.68.0-255,5738,54696,92,298321
9136,0.000334,172.31.47.0-255,66,54762,92,298321
9137,0.000366,74.125.68.0-255,2814,57576,92,298321
9138,0.000368,172.31.47.0-255,66,57642,92,298321
9139,0.000371,74.125.68.0-255,385,58027,92,298321
9140,0.000422,74.125.68.0-255,1484,59511,92,298321
9141,0.000424,172.31.47.0-255,66,59577,92,298321
9142,0.000442,74.125.68.0-255,2902,62479,92,298321
9143,0.000445,172.31.47.0-255,66,62545,92,298321
9144,0.00045,74.125.68.0-255,4320,66865,92,298321
9145,0.000453,172.31.47.0-255,66,66931,92,298321
9146,0.000481,74.125.68.0-255,1484,68415,92,298321
9147,0.000489,74.125.68.0-255,6797,75212,92,298321
9148,0.000492,172.31.47.0-255,66,75278,92,298321
9149,0.000495,74.125.68.0-255,1484,76762,92,298321
9150,0.000523,74.125.68.0-255,5738,82500,92,298321
9151,0.000525,172.31.47.0-255,66,82566,92,298321
9152,0.000533,74.125.68.0-255,7156,89722,92,298321
9153,0.000535,172.31.47.0-255,66,89788,92,298321
9154,0.000554,74.125.68.0-255,2543,92331,92,298321
9155,0.000557,172.31.47.0-255,66,92397,92,298321
9156,0.000914,74.125.68.0-255,1484,93881,92,298321
9157,0.000931,74.125.68.0-255,2902,96783,92,298321
9158,0.000935,172.31.47.0-255,66,96849,92,298321
9159,0.000969,74.125.68.0-255,5738,102587,92,298321
9160,0.000971,172.31.47.0-255,66,102653,92,298321
9161,0.000976,74.125.68.0-255,2902,105555,92,298321
9162,0.000978,172.31.47.0-255,66,105621,92,298321
9163,0.000988,74.125.68.0-255,4320,109941,92,298321
9164,0.000991,172.31.47.0-255,66,110007,92,298321
9165,0.000996,74.125.68.0-255,4320,114327,92,298321
9166,0.000998,172.31.47.0-255,66,114393,92,298321
9167,0.001033,74.125.68.0-255,4320,118713,92,298321
9168,0.001037,172.31.47.0-255,66,118779,92,298321
9169,0.001043,74.125.68.0-255,4320,123099,92,298321
9170,0.001045,172.31.47.0-255,66,123165,92,298321
9171,0.001074,74.125.68.0-255,3602,126767,92,298321
9172,0.001076,172.31.47.0-255,66,126833,92,298321
9173,0.0011,74.125.68.0-255,4320,131153,92,298321
9174,0.001103,74.125.68.0-255,1484,132637,92,298321
9175,0.001107,172.31.47.0-255,66,132703,92,298321
9176,0.001116,74.125.68.0-255,1484,134187,92,298321
9177,0.001118,172.31.47.0-255,66,134253,92,298321
9178,0.001127,74.125.68.0-255,4320,138573,92,298321
9179,0.00113,172.31.47.0-255,66,138639,92,298321
9180,0.001168,172.31.47.0-255,66,138705,92,298321
9181,0.001173,74.125.68.0-255,2902,141607,92,298321
9182,0.001175,172.31.47.0-255,66,141673,92,298321
9183,0.001181,74.125.68.0-255,4320,145993,92,298321
9184,0.001183,172.31.47.0-255,66,146059,92,298321
9185,0.001214,74.125.68.0-255,6438,152497,92,298321
9186,0.001217,172.31.47.0-255,66,152563,92,298321
9187,0.001279,74.125.68.0-255,1484,154047,92,298321
9188,0.001293,74.125.68.0-255,2902,156949,92,298321
9189,0.001296,172.31.47.0-255,66,157015,92,298321
9190,0.001326,74.125.68.0-255,4320,161335,92,298321
9191,0.001329,172.31.47.0-255,66,161401,92,298321
9192,0.001336,74.125.68.0-255,5738,167139,92,298321
9193,0.001338,172.31.47.0-255,66,167205,92,298321
9194,0.001365,172.31.47.0-255,66,167271,92,298321
9195,0.001385,74.125.68.0-255,1484,168755,92,298321
9196,0.001395,74.125.68.0-255,4320,173075,92,298321
9197,0.001398,172.31.47.0-255,66,173141,92,298321
9198,0.001431,74.125.68.0-255,3602,176743,92,298321
9199,0.001436,172.31.47.0-255,66,176809,92,298321
9200,0.001475,74.125.68.0-255,1484,178293,92,298321
9201,0.00149,74.125.68.0-255,2902,181195,92,298321
9202,0.001533,172.31.47.0-255,66,181261,92,298321
9203,0.001563,74.125.68.0-255,5738,186999,92,298321
9204,0.001567,172.31.47.0-255,66,187065,92,298321
9205,0.001572,74.125.68.0-255,2902,189967,92,298321
9206,0.001574,172.31.47.0-255,66,190033,92,298321
9207,0.001591,172.31.47.0-255,66,190099,92,298321
9208,0.001601,172.31.47.0-255,66,190165,92,298321
9209,0.001604,74.125.68.0-255,766,190931,92,298321
9210,0.001747,74.125.68.0-255,1484,192415,92,298321
9211,0.001751,172.31.47.0-255,66,192481,92,298321
9212,0.001757,74.125.68.0-255,2902,195383,92,298321
9213,0.001759,172.31.47.0-255,66,195449,92,298321
9214,0.001768,74.125.68.0-255,2902,198351,92,298321
9215,0.00177,172.31.47.0-255,66,198417,92,298321
9216,0.001801,74.125.68.0-255,4320,202737,92,298321
9217,0.001803,172.31.47.0-255,66,202803,92,298321
9218,0.001824,172.31.47.0-255,66,202869,92,298321
9219,0.001831,74.125.68.0-255,5738,208607,92,298321
9220,0.001833,172.31.47.0-255,66,208673,92,298321
9221,0.001836,74.125.68.0-255,1484,210157,92,298321
9222,0.001872,74.125.68.0-255,5738,215895,92,298321
9223,0.001875,172.31.47.0-255,66,215961,92,298321
9224,0.001882,74.125.68.0-255,5020,220981,92,298321
9225,0.001884,172.31.47.0-255,66,221047,92,298321
9226,0.001895,74.125.68.0-255,5738,226785,92,298321
9227,0.001898,172.31.47.0-255,66,226851,92,298321
9228,0.001955,172.31.47.0-255,66,226917,92,298321
9229,0.00198,74.125.68.0-255,2902,229819,92,298321
9230,0.001983,172.31.47.0-255,66,229885,92,298321
9231,0.002018,172.31.47.0-255,66,229951,92,298321
9232,0.002028,172.31.47.0-255,66,230017,92,298321
9233,0.002044,74.125.68.0-255,2902,232919,92,298321
9234,0.002046,172.31.47.0-255,66,232985,92,298321
9235,0.002049,74.125.68.0-255,1484,234469,92,298321
9236,0.002087,172.31.47.0-255,66,234535,92,298321
9237,0.002094,74.125.68.0-255,7156,241691,92,298321
9238,0.002096,172.31.47.0-255,66,241757,92,298321
9239,0.002113,74.125.68.0-255,4320,246077,92,298321
9240,0.002115,172.31.47.0-255,66,246143,92,298321
9241,0.002139,74.125.68.0-255,3602,249745,92,298321
9242,0.002146,172.31.47.0-255,66,249811,92,298321
9243,0.002151,74.125.68.0-255,2902,252713,92,298321
9244,0.002153,172.31.47.0-255,66,252779,92,298321
9245,0.00218,172.31.47.0-255,66,252845,92,298321
9246,0.002208,74.125.68.0-255,1484,254329,92,298321
9247,0.002214,74.125.68.0-255,4320,258649,92,298321
9248,0.002216,172.31.47.0-255,66,258715,92,298321
9249,0.002245,74.125.68.0-255,7156,265871,92,298321
9250,0.002248,172.31.47.0-255,66,265937,92,298321
9251,0.002273,172.31.47.0-255,66,266003,92,298321
9252,0.002317,172.31.47.0-255,66,266069,92,298321
9253,0.002349,74.125.68.0-255,5738,271807,92,298321
9254,0.002353,172.31.47.0-255,66,271873,92,298321
9255,0.002359,74.125.68.0-255,5738,277611,92,298321
9256,0.002361,172.31.47.0-255,66,277677,92,298321
9257,0.002365,74.125.68.0-255,2902,280579,92,298321
9258,0.002367,172.31.47.0-255,66,280645,92,298321
9259,0.004662,74.125.68.0-255,5738,286383,92,298321
9260,0.004669,172.31.47.0-255,66,286449,92,298321
9261,0.006953,74.125.68.0-255,2902,289351,92,298321
9262,0.006956,172.31.47.0-255,66,289417,92,298321
9263,0.006974,74.125.68.0-255,2902,292319,92,298321
9264,0.006975,172.31.47.0-255,66,292385,92,298321
9265,0.009248,74.125.68.0-255,2902,295287,92,298321
9266,0.009253,172.31.47.0-255,66,295353,92,298321
9267,0.009281,74.125.68.0-255,2902,298255,92,298321
9268,0.009284,172.31.47.0-255,66,298321,92,298321
9269,0.0,74.125.24.0-255,373,373,92,49596
9270,3.1e-05,172.31.47.0-255,66,439,92,49596
9271,3.7e-05,74.125.24.0-255,1484,1923,92,49596
9272,4.2e-05,172.31.47.0-255,66,1989,92,49596
9273,5.8e-05,74.125.24.0-255,4320,6309,92,49596
9274,6e-05,172.31.47.0-255,66,6375,92,49596
9275,0.000224,74.125.24.0-255,4320,10695,92,49596
9276,0.000229,172.31.47.0-255,66,10761,92,49596
9277,0.000395,74.125.24.0-255,4320,15081,92,49596
9278,0.000401,172.31.47.0-255,66,15147,92,49596
9279,0.000413,74.125.24.0-255,6153,21300,92,49596
9280,0.000416,172.31.47.0-255,66,21366,92,49596
9281,0.000822,74.125.24.0-255,5738,27104,92,49596
9282,0.000827,172.31.47.0-255,66,27170,92,49596
9283,0.001045,74.125.24.0-255,4156,31326,92,49596
9284,0.00105,172.31.47.0-255,66,31392,92,49596
9285,0.003175,74.125.24.0-255,1484,32876,92,49596
9286,0.003182,172.31.47.0-255,66,32942,92,49596
9287,0.003404,74.125.24.0-255,2902,35844,92,49596
9288,0.003408,172.31.47.0-255,66,35910,92,49596
9289,0.003425,74.125.24.0-255,1484,37394,92,49596
9290,0.003427,172.31.47.0-255,66,37460,92,49596
9291,0.005538,74.125.24.0-255,1484,38944,92,49596
9292,0.005545,172.31.47.0-255,66,39010,92,49596
9293,0.005751,74.125.24.0-255,2902,41912,92,49596
9294,0.005755,172.31.47.0-255,66,41978,92,49596
9295,0.005793,74.125.24.0-255,1484,43462,92,49596
9296,0.005796,172.31.47.0-255,66,43528,92,49596
9297,0.007897,74.125.24.0-255,1484,45012,92,49596
9298,0.007904,172.31.47.0-255,66,45078,92,49596
9299,0.008074,74.125.24.0-255,1484,46562,92,49596
9300,0.00808,172.31.47.0-255,66,46628,92,49596
9301,0.008126,74.125.24.0-255,2902,49530,92,49596
9302,0.008131,172.31.47.0-255,66,49596,92,49596
9303,0.0,74.125.24.0-255,152,152,92,100202
9304,2.5e-05,172.31.47.0-255,66,218,92,100202
9305,3.2e-05,74.125.24.0-255,1484,1702,92,100202
9306,3.6e-05,172.31.47.0-255,66,1768,92,100202
9307,4e-05,74.125.24.0-255,2902,4670,92,100202
9308,4.9e-05,172.31.47.0-255,66,4736,92,100202
9309,5.3e-05,74.125.24.0-255,2902,7638,92,100202
9310,5.5e-05,172.31.47.0-255,66,7704,92,100202
9311,7.8e-05,74.125.24.0-255,4320,12024,92,100202
9312,8.1e-05,172.31.47.0-255,66,12090,92,100202
9313,0.000102,74.125.24.0-255,2172,14262,92,100202
9314,0.000105,172.31.47.0-255,66,14328,92,100202
9315,0.000108,74.125.24.0-255,2902,17230,92,100202
9316,0.00011,172.31.47.0-255,66,17296,92,100202
9317,0.000134,74.125.24.0-255,4320,21616,92,100202
9318,0.000141,172.31.47.0-255,66,21682,92,100202
9319,0.000159,74.125.24.0-255,2902,24584,92,100202
9320,0.000162,172.31.47.0-255,66,24650,92,100202
9321,0.000169,74.125.24.0-255,6797,31447,92,100202
9322,0.000171,172.31.47.0-255,66,31513,92,100202
9323,0.000305,74.125.24.0-255,1484,32997,92,100202
9324,0.00031,172.31.47.0-255,66,33063,92,100202
9325,0.000316,74.125.24.0-255,2902,35965,92,100202
9326,0.000318,172.31.47.0-255,66,36031,92,100202
9327,0.000329,74.125.24.0-255,4320,40351,92,100202
9328,0.000333,172.31.47.0-255,66,40417,92,100202
9329,0.000358,74.125.24.0-255,1484,41901,92,100202
9330,0.000361,172.31.47.0-255,66,41967,92,100202
9331,0.000374,172.31.47.0-255,66,42033,92,100202
9332,0.0004,74.125.24.0-255,5738,47771,92,100202
9333,0.000405,172.31.47.0-255,66,47837,92,100202
9334,0.000432,74.125.24.0-255,4320,52157,92,100202
9335,0.000436,172.31.47.0-255,66,52223,92,100202
9336,0.000441,74.125.24.0-255,3961,56184,92,100202
9337,0.000443,172.31.47.0-255,66,56250,92,100202
9338,0.000749,74.125.24.0-255,412,56662,92,100202
9339,0.000785,172.31.47.0-255,66,56728,92,100202
9340,0.000788,74.125.24.0-255,332,57060,92,100202
9341,0.000802,172.31.47.0-255,66,57126,92,100202
9342,0.001322,74.125.24.0-255,1484,58610,92,100202
9343,0.001332,74.125.24.0-255,2902,61512,92,100202
9344,0.001336,172.31.47.0-255,66,61578,92,100202
9345,0.001343,74.125.24.0-255,5738,67316,92,100202
9346,0.001346,172.31.47.0-255,66,67382,92,100202
9347,0.001382,172.31.47.0-255,66,67448,92,100202
9348,0.001389,74.125.24.0-255,5738,73186,92,100202
9349,0.001391,172.31.47.0-255,66,73252,92,100202
9350,0.001422,74.125.24.0-255,5020,78272,92,100202
9351,0.001425,172.31.47.0-255,66,78338,92,100202
9352,0.003618,74.125.24.0-255,5738,84076,92,100202
9353,0.003682,172.31.47.0-255,66,84142,92,100202
9354,0.005714,74.125.24.0-255,4320,88462,92,100202
9355,0.00572,172.31.47.0-255,66,88528,92,100202
9356,0.00575,74.125.24.0-255,1484,90012,92,100202
9357,0.00774,74.125.24.0-255,4320,94332,92,100202
9358,0.007746,172.31.47.0-255,66,94398,92,100202
9359,0.009754,74.125.24.0-255,5738,100136,92,100202
9360,0.009759,172.31.47.0-255,66,100202,92,100202
9361,0.0,172.217.194.0-255,153,153,92,248988
9362,1.6e-05,172.31.47.0-255,66,219,92,248988
9363,2.3e-05,172.217.194.0-255,1484,1703,92,248988
9364,2.7e-05,172.31.47.0-255,66,1769,92,248988
9365,3.3e-05,172.217.194.0-255,2902,4671,92,248988
9366,4.4e-05,172.31.47.0-255,66,4737,92,248988
9367,4.8e-05,172.217.194.0-255,2902,7639,92,248988
9368,5.1e-05,172.31.47.0-255,66,7705,92,248988
9369,7.3e-05,172.217.194.0-255,2902,10607,92,248988
9370,8.1e-05,172.31.47.0-255,66,10673,92,248988
9371,0.000107,172.217.194.0-255,7156,17829,92,248988
9372,0.000111,172.31.47.0-255,66,17895,92,248988
9373,0.000142,172.217.194.0-255,3589,21484,92,248988
9374,0.000146,172.31.47.0-255,66,21550,92,248988
9375,0.000153,172.217.194.0-255,7156,28706,92,248988
9376,0.000155,172.31.47.0-255,66,28772,92,248988
9377,0.000162,172.217.194.0-255,2543,31315,92,248988
9378,0.000164,172.31.47.0-255,66,31381,92,248988
9379,0.000238,172.217.194.0-255,1484,32865,92,248988
9380,0.000241,172.31.47.0-255,66,32931,92,248988
9381,0.000267,172.217.194.0-255,2902,35833,92,248988
9382,0.00027,172.31.47.0-255,66,35899,92,248988
9383,0.000277,172.217.194.0-255,5738,41637,92,248988
9384,0.000279,172.31.47.0-255,66,41703,92,248988
9385,0.000323,172.31.47.0-255,66,41769,92,248988
9386,0.000349,172.217.194.0-255,3961,45730,92,248988
9387,0.000352,172.31.47.0-255,66,45796,92,248988
9388,0.000383,172.217.194.0-255,7156,52952,92,248988
9389,0.000386,172.31.47.0-255,66,53018,92,248988
9390,0.000411,172.217.194.0-255,3132,56150,92,248988
9391,0.000414,172.31.47.0-255,66,56216,92,248988
9392,0.000586,172.217.194.0-255,1484,57700,92,248988
9393,0.000591,172.31.47.0-255,66,57766,92,248988
9394,0.000596,172.217.194.0-255,2902,60668,92,248988
9395,0.000599,172.31.47.0-255,66,60734,92,248988
9396,0.000633,172.217.194.0-255,5738,66472,92,248988
9397,0.000637,172.31.47.0-255,66,66538,92,248988
9398,0.000643,172.217.194.0-255,7156,73694,92,248988
9399,0.000646,172.31.47.0-255,66,73760,92,248988
9400,0.000659,172.217.194.0-255,7156,80916,92,248988
9401,0.000665,172.31.47.0-255,66,80982,92,248988
9402,0.000689,172.217.194.0-255,7156,88138,92,248988
9403,0.000693,172.217.194.0-255,2184,90322,92,248988
9404,0.000748,172.217.194.0-255,1484,91806,92,248988
9405,0.000753,172.217.194.0-255,2902,94708,92,248988
9406,0.000758,172.217.194.0-255,4320,99028,92,248988
9407,0.000773,172.217.194.0-255,1484,100512,92,248988
9408,0.000793,172.31.47.0-255,66,100578,92,248988
9409,0.000827,172.217.194.0-255,4320,104898,92,248988
9410,0.000856,172.31.47.0-255,66,104964,92,248988
9411,0.000868,172.217.194.0-255,4320,109284,92,248988
9412,0.000875,172.31.47.0-255,66,109350,92,248988
9413,0.00093,172.31.47.0-255,66,109416,92,248988
9414,0.000982,172.217.194.0-255,5738,115154,92,248988
9415,0.001008,172.31.47.0-255,66,115220,92,248988
9416,0.001016,172.217.194.0-255,1484,116704,92,248988
9417,0.001021,172.31.47.0-255,66,116770,92,248988
9418,0.001044,172.217.194.0-255,2184,118954,92,248988
9419,0.00105,172.217.194.0-255,4320,123274,92,248988
9420,0.001055,172.217.194.0-255,4320,127594,92,248988
9421,0.001078,172.217.194.0-255,5738,133332,92,248988
9422,0.001085,172.217.194.0-255,5738,139070,92,248988
9423,0.001097,172.31.47.0-255,66,139136,92,248988
9424,0.001104,172.217.194.0-255,7156,146292,92,248988
9425,0.001114,172.31.47.0-255,66,146358,92,248988
9426,0.001134,172.217.194.0-255,6438,152796,92,248988
9427,0.001152,172.31.47.0-255,66,152862,92,248988
9428,0.001173,172.217.194.0-255,7156,160018,92,248988
9429,0.001177,172.217.194.0-255,2902,162920,92,248988
9430,0.001194,172.217.194.0-255,2902,165822,92,248988
9431,0.001197,172.217.194.0-255,1484,167306,92,248988
9432,0.001208,172.31.47.0-255,66,167372,92,248988
9433,0.001242,172.217.194.0-255,6438,173810,92,248988
9434,0.001257,172.217.194.0-255,1484,175294,92,248988
9435,0.001277,172.217.194.0-255,5738,181032,92,248988
9436,0.001281,172.217.194.0-255,2902,183934,92,248988
9437,0.001297,172.217.194.0-255,5738,189672,92,248988
9438,0.001333,172.31.47.0-255,66,189738,92,248988
9439,0.001341,172.31.47.0-255,66,189804,92,248988
9440,0.001374,172.217.194.0-255,766,190570,92,248988
9441,0.001396,172.31.47.0-255,66,190636,92,248988
9442,0.001421,172.217.194.0-255,1484,192120,92,248988
9443,0.001426,172.217.194.0-255,2902,195022,92,248988
9444,0.00143,172.217.194.0-255,2902,197924,92,248988
9445,0.001449,172.217.194.0-255,2902,200826,92,248988
9446,0.001454,172.31.47.0-255,66,200892,92,248988
9447,0.001467,172.217.194.0-255,5738,206630,92,248988
9448,0.00149,172.217.194.0-255,7156,213786,92,248988
9449,0.001511,172.217.194.0-255,2184,215970,92,248988
9450,0.001522,172.31.47.0-255,66,216036,92,248988
9451,0.00187,172.217.194.0-255,1484,217520,92,248988
9452,0.001876,172.217.194.0-255,2902,220422,92,248988
9453,0.001879,172.217.194.0-255,1484,221906,92,248988
9454,0.001891,172.31.47.0-255,66,221972,92,248988
9455,0.001902,172.217.194.0-255,4320,226292,92,248988
9456,0.001913,172.217.194.0-255,4320,230612,92,248988
9457,0.001918,172.31.47.0-255,66,230678,92,248988
9458,0.001971,172.217.194.0-255,766,231444,92,248988
9459,0.001982,172.31.47.0-255,66,231510,92,248988
9460,0.002021,172.217.194.0-255,1484,232994,92,248988
9461,0.003983,172.217.194.0-255,4320,237314,92,248988
9462,0.00399,172.31.47.0-255,66,237380,92,248988
9463,0.006012,172.217.194.0-255,5738,243118,92,248988
9464,0.006633,172.31.47.0-255,66,243184,92,248988
9465,0.008641,172.217.194.0-255,5738,248922,92,248988
9466,0.008646,172.31.47.0-255,66,248988,92,248988
9467,0.0,172.31.47.0-255,105,105,92,210
9468,0.001467,157.240.13.0-255,105,210,92,210
9469,0.0,74.125.68.0-255,290,290,92,231916
9470,2.1e-05,172.31.47.0-255,66,356,92,231916
9471,2.6e-05,74.125.68.0-255,1484,1840,92,231916
9472,3.1e-05,172.31.47.0-255,66,1906,92,231916
9473,3.8e-05,74.125.68.0-255,4320,6226,92,231916
9474,4.8e-05,172.31.47.0-255,66,6292,92,231916
9475,5.2e-05,74.125.68.0-255,2902,9194,92,231916
9476,5.5e-05,172.31.47.0-255,66,9260,92,231916
9477,6e-05,74.125.68.0-255,4320,13580,92,231916
9478,6.3e-05,172.31.47.0-255,66,13646,92,231916
9479,0.000101,172.31.47.0-255,66,13712,92,231916
9480,0.00014,74.125.68.0-255,1484,15196,92,231916
9481,0.000142,172.31.47.0-255,66,15262,92,231916
9482,0.000171,74.125.68.0-255,6797,22059,92,231916
9483,0.000173,172.31.47.0-255,66,22125,92,231916
9484,0.000232,74.125.68.0-255,1484,23609,92,231916
9485,0.000234,172.31.47.0-255,66,23675,92,231916
9486,0.00026,74.125.68.0-255,2902,26577,92,231916
9487,0.000263,172.31.47.0-255,66,26643,92,231916
9488,0.000295,74.125.68.0-255,5738,32381,92,231916
9489,0.000297,172.31.47.0-255,66,32447,92,231916
9490,0.000302,74.125.68.0-255,4320,36767,92,231916
9491,0.000304,172.31.47.0-255,66,36833,92,231916
9492,0.000327,74.125.68.0-255,2902,39735,92,231916
9493,0.000329,172.31.47.0-255,66,39801,92,231916
9494,0.000351,74.125.68.0-255,2543,42344,92,231916
9495,0.000353,172.31.47.0-255,66,42410,92,231916
9496,0.000357,74.125.68.0-255,2902,45312,92,231916
9497,0.000359,172.31.47.0-255,66,45378,92,231916
9498,0.000364,74.125.68.0-255,4320,49698,92,231916
9499,0.000366,172.31.47.0-255,66,49764,92,231916
9500,0.000404,74.125.68.0-255,7070,56834,92,231916
9501,0.000407,172.31.47.0-255,66,56900,92,231916
9502,0.000428,74.125.68.0-255,132,57032,92,231916
9503,0.00043,172.31.47.0-255,66,57098,92,231916
9504,0.000514,74.125.68.0-255,1484,58582,92,231916
9505,0.000518,172.31.47.0-255,66,58648,92,231916
9506,0.000523,74.125.68.0-255,2902,61550,92,231916
9507,0.000525,172.31.47.0-255,66,61616,92,231916
9508,0.000541,74.125.68.0-255,2902,64518,92,231916
9509,0.000546,172.31.47.0-255,66,64584,92,231916
9510,0.000568,74.125.68.0-255,2902,67486,92,231916
9511,0.00057,172.31.47.0-255,66,67552,92,231916
9512,0.000577,74.125.68.0-255,7156,74708,92,231916
9513,0.000579,172.31.47.0-255,66,74774,92,231916
9514,0.000598,74.125.68.0-255,5738,80512,92,231916
9515,0.000601,172.31.47.0-255,66,80578,92,231916
9516,0.000641,172.31.47.0-255,66,80644,92,231916
9517,0.000646,74.125.68.0-255,2184,82828,92,231916
9518,0.000648,172.31.47.0-255,66,82894,92,231916
9519,0.001075,74.125.68.0-255,1484,84378,92,231916
9520,0.00108,172.31.47.0-255,66,84444,92,231916
9521,0.001086,74.125.68.0-255,2902,87346,92,231916
9522,0.001089,172.31.47.0-255,66,87412,92,231916
9523,0.001117,74.125.68.0-255,5738,93150,92,231916
9524,0.00112,172.31.47.0-255,66,93216,92,231916
9525,0.001123,74.125.68.0-255,1484,94700,92,231916
9526,0.001124,172.31.47.0-255,66,94766,92,231916
9527,0.001152,74.125.68.0-255,2902,97668,92,231916
9528,0.001159,172.31.47.0-255,66,97734,92,231916
9529,0.00117,74.125.68.0-255,1484,99218,92,231916
9530,0.001177,172.31.47.0-255,66,99284,92,231916
9531,0.001203,74.125.68.0-255,2902,102186,92,231916
9532,0.00121,74.125.68.0-255,5738,107924,92,231916
9533,0.001216,74.125.68.0-255,2902,110826,92,231916
9534,0.001221,74.125.68.0-255,4320,115146,92,231916
9535,0.001239,172.31.47.0-255,66,115212,92,231916
9536,0.001262,74.125.68.0-255,2184,117396,92,231916
9537,0.001279,172.31.47.0-255,66,117462,92,231916
9538,0.001307,74.125.68.0-255,1484,118946,92,231916
9539,0.001321,74.125.68.0-255,2902,121848,92,231916
9540,0.001336,74.125.68.0-255,1484,123332,92,231916
9541,0.001338,172.31.47.0-255,66,123398,92,231916
9542,0.001356,74.125.68.0-255,4320,127718,92,231916
9543,0.00139,74.125.68.0-255,2902,130620,92,231916
9544,0.001434,74.125.68.0-255,2184,132804,92,231916
9545,0.001438,172.31.47.0-255,66,132870,92,231916
9546,0.001446,172.31.47.0-255,66,132936,92,231916
9547,0.001562,74.125.68.0-255,1484,134420,92,231916
9548,0.001583,74.125.68.0-255,2902,137322,92,231916
9549,0.001589,74.125.68.0-255,4320,141642,92,231916
9550,0.001593,172.31.47.0-255,66,141708,92,231916
9551,0.0016,74.125.68.0-255,1484,143192,92,231916
9552,0.001626,74.125.68.0-255,4320,147512,92,231916
9553,0.001633,172.31.47.0-255,66,147578,92,231916
9554,0.001657,74.125.68.0-255,7156,154734,92,231916
9555,0.001691,172.31.47.0-255,66,154800,92,231916
9556,0.001838,74.125.68.0-255,1484,156284,92,231916
9557,0.001852,74.125.68.0-255,2902,159186,92,231916
9558,0.001856,172.31.47.0-255,66,159252,92,231916
9559,0.00186,74.125.68.0-255,1484,160736,92,231916
9560,0.001884,74.125.68.0-255,2902,163638,92,231916
9561,0.00189,74.125.68.0-255,5738,169376,92,231916
9562,0.001917,74.125.68.0-255,4320,173696,92,231916
9563,0.001925,172.31.47.0-255,66,173762,92,231916
9564,0.001936,74.125.68.0-255,7156,180918,92,231916
9565,0.001945,74.125.68.0-255,2902,183820,92,231916
9566,0.001951,172.31.47.0-255,66,183886,92,231916
9567,0.001979,74.125.68.0-255,5020,188906,92,231916
9568,0.001987,172.31.47.0-255,66,188972,92,231916
9569,0.002165,74.125.68.0-255,1484,190456,92,231916
9570,0.00217,74.125.68.0-255,1484,191940,92,231916
9571,0.002173,172.31.47.0-255,66,192006,92,231916
9572,0.0022,74.125.68.0-255,1484,193490,92,231916
9573,0.002206,74.125.68.0-255,4320,197810,92,231916
9574,0.002246,74.125.68.0-255,4320,202130,92,231916
9575,0.002273,74.125.68.0-255,4320,206450,92,231916
9576,0.002277,74.125.68.0-255,2902,209352,92,231916
9577,0.002282,74.125.68.0-255,4320,213672,92,231916
9578,0.002291,74.125.68.0-255,766,214438,92,231916
9579,0.00232,172.31.47.0-255,66,214504,92,231916
9580,0.004605,74.125.68.0-255,5738,220242,92,231916
9581,0.004612,172.31.47.0-255,66,220308,92,231916
9582,0.006893,74.125.68.0-255,5738,226046,92,231916
9583,0.006899,172.31.47.0-255,66,226112,92,231916
9584,0.009191,74.125.68.0-255,5738,231850,92,231916
9585,0.009196,172.31.47.0-255,66,231916,92,231916
9586,0.0,172.217.194.0-255,152,152,92,194726
9587,2.5e-05,172.31.47.0-255,66,218,92,194726
9588,3.2e-05,172.217.194.0-255,1484,1702,92,194726
9589,3.6e-05,172.31.47.0-255,66,1768,92,194726
9590,4.1e-05,172.217.194.0-255,2902,4670,92,194726
9591,4.4e-05,172.31.47.0-255,66,4736,92,194726
9592,5.1e-05,172.217.194.0-255,7156,11892,92,194726
9593,5.4e-05,172.31.47.0-255,66,11958,92,194726
9594,7.1e-05,172.217.194.0-255,1484,13442,92,194726
9595,7.3e-05,172.31.47.0-255,66,13508,92,194726
9596,0.000101,172.217.194.0-255,6416,19924,92,194726
9597,0.000104,172.31.47.0-255,66,19990,92,194726
9598,0.000125,172.217.194.0-255,4320,24310,92,194726
9599,0.000128,172.31.47.0-255,66,24376,92,194726
9600,0.000151,172.217.194.0-255,6797,31173,92,194726
9601,0.000153,172.31.47.0-255,66,31239,92,194726
9602,0.000613,172.217.194.0-255,1484,32723,92,194726
9603,0.000617,172.31.47.0-255,66,32789,92,194726
9604,0.000633,172.217.194.0-255,2902,35691,92,194726
9605,0.000635,172.31.47.0-255,66,35757,92,194726
9606,0.000638,172.217.194.0-255,1484,37241,92,194726
9607,0.00064,172.31.47.0-255,66,37307,92,194726
9608,0.000663,172.217.194.0-255,4320,41627,92,194726
9609,0.000665,172.31.47.0-255,66,41693,92,194726
9610,0.000695,172.217.194.0-255,1484,43177,92,194726
9611,0.000697,172.31.47.0-255,66,43243,92,194726
9612,0.000714,172.217.194.0-255,5738,48981,92,194726
9613,0.000717,172.31.47.0-255,66,49047,92,194726
9614,0.000745,172.217.194.0-255,3961,53008,92,194726
9615,0.000748,172.31.47.0-255,66,53074,92,194726
9616,0.000758,172.31.47.0-255,66,53140,92,194726
9617,0.000779,172.217.194.0-255,1484,54624,92,194726
9618,0.000783,172.217.194.0-255,1379,56003,92,194726
9619,0.000786,172.31.47.0-255,66,56069,92,194726
9620,0.001195,172.217.194.0-255,121,56190,92,194726
9621,0.001492,172.217.194.0-255,1484,57674,92,194726
9622,0.001495,172.31.47.0-255,66,57740,92,194726
9623,0.001499,172.217.194.0-255,1484,59224,92,194726
9624,0.001512,172.217.194.0-255,1484,60708,92,194726
9625,0.001513,172.31.47.0-255,66,60774,92,194726
9626,0.001528,172.217.194.0-255,5738,66512,92,194726
9627,0.00153,172.31.47.0-255,66,66578,92,194726
9628,0.001548,172.217.194.0-255,1484,68062,92,194726
9629,0.001574,172.31.47.0-255,66,68128,92,194726
9630,0.001607,172.217.194.0-255,4320,72448,92,194726
9631,0.001609,172.31.47.0-255,66,72514,92,194726
9632,0.001651,172.217.194.0-255,7156,79670,92,194726
9633,0.001653,172.31.47.0-255,66,79736,92,194726
9634,0.001668,172.217.194.0-255,2184,81920,92,194726
9635,0.00167,172.31.47.0-255,66,81986,92,194726
9636,0.001796,172.217.194.0-255,1484,83470,92,194726
9637,0.001806,172.217.194.0-255,2902,86372,92,194726
9638,0.001808,172.31.47.0-255,66,86438,92,194726
9639,0.001818,172.217.194.0-255,1484,87922,92,194726
9640,0.001833,172.217.194.0-255,4320,92242,92,194726
9641,0.001835,172.31.47.0-255,66,92308,92,194726
9642,0.001854,172.217.194.0-255,4320,96628,92,194726
9643,0.001856,172.31.47.0-255,66,96694,92,194726
9644,0.001868,172.217.194.0-255,4320,101014,92,194726
9645,0.00187,172.31.47.0-255,66,101080,92,194726
9646,0.001895,172.217.194.0-255,7156,108236,92,194726
9647,0.001897,172.31.47.0-255,66,108302,92,194726
9648,0.001899,172.217.194.0-255,1484,109786,92,194726
9649,0.001918,172.217.194.0-255,2902,112688,92,194726
9650,0.00192,172.31.47.0-255,66,112754,92,194726
9651,0.001928,172.217.194.0-255,1484,114238,92,194726
9652,0.001938,172.217.194.0-255,2184,116422,92,194726
9653,0.00194,172.31.47.0-255,66,116488,92,194726
9654,0.00201,172.217.194.0-255,4320,120808,92,194726
9655,0.002012,172.31.47.0-255,66,120874,92,194726
9656,0.002029,172.217.194.0-255,2902,123776,92,194726
9657,0.00203,172.31.47.0-255,66,123842,92,194726
9658,0.002046,172.217.194.0-255,2902,126744,92,194726
9659,0.002048,172.31.47.0-255,66,126810,92,194726
9660,0.002063,172.217.194.0-255,5738,132548,92,194726
9661,0.002065,172.31.47.0-255,66,132614,92,194726
9662,0.002085,172.217.194.0-255,7156,139770,92,194726
9663,0.002087,172.31.47.0-255,66,139836,92,194726
9664,0.002112,172.31.47.0-255,66,139902,92,194726
9665,0.002114,172.217.194.0-255,766,140668,92,194726
9666,0.002138,172.217.194.0-255,1484,142152,92,194726
9667,0.00214,172.31.47.0-255,66,142218,92,194726
9668,0.002143,172.217.194.0-255,1484,143702,92,194726
9669,0.002156,172.217.194.0-255,1484,145186,92,194726
9670,0.002158,172.31.47.0-255,66,145252,92,194726
9671,0.002168,172.217.194.0-255,1484,146736,92,194726
9672,0.002182,172.217.194.0-255,2902,149638,92,194726
9673,0.002184,172.31.47.0-255,66,149704,92,194726
9674,0.002199,172.217.194.0-255,1484,151188,92,194726
9675,0.002208,172.217.194.0-255,1484,152672,92,194726
9676,0.00221,172.31.47.0-255,66,152738,92,194726
9677,0.002227,172.217.194.0-255,1484,154222,92,194726
9678,0.002241,172.217.194.0-255,4320,158542,92,194726
9679,0.002243,172.31.47.0-255,66,158608,92,194726
9680,0.002263,172.217.194.0-255,5738,164346,92,194726
9681,0.002265,172.31.47.0-255,66,164412,92,194726
9682,0.002289,172.217.194.0-255,4320,168732,92,194726
9683,0.002291,172.31.47.0-255,66,168798,92,194726
9684,0.00231,172.217.194.0-255,5738,174536,92,194726
9685,0.002312,172.31.47.0-255,66,174602,92,194726
9686,0.002314,172.217.194.0-255,766,175368,92,194726
9687,0.002331,172.217.194.0-255,1484,176852,92,194726
9688,0.002333,172.31.47.0-255,66,176918,92,194726
9689,0.002355,172.217.194.0-255,1484,178402,92,194726
9690,0.004521,172.217.194.0-255,1484,179886,92,194726
9691,0.004525,172.31.47.0-255,66,179952,92,194726
9692,0.004559,172.217.194.0-255,2902,182854,92,194726
9693,0.004561,172.31.47.0-255,66,182920,92,194726
9694,0.006775,172.217.194.0-255,2902,185822,92,194726
9695,0.006781,172.31.47.0-255,66,185888,92,194726
9696,0.006803,172.217.194.0-255,1484,187372,92,194726
9697,0.006815,172.217.194.0-255,1484,188856,92,194726
9698,0.006818,172.31.47.0-255,66,188922,92,194726
9699,0.009146,172.217.194.0-255,5738,194660,92,194726
9700,0.009153,172.31.47.0-255,66,194726,92,194726
9701,0.0,172.217.194.0-255,153,153,92,183392
9702,2.1e-05,172.31.47.0-255,66,219,92,183392
9703,2.7e-05,172.217.194.0-255,1484,1703,92,183392
9704,3e-05,172.31.47.0-255,66,1769,92,183392
9705,3.5e-05,172.217.194.0-255,2902,4671,92,183392
9706,3.7e-05,172.31.47.0-255,66,4737,92,183392
9707,4.3e-05,172.217.194.0-255,5738,10475,92,183392
9708,4.5e-05,172.31.47.0-255,66,10541,92,183392
9709,5.8e-05,172.217.194.0-255,1484,12025,92,183392
9710,6e-05,172.31.47.0-255,66,12091,92,183392
9711,6.6e-05,172.217.194.0-255,4927,17018,92,183392
9712,6.8e-05,172.31.47.0-255,66,17084,92,183392
9713,7.2e-05,172.217.194.0-255,2902,19986,92,183392
9714,7.3e-05,172.31.47.0-255,66,20052,92,183392
9715,0.000105,172.31.47.0-255,66,20118,92,183392
9716,0.000131,172.217.194.0-255,1484,21602,92,183392
9717,0.000133,172.31.47.0-255,66,21668,92,183392
9718,0.000137,172.217.194.0-255,2902,24570,92,183392
9719,0.000138,172.31.47.0-255,66,24636,92,183392
9720,0.000158,172.217.194.0-255,5738,30374,92,183392
9721,0.00016,172.31.47.0-255,66,30440,92,183392
9722,0.000162,172.217.194.0-255,1484,31924,92,183392
9723,0.000163,172.31.47.0-255,66,31990,92,183392
9724,0.000198,172.31.47.0-255,66,32056,92,183392
9725,0.000222,172.217.194.0-255,2902,34958,92,183392
9726,0.000224,172.31.47.0-255,66,35024,92,183392
9727,0.000247,172.31.47.0-255,66,35090,92,183392
9728,0.000249,172.217.194.0-255,119,35209,92,183392
9729,0.000251,172.31.47.0-255,66,35275,92,183392
9730,0.000253,172.217.194.0-255,381,35656,92,183392
9731,0.000542,172.217.194.0-255,1484,37140,92,183392
9732,0.000546,172.31.47.0-255,66,37206,92,183392
9733,0.00055,172.217.194.0-255,2902,40108,92,183392
9734,0.000552,172.31.47.0-255,66,40174,92,183392
9735,0.000573,172.217.194.0-255,5738,45912,92,183392
9736,0.000575,172.31.47.0-255,66,45978,92,183392
9737,0.000609,172.31.47.0-255,66,46044,92,183392
9738,0.000619,172.31.47.0-255,66,46110,92,183392
9739,0.00066,172.217.194.0-255,7156,53266,92,183392
9740,0.000665,172.31.47.0-255,66,53332,92,183392
9741,0.000678,172.217.194.0-255,2902,56234,92,183392
9742,0.000681,172.31.47.0-255,66,56300,92,183392
9743,0.00069,172.31.47.0-255,66,56366,92,183392
9744,0.000716,172.217.194.0-255,7156,63522,92,183392
9745,0.000719,172.31.47.0-255,66,63588,92,183392
9746,0.00074,172.217.194.0-255,4471,68059,92,183392
9747,0.000742,172.31.47.0-255,66,68125,92,183392
9748,0.000756,172.217.194.0-255,2902,71027,92,183392
9749,0.000759,172.31.47.0-255,66,71093,92,183392
9750,0.000795,172.31.47.0-255,66,71159,92,183392
9751,0.000797,172.217.194.0-255,1484,72643,92,183392
9752,0.000812,172.217.194.0-255,3602,76245,92,183392
9753,0.000844,172.217.194.0-255,1484,77729,92,183392
9754,0.000857,172.217.194.0-255,2902,80631,92,183392
9755,0.000891,172.217.194.0-255,4320,84951,92,183392
9756,0.000896,172.31.47.0-255,66,85017,92,183392
9757,0.000911,172.217.194.0-255,3602,88619,92,183392
9758,0.000927,172.31.47.0-255,66,88685,92,183392
9759,0.000961,172.217.194.0-255,4320,93005,92,183392
9760,0.000965,172.217.194.0-255,1484,94489,92,183392
9761,0.000972,172.31.47.0-255,66,94555,92,183392
9762,0.000983,172.217.194.0-255,4320,98875,92,183392
9763,0.000987,172.217.194.0-255,4320,103195,92,183392
9764,0.001002,172.217.194.0-255,7156,110351,92,183392
9765,0.001004,172.217.194.0-255,1484,111835,92,183392
9766,0.001022,172.31.47.0-255,66,111901,92,183392
9767,0.001038,172.31.47.0-255,66,111967,92,183392
9768,0.001065,172.217.194.0-255,4320,116287,92,183392
9769,0.001072,172.31.47.0-255,66,116353,92,183392
9770,0.001111,172.217.194.0-255,2902,119255,92,183392
9771,0.001117,172.31.47.0-255,66,119321,92,183392
9772,0.001147,172.31.47.0-255,66,119387,92,183392
9773,0.001172,172.217.194.0-255,766,120153,92,183392
9774,0.001213,172.31.47.0-255,66,120219,92,183392
9775,0.001246,172.217.194.0-255,1484,121703,92,183392
9776,0.001251,172.217.194.0-255,2902,124605,92,183392
9777,0.001262,172.31.47.0-255,66,124671,92,183392
9778,0.001267,172.217.194.0-255,4320,128991,92,183392
9779,0.001272,172.31.47.0-255,66,129057,92,183392
9780,0.001279,172.217.194.0-255,1484,130541,92,183392
9781,0.001281,172.217.194.0-255,1484,132025,92,183392
9782,0.001315,172.217.194.0-255,1484,133509,92,183392
9783,0.001327,172.31.47.0-255,66,133575,92,183392
9784,0.001345,172.31.47.0-255,66,133641,92,183392
9785,0.001375,172.217.194.0-255,2902,136543,92,183392
9786,0.00138,172.31.47.0-255,66,136609,92,183392
9787,0.001399,172.217.194.0-255,2902,139511,92,183392
9788,0.001406,172.217.194.0-255,7156,146667,92,183392
9789,0.00145,172.217.194.0-255,1484,148151,92,183392
9790,0.001471,172.217.194.0-255,5020,153171,92,183392
9791,0.001486,172.31.47.0-255,66,153237,92,183392
9792,0.001512,172.217.194.0-255,1484,154721,92,183392
9793,0.001517,172.217.194.0-255,2902,157623,92,183392
9794,0.001532,172.217.194.0-255,4320,161943,92,183392
9795,0.001542,172.217.194.0-255,1484,163427,92,183392
9796,0.001553,172.217.194.0-255,2902,166329,92,183392
9797,0.001569,172.217.194.0-255,1484,167813,92,183392
9798,0.001573,172.31.47.0-255,66,167879,92,183392
9799,0.001578,172.31.47.0-255,66,167945,92,183392
9800,0.001616,172.31.47.0-255,66,168011,92,183392
9801,0.001627,172.217.194.0-255,5738,173749,92,183392
9802,0.001633,172.31.47.0-255,66,173815,92,183392
9803,0.001659,172.217.194.0-255,6438,180253,92,183392
9804,0.001672,172.217.194.0-255,2902,183155,92,183392
9805,0.001683,172.31.47.0-255,66,183221,92,183392
9806,0.001705,172.217.194.0-255,105,183326,92,183392
9807,0.001733,172.31.47.0-255,66,183392,92,183392
9808,0.0,172.31.47.0-255,105,105,92,105
9809,0.0,172.217.194.0-255,153,153,92,146684
9810,2.4e-05,172.31.47.0-255,66,219,92,146684
9811,3e-05,172.217.194.0-255,1484,1703,92,146684
9812,3.3e-05,172.31.47.0-255,66,1769,92,146684
9813,3.8e-05,172.217.194.0-255,2902,4671,92,146684
9814,3.9e-05,172.31.47.0-255,66,4737,92,146684
9815,4.5e-05,172.217.194.0-255,7156,11893,92,146684
9816,4.7e-05,172.31.47.0-255,66,11959,92,146684
9817,8.1e-05,172.31.47.0-255,66,12025,92,146684
9818,0.000112,172.217.194.0-255,2902,14927,92,146684
9819,0.000114,172.31.47.0-255,66,14993,92,146684
9820,0.000133,172.217.194.0-255,3961,18954,92,146684
9821,0.000135,172.31.47.0-255,66,19020,92,146684
9822,0.000151,172.217.194.0-255,1484,20504,92,146684
9823,0.000153,172.31.47.0-255,66,20570,92,146684
9824,0.000174,172.217.194.0-255,2902,23472,92,146684
9825,0.000176,172.31.47.0-255,66,23538,92,146684
9826,0.000181,172.217.194.0-255,5738,29276,92,146684
9827,0.000183,172.31.47.0-255,66,29342,92,146684
9828,0.000205,172.217.194.0-255,4320,33662,92,146684
9829,0.000208,172.31.47.0-255,66,33728,92,146684
9830,0.000243,172.217.194.0-255,2543,36271,92,146684
9831,0.000245,172.31.47.0-255,66,36337,92,146684
9832,0.000394,172.217.194.0-255,1484,37821,92,146684
9833,0.000397,172.31.47.0-255,66,37887,92,146684
9834,0.000402,172.217.194.0-255,2902,40789,92,146684
9835,0.000404,172.31.47.0-255,66,40855,92,146684
9836,0.000421,172.217.194.0-255,5738,46593,92,146684
9837,0.000423,172.31.47.0-255,66,46659,92,146684
9838,0.000443,172.217.194.0-255,7112,53771,92,146684
9839,0.000448,172.31.47.0-255,66,53837,92,146684
9840,0.000679,172.217.194.0-255,363,54200,92,146684
9841,0.000707,172.31.47.0-255,66,54266,92,146684
9842,0.000956,172.217.194.0-255,1484,55750,92,146684
9843,0.000963,172.217.194.0-255,2902,58652,92,146684
9844,0.000967,172.31.47.0-255,66,58718,92,146684
9845,0.000973,172.217.194.0-255,2902,61620,92,146684
9846,0.000974,172.31.47.0-255,66,61686,92,146684
9847,0.000989,172.217.194.0-255,2902,64588,92,146684
9848,0.000991,172.31.47.0-255,66,64654,92,146684
9849,0.000998,172.217.194.0-255,7156,71810,92,146684
9850,0.000999,172.31.47.0-255,66,71876,92,146684
9851,0.001027,172.217.194.0-255,5738,77614,92,146684
9852,0.00103,172.31.47.0-255,66,77680,92,146684
9853,0.001039,172.31.47.0-255,66,77746,92,146684
9854,0.001065,172.217.194.0-255,766,78512,92,146684
9855,0.001289,172.217.194.0-255,1484,79996,92,146684
9856,0.001294,172.31.47.0-255,66,80062,92,146684
9857,0.001298,172.217.194.0-255,2902,82964,92,146684
9858,0.0013,172.31.47.0-255,66,83030,92,146684
9859,0.001305,172.217.194.0-255,5738,88768,92,146684
9860,0.001307,172.31.47.0-255,66,88834,92,146684
9861,0.001346,172.217.194.0-255,7156,95990,92,146684
9862,0.001348,172.31.47.0-255,66,96056,92,146684
9863,0.001357,172.31.47.0-255,66,96122,92,146684
9864,0.001369,172.217.194.0-255,4320,100442,92,146684
9865,0.001371,172.31.47.0-255,66,100508,92,146684
9866,0.001375,172.217.194.0-255,2184,102692,92,146684
9867,0.001376,172.31.47.0-255,66,102758,92,146684
9868,0.002006,172.217.194.0-255,1484,104242,92,146684
9869,0.002039,172.217.194.0-255,2902,107144,92,146684
9870,0.002043,172.31.47.0-255,66,107210,92,146684
9871,0.002048,172.217.194.0-255,4320,111530,92,146684
9872,0.00205,172.31.47.0-255,66,111596,92,146684
9873,0.002063,172.217.194.0-255,1484,113080,92,146684
9874,0.002072,172.217.194.0-255,1484,114564,92,146684
9875,0.002074,172.31.47.0-255,66,114630,92,146684
9876,0.002094,172.217.194.0-255,7156,121786,92,146684
9877,0.002097,172.31.47.0-255,66,121852,92,146684
9878,0.002134,172.217.194.0-255,4320,126172,92,146684
9879,0.002137,172.31.47.0-255,66,126238,92,146684
9880,0.002153,172.217.194.0-255,2902,129140,92,146684
9881,0.002155,172.31.47.0-255,66,129206,92,146684
9882,0.002163,172.31.47.0-255,66,129272,92,146684
9883,0.004459,172.217.194.0-255,5738,135010,92,146684
9884,0.004463,172.31.47.0-255,66,135076,92,146684
9885,0.006765,172.217.194.0-255,5738,140814,92,146684
9886,0.006773,172.31.47.0-255,66,140880,92,146684
9887,0.009088,172.217.194.0-255,5738,146618,92,146684
9888,0.009097,172.31.47.0-255,66,146684,92,146684
9889,0.0,172.217.194.0-255,153,153,92,212509
9890,3.3e-05,172.31.47.0-255,66,219,92,212509
9891,3.9e-05,172.217.194.0-255,1484,1703,92,212509
9892,4.4e-05,172.31.47.0-255,66,1769,92,212509
9893,4.9e-05,172.217.194.0-255,2902,4671,92,212509
9894,5.1e-05,172.31.47.0-255,66,4737,92,212509
9895,5.8e-05,172.217.194.0-255,7156,11893,92,212509
9896,6.1e-05,172.31.47.0-255,66,11959,92,212509
9897,8.6e-05,172.31.47.0-255,66,12025,92,212509
9898,0.000108,172.217.194.0-255,3497,15522,92,212509
9899,0.00011,172.31.47.0-255,66,15588,92,212509
9900,0.000116,172.217.194.0-255,6797,22385,92,212509
9901,0.000119,172.31.47.0-255,66,22451,92,212509
9902,0.000208,172.217.194.0-255,1484,23935,92,212509
9903,0.000213,172.31.47.0-255,66,24001,92,212509
9904,0.000217,172.217.194.0-255,1484,25485,92,212509
9905,0.000219,172.31.47.0-255,66,25551,92,212509
9906,0.000236,172.217.194.0-255,1484,27035,92,212509
9907,0.000239,172.31.47.0-255,66,27101,92,212509
9908,0.000246,172.217.194.0-255,5738,32839,92,212509
9909,0.000248,172.31.47.0-255,66,32905,92,212509
9910,0.000255,172.217.194.0-255,6797,39702,92,212509
9911,0.000257,172.31.47.0-255,66,39768,92,212509
9912,0.000262,172.217.194.0-255,2902,42670,92,212509
9913,0.000265,172.31.47.0-255,66,42736,92,212509
9914,0.000285,172.217.194.0-255,4320,47056,92,212509
9915,0.000289,172.31.47.0-255,66,47122,92,212509
9916,0.00031,172.217.194.0-255,4320,51442,92,212509
9917,0.000314,172.31.47.0-255,66,51508,92,212509
9918,0.00034,172.217.194.0-255,5636,57144,92,212509
9919,0.000344,172.31.47.0-255,66,57210,92,212509
9920,0.000346,172.217.194.0-255,428,57638,92,212509
9921,0.00042,172.217.194.0-255,1484,59122,92,212509
9922,0.000423,172.31.47.0-255,66,59188,92,212509
9923,0.000456,172.217.194.0-255,2902,62090,92,212509
9924,0.00046,172.31.47.0-255,66,62156,92,212509
9925,0.000467,172.217.194.0-255,5738,67894,92,212509
9926,0.000471,172.217.194.0-255,2902,70796,92,212509
9927,0.000472,172.31.47.0-255,66,70862,92,212509
9928,0.000476,172.31.47.0-255,66,70928,92,212509
9929,0.000504,172.217.194.0-255,3961,74889,92,212509
9930,0.000507,172.31.47.0-255,66,74955,92,212509
9931,0.000514,172.217.194.0-255,7156,82111,92,212509
9932,0.000517,172.31.47.0-255,66,82177,92,212509
9933,0.000527,172.31.47.0-255,66,82243,92,212509
9934,0.001,172.217.194.0-255,1484,83727,92,212509
9935,0.001007,172.217.194.0-255,2902,86629,92,212509
9936,0.001011,172.31.47.0-255,66,86695,92,212509
9937,0.001032,172.217.194.0-255,5738,92433,92,212509
9938,0.001034,172.31.47.0-255,66,92499,92,212509
9939,0.001085,172.31.47.0-255,66,92565,92,212509
9940,0.001107,172.217.194.0-255,4320,96885,92,212509
9941,0.00111,172.31.47.0-255,66,96951,92,212509
9942,0.001121,172.31.47.0-255,66,97017,92,212509
9943,0.001124,172.217.194.0-255,766,97783,92,212509
9944,0.001127,172.217.194.0-255,1484,99267,92,212509
9945,0.001129,172.31.47.0-255,66,99333,92,212509
9946,0.001134,172.217.194.0-255,4320,103653,92,212509
9947,0.001137,172.31.47.0-255,66,103719,92,212509
9948,0.001172,172.31.47.0-255,66,103785,92,212509
9949,0.001182,172.31.47.0-255,66,103851,92,212509
9950,0.001217,172.217.194.0-255,2902,106753,92,212509
9951,0.001221,172.31.47.0-255,66,106819,92,212509
9952,0.001244,172.217.194.0-255,6438,113257,92,212509
9953,0.001247,172.31.47.0-255,66,113323,92,212509
9954,0.001259,172.31.47.0-255,66,113389,92,212509
9955,0.001263,172.217.194.0-255,2902,116291,92,212509
9956,0.001266,172.31.47.0-255,66,116357,92,212509
9957,0.001285,172.217.194.0-255,7156,123513,92,212509
9958,0.001287,172.31.47.0-255,66,123579,92,212509
9959,0.001327,172.217.194.0-255,7156,130735,92,212509
9960,0.00133,172.31.47.0-255,66,130801,92,212509
9961,0.001354,172.217.194.0-255,6438,137239,92,212509
9962,0.001357,172.31.47.0-255,66,137305,92,212509
9963,0.001722,172.217.194.0-255,1484,138789,92,212509
9964,0.001727,172.217.194.0-255,2902,141691,92,212509
9965,0.001731,172.31.47.0-255,66,141757,92,212509
9966,0.00175,172.217.194.0-255,1484,143241,92,212509
9967,0.001755,172.217.194.0-255,2902,146143,92,212509
9968,0.001757,172.31.47.0-255,66,146209,92,212509
9969,0.001776,172.217.194.0-255,2902,149111,92,212509
9970,0.001779,172.31.47.0-255,66,149177,92,212509
9971,0.001783,172.217.194.0-255,2902,152079,92,212509
9972,0.001785,172.31.47.0-255,66,152145,92,212509
9973,0.001818,172.31.47.0-255,66,152211,92,212509
9974,0.001824,172.217.194.0-255,5738,157949,92,212509
9975,0.001826,172.31.47.0-255,66,158015,92,212509
9976,0.001844,172.217.194.0-255,1484,159499,92,212509
9977,0.001856,172.217.194.0-255,2184,161683,92,212509
9978,0.001859,172.31.47.0-255,66,161749,92,212509
9979,0.002402,172.217.194.0-255,1484,163233,92,212509
9980,0.002407,172.217.194.0-255,1484,164717,92,212509
9981,0.00241,172.31.47.0-255,66,164783,92,212509
9982,0.002429,172.217.194.0-255,1484,166267,92,212509
9983,0.002435,172.217.194.0-255,5738,172005,92,212509
9984,0.002437,172.31.47.0-255,66,172071,92,212509
9985,0.002442,172.217.194.0-255,4320,176391,92,212509
9986,0.002444,172.31.47.0-255,66,176457,92,212509
9987,0.002481,172.31.47.0-255,66,176523,92,212509
9988,0.002491,172.31.47.0-255,66,176589,92,212509
9989,0.002514,172.217.194.0-255,2184,178773,92,212509
9990,0.002516,172.31.47.0-255,66,178839,92,212509
9991,0.002532,172.217.194.0-255,2902,181741,92,212509
9992,0.002535,172.31.47.0-255,66,181807,92,212509
9993,0.00255,172.217.194.0-255,1484,183291,92,212509
9994,0.002569,172.217.194.0-255,5738,189029,92,212509
9995,0.002573,172.31.47.0-255,66,189095,92,212509
9996,0.002579,172.217.194.0-255,4320,193415,92,212509
9997,0.002581,172.31.47.0-255,66,193481,92,212509
9998,0.002601,172.217.194.0-255,7156,200637,92,212509
9999,0.002605,172.31.47.0-255,66,200703,92,212509
10000,0.002608,172.217.194.0-255,1484,202187,92,212509
10001,0.002639,172.31.47.0-255,66,202253,92,212509
10002,0.005201,172.217.194.0-255,4320,206573,92,212509
10003,0.005208,172.31.47.0-255,66,206639,92,212509
10004,0.005223,172.217.194.0-255,1484,208123,92,212509
10005,0.00778,172.217.194.0-255,4320,212443,92,212509
10006,0.007785,172.31.47.0-255,66,212509,92,212509
10007,0.0,172.217.194.0-255,153,153,92,190978
10008,2e-05,172.31.47.0-255,66,219,92,190978
10009,2.5e-05,172.217.194.0-255,1484,1703,92,190978
10010,2.9e-05,172.31.47.0-255,66,1769,92,190978
10011,3.4e-05,172.217.194.0-255,2902,4671,92,190978
10012,3.7e-05,172.31.47.0-255,66,4737,92,190978
10013,4.2e-05,172.217.194.0-255,5738,10475,92,190978
10014,4.4e-05,172.31.47.0-255,66,10541,92,190978
10015,6.9e-05,172.217.194.0-255,1484,12025,92,190978
10016,7e-05,172.31.47.0-255,66,12091,92,190978
10017,7.4e-05,172.217.194.0-255,2205,14296,92,190978
10018,7.6e-05,172.31.47.0-255,66,14362,92,190978
10019,0.000168,172.217.194.0-255,1484,15846,92,190978
10020,0.000171,172.31.47.0-255,66,15912,92,190978
10021,0.000175,172.217.194.0-255,2902,18814,92,190978
10022,0.000177,172.31.47.0-255,66,18880,92,190978
10023,0.000179,172.217.194.0-255,1484,20364,92,190978
10024,0.000181,172.31.47.0-255,66,20430,92,190978
10025,0.000209,172.217.194.0-255,4320,24750,92,190978
10026,0.000212,172.31.47.0-255,66,24816,92,190978
10027,0.000217,172.217.194.0-255,5738,30554,92,190978
10028,0.000218,172.31.47.0-255,66,30620,92,190978
10029,0.000239,172.217.194.0-255,1125,31745,92,190978
10030,0.000241,172.31.47.0-255,66,31811,92,190978
10031,0.000359,172.217.194.0-255,1484,33295,92,190978
10032,0.000362,172.31.47.0-255,66,33361,92,190978
10033,0.000367,172.217.194.0-255,2902,36263,92,190978
10034,0.000369,172.31.47.0-255,66,36329,92,190978
10035,0.00038,172.217.194.0-255,2902,39231,92,190978
10036,0.000382,172.31.47.0-255,66,39297,92,190978
10037,0.000404,172.217.194.0-255,2902,42199,92,190978
10038,0.000407,172.31.47.0-255,66,42265,92,190978
10039,0.000423,172.217.194.0-255,2902,45167,92,190978
10040,0.000425,172.31.47.0-255,66,45233,92,190978
10041,0.000446,172.217.194.0-255,3961,49194,92,190978
10042,0.000448,172.31.47.0-255,66,49260,92,190978
10043,0.000454,172.217.194.0-255,7156,56416,92,190978
10044,0.000455,172.31.47.0-255,66,56482,92,190978
10045,0.000459,172.217.194.0-255,4320,60802,92,190978
10046,0.000461,172.31.47.0-255,66,60868,92,190978
10047,0.000485,172.217.194.0-255,5637,66505,92,190978
10048,0.000488,172.31.47.0-255,66,66571,92,190978
10049,0.000535,172.217.194.0-255,119,66690,92,190978
10050,0.000605,172.217.194.0-255,376,67066,92,190978
10051,0.00073,172.217.194.0-255,1484,68550,92,190978
10052,0.000733,172.31.47.0-255,66,68616,92,190978
10053,0.000736,172.217.194.0-255,1484,70100,92,190978
10054,0.000751,172.217.194.0-255,1484,71584,92,190978
10055,0.000753,172.31.47.0-255,66,71650,92,190978
10056,0.000755,172.217.194.0-255,1484,73134,92,190978
10057,0.000775,172.217.194.0-255,4320,77454,92,190978
10058,0.000778,172.217.194.0-255,2902,80356,92,190978
10059,0.000781,172.31.47.0-255,66,80422,92,190978
10060,0.000787,172.31.47.0-255,66,80488,92,190978
10061,0.00079,172.217.194.0-255,1484,81972,92,190978
10062,0.000793,172.217.194.0-255,2902,84874,92,190978
10063,0.000795,172.31.47.0-255,66,84940,92,190978
10064,0.000821,172.31.47.0-255,66,85006,92,190978
10065,0.00085,172.31.47.0-255,66,85072,92,190978
10066,0.001027,172.217.194.0-255,1484,86556,92,190978
10067,0.00103,172.217.194.0-255,1484,88040,92,190978
10068,0.001033,172.31.47.0-255,66,88106,92,190978
10069,0.001047,172.217.194.0-255,1484,89590,92,190978
10070,0.001053,172.217.194.0-255,5738,95328,92,190978
10071,0.001054,172.31.47.0-255,66,95394,92,190978
10072,0.001059,172.217.194.0-255,4320,99714,92,190978
10073,0.001061,172.31.47.0-255,66,99780,92,190978
10074,0.001093,172.31.47.0-255,66,99846,92,190978
10075,0.001097,172.217.194.0-255,2902,102748,92,190978
10076,0.001098,172.31.47.0-255,66,102814,92,190978
10077,0.001112,172.217.194.0-255,2902,105716,92,190978
10078,0.001113,172.31.47.0-255,66,105782,92,190978
10079,0.001128,172.217.194.0-255,5020,110802,92,190978
10080,0.00113,172.31.47.0-255,66,110868,92,190978
10081,0.001355,172.217.194.0-255,1484,112352,92,190978
10082,0.00136,172.217.194.0-255,2902,115254,92,190978
10083,0.001362,172.31.47.0-255,66,115320,92,190978
10084,0.001365,172.217.194.0-255,1484,116804,92,190978
10085,0.001381,172.217.194.0-255,4320,121124,92,190978
10086,0.001383,172.31.47.0-255,66,121190,92,190978
10087,0.001395,172.217.194.0-255,2902,124092,92,190978
10088,0.001397,172.31.47.0-255,66,124158,92,190978
10089,0.001423,172.31.47.0-255,66,124224,92,190978
10090,0.001425,172.217.194.0-255,1484,125708,92,190978
10091,0.001446,172.217.194.0-255,7156,132864,92,190978
10092,0.001449,172.31.47.0-255,66,132930,92,190978
10093,0.00146,172.217.194.0-255,2184,135114,92,190978
10094,0.001462,172.31.47.0-255,66,135180,92,190978
10095,0.002032,172.217.194.0-255,1484,136664,92,190978
10096,0.00204,172.217.194.0-255,2902,139566,92,190978
10097,0.002043,172.31.47.0-255,66,139632,92,190978
10098,0.002048,172.217.194.0-255,2902,142534,92,190978
10099,0.00205,172.31.47.0-255,66,142600,92,190978
10100,0.002063,172.217.194.0-255,2902,145502,92,190978
10101,0.002065,172.31.47.0-255,66,145568,92,190978
10102,0.002069,172.217.194.0-255,4320,149888,92,190978
10103,0.002071,172.31.47.0-255,66,149954,92,190978
10104,0.002102,172.31.47.0-255,66,150020,92,190978
10105,0.002112,172.31.47.0-255,66,150086,92,190978
10106,0.002247,172.217.194.0-255,1484,151570,92,190978
10107,0.002262,172.217.194.0-255,2902,154472,92,190978
10108,0.002265,172.31.47.0-255,66,154538,92,190978
10109,0.002271,172.217.194.0-255,5738,160276,92,190978
10110,0.002272,172.31.47.0-255,66,160342,92,190978
10111,0.002285,172.217.194.0-255,2902,163244,92,190978
10112,0.002287,172.31.47.0-255,66,163310,92,190978
10113,0.002299,172.217.194.0-255,2902,166212,92,190978
10114,0.0023,172.31.47.0-255,66,166278,92,190978
10115,0.002307,172.217.194.0-255,7156,173434,92,190978
10116,0.002308,172.31.47.0-255,66,173500,92,190978
10117,0.002351,172.31.47.0-255,66,173566,92,190978
10118,0.004714,172.217.194.0-255,5738,179304,92,190978
10119,0.00472,172.31.47.0-255,66,179370,92,190978
10120,0.007132,172.217.194.0-255,5738,185108,92,190978
10121,0.007143,172.31.47.0-255,66,185174,92,190978
10122,0.009565,172.217.194.0-255,5738,190912,92,190978
10123,0.009571,172.31.47.0-255,66,190978,92,190978
10124,0.0,172.253.118.0-255,153,153,92,209693
10125,2.2e-05,172.31.47.0-255,66,219,92,209693
10126,2.9e-05,172.253.118.0-255,1484,1703,92,209693
10127,3.3e-05,172.31.47.0-255,66,1769,92,209693
10128,3.8e-05,172.253.118.0-255,2902,4671,92,209693
10129,4.1e-05,172.31.47.0-255,66,4737,92,209693
10130,4.8e-05,172.253.118.0-255,7156,11893,92,209693
10131,5.1e-05,172.31.47.0-255,66,11959,92,209693
10132,7.6e-05,172.31.47.0-255,66,12025,92,209693
10133,9.6e-05,172.253.118.0-255,2004,14029,92,209693
10134,9.9e-05,172.31.47.0-255,66,14095,92,209693
10135,0.000113,172.253.118.0-255,5738,19833,92,209693
10136,0.000115,172.31.47.0-255,66,19899,92,209693
10137,0.000133,172.253.118.0-255,1125,21024,92,209693
10138,0.000135,172.31.47.0-255,66,21090,92,209693
10139,0.000214,172.253.118.0-255,1484,22574,92,209693
10140,0.000217,172.31.47.0-255,66,22640,92,209693
10141,0.000229,172.253.118.0-255,2902,25542,92,209693
10142,0.000232,172.31.47.0-255,66,25608,92,209693
10143,0.000236,172.253.118.0-255,2902,28510,92,209693
10144,0.000238,172.31.47.0-255,66,28576,92,209693
10145,0.000256,172.253.118.0-255,2902,31478,92,209693
10146,0.000258,172.31.47.0-255,66,31544,92,209693
10147,0.000265,172.253.118.0-255,6797,38341,92,209693
10148,0.000267,172.31.47.0-255,66,38407,92,209693
10149,0.000295,172.253.118.0-255,7156,45563,92,209693
10150,0.000297,172.31.47.0-255,66,45629,92,209693
10151,0.000314,172.253.118.0-255,4320,49949,92,209693
10152,0.000316,172.31.47.0-255,66,50015,92,209693
10153,0.000337,172.253.118.0-255,5379,55394,92,209693
10154,0.000339,172.31.47.0-255,66,55460,92,209693
10155,0.000341,172.253.118.0-255,364,55824,92,209693
10156,0.000372,172.253.118.0-255,380,56204,92,209693
10157,0.000459,172.253.118.0-255,1484,57688,92,209693
10158,0.000462,172.31.47.0-255,66,57754,92,209693
10159,0.000487,172.253.118.0-255,2902,60656,92,209693
10160,0.000489,172.31.47.0-255,66,60722,92,209693
10161,0.000495,172.253.118.0-255,5738,66460,92,209693
10162,0.000497,172.31.47.0-255,66,66526,92,209693
10163,0.000522,172.253.118.0-255,6247,72773,92,209693
10164,0.000524,172.31.47.0-255,66,72839,92,209693
10165,0.000693,172.253.118.0-255,1484,74323,92,209693
10166,0.000707,172.253.118.0-255,1484,75807,92,209693
10167,0.00071,172.31.47.0-255,66,75873,92,209693
10168,0.000713,172.253.118.0-255,1484,77357,92,209693
10169,0.000723,172.253.118.0-255,1484,78841,92,209693
10170,0.000725,172.31.47.0-255,66,78907,92,209693
10171,0.00073,172.253.118.0-255,2902,81809,92,209693
10172,0.000731,172.31.47.0-255,66,81875,92,209693
10173,0.000743,172.253.118.0-255,2902,84777,92,209693
10174,0.000745,172.31.47.0-255,66,84843,92,209693
10175,0.000762,172.253.118.0-255,7156,91999,92,209693
10176,0.000764,172.31.47.0-255,66,92065,92,209693
10177,0.00079,172.253.118.0-255,5738,97803,92,209693
10178,0.000792,172.31.47.0-255,66,97869,92,209693
10179,0.000797,172.253.118.0-255,5738,103607,92,209693
10180,0.000799,172.31.47.0-255,66,103673,92,209693
10181,0.000848,172.253.118.0-255,3602,107275,92,209693
10182,0.000852,172.31.47.0-255,66,107341,92,209693
10183,0.001344,172.253.118.0-255,1484,108825,92,209693
10184,0.001349,172.253.118.0-255,1484,110309,92,209693
10185,0.001352,172.31.47.0-255,66,110375,92,209693
10186,0.001364,172.253.118.0-255,1484,111859,92,209693
10187,0.001371,172.253.118.0-255,5738,117597,92,209693
10188,0.001373,172.31.47.0-255,66,117663,92,209693
10189,0.001376,172.253.118.0-255,1484,119147,92,209693
10190,0.001411,172.31.47.0-255,66,119213,92,209693
10191,0.001437,172.253.118.0-255,4320,123533,92,209693
10192,0.001439,172.31.47.0-255,66,123599,92,209693
10193,0.001467,172.31.47.0-255,66,123665,92,209693
10194,0.001531,172.253.118.0-255,1484,125149,92,209693
10195,0.001544,172.253.118.0-255,2902,128051,92,209693
10196,0.001547,172.31.47.0-255,66,128117,92,209693
10197,0.00157,172.253.118.0-255,5738,133855,92,209693
10198,0.001572,172.31.47.0-255,66,133921,92,209693
10199,0.001577,172.253.118.0-255,2902,136823,92,209693
10200,0.001579,172.31.47.0-255,66,136889,92,209693
10201,0.001607,172.31.47.0-255,66,136955,92,209693
10202,0.001637,172.253.118.0-255,4320,141275,92,209693
10203,0.001641,172.31.47.0-255,66,141341,92,209693
10204,0.001657,172.253.118.0-255,6438,147779,92,209693
10205,0.001659,172.31.47.0-255,66,147845,92,209693
10206,0.001776,172.253.118.0-255,1484,149329,92,209693
10207,0.001782,172.253.118.0-255,2902,152231,92,209693
10208,0.001785,172.31.47.0-255,66,152297,92,209693
10209,0.001804,172.253.118.0-255,1484,153781,92,209693
10210,0.001822,172.253.118.0-255,4320,158101,92,209693
10211,0.001825,172.31.47.0-255,66,158167,92,209693
10212,0.001836,172.31.47.0-255,66,158233,92,209693
10213,0.001851,172.253.118.0-255,4320,162553,92,209693
10214,0.001854,172.31.47.0-255,66,162619,92,209693
10215,0.001865,172.31.47.0-255,66,162685,92,209693
10216,0.001882,172.253.118.0-255,2184,164869,92,209693
10217,0.001884,172.31.47.0-255,66,164935,92,209693
10218,0.001905,172.253.118.0-255,2902,167837,92,209693
10219,0.001907,172.31.47.0-255,66,167903,92,209693
10220,0.001935,172.253.118.0-255,7156,175059,92,209693
10221,0.001939,172.31.47.0-255,66,175125,92,209693
10222,0.00195,172.31.47.0-255,66,175191,92,209693
10223,0.002015,172.31.47.0-255,66,175257,92,209693
10224,0.00204,172.253.118.0-255,3602,178859,92,209693
10225,0.002043,172.31.47.0-255,66,178925,92,209693
10226,0.002103,172.253.118.0-255,1484,180409,92,209693
10227,0.002117,172.253.118.0-255,2902,183311,92,209693
10228,0.00212,172.31.47.0-255,66,183377,92,209693
10229,0.002144,172.253.118.0-255,5738,189115,92,209693
10230,0.002146,172.31.47.0-255,66,189181,92,209693
10231,0.002151,172.253.118.0-255,2902,192083,92,209693
10232,0.002153,172.31.47.0-255,66,192149,92,209693
10233,0.002197,172.31.47.0-255,66,192215,92,209693
10234,0.00221,172.31.47.0-255,66,192281,92,209693
10235,0.004472,172.253.118.0-255,5738,198019,92,209693
10236,0.004479,172.31.47.0-255,66,198085,92,209693
10237,0.006778,172.253.118.0-255,5738,203823,92,209693
10238,0.006785,172.31.47.0-255,66,203889,92,209693
10239,0.00906,172.253.118.0-255,5738,209627,92,209693
10240,0.009067,172.31.47.0-255,66,209693,92,209693
10241,0.0,74.125.24.0-255,153,153,92,154582
10242,2.7e-05,172.31.47.0-255,66,219,92,154582
10243,3.4e-05,74.125.24.0-255,1484,1703,92,154582
10244,3.8e-05,172.31.47.0-255,66,1769,92,154582
10245,4.3e-05,74.125.24.0-255,2902,4671,92,154582
10246,5.2e-05,172.31.47.0-255,66,4737,92,154582
10247,5.7e-05,74.125.24.0-255,2902,7639,92,154582
10248,6e-05,172.31.47.0-255,66,7705,92,154582
10249,6.6e-05,74.125.24.0-255,2902,10607,92,154582
10250,6.8e-05,172.31.47.0-255,66,10673,92,154582
10251,9.8e-05,74.125.24.0-255,1484,12157,92,154582
10252,0.0001,172.31.47.0-255,66,12223,92,154582
10253,0.000105,74.125.24.0-255,2127,14350,92,154582
10254,0.000107,172.31.47.0-255,66,14416,92,154582
10255,0.000201,74.125.24.0-255,1484,15900,92,154582
10256,0.000205,172.31.47.0-255,66,15966,92,154582
10257,0.000228,74.125.24.0-255,1484,17450,92,154582
10258,0.000232,172.31.47.0-255,66,17516,92,154582
10259,0.000236,74.125.24.0-255,2902,20418,92,154582
10260,0.000238,172.31.47.0-255,66,20484,92,154582
10261,0.000244,74.125.24.0-255,5738,26222,92,154582
10262,0.000252,172.31.47.0-255,66,26288,92,154582
10263,0.000257,74.125.24.0-255,4320,30608,92,154582
10264,0.000259,172.31.47.0-255,66,30674,92,154582
10265,0.000291,74.125.24.0-255,1125,31799,92,154582
10266,0.000295,172.31.47.0-255,66,31865,92,154582
10267,0.000302,74.125.24.0-255,5738,37603,92,154582
10268,0.000305,172.31.47.0-255,66,37669,92,154582
10269,0.00031,74.125.24.0-255,4320,41989,92,154582
10270,0.000313,172.31.47.0-255,66,42055,92,154582
10271,0.000344,74.125.24.0-255,6797,48852,92,154582
10272,0.000347,172.31.47.0-255,66,48918,92,154582
10273,0.000355,74.125.24.0-255,7156,56074,92,154582
10274,0.000358,172.31.47.0-255,66,56140,92,154582
10275,0.000383,74.125.24.0-255,4320,60460,92,154582
10276,0.000386,172.31.47.0-255,66,60526,92,154582
10277,0.000392,74.125.24.0-255,5379,65905,92,154582
10278,0.000395,172.31.47.0-255,66,65971,92,154582
10279,0.000397,74.125.24.0-255,450,66421,92,154582
10280,0.000602,74.125.24.0-255,327,66748,92,154582
10281,0.000749,172.31.47.0-255,66,66814,92,154582
10282,0.001047,74.125.24.0-255,1484,68298,92,154582
10283,0.001057,74.125.24.0-255,2902,71200,92,154582
10284,0.001061,172.31.47.0-255,66,71266,92,154582
10285,0.001071,74.125.24.0-255,5738,77004,92,154582
10286,0.001073,172.31.47.0-255,66,77070,92,154582
10287,0.001084,74.125.24.0-255,4320,81390,92,154582
10288,0.001086,172.31.47.0-255,66,81456,92,154582
10289,0.001094,74.125.24.0-255,7156,88612,92,154582
10290,0.001096,172.31.47.0-255,66,88678,92,154582
10291,0.001126,74.125.24.0-255,4320,92998,92,154582
10292,0.001129,172.31.47.0-255,66,93064,92,154582
10293,0.001139,172.31.47.0-255,66,93130,92,154582
10294,0.001412,74.125.24.0-255,1484,94614,92,154582
10295,0.001419,74.125.24.0-255,2902,97516,92,154582
10296,0.001424,172.31.47.0-255,66,97582,92,154582
10297,0.001431,74.125.24.0-255,5738,103320,92,154582
10298,0.001433,172.31.47.0-255,66,103386,92,154582
10299,0.001453,172.31.47.0-255,66,103452,92,154582
10300,0.00146,74.125.24.0-255,7156,110608,92,154582
10301,0.001462,172.31.47.0-255,66,110674,92,154582
10302,0.001489,74.125.24.0-255,3602,114276,92,154582
10303,0.001493,172.31.47.0-255,66,114342,92,154582
10304,0.002178,74.125.24.0-255,1484,115826,92,154582
10305,0.002189,74.125.24.0-255,2902,118728,92,154582
10306,0.002194,172.31.47.0-255,66,118794,92,154582
10307,0.002225,74.125.24.0-255,5738,124532,92,154582
10308,0.002227,172.31.47.0-255,66,124598,92,154582
10309,0.002232,74.125.24.0-255,2902,127500,92,154582
10310,0.002234,172.31.47.0-255,66,127566,92,154582
10311,0.002279,172.31.47.0-255,66,127632,92,154582
10312,0.002285,74.125.24.0-255,5738,133370,92,154582
10313,0.002287,172.31.47.0-255,66,133436,92,154582
10314,0.002315,74.125.24.0-255,5020,138456,92,154582
10315,0.002317,172.31.47.0-255,66,138522,92,154582
10316,0.00464,74.125.24.0-255,5738,144260,92,154582
10317,0.004646,172.31.47.0-255,66,144326,92,154582
10318,0.006969,74.125.24.0-255,4320,148646,92,154582
10319,0.006975,172.31.47.0-255,66,148712,92,154582
10320,0.006998,74.125.24.0-255,1484,150196,92,154582
10321,0.009294,74.125.24.0-255,4320,154516,92,154582
10322,0.0093,172.31.47.0-255,66,154582,92,154582
10323,0.0,74.125.24.0-255,153,153,92,257718
10324,9.2e-05,172.31.47.0-255,66,219,92,257718
10325,9.9e-05,74.125.24.0-255,1484,1703,92,257718
10326,0.000104,172.31.47.0-255,66,1769,92,257718
10327,0.000109,74.125.24.0-255,2902,4671,92,257718
10328,0.000111,172.31.47.0-255,66,4737,92,257718
10329,0.000118,74.125.24.0-255,7156,11893,92,257718
10330,0.000121,172.31.47.0-255,66,11959,92,257718
10331,0.000124,74.125.24.0-255,2173,14132,92,257718
10332,0.000127,172.31.47.0-255,66,14198,92,257718
10333,0.00014,172.31.47.0-255,66,14264,92,257718
10334,0.000145,74.125.24.0-255,5379,19643,92,257718
10335,0.000148,172.31.47.0-255,66,19709,92,257718
10336,0.000423,74.125.24.0-255,1484,21193,92,257718
10337,0.000428,172.31.47.0-255,66,21259,92,257718
10338,0.000435,74.125.24.0-255,2902,24161,92,257718
10339,0.000437,74.125.24.0-255,1484,25645,92,257718
10340,0.000439,172.31.47.0-255,66,25711,92,257718
10341,0.000444,172.31.47.0-255,66,25777,92,257718
10342,0.000454,74.125.24.0-255,4320,30097,92,257718
10343,0.000457,172.31.47.0-255,66,30163,92,257718
10344,0.000495,172.31.47.0-255,66,30229,92,257718
10345,0.000536,172.31.47.0-255,66,30295,92,257718
10346,0.000565,74.125.24.0-255,4320,34615,92,257718
10347,0.000569,172.31.47.0-255,66,34681,92,257718
10348,0.000588,74.125.24.0-255,1434,36115,92,257718
10349,0.000591,172.31.47.0-255,66,36181,92,257718
10350,0.000593,74.125.24.0-255,113,36294,92,257718
10351,0.000595,172.31.47.0-255,66,36360,92,257718
10352,0.000811,74.125.24.0-255,1484,37844,92,257718
10353,0.000833,74.125.24.0-255,2902,40746,92,257718
10354,0.000836,172.31.47.0-255,66,40812,92,257718
10355,0.000843,74.125.24.0-255,5738,46550,92,257718
10356,0.000851,172.31.47.0-255,66,46616,92,257718
10357,0.000878,74.125.24.0-255,4320,50936,92,257718
10358,0.000883,172.31.47.0-255,66,51002,92,257718
10359,0.000907,74.125.24.0-255,7156,58158,92,257718
10360,0.00091,74.125.24.0-255,1484,59642,92,257718
10361,0.000911,172.31.47.0-255,66,59708,92,257718
10362,0.000922,74.125.24.0-255,2902,62610,92,257718
10363,0.000926,172.31.47.0-255,66,62676,92,257718
10364,0.000951,172.31.47.0-255,66,62742,92,257718
10365,0.001077,74.125.24.0-255,1484,64226,92,257718
10366,0.001099,74.125.24.0-255,2902,67128,92,257718
10367,0.001102,172.31.47.0-255,66,67194,92,257718
10368,0.001122,74.125.24.0-255,2902,70096,92,257718
10369,0.001127,172.31.47.0-255,66,70162,92,257718
10370,0.001136,74.125.24.0-255,2902,73064,92,257718
10371,0.001141,172.31.47.0-255,66,73130,92,257718
10372,0.001142,74.125.24.0-255,5738,78868,92,257718
10373,0.001156,172.31.47.0-255,66,78934,92,257718
10374,0.001169,74.125.24.0-255,7156,86090,92,257718
10375,0.001174,172.31.47.0-255,66,86156,92,257718
10376,0.001185,74.125.24.0-255,5738,91894,92,257718
10377,0.001189,74.125.24.0-255,2902,94796,92,257718
10378,0.001189,172.31.47.0-255,66,94862,92,257718
10379,0.001204,172.31.47.0-255,66,94928,92,257718
10380,0.001206,74.125.24.0-255,2184,97112,92,257718
10381,0.001216,172.31.47.0-255,66,97178,92,257718
10382,0.001301,74.125.24.0-255,1484,98662,92,257718
10383,0.001316,74.125.24.0-255,2902,101564,92,257718
10384,0.001319,172.31.47.0-255,66,101630,92,257718
10385,0.001326,74.125.24.0-255,4320,105950,92,257718
10386,0.001338,74.125.24.0-255,1484,107434,92,257718
10387,0.001338,172.31.47.0-255,66,107500,92,257718
10388,0.001356,74.125.24.0-255,5738,113238,92,257718
10389,0.001365,172.31.47.0-255,66,113304,92,257718
10390,0.00138,74.125.24.0-255,7156,120460,92,257718
10391,0.001383,74.125.24.0-255,1484,121944,92,257718
10392,0.001388,172.31.47.0-255,66,122010,92,257718
10393,0.001423,172.31.47.0-255,66,122076,92,257718
10394,0.001781,74.125.24.0-255,1484,123560,92,257718
10395,0.001785,172.31.47.0-255,66,123626,92,257718
10396,0.001793,74.125.24.0-255,2902,126528,92,257718
10397,0.001808,74.125.24.0-255,5738,132266,92,257718
10398,0.001899,74.125.24.0-255,5738,138004,92,257718
10399,0.001912,74.125.24.0-255,5020,143024,92,257718
10400,0.001915,74.125.24.0-255,1484,144508,92,257718
10401,0.001933,74.125.24.0-255,7156,151664,92,257718
10402,0.001943,74.125.24.0-255,2902,154566,92,257718
10403,0.001968,74.125.24.0-255,7156,161722,92,257718
10404,0.001985,74.125.24.0-255,6438,168160,92,257718
10405,0.00202,74.125.24.0-255,2902,171062,92,257718
10406,0.002061,74.125.24.0-255,4320,175382,92,257718
10407,0.002066,74.125.24.0-255,2184,177566,92,257718
10408,0.002164,74.125.24.0-255,1484,179050,92,257718
10409,0.002178,74.125.24.0-255,2902,181952,92,257718
10410,0.002189,74.125.24.0-255,2902,184854,92,257718
10411,0.002198,74.125.24.0-255,1484,186338,92,257718
10412,0.002215,74.125.24.0-255,4320,190658,92,257718
10413,0.00223,74.125.24.0-255,4320,194978,92,257718
10414,0.002246,74.125.24.0-255,1484,196462,92,257718
10415,0.002291,74.125.24.0-255,7156,203618,92,257718
10416,0.002302,74.125.24.0-255,766,204384,92,257718
10417,0.002306,74.125.24.0-255,2902,207286,92,257718
10418,0.00233,74.125.24.0-255,2902,210188,92,257718
10419,0.002387,74.125.24.0-255,7156,217344,92,257718
10420,0.002421,74.125.24.0-255,5020,222364,92,257718
10421,0.002485,74.125.24.0-255,1484,223848,92,257718
10422,0.002497,74.125.24.0-255,1484,225332,92,257718
10423,0.002507,74.125.24.0-255,1484,226816,92,257718
10424,0.002519,74.125.24.0-255,2902,229718,92,257718
10425,0.002529,74.125.24.0-255,2902,232620,92,257718
10426,0.002549,74.125.24.0-255,2902,235522,92,257718
10427,0.002576,74.125.24.0-255,1484,237006,92,257718
10428,0.00259,74.125.24.0-255,4320,241326,92,257718
10429,0.002618,74.125.24.0-255,2184,243510,92,257718
10430,0.002627,74.125.24.0-255,2902,246412,92,257718
10431,0.002643,74.125.24.0-255,7156,253568,92,257718
10432,0.002645,74.125.24.0-255,1484,255052,92,257718
10433,0.005443,172.31.47.0-255,66,255118,92,257718
10434,0.008026,74.125.24.0-255,2429,257547,92,257718
10435,0.008032,172.31.47.0-255,66,257613,92,257718
10436,0.00912,172.31.47.0-255,105,257718,92,257718
10437,0.0,74.125.24.0-255,152,152,92,76593
10438,2.6e-05,172.31.47.0-255,66,218,92,76593
10439,5.3e-05,74.125.24.0-255,1484,1702,92,76593
10440,5.7e-05,172.31.47.0-255,66,1768,92,76593
10441,6e-05,74.125.24.0-255,1484,3252,92,76593
10442,6.3e-05,172.31.47.0-255,66,3318,92,76593
10443,8.7e-05,74.125.24.0-255,1484,4802,92,76593
10444,8.9e-05,172.31.47.0-255,66,4868,92,76593
10445,9.9e-05,74.125.24.0-255,7156,12024,92,76593
10446,0.000103,74.125.24.0-255,2065,14089,92,76593
10447,0.000105,172.31.47.0-255,66,14155,92,76593
10448,0.000108,172.31.47.0-255,66,14221,92,76593
10449,0.000115,172.31.47.0-255,66,14287,92,76593
10450,0.000128,172.31.47.0-255,66,14353,92,76593
10451,0.000167,172.31.47.0-255,66,14419,92,76593
10452,0.000172,74.125.24.0-255,3602,18021,92,76593
10453,0.000174,172.31.47.0-255,66,18087,92,76593
10454,0.000675,74.125.24.0-255,1484,19571,92,76593
10455,0.000681,172.31.47.0-255,66,19637,92,76593
10456,0.000687,74.125.24.0-255,2902,22539,92,76593
10457,0.000691,172.31.47.0-255,66,22605,92,76593
10458,0.000696,74.125.24.0-255,4320,26925,92,76593
10459,0.000698,172.31.47.0-255,66,26991,92,76593
10460,0.000717,74.125.24.0-255,1484,28475,92,76593
10461,0.00072,74.125.24.0-255,1484,29959,92,76593
10462,0.000722,172.31.47.0-255,66,30025,92,76593
10463,0.000725,172.31.47.0-255,66,30091,92,76593
10464,0.000747,74.125.24.0-255,5689,35780,92,76593
10465,0.00075,172.31.47.0-255,66,35846,92,76593
10466,0.000753,74.125.24.0-255,111,35957,92,76593
10467,0.000889,172.31.47.0-255,66,36023,92,76593
10468,0.002014,74.125.24.0-255,1484,37507,92,76593
10469,0.002028,74.125.24.0-255,2902,40409,92,76593
10470,0.002036,172.31.47.0-255,66,40475,92,76593
10471,0.002045,74.125.24.0-255,5738,46213,92,76593
10472,0.002048,172.31.47.0-255,66,46279,92,76593
10473,0.002055,74.125.24.0-255,7156,53435,92,76593
10474,0.002057,172.31.47.0-255,66,53501,92,76593
10475,0.002069,172.31.47.0-255,66,53567,92,76593
10476,0.002086,74.125.24.0-255,2902,56469,92,76593
10477,0.002087,172.31.47.0-255,66,56535,92,76593
10478,0.002092,74.125.24.0-255,2184,58719,92,76593
10479,0.002093,172.31.47.0-255,66,58785,92,76593
10480,0.004094,74.125.24.0-255,2902,61687,92,76593
10481,0.004103,172.31.47.0-255,66,61753,92,76593
10482,0.004122,74.125.24.0-255,2902,64655,92,76593
10483,0.004124,172.31.47.0-255,66,64721,92,76593
10484,0.006087,74.125.24.0-255,2902,67623,92,76593
10485,0.006099,172.31.47.0-255,66,67689,92,76593
10486,0.006134,74.125.24.0-255,2902,70591,92,76593
10487,0.006138,172.31.47.0-255,66,70657,92,76593
10488,0.008077,74.125.24.0-255,2902,73559,92,76593
10489,0.008087,172.31.47.0-255,66,73625,92,76593
10490,0.008149,74.125.24.0-255,2902,76527,92,76593
10491,0.008153,172.31.47.0-255,66,76593,92,76593
10492,0.0,172.31.47.0-255,105,105,92,105
10493,0.0,172.31.47.0-255,74,74,92,1321
10494,0.001654,172.217.27.0-255,74,148,92,1321
10495,0.001677,172.31.47.0-255,66,214,92,1321
10496,0.003268,172.31.47.0-255,697,911,92,1321
10497,0.004888,172.217.27.0-255,66,977,92,1321
10498,0.005258,172.217.27.0-255,278,1255,92,1321
10499,0.005268,172.31.47.0-255,66,1321,92,1321
10500,0.0,172.31.47.0-255,105,105,92,276
10501,0.001647,157.240.13.0-255,105,210,92,276
10502,0.001655,172.31.47.0-255,66,276,92,276
10503,0.0,74.125.130.0-255,225,225,92,50861
10504,1.6e-05,172.31.47.0-255,66,291,92,50861
10505,2.2e-05,74.125.130.0-255,1484,1775,92,50861
10506,2.5e-05,172.31.47.0-255,66,1841,92,50861
10507,5e-05,74.125.130.0-255,2902,4743,92,50861
10508,5.4e-05,172.31.47.0-255,66,4809,92,50861
10509,7.9e-05,74.125.130.0-255,1484,6293,92,50861
10510,8.1e-05,172.31.47.0-255,66,6359,92,50861
10511,0.00024,74.125.130.0-255,5738,12097,92,50861
10512,0.000245,172.31.47.0-255,66,12163,92,50861
10513,0.000263,74.125.130.0-255,1957,14120,92,50861
10514,0.000265,172.31.47.0-255,66,14186,92,50861
10515,0.000595,74.125.130.0-255,5738,19924,92,50861
10516,0.0006,172.31.47.0-255,66,19990,92,50861
10517,0.000626,74.125.130.0-255,2902,22892,92,50861
10518,0.000629,172.31.47.0-255,66,22958,92,50861
10519,0.000957,74.125.130.0-255,5738,28696,92,50861
10520,0.000963,172.31.47.0-255,66,28762,92,50861
10521,0.00099,74.125.130.0-255,2543,31305,92,50861
10522,0.000993,172.31.47.0-255,66,31371,92,50861
10523,0.002293,74.125.130.0-255,1534,32905,92,50861
10524,0.002296,172.31.47.0-255,66,32971,92,50861
10525,0.003234,74.125.130.0-255,2902,35873,92,50861
10526,0.00324,172.31.47.0-255,66,35939,92,50861
10527,0.004551,74.125.130.0-255,2902,38841,92,50861
10528,0.004557,172.31.47.0-255,66,38907,92,50861
10529,0.005485,74.125.130.0-255,2902,41809,92,50861
10530,0.005493,172.31.47.0-255,66,41875,92,50861
10531,0.006802,74.125.130.0-255,2902,44777,92,50861
10532,0.006809,172.31.47.0-255,66,44843,92,50861
10533,0.007756,74.125.130.0-255,1434,46277,92,50861
10534,0.007761,172.31.47.0-255,66,46343,92,50861
10535,0.007791,74.125.130.0-255,1484,47827,92,50861
10536,0.007794,172.31.47.0-255,66,47893,92,50861
10537,0.009043,74.125.130.0-255,2902,50795,92,50861
10538,0.009049,172.31.47.0-255,66,50861,92,50861
10539,0.0,172.31.47.0-255,105,105,92,630
10540,4.1e-05,172.31.47.0-255,105,210,92,630
10541,7.8e-05,172.31.47.0-255,105,315,92,630
10542,0.001513,157.240.13.0-255,105,420,92,630
10543,0.001844,157.240.13.0-255,105,525,92,630
10544,0.002119,157.240.13.0-255,105,630,92,630
10545,0.0,172.217.24.0-255,153,153,92,152772
10546,2.8e-05,172.31.47.0-255,66,219,92,152772
10547,3.4e-05,172.217.24.0-255,1484,1703,92,152772
10548,3.8e-05,172.31.47.0-255,66,1769,92,152772
10549,4.2e-05,172.217.24.0-255,2902,4671,92,152772
10550,4.5e-05,172.31.47.0-255,66,4737,92,152772
10551,5.8e-05,172.217.24.0-255,7156,11893,92,152772
10552,6.1e-05,172.31.47.0-255,66,11959,92,152772
10553,6.4e-05,172.217.24.0-255,1484,13443,92,152772
10554,6.5e-05,172.31.47.0-255,66,13509,92,152772
10555,9.9e-05,172.217.24.0-255,605,14114,92,152772
10556,0.000101,172.31.47.0-255,66,14180,92,152772
10557,0.000139,172.217.24.0-255,1484,15664,92,152772
10558,0.000142,172.31.47.0-255,66,15730,92,152772
10559,0.000146,172.217.24.0-255,1484,17214,92,152772
10560,0.000148,172.31.47.0-255,66,17280,92,152772
10561,0.000176,172.217.24.0-255,2902,20182,92,152772
10562,0.000179,172.31.47.0-255,66,20248,92,152772
10563,0.000184,172.217.24.0-255,5738,25986,92,152772
10564,0.000186,172.31.47.0-255,66,26052,92,152772
10565,0.000206,172.217.24.0-255,5379,31431,92,152772
10566,0.000209,172.31.47.0-255,66,31497,92,152772
10567,0.000374,172.217.24.0-255,1484,32981,92,152772
10568,0.00038,172.31.47.0-255,66,33047,92,152772
10569,0.000385,172.217.24.0-255,2902,35949,92,152772
10570,0.000386,172.31.47.0-255,66,36015,92,152772
10571,0.000392,172.217.24.0-255,5738,41753,92,152772
10572,0.000394,172.31.47.0-255,66,41819,92,152772
10573,0.000403,172.217.24.0-255,4320,46139,92,152772
10574,0.000405,172.31.47.0-255,66,46205,92,152772
10575,0.000454,172.217.24.0-255,2543,48748,92,152772
10576,0.000458,172.31.47.0-255,66,48814,92,152772
10577,0.000493,172.217.24.0-255,2902,51716,92,152772
10578,0.000497,172.31.47.0-255,66,51782,92,152772
10579,0.000501,172.217.24.0-255,2902,54684,92,152772
10580,0.000513,172.31.47.0-255,66,54750,92,152772
10581,0.000529,172.217.24.0-255,4320,59070,92,152772
10582,0.000538,172.31.47.0-255,66,59136,92,152772
10583,0.000567,172.217.24.0-255,7088,66224,92,152772
10584,0.000578,172.31.47.0-255,66,66290,92,152772
10585,0.001115,172.217.24.0-255,132,66422,92,152772
10586,0.001166,172.31.47.0-255,66,66488,92,152772
10587,0.001213,172.217.24.0-255,1484,67972,92,152772
10588,0.001218,172.31.47.0-255,66,68038,92,152772
10589,0.00124,172.217.24.0-255,2902,70940,92,152772
10590,0.001246,172.217.24.0-255,5738,76678,92,152772
10591,0.001255,172.31.47.0-255,66,76744,92,152772
10592,0.001284,172.217.24.0-255,6797,83541,92,152772
10593,0.001299,172.217.24.0-255,7156,90697,92,152772
10594,0.001299,172.31.47.0-255,66,90763,92,152772
10595,0.001304,172.31.47.0-255,66,90829,92,152772
10596,0.001335,172.31.47.0-255,66,90895,92,152772
10597,0.001359,172.217.24.0-255,1125,92020,92,152772
10598,0.001466,172.217.24.0-255,1484,93504,92,152772
10599,0.001469,172.31.47.0-255,66,93570,92,152772
10600,0.001473,172.217.24.0-255,2902,96472,92,152772
10601,0.001481,172.31.47.0-255,66,96538,92,152772
10602,0.0015,172.217.24.0-255,5738,102276,92,152772
10603,0.001505,172.217.24.0-255,2902,105178,92,152772
10604,0.001505,172.31.47.0-255,66,105244,92,152772
10605,0.001509,172.31.47.0-255,66,105310,92,152772
10606,0.001552,172.31.47.0-255,66,105376,92,152772
10607,0.001565,172.31.47.0-255,66,105442,92,152772
10608,0.001603,172.217.24.0-255,2184,107626,92,152772
10609,0.001606,172.31.47.0-255,66,107692,92,152772
10610,0.001619,172.217.24.0-255,2902,110594,92,152772
10611,0.001628,172.217.24.0-255,4320,114914,92,152772
10612,0.001632,172.31.47.0-255,66,114980,92,152772
10613,0.001645,172.217.24.0-255,5738,120718,92,152772
10614,0.001653,172.31.47.0-255,66,120784,92,152772
10615,0.00166,172.217.24.0-255,2902,123686,92,152772
10616,0.001665,172.31.47.0-255,66,123752,92,152772
10617,0.001675,172.217.24.0-255,5738,129490,92,152772
10618,0.00168,172.31.47.0-255,66,129556,92,152772
10619,0.001709,172.31.47.0-255,66,129622,92,152772
10620,0.003655,172.217.24.0-255,5738,135360,92,152772
10621,0.003661,172.31.47.0-255,66,135426,92,152772
10622,0.005603,172.217.24.0-255,5738,141164,92,152772
10623,0.005609,172.31.47.0-255,66,141230,92,152772
10624,0.007573,172.217.24.0-255,5738,146968,92,152772
10625,0.00758,172.31.47.0-255,66,147034,92,152772
10626,0.009542,172.217.24.0-255,5738,152772,92,152772
10627,0.0,74.125.24.0-255,225,225,92,31257
10628,3e-05,172.31.47.0-255,66,291,92,31257
10629,3.6e-05,74.125.24.0-255,1484,1775,92,31257
10630,3.9e-05,172.31.47.0-255,66,1841,92,31257
10631,7.3e-05,74.125.24.0-255,4320,6161,92,31257
10632,7.9e-05,172.31.47.0-255,66,6227,92,31257
10633,0.000248,172.31.47.0-255,66,6293,92,31257
10634,0.000615,74.125.24.0-255,5738,12031,92,31257
10635,0.00062,172.31.47.0-255,66,12097,92,31257
10636,0.000849,74.125.24.0-255,1484,13581,92,31257
10637,0.000854,172.31.47.0-255,66,13647,92,31257
10638,0.000891,172.31.47.0-255,66,13713,92,31257
10639,0.003187,74.125.24.0-255,5738,19451,92,31257
10640,0.003193,172.31.47.0-255,66,19517,92,31257
10641,0.005519,74.125.24.0-255,5738,25255,92,31257
10642,0.00553,172.31.47.0-255,66,25321,92,31257
10643,0.00783,74.125.24.0-255,2902,28223,92,31257
10644,0.007837,172.31.47.0-255,66,28289,92,31257
10645,0.007871,74.125.24.0-255,2902,31191,92,31257
10646,0.007874,172.31.47.0-255,66,31257,92,31257
10647,0.0,74.125.200.0-255,153,153,92,134271
10648,2.4e-05,172.31.47.0-255,66,219,92,134271
10649,3.1e-05,74.125.200.0-255,1484,1703,92,134271
10650,3.4e-05,172.31.47.0-255,66,1769,92,134271
10651,5.9e-05,74.125.200.0-255,2902,4671,92,134271
10652,6.2e-05,172.31.47.0-255,66,4737,92,134271
10653,7.4e-05,74.125.200.0-255,7156,11893,92,134271
10654,7.6e-05,172.31.47.0-255,66,11959,92,134271
10655,8e-05,74.125.200.0-255,2220,14179,92,134271
10656,8.4e-05,172.31.47.0-255,66,14245,92,134271
10657,0.000267,74.125.200.0-255,1484,15729,92,134271
10658,0.000272,172.31.47.0-255,66,15795,92,134271
10659,0.000278,74.125.200.0-255,2902,18697,92,134271
10660,0.000282,172.31.47.0-255,66,18763,92,134271
10661,0.000302,74.125.200.0-255,4320,23083,92,134271
10662,0.000305,172.31.47.0-255,66,23149,92,134271
10663,0.000328,74.125.200.0-255,1484,24633,92,134271
10664,0.000331,172.31.47.0-255,66,24699,92,134271
10665,0.000338,74.125.200.0-255,6797,31496,92,134271
10666,0.000342,172.31.47.0-255,66,31562,92,134271
10667,0.000376,74.125.200.0-255,7156,38718,92,134271
10668,0.00038,172.31.47.0-255,66,38784,92,134271
10669,0.000385,74.125.200.0-255,2902,41686,92,134271
10670,0.000388,172.31.47.0-255,66,41752,92,134271
10671,0.000422,74.125.200.0-255,6797,48549,92,134271
10672,0.000426,172.31.47.0-255,66,48615,92,134271
10673,0.000445,74.125.200.0-255,2902,51517,92,134271
10674,0.000448,172.31.47.0-255,66,51583,92,134271
10675,0.000453,74.125.200.0-255,4320,55903,92,134271
10676,0.000455,172.31.47.0-255,66,55969,92,134271
10677,0.00046,74.125.200.0-255,4320,60289,92,134271
10678,0.000463,172.31.47.0-255,66,60355,92,134271
10679,0.000491,74.125.200.0-255,4320,64675,92,134271
10680,0.000494,172.31.47.0-255,66,64741,92,134271
10681,0.000497,74.125.200.0-255,1395,66136,92,134271
10682,0.000624,74.125.200.0-255,137,66273,92,134271
10683,0.000661,74.125.200.0-255,346,66619,92,134271
10684,0.000664,172.31.47.0-255,66,66685,92,134271
10685,0.000922,74.125.200.0-255,1484,68169,92,134271
10686,0.000931,74.125.200.0-255,2902,71071,92,134271
10687,0.000934,172.31.47.0-255,66,71137,92,134271
10688,0.000939,74.125.200.0-255,2902,74039,92,134271
10689,0.000941,172.31.47.0-255,66,74105,92,134271
10690,0.000962,74.125.200.0-255,2902,77007,92,134271
10691,0.000969,172.31.47.0-255,66,77073,92,134271
10692,0.000974,74.125.200.0-255,2902,79975,92,134271
10693,0.000976,172.31.47.0-255,66,80041,92,134271
10694,0.001019,74.125.200.0-255,4320,84361,92,134271
10695,0.001024,172.31.47.0-255,66,84427,92,134271
10696,0.001026,172.31.47.0-255,66,84493,92,134271
10697,0.001066,74.125.200.0-255,6438,90931,92,134271
10698,0.00107,172.31.47.0-255,66,90997,92,134271
10699,0.001859,74.125.200.0-255,1484,92481,92,134271
10700,0.001866,74.125.200.0-255,1484,93965,92,134271
10701,0.001869,172.31.47.0-255,66,94031,92,134271
10702,0.001892,74.125.200.0-255,1484,95515,92,134271
10703,0.001897,74.125.200.0-255,5738,101253,92,134271
10704,0.001899,172.31.47.0-255,66,101319,92,134271
10705,0.001903,74.125.200.0-255,2902,104221,92,134271
10706,0.001904,172.31.47.0-255,66,104287,92,134271
10707,0.001925,74.125.200.0-255,4320,108607,92,134271
10708,0.001931,172.31.47.0-255,66,108673,92,134271
10709,0.00196,172.31.47.0-255,66,108739,92,134271
10710,0.001998,74.125.200.0-255,4320,113059,92,134271
10711,0.002,172.31.47.0-255,66,113125,92,134271
10712,0.002025,74.125.200.0-255,3602,116727,92,134271
10713,0.002027,172.31.47.0-255,66,116793,92,134271
10714,0.004279,74.125.200.0-255,1484,118277,92,134271
10715,0.004296,74.125.200.0-255,4320,122597,92,134271
10716,0.004299,172.31.47.0-255,66,122663,92,134271
10717,0.006584,74.125.200.0-255,5738,128401,92,134271
10718,0.006589,172.31.47.0-255,66,128467,92,134271
10719,0.008871,74.125.200.0-255,5738,134205,92,134271
10720,0.008879,172.31.47.0-255,66,134271,92,134271
10721,0.0,74.125.68.0-255,297,297,92,221538
10722,2.5e-05,172.31.47.0-255,66,363,92,221538
10723,3.1e-05,74.125.68.0-255,1484,1847,92,221538
10724,3.6e-05,172.31.47.0-255,66,1913,92,221538
10725,3.9e-05,74.125.68.0-255,1484,3397,92,221538
10726,5e-05,172.31.47.0-255,66,3463,92,221538
10727,5.6e-05,74.125.68.0-255,2902,6365,92,221538
10728,5.9e-05,172.31.47.0-255,66,6431,92,221538
10729,6.5e-05,74.125.68.0-255,5738,12169,92,221538
10730,6.8e-05,172.31.47.0-255,66,12235,92,221538
10731,7e-05,74.125.68.0-255,1484,13719,92,221538
10732,7.3e-05,172.31.47.0-255,66,13785,92,221538
10733,0.000103,74.125.68.0-255,488,14273,92,221538
10734,0.000105,172.31.47.0-255,66,14339,92,221538
10735,0.000152,74.125.68.0-255,1484,15823,92,221538
10736,0.000155,172.31.47.0-255,66,15889,92,221538
10737,0.000186,74.125.68.0-255,2902,18791,92,221538
10738,0.000189,172.31.47.0-255,66,18857,92,221538
10739,0.000196,74.125.68.0-255,5738,24595,92,221538
10740,0.000198,172.31.47.0-255,66,24661,92,221538
10741,0.000226,74.125.68.0-255,6797,31458,92,221538
10742,0.000228,172.31.47.0-255,66,31524,92,221538
10743,0.000284,74.125.68.0-255,7156,38680,92,221538
10744,0.000291,74.125.68.0-255,7156,45836,92,221538
10745,0.000295,172.31.47.0-255,66,45902,92,221538
10746,0.000298,172.31.47.0-255,66,45968,92,221538
10747,0.00035,74.125.68.0-255,2543,48511,92,221538
10748,0.000353,172.31.47.0-255,66,48577,92,221538
10749,0.000589,74.125.68.0-255,1484,50061,92,221538
10750,0.000594,172.31.47.0-255,66,50127,92,221538
10751,0.000626,74.125.68.0-255,1484,51611,92,221538
10752,0.00063,172.31.47.0-255,66,51677,92,221538
10753,0.000665,74.125.68.0-255,2902,54579,92,221538
10754,0.000668,172.31.47.0-255,66,54645,92,221538
10755,0.000675,74.125.68.0-255,5738,60383,92,221538
10756,0.000678,172.31.47.0-255,66,60449,92,221538
10757,0.000683,74.125.68.0-255,5379,65828,92,221538
10758,0.00069,74.125.68.0-255,5738,71566,92,221538
10759,0.000716,74.125.68.0-255,4320,75886,92,221538
10760,0.000728,74.125.68.0-255,2902,78788,92,221538
10761,0.000756,74.125.68.0-255,2902,81690,92,221538
10762,0.000768,74.125.68.0-255,1705,83395,92,221538
10763,0.000787,74.125.68.0-255,4320,87715,92,221538
10764,0.000802,74.125.68.0-255,1484,89199,92,221538
10765,0.000805,74.125.68.0-255,1484,90683,92,221538
10766,0.00083,74.125.68.0-255,5738,96421,92,221538
10767,0.000859,74.125.68.0-255,3961,100382,92,221538
10768,0.000978,172.31.47.0-255,66,100448,92,221538
10769,0.001371,74.125.68.0-255,1484,101932,92,221538
10770,0.001377,74.125.68.0-255,1484,103416,92,221538
10771,0.00138,172.31.47.0-255,66,103482,92,221538
10772,0.001417,74.125.68.0-255,1484,104966,92,221538
10773,0.001426,74.125.68.0-255,5738,110704,92,221538
10774,0.001428,74.125.68.0-255,1484,112188,92,221538
10775,0.001432,74.125.68.0-255,2902,115090,92,221538
10776,0.001455,74.125.68.0-255,5738,120828,92,221538
10777,0.001468,172.31.47.0-255,66,120894,92,221538
10778,0.001513,172.31.47.0-255,66,120960,92,221538
10779,0.00158,74.125.68.0-255,5020,125980,92,221538
10780,0.0016,172.31.47.0-255,66,126046,92,221538
10781,0.001603,74.125.68.0-255,1484,127530,92,221538
10782,0.001606,74.125.68.0-255,1484,129014,92,221538
10783,0.001611,172.31.47.0-255,66,129080,92,221538
10784,0.001642,74.125.68.0-255,1484,130564,92,221538
10785,0.001649,74.125.68.0-255,5738,136302,92,221538
10786,0.001659,74.125.68.0-255,7156,143458,92,221538
10787,0.001671,74.125.68.0-255,2902,146360,92,221538
10788,0.001684,74.125.68.0-255,4320,150680,92,221538
10789,0.001689,172.31.47.0-255,66,150746,92,221538
10790,0.001725,74.125.68.0-255,2902,153648,92,221538
10791,0.001738,74.125.68.0-255,2184,155832,92,221538
10792,0.00174,74.125.68.0-255,1484,157316,92,221538
10793,0.001752,74.125.68.0-255,4320,161636,92,221538
10794,0.001771,172.31.47.0-255,66,161702,92,221538
10795,0.001777,74.125.68.0-255,4320,166022,92,221538
10796,0.001782,172.31.47.0-255,66,166088,92,221538
10797,0.001804,74.125.68.0-255,5738,171826,92,221538
10798,0.001807,74.125.68.0-255,1484,173310,92,221538
10799,0.00182,172.31.47.0-255,66,173376,92,221538
10800,0.001862,74.125.68.0-255,2184,175560,92,221538
10801,0.001885,172.31.47.0-255,66,175626,92,221538
10802,0.001929,74.125.68.0-255,1484,177110,92,221538
10803,0.00195,74.125.68.0-255,2902,180012,92,221538
10804,0.001966,172.31.47.0-255,66,180078,92,221538
10805,0.001972,74.125.68.0-255,5738,185816,92,221538
10806,0.002015,74.125.68.0-255,1484,187300,92,221538
10807,0.002022,172.31.47.0-255,66,187366,92,221538
10808,0.002032,74.125.68.0-255,2902,190268,92,221538
10809,0.002037,74.125.68.0-255,5738,196006,92,221538
10810,0.002043,74.125.68.0-255,1484,197490,92,221538
10811,0.002071,74.125.68.0-255,4320,201810,92,221538
10812,0.002078,172.31.47.0-255,66,201876,92,221538
10813,0.002107,74.125.68.0-255,4320,206196,92,221538
10814,0.002112,74.125.68.0-255,2902,209098,92,221538
10815,0.002114,74.125.68.0-255,766,209864,92,221538
10816,0.002139,172.31.47.0-255,66,209930,92,221538
10817,0.004274,74.125.68.0-255,5738,215668,92,221538
10818,0.004287,172.31.47.0-255,66,215734,92,221538
10819,0.006383,74.125.68.0-255,5738,221472,92,221538
10820,0.009993,172.31.47.0-255,66,221538,92,221538
10821,0.0,74.125.200.0-255,153,153,92,233800
10822,1.5e-05,172.31.47.0-255,66,219,92,233800
10823,2.1e-05,74.125.200.0-255,1484,1703,92,233800
10824,2.5e-05,172.31.47.0-255,66,1769,92,233800
10825,4.1e-05,74.125.200.0-255,2902,4671,92,233800
10826,4.4e-05,172.31.47.0-255,66,4737,92,233800
10827,6.7e-05,74.125.200.0-255,1484,6221,92,233800
10828,6.9e-05,172.31.47.0-255,66,6287,92,233800
10829,9.3e-05,74.125.200.0-255,5738,12025,92,233800
10830,9.5e-05,172.31.47.0-255,66,12091,92,233800
10831,0.000113,74.125.200.0-255,2144,14235,92,233800
10832,0.000115,172.31.47.0-255,66,14301,92,233800
10833,0.000212,74.125.200.0-255,1484,15785,92,233800
10834,0.000216,172.31.47.0-255,66,15851,92,233800
10835,0.000221,74.125.200.0-255,2902,18753,92,233800
10836,0.000223,172.31.47.0-255,66,18819,92,233800
10837,0.000242,74.125.200.0-255,2902,21721,92,233800
10838,0.000244,172.31.47.0-255,66,21787,92,233800
10839,0.000256,74.125.200.0-255,2902,24689,92,233800
10840,0.000258,172.31.47.0-255,66,24755,92,233800
10841,0.000263,74.125.200.0-255,5738,30493,92,233800
10842,0.000266,172.31.47.0-255,66,30559,92,233800
10843,0.000294,74.125.200.0-255,2902,33461,92,233800
10844,0.000297,172.31.47.0-255,66,33527,92,233800
10845,0.000319,74.125.200.0-255,3961,37488,92,233800
10846,0.000322,172.31.47.0-255,66,37554,92,233800
10847,0.000327,74.125.200.0-255,4320,41874,92,233800
10848,0.000329,172.31.47.0-255,66,41940,92,233800
10849,0.000332,74.125.200.0-255,1484,43424,92,233800
10850,0.000334,172.31.47.0-255,66,43490,92,233800
10851,0.000361,74.125.200.0-255,4320,47810,92,233800
10852,0.000364,172.31.47.0-255,66,47876,92,233800
10853,0.000371,74.125.200.0-255,5738,53614,92,233800
10854,0.000373,172.31.47.0-255,66,53680,92,233800
10855,0.000403,74.125.200.0-255,7156,60836,92,233800
10856,0.000406,172.31.47.0-255,66,60902,92,233800
10857,0.000414,74.125.200.0-255,5020,65922,92,233800
10858,0.000417,172.31.47.0-255,66,65988,92,233800
10859,0.000441,74.125.200.0-255,433,66421,92,233800
10860,0.000516,74.125.200.0-255,1484,67905,92,233800
10861,0.000521,172.31.47.0-255,66,67971,92,233800
10862,0.000525,74.125.200.0-255,2902,70873,92,233800
10863,0.000528,172.31.47.0-255,66,70939,92,233800
10864,0.000532,74.125.200.0-255,2902,73841,92,233800
10865,0.000535,172.31.47.0-255,66,73907,92,233800
10866,0.000551,74.125.200.0-255,2902,76809,92,233800
10867,0.000554,172.31.47.0-255,66,76875,92,233800
10868,0.000571,74.125.200.0-255,4320,81195,92,233800
10869,0.000573,172.31.47.0-255,66,81261,92,233800
10870,0.000597,172.31.47.0-255,66,81327,92,233800
10871,0.000655,74.125.200.0-255,5738,87065,92,233800
10872,0.000657,172.31.47.0-255,66,87131,92,233800
10873,0.000678,74.125.200.0-255,5297,92428,92,233800
10874,0.000681,172.31.47.0-255,66,92494,92,233800
10875,0.000684,74.125.200.0-255,1484,93978,92,233800
10876,0.000709,74.125.200.0-255,2902,96880,92,233800
10877,0.000712,172.31.47.0-255,66,96946,92,233800
10878,0.000715,74.125.200.0-255,1484,98430,92,233800
10879,0.000731,74.125.200.0-255,4320,102750,92,233800
10880,0.000733,172.31.47.0-255,66,102816,92,233800
10881,0.000754,74.125.200.0-255,2902,105718,92,233800
10882,0.000757,172.31.47.0-255,66,105784,92,233800
10883,0.00078,74.125.200.0-255,2902,108686,92,233800
10884,0.000782,172.31.47.0-255,66,108752,92,233800
10885,0.00079,74.125.200.0-255,7156,115908,92,233800
10886,0.000792,172.31.47.0-255,66,115974,92,233800
10887,0.000797,74.125.200.0-255,2902,118876,92,233800
10888,0.000799,172.31.47.0-255,66,118942,92,233800
10889,0.000829,172.31.47.0-255,66,119008,92,233800
10890,0.000845,74.125.200.0-255,1484,120492,92,233800
10891,0.000849,74.125.200.0-255,1484,121976,92,233800
10892,0.000851,172.31.47.0-255,66,122042,92,233800
10893,0.000871,74.125.200.0-255,1484,123526,92,233800
10894,0.000877,74.125.200.0-255,5738,129264,92,233800
10895,0.00088,172.31.47.0-255,66,129330,92,233800
10896,0.000882,74.125.200.0-255,1484,130814,92,233800
10897,0.000886,74.125.200.0-255,2902,133716,92,233800
10898,0.000889,172.31.47.0-255,66,133782,92,233800
10899,0.000911,74.125.200.0-255,5738,139520,92,233800
10900,0.000914,172.31.47.0-255,66,139586,92,233800
10901,0.000941,172.31.47.0-255,66,139652,92,233800
10902,0.000963,74.125.200.0-255,2184,141836,92,233800
10903,0.000966,172.31.47.0-255,66,141902,92,233800
10904,0.001198,74.125.200.0-255,1484,143386,92,233800
10905,0.001215,74.125.200.0-255,2902,146288,92,233800
10906,0.001219,172.31.47.0-255,66,146354,92,233800
10907,0.001239,74.125.200.0-255,4320,150674,92,233800
10908,0.001242,172.31.47.0-255,66,150740,92,233800
10909,0.001267,74.125.200.0-255,2902,153642,92,233800
10910,0.00127,172.31.47.0-255,66,153708,92,233800
10911,0.001295,74.125.200.0-255,5738,159446,92,233800
10912,0.001298,172.31.47.0-255,66,159512,92,233800
10913,0.001301,74.125.200.0-255,1484,160996,92,233800
10914,0.00132,74.125.200.0-255,7156,168152,92,233800
10915,0.001323,172.31.47.0-255,66,168218,92,233800
10916,0.001341,74.125.200.0-255,4320,172538,92,233800
10917,0.001344,172.31.47.0-255,66,172604,92,233800
10918,0.001349,74.125.200.0-255,2902,175506,92,233800
10919,0.001351,172.31.47.0-255,66,175572,92,233800
10920,0.001371,74.125.200.0-255,766,176338,92,233800
10921,0.001468,74.125.200.0-255,1484,177822,92,233800
10922,0.001472,172.31.47.0-255,66,177888,92,233800
10923,0.001476,74.125.200.0-255,1484,179372,92,233800
10924,0.001491,74.125.200.0-255,1484,180856,92,233800
10925,0.001494,172.31.47.0-255,66,180922,92,233800
10926,0.001508,74.125.200.0-255,5738,186660,92,233800
10927,0.001511,172.31.47.0-255,66,186726,92,233800
10928,0.00155,172.31.47.0-255,66,186792,92,233800
10929,0.001555,74.125.200.0-255,2902,189694,92,233800
10930,0.001556,172.31.47.0-255,66,189760,92,233800
10931,0.001577,172.31.47.0-255,66,189826,92,233800
10932,0.001582,74.125.200.0-255,2184,192010,92,233800
10933,0.001583,172.31.47.0-255,66,192076,92,233800
10934,0.001769,74.125.200.0-255,1484,193560,92,233800
10935,0.001789,74.125.200.0-255,1484,195044,92,233800
10936,0.001793,172.31.47.0-255,66,195110,92,233800
10937,0.001799,74.125.200.0-255,2902,198012,92,233800
10938,0.001801,172.31.47.0-255,66,198078,92,233800
10939,0.001825,74.125.200.0-255,5738,203816,92,233800
10940,0.001828,172.31.47.0-255,66,203882,92,233800
10941,0.001838,74.125.200.0-255,2902,206784,92,233800
10942,0.00184,172.31.47.0-255,66,206850,92,233800
10943,0.001861,172.31.47.0-255,66,206916,92,233800
10944,0.001893,74.125.200.0-255,4320,211236,92,233800
10945,0.001896,172.31.47.0-255,66,211302,92,233800
10946,0.001917,74.125.200.0-255,5020,216322,92,233800
10947,0.001921,172.31.47.0-255,66,216388,92,233800
10948,0.003966,74.125.200.0-255,5738,222126,92,233800
10949,0.003973,172.31.47.0-255,66,222192,92,233800
10950,0.006081,74.125.200.0-255,5738,227930,92,233800
10951,0.006098,172.31.47.0-255,66,227996,92,233800
10952,0.00817,74.125.200.0-255,5738,233734,92,233800
10953,0.008183,172.31.47.0-255,66,233800,92,233800
10954,0.0,74.125.24.0-255,153,153,92,156118
10955,1.6e-05,172.31.47.0-255,66,219,92,156118
10956,2.2e-05,74.125.24.0-255,1484,1703,92,156118
10957,2.5e-05,172.31.47.0-255,66,1769,92,156118
10958,3.1e-05,74.125.24.0-255,2902,4671,92,156118
10959,3.4e-05,172.31.47.0-255,66,4737,92,156118
10960,5.5e-05,74.125.24.0-255,5738,10475,92,156118
10961,5.8e-05,172.31.47.0-255,66,10541,92,156118
10962,8e-05,74.125.24.0-255,3546,14087,92,156118
10963,8.2e-05,172.31.47.0-255,66,14153,92,156118
10964,0.000819,74.125.24.0-255,1484,15637,92,156118
10965,0.000825,172.31.47.0-255,66,15703,92,156118
10966,0.000834,74.125.24.0-255,2902,18605,92,156118
10967,0.000836,172.31.47.0-255,66,18671,92,156118
10968,0.000864,74.125.24.0-255,5738,24409,92,156118
10969,0.000867,172.31.47.0-255,66,24475,92,156118
10970,0.00087,74.125.24.0-255,1484,25959,92,156118
10971,0.000871,172.31.47.0-255,66,26025,92,156118
10972,0.000876,74.125.24.0-255,2902,28927,92,156118
10973,0.000878,172.31.47.0-255,66,28993,92,156118
10974,0.000908,74.125.24.0-255,6797,35790,92,156118
10975,0.000911,172.31.47.0-255,66,35856,92,156118
10976,0.000954,172.31.47.0-255,66,35922,92,156118
10977,0.000984,74.125.24.0-255,5738,41660,92,156118
10978,0.000987,172.31.47.0-255,66,41726,92,156118
10979,0.000998,172.31.47.0-255,66,41792,92,156118
10980,0.001492,74.125.24.0-255,136,41928,92,156118
10981,0.001498,172.31.47.0-255,66,41994,92,156118
10982,0.001535,74.125.24.0-255,1484,43478,92,156118
10983,0.001538,172.31.47.0-255,66,43544,92,156118
10984,0.001545,74.125.24.0-255,2902,46446,92,156118
10985,0.001562,74.125.24.0-255,7156,53602,92,156118
10986,0.001569,74.125.24.0-255,5738,59340,92,156118
10987,0.001591,74.125.24.0-255,2902,62242,92,156118
10988,0.001612,74.125.24.0-255,2902,65144,92,156118
10989,0.001627,74.125.24.0-255,5738,70882,92,156118
10990,0.001664,74.125.24.0-255,7156,78038,92,156118
10991,0.001693,74.125.24.0-255,5738,83776,92,156118
10992,0.001734,172.31.47.0-255,66,83842,92,156118
10993,0.00174,172.31.47.0-255,66,83908,92,156118
10994,0.001791,74.125.24.0-255,6438,90346,92,156118
10995,0.001814,172.31.47.0-255,66,90412,92,156118
10996,0.001859,74.125.24.0-255,1484,91896,92,156118
10997,0.001876,74.125.24.0-255,2902,94798,92,156118
10998,0.00188,74.125.24.0-255,1484,96282,92,156118
10999,0.0019,74.125.24.0-255,4320,100602,92,156118
11000,0.001904,172.31.47.0-255,66,100668,92,156118
11001,0.00191,172.31.47.0-255,66,100734,92,156118
11002,0.001921,74.125.24.0-255,1484,102218,92,156118
11003,0.001955,74.125.24.0-255,5738,107956,92,156118
11004,0.001977,172.31.47.0-255,66,108022,92,156118
11005,0.002011,74.125.24.0-255,5738,113760,92,156118
11006,0.002023,74.125.24.0-255,2184,115944,92,156118
11007,0.002032,172.31.47.0-255,66,116010,92,156118
11008,0.002309,74.125.24.0-255,1484,117494,92,156118
11009,0.002315,74.125.24.0-255,2902,120396,92,156118
11010,0.002321,74.125.24.0-255,5738,126134,92,156118
11011,0.00234,172.31.47.0-255,66,126200,92,156118
11012,0.002357,172.31.47.0-255,66,126266,92,156118
11013,0.002375,74.125.24.0-255,4320,130586,92,156118
11014,0.002384,172.31.47.0-255,66,130652,92,156118
11015,0.002394,74.125.24.0-255,4320,134972,92,156118
11016,0.002397,172.31.47.0-255,66,135038,92,156118
11017,0.002419,74.125.24.0-255,5738,140776,92,156118
11018,0.002501,74.125.24.0-255,3602,144378,92,156118
11019,0.002504,172.31.47.0-255,66,144444,92,156118
11020,0.002511,172.31.47.0-255,66,144510,92,156118
11021,0.005068,74.125.24.0-255,5738,150248,92,156118
11022,0.005075,172.31.47.0-255,66,150314,92,156118
11023,0.007617,74.125.24.0-255,5738,156052,92,156118
11024,0.008851,172.31.47.0-255,66,156118,92,156118
11025,0.0,172.217.194.0-255,153,153,92,167782
11026,2.8e-05,172.31.47.0-255,66,219,92,167782
11027,3.4e-05,172.217.194.0-255,1484,1703,92,167782
11028,3.8e-05,172.31.47.0-255,66,1769,92,167782
11029,4.2e-05,172.217.194.0-255,2902,4671,92,167782
11030,4.4e-05,172.31.47.0-255,66,4737,92,167782
11031,7.2e-05,172.217.194.0-255,7156,11893,92,167782
11032,7.4e-05,172.31.47.0-255,66,11959,92,167782
11033,7.7e-05,172.217.194.0-255,1484,13443,92,167782
11034,8.1e-05,172.31.47.0-255,66,13509,92,167782
11035,9.6e-05,172.217.194.0-255,5009,18518,92,167782
11036,9.8e-05,172.31.47.0-255,66,18584,92,167782
11037,0.000103,172.217.194.0-255,7156,25740,92,167782
11038,0.000105,172.31.47.0-255,66,25806,92,167782
11039,0.000143,172.31.47.0-255,66,25872,92,167782
11040,0.000149,172.217.194.0-255,6438,32310,92,167782
11041,0.000151,172.31.47.0-255,66,32376,92,167782
11042,0.000209,172.217.194.0-255,4320,36696,92,167782
11043,0.000212,172.31.47.0-255,66,36762,92,167782
11044,0.000244,172.31.47.0-255,66,36828,92,167782
11045,0.000289,172.217.194.0-255,1484,38312,92,167782
11046,0.000292,172.31.47.0-255,66,38378,92,167782
11047,0.000296,172.217.194.0-255,2902,41280,92,167782
11048,0.000298,172.31.47.0-255,66,41346,92,167782
11049,0.000301,172.217.194.0-255,1484,42830,92,167782
11050,0.000302,172.31.47.0-255,66,42896,92,167782
11051,0.000324,172.217.194.0-255,4320,47216,92,167782
11052,0.000327,172.31.47.0-255,66,47282,92,167782
11053,0.000336,172.31.47.0-255,66,47348,92,167782
11054,0.000364,172.217.194.0-255,4320,51668,92,167782
11055,0.000367,172.31.47.0-255,66,51734,92,167782
11056,0.000377,172.31.47.0-255,66,51800,92,167782
11057,0.000393,172.217.194.0-255,1484,53284,92,167782
11058,0.000395,172.31.47.0-255,66,53350,92,167782
11059,0.000423,172.217.194.0-255,4320,57670,92,167782
11060,0.000426,172.31.47.0-255,66,57736,92,167782
11061,0.000432,172.217.194.0-255,7156,64892,92,167782
11062,0.000435,172.31.47.0-255,66,64958,92,167782
11063,0.00044,172.217.194.0-255,4320,69278,92,167782
11064,0.000442,172.31.47.0-255,66,69344,92,167782
11065,0.000478,172.31.47.0-255,66,69410,92,167782
11066,0.000484,172.217.194.0-255,6438,75848,92,167782
11067,0.000486,172.31.47.0-255,66,75914,92,167782
11068,0.000499,172.217.194.0-255,5738,81652,92,167782
11069,0.000502,172.31.47.0-255,66,81718,92,167782
11070,0.000524,172.31.47.0-255,66,81784,92,167782
11071,0.000534,172.217.194.0-255,5738,87522,92,167782
11072,0.000536,172.31.47.0-255,66,87588,92,167782
11073,0.000547,172.217.194.0-255,1484,89072,92,167782
11074,0.000548,172.31.47.0-255,66,89138,92,167782
11075,0.000551,172.217.194.0-255,1484,90622,92,167782
11076,0.000553,172.31.47.0-255,66,90688,92,167782
11077,0.000566,172.217.194.0-255,4320,95008,92,167782
11078,0.000568,172.31.47.0-255,66,95074,92,167782
11079,0.000587,172.217.194.0-255,5320,100394,92,167782
11080,0.000591,172.31.47.0-255,66,100460,92,167782
11081,0.000667,172.217.194.0-255,1484,101944,92,167782
11082,0.00067,172.217.194.0-255,1484,103428,92,167782
11083,0.000671,172.31.47.0-255,66,103494,92,167782
11084,0.000678,172.217.194.0-255,1484,104978,92,167782
11085,0.000684,172.217.194.0-255,5738,110716,92,167782
11086,0.000685,172.31.47.0-255,66,110782,92,167782
11087,0.000689,172.31.47.0-255,66,110848,92,167782
11088,0.00075,172.31.47.0-255,66,110914,92,167782
11089,0.000757,172.217.194.0-255,7156,118070,92,167782
11090,0.000761,172.31.47.0-255,66,118136,92,167782
11091,0.000769,172.217.194.0-255,2902,121038,92,167782
11092,0.000776,172.31.47.0-255,66,121104,92,167782
11093,0.000779,172.217.194.0-255,766,121870,92,167782
11094,0.001536,172.31.47.0-255,66,121936,92,167782
11095,0.001688,172.217.194.0-255,1484,123420,92,167782
11096,0.001693,172.31.47.0-255,66,123486,92,167782
11097,0.0017,172.217.194.0-255,2902,126388,92,167782
11098,0.001703,172.31.47.0-255,66,126454,92,167782
11099,0.001709,172.217.194.0-255,5738,132192,92,167782
11100,0.001711,172.31.47.0-255,66,132258,92,167782
11101,0.001743,172.217.194.0-255,5738,137996,92,167782
11102,0.001746,172.31.47.0-255,66,138062,92,167782
11103,0.001768,172.217.194.0-255,7156,145218,92,167782
11104,0.001771,172.31.47.0-255,66,145284,92,167782
11105,0.00179,172.217.194.0-255,5738,151022,92,167782
11106,0.001792,172.31.47.0-255,66,151088,92,167782
11107,0.001816,172.217.194.0-255,5020,156108,92,167782
11108,0.001818,172.31.47.0-255,66,156174,92,167782
11109,0.003868,172.217.194.0-255,5738,161912,92,167782
11110,0.006473,172.31.47.0-255,66,161978,92,167782
11111,0.008539,172.217.194.0-255,5738,167716,92,167782
11112,0.008547,172.31.47.0-255,66,167782,92,167782
11113,0.0,74.125.200.0-255,152,152,92,212515
11114,3.3e-05,172.31.47.0-255,66,218,92,212515
11115,4e-05,74.125.200.0-255,1484,1702,92,212515
11116,4.5e-05,172.31.47.0-255,66,1768,92,212515
11117,5.6e-05,74.125.200.0-255,2902,4670,92,212515
11118,5.9e-05,172.31.47.0-255,66,4736,92,212515
11119,6.5e-05,74.125.200.0-255,5738,10474,92,212515
11120,6.7e-05,172.31.47.0-255,66,10540,92,212515
11121,7.2e-05,74.125.200.0-255,2902,13442,92,212515
11122,7.4e-05,172.31.47.0-255,66,13508,92,212515
11123,0.0001,74.125.200.0-255,639,14147,92,212515
11124,0.000102,172.31.47.0-255,66,14213,92,212515
11125,0.000284,74.125.200.0-255,1484,15697,92,212515
11126,0.00029,172.31.47.0-255,66,15763,92,212515
11127,0.000294,74.125.200.0-255,2902,18665,92,212515
11128,0.000296,172.31.47.0-255,66,18731,92,212515
11129,0.000331,74.125.200.0-255,5738,24469,92,212515
11130,0.000334,172.31.47.0-255,66,24535,92,212515
11131,0.000338,74.125.200.0-255,2902,27437,92,212515
11132,0.00034,172.31.47.0-255,66,27503,92,212515
11133,0.000344,74.125.200.0-255,3961,31464,92,212515
11134,0.000351,172.31.47.0-255,66,31530,92,212515
11135,0.000479,74.125.200.0-255,1484,33014,92,212515
11136,0.000483,172.31.47.0-255,66,33080,92,212515
11137,0.000487,74.125.200.0-255,1484,34564,92,212515
11138,0.000489,172.31.47.0-255,66,34630,92,212515
11139,0.000509,74.125.200.0-255,1484,36114,92,212515
11140,0.000512,172.31.47.0-255,66,36180,92,212515
11141,0.000538,74.125.200.0-255,5738,41918,92,212515
11142,0.000541,172.31.47.0-255,66,41984,92,212515
11143,0.000545,74.125.200.0-255,2902,44886,92,212515
11144,0.000546,172.31.47.0-255,66,44952,92,212515
11145,0.000574,74.125.200.0-255,3961,48913,92,212515
11146,0.000576,172.31.47.0-255,66,48979,92,212515
11147,0.000581,74.125.200.0-255,4320,53299,92,212515
11148,0.000583,172.31.47.0-255,66,53365,92,212515
11149,0.000613,74.125.200.0-255,2902,56267,92,212515
11150,0.000616,172.31.47.0-255,66,56333,92,212515
11151,0.000621,74.125.200.0-255,5738,62071,92,212515
11152,0.000623,172.31.47.0-255,66,62137,92,212515
11153,0.000671,74.125.200.0-255,2902,65039,92,212515
11154,0.000676,172.31.47.0-255,66,65105,92,212515
11155,0.000683,74.125.200.0-255,1477,66582,92,212515
11156,0.00076,74.125.200.0-255,333,66915,92,212515
11157,0.000764,172.31.47.0-255,66,66981,92,212515
11158,0.00115,74.125.200.0-255,1484,68465,92,212515
11159,0.001166,74.125.200.0-255,2902,71367,92,212515
11160,0.00117,172.31.47.0-255,66,71433,92,212515
11161,0.001175,74.125.200.0-255,2902,74335,92,212515
11162,0.001176,172.31.47.0-255,66,74401,92,212515
11163,0.001196,74.125.200.0-255,2902,77303,92,212515
11164,0.001199,172.31.47.0-255,66,77369,92,212515
11165,0.001209,74.125.200.0-255,7156,84525,92,212515
11166,0.001211,172.31.47.0-255,66,84591,92,212515
11167,0.001273,172.31.47.0-255,66,84657,92,212515
11168,0.001285,74.125.200.0-255,2184,86841,92,212515
11169,0.00129,172.31.47.0-255,66,86907,92,212515
11170,0.001437,74.125.200.0-255,1484,88391,92,212515
11171,0.001453,74.125.200.0-255,2902,91293,92,212515
11172,0.001456,172.31.47.0-255,66,91359,92,212515
11173,0.001481,74.125.200.0-255,5738,97097,92,212515
11174,0.001483,172.31.47.0-255,66,97163,92,212515
11175,0.001488,74.125.200.0-255,4320,101483,92,212515
11176,0.00149,172.31.47.0-255,66,101549,92,212515
11177,0.001493,74.125.200.0-255,1484,103033,92,212515
11178,0.001522,74.125.200.0-255,4320,107353,92,212515
11179,0.001524,172.31.47.0-255,66,107419,92,212515
11180,0.001527,74.125.200.0-255,1484,108903,92,212515
11181,0.001552,172.31.47.0-255,66,108969,92,212515
11182,0.001598,74.125.200.0-255,2184,111153,92,212515
11183,0.0016,172.31.47.0-255,66,111219,92,212515
11184,0.001719,74.125.200.0-255,1484,112703,92,212515
11185,0.001736,74.125.200.0-255,2902,115605,92,212515
11186,0.001739,172.31.47.0-255,66,115671,92,212515
11187,0.001748,74.125.200.0-255,1484,117155,92,212515
11188,0.001751,74.125.200.0-255,1484,118639,92,212515
11189,0.001755,172.31.47.0-255,66,118705,92,212515
11190,0.001776,74.125.200.0-255,1484,120189,92,212515
11191,0.001782,74.125.200.0-255,5738,125927,92,212515
11192,0.001784,172.31.47.0-255,66,125993,92,212515
11193,0.001796,74.125.200.0-255,2902,128895,92,212515
11194,0.001802,172.31.47.0-255,66,128961,92,212515
11195,0.001815,74.125.200.0-255,7156,136117,92,212515
11196,0.001824,172.31.47.0-255,66,136183,92,212515
11197,0.001844,74.125.200.0-255,1484,137667,92,212515
11198,0.001856,74.125.200.0-255,4320,141987,92,212515
11199,0.001858,172.31.47.0-255,66,142053,92,212515
11200,0.001876,74.125.200.0-255,5020,147073,92,212515
11201,0.001879,172.31.47.0-255,66,147139,92,212515
11202,0.001881,74.125.200.0-255,1484,148623,92,212515
11203,0.001905,74.125.200.0-255,1484,150107,92,212515
11204,0.001919,74.125.200.0-255,5738,155845,92,212515
11205,0.001949,74.125.200.0-255,1484,157329,92,212515
11206,0.001986,74.125.200.0-255,1484,158813,92,212515
11207,0.002007,74.125.200.0-255,2184,160997,92,212515
11208,0.002083,74.125.200.0-255,1484,162481,92,212515
11209,0.0021,74.125.200.0-255,1484,163965,92,212515
11210,0.00212,74.125.200.0-255,2902,166867,92,212515
11211,0.002139,74.125.200.0-255,5738,172605,92,212515
11212,0.002167,74.125.200.0-255,7156,179761,92,212515
11213,0.002188,74.125.200.0-255,5738,185499,92,212515
11214,0.002205,74.125.200.0-255,2902,188401,92,212515
11215,0.002209,74.125.200.0-255,2902,191303,92,212515
11216,0.002227,74.125.200.0-255,3602,194905,92,212515
11217,0.002331,74.125.200.0-255,1484,196389,92,212515
11218,0.002334,74.125.200.0-255,1484,197873,92,212515
11219,0.002344,74.125.200.0-255,1484,199357,92,212515
11220,0.002361,74.125.200.0-255,1484,200841,92,212515
11221,0.003528,172.31.47.0-255,66,200907,92,212515
11222,0.005845,74.125.200.0-255,5738,206645,92,212515
11223,0.005852,172.31.47.0-255,66,206711,92,212515
11224,0.008173,74.125.200.0-255,5738,212449,92,212515
11225,0.008179,172.31.47.0-255,66,212515,92,212515
11226,0.0,172.31.47.0-255,105,105,92,459
11227,0.000295,172.31.47.0-255,90,195,92,459
11228,0.000304,172.31.47.0-255,66,261,92,459
11229,0.002591,74.125.24.0-255,66,327,92,459
11230,0.002603,74.125.24.0-255,66,393,92,459
11231,0.002615,172.31.47.0-255,66,459,92,459
11232,0.0,172.217.194.0-255,153,153,92,175744
11233,2.2e-05,172.31.47.0-255,66,219,92,175744
11234,2.9e-05,172.217.194.0-255,1484,1703,92,175744
11235,3.3e-05,172.31.47.0-255,66,1769,92,175744
11236,4.7e-05,172.217.194.0-255,2902,4671,92,175744
11237,5e-05,172.31.47.0-255,66,4737,92,175744
11238,5.8e-05,172.217.194.0-255,7156,11893,92,175744
11239,6.1e-05,172.31.47.0-255,66,11959,92,175744
11240,9.7e-05,172.217.194.0-255,2098,14057,92,175744
11241,0.0001,172.31.47.0-255,66,14123,92,175744
11242,0.000133,172.217.194.0-255,1484,15607,92,175744
11243,0.000135,172.31.47.0-255,66,15673,92,175744
11244,0.000149,172.217.194.0-255,2902,18575,92,175744
11245,0.000156,172.31.47.0-255,66,18641,92,175744
11246,0.000163,172.217.194.0-255,5738,24379,92,175744
11247,0.000165,172.31.47.0-255,66,24445,92,175744
11248,0.000202,172.217.194.0-255,6797,31242,92,175744
11249,0.000204,172.31.47.0-255,66,31308,92,175744
11250,0.000212,172.217.194.0-255,7156,38464,92,175744
11251,0.000214,172.31.47.0-255,66,38530,92,175744
11252,0.000245,172.31.47.0-255,66,38596,92,175744
11253,0.000289,172.217.194.0-255,7156,45752,92,175744
11254,0.000291,172.31.47.0-255,66,45818,92,175744
11255,0.000296,172.217.194.0-255,2902,48720,92,175744
11256,0.000299,172.31.47.0-255,66,48786,92,175744
11257,0.000326,172.217.194.0-255,5738,54524,92,175744
11258,0.000333,172.31.47.0-255,66,54590,92,175744
11259,0.000336,172.217.194.0-255,1406,55996,92,175744
11260,0.000338,172.31.47.0-255,66,56062,92,175744
11261,0.000516,172.217.194.0-255,116,56178,92,175744
11262,0.00052,172.31.47.0-255,66,56244,92,175744
11263,0.000524,172.217.194.0-255,377,56621,92,175744
11264,0.000673,172.217.194.0-255,1484,58105,92,175744
11265,0.000677,172.31.47.0-255,66,58171,92,175744
11266,0.000683,172.217.194.0-255,2902,61073,92,175744
11267,0.000685,172.31.47.0-255,66,61139,92,175744
11268,0.000696,172.217.194.0-255,4320,65459,92,175744
11269,0.000698,172.31.47.0-255,66,65525,92,175744
11270,0.000729,172.217.194.0-255,1484,67009,92,175744
11271,0.000742,172.31.47.0-255,66,67075,92,175744
11272,0.000749,172.217.194.0-255,5738,72813,92,175744
11273,0.000751,172.31.47.0-255,66,72879,92,175744
11274,0.000792,172.31.47.0-255,66,72945,92,175744
11275,0.000867,172.217.194.0-255,1484,74429,92,175744
11276,0.000882,172.217.194.0-255,2902,77331,92,175744
11277,0.000885,172.31.47.0-255,66,77397,92,175744
11278,0.000892,172.217.194.0-255,5738,83135,92,175744
11279,0.000895,172.31.47.0-255,66,83201,92,175744
11280,0.000948,172.31.47.0-255,66,83267,92,175744
11281,0.00096,172.31.47.0-255,66,83333,92,175744
11282,0.000983,172.217.194.0-255,766,84099,92,175744
11283,0.001083,172.217.194.0-255,1484,85583,92,175744
11284,0.001087,172.31.47.0-255,66,85649,92,175744
11285,0.001092,172.217.194.0-255,2902,88551,92,175744
11286,0.001094,172.31.47.0-255,66,88617,92,175744
11287,0.001105,172.217.194.0-255,4320,92937,92,175744
11288,0.001107,172.31.47.0-255,66,93003,92,175744
11289,0.001118,172.217.194.0-255,1484,94487,92,175744
11290,0.001143,172.217.194.0-255,4320,98807,92,175744
11291,0.001145,172.31.47.0-255,66,98873,92,175744
11292,0.001178,172.31.47.0-255,66,98939,92,175744
11293,0.001195,172.31.47.0-255,66,99005,92,175744
11294,0.001594,172.217.194.0-255,1484,100489,92,175744
11295,0.001598,172.217.194.0-255,1484,101973,92,175744
11296,0.001603,172.31.47.0-255,66,102039,92,175744
11297,0.001632,172.217.194.0-255,1484,103523,92,175744
11298,0.001639,172.217.194.0-255,5738,109261,92,175744
11299,0.001641,172.31.47.0-255,66,109327,92,175744
11300,0.001652,172.31.47.0-255,66,109393,92,175744
11301,0.001693,172.217.194.0-255,2902,112295,92,175744
11302,0.001696,172.31.47.0-255,66,112361,92,175744
11303,0.001711,172.31.47.0-255,66,112427,92,175744
11304,0.001715,172.217.194.0-255,2184,114611,92,175744
11305,0.001717,172.31.47.0-255,66,114677,92,175744
11306,0.001783,172.217.194.0-255,1484,116161,92,175744
11307,0.001788,172.217.194.0-255,2902,119063,92,175744
11308,0.001791,172.31.47.0-255,66,119129,92,175744
11309,0.001795,172.217.194.0-255,2902,122031,92,175744
11310,0.001797,172.31.47.0-255,66,122097,92,175744
11311,0.001825,172.217.194.0-255,2902,124999,92,175744
11312,0.001828,172.31.47.0-255,66,125065,92,175744
11313,0.001834,172.217.194.0-255,5738,130803,92,175744
11314,0.001836,172.31.47.0-255,66,130869,92,175744
11315,0.001841,172.217.194.0-255,2902,133771,92,175744
11316,0.001843,172.31.47.0-255,66,133837,92,175744
11317,0.001891,172.31.47.0-255,66,133903,92,175744
11318,0.001897,172.217.194.0-255,5020,138923,92,175744
11319,0.0019,172.31.47.0-255,66,138989,92,175744
11320,0.001967,172.217.194.0-255,1484,140473,92,175744
11321,0.001981,172.217.194.0-255,2902,143375,92,175744
11322,0.001985,172.31.47.0-255,66,143441,92,175744
11323,0.001992,172.217.194.0-255,5738,149179,92,175744
11324,0.001994,172.31.47.0-255,66,149245,92,175744
11325,0.002037,172.31.47.0-255,66,149311,92,175744
11326,0.002069,172.217.194.0-255,7156,156467,92,175744
11327,0.002072,172.31.47.0-255,66,156533,92,175744
11328,0.0021,172.217.194.0-255,3602,160135,92,175744
11329,0.002103,172.31.47.0-255,66,160201,92,175744
11330,0.00212,172.31.47.0-255,66,160267,92,175744
11331,0.002123,172.217.194.0-255,1484,161751,92,175744
11332,0.002162,172.31.47.0-255,66,161817,92,175744
11333,0.002189,172.31.47.0-255,66,161883,92,175744
11334,0.002228,172.31.47.0-255,66,161949,92,175744
11335,0.002233,172.217.194.0-255,4320,166269,92,175744
11336,0.002235,172.31.47.0-255,66,166335,92,175744
11337,0.00227,172.217.194.0-255,7156,173491,92,175744
11338,0.002273,172.31.47.0-255,66,173557,92,175744
11339,0.002276,172.217.194.0-255,1484,175041,92,175744
11340,0.002324,172.31.47.0-255,66,175107,92,175744
11341,0.002389,172.31.47.0-255,66,175173,92,175744
11342,0.002431,172.31.47.0-255,66,175239,92,175744
11343,0.002521,172.31.47.0-255,66,175305,92,175744
11344,0.002563,172.31.47.0-255,66,175371,92,175744
11345,0.002591,172.217.194.0-255,97,175468,92,175744
11346,0.004849,172.217.194.0-255,105,175573,92,175744
11347,0.009579,172.31.47.0-255,66,175639,92,175744
11348,0.009615,172.31.47.0-255,105,175744,92,175744
11349,0.0,172.31.47.0-255,66,66,92,66
11350,0.0,74.125.24.0-255,153,153,92,81570
11351,2.5e-05,172.31.47.0-255,66,219,92,81570
11352,3.1e-05,74.125.24.0-255,1484,1703,92,81570
11353,3.4e-05,172.31.47.0-255,66,1769,92,81570
11354,3.9e-05,74.125.24.0-255,2902,4671,92,81570
11355,4.1e-05,172.31.47.0-255,66,4737,92,81570
11356,5.4e-05,74.125.24.0-255,7156,11893,92,81570
11357,5.7e-05,172.31.47.0-255,66,11959,92,81570
11358,6.1e-05,74.125.24.0-255,2013,13972,92,81570
11359,6.4e-05,172.31.47.0-255,66,14038,92,81570
11360,0.000362,74.125.24.0-255,1484,15522,92,81570
11361,0.000367,172.31.47.0-255,66,15588,92,81570
11362,0.000373,74.125.24.0-255,2902,18490,92,81570
11363,0.000375,172.31.47.0-255,66,18556,92,81570
11364,0.000386,74.125.24.0-255,2902,21458,92,81570
11365,0.000388,172.31.47.0-255,66,21524,92,81570
11366,0.0004,74.125.24.0-255,2902,24426,92,81570
11367,0.000403,172.31.47.0-255,66,24492,92,81570
11368,0.000407,74.125.24.0-255,2902,27394,92,81570
11369,0.000414,172.31.47.0-255,66,27460,92,81570
11370,0.000443,74.125.24.0-255,3961,31421,92,81570
11371,0.000447,172.31.47.0-255,66,31487,92,81570
11372,0.000454,74.125.24.0-255,7156,38643,92,81570
11373,0.000457,172.31.47.0-255,66,38709,92,81570
11374,0.000485,74.125.24.0-255,2902,41611,92,81570
11375,0.000488,172.31.47.0-255,66,41677,92,81570
11376,0.000522,74.125.24.0-255,6797,48474,92,81570
11377,0.000528,172.31.47.0-255,66,48540,92,81570
11378,0.001366,74.125.24.0-255,1484,50024,92,81570
11379,0.001374,172.31.47.0-255,66,50090,92,81570
11380,0.001385,74.125.24.0-255,2902,52992,92,81570
11381,0.001388,172.31.47.0-255,66,53058,92,81570
11382,0.001401,74.125.24.0-255,5738,58796,92,81570
11383,0.001403,172.31.47.0-255,66,58862,92,81570
11384,0.001425,74.125.24.0-255,4320,63182,92,81570
11385,0.001428,172.31.47.0-255,66,63248,92,81570
11386,0.001465,172.31.47.0-255,66,63314,92,81570
11387,0.001483,172.31.47.0-255,66,63380,92,81570
11388,0.001551,172.31.47.0-255,66,63446,92,81570
11389,0.001554,74.125.24.0-255,646,64092,92,81570
11390,0.001556,172.31.47.0-255,66,64158,92,81570
11391,0.003675,74.125.24.0-255,5738,69896,92,81570
11392,0.00368,172.31.47.0-255,66,69962,92,81570
11393,0.005798,74.125.24.0-255,5738,75700,92,81570
11394,0.005803,172.31.47.0-255,66,75766,92,81570
11395,0.007913,74.125.24.0-255,5738,81504,92,81570
11396,0.00792,172.31.47.0-255,66,81570,92,81570
11397,0.0,74.125.24.0-255,431,431,92,97923
11398,2.1e-05,74.125.24.0-255,1484,1915,92,97923
11399,2.8e-05,172.31.47.0-255,66,1981,92,97923
11400,3.6e-05,74.125.24.0-255,4320,6301,92,97923
11401,3.8e-05,172.31.47.0-255,66,6367,92,97923
11402,0.000176,74.125.24.0-255,7156,13523,92,97923
11403,0.000181,172.31.47.0-255,66,13589,92,97923
11404,0.00045,74.125.24.0-255,686,14275,92,97923
11405,0.000495,74.125.24.0-255,7156,21431,92,97923
11406,0.000499,172.31.47.0-255,66,21497,92,97923
11407,0.000517,74.125.24.0-255,1484,22981,92,97923
11408,0.000841,74.125.24.0-255,7156,30137,92,97923
11409,0.000848,172.31.47.0-255,66,30203,92,97923
11410,0.00208,74.125.24.0-255,5738,35941,92,97923
11411,0.002337,74.125.24.0-255,2902,38843,92,97923
11412,0.002346,74.125.24.0-255,1484,40327,92,97923
11413,0.002511,74.125.24.0-255,2902,43229,92,97923
11414,0.002536,74.125.24.0-255,7156,50385,92,97923
11415,0.002929,74.125.24.0-255,4320,54705,92,97923
11416,0.003062,172.31.47.0-255,66,54771,92,97923
11417,0.003401,172.31.47.0-255,66,54837,92,97923
11418,0.003886,74.125.24.0-255,2902,57739,92,97923
11419,0.003892,172.31.47.0-255,66,57805,92,97923
11420,0.003975,74.125.24.0-255,1484,59289,92,97923
11421,0.005112,172.31.47.0-255,66,59355,92,97923
11422,0.005169,172.31.47.0-255,66,59421,92,97923
11423,0.005462,74.125.24.0-255,7156,66577,92,97923
11424,0.005468,172.31.47.0-255,66,66643,92,97923
11425,0.005483,74.125.24.0-255,2118,68761,92,97923
11426,0.005486,172.31.47.0-255,66,68827,92,97923
11427,0.005506,74.125.24.0-255,7156,75983,92,97923
11428,0.005508,172.31.47.0-255,66,76049,92,97923
11429,0.005551,172.31.47.0-255,66,76115,92,97923
11430,0.005573,74.125.24.0-255,2766,78881,92,97923
11431,0.005577,172.31.47.0-255,66,78947,92,97923
11432,0.00595,172.31.47.0-255,66,79013,92,97923
11433,0.007153,172.31.47.0-255,66,79079,92,97923
11434,0.007192,172.31.47.0-255,66,79145,92,97923
11435,0.00721,74.125.24.0-255,1926,81071,92,97923
11436,0.007212,172.31.47.0-255,66,81137,92,97923
11437,0.007343,74.125.24.0-255,2902,84039,92,97923
11438,0.007347,172.31.47.0-255,66,84105,92,97923
11439,0.00738,172.31.47.0-255,66,84171,92,97923
11440,0.007582,74.125.24.0-255,7156,91327,92,97923
11441,0.00759,172.31.47.0-255,66,91393,92,97923
11442,0.007651,172.31.47.0-255,66,91459,92,97923
11443,0.007675,172.31.47.0-255,66,91525,92,97923
11444,0.008306,172.31.47.0-255,66,91591,92,97923
11445,0.008361,172.31.47.0-255,66,91657,92,97923
11446,0.008843,172.31.47.0-255,66,91723,92,97923
11447,0.00887,172.31.47.0-255,66,91789,92,97923
11448,0.009181,172.31.47.0-255,66,91855,92,97923
11449,0.009231,172.31.47.0-255,66,91921,92,97923
11450,0.009359,172.31.47.0-255,66,91987,92,97923
11451,0.009418,172.31.47.0-255,66,92053,92,97923
11452,0.009526,74.125.24.0-255,5738,97791,92,97923
11453,0.009534,172.31.47.0-255,66,97857,92,97923
11454,0.009579,172.31.47.0-255,66,97923,92,97923
11455,0.0,172.31.47.0-255,105,105,92,276
11456,0.001775,157.240.13.0-255,105,210,92,276
11457,0.001787,172.31.47.0-255,66,276,92,276
11458,0.0,172.217.194.0-255,152,152,92,143135
11459,2.3e-05,172.31.47.0-255,66,218,92,143135
11460,2.9e-05,172.217.194.0-255,1484,1702,92,143135
11461,3.3e-05,172.31.47.0-255,66,1768,92,143135
11462,3.9e-05,172.217.194.0-255,2902,4670,92,143135
11463,4.1e-05,172.31.47.0-255,66,4736,92,143135
11464,4.4e-05,172.217.194.0-255,1484,6220,92,143135
11465,4.6e-05,172.31.47.0-255,66,6286,92,143135
11466,7.4e-05,172.217.194.0-255,4320,10606,92,143135
11467,7.7e-05,172.31.47.0-255,66,10672,92,143135
11468,8.2e-05,172.217.194.0-255,3410,14082,92,143135
11469,8.4e-05,172.31.47.0-255,66,14148,92,143135
11470,0.000124,172.31.47.0-255,66,14214,92,143135
11471,0.000129,172.217.194.0-255,5379,19593,92,143135
11472,0.000131,172.31.47.0-255,66,19659,92,143135
11473,0.000197,172.217.194.0-255,1484,21143,92,143135
11474,0.0002,172.31.47.0-255,66,21209,92,143135
11475,0.000204,172.217.194.0-255,2902,24111,92,143135
11476,0.000206,172.31.47.0-255,66,24177,92,143135
11477,0.000218,172.217.194.0-255,1484,25661,92,143135
11478,0.000219,172.31.47.0-255,66,25727,92,143135
11479,0.000238,172.217.194.0-255,4320,30047,92,143135
11480,0.00024,172.31.47.0-255,66,30113,92,143135
11481,0.000258,172.217.194.0-255,5738,35851,92,143135
11482,0.00026,172.31.47.0-255,66,35917,92,143135
11483,0.000297,172.31.47.0-255,66,35983,92,143135
11484,0.000308,172.31.47.0-255,66,36049,92,143135
11485,0.00031,172.217.194.0-255,432,36481,92,143135
11486,0.000313,172.31.47.0-255,66,36547,92,143135
11487,0.000404,172.217.194.0-255,1484,38031,92,143135
11488,0.000408,172.31.47.0-255,66,38097,92,143135
11489,0.000413,172.217.194.0-255,2902,40999,92,143135
11490,0.000415,172.31.47.0-255,66,41065,92,143135
11491,0.000422,172.217.194.0-255,5738,46803,92,143135
11492,0.000424,172.31.47.0-255,66,46869,92,143135
11493,0.000473,172.217.194.0-255,1484,48353,92,143135
11494,0.000476,172.31.47.0-255,66,48419,92,143135
11495,0.000491,172.217.194.0-255,4830,53249,92,143135
11496,0.000547,172.31.47.0-255,66,53315,92,143135
11497,0.000875,172.217.194.0-255,1484,54799,92,143135
11498,0.000898,172.217.194.0-255,2902,57701,92,143135
11499,0.000901,172.31.47.0-255,66,57767,92,143135
11500,0.000909,172.217.194.0-255,5738,63505,92,143135
11501,0.000927,172.31.47.0-255,66,63571,92,143135
11502,0.000939,172.217.194.0-255,7156,70727,92,143135
11503,0.000949,172.31.47.0-255,66,70793,92,143135
11504,0.000955,172.217.194.0-255,5738,76531,92,143135
11505,0.00099,172.217.194.0-255,7156,83687,92,143135
11506,0.000993,172.31.47.0-255,66,83753,92,143135
11507,0.001003,172.217.194.0-255,3602,87355,92,143135
11508,0.001044,172.31.47.0-255,66,87421,92,143135
11509,0.001724,172.217.194.0-255,1484,88905,92,143135
11510,0.001735,172.217.194.0-255,2902,91807,92,143135
11511,0.001739,172.31.47.0-255,66,91873,92,143135
11512,0.001748,172.217.194.0-255,5738,97611,92,143135
11513,0.00175,172.31.47.0-255,66,97677,92,143135
11514,0.001753,172.217.194.0-255,1484,99161,92,143135
11515,0.00178,172.217.194.0-255,5738,104899,92,143135
11516,0.001782,172.31.47.0-255,66,104965,92,143135
11517,0.001787,172.217.194.0-255,2902,107867,92,143135
11518,0.001789,172.31.47.0-255,66,107933,92,143135
11519,0.001812,172.31.47.0-255,66,107999,92,143135
11520,0.001817,172.217.194.0-255,2184,110183,92,143135
11521,0.001819,172.31.47.0-255,66,110249,92,143135
11522,0.002232,172.217.194.0-255,1484,111733,92,143135
11523,0.00224,172.217.194.0-255,2902,114635,92,143135
11524,0.002244,172.31.47.0-255,66,114701,92,143135
11525,0.002252,172.217.194.0-255,5738,120439,92,143135
11526,0.002254,172.31.47.0-255,66,120505,92,143135
11527,0.00226,172.217.194.0-255,4320,124825,92,143135
11528,0.002262,172.31.47.0-255,66,124891,92,143135
11529,0.002329,172.217.194.0-255,4320,129211,92,143135
11530,0.002349,172.217.194.0-255,3602,132813,92,143135
11531,0.005019,172.31.47.0-255,66,132879,92,143135
11532,0.007335,172.217.194.0-255,4320,137199,92,143135
11533,0.00734,172.31.47.0-255,66,137265,92,143135
11534,0.007358,172.217.194.0-255,1484,138749,92,143135
11535,0.009651,172.217.194.0-255,4320,143069,92,143135
11536,0.009658,172.31.47.0-255,66,143135,92,143135
11537,0.0,172.31.47.0-255,105,105,92,276
11538,0.001857,157.240.7.0-255,105,210,92,276
11539,0.00187,172.31.47.0-255,66,276,92,276
11540,0.0,172.31.47.0-255,130,130,92,1584
11541,0.001743,172.31.47.0-255,236,366,92,1584
11542,0.00178,172.31.47.0-255,359,725,92,1584
11543,0.00247,74.125.24.0-255,630,1355,92,1584
11544,0.003844,74.125.24.0-255,66,1421,92,1584
11545,0.004804,74.125.24.0-255,97,1518,92,1584
11546,0.004815,172.31.47.0-255,66,1584,92,1584
11547,0.0,172.217.194.0-255,152,152,92,144095
11548,3.5e-05,172.31.47.0-255,66,218,92,144095
11549,4.2e-05,172.217.194.0-255,1484,1702,92,144095
11550,4.6e-05,172.31.47.0-255,66,1768,92,144095
11551,5.8e-05,172.217.194.0-255,2902,4670,92,144095
11552,6.1e-05,172.31.47.0-255,66,4736,92,144095
11553,6.7e-05,172.217.194.0-255,7156,11892,92,144095
11554,7.1e-05,172.31.47.0-255,66,11958,92,144095
11555,7.5e-05,172.217.194.0-255,2095,14053,92,144095
11556,7.8e-05,172.31.47.0-255,66,14119,92,144095
11557,0.000106,172.217.194.0-255,2902,17021,92,144095
11558,0.000109,172.31.47.0-255,66,17087,92,144095
11559,0.000144,172.217.194.0-255,7156,24243,92,144095
11560,0.000147,172.31.47.0-255,66,24309,92,144095
11561,0.00015,172.217.194.0-255,1484,25793,92,144095
11562,0.000152,172.31.47.0-255,66,25859,92,144095
11563,0.000179,172.217.194.0-255,2902,28761,92,144095
11564,0.000187,172.31.47.0-255,66,28827,92,144095
11565,0.000215,172.217.194.0-255,2543,31370,92,144095
11566,0.000217,172.31.47.0-255,66,31436,92,144095
11567,0.000245,172.217.194.0-255,5738,37174,92,144095
11568,0.000248,172.31.47.0-255,66,37240,92,144095
11569,0.000251,172.217.194.0-255,1484,38724,92,144095
11570,0.000254,172.31.47.0-255,66,38790,92,144095
11571,0.000265,172.31.47.0-255,66,38856,92,144095
11572,0.000299,172.217.194.0-255,5738,44594,92,144095
11573,0.000306,172.31.47.0-255,66,44660,92,144095
11574,0.000346,172.31.47.0-255,66,44726,92,144095
11575,0.00035,172.217.194.0-255,677,45403,92,144095
11576,0.000352,172.31.47.0-255,66,45469,92,144095
11577,0.000612,172.217.194.0-255,1484,46953,92,144095
11578,0.000619,172.217.194.0-255,2902,49855,92,144095
11579,0.000622,172.31.47.0-255,66,49921,92,144095
11580,0.000644,172.217.194.0-255,5738,55659,92,144095
11581,0.000647,172.31.47.0-255,66,55725,92,144095
11582,0.000652,172.217.194.0-255,2902,58627,92,144095
11583,0.000654,172.31.47.0-255,66,58693,92,144095
11584,0.000678,172.217.194.0-255,2902,61595,92,144095
11585,0.000686,172.31.47.0-255,66,61661,92,144095
11586,0.000691,172.217.194.0-255,2902,64563,92,144095
11587,0.000692,172.31.47.0-255,66,64629,92,144095
11588,0.000739,172.31.47.0-255,66,64695,92,144095
11589,0.000743,172.217.194.0-255,766,65461,92,144095
11590,0.000809,172.217.194.0-255,1484,66945,92,144095
11591,0.000812,172.31.47.0-255,66,67011,92,144095
11592,0.000838,172.217.194.0-255,2902,69913,92,144095
11593,0.000841,172.31.47.0-255,66,69979,92,144095
11594,0.000848,172.217.194.0-255,5738,75717,92,144095
11595,0.00085,172.31.47.0-255,66,75783,92,144095
11596,0.000853,172.217.194.0-255,1484,77267,92,144095
11597,0.000905,172.31.47.0-255,66,77333,92,144095
11598,0.000915,172.31.47.0-255,66,77399,92,144095
11599,0.000919,172.217.194.0-255,2184,79583,92,144095
11600,0.000924,172.31.47.0-255,66,79649,92,144095
11601,0.001487,172.217.194.0-255,1484,81133,92,144095
11602,0.001498,172.217.194.0-255,2902,84035,92,144095
11603,0.001501,172.31.47.0-255,66,84101,92,144095
11604,0.001506,172.217.194.0-255,2902,87003,92,144095
11605,0.001508,172.31.47.0-255,66,87069,92,144095
11606,0.001533,172.217.194.0-255,2902,89971,92,144095
11607,0.001544,172.31.47.0-255,66,90037,92,144095
11608,0.001556,172.31.47.0-255,66,90103,92,144095
11609,0.001579,172.217.194.0-255,2902,93005,92,144095
11610,0.001582,172.31.47.0-255,66,93071,92,144095
11611,0.001618,172.31.47.0-255,66,93137,92,144095
11612,0.001717,172.217.194.0-255,1484,94621,92,144095
11613,0.001723,172.217.194.0-255,2902,97523,92,144095
11614,0.001726,172.31.47.0-255,66,97589,92,144095
11615,0.001729,172.217.194.0-255,1484,99073,92,144095
11616,0.00175,172.217.194.0-255,4320,103393,92,144095
11617,0.001752,172.31.47.0-255,66,103459,92,144095
11618,0.001759,172.217.194.0-255,5738,109197,92,144095
11619,0.001761,172.31.47.0-255,66,109263,92,144095
11620,0.001785,172.217.194.0-255,7156,116419,92,144095
11621,0.001789,172.31.47.0-255,66,116485,92,144095
11622,0.001818,172.31.47.0-255,66,116551,92,144095
11623,0.001823,172.217.194.0-255,2902,119453,92,144095
11624,0.001825,172.31.47.0-255,66,119519,92,144095
11625,0.00187,172.31.47.0-255,66,119585,92,144095
11626,0.001883,172.31.47.0-255,66,119651,92,144095
11627,0.001902,172.217.194.0-255,1484,121135,92,144095
11628,0.001916,172.31.47.0-255,66,121201,92,144095
11629,0.001991,172.217.194.0-255,1484,122685,92,144095
11630,0.001997,172.217.194.0-255,2902,125587,92,144095
11631,0.002,172.31.47.0-255,66,125653,92,144095
11632,0.002003,172.217.194.0-255,1484,127137,92,144095
11633,0.002024,172.217.194.0-255,4320,131457,92,144095
11634,0.002028,172.31.47.0-255,66,131523,92,144095
11635,0.002034,172.217.194.0-255,4320,135843,92,144095
11636,0.002036,172.31.47.0-255,66,135909,92,144095
11637,0.00207,172.31.47.0-255,66,135975,92,144095
11638,0.002073,172.217.194.0-255,1484,137459,92,144095
11639,0.002094,172.217.194.0-255,766,138225,92,144095
11640,0.006441,172.31.47.0-255,66,138291,92,144095
11641,0.008502,172.217.194.0-255,5738,144029,92,144095
11642,0.008509,172.31.47.0-255,66,144095,92,144095
11643,0.0,74.125.24.0-255,153,153,92,214215
11644,2.3e-05,172.31.47.0-255,66,219,92,214215
11645,3e-05,74.125.24.0-255,1484,1703,92,214215
11646,3.5e-05,172.31.47.0-255,66,1769,92,214215
11647,4.1e-05,74.125.24.0-255,2902,4671,92,214215
11648,4.3e-05,172.31.47.0-255,66,4737,92,214215
11649,4.7e-05,74.125.24.0-255,1484,6221,92,214215
11650,4.9e-05,172.31.47.0-255,66,6287,92,214215
11651,7.6e-05,74.125.24.0-255,5738,12025,92,214215
11652,7.9e-05,172.31.47.0-255,66,12091,92,214215
11653,8.3e-05,74.125.24.0-255,2156,14247,92,214215
11654,8.5e-05,172.31.47.0-255,66,14313,92,214215
11655,0.0001,74.125.24.0-255,1484,15797,92,214215
11656,0.000102,172.31.47.0-255,66,15863,92,214215
11657,0.000128,172.31.47.0-255,66,15929,92,214215
11658,0.000133,74.125.24.0-255,2902,18831,92,214215
11659,0.000135,172.31.47.0-255,66,18897,92,214215
11660,0.000158,74.125.24.0-255,2543,21440,92,214215
11661,0.00016,172.31.47.0-255,66,21506,92,214215
11662,0.000172,74.125.24.0-255,1484,22990,92,214215
11663,0.000175,172.31.47.0-255,66,23056,92,214215
11664,0.000204,74.125.24.0-255,2902,25958,92,214215
11665,0.000206,172.31.47.0-255,66,26024,92,214215
11666,0.000212,74.125.24.0-255,5738,31762,92,214215
11667,0.000214,172.31.47.0-255,66,31828,92,214215
11668,0.00022,74.125.24.0-255,4320,36148,92,214215
11669,0.000222,172.31.47.0-255,66,36214,92,214215
11670,0.000248,172.31.47.0-255,66,36280,92,214215
11671,0.000285,172.31.47.0-255,66,36346,92,214215
11672,0.0003,74.125.24.0-255,1435,37781,92,214215
11673,0.000303,172.31.47.0-255,66,37847,92,214215
11674,0.000334,74.125.24.0-255,111,37958,92,214215
11675,0.000337,172.31.47.0-255,66,38024,92,214215
11676,0.000485,74.125.24.0-255,1484,39508,92,214215
11677,0.00049,172.31.47.0-255,66,39574,92,214215
11678,0.000496,74.125.24.0-255,2902,42476,92,214215
11679,0.000499,172.31.47.0-255,66,42542,92,214215
11680,0.000503,74.125.24.0-255,1484,44026,92,214215
11681,0.000506,172.31.47.0-255,66,44092,92,214215
11682,0.000525,74.125.24.0-255,4320,48412,92,214215
11683,0.000543,172.31.47.0-255,66,48478,92,214215
11684,0.000556,172.31.47.0-255,66,48544,92,214215
11685,0.000579,74.125.24.0-255,4320,52864,92,214215
11686,0.000582,172.31.47.0-255,66,52930,92,214215
11687,0.000595,74.125.24.0-255,2902,55832,92,214215
11688,0.000598,172.31.47.0-255,66,55898,92,214215
11689,0.00062,74.125.24.0-255,2809,58707,92,214215
11690,0.000623,172.31.47.0-255,66,58773,92,214215
11691,0.00074,74.125.24.0-255,1484,60257,92,214215
11692,0.000745,74.125.24.0-255,1484,61741,92,214215
11693,0.000747,172.31.47.0-255,66,61807,92,214215
11694,0.000767,74.125.24.0-255,1484,63291,92,214215
11695,0.000773,74.125.24.0-255,5738,69029,92,214215
11696,0.000785,74.125.24.0-255,1484,70513,92,214215
11697,0.000788,172.31.47.0-255,66,70579,92,214215
11698,0.000823,172.31.47.0-255,66,70645,92,214215
11699,0.000861,74.125.24.0-255,4320,74965,92,214215
11700,0.000871,172.31.47.0-255,66,75031,92,214215
11701,0.000882,74.125.24.0-255,5888,80919,92,214215
11702,0.000897,172.31.47.0-255,66,80985,92,214215
11703,0.00093,74.125.24.0-255,2902,83887,92,214215
11704,0.000936,172.31.47.0-255,66,83953,92,214215
11705,0.000996,74.125.24.0-255,5738,89691,92,214215
11706,0.001013,172.31.47.0-255,66,89757,92,214215
11707,0.001018,74.125.24.0-255,2184,91941,92,214215
11708,0.001026,172.31.47.0-255,66,92007,92,214215
11709,0.001144,74.125.24.0-255,1484,93491,92,214215
11710,0.001156,74.125.24.0-255,2902,96393,92,214215
11711,0.001161,74.125.24.0-255,5738,102131,92,214215
11712,0.001178,74.125.24.0-255,5738,107869,92,214215
11713,0.001191,74.125.24.0-255,7156,115025,92,214215
11714,0.001197,172.31.47.0-255,66,115091,92,214215
11715,0.001222,74.125.24.0-255,4320,119411,92,214215
11716,0.00123,172.31.47.0-255,66,119477,92,214215
11717,0.001249,74.125.24.0-255,6438,125915,92,214215
11718,0.001254,172.31.47.0-255,66,125981,92,214215
11719,0.001486,74.125.24.0-255,1484,127465,92,214215
11720,0.001491,74.125.24.0-255,2902,130367,92,214215
11721,0.001494,172.31.47.0-255,66,130433,92,214215
11722,0.001516,74.125.24.0-255,5738,136171,92,214215
11723,0.001526,74.125.24.0-255,1484,137655,92,214215
11724,0.001541,74.125.24.0-255,5738,143393,92,214215
11725,0.001547,172.31.47.0-255,66,143459,92,214215
11726,0.001565,74.125.24.0-255,4320,147779,92,214215
11727,0.001569,172.31.47.0-255,66,147845,92,214215
11728,0.001575,74.125.24.0-255,1484,149329,92,214215
11729,0.001608,172.31.47.0-255,66,149395,92,214215
11730,0.001659,74.125.24.0-255,1484,150879,92,214215
11731,0.001664,74.125.24.0-255,2902,153781,92,214215
11732,0.001669,74.125.24.0-255,5738,159519,92,214215
11733,0.001679,172.31.47.0-255,66,159585,92,214215
11734,0.001696,74.125.24.0-255,2902,162487,92,214215
11735,0.001706,74.125.24.0-255,5738,168225,92,214215
11736,0.00172,74.125.24.0-255,4320,172545,92,214215
11737,0.001724,172.31.47.0-255,66,172611,92,214215
11738,0.001777,172.31.47.0-255,66,172677,92,214215
11739,0.001796,74.125.24.0-255,4320,176997,92,214215
11740,0.001807,172.31.47.0-255,66,177063,92,214215
11741,0.001817,74.125.24.0-255,7156,184219,92,214215
11742,0.001824,172.31.47.0-255,66,184285,92,214215
11743,0.00184,74.125.24.0-255,1484,185769,92,214215
11744,0.00188,172.31.47.0-255,66,185835,92,214215
11745,0.001909,74.125.24.0-255,4320,190155,92,214215
11746,0.001916,172.31.47.0-255,66,190221,92,214215
11747,0.001949,172.31.47.0-255,66,190287,92,214215
11748,0.001968,74.125.24.0-255,4320,194607,92,214215
11749,0.001974,172.31.47.0-255,66,194673,92,214215
11750,0.002018,74.125.24.0-255,3602,198275,92,214215
11751,0.002022,172.31.47.0-255,66,198341,92,214215
11752,0.002127,74.125.24.0-255,4320,202661,92,214215
11753,0.002165,172.31.47.0-255,66,202727,92,214215
11754,0.002224,74.125.24.0-255,2902,205629,92,214215
11755,0.002236,74.125.24.0-255,2184,207813,92,214215
11756,0.002239,172.31.47.0-255,66,207879,92,214215
11757,0.002248,74.125.24.0-255,2902,210781,92,214215
11758,0.002251,172.31.47.0-255,66,210847,92,214215
11759,0.002263,172.31.47.0-255,66,210913,92,214215
11760,0.00229,172.31.47.0-255,66,210979,92,214215
11761,0.002338,172.31.47.0-255,66,211045,92,214215
11762,0.002406,74.125.24.0-255,2902,213947,92,214215
11763,0.002417,172.31.47.0-255,66,214013,92,214215
11764,0.002449,172.31.47.0-255,66,214079,92,214215
11765,0.002456,74.125.24.0-255,136,214215,92,214215
11766,0.0,172.31.47.0-255,105,105,92,276
11767,0.001502,157.240.13.0-255,105,210,92,276
11768,0.001513,172.31.47.0-255,66,276,92,276
11769,0.0,74.125.24.0-255,146,146,92,120280
11770,2.5e-05,172.31.47.0-255,66,212,92,120280
11771,3.1e-05,74.125.24.0-255,1484,1696,92,120280
11772,3.4e-05,172.31.47.0-255,66,1762,92,120280
11773,3.9e-05,74.125.24.0-255,2902,4664,92,120280
11774,4.7e-05,172.31.47.0-255,66,4730,92,120280
11775,5.2e-05,74.125.24.0-255,5738,10468,92,120280
11776,5.4e-05,172.31.47.0-255,66,10534,92,120280
11777,8.3e-05,74.125.24.0-255,3590,14124,92,120280
11778,8.5e-05,172.31.47.0-255,66,14190,92,120280
11779,0.00023,74.125.24.0-255,1484,15674,92,120280
11780,0.000235,172.31.47.0-255,66,15740,92,120280
11781,0.000239,74.125.24.0-255,2902,18642,92,120280
11782,0.000243,172.31.47.0-255,66,18708,92,120280
11783,0.000245,74.125.24.0-255,1484,20192,92,120280
11784,0.000252,172.31.47.0-255,66,20258,92,120280
11785,0.000277,74.125.24.0-255,4320,24578,92,120280
11786,0.000283,172.31.47.0-255,66,24644,92,120280
11787,0.000286,74.125.24.0-255,1484,26128,92,120280
11788,0.000288,172.31.47.0-255,66,26194,92,120280
11789,0.00032,74.125.24.0-255,5379,31573,92,120280
11790,0.000323,172.31.47.0-255,66,31639,92,120280
11791,0.000354,74.125.24.0-255,1484,33123,92,120280
11792,0.000357,172.31.47.0-255,66,33189,92,120280
11793,0.000361,74.125.24.0-255,2902,36091,92,120280
11794,0.000363,172.31.47.0-255,66,36157,92,120280
11795,0.000382,74.125.24.0-255,2902,39059,92,120280
11796,0.00039,172.31.47.0-255,66,39125,92,120280
11797,0.000416,74.125.24.0-255,2902,42027,92,120280
11798,0.000418,172.31.47.0-255,66,42093,92,120280
11799,0.000425,74.125.24.0-255,6797,48890,92,120280
11800,0.000426,172.31.47.0-255,66,48956,92,120280
11801,0.001177,74.125.24.0-255,1484,50440,92,120280
11802,0.001183,172.31.47.0-255,66,50506,92,120280
11803,0.001193,74.125.24.0-255,2902,53408,92,120280
11804,0.001205,74.125.24.0-255,5738,59146,92,120280
11805,0.001228,74.125.24.0-255,1484,60630,92,120280
11806,0.001241,74.125.24.0-255,4320,64950,92,120280
11807,0.001254,74.125.24.0-255,5379,70329,92,120280
11808,0.001296,74.125.24.0-255,1484,71813,92,120280
11809,0.001314,74.125.24.0-255,2902,74715,92,120280
11810,0.00134,74.125.24.0-255,2902,77617,92,120280
11811,0.001357,74.125.24.0-255,2902,80519,92,120280
11812,0.001363,74.125.24.0-255,5738,86257,92,120280
11813,0.001379,74.125.24.0-255,1705,87962,92,120280
11814,0.001822,172.31.47.0-255,66,88028,92,120280
11815,0.002074,74.125.24.0-255,1484,89512,92,120280
11816,0.002079,74.125.24.0-255,1484,90996,92,120280
11817,0.002081,172.31.47.0-255,66,91062,92,120280
11818,0.002118,74.125.24.0-255,1484,92546,92,120280
11819,0.002124,74.125.24.0-255,5738,98284,92,120280
11820,0.002131,172.31.47.0-255,66,98350,92,120280
11821,0.002141,172.31.47.0-255,66,98416,92,120280
11822,0.002172,74.125.24.0-255,5738,104154,92,120280
11823,0.002182,172.31.47.0-255,66,104220,92,120280
11824,0.002199,172.31.47.0-255,66,104286,92,120280
11825,0.004399,74.125.24.0-255,4320,108606,92,120280
11826,0.004403,172.31.47.0-255,66,108672,92,120280
11827,0.004429,74.125.24.0-255,1484,110156,92,120280
11828,0.006615,74.125.24.0-255,4320,114476,92,120280
11829,0.006621,172.31.47.0-255,66,114542,92,120280
11830,0.009015,74.125.24.0-255,5738,120280,92,120280
11831,0.0,172.31.47.0-255,105,105,92,276
11832,0.001757,157.240.13.0-255,105,210,92,276
11833,0.001768,172.31.47.0-255,66,276,92,276
11834,0.0,172.31.47.0-255,66,66,92,66
11835,0.0,74.125.200.0-255,153,153,92,262924
11836,2.7e-05,172.31.47.0-255,66,219,92,262924
11837,6.9e-05,74.125.200.0-255,1484,1703,92,262924
11838,7.4e-05,172.31.47.0-255,66,1769,92,262924
11839,7.9e-05,74.125.200.0-255,2902,4671,92,262924
11840,8.2e-05,172.31.47.0-255,66,4737,92,262924
11841,0.000129,74.125.200.0-255,5738,10475,92,262924
11842,0.000133,172.31.47.0-255,66,10541,92,262924
11843,0.000137,74.125.200.0-255,1484,12025,92,262924
11844,0.000139,172.31.47.0-255,66,12091,92,262924
11845,0.000143,74.125.200.0-255,2109,14200,92,262924
11846,0.000146,172.31.47.0-255,66,14266,92,262924
11847,0.000279,74.125.200.0-255,1484,15750,92,262924
11848,0.000284,172.31.47.0-255,66,15816,92,262924
11849,0.000315,74.125.200.0-255,2902,18718,92,262924
11850,0.000319,172.31.47.0-255,66,18784,92,262924
11851,0.000324,74.125.200.0-255,4320,23104,92,262924
11852,0.000327,172.31.47.0-255,66,23170,92,262924
11853,0.000335,74.125.200.0-255,1484,24654,92,262924
11854,0.000337,172.31.47.0-255,66,24720,92,262924
11855,0.000363,74.125.200.0-255,4320,29040,92,262924
11856,0.000371,172.31.47.0-255,66,29106,92,262924
11857,0.00038,74.125.200.0-255,7156,36262,92,262924
11858,0.000382,172.31.47.0-255,66,36328,92,262924
11859,0.000421,74.125.200.0-255,3961,40289,92,262924
11860,0.000424,172.31.47.0-255,66,40355,92,262924
11861,0.000437,172.31.47.0-255,66,40421,92,262924
11862,0.000454,172.31.47.0-255,66,40487,92,262924
11863,0.000485,74.125.200.0-255,3935,44422,92,262924
11864,0.000488,172.31.47.0-255,66,44488,92,262924
11865,0.000492,74.125.200.0-255,109,44597,92,262924
11866,0.000494,172.31.47.0-255,66,44663,92,262924
11867,0.000553,74.125.200.0-255,1484,46147,92,262924
11868,0.000556,172.31.47.0-255,66,46213,92,262924
11869,0.000577,74.125.200.0-255,2902,49115,92,262924
11870,0.00058,172.31.47.0-255,66,49181,92,262924
11871,0.000586,74.125.200.0-255,4320,53501,92,262924
11872,0.000588,172.31.47.0-255,66,53567,92,262924
11873,0.00063,172.31.47.0-255,66,53633,92,262924
11874,0.000637,74.125.200.0-255,7156,60789,92,262924
11875,0.000639,172.31.47.0-255,66,60855,92,262924
11876,0.000656,172.31.47.0-255,66,60921,92,262924
11877,0.000659,74.125.200.0-255,1033,61954,92,262924
11878,0.000661,172.31.47.0-255,66,62020,92,262924
11879,0.000738,74.125.200.0-255,1484,63504,92,262924
11880,0.000741,172.31.47.0-255,66,63570,92,262924
11881,0.000746,74.125.200.0-255,2902,66472,92,262924
11882,0.000748,172.31.47.0-255,66,66538,92,262924
11883,0.000784,74.125.200.0-255,5738,72276,92,262924
11884,0.000788,74.125.200.0-255,2902,75178,92,262924
11885,0.000789,172.31.47.0-255,66,75244,92,262924
11886,0.000792,74.125.200.0-255,4320,79564,92,262924
11887,0.000792,172.31.47.0-255,66,79630,92,262924
11888,0.000795,172.31.47.0-255,66,79696,92,262924
11889,0.000864,172.31.47.0-255,66,79762,92,262924
11890,0.000874,172.31.47.0-255,66,79828,92,262924
11891,0.000909,74.125.200.0-255,1484,81312,92,262924
11892,0.000913,172.31.47.0-255,66,81378,92,262924
11893,0.000917,74.125.200.0-255,2902,84280,92,262924
11894,0.00092,172.31.47.0-255,66,84346,92,262924
11895,0.000925,74.125.200.0-255,5738,90084,92,262924
11896,0.000927,172.31.47.0-255,66,90150,92,262924
11897,0.000937,74.125.200.0-255,2902,93052,92,262924
11898,0.000939,172.31.47.0-255,66,93118,92,262924
11899,0.000945,74.125.200.0-255,4320,97438,92,262924
11900,0.000947,172.31.47.0-255,66,97504,92,262924
11901,0.000958,74.125.200.0-255,1484,98988,92,262924
11902,0.000961,172.31.47.0-255,66,99054,92,262924
11903,0.000991,74.125.200.0-255,7156,106210,92,262924
11904,0.000994,172.31.47.0-255,66,106276,92,262924
11905,0.001011,172.31.47.0-255,66,106342,92,262924
11906,0.001271,74.125.200.0-255,1484,107826,92,262924
11907,0.001276,172.31.47.0-255,66,107892,92,262924
11908,0.001302,74.125.200.0-255,2902,110794,92,262924
11909,0.001305,172.31.47.0-255,66,110860,92,262924
11910,0.00131,74.125.200.0-255,4320,115180,92,262924
11911,0.001312,172.31.47.0-255,66,115246,92,262924
11912,0.001317,74.125.200.0-255,4320,119566,92,262924
11913,0.001319,172.31.47.0-255,66,119632,92,262924
11914,0.00136,74.125.200.0-255,4320,123952,92,262924
11915,0.001364,172.31.47.0-255,66,124018,92,262924
11916,0.00137,74.125.200.0-255,5738,129756,92,262924
11917,0.001373,172.31.47.0-255,66,129822,92,262924
11918,0.001385,74.125.200.0-255,7156,136978,92,262924
11919,0.001389,172.31.47.0-255,66,137044,92,262924
11920,0.001394,74.125.200.0-255,3602,140646,92,262924
11921,0.001396,172.31.47.0-255,66,140712,92,262924
11922,0.001568,74.125.200.0-255,1484,142196,92,262924
11923,0.001575,74.125.200.0-255,2902,145098,92,262924
11924,0.00158,172.31.47.0-255,66,145164,92,262924
11925,0.001586,74.125.200.0-255,4320,149484,92,262924
11926,0.001588,172.31.47.0-255,66,149550,92,262924
11927,0.001603,74.125.200.0-255,1484,151034,92,262924
11928,0.001608,74.125.200.0-255,2902,153936,92,262924
11929,0.001615,172.31.47.0-255,66,154002,92,262924
11930,0.001636,74.125.200.0-255,4320,158322,92,262924
11931,0.001639,172.31.47.0-255,66,158388,92,262924
11932,0.001643,74.125.200.0-255,4320,162708,92,262924
11933,0.001645,172.31.47.0-255,66,162774,92,262924
11934,0.001681,172.31.47.0-255,66,162840,92,262924
11935,0.001698,74.125.200.0-255,2184,165024,92,262924
11936,0.001701,172.31.47.0-255,66,165090,92,262924
11937,0.001744,74.125.200.0-255,1484,166574,92,262924
11938,0.001748,74.125.200.0-255,1484,168058,92,262924
11939,0.001751,172.31.47.0-255,66,168124,92,262924
11940,0.001777,74.125.200.0-255,1484,169608,92,262924
11941,0.001784,74.125.200.0-255,5738,175346,92,262924
11942,0.001787,172.31.47.0-255,66,175412,92,262924
11943,0.001796,74.125.200.0-255,4320,179732,92,262924
11944,0.001806,172.31.47.0-255,66,179798,92,262924
11945,0.001828,74.125.200.0-255,2902,182700,92,262924
11946,0.001831,172.31.47.0-255,66,182766,92,262924
11947,0.001841,172.31.47.0-255,66,182832,92,262924
11948,0.001846,74.125.200.0-255,4320,187152,92,262924
11949,0.001851,172.31.47.0-255,66,187218,92,262924
11950,0.001871,74.125.200.0-255,3602,190820,92,262924
11951,0.001873,172.31.47.0-255,66,190886,92,262924
11952,0.002222,74.125.200.0-255,1484,192370,92,262924
11953,0.002226,74.125.200.0-255,1484,193854,92,262924
11954,0.002229,172.31.47.0-255,66,193920,92,262924
11955,0.002253,74.125.200.0-255,1484,195404,92,262924
11956,0.002257,74.125.200.0-255,2902,198306,92,262924
11957,0.002259,172.31.47.0-255,66,198372,92,262924
11958,0.002264,74.125.200.0-255,4320,202692,92,262924
11959,0.002266,172.31.47.0-255,66,202758,92,262924
11960,0.002291,172.31.47.0-255,66,202824,92,262924
11961,0.002294,74.125.200.0-255,1484,204308,92,262924
11962,0.00232,74.125.200.0-255,4320,208628,92,262924
11963,0.002323,172.31.47.0-255,66,208694,92,262924
11964,0.002349,74.125.200.0-255,7156,215850,92,262924
11965,0.002351,172.31.47.0-255,66,215916,92,262924
11966,0.002354,74.125.200.0-255,766,216682,92,262924
11967,0.002406,74.125.200.0-255,1484,218166,92,262924
11968,0.002408,172.31.47.0-255,66,218232,92,262924
11969,0.002413,74.125.200.0-255,4320,222552,92,262924
11970,0.002416,172.31.47.0-255,66,222618,92,262924
11971,0.002418,74.125.200.0-255,1484,224102,92,262924
11972,0.002427,74.125.200.0-255,2902,227004,92,262924
11973,0.002429,172.31.47.0-255,66,227070,92,262924
11974,0.002454,74.125.200.0-255,4320,231390,92,262924
11975,0.002456,172.31.47.0-255,66,231456,92,262924
11976,0.002461,74.125.200.0-255,5738,237194,92,262924
11977,0.002467,172.31.47.0-255,66,237260,92,262924
11978,0.002496,74.125.200.0-255,7156,244416,92,262924
11979,0.002498,172.31.47.0-255,66,244482,92,262924
11980,0.002507,74.125.200.0-255,4320,248802,92,262924
11981,0.002509,172.31.47.0-255,66,248868,92,262924
11982,0.00255,74.125.200.0-255,2184,251052,92,262924
11983,0.002553,172.31.47.0-255,66,251118,92,262924
11984,0.005057,74.125.200.0-255,2902,254020,92,262924
11985,0.00506,172.31.47.0-255,66,254086,92,262924
11986,0.005086,74.125.200.0-255,1484,255570,92,262924
11987,0.005096,74.125.200.0-255,1484,257054,92,262924
11988,0.005098,172.31.47.0-255,66,257120,92,262924
11989,0.007639,74.125.200.0-255,5738,262858,92,262924
11990,0.007659,172.31.47.0-255,66,262924,92,262924
11991,0.0,172.31.47.0-255,66,66,92,66
11992,0.0,74.125.24.0-255,153,153,92,130325
11993,3e-05,172.31.47.0-255,66,219,92,130325
11994,3.7e-05,74.125.24.0-255,1484,1703,92,130325
11995,4e-05,172.31.47.0-255,66,1769,92,130325
11996,4.5e-05,74.125.24.0-255,2902,4671,92,130325
11997,4.6e-05,172.31.47.0-255,66,4737,92,130325
11998,5.2e-05,74.125.24.0-255,7156,11893,92,130325
11999,5.5e-05,172.31.47.0-255,66,11959,92,130325
12000,5.8e-05,74.125.24.0-255,2102,14061,92,130325
12001,6e-05,172.31.47.0-255,66,14127,92,130325
12002,0.0001,172.31.47.0-255,66,14193,92,130325
12003,0.000119,74.125.24.0-255,1484,15677,92,130325
12004,0.000121,172.31.47.0-255,66,15743,92,130325
12005,0.000139,74.125.24.0-255,3961,19704,92,130325
12006,0.000141,172.31.47.0-255,66,19770,92,130325
12007,0.000182,74.125.24.0-255,1484,21254,92,130325
12008,0.000185,172.31.47.0-255,66,21320,92,130325
12009,0.000188,74.125.24.0-255,1484,22804,92,130325
12010,0.000189,172.31.47.0-255,66,22870,92,130325
12011,0.000205,74.125.24.0-255,1484,24354,92,130325
12012,0.000208,172.31.47.0-255,66,24420,92,130325
12013,0.000214,74.125.24.0-255,5738,30158,92,130325
12014,0.000215,172.31.47.0-255,66,30224,92,130325
12015,0.000219,74.125.24.0-255,4320,34544,92,130325
12016,0.000221,172.31.47.0-255,66,34610,92,130325
12017,0.000267,172.31.47.0-255,66,34676,92,130325
12018,0.000273,74.125.24.0-255,5738,40414,92,130325
12019,0.000275,172.31.47.0-255,66,40480,92,130325
12020,0.000316,74.125.24.0-255,1437,41917,92,130325
12021,0.000319,172.31.47.0-255,66,41983,92,130325
12022,0.000334,74.125.24.0-255,112,42095,92,130325
12023,0.000465,74.125.24.0-255,330,42425,92,130325
12024,0.000783,172.31.47.0-255,66,42491,92,130325
12025,0.000877,74.125.24.0-255,1484,43975,92,130325
12026,0.000888,74.125.24.0-255,2902,46877,92,130325
12027,0.000891,172.31.47.0-255,66,46943,92,130325
12028,0.000895,74.125.24.0-255,1484,48427,92,130325
12029,0.000918,74.125.24.0-255,4320,52747,92,130325
12030,0.000938,172.31.47.0-255,66,52813,92,130325
12031,0.000946,74.125.24.0-255,7156,59969,92,130325
12032,0.000949,172.31.47.0-255,66,60035,92,130325
12033,0.000954,74.125.24.0-255,2902,62937,92,130325
12034,0.000956,172.31.47.0-255,66,63003,92,130325
12035,0.000997,172.31.47.0-255,66,63069,92,130325
12036,0.001002,74.125.24.0-255,2184,65253,92,130325
12037,0.001004,172.31.47.0-255,66,65319,92,130325
12038,0.001611,74.125.24.0-255,1484,66803,92,130325
12039,0.001622,74.125.24.0-255,2902,69705,92,130325
12040,0.001627,172.31.47.0-255,66,69771,92,130325
12041,0.001635,74.125.24.0-255,5738,75509,92,130325
12042,0.001637,172.31.47.0-255,66,75575,92,130325
12043,0.001679,172.31.47.0-255,66,75641,92,130325
12044,0.001686,74.125.24.0-255,7156,82797,92,130325
12045,0.001688,172.31.47.0-255,66,82863,92,130325
12046,0.001718,74.125.24.0-255,3602,86465,92,130325
12047,0.001721,172.31.47.0-255,66,86531,92,130325
12048,0.001966,74.125.24.0-255,1484,88015,92,130325
12049,0.001986,74.125.24.0-255,2902,90917,92,130325
12050,0.001989,172.31.47.0-255,66,90983,92,130325
12051,0.001997,74.125.24.0-255,5738,96721,92,130325
12052,0.001999,172.31.47.0-255,66,96787,92,130325
12053,0.002028,74.125.24.0-255,5738,102525,92,130325
12054,0.002032,172.31.47.0-255,66,102591,92,130325
12055,0.002035,74.125.24.0-255,1484,104075,92,130325
12056,0.002055,74.125.24.0-255,5738,109813,92,130325
12057,0.002059,172.31.47.0-255,66,109879,92,130325
12058,0.00207,74.125.24.0-255,2902,112781,92,130325
12059,0.002072,172.31.47.0-255,66,112847,92,130325
12060,0.002093,172.31.47.0-255,66,112913,92,130325
12061,0.004419,74.125.24.0-255,5738,118651,92,130325
12062,0.004423,172.31.47.0-255,66,118717,92,130325
12063,0.006763,74.125.24.0-255,5738,124455,92,130325
12064,0.00677,172.31.47.0-255,66,124521,92,130325
12065,0.009123,74.125.24.0-255,5738,130259,92,130325
12066,0.009131,172.31.47.0-255,66,130325,92,130325
12067,0.0,74.125.68.0-255,153,153,92,274853
12068,1.6e-05,172.31.47.0-255,66,219,92,274853
12069,2.2e-05,74.125.68.0-255,1484,1703,92,274853
12070,2.6e-05,172.31.47.0-255,66,1769,92,274853
12071,3.1e-05,74.125.68.0-255,2902,4671,92,274853
12072,4.1e-05,172.31.47.0-255,66,4737,92,274853
12073,7.2e-05,74.125.68.0-255,5738,10475,92,274853
12074,7.5e-05,172.31.47.0-255,66,10541,92,274853
12075,7.9e-05,74.125.68.0-255,2902,13443,92,274853
12076,8.1e-05,172.31.47.0-255,66,13509,92,274853
12077,0.000106,74.125.68.0-255,3518,17027,92,274853
12078,0.000108,172.31.47.0-255,66,17093,92,274853
12079,0.000112,74.125.68.0-255,2902,19995,92,274853
12080,0.000114,172.31.47.0-255,66,20061,92,274853
12081,0.000144,74.125.68.0-255,2902,22963,92,274853
12082,0.000146,172.31.47.0-255,66,23029,92,274853
12083,0.000152,74.125.68.0-255,7156,30185,92,274853
12084,0.000154,172.31.47.0-255,66,30251,92,274853
12085,0.000157,74.125.68.0-255,1125,31376,92,274853
12086,0.000159,172.31.47.0-255,66,31442,92,274853
12087,0.000288,74.125.68.0-255,1484,32926,92,274853
12088,0.000292,172.31.47.0-255,66,32992,92,274853
12089,0.000297,74.125.68.0-255,2902,35894,92,274853
12090,0.000299,172.31.47.0-255,66,35960,92,274853
12091,0.000326,74.125.68.0-255,5738,41698,92,274853
12092,0.000328,172.31.47.0-255,66,41764,92,274853
12093,0.000355,74.125.68.0-255,7156,48920,92,274853
12094,0.000357,172.31.47.0-255,66,48986,92,274853
12095,0.000375,74.125.68.0-255,5738,54724,92,274853
12096,0.000377,172.31.47.0-255,66,54790,92,274853
12097,0.00041,74.125.68.0-255,2902,57692,92,274853
12098,0.000412,172.31.47.0-255,66,57758,92,274853
12099,0.000437,74.125.68.0-255,4320,62078,92,274853
12100,0.00044,172.31.47.0-255,66,62144,92,274853
12101,0.000442,74.125.68.0-255,1484,63628,92,274853
12102,0.000444,172.31.47.0-255,66,63694,92,274853
12103,0.000472,74.125.68.0-255,2521,66215,92,274853
12104,0.000496,74.125.68.0-255,110,66325,92,274853
12105,0.000499,172.31.47.0-255,66,66391,92,274853
12106,0.000604,74.125.68.0-255,1484,67875,92,274853
12107,0.000613,172.31.47.0-255,66,67941,92,274853
12108,0.000623,74.125.68.0-255,2902,70843,92,274853
12109,0.000629,74.125.68.0-255,1484,72327,92,274853
12110,0.000645,74.125.68.0-255,2902,75229,92,274853
12111,0.00066,74.125.68.0-255,4320,79549,92,274853
12112,0.000662,172.31.47.0-255,66,79615,92,274853
12113,0.000667,172.31.47.0-255,66,79681,92,274853
12114,0.000676,74.125.68.0-255,1484,81165,92,274853
12115,0.000684,74.125.68.0-255,4320,85485,92,274853
12116,0.000686,74.125.68.0-255,1484,86969,92,274853
12117,0.000711,74.125.68.0-255,4320,91289,92,274853
12118,0.000718,172.31.47.0-255,66,91355,92,274853
12119,0.000743,74.125.68.0-255,5738,97093,92,274853
12120,0.00075,172.31.47.0-255,66,97159,92,274853
12121,0.000759,74.125.68.0-255,3602,100761,92,274853
12122,0.000783,172.31.47.0-255,66,100827,92,274853
12123,0.000873,74.125.68.0-255,1484,102311,92,274853
12124,0.000877,74.125.68.0-255,1484,103795,92,274853
12125,0.00089,74.125.68.0-255,1484,105279,92,274853
12126,0.000905,74.125.68.0-255,5738,111017,92,274853
12127,0.00091,172.31.47.0-255,66,111083,92,274853
12128,0.000934,74.125.68.0-255,7156,118239,92,274853
12129,0.000944,172.31.47.0-255,66,118305,92,274853
12130,0.000951,74.125.68.0-255,1484,119789,92,274853
12131,0.000988,74.125.68.0-255,1484,121273,92,274853
12132,0.001019,74.125.68.0-255,2902,124175,92,274853
12133,0.001022,74.125.68.0-255,766,124941,92,274853
12134,0.00103,172.31.47.0-255,66,125007,92,274853
12135,0.001248,74.125.68.0-255,1484,126491,92,274853
12136,0.001262,74.125.68.0-255,2902,129393,92,274853
12137,0.001268,172.31.47.0-255,66,129459,92,274853
12138,0.001297,74.125.68.0-255,5738,135197,92,274853
12139,0.001307,172.31.47.0-255,66,135263,92,274853
12140,0.001317,74.125.68.0-255,4320,139583,92,274853
12141,0.001321,172.31.47.0-255,66,139649,92,274853
12142,0.001337,74.125.68.0-255,2902,142551,92,274853
12143,0.00136,74.125.68.0-255,1484,144035,92,274853
12144,0.001365,74.125.68.0-255,2902,146937,92,274853
12145,0.001382,74.125.68.0-255,1484,148421,92,274853
12146,0.001397,74.125.68.0-255,2902,151323,92,274853
12147,0.001409,74.125.68.0-255,1484,152807,92,274853
12148,0.001414,172.31.47.0-255,66,152873,92,274853
12149,0.001425,74.125.68.0-255,4320,157193,92,274853
12150,0.001434,74.125.68.0-255,2184,159377,92,274853
12151,0.00149,172.31.47.0-255,66,159443,92,274853
12152,0.001757,74.125.68.0-255,1484,160927,92,274853
12153,0.001772,74.125.68.0-255,2902,163829,92,274853
12154,0.001776,172.31.47.0-255,66,163895,92,274853
12155,0.001779,74.125.68.0-255,1484,165379,92,274853
12156,0.001803,74.125.68.0-255,1484,166863,92,274853
12157,0.001809,74.125.68.0-255,4320,171183,92,274853
12158,0.001822,74.125.68.0-255,2902,174085,92,274853
12159,0.001834,172.31.47.0-255,66,174151,92,274853
12160,0.001841,74.125.68.0-255,5738,179889,92,274853
12161,0.001845,74.125.68.0-255,2902,182791,92,274853
12162,0.001855,172.31.47.0-255,66,182857,92,274853
12163,0.001899,74.125.68.0-255,4320,187177,92,274853
12164,0.001904,172.31.47.0-255,66,187243,92,274853
12165,0.001916,74.125.68.0-255,6438,193681,92,274853
12166,0.00194,172.31.47.0-255,66,193747,92,274853
12167,0.002021,74.125.68.0-255,1484,195231,92,274853
12168,0.002047,74.125.68.0-255,2902,198133,92,274853
12169,0.00205,172.31.47.0-255,66,198199,92,274853
12170,0.002057,74.125.68.0-255,4320,202519,92,274853
12171,0.002066,172.31.47.0-255,66,202585,92,274853
12172,0.002111,74.125.68.0-255,4320,206905,92,274853
12173,0.002135,172.31.47.0-255,66,206971,92,274853
12174,0.002185,172.31.47.0-255,66,207037,92,274853
12175,0.002229,172.31.47.0-255,66,207103,92,274853
12176,0.00225,74.125.68.0-255,5738,212841,92,274853
12177,0.002276,74.125.68.0-255,2902,215743,92,274853
12178,0.002307,74.125.68.0-255,1484,217227,92,274853
12179,0.002336,74.125.68.0-255,2902,220129,92,274853
12180,0.00236,74.125.68.0-255,4320,224449,92,274853
12181,0.002411,74.125.68.0-255,5738,230187,92,274853
12182,0.002432,74.125.68.0-255,5020,235207,92,274853
12183,0.002449,74.125.68.0-255,4320,239527,92,274853
12184,0.002475,74.125.68.0-255,7156,246683,92,274853
12185,0.00248,74.125.68.0-255,4320,251003,92,274853
12186,0.002525,74.125.68.0-255,7156,258159,92,274853
12187,0.002546,74.125.68.0-255,766,258925,92,274853
12188,0.002574,74.125.68.0-255,5738,264663,92,274853
12189,0.002588,74.125.68.0-255,4320,268983,92,274853
12190,0.004923,172.31.47.0-255,66,269049,92,274853
12191,0.007501,74.125.68.0-255,5738,274787,92,274853
12192,0.007507,172.31.47.0-255,66,274853,92,274853
12193,0.0,74.125.130.0-255,153,153,92,212437
12194,2.2e-05,172.31.47.0-255,66,219,92,212437
12195,2.8e-05,74.125.130.0-255,1484,1703,92,212437
12196,3.2e-05,172.31.47.0-255,66,1769,92,212437
12197,3.5e-05,74.125.130.0-255,1484,3253,92,212437
12198,3.8e-05,172.31.47.0-255,66,3319,92,212437
12199,4.3e-05,74.125.130.0-255,2902,6221,92,212437
12200,4.6e-05,172.31.47.0-255,66,6287,92,212437
12201,7.5e-05,74.125.130.0-255,5738,12025,92,212437
12202,7.7e-05,172.31.47.0-255,66,12091,92,212437
12203,8e-05,74.125.130.0-255,1484,13575,92,212437
12204,8.1e-05,172.31.47.0-255,66,13641,92,212437
12205,0.000104,74.125.130.0-255,675,14316,92,212437
12206,0.000106,172.31.47.0-255,66,14382,92,212437
12207,0.000288,74.125.130.0-255,1484,15866,92,212437
12208,0.000293,172.31.47.0-255,66,15932,92,212437
12209,0.000298,74.125.130.0-255,2902,18834,92,212437
12210,0.0003,172.31.47.0-255,66,18900,92,212437
12211,0.000305,74.125.130.0-255,2902,21802,92,212437
12212,0.000307,172.31.47.0-255,66,21868,92,212437
12213,0.000333,74.125.130.0-255,2902,24770,92,212437
12214,0.000336,172.31.47.0-255,66,24836,92,212437
12215,0.000342,74.125.130.0-255,5738,30574,92,212437
12216,0.000344,172.31.47.0-255,66,30640,92,212437
12217,0.000372,74.125.130.0-255,6797,37437,92,212437
12218,0.000375,172.31.47.0-255,66,37503,92,212437
12219,0.000378,74.125.130.0-255,1484,38987,92,212437
12220,0.000379,172.31.47.0-255,66,39053,92,212437
12221,0.000397,74.125.130.0-255,4320,43373,92,212437
12222,0.0004,172.31.47.0-255,66,43439,92,212437
12223,0.000406,74.125.130.0-255,7156,50595,92,212437
12224,0.000408,172.31.47.0-255,66,50661,92,212437
12225,0.000451,172.31.47.0-255,66,50727,92,212437
12226,0.000513,74.125.130.0-255,5020,55747,92,212437
12227,0.000516,172.31.47.0-255,66,55813,92,212437
12228,0.000519,74.125.130.0-255,376,56189,92,212437
12229,0.000914,172.31.47.0-255,66,56255,92,212437
12230,0.000979,74.125.130.0-255,1484,57739,92,212437
12231,0.000998,74.125.130.0-255,2902,60641,92,212437
12232,0.001001,172.31.47.0-255,66,60707,92,212437
12233,0.001021,74.125.130.0-255,5738,66445,92,212437
12234,0.001023,172.31.47.0-255,66,66511,92,212437
12235,0.001028,74.125.130.0-255,2902,69413,92,212437
12236,0.001029,172.31.47.0-255,66,69479,92,212437
12237,0.001051,74.125.130.0-255,4320,73799,92,212437
12238,0.001053,172.31.47.0-255,66,73865,92,212437
12239,0.00106,74.125.130.0-255,7156,81021,92,212437
12240,0.001061,172.31.47.0-255,66,81087,92,212437
12241,0.001079,74.125.130.0-255,1484,82571,92,212437
12242,0.001084,74.125.130.0-255,2902,85473,92,212437
12243,0.001085,172.31.47.0-255,66,85539,92,212437
12244,0.001107,74.125.130.0-255,5020,90559,92,212437
12245,0.001109,172.31.47.0-255,66,90625,92,212437
12246,0.001282,74.125.130.0-255,366,90991,92,212437
12247,0.001324,74.125.130.0-255,1484,92475,92,212437
12248,0.001328,172.31.47.0-255,66,92541,92,212437
12249,0.001332,74.125.130.0-255,1484,94025,92,212437
12250,0.001336,74.125.130.0-255,2902,96927,92,212437
12251,0.001338,172.31.47.0-255,66,96993,92,212437
12252,0.001358,74.125.130.0-255,2902,99895,92,212437
12253,0.001361,172.31.47.0-255,66,99961,92,212437
12254,0.001377,74.125.130.0-255,2902,102863,92,212437
12255,0.001379,172.31.47.0-255,66,102929,92,212437
12256,0.001384,74.125.130.0-255,2902,105831,92,212437
12257,0.001385,172.31.47.0-255,66,105897,92,212437
12258,0.001407,74.125.130.0-255,4320,110217,92,212437
12259,0.00141,172.31.47.0-255,66,110283,92,212437
12260,0.001413,74.125.130.0-255,2902,113185,92,212437
12261,0.001415,172.31.47.0-255,66,113251,92,212437
12262,0.00143,74.125.130.0-255,5738,118989,92,212437
12263,0.001432,172.31.47.0-255,66,119055,92,212437
12264,0.001451,74.125.130.0-255,6438,125493,92,212437
12265,0.001453,172.31.47.0-255,66,125559,92,212437
12266,0.001585,74.125.130.0-255,1484,127043,92,212437
12267,0.001604,74.125.130.0-255,2902,129945,92,212437
12268,0.001608,172.31.47.0-255,66,130011,92,212437
12269,0.001613,74.125.130.0-255,2902,132913,92,212437
12270,0.001615,172.31.47.0-255,66,132979,92,212437
12271,0.001628,74.125.130.0-255,2902,135881,92,212437
12272,0.00163,172.31.47.0-255,66,135947,92,212437
12273,0.001633,74.125.130.0-255,1484,137431,92,212437
12274,0.001656,74.125.130.0-255,5738,143169,92,212437
12275,0.001659,172.31.47.0-255,66,143235,92,212437
12276,0.001672,74.125.130.0-255,1484,144719,92,212437
12277,0.001698,74.125.130.0-255,7156,151875,92,212437
12278,0.001701,172.31.47.0-255,66,151941,92,212437
12279,0.001705,74.125.130.0-255,2902,154843,92,212437
12280,0.001707,172.31.47.0-255,66,154909,92,212437
12281,0.00171,74.125.130.0-255,1484,156393,92,212437
12282,0.001731,74.125.130.0-255,2902,159295,92,212437
12283,0.001733,172.31.47.0-255,66,159361,92,212437
12284,0.001736,74.125.130.0-255,766,160127,92,212437
12285,0.001896,74.125.130.0-255,1484,161611,92,212437
12286,0.001899,172.31.47.0-255,66,161677,92,212437
12287,0.001903,74.125.130.0-255,1484,163161,92,212437
12288,0.001917,74.125.130.0-255,1484,164645,92,212437
12289,0.001919,172.31.47.0-255,66,164711,92,212437
12290,0.001935,74.125.130.0-255,1484,166195,92,212437
12291,0.001947,74.125.130.0-255,2902,169097,92,212437
12292,0.001949,172.31.47.0-255,66,169163,92,212437
12293,0.001965,74.125.130.0-255,1484,170647,92,212437
12294,0.001968,74.125.130.0-255,1484,172131,92,212437
12295,0.001969,172.31.47.0-255,66,172197,92,212437
12296,0.001986,74.125.130.0-255,5738,177935,92,212437
12297,0.001988,172.31.47.0-255,66,178001,92,212437
12298,0.001993,74.125.130.0-255,4320,182321,92,212437
12299,0.001996,172.31.47.0-255,66,182387,92,212437
12300,0.00201,74.125.130.0-255,1484,183871,92,212437
12301,0.002038,74.125.130.0-255,4320,188191,92,212437
12302,0.002041,172.31.47.0-255,66,188257,92,212437
12303,0.002046,74.125.130.0-255,4320,192577,92,212437
12304,0.002048,172.31.47.0-255,66,192643,92,212437
12305,0.002098,74.125.130.0-255,2184,194827,92,212437
12306,0.002099,172.31.47.0-255,66,194893,92,212437
12307,0.004147,74.125.130.0-255,2902,197795,92,212437
12308,0.00415,172.31.47.0-255,66,197861,92,212437
12309,0.004167,74.125.130.0-255,2902,200763,92,212437
12310,0.004169,172.31.47.0-255,66,200829,92,212437
12311,0.006215,74.125.130.0-255,5738,206567,92,212437
12312,0.006221,172.31.47.0-255,66,206633,92,212437
12313,0.008286,74.125.130.0-255,5738,212371,92,212437
12314,0.008292,172.31.47.0-255,66,212437,92,212437
12315,0.0,172.217.194.0-255,153,153,92,227830
12316,3.2e-05,172.31.47.0-255,66,219,92,227830
12317,3.9e-05,172.217.194.0-255,1484,1703,92,227830
12318,4.3e-05,172.31.47.0-255,66,1769,92,227830
12319,4.8e-05,172.217.194.0-255,2902,4671,92,227830
12320,5e-05,172.31.47.0-255,66,4737,92,227830
12321,5.6e-05,172.217.194.0-255,7156,11893,92,227830
12322,5.9e-05,172.31.47.0-255,66,11959,92,227830
12323,6.2e-05,172.217.194.0-255,2165,14124,92,227830
12324,6.4e-05,172.31.47.0-255,66,14190,92,227830
12325,8.4e-05,172.217.194.0-255,1484,15674,92,227830
12326,8.6e-05,172.31.47.0-255,66,15740,92,227830
12327,0.000104,172.217.194.0-255,2902,18642,92,227830
12328,0.000106,172.31.47.0-255,66,18708,92,227830
12329,0.000111,172.217.194.0-255,5738,24446,92,227830
12330,0.000112,172.31.47.0-255,66,24512,92,227830
12331,0.000132,172.217.194.0-255,1484,25996,92,227830
12332,0.000135,172.31.47.0-255,66,26062,92,227830
12333,0.000156,172.217.194.0-255,5379,31441,92,227830
12334,0.000159,172.31.47.0-255,66,31507,92,227830
12335,0.000201,172.217.194.0-255,1484,32991,92,227830
12336,0.000204,172.31.47.0-255,66,33057,92,227830
12337,0.000207,172.217.194.0-255,1484,34541,92,227830
12338,0.000208,172.31.47.0-255,66,34607,92,227830
12339,0.000221,172.217.194.0-255,1484,36091,92,227830
12340,0.000223,172.31.47.0-255,66,36157,92,227830
12341,0.000227,172.217.194.0-255,2902,39059,92,227830
12342,0.000229,172.31.47.0-255,66,39125,92,227830
12343,0.000249,172.217.194.0-255,2902,42027,92,227830
12344,0.000251,172.31.47.0-255,66,42093,92,227830
12345,0.000254,172.217.194.0-255,1484,43577,92,227830
12346,0.000256,172.31.47.0-255,66,43643,92,227830
12347,0.000275,172.217.194.0-255,5379,49022,92,227830
12348,0.000278,172.31.47.0-255,66,49088,92,227830
12349,0.000319,172.31.47.0-255,66,49154,92,227830
12350,0.000322,172.217.194.0-255,2543,51697,92,227830
12351,0.000324,172.31.47.0-255,66,51763,92,227830
12352,0.000326,172.217.194.0-255,363,52126,92,227830
12353,0.000328,172.31.47.0-255,66,52192,92,227830
12354,0.00033,172.217.194.0-255,380,52572,92,227830
12355,0.000332,172.31.47.0-255,66,52638,92,227830
12356,0.00066,172.217.194.0-255,1484,54122,92,227830
12357,0.000664,172.31.47.0-255,66,54188,92,227830
12358,0.00067,172.217.194.0-255,2902,57090,92,227830
12359,0.000672,172.31.47.0-255,66,57156,92,227830
12360,0.000687,172.217.194.0-255,5738,62894,92,227830
12361,0.000694,172.31.47.0-255,66,62960,92,227830
12362,0.000703,172.217.194.0-255,4320,67280,92,227830
12363,0.000709,172.31.47.0-255,66,67346,92,227830
12364,0.000731,172.217.194.0-255,4320,71666,92,227830
12365,0.000739,172.31.47.0-255,66,71732,92,227830
12366,0.000777,172.217.194.0-255,4320,76052,92,227830
12367,0.000782,172.31.47.0-255,66,76118,92,227830
12368,0.000798,172.217.194.0-255,2184,78302,92,227830
12369,0.0008,172.31.47.0-255,66,78368,92,227830
12370,0.000905,172.217.194.0-255,1484,79852,92,227830
12371,0.00091,172.217.194.0-255,2902,82754,92,227830
12372,0.000921,172.31.47.0-255,66,82820,92,227830
12373,0.000932,172.217.194.0-255,5738,88558,92,227830
12374,0.000935,172.31.47.0-255,66,88624,92,227830
12375,0.000971,172.31.47.0-255,66,88690,92,227830
12376,0.000988,172.31.47.0-255,66,88756,92,227830
12377,0.001025,172.217.194.0-255,1484,90240,92,227830
12378,0.001029,172.217.194.0-255,1484,91724,92,227830
12379,0.00104,172.217.194.0-255,1484,93208,92,227830
12380,0.001041,172.31.47.0-255,66,93274,92,227830
12381,0.001044,172.217.194.0-255,2902,96176,92,227830
12382,0.001055,172.217.194.0-255,2902,99078,92,227830
12383,0.001079,172.217.194.0-255,7156,106234,92,227830
12384,0.001084,172.31.47.0-255,66,106300,92,227830
12385,0.001106,172.217.194.0-255,5738,112038,92,227830
12386,0.001111,172.31.47.0-255,66,112104,92,227830
12387,0.001147,172.31.47.0-255,66,112170,92,227830
12388,0.001286,172.217.194.0-255,1484,113654,92,227830
12389,0.001302,172.217.194.0-255,2902,116556,92,227830
12390,0.001308,172.31.47.0-255,66,116622,92,227830
12391,0.001318,172.217.194.0-255,1484,118106,92,227830
12392,0.001333,172.217.194.0-255,4320,122426,92,227830
12393,0.001336,172.31.47.0-255,66,122492,92,227830
12394,0.001378,172.31.47.0-255,66,122558,92,227830
12395,0.001379,172.217.194.0-255,2902,125460,92,227830
12396,0.001382,172.31.47.0-255,66,125526,92,227830
12397,0.001391,172.217.194.0-255,2902,128428,92,227830
12398,0.001395,172.31.47.0-255,66,128494,92,227830
12399,0.001423,172.31.47.0-255,66,128560,92,227830
12400,0.001742,172.217.194.0-255,1484,130044,92,227830
12401,0.001747,172.217.194.0-255,2902,132946,92,227830
12402,0.00175,172.31.47.0-255,66,133012,92,227830
12403,0.001755,172.217.194.0-255,2902,135914,92,227830
12404,0.001764,172.31.47.0-255,66,135980,92,227830
12405,0.001771,172.217.194.0-255,2902,138882,92,227830
12406,0.001782,172.31.47.0-255,66,138948,92,227830
12407,0.001786,172.217.194.0-255,7156,146104,92,227830
12408,0.001796,172.31.47.0-255,66,146170,92,227830
12409,0.001809,172.217.194.0-255,5738,151908,92,227830
12410,0.001814,172.217.194.0-255,2902,154810,92,227830
12411,0.001822,172.31.47.0-255,66,154876,92,227830
12412,0.001846,172.31.47.0-255,66,154942,92,227830
12413,0.001897,172.217.194.0-255,1484,156426,92,227830
12414,0.001902,172.217.194.0-255,2902,159328,92,227830
12415,0.001905,172.31.47.0-255,66,159394,92,227830
12416,0.00191,172.217.194.0-255,4320,163714,92,227830
12417,0.001919,172.31.47.0-255,66,163780,92,227830
12418,0.001926,172.217.194.0-255,1484,165264,92,227830
12419,0.001931,172.217.194.0-255,4320,169584,92,227830
12420,0.001945,172.31.47.0-255,66,169650,92,227830
12421,0.001961,172.31.47.0-255,66,169716,92,227830
12422,0.001975,172.31.47.0-255,66,169782,92,227830
12423,0.001983,172.217.194.0-255,2184,171966,92,227830
12424,0.001991,172.31.47.0-255,66,172032,92,227830
12425,0.002261,172.217.194.0-255,1484,173516,92,227830
12426,0.002267,172.217.194.0-255,2902,176418,92,227830
12427,0.002271,172.31.47.0-255,66,176484,92,227830
12428,0.002292,172.217.194.0-255,4320,180804,92,227830
12429,0.002295,172.217.194.0-255,1484,182288,92,227830
12430,0.002297,172.31.47.0-255,66,182354,92,227830
12431,0.002317,172.217.194.0-255,4320,186674,92,227830
12432,0.002322,172.31.47.0-255,66,186740,92,227830
12433,0.002332,172.217.194.0-255,4320,191060,92,227830
12434,0.002352,172.31.47.0-255,66,191126,92,227830
12435,0.002356,172.217.194.0-255,7156,198282,92,227830
12436,0.002367,172.31.47.0-255,66,198348,92,227830
12437,0.00248,172.217.194.0-255,1484,199832,92,227830
12438,0.002486,172.217.194.0-255,2902,202734,92,227830
12439,0.00249,172.31.47.0-255,66,202800,92,227830
12440,0.002494,172.217.194.0-255,1484,204284,92,227830
12441,0.002508,172.217.194.0-255,4320,208604,92,227830
12442,0.002514,172.31.47.0-255,66,208670,92,227830
12443,0.002529,172.217.194.0-255,4320,212990,92,227830
12444,0.002539,172.31.47.0-255,66,213056,92,227830
12445,0.002551,172.217.194.0-255,2902,215958,92,227830
12446,0.002552,172.31.47.0-255,66,216024,92,227830
12447,0.002556,172.31.47.0-255,66,216090,92,227830
12448,0.002571,172.31.47.0-255,66,216156,92,227830
12449,0.002631,172.31.47.0-255,66,216222,92,227830
12450,0.005184,172.217.194.0-255,5738,221960,92,227830
12451,0.005191,172.31.47.0-255,66,222026,92,227830
12452,0.007756,172.217.194.0-255,5738,227764,92,227830
12453,0.007761,172.31.47.0-255,66,227830,92,227830
12454,0.0,74.125.24.0-255,153,153,92,134612
12455,2.9e-05,172.31.47.0-255,66,219,92,134612
12456,3.5e-05,74.125.24.0-255,1484,1703,92,134612
12457,3.9e-05,172.31.47.0-255,66,1769,92,134612
12458,4.4e-05,74.125.24.0-255,2902,4671,92,134612
12459,4.6e-05,172.31.47.0-255,66,4737,92,134612
12460,6.8e-05,74.125.24.0-255,7156,11893,92,134612
12461,7e-05,172.31.47.0-255,66,11959,92,134612
12462,7.3e-05,74.125.24.0-255,2182,14141,92,134612
12463,7.5e-05,172.31.47.0-255,66,14207,92,134612
12464,0.000103,74.125.24.0-255,4320,18527,92,134612
12465,0.000106,172.31.47.0-255,66,18593,92,134612
12466,0.000122,74.125.24.0-255,7156,25749,92,134612
12467,0.000125,172.31.47.0-255,66,25815,92,134612
12468,0.00013,74.125.24.0-255,5379,31194,92,134612
12469,0.000132,172.31.47.0-255,66,31260,92,134612
12470,0.000381,74.125.24.0-255,1484,32744,92,134612
12471,0.000385,172.31.47.0-255,66,32810,92,134612
12472,0.00039,74.125.24.0-255,2902,35712,92,134612
12473,0.000392,172.31.47.0-255,66,35778,92,134612
12474,0.000395,74.125.24.0-255,1484,37262,92,134612
12475,0.000396,172.31.47.0-255,66,37328,92,134612
12476,0.000411,74.125.24.0-255,4320,41648,92,134612
12477,0.000413,172.31.47.0-255,66,41714,92,134612
12478,0.000432,74.125.24.0-255,5738,47452,92,134612
12479,0.000434,172.31.47.0-255,66,47518,92,134612
12480,0.000455,74.125.24.0-255,1125,48643,92,134612
12481,0.000458,172.31.47.0-255,66,48709,92,134612
12482,0.000465,74.125.24.0-255,7156,55865,92,134612
12483,0.000466,172.31.47.0-255,66,55931,92,134612
12484,0.000472,74.125.24.0-255,4320,60251,92,134612
12485,0.000474,172.31.47.0-255,66,60317,92,134612
12486,0.000499,74.125.24.0-255,5688,66005,92,134612
12487,0.000503,74.125.24.0-255,113,66118,92,134612
12488,0.000504,172.31.47.0-255,66,66184,92,134612
12489,0.000603,74.125.24.0-255,1484,67668,92,134612
12490,0.000607,172.31.47.0-255,66,67734,92,134612
12491,0.000611,74.125.24.0-255,2902,70636,92,134612
12492,0.00062,172.31.47.0-255,66,70702,92,134612
12493,0.000635,74.125.24.0-255,5738,76440,92,134612
12494,0.000643,172.31.47.0-255,66,76506,92,134612
12495,0.000675,74.125.24.0-255,4320,80826,92,134612
12496,0.000679,172.31.47.0-255,66,80892,92,134612
12497,0.000709,172.31.47.0-255,66,80958,92,134612
12498,0.000752,172.31.47.0-255,66,81024,92,134612
12499,0.001808,74.125.24.0-255,1484,82508,92,134612
12500,0.001817,74.125.24.0-255,2902,85410,92,134612
12501,0.00182,172.31.47.0-255,66,85476,92,134612
12502,0.001827,74.125.24.0-255,5738,91214,92,134612
12503,0.001848,74.125.24.0-255,2902,94116,92,134612
12504,0.001866,74.125.24.0-255,7156,101272,92,134612
12505,0.001883,74.125.24.0-255,2902,104174,92,134612
12506,0.00225,74.125.24.0-255,1484,105658,92,134612
12507,0.002264,74.125.24.0-255,2902,108560,92,134612
12508,0.002276,74.125.24.0-255,4320,112880,92,134612
12509,0.002287,74.125.24.0-255,1484,114364,92,134612
12510,0.002304,74.125.24.0-255,5738,120102,92,134612
12511,0.002324,74.125.24.0-255,7156,127258,92,134612
12512,0.002327,74.125.24.0-255,1484,128742,92,134612
12513,0.006517,172.31.47.0-255,66,128808,92,134612
12514,0.008785,74.125.24.0-255,5738,134546,92,134612
12515,0.008795,172.31.47.0-255,66,134612,92,134612
12516,0.0,172.217.194.0-255,153,153,92,274099
12517,1.3e-05,172.31.47.0-255,66,219,92,274099
12518,3.7e-05,172.217.194.0-255,1484,1703,92,274099
12519,4.1e-05,172.31.47.0-255,66,1769,92,274099
12520,4.6e-05,172.217.194.0-255,2902,4671,92,274099
12521,4.8e-05,172.31.47.0-255,66,4737,92,274099
12522,5e-05,172.217.194.0-255,1484,6221,92,274099
12523,5.3e-05,172.31.47.0-255,66,6287,92,274099
12524,8.6e-05,172.217.194.0-255,1484,7771,92,274099
12525,8.8e-05,172.31.47.0-255,66,7837,92,274099
12526,9.3e-05,172.217.194.0-255,4320,12157,92,274099
12527,9.6e-05,172.31.47.0-255,66,12223,92,274099
12528,0.000115,172.217.194.0-255,2253,14476,92,274099
12529,0.000121,172.31.47.0-255,66,14542,92,274099
12530,0.000247,172.217.194.0-255,1484,16026,92,274099
12531,0.000252,172.31.47.0-255,66,16092,92,274099
12532,0.000257,172.217.194.0-255,2902,18994,92,274099
12533,0.000259,172.31.47.0-255,66,19060,92,274099
12534,0.000264,172.217.194.0-255,4320,23380,92,274099
12535,0.000265,172.31.47.0-255,66,23446,92,274099
12536,0.000288,172.217.194.0-255,1484,24930,92,274099
12537,0.00029,172.31.47.0-255,66,24996,92,274099
12538,0.000313,172.217.194.0-255,4320,29316,92,274099
12539,0.000316,172.31.47.0-255,66,29382,92,274099
12540,0.000348,172.31.47.0-255,66,29448,92,274099
12541,0.00035,172.217.194.0-255,1484,30932,92,274099
12542,0.000352,172.31.47.0-255,66,30998,92,274099
12543,0.000368,172.31.47.0-255,66,31064,92,274099
12544,0.000401,172.217.194.0-255,1484,32548,92,274099
12545,0.000403,172.31.47.0-255,66,32614,92,274099
12546,0.000412,172.31.47.0-255,66,32680,92,274099
12547,0.000417,172.217.194.0-255,709,33389,92,274099
12548,0.000419,172.31.47.0-255,66,33455,92,274099
12549,0.000659,172.217.194.0-255,1484,34939,92,274099
12550,0.000665,172.31.47.0-255,66,35005,92,274099
12551,0.00067,172.217.194.0-255,2902,37907,92,274099
12552,0.000672,172.31.47.0-255,66,37973,92,274099
12553,0.0007,172.217.194.0-255,5738,43711,92,274099
12554,0.000702,172.31.47.0-255,66,43777,92,274099
12555,0.000721,172.217.194.0-255,5738,49515,92,274099
12556,0.000723,172.31.47.0-255,66,49581,92,274099
12557,0.000743,172.217.194.0-255,7156,56737,92,274099
12558,0.000749,172.217.194.0-255,5738,62475,92,274099
12559,0.000774,172.31.47.0-255,66,62541,92,274099
12560,0.000793,172.217.194.0-255,5020,67561,92,274099
12561,0.000809,172.31.47.0-255,66,67627,92,274099
12562,0.000837,172.217.194.0-255,4320,71947,92,274099
12563,0.00084,172.217.194.0-255,1484,73431,92,274099
12564,0.00086,172.217.194.0-255,4320,77751,92,274099
12565,0.000867,172.31.47.0-255,66,77817,92,274099
12566,0.000904,172.31.47.0-255,66,77883,92,274099
12567,0.000912,172.217.194.0-255,1484,79367,92,274099
12568,0.000931,172.217.194.0-255,4320,83687,92,274099
12569,0.000938,172.31.47.0-255,66,83753,92,274099
12570,0.000955,172.217.194.0-255,6438,90191,92,274099
12571,0.000974,172.217.194.0-255,5738,95929,92,274099
12572,0.00098,172.31.47.0-255,66,95995,92,274099
12573,0.00099,172.217.194.0-255,7156,103151,92,274099
12574,0.000998,172.217.194.0-255,4320,107471,92,274099
12575,0.001003,172.31.47.0-255,66,107537,92,274099
12576,0.001046,172.217.194.0-255,2902,110439,92,274099
12577,0.00105,172.31.47.0-255,66,110505,92,274099
12578,0.001093,172.31.47.0-255,66,110571,92,274099
12579,0.001114,172.217.194.0-255,5738,116309,92,274099
12580,0.001121,172.217.194.0-255,7156,123465,92,274099
12581,0.001161,172.217.194.0-255,7156,130621,92,274099
12582,0.001179,172.217.194.0-255,7156,137777,92,274099
12583,0.001185,172.217.194.0-255,6438,144215,92,274099
12584,0.001192,172.31.47.0-255,66,144281,92,274099
12585,0.0012,172.217.194.0-255,1484,145765,92,274099
12586,0.001211,172.217.194.0-255,1484,147249,92,274099
12587,0.001223,172.217.194.0-255,1484,148733,92,274099
12588,0.001228,172.217.194.0-255,4320,153053,92,274099
12589,0.001238,172.217.194.0-255,1484,154537,92,274099
12590,0.001242,172.31.47.0-255,66,154603,92,274099
12591,0.001267,172.217.194.0-255,1484,156087,92,274099
12592,0.001282,172.31.47.0-255,66,156153,92,274099
12593,0.001302,172.217.194.0-255,2184,158337,92,274099
12594,0.001321,172.217.194.0-255,1484,159821,92,274099
12595,0.001327,172.31.47.0-255,66,159887,92,274099
12596,0.001336,172.217.194.0-255,1484,161371,92,274099
12597,0.001345,172.217.194.0-255,5738,167109,92,274099
12598,0.001356,172.31.47.0-255,66,167175,92,274099
12599,0.001363,172.217.194.0-255,1484,168659,92,274099
12600,0.001367,172.217.194.0-255,2902,171561,92,274099
12601,0.001375,172.31.47.0-255,66,171627,92,274099
12602,0.001424,172.31.47.0-255,66,171693,92,274099
12603,0.001449,172.217.194.0-255,1484,173177,92,274099
12604,0.001479,172.217.194.0-255,2902,176079,92,274099
12605,0.001504,172.31.47.0-255,66,176145,92,274099
12606,0.001529,172.217.194.0-255,2902,179047,92,274099
12607,0.001535,172.217.194.0-255,6438,185485,92,274099
12608,0.001547,172.31.47.0-255,66,185551,92,274099
12609,0.001799,172.217.194.0-255,1484,187035,92,274099
12610,0.001816,172.217.194.0-255,2902,189937,92,274099
12611,0.001836,172.217.194.0-255,5738,195675,92,274099
12612,0.001839,172.31.47.0-255,66,195741,92,274099
12613,0.001849,172.31.47.0-255,66,195807,92,274099
12614,0.001894,172.217.194.0-255,4320,200127,92,274099
12615,0.001901,172.31.47.0-255,66,200193,92,274099
12616,0.001928,172.217.194.0-255,4320,204513,92,274099
12617,0.001937,172.31.47.0-255,66,204579,92,274099
12618,0.001964,172.217.194.0-255,6438,211017,92,274099
12619,0.001976,172.31.47.0-255,66,211083,92,274099
12620,0.003459,172.217.194.0-255,1484,212567,92,274099
12621,0.003484,172.217.194.0-255,2902,215469,92,274099
12622,0.00349,172.31.47.0-255,66,215535,92,274099
12623,0.003504,172.217.194.0-255,5738,221273,92,274099
12624,0.003514,172.217.194.0-255,4320,225593,92,274099
12625,0.003529,172.217.194.0-255,4320,229913,92,274099
12626,0.003537,172.31.47.0-255,66,229979,92,274099
12627,0.003545,172.217.194.0-255,1484,231463,92,274099
12628,0.003573,172.217.194.0-255,4320,235783,92,274099
12629,0.003616,172.217.194.0-255,1484,237267,92,274099
12630,0.00362,172.31.47.0-255,66,237333,92,274099
12631,0.003649,172.217.194.0-255,7156,244489,92,274099
12632,0.003674,172.31.47.0-255,66,244555,92,274099
12633,0.003682,172.217.194.0-255,7156,251711,92,274099
12634,0.003687,172.31.47.0-255,66,251777,92,274099
12635,0.003714,172.217.194.0-255,5020,256797,92,274099
12636,0.003727,172.31.47.0-255,66,256863,92,274099
12637,0.004087,172.217.194.0-255,1484,258347,92,274099
12638,0.004093,172.217.194.0-255,2902,261249,92,274099
12639,0.004099,172.31.47.0-255,66,261315,92,274099
12640,0.004117,172.217.194.0-255,5738,267053,92,274099
12641,0.00412,172.217.194.0-255,2902,269955,92,274099
12642,0.004138,172.217.194.0-255,3639,273594,92,274099
12643,0.004141,172.217.194.0-255,97,273691,92,274099
12644,0.004153,172.31.47.0-255,66,273757,92,274099
12645,0.004211,172.217.194.0-255,105,273862,92,274099
12646,0.0046,172.31.47.0-255,66,273928,92,274099
12647,0.004642,172.31.47.0-255,105,274033,92,274099
12648,0.006633,172.217.194.0-255,66,274099,92,274099
12649,0.0,172.217.26.0-255,153,153,92,87075
12650,3.2e-05,172.31.47.0-255,66,219,92,87075
12651,3.9e-05,172.217.26.0-255,1484,1703,92,87075
12652,4.3e-05,172.31.47.0-255,66,1769,92,87075
12653,4.7e-05,172.217.26.0-255,2902,4671,92,87075
12654,5.9e-05,172.31.47.0-255,66,4737,92,87075
12655,0.000102,172.217.26.0-255,7156,11893,92,87075
12656,0.000105,172.31.47.0-255,66,11959,92,87075
12657,0.000224,172.217.26.0-255,2101,14060,92,87075
12658,0.000228,172.31.47.0-255,66,14126,92,87075
12659,0.000266,172.217.26.0-255,2902,17028,92,87075
12660,0.000272,172.31.47.0-255,66,17094,92,87075
12661,0.000298,172.31.47.0-255,66,17160,92,87075
12662,0.000488,172.217.26.0-255,2902,20062,92,87075
12663,0.000492,172.31.47.0-255,66,20128,92,87075
12664,0.000517,172.217.26.0-255,2543,22671,92,87075
12665,0.000521,172.31.47.0-255,66,22737,92,87075
12666,0.000593,172.217.26.0-255,4320,27057,92,87075
12667,0.000598,172.31.47.0-255,66,27123,92,87075
12668,0.000644,172.31.47.0-255,66,27189,92,87075
12669,0.001037,172.217.26.0-255,7156,34345,92,87075
12670,0.001043,172.31.47.0-255,66,34411,92,87075
12671,0.001173,172.217.26.0-255,3961,38372,92,87075
12672,0.001178,172.31.47.0-255,66,38438,92,87075
12673,0.001218,172.217.26.0-255,398,38836,92,87075
12674,0.00122,172.31.47.0-255,66,38902,92,87075
12675,0.001306,172.217.26.0-255,117,39019,92,87075
12676,0.001309,172.31.47.0-255,66,39085,92,87075
12677,0.001564,172.217.26.0-255,1484,40569,92,87075
12678,0.001567,172.31.47.0-255,66,40635,92,87075
12679,0.001595,172.217.26.0-255,2902,43537,92,87075
12680,0.001598,172.31.47.0-255,66,43603,92,87075
12681,0.001627,172.217.26.0-255,1484,45087,92,87075
12682,0.001656,172.217.26.0-255,2902,47989,92,87075
12683,0.001659,172.31.47.0-255,66,48055,92,87075
12684,0.001708,172.217.26.0-255,2902,50957,92,87075
12685,0.001712,172.31.47.0-255,66,51023,92,87075
12686,0.001736,172.217.26.0-255,2902,53925,92,87075
12687,0.001739,172.31.47.0-255,66,53991,92,87075
12688,0.001832,172.31.47.0-255,66,54057,92,87075
12689,0.001856,172.217.26.0-255,5379,59436,92,87075
12690,0.001859,172.31.47.0-255,66,59502,92,87075
12691,0.0021,172.217.26.0-255,2902,62404,92,87075
12692,0.002106,172.31.47.0-255,66,62470,92,87075
12693,0.002129,172.217.26.0-255,2543,65013,92,87075
12694,0.002132,172.31.47.0-255,66,65079,92,87075
12695,0.004045,172.217.26.0-255,2902,67981,92,87075
12696,0.00405,172.31.47.0-255,66,68047,92,87075
12697,0.004078,172.217.26.0-255,2902,70949,92,87075
12698,0.004081,172.31.47.0-255,66,71015,92,87075
12699,0.006002,172.217.26.0-255,4320,75335,92,87075
12700,0.006008,172.31.47.0-255,66,75401,92,87075
12701,0.006058,172.217.26.0-255,1484,76885,92,87075
12702,0.007978,172.217.26.0-255,4320,81205,92,87075
12703,0.007985,172.31.47.0-255,66,81271,92,87075
12704,0.009942,172.217.26.0-255,5738,87009,92,87075
12705,0.009948,172.31.47.0-255,66,87075,92,87075
12706,0.0,216.58.221.0-255,153,153,92,67132
12707,3e-05,172.31.47.0-255,66,219,92,67132
12708,3.7e-05,216.58.221.0-255,1484,1703,92,67132
12709,4e-05,172.31.47.0-255,66,1769,92,67132
12710,5.3e-05,216.58.221.0-255,2902,4671,92,67132
12711,5.6e-05,172.31.47.0-255,66,4737,92,67132
12712,9.9e-05,216.58.221.0-255,7156,11893,92,67132
12713,0.000102,172.31.47.0-255,66,11959,92,67132
12714,0.000257,216.58.221.0-255,2148,14107,92,67132
12715,0.000262,172.31.47.0-255,66,14173,92,67132
12716,0.000307,216.58.221.0-255,4320,18493,92,67132
12717,0.000311,172.31.47.0-255,66,18559,92,67132
12718,0.000338,216.58.221.0-255,7156,25715,92,67132
12719,0.000342,172.31.47.0-255,66,25781,92,67132
12720,0.000564,216.58.221.0-255,2902,28683,92,67132
12721,0.000568,172.31.47.0-255,66,28749,92,67132
12722,0.000604,172.31.47.0-255,66,28815,92,67132
12723,0.000831,172.31.47.0-255,66,28881,92,67132
12724,0.00086,216.58.221.0-255,2543,31424,92,67132
12725,0.000863,172.31.47.0-255,66,31490,92,67132
12726,0.001093,172.31.47.0-255,66,31556,92,67132
12727,0.001129,172.31.47.0-255,66,31622,92,67132
12728,0.001435,216.58.221.0-255,356,31978,92,67132
12729,0.00144,172.31.47.0-255,66,32044,92,67132
12730,0.001457,216.58.221.0-255,1550,33594,92,67132
12731,0.00146,172.31.47.0-255,66,33660,92,67132
12732,0.001491,216.58.221.0-255,4320,37980,92,67132
12733,0.001494,172.31.47.0-255,66,38046,92,67132
12734,0.001598,216.58.221.0-255,1484,39530,92,67132
12735,0.001818,216.58.221.0-255,2902,42432,92,67132
12736,0.002295,216.58.221.0-255,2902,45334,92,67132
12737,0.003,216.58.221.0-255,4320,49654,92,67132
12738,0.003756,172.31.47.0-255,66,49720,92,67132
12739,0.005648,216.58.221.0-255,5738,55458,92,67132
12740,0.005654,172.31.47.0-255,66,55524,92,67132
12741,0.007547,216.58.221.0-255,5738,61262,92,67132
12742,0.007553,172.31.47.0-255,66,61328,92,67132
12743,0.00945,216.58.221.0-255,5738,67066,92,67132
12744,0.009457,172.31.47.0-255,66,67132,92,67132
12745,0.0,74.125.24.0-255,152,152,92,185372
12746,2.9e-05,172.31.47.0-255,66,218,92,185372
12747,3.5e-05,74.125.24.0-255,1484,1702,92,185372
12748,3.9e-05,172.31.47.0-255,66,1768,92,185372
12749,4.3e-05,74.125.24.0-255,2902,4670,92,185372
12750,4.6e-05,172.31.47.0-255,66,4736,92,185372
12751,6e-05,74.125.24.0-255,7156,11892,92,185372
12752,6.3e-05,172.31.47.0-255,66,11958,92,185372
12753,6.6e-05,74.125.24.0-255,2176,14134,92,185372
12754,6.9e-05,172.31.47.0-255,66,14200,92,185372
12755,0.000101,74.125.24.0-255,7156,21356,92,185372
12756,0.000104,172.31.47.0-255,66,21422,92,185372
12757,0.000128,74.125.24.0-255,4320,25742,92,185372
12758,0.000131,172.31.47.0-255,66,25808,92,185372
12759,0.000137,74.125.24.0-255,5379,31187,92,185372
12760,0.000139,172.31.47.0-255,66,31253,92,185372
12761,0.000186,74.125.24.0-255,1484,32737,92,185372
12762,0.000189,172.31.47.0-255,66,32803,92,185372
12763,0.000194,74.125.24.0-255,2902,35705,92,185372
12764,0.000196,172.31.47.0-255,66,35771,92,185372
12765,0.000218,74.125.24.0-255,5738,41509,92,185372
12766,0.000221,172.31.47.0-255,66,41575,92,185372
12767,0.000224,74.125.24.0-255,1484,43059,92,185372
12768,0.000226,172.31.47.0-255,66,43125,92,185372
12769,0.000255,172.31.47.0-255,66,43191,92,185372
12770,0.00026,74.125.24.0-255,4320,47511,92,185372
12771,0.000264,172.31.47.0-255,66,47577,92,185372
12772,0.000296,74.125.24.0-255,6438,54015,92,185372
12773,0.0003,172.31.47.0-255,66,54081,92,185372
12774,0.000302,74.125.24.0-255,425,54506,92,185372
12775,0.000304,172.31.47.0-255,66,54572,92,185372
12776,0.000359,74.125.24.0-255,1484,56056,92,185372
12777,0.000365,74.125.24.0-255,2902,58958,92,185372
12778,0.000368,172.31.47.0-255,66,59024,92,185372
12779,0.000378,74.125.24.0-255,1484,60508,92,185372
12780,0.000395,74.125.24.0-255,4320,64828,92,185372
12781,0.000399,172.31.47.0-255,66,64894,92,185372
12782,0.000401,74.125.24.0-255,1484,66378,92,185372
12783,0.000427,74.125.24.0-255,5082,71460,92,185372
12784,0.000429,172.31.47.0-255,66,71526,92,185372
12785,0.000843,74.125.24.0-255,1484,73010,92,185372
12786,0.000849,74.125.24.0-255,2902,75912,92,185372
12787,0.000853,172.31.47.0-255,66,75978,92,185372
12788,0.000857,74.125.24.0-255,2902,78880,92,185372
12789,0.000859,172.31.47.0-255,66,78946,92,185372
12790,0.00088,74.125.24.0-255,2902,81848,92,185372
12791,0.000883,172.31.47.0-255,66,81914,92,185372
12792,0.000889,74.125.24.0-255,7156,89070,92,185372
12793,0.000891,172.31.47.0-255,66,89136,92,185372
12794,0.000915,74.125.24.0-255,5738,94874,92,185372
12795,0.000917,172.31.47.0-255,66,94940,92,185372
12796,0.000941,74.125.24.0-255,2902,97842,92,185372
12797,0.000943,172.31.47.0-255,66,97908,92,185372
12798,0.000976,172.31.47.0-255,66,97974,92,185372
12799,0.001303,74.125.24.0-255,1484,99458,92,185372
12800,0.00132,74.125.24.0-255,2902,102360,92,185372
12801,0.001323,172.31.47.0-255,66,102426,92,185372
12802,0.001335,74.125.24.0-255,4320,106746,92,185372
12803,0.001341,172.31.47.0-255,66,106812,92,185372
12804,0.001344,74.125.24.0-255,2902,109714,92,185372
12805,0.001346,172.31.47.0-255,66,109780,92,185372
12806,0.001367,74.125.24.0-255,5738,115518,92,185372
12807,0.001369,172.31.47.0-255,66,115584,92,185372
12808,0.001374,74.125.24.0-255,7156,122740,92,185372
12809,0.001376,172.31.47.0-255,66,122806,92,185372
12810,0.0014,74.125.24.0-255,5738,128544,92,185372
12811,0.001402,172.31.47.0-255,66,128610,92,185372
12812,0.001414,74.125.24.0-255,1484,130094,92,185372
12813,0.00143,74.125.24.0-255,2184,132278,92,185372
12814,0.001432,172.31.47.0-255,66,132344,92,185372
12815,0.001463,74.125.24.0-255,1484,133828,92,185372
12816,0.001473,74.125.24.0-255,2902,136730,92,185372
12817,0.001475,172.31.47.0-255,66,136796,92,185372
12818,0.001486,74.125.24.0-255,1484,138280,92,185372
12819,0.0015,74.125.24.0-255,4320,142600,92,185372
12820,0.001502,172.31.47.0-255,66,142666,92,185372
12821,0.001524,74.125.24.0-255,4320,146986,92,185372
12822,0.001526,172.31.47.0-255,66,147052,92,185372
12823,0.001556,172.31.47.0-255,66,147118,92,185372
12824,0.001568,74.125.24.0-255,2902,150020,92,185372
12825,0.001569,172.31.47.0-255,66,150086,92,185372
12826,0.001598,172.31.47.0-255,66,150152,92,185372
12827,0.001625,74.125.24.0-255,1484,151636,92,185372
12828,0.001635,74.125.24.0-255,1484,153120,92,185372
12829,0.001636,172.31.47.0-255,66,153186,92,185372
12830,0.001663,74.125.24.0-255,1484,154670,92,185372
12831,0.001669,74.125.24.0-255,5738,160408,92,185372
12832,0.00167,172.31.47.0-255,66,160474,92,185372
12833,0.001675,74.125.24.0-255,4320,164794,92,185372
12834,0.001676,172.31.47.0-255,66,164860,92,185372
12835,0.001697,74.125.24.0-255,2902,167762,92,185372
12836,0.001699,172.31.47.0-255,66,167828,92,185372
12837,0.001707,172.31.47.0-255,66,167894,92,185372
12838,0.001766,172.31.47.0-255,66,167960,92,185372
12839,0.004106,74.125.24.0-255,5738,173698,92,185372
12840,0.004108,172.31.47.0-255,66,173764,92,185372
12841,0.006454,74.125.24.0-255,5738,179502,92,185372
12842,0.006461,172.31.47.0-255,66,179568,92,185372
12843,0.008779,74.125.24.0-255,5738,185306,92,185372
12844,0.008785,172.31.47.0-255,66,185372,92,185372
12845,0.0,172.31.47.0-255,105,105,92,105
12846,0.0,172.217.194.0-255,152,152,92,130437
12847,1.6e-05,172.31.47.0-255,66,218,92,130437
12848,2.3e-05,172.217.194.0-255,1484,1702,92,130437
12849,2.8e-05,172.31.47.0-255,66,1768,92,130437
12850,3.3e-05,172.217.194.0-255,2902,4670,92,130437
12851,3.5e-05,172.31.47.0-255,66,4736,92,130437
12852,4.1e-05,172.217.194.0-255,7156,11892,92,130437
12853,4.4e-05,172.31.47.0-255,66,11958,92,130437
12854,4.7e-05,172.217.194.0-255,2022,13980,92,130437
12855,4.9e-05,172.31.47.0-255,66,14046,92,130437
12856,9.7e-05,172.217.194.0-255,4320,18366,92,130437
12857,0.0001,172.31.47.0-255,66,18432,92,130437
12858,0.000117,172.217.194.0-255,2902,21334,92,130437
12859,0.000119,172.31.47.0-255,66,21400,92,130437
12860,0.000129,172.31.47.0-255,66,21466,92,130437
12861,0.000143,172.217.194.0-255,1125,22591,92,130437
12862,0.000144,172.31.47.0-255,66,22657,92,130437
12863,0.000202,172.217.194.0-255,1484,24141,92,130437
12864,0.000205,172.31.47.0-255,66,24207,92,130437
12865,0.000221,172.217.194.0-255,2902,27109,92,130437
12866,0.000223,172.31.47.0-255,66,27175,92,130437
12867,0.000227,172.217.194.0-255,2902,30077,92,130437
12868,0.000228,172.31.47.0-255,66,30143,92,130437
12869,0.00025,172.217.194.0-255,2902,33045,92,130437
12870,0.000252,172.31.47.0-255,66,33111,92,130437
12871,0.000255,172.217.194.0-255,1484,34595,92,130437
12872,0.000256,172.31.47.0-255,66,34661,92,130437
12873,0.000275,172.217.194.0-255,5379,40040,92,130437
12874,0.000277,172.31.47.0-255,66,40106,92,130437
12875,0.000334,172.217.194.0-255,1484,41590,92,130437
12876,0.000336,172.31.47.0-255,66,41656,92,130437
12877,0.000352,172.217.194.0-255,2902,44558,92,130437
12878,0.000354,172.31.47.0-255,66,44624,92,130437
12879,0.000357,172.217.194.0-255,1484,46108,92,130437
12880,0.000359,172.31.47.0-255,66,46174,92,130437
12881,0.000364,172.217.194.0-255,4320,50494,92,130437
12882,0.000366,172.31.47.0-255,66,50560,92,130437
12883,0.000378,172.217.194.0-255,1484,52044,92,130437
12884,0.000379,172.31.47.0-255,66,52110,92,130437
12885,0.000401,172.217.194.0-255,2902,55012,92,130437
12886,0.000403,172.31.47.0-255,66,55078,92,130437
12887,0.00042,172.217.194.0-255,2543,57621,92,130437
12888,0.000422,172.31.47.0-255,66,57687,92,130437
12889,0.000851,172.217.194.0-255,646,58333,92,130437
12890,0.000856,172.31.47.0-255,66,58399,92,130437
12891,0.001176,172.217.194.0-255,1484,59883,92,130437
12892,0.001182,172.217.194.0-255,2902,62785,92,130437
12893,0.001186,172.31.47.0-255,66,62851,92,130437
12894,0.00119,172.217.194.0-255,1484,64335,92,130437
12895,0.001208,172.217.194.0-255,4320,68655,92,130437
12896,0.001211,172.31.47.0-255,66,68721,92,130437
12897,0.001237,172.31.47.0-255,66,68787,92,130437
12898,0.001244,172.217.194.0-255,5738,74525,92,130437
12899,0.001246,172.31.47.0-255,66,74591,92,130437
12900,0.00127,172.217.194.0-255,6438,81029,92,130437
12901,0.001293,172.31.47.0-255,66,81095,92,130437
12902,0.001694,172.217.194.0-255,1484,82579,92,130437
12903,0.0017,172.217.194.0-255,2902,85481,92,130437
12904,0.001703,172.31.47.0-255,66,85547,92,130437
12905,0.001721,172.217.194.0-255,2902,88449,92,130437
12906,0.001723,172.31.47.0-255,66,88515,92,130437
12907,0.001743,172.217.194.0-255,2902,91417,92,130437
12908,0.001745,172.31.47.0-255,66,91483,92,130437
12909,0.001769,172.217.194.0-255,1484,92967,92,130437
12910,0.001783,172.217.194.0-255,5738,98705,92,130437
12911,0.001785,172.31.47.0-255,66,98771,92,130437
12912,0.001796,172.31.47.0-255,66,98837,92,130437
12913,0.001799,172.217.194.0-255,2184,101021,92,130437
12914,0.0018,172.31.47.0-255,66,101087,92,130437
12915,0.002014,172.217.194.0-255,1484,102571,92,130437
12916,0.002019,172.217.194.0-255,2902,105473,92,130437
12917,0.002021,172.31.47.0-255,66,105539,92,130437
12918,0.002024,172.217.194.0-255,1484,107023,92,130437
12919,0.002043,172.217.194.0-255,4320,111343,92,130437
12920,0.002045,172.31.47.0-255,66,111409,92,130437
12921,0.002071,172.31.47.0-255,66,111475,92,130437
12922,0.002073,172.217.194.0-255,1484,112959,92,130437
12923,0.002097,172.31.47.0-255,66,113025,92,130437
12924,0.004438,172.217.194.0-255,5738,118763,92,130437
12925,0.004445,172.31.47.0-255,66,118829,92,130437
12926,0.006793,172.217.194.0-255,5738,124567,92,130437
12927,0.0068,172.31.47.0-255,66,124633,92,130437
12928,0.00911,172.217.194.0-255,5738,130371,92,130437
12929,0.009118,172.31.47.0-255,66,130437,92,130437
12930,0.0,74.125.24.0-255,153,153,92,164665
12931,3.5e-05,172.31.47.0-255,66,219,92,164665
12932,4.2e-05,74.125.24.0-255,1484,1703,92,164665
12933,4.7e-05,172.31.47.0-255,66,1769,92,164665
12934,5.1e-05,74.125.24.0-255,2902,4671,92,164665
12935,5.4e-05,172.31.47.0-255,66,4737,92,164665
12936,6.1e-05,74.125.24.0-255,5738,10475,92,164665
12937,6.3e-05,172.31.47.0-255,66,10541,92,164665
12938,9.7e-05,74.125.24.0-255,3545,14086,92,164665
12939,0.0001,172.31.47.0-255,66,14152,92,164665
12940,0.000133,74.125.24.0-255,4320,18472,92,164665
12941,0.000136,172.31.47.0-255,66,18538,92,164665
12942,0.00014,74.125.24.0-255,4320,22858,92,164665
12943,0.000142,172.31.47.0-255,66,22924,92,164665
12944,0.000153,74.125.24.0-255,1484,24408,92,164665
12945,0.000155,172.31.47.0-255,66,24474,92,164665
12946,0.000175,74.125.24.0-255,4320,28794,92,164665
12947,0.000177,172.31.47.0-255,66,28860,92,164665
12948,0.000184,74.125.24.0-255,2902,31762,92,164665
12949,0.000186,172.31.47.0-255,66,31828,92,164665
12950,0.000213,172.31.47.0-255,66,31894,92,164665
12951,0.00022,74.125.24.0-255,7156,39050,92,164665
12952,0.000223,172.31.47.0-255,66,39116,92,164665
12953,0.000242,74.125.24.0-255,766,39882,92,164665
12954,0.000245,172.31.47.0-255,66,39948,92,164665
12955,0.000497,74.125.24.0-255,1484,41432,92,164665
12956,0.000503,74.125.24.0-255,2902,44334,92,164665
12957,0.000504,172.31.47.0-255,66,44400,92,164665
12958,0.000509,172.31.47.0-255,66,44466,92,164665
12959,0.00053,74.125.24.0-255,5738,50204,92,164665
12960,0.000534,172.31.47.0-255,66,50270,92,164665
12961,0.000556,74.125.24.0-255,2902,53172,92,164665
12962,0.000559,172.31.47.0-255,66,53238,92,164665
12963,0.000575,74.125.24.0-255,4273,57511,92,164665
12964,0.000578,172.31.47.0-255,66,57577,92,164665
12965,0.000712,74.125.24.0-255,109,57686,92,164665
12966,0.00075,74.125.24.0-255,1484,59170,92,164665
12967,0.000754,172.31.47.0-255,66,59236,92,164665
12968,0.000759,74.125.24.0-255,2902,62138,92,164665
12969,0.000761,172.31.47.0-255,66,62204,92,164665
12970,0.000791,74.125.24.0-255,7156,69360,92,164665
12971,0.000794,172.31.47.0-255,66,69426,92,164665
12972,0.000819,172.31.47.0-255,66,69492,92,164665
12973,0.000849,74.125.24.0-255,7156,76648,92,164665
12974,0.000852,172.31.47.0-255,66,76714,92,164665
12975,0.000856,74.125.24.0-255,2902,79616,92,164665
12976,0.000858,172.31.47.0-255,66,79682,92,164665
12977,0.000863,74.125.24.0-255,2902,82584,92,164665
12978,0.000865,172.31.47.0-255,66,82650,92,164665
12979,0.000887,74.125.24.0-255,766,83416,92,164665
12980,0.001114,172.31.47.0-255,66,83482,92,164665
12981,0.001433,74.125.24.0-255,1484,84966,92,164665
12982,0.001442,74.125.24.0-255,2902,87868,92,164665
12983,0.001445,172.31.47.0-255,66,87934,92,164665
12984,0.00145,74.125.24.0-255,2902,90836,92,164665
12985,0.001452,172.31.47.0-255,66,90902,92,164665
12986,0.001468,74.125.24.0-255,2902,93804,92,164665
12987,0.00147,172.31.47.0-255,66,93870,92,164665
12988,0.001473,74.125.24.0-255,1484,95354,92,164665
12989,0.001492,172.31.47.0-255,66,95420,92,164665
12990,0.001549,172.31.47.0-255,66,95486,92,164665
12991,0.001754,74.125.24.0-255,1484,96970,92,164665
12992,0.00176,74.125.24.0-255,2902,99872,92,164665
12993,0.001763,172.31.47.0-255,66,99938,92,164665
12994,0.001782,74.125.24.0-255,5738,105676,92,164665
12995,0.001783,172.31.47.0-255,66,105742,92,164665
12996,0.001807,172.31.47.0-255,66,105808,92,164665
12997,0.001825,74.125.24.0-255,4320,110128,92,164665
12998,0.001827,172.31.47.0-255,66,110194,92,164665
12999,0.001833,74.125.24.0-255,7156,117350,92,164665
13000,0.001834,172.31.47.0-255,66,117416,92,164665
13001,0.001861,74.125.24.0-255,4320,121736,92,164665
13002,0.001863,172.31.47.0-255,66,121802,92,164665
13003,0.001888,172.31.47.0-255,66,121868,92,164665
13004,0.001909,74.125.24.0-255,3602,125470,92,164665
13005,0.001911,172.31.47.0-255,66,125536,92,164665
13006,0.001925,74.125.24.0-255,1484,127020,92,164665
13007,0.001948,172.31.47.0-255,66,127086,92,164665
13008,0.001991,172.31.47.0-255,66,127152,92,164665
13009,0.002002,74.125.24.0-255,2902,130054,92,164665
13010,0.002004,172.31.47.0-255,66,130120,92,164665
13011,0.00203,172.31.47.0-255,66,130186,92,164665
13012,0.002039,74.125.24.0-255,2902,133088,92,164665
13013,0.002041,172.31.47.0-255,66,133154,92,164665
13014,0.002084,74.125.24.0-255,3602,136756,92,164665
13015,0.002086,172.31.47.0-255,66,136822,92,164665
13016,0.00213,172.31.47.0-255,66,136888,92,164665
13017,0.002154,172.31.47.0-255,66,136954,92,164665
13018,0.002212,74.125.24.0-255,4320,141274,92,164665
13019,0.002214,172.31.47.0-255,66,141340,92,164665
13020,0.002268,172.31.47.0-255,66,141406,92,164665
13021,0.002337,74.125.24.0-255,5738,147144,92,164665
13022,0.002339,172.31.47.0-255,66,147210,92,164665
13023,0.002371,172.31.47.0-255,66,147276,92,164665
13024,0.002415,74.125.24.0-255,4320,151596,92,164665
13025,0.002417,172.31.47.0-255,66,151662,92,164665
13026,0.002476,172.31.47.0-255,66,151728,92,164665
13027,0.002593,172.31.47.0-255,66,151794,92,164665
13028,0.002629,172.31.47.0-255,66,151860,92,164665
13029,0.002665,74.125.24.0-255,1484,153344,92,164665
13030,0.002672,74.125.24.0-255,7156,160500,92,164665
13031,0.002674,172.31.47.0-255,66,160566,92,164665
13032,0.002698,172.31.47.0-255,66,160632,92,164665
13033,0.002723,74.125.24.0-255,3691,164323,92,164665
13034,0.002725,172.31.47.0-255,66,164389,92,164665
13035,0.002728,74.125.24.0-255,105,164494,92,164665
13036,0.008846,172.31.47.0-255,66,164560,92,164665
13037,0.008874,172.31.47.0-255,105,164665,92,164665
13038,0.0,172.31.47.0-255,105,105,92,276
13039,0.001768,157.240.13.0-255,105,210,92,276
13040,0.001778,172.31.47.0-255,66,276,92,276
13041,0.0,172.31.47.0-255,233,233,92,299
13042,0.005804,172.217.194.0-255,66,299,92,299
13043,0.0,74.125.24.0-255,153,153,92,144494
13044,2.7e-05,172.31.47.0-255,66,219,92,144494
13045,3.5e-05,74.125.24.0-255,1484,1703,92,144494
13046,4e-05,172.31.47.0-255,66,1769,92,144494
13047,5.3e-05,74.125.24.0-255,2902,4671,92,144494
13048,5.6e-05,172.31.47.0-255,66,4737,92,144494
13049,6.5e-05,74.125.24.0-255,7156,11893,92,144494
13050,6.7e-05,172.31.47.0-255,66,11959,92,144494
13051,7.3e-05,74.125.24.0-255,4784,16743,92,144494
13052,7.6e-05,172.31.47.0-255,66,16809,92,144494
13053,9.1e-05,172.31.47.0-255,66,16875,92,144494
13054,0.000131,74.125.24.0-255,1484,18359,92,144494
13055,0.000134,172.31.47.0-255,66,18425,92,144494
13056,0.000138,74.125.24.0-255,1484,19909,92,144494
13057,0.00014,172.31.47.0-255,66,19975,92,144494
13058,0.000172,74.125.24.0-255,1484,21459,92,144494
13059,0.000175,172.31.47.0-255,66,21525,92,144494
13060,0.000182,74.125.24.0-255,5738,27263,92,144494
13061,0.000185,172.31.47.0-255,66,27329,92,144494
13062,0.000199,172.31.47.0-255,66,27395,92,144494
13063,0.000213,172.31.47.0-255,66,27461,92,144494
13064,0.000271,74.125.24.0-255,647,28108,92,144494
13065,0.000274,172.31.47.0-255,66,28174,92,144494
13066,0.000736,74.125.24.0-255,1484,29658,92,144494
13067,0.000741,74.125.24.0-255,2902,32560,92,144494
13068,0.000742,172.31.47.0-255,66,32626,92,144494
13069,0.000747,172.31.47.0-255,66,32692,92,144494
13070,0.000754,74.125.24.0-255,1484,34176,92,144494
13071,0.000762,172.31.47.0-255,66,34242,92,144494
13072,0.000787,74.125.24.0-255,4320,38562,92,144494
13073,0.000791,172.31.47.0-255,66,38628,92,144494
13074,0.000805,172.31.47.0-255,66,38694,92,144494
13075,0.000817,172.31.47.0-255,66,38760,92,144494
13076,0.001464,74.125.24.0-255,1484,40244,92,144494
13077,0.001475,74.125.24.0-255,2902,43146,92,144494
13078,0.001479,172.31.47.0-255,66,43212,92,144494
13079,0.001485,74.125.24.0-255,5738,48950,92,144494
13080,0.001487,172.31.47.0-255,66,49016,92,144494
13081,0.00153,172.31.47.0-255,66,49082,92,144494
13082,0.00154,172.31.47.0-255,66,49148,92,144494
13083,0.001547,74.125.24.0-255,766,49914,92,144494
13084,0.001643,74.125.24.0-255,1484,51398,92,144494
13085,0.001647,172.31.47.0-255,66,51464,92,144494
13086,0.001652,74.125.24.0-255,2902,54366,92,144494
13087,0.001653,172.31.47.0-255,66,54432,92,144494
13088,0.001657,74.125.24.0-255,2902,57334,92,144494
13089,0.001664,172.31.47.0-255,66,57400,92,144494
13090,0.001695,74.125.24.0-255,1484,58884,92,144494
13091,0.001705,172.31.47.0-255,66,58950,92,144494
13092,0.001708,74.125.24.0-255,1484,60434,92,144494
13093,0.001748,172.31.47.0-255,66,60500,92,144494
13094,0.00178,74.125.24.0-255,1484,61984,92,144494
13095,0.001795,74.125.24.0-255,2902,64886,92,144494
13096,0.0018,172.31.47.0-255,66,64952,92,144494
13097,0.001838,74.125.24.0-255,4320,69272,92,144494
13098,0.00184,172.31.47.0-255,66,69338,92,144494
13099,0.001859,74.125.24.0-255,1484,70822,92,144494
13100,0.001861,74.125.24.0-255,1484,72306,92,144494
13101,0.001863,172.31.47.0-255,66,72372,92,144494
13102,0.001871,172.31.47.0-255,66,72438,92,144494
13103,0.001886,172.31.47.0-255,66,72504,92,144494
13104,0.001926,74.125.24.0-255,1484,73988,92,144494
13105,0.001945,74.125.24.0-255,2902,76890,92,144494
13106,0.001947,172.31.47.0-255,66,76956,92,144494
13107,0.001952,74.125.24.0-255,5738,82694,92,144494
13108,0.001954,172.31.47.0-255,66,82760,92,144494
13109,0.001983,172.31.47.0-255,66,82826,92,144494
13110,0.002018,74.125.24.0-255,2902,85728,92,144494
13111,0.00202,172.31.47.0-255,66,85794,92,144494
13112,0.002053,172.31.47.0-255,66,85860,92,144494
13113,0.002072,74.125.24.0-255,1484,87344,92,144494
13114,0.002085,74.125.24.0-255,2902,90246,92,144494
13115,0.002086,172.31.47.0-255,66,90312,92,144494
13116,0.002089,74.125.24.0-255,1484,91796,92,144494
13117,0.00211,74.125.24.0-255,4320,96116,92,144494
13118,0.002112,172.31.47.0-255,66,96182,92,144494
13119,0.002118,74.125.24.0-255,7156,103338,92,144494
13120,0.00212,172.31.47.0-255,66,103404,92,144494
13121,0.002152,74.125.24.0-255,5738,109142,92,144494
13122,0.002154,172.31.47.0-255,66,109208,92,144494
13123,0.002165,74.125.24.0-255,1484,110692,92,144494
13124,0.00219,172.31.47.0-255,66,110758,92,144494
13125,0.002224,172.31.47.0-255,66,110824,92,144494
13126,0.002229,74.125.24.0-255,5738,116562,92,144494
13127,0.002231,172.31.47.0-255,66,116628,92,144494
13128,0.002253,74.125.24.0-255,1484,118112,92,144494
13129,0.002257,74.125.24.0-255,2902,121014,92,144494
13130,0.002258,172.31.47.0-255,66,121080,92,144494
13131,0.00229,172.31.47.0-255,66,121146,92,144494
13132,0.002292,74.125.24.0-255,1484,122630,92,144494
13133,0.002298,74.125.24.0-255,5738,128368,92,144494
13134,0.002307,172.31.47.0-255,66,128434,92,144494
13135,0.004548,74.125.24.0-255,5738,134172,92,144494
13136,0.004551,172.31.47.0-255,66,134238,92,144494
13137,0.006809,74.125.24.0-255,4320,138558,92,144494
13138,0.006813,172.31.47.0-255,66,138624,92,144494
13139,0.006836,74.125.24.0-255,1484,140108,92,144494
13140,0.009068,74.125.24.0-255,4320,144428,92,144494
13141,0.009074,172.31.47.0-255,66,144494,92,144494
13142,0.0,74.125.24.0-255,153,153,92,133553
13143,2.8e-05,172.31.47.0-255,66,219,92,133553
13144,3.4e-05,74.125.24.0-255,1484,1703,92,133553
13145,3.7e-05,172.31.47.0-255,66,1769,92,133553
13146,4.1e-05,74.125.24.0-255,2902,4671,92,133553
13147,4.3e-05,172.31.47.0-255,66,4737,92,133553
13148,6.9e-05,74.125.24.0-255,7156,11893,92,133553
13149,7.1e-05,172.31.47.0-255,66,11959,92,133553
13150,8.9e-05,74.125.24.0-255,2065,14024,92,133553
13151,9.1e-05,172.31.47.0-255,66,14090,92,133553
13152,0.000423,74.125.24.0-255,1484,15574,92,133553
13153,0.000428,172.31.47.0-255,66,15640,92,133553
13154,0.000434,74.125.24.0-255,2902,18542,92,133553
13155,0.000436,172.31.47.0-255,66,18608,92,133553
13156,0.00045,74.125.24.0-255,5738,24346,92,133553
13157,0.000452,172.31.47.0-255,66,24412,92,133553
13158,0.000488,74.125.24.0-255,4320,28732,92,133553
13159,0.000491,172.31.47.0-255,66,28798,92,133553
13160,0.000506,74.125.24.0-255,2543,31341,92,133553
13161,0.00051,172.31.47.0-255,66,31407,92,133553
13162,0.000634,74.125.24.0-255,1484,32891,92,133553
13163,0.000638,172.31.47.0-255,66,32957,92,133553
13164,0.000643,74.125.24.0-255,2902,35859,92,133553
13165,0.000645,172.31.47.0-255,66,35925,92,133553
13166,0.000665,74.125.24.0-255,2902,38827,92,133553
13167,0.000667,172.31.47.0-255,66,38893,92,133553
13168,0.000689,74.125.24.0-255,2902,41795,92,133553
13169,0.000692,172.31.47.0-255,66,41861,92,133553
13170,0.000697,74.125.24.0-255,5738,47599,92,133553
13171,0.000699,172.31.47.0-255,66,47665,92,133553
13172,0.000717,74.125.24.0-255,6797,54462,92,133553
13173,0.000719,172.31.47.0-255,66,54528,92,133553
13174,0.000743,74.125.24.0-255,5738,60266,92,133553
13175,0.000745,172.31.47.0-255,66,60332,92,133553
13176,0.000763,74.125.24.0-255,5687,66019,92,133553
13177,0.000765,172.31.47.0-255,66,66085,92,133553
13178,0.000768,74.125.24.0-255,112,66197,92,133553
13179,0.000913,74.125.24.0-255,1484,67681,92,133553
13180,0.000918,172.31.47.0-255,66,67747,92,133553
13181,0.000922,74.125.24.0-255,2902,70649,92,133553
13182,0.000924,172.31.47.0-255,66,70715,92,133553
13183,0.000953,74.125.24.0-255,5738,76453,92,133553
13184,0.000956,172.31.47.0-255,66,76519,92,133553
13185,0.000981,74.125.24.0-255,2902,79421,92,133553
13186,0.000982,172.31.47.0-255,66,79487,92,133553
13187,0.001009,172.31.47.0-255,66,79553,92,133553
13188,0.001014,74.125.24.0-255,7156,86709,92,133553
13189,0.001016,172.31.47.0-255,66,86775,92,133553
13190,0.001032,74.125.24.0-255,4320,91095,92,133553
13191,0.001034,172.31.47.0-255,66,91161,92,133553
13192,0.001037,74.125.24.0-255,1368,92529,92,133553
13193,0.001395,74.125.24.0-255,1484,94013,92,133553
13194,0.001396,172.31.47.0-255,66,94079,92,133553
13195,0.001411,74.125.24.0-255,2902,96981,92,133553
13196,0.001413,172.31.47.0-255,66,97047,92,133553
13197,0.001429,74.125.24.0-255,5738,102785,92,133553
13198,0.001431,172.31.47.0-255,66,102851,92,133553
13199,0.001443,74.125.24.0-255,2902,105753,92,133553
13200,0.001445,172.31.47.0-255,66,105819,92,133553
13201,0.001464,74.125.24.0-255,5738,111557,92,133553
13202,0.001465,172.31.47.0-255,66,111623,92,133553
13203,0.001514,172.31.47.0-255,66,111689,92,133553
13204,0.003549,74.125.24.0-255,5738,117427,92,133553
13205,0.003558,172.31.47.0-255,66,117493,92,133553
13206,0.00557,74.125.24.0-255,5738,123231,92,133553
13207,0.005576,172.31.47.0-255,66,123297,92,133553
13208,0.007606,74.125.24.0-255,4320,127617,92,133553
13209,0.007611,172.31.47.0-255,66,127683,92,133553
13210,0.007641,74.125.24.0-255,1484,129167,92,133553
13211,0.009634,74.125.24.0-255,4320,133487,92,133553
13212,0.00964,172.31.47.0-255,66,133553,92,133553
13213,0.0,74.125.200.0-255,153,153,92,304454
13214,3.5e-05,172.31.47.0-255,66,219,92,304454
13215,4.3e-05,74.125.200.0-255,1484,1703,92,304454
13216,4.7e-05,172.31.47.0-255,66,1769,92,304454
13217,5.1e-05,74.125.200.0-255,2902,4671,92,304454
13218,5.4e-05,172.31.47.0-255,66,4737,92,304454
13219,6e-05,74.125.200.0-255,5738,10475,92,304454
13220,6.2e-05,172.31.47.0-255,66,10541,92,304454
13221,8.7e-05,74.125.200.0-255,4320,14861,92,304454
13222,8.9e-05,172.31.47.0-255,66,14927,92,304454
13223,0.000106,74.125.200.0-255,3579,18506,92,304454
13224,0.000109,172.31.47.0-255,66,18572,92,304454
13225,0.000133,74.125.200.0-255,4320,22892,92,304454
13226,0.000136,172.31.47.0-255,66,22958,92,304454
13227,0.000161,74.125.200.0-255,4320,27278,92,304454
13228,0.000164,172.31.47.0-255,66,27344,92,304454
13229,0.00017,74.125.200.0-255,3961,31305,92,304454
13230,0.000172,172.31.47.0-255,66,31371,92,304454
13231,0.000186,74.125.200.0-255,4320,35691,92,304454
13232,0.000188,172.31.47.0-255,66,35757,92,304454
13233,0.000196,74.125.200.0-255,5738,41495,92,304454
13234,0.000198,172.31.47.0-255,66,41561,92,304454
13235,0.000243,74.125.200.0-255,6797,48358,92,304454
13236,0.000247,172.31.47.0-255,66,48424,92,304454
13237,0.000454,74.125.200.0-255,1484,49908,92,304454
13238,0.000458,172.31.47.0-255,66,49974,92,304454
13239,0.000476,74.125.200.0-255,2902,52876,92,304454
13240,0.000479,172.31.47.0-255,66,52942,92,304454
13241,0.000488,74.125.200.0-255,5738,58680,92,304454
13242,0.00049,172.31.47.0-255,66,58746,92,304454
13243,0.000493,74.125.200.0-255,1484,60230,92,304454
13244,0.000495,172.31.47.0-255,66,60296,92,304454
13245,0.000527,74.125.200.0-255,5379,65675,92,304454
13246,0.000537,172.31.47.0-255,66,65741,92,304454
13247,0.000601,74.125.200.0-255,1484,67225,92,304454
13248,0.000616,74.125.200.0-255,2902,70127,92,304454
13249,0.000639,74.125.200.0-255,5738,75865,92,304454
13250,0.000646,172.31.47.0-255,66,75931,92,304454
13251,0.000664,74.125.200.0-255,6797,82728,92,304454
13252,0.000672,172.31.47.0-255,66,82794,92,304454
13253,0.000834,74.125.200.0-255,1484,84278,92,304454
13254,0.000838,74.125.200.0-255,1484,85762,92,304454
13255,0.000842,172.31.47.0-255,66,85828,92,304454
13256,0.000858,74.125.200.0-255,1484,87312,92,304454
13257,0.000861,74.125.200.0-255,1484,88796,92,304454
13258,0.000864,172.31.47.0-255,66,88862,92,304454
13259,0.000885,74.125.200.0-255,4320,93182,92,304454
13260,0.000888,74.125.200.0-255,1484,94666,92,304454
13261,0.000892,172.31.47.0-255,66,94732,92,304454
13262,0.000906,74.125.200.0-255,5738,100470,92,304454
13263,0.000915,172.31.47.0-255,66,100536,92,304454
13264,0.000921,74.125.200.0-255,4320,104856,92,304454
13265,0.000924,74.125.200.0-255,2902,107758,92,304454
13266,0.000928,172.31.47.0-255,66,107824,92,304454
13267,0.000939,74.125.200.0-255,5738,113562,92,304454
13268,0.00095,172.31.47.0-255,66,113628,92,304454
13269,0.000951,74.125.200.0-255,3602,117230,92,304454
13270,0.000953,172.31.47.0-255,66,117296,92,304454
13271,0.001026,74.125.200.0-255,1484,118780,92,304454
13272,0.001041,74.125.200.0-255,2902,121682,92,304454
13273,0.001043,172.31.47.0-255,66,121748,92,304454
13274,0.001046,74.125.200.0-255,1484,123232,92,304454
13275,0.001062,74.125.200.0-255,2902,126134,92,304454
13276,0.001066,74.125.200.0-255,4320,130454,92,304454
13277,0.001067,172.31.47.0-255,66,130520,92,304454
13278,0.001081,74.125.200.0-255,4320,134840,92,304454
13279,0.001083,172.31.47.0-255,66,134906,92,304454
13280,0.001087,172.31.47.0-255,66,134972,92,304454
13281,0.001091,74.125.200.0-255,2902,137874,92,304454
13282,0.001099,172.31.47.0-255,66,137940,92,304454
13283,0.001109,74.125.200.0-255,5738,143678,92,304454
13284,0.001128,172.31.47.0-255,66,143744,92,304454
13285,0.001142,74.125.200.0-255,1484,145228,92,304454
13286,0.001166,74.125.200.0-255,6438,151666,92,304454
13287,0.001172,172.31.47.0-255,66,151732,92,304454
13288,0.001551,74.125.200.0-255,1484,153216,92,304454
13289,0.001574,74.125.200.0-255,2902,156118,92,304454
13290,0.001577,172.31.47.0-255,66,156184,92,304454
13291,0.001583,74.125.200.0-255,5738,161922,92,304454
13292,0.001585,74.125.200.0-255,1484,163406,92,304454
13293,0.001597,74.125.200.0-255,4320,167726,92,304454
13294,0.001625,74.125.200.0-255,7156,174882,92,304454
13295,0.001648,74.125.200.0-255,2902,177784,92,304454
13296,0.001669,74.125.200.0-255,5738,183522,92,304454
13297,0.001695,74.125.200.0-255,2184,185706,92,304454
13298,0.001787,74.125.200.0-255,1484,187190,92,304454
13299,0.001791,74.125.200.0-255,1484,188674,92,304454
13300,0.001805,74.125.200.0-255,1484,190158,92,304454
13301,0.001816,74.125.200.0-255,4320,194478,92,304454
13302,0.001824,74.125.200.0-255,1484,195962,92,304454
13303,0.001838,74.125.200.0-255,1484,197446,92,304454
13304,0.001859,74.125.200.0-255,7156,204602,92,304454
13305,0.001881,74.125.200.0-255,4320,208922,92,304454
13306,0.001896,74.125.200.0-255,4320,213242,92,304454
13307,0.001917,74.125.200.0-255,6438,219680,92,304454
13308,0.00195,74.125.200.0-255,7156,226836,92,304454
13309,0.002006,74.125.200.0-255,6438,233274,92,304454
13310,0.002104,74.125.200.0-255,1484,234758,92,304454
13311,0.002108,74.125.200.0-255,2902,237660,92,304454
13312,0.002136,74.125.200.0-255,2902,240562,92,304454
13313,0.00215,74.125.200.0-255,2902,243464,92,304454
13314,0.002153,74.125.200.0-255,2902,246366,92,304454
13315,0.002187,74.125.200.0-255,1484,247850,92,304454
13316,0.002207,74.125.200.0-255,4320,252170,92,304454
13317,0.002222,74.125.200.0-255,4320,256490,92,304454
13318,0.002326,74.125.200.0-255,1484,257974,92,304454
13319,0.002341,74.125.200.0-255,2902,260876,92,304454
13320,0.002344,74.125.200.0-255,1484,262360,92,304454
13321,0.002356,74.125.200.0-255,1484,263844,92,304454
13322,0.002367,74.125.200.0-255,1484,265328,92,304454
13323,0.002371,74.125.200.0-255,4320,269648,92,304454
13324,0.002387,74.125.200.0-255,1484,271132,92,304454
13325,0.002407,74.125.200.0-255,4320,275452,92,304454
13326,0.002427,74.125.200.0-255,4320,279772,92,304454
13327,0.00243,74.125.200.0-255,1484,281256,92,304454
13328,0.002455,74.125.200.0-255,2902,284158,92,304454
13329,0.002467,74.125.200.0-255,2184,286342,92,304454
13330,0.00247,74.125.200.0-255,1484,287826,92,304454
13331,0.002488,74.125.200.0-255,4320,292146,92,304454
13332,0.002491,74.125.200.0-255,1484,293630,92,304454
13333,0.002523,74.125.200.0-255,4320,297950,92,304454
13334,0.002549,74.125.200.0-255,6438,304388,92,304454
13335,0.008871,172.31.47.0-255,66,304454,92,304454
13336,0.0,74.125.24.0-255,66,66,92,66
13337,0.0,74.125.24.0-255,298,298,92,205773
13338,3.6e-05,172.31.47.0-255,66,364,92,205773
13339,4.3e-05,74.125.24.0-255,1484,1848,92,205773
13340,4.8e-05,172.31.47.0-255,66,1914,92,205773
13341,6.7e-05,74.125.24.0-255,4320,6234,92,205773
13342,7.2e-05,172.31.47.0-255,66,6300,92,205773
13343,7.9e-05,74.125.24.0-255,4320,10620,92,205773
13344,8.2e-05,172.31.47.0-255,66,10686,92,205773
13345,9.8e-05,172.31.47.0-255,66,10752,92,205773
13346,0.000112,172.31.47.0-255,66,10818,92,205773
13347,0.000168,74.125.24.0-255,1484,12302,92,205773
13348,0.000172,172.31.47.0-255,66,12368,92,205773
13349,0.000178,74.125.24.0-255,2902,15270,92,205773
13350,0.00018,172.31.47.0-255,66,15336,92,205773
13351,0.000192,74.125.24.0-255,2902,18238,92,205773
13352,0.000195,172.31.47.0-255,66,18304,92,205773
13353,0.000234,74.125.24.0-255,2902,21206,92,205773
13354,0.000238,172.31.47.0-255,66,21272,92,205773
13355,0.000265,172.31.47.0-255,66,21338,92,205773
13356,0.000274,74.125.24.0-255,7156,28494,92,205773
13357,0.000277,172.31.47.0-255,66,28560,92,205773
13358,0.00028,74.125.24.0-255,1484,30044,92,205773
13359,0.000283,172.31.47.0-255,66,30110,92,205773
13360,0.000318,74.125.24.0-255,1745,31855,92,205773
13361,0.000321,172.31.47.0-255,66,31921,92,205773
13362,0.000459,74.125.24.0-255,1484,33405,92,205773
13363,0.000464,172.31.47.0-255,66,33471,92,205773
13364,0.000468,74.125.24.0-255,2902,36373,92,205773
13365,0.00047,172.31.47.0-255,66,36439,92,205773
13366,0.000502,74.125.24.0-255,5738,42177,92,205773
13367,0.000504,172.31.47.0-255,66,42243,92,205773
13368,0.000513,172.31.47.0-255,66,42309,92,205773
13369,0.00054,74.125.24.0-255,1484,43793,92,205773
13370,0.00058,172.31.47.0-255,66,43859,92,205773
13371,0.000901,74.125.24.0-255,1484,45343,92,205773
13372,0.000918,74.125.24.0-255,2902,48245,92,205773
13373,0.000922,172.31.47.0-255,66,48311,92,205773
13374,0.000948,74.125.24.0-255,5738,54049,92,205773
13375,0.00095,172.31.47.0-255,66,54115,92,205773
13376,0.000954,74.125.24.0-255,2902,57017,92,205773
13377,0.000955,172.31.47.0-255,66,57083,92,205773
13378,0.000992,172.31.47.0-255,66,57149,92,205773
13379,0.001002,74.125.24.0-255,5738,62887,92,205773
13380,0.001003,172.31.47.0-255,66,62953,92,205773
13381,0.001027,74.125.24.0-255,4320,67273,92,205773
13382,0.001028,172.31.47.0-255,66,67339,92,205773
13383,0.001031,74.125.24.0-255,766,68105,92,205773
13384,0.001613,172.31.47.0-255,66,68171,92,205773
13385,0.002067,74.125.24.0-255,1484,69655,92,205773
13386,0.002079,74.125.24.0-255,2902,72557,92,205773
13387,0.002083,172.31.47.0-255,66,72623,92,205773
13388,0.002091,74.125.24.0-255,5738,78361,92,205773
13389,0.002093,172.31.47.0-255,66,78427,92,205773
13390,0.002136,172.31.47.0-255,66,78493,92,205773
13391,0.002169,74.125.24.0-255,2902,81395,92,205773
13392,0.002171,172.31.47.0-255,66,81461,92,205773
13393,0.002203,172.31.47.0-255,66,81527,92,205773
13394,0.002312,74.125.24.0-255,1484,83011,92,205773
13395,0.002333,74.125.24.0-255,2902,85913,92,205773
13396,0.002336,172.31.47.0-255,66,85979,92,205773
13397,0.002343,74.125.24.0-255,5738,91717,92,205773
13398,0.002344,172.31.47.0-255,66,91783,92,205773
13399,0.002381,172.31.47.0-255,66,91849,92,205773
13400,0.002383,74.125.24.0-255,1484,93333,92,205773
13401,0.002408,172.31.47.0-255,66,93399,92,205773
13402,0.002433,74.125.24.0-255,766,94165,92,205773
13403,0.002731,74.125.24.0-255,1484,95649,92,205773
13404,0.002737,172.31.47.0-255,66,95715,92,205773
13405,0.002782,74.125.24.0-255,1484,97199,92,205773
13406,0.002815,74.125.24.0-255,1484,98683,92,205773
13407,0.002817,172.31.47.0-255,66,98749,92,205773
13408,0.00282,74.125.24.0-255,1484,100233,92,205773
13409,0.002843,74.125.24.0-255,2902,103135,92,205773
13410,0.002845,172.31.47.0-255,66,103201,92,205773
13411,0.002858,74.125.24.0-255,4320,107521,92,205773
13412,0.002863,172.31.47.0-255,66,107587,92,205773
13413,0.002866,74.125.24.0-255,1484,109071,92,205773
13414,0.002898,74.125.24.0-255,7156,116227,92,205773
13415,0.0029,172.31.47.0-255,66,116293,92,205773
13416,0.002936,172.31.47.0-255,66,116359,92,205773
13417,0.00294,74.125.24.0-255,2184,118543,92,205773
13418,0.002941,172.31.47.0-255,66,118609,92,205773
13419,0.003151,74.125.24.0-255,1484,120093,92,205773
13420,0.003167,74.125.24.0-255,2902,122995,92,205773
13421,0.003169,172.31.47.0-255,66,123061,92,205773
13422,0.003196,74.125.24.0-255,5738,128799,92,205773
13423,0.003199,172.31.47.0-255,66,128865,92,205773
13424,0.003203,74.125.24.0-255,4320,133185,92,205773
13425,0.003206,172.31.47.0-255,66,133251,92,205773
13426,0.003231,74.125.24.0-255,1484,134735,92,205773
13427,0.003266,74.125.24.0-255,7156,141891,92,205773
13428,0.003269,172.31.47.0-255,66,141957,92,205773
13429,0.00328,172.31.47.0-255,66,142023,92,205773
13430,0.003293,172.31.47.0-255,66,142089,92,205773
13431,0.003298,74.125.24.0-255,4320,146409,92,205773
13432,0.0033,74.125.24.0-255,1484,147893,92,205773
13433,0.003302,74.125.24.0-255,1484,149377,92,205773
13434,0.00333,74.125.24.0-255,1484,150861,92,205773
13435,0.003349,74.125.24.0-255,4320,155181,92,205773
13436,0.003365,74.125.24.0-255,5020,160201,92,205773
13437,0.003367,74.125.24.0-255,1484,161685,92,205773
13438,0.003404,74.125.24.0-255,4320,166005,92,205773
13439,0.00343,74.125.24.0-255,1484,167489,92,205773
13440,0.003444,74.125.24.0-255,2902,170391,92,205773
13441,0.003503,74.125.24.0-255,4320,174711,92,205773
13442,0.003539,74.125.24.0-255,766,175477,92,205773
13443,0.003551,74.125.24.0-255,1484,176961,92,205773
13444,0.00359,74.125.24.0-255,7156,184117,92,205773
13445,0.003632,74.125.24.0-255,2902,187019,92,205773
13446,0.003646,74.125.24.0-255,5738,192757,92,205773
13447,0.003656,74.125.24.0-255,1484,194241,92,205773
13448,0.003661,74.125.24.0-255,4320,198561,92,205773
13449,0.003675,74.125.24.0-255,1484,200045,92,205773
13450,0.003702,74.125.24.0-255,2902,202947,92,205773
13451,0.003716,74.125.24.0-255,2550,205497,92,205773
13452,0.003747,74.125.24.0-255,105,205602,92,205773
13453,0.005723,172.31.47.0-255,66,205668,92,205773
13454,0.007994,172.31.47.0-255,105,205773,92,205773
13455,0.0,74.125.200.0-255,153,153,92,209963
13456,3.3e-05,172.31.47.0-255,66,219,92,209963
13457,4e-05,74.125.200.0-255,1484,1703,92,209963
13458,4.4e-05,172.31.47.0-255,66,1769,92,209963
13459,4.7e-05,74.125.200.0-255,1484,3253,92,209963
13460,5.8e-05,172.31.47.0-255,66,3319,92,209963
13461,6.4e-05,74.125.200.0-255,2902,6221,92,209963
13462,6.6e-05,172.31.47.0-255,66,6287,92,209963
13463,7.3e-05,74.125.200.0-255,5738,12025,92,209963
13464,7.5e-05,172.31.47.0-255,66,12091,92,209963
13465,9.8e-05,74.125.200.0-255,2148,14239,92,209963
13466,0.000107,172.31.47.0-255,66,14305,92,209963
13467,0.000134,74.125.200.0-255,2902,17207,92,209963
13468,0.000138,172.31.47.0-255,66,17273,92,209963
13469,0.000142,74.125.200.0-255,2902,20175,92,209963
13470,0.000144,172.31.47.0-255,66,20241,92,209963
13471,0.000176,74.125.200.0-255,4320,24561,92,209963
13472,0.000179,172.31.47.0-255,66,24627,92,209963
13473,0.00021,74.125.200.0-255,6797,31424,92,209963
13474,0.000213,172.31.47.0-255,66,31490,92,209963
13475,0.000317,74.125.200.0-255,1484,32974,92,209963
13476,0.000321,172.31.47.0-255,66,33040,92,209963
13477,0.000328,74.125.200.0-255,2902,35942,92,209963
13478,0.00033,172.31.47.0-255,66,36008,92,209963
13479,0.00034,74.125.200.0-255,2902,38910,92,209963
13480,0.000343,172.31.47.0-255,66,38976,92,209963
13481,0.000372,74.125.200.0-255,2902,41878,92,209963
13482,0.000375,172.31.47.0-255,66,41944,92,209963
13483,0.000383,74.125.200.0-255,6797,48741,92,209963
13484,0.000386,172.31.47.0-255,66,48807,92,209963
13485,0.000394,74.125.200.0-255,1484,50291,92,209963
13486,0.000396,172.31.47.0-255,66,50357,92,209963
13487,0.000438,74.125.200.0-255,2902,53259,92,209963
13488,0.000442,172.31.47.0-255,66,53325,92,209963
13489,0.000468,74.125.200.0-255,1484,54809,92,209963
13490,0.000472,74.125.200.0-255,2902,57711,92,209963
13491,0.000472,172.31.47.0-255,66,57777,92,209963
13492,0.000479,172.31.47.0-255,66,57843,92,209963
13493,0.000502,74.125.200.0-255,4320,62163,92,209963
13494,0.000506,172.31.47.0-255,66,62229,92,209963
13495,0.000522,74.125.200.0-255,1484,63713,92,209963
13496,0.000547,74.125.200.0-255,2816,66529,92,209963
13497,0.000554,172.31.47.0-255,66,66595,92,209963
13498,0.000566,74.125.200.0-255,132,66727,92,209963
13499,0.000662,74.125.200.0-255,1484,68211,92,209963
13500,0.000668,172.31.47.0-255,66,68277,92,209963
13501,0.000675,74.125.200.0-255,2902,71179,92,209963
13502,0.000678,172.31.47.0-255,66,71245,92,209963
13503,0.000706,74.125.200.0-255,4320,75565,92,209963
13504,0.000711,172.31.47.0-255,66,75631,92,209963
13505,0.000741,74.125.200.0-255,5738,81369,92,209963
13506,0.000746,172.31.47.0-255,66,81435,92,209963
13507,0.000757,74.125.200.0-255,4320,85755,92,209963
13508,0.000763,172.31.47.0-255,66,85821,92,209963
13509,0.000775,74.125.200.0-255,5738,91559,92,209963
13510,0.000787,172.31.47.0-255,66,91625,92,209963
13511,0.000821,172.31.47.0-255,66,91691,92,209963
13512,0.000827,74.125.200.0-255,766,92457,92,209963
13513,0.000847,74.125.200.0-255,348,92805,92,209963
13514,0.001113,172.31.47.0-255,66,92871,92,209963
13515,0.001171,74.125.200.0-255,1484,94355,92,209963
13516,0.001175,172.31.47.0-255,66,94421,92,209963
13517,0.001183,74.125.200.0-255,2902,97323,92,209963
13518,0.001185,172.31.47.0-255,66,97389,92,209963
13519,0.001219,74.125.200.0-255,4320,101709,92,209963
13520,0.001222,74.125.200.0-255,1484,103193,92,209963
13521,0.001239,74.125.200.0-255,4320,107513,92,209963
13522,0.001263,74.125.200.0-255,4320,111833,92,209963
13523,0.001277,74.125.200.0-255,1484,113317,92,209963
13524,0.001299,74.125.200.0-255,4320,117637,92,209963
13525,0.001313,74.125.200.0-255,2902,120539,92,209963
13526,0.001317,74.125.200.0-255,2902,123441,92,209963
13527,0.001339,74.125.200.0-255,1484,124925,92,209963
13528,0.001356,74.125.200.0-255,2184,127109,92,209963
13529,0.001441,74.125.200.0-255,1484,128593,92,209963
13530,0.001446,74.125.200.0-255,1484,130077,92,209963
13531,0.001462,74.125.200.0-255,1484,131561,92,209963
13532,0.001477,74.125.200.0-255,4320,135881,92,209963
13533,0.001512,74.125.200.0-255,1484,137365,92,209963
13534,0.00154,74.125.200.0-255,7156,144521,92,209963
13535,0.001562,74.125.200.0-255,1484,146005,92,209963
13536,0.001584,74.125.200.0-255,5738,151743,92,209963
13537,0.001641,74.125.200.0-255,766,152509,92,209963
13538,0.001745,74.125.200.0-255,1484,153993,92,209963
13539,0.001757,74.125.200.0-255,2902,156895,92,209963
13540,0.001776,74.125.200.0-255,1484,158379,92,209963
13541,0.001781,74.125.200.0-255,2902,161281,92,209963
13542,0.001783,74.125.200.0-255,1484,162765,92,209963
13543,0.001796,74.125.200.0-255,4320,167085,92,209963
13544,0.001821,74.125.200.0-255,1484,168569,92,209963
13545,0.001842,74.125.200.0-255,7156,175725,92,209963
13546,0.001852,74.125.200.0-255,2902,178627,92,209963
13547,0.001868,74.125.200.0-255,5738,184365,92,209963
13548,0.00188,74.125.200.0-255,2184,186549,92,209963
13549,0.00204,74.125.200.0-255,1484,188033,92,209963
13550,0.002062,74.125.200.0-255,2902,190935,92,209963
13551,0.002081,74.125.200.0-255,1484,192419,92,209963
13552,0.002091,74.125.200.0-255,2902,195321,92,209963
13553,0.002106,74.125.200.0-255,1484,196805,92,209963
13554,0.002117,74.125.200.0-255,1484,198289,92,209963
13555,0.004211,172.31.47.0-255,66,198355,92,209963
13556,0.006312,74.125.200.0-255,5738,204093,92,209963
13557,0.006316,172.31.47.0-255,66,204159,92,209963
13558,0.008394,74.125.200.0-255,5738,209897,92,209963
13559,0.008401,172.31.47.0-255,66,209963,92,209963
13560,0.0,172.31.47.0-255,105,105,92,342
13561,0.001732,157.240.13.0-255,66,171,92,342
13562,0.001795,157.240.13.0-255,105,276,92,342
13563,0.0018,172.31.47.0-255,66,342,92,342
13564,0.0,74.125.68.0-255,153,153,92,211666
13565,2e-05,172.31.47.0-255,66,219,92,211666
13566,2.7e-05,74.125.68.0-255,1484,1703,92,211666
13567,3.1e-05,172.31.47.0-255,66,1769,92,211666
13568,3.5e-05,74.125.68.0-255,2902,4671,92,211666
13569,4.5e-05,172.31.47.0-255,66,4737,92,211666
13570,8e-05,74.125.68.0-255,5738,10475,92,211666
13571,8.3e-05,74.125.68.0-255,3430,13905,92,211666
13572,8.4e-05,172.31.47.0-255,66,13971,92,211666
13573,8.7e-05,172.31.47.0-255,66,14037,92,211666
13574,0.000121,74.125.68.0-255,1484,15521,92,211666
13575,0.000124,172.31.47.0-255,66,15587,92,211666
13576,0.000143,74.125.68.0-255,2902,18489,92,211666
13577,0.000145,172.31.47.0-255,66,18555,92,211666
13578,0.000148,74.125.68.0-255,1484,20039,92,211666
13579,0.00015,172.31.47.0-255,66,20105,92,211666
13580,0.000179,74.125.68.0-255,4320,24425,92,211666
13581,0.000182,172.31.47.0-255,66,24491,92,211666
13582,0.000195,74.125.68.0-255,5738,30229,92,211666
13583,0.000197,172.31.47.0-255,66,30295,92,211666
13584,0.000231,74.125.68.0-255,1125,31420,92,211666
13585,0.000233,172.31.47.0-255,66,31486,92,211666
13586,0.000299,74.125.68.0-255,1484,32970,92,211666
13587,0.000302,172.31.47.0-255,66,33036,92,211666
13588,0.000307,74.125.68.0-255,2902,35938,92,211666
13589,0.000309,172.31.47.0-255,66,36004,92,211666
13590,0.000341,74.125.68.0-255,4320,40324,92,211666
13591,0.000344,172.31.47.0-255,66,40390,92,211666
13592,0.000349,74.125.68.0-255,5738,46128,92,211666
13593,0.000352,172.31.47.0-255,66,46194,92,211666
13594,0.000383,74.125.68.0-255,7156,53350,92,211666
13595,0.000386,172.31.47.0-255,66,53416,92,211666
13596,0.000412,74.125.68.0-255,2543,55959,92,211666
13597,0.000415,172.31.47.0-255,66,56025,92,211666
13598,0.000427,172.31.47.0-255,66,56091,92,211666
13599,0.000434,74.125.68.0-255,114,56205,92,211666
13600,0.000437,172.31.47.0-255,66,56271,92,211666
13601,0.000585,74.125.68.0-255,331,56602,92,211666
13602,0.000588,172.31.47.0-255,66,56668,92,211666
13603,0.000921,74.125.68.0-255,1484,58152,92,211666
13604,0.000927,172.31.47.0-255,66,58218,92,211666
13605,0.000935,74.125.68.0-255,1484,59702,92,211666
13606,0.000938,172.31.47.0-255,66,59768,92,211666
13607,0.000978,74.125.68.0-255,1484,61252,92,211666
13608,0.000981,172.31.47.0-255,66,61318,92,211666
13609,0.000988,74.125.68.0-255,5738,67056,92,211666
13610,0.000991,172.31.47.0-255,66,67122,92,211666
13611,0.001001,74.125.68.0-255,2902,70024,92,211666
13612,0.001004,172.31.47.0-255,66,70090,92,211666
13613,0.00101,74.125.68.0-255,4320,74410,92,211666
13614,0.001025,74.125.68.0-255,5738,80148,92,211666
13615,0.001051,172.31.47.0-255,66,80214,92,211666
13616,0.001053,172.31.47.0-255,66,80280,92,211666
13617,0.001054,172.31.47.0-255,66,80346,92,211666
13618,0.001078,74.125.68.0-255,2184,82530,92,211666
13619,0.001086,172.31.47.0-255,66,82596,92,211666
13620,0.001092,74.125.68.0-255,2902,85498,92,211666
13621,0.001094,172.31.47.0-255,66,85564,92,211666
13622,0.001127,74.125.68.0-255,4320,89884,92,211666
13623,0.00113,172.31.47.0-255,66,89950,92,211666
13624,0.001136,74.125.68.0-255,5738,95688,92,211666
13625,0.001173,74.125.68.0-255,4320,100008,92,211666
13626,0.001216,74.125.68.0-255,5020,105028,92,211666
13627,0.001259,74.125.68.0-255,1484,106512,92,211666
13628,0.001274,74.125.68.0-255,2902,109414,92,211666
13629,0.00129,74.125.68.0-255,2902,112316,92,211666
13630,0.001305,74.125.68.0-255,2902,115218,92,211666
13631,0.001316,74.125.68.0-255,2902,118120,92,211666
13632,0.001334,74.125.68.0-255,2902,121022,92,211666
13633,0.001341,74.125.68.0-255,7156,128178,92,211666
13634,0.001365,74.125.68.0-255,4320,132498,92,211666
13635,0.00139,74.125.68.0-255,6438,138936,92,211666
13636,0.001442,74.125.68.0-255,1484,140420,92,211666
13637,0.001446,74.125.68.0-255,1484,141904,92,211666
13638,0.001457,74.125.68.0-255,1484,143388,92,211666
13639,0.001477,74.125.68.0-255,1484,144872,92,211666
13640,0.001493,74.125.68.0-255,2902,147774,92,211666
13641,0.001515,74.125.68.0-255,5738,153512,92,211666
13642,0.001531,74.125.68.0-255,1484,154996,92,211666
13643,0.001547,74.125.68.0-255,5738,160734,92,211666
13644,0.001568,74.125.68.0-255,4320,165054,92,211666
13645,0.001599,74.125.68.0-255,1484,166538,92,211666
13646,0.001616,74.125.68.0-255,4320,170858,92,211666
13647,0.001626,74.125.68.0-255,2184,173042,92,211666
13648,0.001665,74.125.68.0-255,2902,175944,92,211666
13649,0.001676,74.125.68.0-255,4320,180264,92,211666
13650,0.001693,74.125.68.0-255,2902,183166,92,211666
13651,0.001705,74.125.68.0-255,3602,186768,92,211666
13652,0.001997,74.125.68.0-255,1484,188252,92,211666
13653,0.002011,74.125.68.0-255,2902,191154,92,211666
13654,0.002013,74.125.68.0-255,1484,192638,92,211666
13655,0.002037,74.125.68.0-255,2902,195540,92,211666
13656,0.003253,172.31.47.0-255,66,195606,92,211666
13657,0.005298,74.125.68.0-255,5738,201344,92,211666
13658,0.005305,172.31.47.0-255,66,201410,92,211666
13659,0.007344,74.125.68.0-255,4320,205730,92,211666
13660,0.00735,172.31.47.0-255,66,205796,92,211666
13661,0.007377,74.125.68.0-255,1484,207280,92,211666
13662,0.009397,74.125.68.0-255,4320,211600,92,211666
13663,0.009404,172.31.47.0-255,66,211666,92,211666
13664,0.0,74.125.24.0-255,153,153,92,111635
13665,2.3e-05,172.31.47.0-255,66,219,92,111635
13666,3e-05,74.125.24.0-255,1484,1703,92,111635
13667,3.5e-05,172.31.47.0-255,66,1769,92,111635
13668,4.1e-05,74.125.24.0-255,2902,4671,92,111635
13669,4.5e-05,172.31.47.0-255,66,4737,92,111635
13670,5.8e-05,74.125.24.0-255,5738,10475,92,111635
13671,6.2e-05,172.31.47.0-255,66,10541,92,111635
13672,9e-05,74.125.24.0-255,3481,14022,92,111635
13673,9.3e-05,172.31.47.0-255,66,14088,92,111635
13674,0.000122,74.125.24.0-255,4320,18408,92,111635
13675,0.000125,172.31.47.0-255,66,18474,92,111635
13676,0.000131,74.125.24.0-255,5738,24212,92,111635
13677,0.000133,172.31.47.0-255,66,24278,92,111635
13678,0.000175,74.125.24.0-255,5738,30016,92,111635
13679,0.000177,172.31.47.0-255,66,30082,92,111635
13680,0.000202,74.125.24.0-255,1125,31207,92,111635
13681,0.000204,172.31.47.0-255,66,31273,92,111635
13682,0.000282,74.125.24.0-255,1484,32757,92,111635
13683,0.000285,172.31.47.0-255,66,32823,92,111635
13684,0.000313,74.125.24.0-255,2902,35725,92,111635
13685,0.000316,172.31.47.0-255,66,35791,92,111635
13686,0.000322,74.125.24.0-255,5738,41529,92,111635
13687,0.000324,172.31.47.0-255,66,41595,92,111635
13688,0.000327,74.125.24.0-255,1484,43079,92,111635
13689,0.000333,172.31.47.0-255,66,43145,92,111635
13690,0.000366,74.125.24.0-255,4320,47465,92,111635
13691,0.000369,172.31.47.0-255,66,47531,92,111635
13692,0.000376,74.125.24.0-255,6797,54328,92,111635
13693,0.000378,172.31.47.0-255,66,54394,92,111635
13694,0.000393,172.31.47.0-255,66,54460,92,111635
13695,0.000414,74.125.24.0-255,677,55137,92,111635
13696,0.000971,74.125.24.0-255,1484,56621,92,111635
13697,0.000977,172.31.47.0-255,66,56687,92,111635
13698,0.000984,74.125.24.0-255,2902,59589,92,111635
13699,0.000986,172.31.47.0-255,66,59655,92,111635
13700,0.000997,74.125.24.0-255,5738,65393,92,111635
13701,0.000999,172.31.47.0-255,66,65459,92,111635
13702,0.001026,74.125.24.0-255,2902,68361,92,111635
13703,0.001029,172.31.47.0-255,66,68427,92,111635
13704,0.001063,172.31.47.0-255,66,68493,92,111635
13705,0.001074,172.31.47.0-255,66,68559,92,111635
13706,0.001077,74.125.24.0-255,766,69325,92,111635
13707,0.001523,172.31.47.0-255,66,69391,92,111635
13708,0.001741,74.125.24.0-255,1484,70875,92,111635
13709,0.001751,74.125.24.0-255,2902,73777,92,111635
13710,0.001755,172.31.47.0-255,66,73843,92,111635
13711,0.001791,74.125.24.0-255,4320,78163,92,111635
13712,0.001794,172.31.47.0-255,66,78229,92,111635
13713,0.001798,74.125.24.0-255,1484,79713,92,111635
13714,0.001831,74.125.24.0-255,7156,86869,92,111635
13715,0.001834,172.31.47.0-255,66,86935,92,111635
13716,0.001841,74.125.24.0-255,7156,94091,92,111635
13717,0.001843,172.31.47.0-255,66,94157,92,111635
13718,0.001883,172.31.47.0-255,66,94223,92,111635
13719,0.004393,74.125.24.0-255,5738,99961,92,111635
13720,0.0044,172.31.47.0-255,66,100027,92,111635
13721,0.006917,74.125.24.0-255,5738,105765,92,111635
13722,0.006921,172.31.47.0-255,66,105831,92,111635
13723,0.009379,74.125.24.0-255,5738,111569,92,111635
13724,0.009386,172.31.47.0-255,66,111635,92,111635
13725,0.0,172.31.47.0-255,105,105,92,276
13726,0.00174,157.240.13.0-255,105,210,92,276
13727,0.001748,172.31.47.0-255,66,276,92,276
13728,0.0,172.253.118.0-255,153,153,92,99026
13729,3e-05,172.31.47.0-255,66,219,92,99026
13730,3.7e-05,172.253.118.0-255,1484,1703,92,99026
13731,4.2e-05,172.31.47.0-255,66,1769,92,99026
13732,4.6e-05,172.253.118.0-255,2902,4671,92,99026
13733,4.8e-05,172.31.47.0-255,66,4737,92,99026
13734,6.2e-05,172.253.118.0-255,7156,11893,92,99026
13735,6.5e-05,172.31.47.0-255,66,11959,92,99026
13736,0.000102,172.253.118.0-255,2902,14861,92,99026
13737,0.000105,172.31.47.0-255,66,14927,92,99026
13738,0.00012,172.253.118.0-255,3553,18480,92,99026
13739,0.000123,172.31.47.0-255,66,18546,92,99026
13740,0.000135,172.253.118.0-255,7156,25702,92,99026
13741,0.000138,172.31.47.0-255,66,25768,92,99026
13742,0.000143,172.253.118.0-255,5379,31147,92,99026
13743,0.000146,172.31.47.0-255,66,31213,92,99026
13744,0.001258,172.253.118.0-255,1484,32697,92,99026
13745,0.001263,172.31.47.0-255,66,32763,92,99026
13746,0.001271,172.253.118.0-255,2902,35665,92,99026
13747,0.001272,172.31.47.0-255,66,35731,92,99026
13748,0.001299,172.253.118.0-255,5738,41469,92,99026
13749,0.001301,172.31.47.0-255,66,41535,92,99026
13750,0.001315,172.253.118.0-255,1484,43019,92,99026
13751,0.001317,172.31.47.0-255,66,43085,92,99026
13752,0.001356,172.31.47.0-255,66,43151,92,99026
13753,0.001378,172.253.118.0-255,2902,46053,92,99026
13754,0.001379,172.31.47.0-255,66,46119,92,99026
13755,0.001406,172.253.118.0-255,6797,52916,92,99026
13756,0.001408,172.31.47.0-255,66,52982,92,99026
13757,0.001537,172.253.118.0-255,1484,54466,92,99026
13758,0.001539,172.31.47.0-255,66,54532,92,99026
13759,0.001542,172.253.118.0-255,1484,56016,92,99026
13760,0.001543,172.31.47.0-255,66,56082,92,99026
13761,0.001569,172.253.118.0-255,1484,57566,92,99026
13762,0.001571,172.31.47.0-255,66,57632,92,99026
13763,0.001576,172.253.118.0-255,5738,63370,92,99026
13764,0.001578,172.31.47.0-255,66,63436,92,99026
13765,0.001607,172.253.118.0-255,4320,67756,92,99026
13766,0.001609,172.31.47.0-255,66,67822,92,99026
13767,0.001641,172.253.118.0-255,1484,69306,92,99026
13768,0.001654,172.253.118.0-255,1125,70431,92,99026
13769,0.001656,172.253.118.0-255,1484,71915,92,99026
13770,0.00167,172.253.118.0-255,1484,73399,92,99026
13771,0.001682,172.253.118.0-255,7156,80555,92,99026
13772,0.0017,172.253.118.0-255,6797,87352,92,99026
13773,0.004591,172.31.47.0-255,66,87418,92,99026
13774,0.007198,172.253.118.0-255,5738,93156,92,99026
13775,0.007205,172.31.47.0-255,66,93222,92,99026
13776,0.009817,172.253.118.0-255,5738,98960,92,99026
13777,0.009824,172.31.47.0-255,66,99026,92,99026
13778,0.0,172.217.194.0-255,153,153,92,126175
13779,1.6e-05,172.31.47.0-255,66,219,92,126175
13780,3.5e-05,172.217.194.0-255,1484,1703,92,126175
13781,4e-05,172.31.47.0-255,66,1769,92,126175
13782,4.5e-05,172.217.194.0-255,2902,4671,92,126175
13783,4.7e-05,172.31.47.0-255,66,4737,92,126175
13784,4.9e-05,172.217.194.0-255,1484,6221,92,126175
13785,5.1e-05,172.31.47.0-255,66,6287,92,126175
13786,8.7e-05,172.217.194.0-255,5738,12025,92,126175
13787,9e-05,172.31.47.0-255,66,12091,92,126175
13788,9.4e-05,172.217.194.0-255,2111,14202,92,126175
13789,9.6e-05,172.31.47.0-255,66,14268,92,126175
13790,0.00025,172.217.194.0-255,1484,15752,92,126175
13791,0.000257,172.31.47.0-255,66,15818,92,126175
13792,0.000263,172.217.194.0-255,2902,18720,92,126175
13793,0.000266,172.31.47.0-255,66,18786,92,126175
13794,0.00027,172.217.194.0-255,2902,21688,92,126175
13795,0.000273,172.31.47.0-255,66,21754,92,126175
13796,0.000296,172.217.194.0-255,7156,28910,92,126175
13797,0.000299,172.31.47.0-255,66,28976,92,126175
13798,0.00033,172.31.47.0-255,66,29042,92,126175
13799,0.000355,172.31.47.0-255,66,29108,92,126175
13800,0.000379,172.217.194.0-255,4320,33428,92,126175
13801,0.000381,172.31.47.0-255,66,33494,92,126175
13802,0.00041,172.31.47.0-255,66,33560,92,126175
13803,0.000424,172.217.194.0-255,2795,36355,92,126175
13804,0.000427,172.31.47.0-255,66,36421,92,126175
13805,0.00056,172.217.194.0-255,1484,37905,92,126175
13806,0.000566,172.31.47.0-255,66,37971,92,126175
13807,0.000573,172.217.194.0-255,2902,40873,92,126175
13808,0.00058,172.217.194.0-255,5738,46611,92,126175
13809,0.000602,172.31.47.0-255,66,46677,92,126175
13810,0.000626,172.31.47.0-255,66,46743,92,126175
13811,0.000639,172.217.194.0-255,7156,53899,92,126175
13812,0.000654,172.217.194.0-255,3602,57501,92,126175
13813,0.000687,172.31.47.0-255,66,57567,92,126175
13814,0.001206,172.217.194.0-255,1484,59051,92,126175
13815,0.001215,172.217.194.0-255,2902,61953,92,126175
13816,0.001219,172.31.47.0-255,66,62019,92,126175
13817,0.001242,172.217.194.0-255,5738,67757,92,126175
13818,0.001245,172.217.194.0-255,1484,69241,92,126175
13819,0.00126,172.217.194.0-255,1484,70725,92,126175
13820,0.001273,172.217.194.0-255,4320,75045,92,126175
13821,0.001275,172.31.47.0-255,66,75111,92,126175
13822,0.001289,172.217.194.0-255,7156,82267,92,126175
13823,0.001293,172.31.47.0-255,66,82333,92,126175
13824,0.001324,172.31.47.0-255,66,82399,92,126175
13825,0.001331,172.217.194.0-255,766,83165,92,126175
13826,0.001585,172.217.194.0-255,1484,84649,92,126175
13827,0.00159,172.31.47.0-255,66,84715,92,126175
13828,0.001595,172.217.194.0-255,2902,87617,92,126175
13829,0.001607,172.217.194.0-255,2902,90519,92,126175
13830,0.001622,172.217.194.0-255,2902,93421,92,126175
13831,0.001628,172.31.47.0-255,66,93487,92,126175
13832,0.001638,172.217.194.0-255,4320,97807,92,126175
13833,0.001642,172.31.47.0-255,66,97873,92,126175
13834,0.00166,172.217.194.0-255,5738,103611,92,126175
13835,0.001681,172.31.47.0-255,66,103677,92,126175
13836,0.001713,172.217.194.0-255,5020,108697,92,126175
13837,0.001724,172.31.47.0-255,66,108763,92,126175
13838,0.003796,172.217.194.0-255,5738,114501,92,126175
13839,0.003801,172.31.47.0-255,66,114567,92,126175
13840,0.005853,172.217.194.0-255,5738,120305,92,126175
13841,0.005859,172.31.47.0-255,66,120371,92,126175
13842,0.007985,172.217.194.0-255,5738,126109,92,126175
13843,0.007993,172.31.47.0-255,66,126175,92,126175
13844,0.0,172.217.194.0-255,153,153,92,265133
13845,2.4e-05,172.31.47.0-255,66,219,92,265133
13846,3.1e-05,172.217.194.0-255,1484,1703,92,265133
13847,3.5e-05,172.31.47.0-255,66,1769,92,265133
13848,5.8e-05,172.217.194.0-255,1484,3253,92,265133
13849,6e-05,172.31.47.0-255,66,3319,92,265133
13850,7.6e-05,172.217.194.0-255,1484,4803,92,265133
13851,7.8e-05,172.31.47.0-255,66,4869,92,265133
13852,8e-05,172.217.194.0-255,1484,6353,92,265133
13853,8.1e-05,172.31.47.0-255,66,6419,92,265133
13854,9.9e-05,172.217.194.0-255,4320,10739,92,265133
13855,0.000101,172.31.47.0-255,66,10805,92,265133
13856,0.000106,172.217.194.0-255,3508,14313,92,265133
13857,0.000108,172.31.47.0-255,66,14379,92,265133
13858,0.000134,172.31.47.0-255,66,14445,92,265133
13859,0.000154,172.217.194.0-255,5379,19824,92,265133
13860,0.000156,172.31.47.0-255,66,19890,92,265133
13861,0.000231,172.217.194.0-255,1484,21374,92,265133
13862,0.000233,172.31.47.0-255,66,21440,92,265133
13863,0.000236,172.217.194.0-255,1484,22924,92,265133
13864,0.000237,172.31.47.0-255,66,22990,92,265133
13865,0.000251,172.217.194.0-255,1484,24474,92,265133
13866,0.000252,172.31.47.0-255,66,24540,92,265133
13867,0.000257,172.217.194.0-255,2902,27442,92,265133
13868,0.00026,172.31.47.0-255,66,27508,92,265133
13869,0.000281,172.217.194.0-255,2902,30410,92,265133
13870,0.000284,172.31.47.0-255,66,30476,92,265133
13871,0.000297,172.217.194.0-255,4320,34796,92,265133
13872,0.000301,172.31.47.0-255,66,34862,92,265133
13873,0.000314,172.217.194.0-255,2543,37405,92,265133
13874,0.000317,172.31.47.0-255,66,37471,92,265133
13875,0.000335,172.217.194.0-255,4320,41791,92,265133
13876,0.000337,172.31.47.0-255,66,41857,92,265133
13877,0.000349,172.217.194.0-255,2902,44759,92,265133
13878,0.000351,172.31.47.0-255,66,44825,92,265133
13879,0.000358,172.217.194.0-255,7156,51981,92,265133
13880,0.000362,172.31.47.0-255,66,52047,92,265133
13881,0.000371,172.217.194.0-255,2543,54590,92,265133
13882,0.000373,172.31.47.0-255,66,54656,92,265133
13883,0.000618,172.217.194.0-255,645,55301,92,265133
13884,0.000721,172.217.194.0-255,1484,56785,92,265133
13885,0.000725,172.31.47.0-255,66,56851,92,265133
13886,0.000729,172.217.194.0-255,1484,58335,92,265133
13887,0.000743,172.217.194.0-255,1484,59819,92,265133
13888,0.000745,172.31.47.0-255,66,59885,92,265133
13889,0.000752,172.217.194.0-255,5738,65623,92,265133
13890,0.000755,172.31.47.0-255,66,65689,92,265133
13891,0.000762,172.217.194.0-255,6797,72486,92,265133
13892,0.000765,172.31.47.0-255,66,72552,92,265133
13893,0.000821,172.217.194.0-255,7156,79708,92,265133
13894,0.000825,172.31.47.0-255,66,79774,92,265133
13895,0.000842,172.217.194.0-255,7156,86930,92,265133
13896,0.000844,172.31.47.0-255,66,86996,92,265133
13897,0.000858,172.217.194.0-255,2543,89539,92,265133
13898,0.000861,172.31.47.0-255,66,89605,92,265133
13899,0.001643,172.217.194.0-255,1484,91089,92,265133
13900,0.001654,172.217.194.0-255,2902,93991,92,265133
13901,0.00166,172.31.47.0-255,66,94057,92,265133
13902,0.001668,172.217.194.0-255,5738,99795,92,265133
13903,0.00167,172.31.47.0-255,66,99861,92,265133
13904,0.001676,172.217.194.0-255,5738,105599,92,265133
13905,0.001678,172.31.47.0-255,66,105665,92,265133
13906,0.001695,172.217.194.0-255,2902,108567,92,265133
13907,0.001698,172.31.47.0-255,66,108633,92,265133
13908,0.001733,172.31.47.0-255,66,108699,92,265133
13909,0.00174,172.217.194.0-255,5020,113719,92,265133
13910,0.001741,172.31.47.0-255,66,113785,92,265133
13911,0.001906,172.217.194.0-255,1484,115269,92,265133
13912,0.001909,172.217.194.0-255,1484,116753,92,265133
13913,0.001911,172.31.47.0-255,66,116819,92,265133
13914,0.001929,172.217.194.0-255,1484,118303,92,265133
13915,0.001936,172.217.194.0-255,5738,124041,92,265133
13916,0.001938,172.31.47.0-255,66,124107,92,265133
13917,0.001954,172.217.194.0-255,4320,128427,92,265133
13918,0.001956,172.31.47.0-255,66,128493,92,265133
13919,0.001979,172.31.47.0-255,66,128559,92,265133
13920,0.001984,172.217.194.0-255,2902,131461,92,265133
13921,0.001986,172.31.47.0-255,66,131527,92,265133
13922,0.002012,172.31.47.0-255,66,131593,92,265133
13923,0.002132,172.217.194.0-255,1484,133077,92,265133
13924,0.002147,172.217.194.0-255,2902,135979,92,265133
13925,0.002149,172.31.47.0-255,66,136045,92,265133
13926,0.002154,172.217.194.0-255,4320,140365,92,265133
13927,0.002156,172.31.47.0-255,66,140431,92,265133
13928,0.002167,172.217.194.0-255,1484,141915,92,265133
13929,0.002175,172.217.194.0-255,7156,149071,92,265133
13930,0.002177,172.31.47.0-255,66,149137,92,265133
13931,0.002197,172.217.194.0-255,2902,152039,92,265133
13932,0.0022,172.31.47.0-255,66,152105,92,265133
13933,0.002239,172.217.194.0-255,4320,156425,92,265133
13934,0.002242,172.31.47.0-255,66,156491,92,265133
13935,0.002259,172.217.194.0-255,7156,163647,92,265133
13936,0.002262,172.31.47.0-255,66,163713,92,265133
13937,0.002285,172.217.194.0-255,2184,165897,92,265133
13938,0.002287,172.31.47.0-255,66,165963,92,265133
13939,0.00229,172.217.194.0-255,2902,168865,92,265133
13940,0.002293,172.31.47.0-255,66,168931,92,265133
13941,0.002297,172.217.194.0-255,4320,173251,92,265133
13942,0.002299,172.31.47.0-255,66,173317,92,265133
13943,0.002305,172.217.194.0-255,4320,177637,92,265133
13944,0.002307,172.31.47.0-255,66,177703,92,265133
13945,0.00232,172.217.194.0-255,4320,182023,92,265133
13946,0.002322,172.31.47.0-255,66,182089,92,265133
13947,0.00236,172.31.47.0-255,66,182155,92,265133
13948,0.0024,172.31.47.0-255,66,182221,92,265133
13949,0.002424,172.31.47.0-255,66,182287,92,265133
13950,0.002468,172.31.47.0-255,66,182353,92,265133
13951,0.002518,172.217.194.0-255,1484,183837,92,265133
13952,0.002522,172.217.194.0-255,2902,186739,92,265133
13953,0.002524,172.31.47.0-255,66,186805,92,265133
13954,0.002527,172.217.194.0-255,1484,188289,92,265133
13955,0.002534,172.217.194.0-255,7156,195445,92,265133
13956,0.002536,172.31.47.0-255,66,195511,92,265133
13957,0.002547,172.217.194.0-255,1484,196995,92,265133
13958,0.002552,172.217.194.0-255,4320,201315,92,265133
13959,0.002554,172.31.47.0-255,66,201381,92,265133
13960,0.002557,172.217.194.0-255,1484,202865,92,265133
13961,0.002586,172.217.194.0-255,4320,207185,92,265133
13962,0.002588,172.31.47.0-255,66,207251,92,265133
13963,0.002609,172.31.47.0-255,66,207317,92,265133
13964,0.002659,172.217.194.0-255,1484,208801,92,265133
13965,0.002676,172.217.194.0-255,2902,211703,92,265133
13966,0.002678,172.31.47.0-255,66,211769,92,265133
13967,0.002682,172.217.194.0-255,2902,214671,92,265133
13968,0.002683,172.31.47.0-255,66,214737,92,265133
13969,0.002699,172.217.194.0-255,2902,217639,92,265133
13970,0.002701,172.31.47.0-255,66,217705,92,265133
13971,0.002705,172.217.194.0-255,5738,223443,92,265133
13972,0.002707,172.31.47.0-255,66,223509,92,265133
13973,0.002721,172.217.194.0-255,4320,227829,92,265133
13974,0.00274,172.217.194.0-255,5020,232849,92,265133
13975,0.002781,172.217.194.0-255,2902,235751,92,265133
13976,0.002792,172.217.194.0-255,2902,238653,92,265133
13977,0.002801,172.217.194.0-255,1484,240137,92,265133
13978,0.002816,172.217.194.0-255,5738,245875,92,265133
13979,0.002852,172.217.194.0-255,4320,250195,92,265133
13980,0.002881,172.217.194.0-255,1484,251679,92,265133
13981,0.002887,172.217.194.0-255,5020,256699,92,265133
13982,0.00289,172.217.194.0-255,2902,259601,92,265133
13983,0.00291,172.217.194.0-255,2902,262503,92,265133
13984,0.003008,172.217.194.0-255,2354,264857,92,265133
13985,0.003061,172.217.194.0-255,105,264962,92,265133
13986,0.00571,172.31.47.0-255,66,265028,92,265133
13987,0.008123,172.31.47.0-255,105,265133,92,265133
13988,0.0,172.217.194.0-255,153,153,92,202752
13989,3.4e-05,172.31.47.0-255,66,219,92,202752
13990,4e-05,172.217.194.0-255,1484,1703,92,202752
13991,4.5e-05,172.31.47.0-255,66,1769,92,202752
13992,5e-05,172.217.194.0-255,2902,4671,92,202752
13993,5.2e-05,172.31.47.0-255,66,4737,92,202752
13994,5.9e-05,172.217.194.0-255,7156,11893,92,202752
13995,6.2e-05,172.31.47.0-255,66,11959,92,202752
13996,6.9e-05,172.217.194.0-255,7156,19115,92,202752
13997,7.1e-05,172.31.47.0-255,66,19181,92,202752
13998,0.0001,172.217.194.0-255,2128,21309,92,202752
13999,0.000105,172.31.47.0-255,66,21375,92,202752
14000,0.000117,172.31.47.0-255,66,21441,92,202752
14001,0.000153,172.217.194.0-255,1484,22925,92,202752
14002,0.000156,172.31.47.0-255,66,22991,92,202752
14003,0.000175,172.217.194.0-255,2902,25893,92,202752
14004,0.000177,172.31.47.0-255,66,25959,92,202752
14005,0.000203,172.217.194.0-255,5738,31697,92,202752
14006,0.000206,172.31.47.0-255,66,31763,92,202752
14007,0.000232,172.31.47.0-255,66,31829,92,202752
14008,0.000258,172.217.194.0-255,2543,34372,92,202752
14009,0.00026,172.31.47.0-255,66,34438,92,202752
14010,0.000271,172.31.47.0-255,66,34504,92,202752
14011,0.000274,172.217.194.0-255,376,34880,92,202752
14012,0.000275,172.31.47.0-255,66,34946,92,202752
14013,0.000301,172.217.194.0-255,367,35313,92,202752
14014,0.000304,172.31.47.0-255,66,35379,92,202752
14015,0.000439,172.217.194.0-255,1484,36863,92,202752
14016,0.000443,172.31.47.0-255,66,36929,92,202752
14017,0.000448,172.217.194.0-255,2902,39831,92,202752
14018,0.00045,172.31.47.0-255,66,39897,92,202752
14019,0.000457,172.217.194.0-255,5738,45635,92,202752
14020,0.000459,172.31.47.0-255,66,45701,92,202752
14021,0.000496,172.31.47.0-255,66,45767,92,202752
14022,0.000507,172.31.47.0-255,66,45833,92,202752
14023,0.000528,172.217.194.0-255,1635,47468,92,202752
14024,0.000533,172.31.47.0-255,66,47534,92,202752
14025,0.000563,172.217.194.0-255,1484,49018,92,202752
14026,0.000569,172.217.194.0-255,2902,51920,92,202752
14027,0.000572,172.31.47.0-255,66,51986,92,202752
14028,0.000595,172.217.194.0-255,5738,57724,92,202752
14029,0.000598,172.31.47.0-255,66,57790,92,202752
14030,0.000603,172.217.194.0-255,4320,62110,92,202752
14031,0.000605,172.31.47.0-255,66,62176,92,202752
14032,0.000652,172.217.194.0-255,2543,64719,92,202752
14033,0.000656,172.31.47.0-255,66,64785,92,202752
14034,0.0007,172.217.194.0-255,1484,66269,92,202752
14035,0.000705,172.217.194.0-255,2902,69171,92,202752
14036,0.000707,172.31.47.0-255,66,69237,92,202752
14037,0.000722,172.217.194.0-255,5738,74975,92,202752
14038,0.000724,172.31.47.0-255,66,75041,92,202752
14039,0.000768,172.31.47.0-255,66,75107,92,202752
14040,0.00078,172.31.47.0-255,66,75173,92,202752
14041,0.000805,172.217.194.0-255,2902,78075,92,202752
14042,0.000808,172.31.47.0-255,66,78141,92,202752
14043,0.000829,172.217.194.0-255,7156,85297,92,202752
14044,0.000832,172.31.47.0-255,66,85363,92,202752
14045,0.000845,172.31.47.0-255,66,85429,92,202752
14046,0.000848,172.217.194.0-255,1484,86913,92,202752
14047,0.000881,172.31.47.0-255,66,86979,92,202752
14048,0.000893,172.217.194.0-255,766,87745,92,202752
14049,0.000905,172.31.47.0-255,66,87811,92,202752
14050,0.000932,172.217.194.0-255,2902,90713,92,202752
14051,0.000935,172.31.47.0-255,66,90779,92,202752
14052,0.000947,172.31.47.0-255,66,90845,92,202752
14053,0.000963,172.217.194.0-255,7156,98001,92,202752
14054,0.000966,172.31.47.0-255,66,98067,92,202752
14055,0.000986,172.217.194.0-255,2184,100251,92,202752
14056,0.000989,172.31.47.0-255,66,100317,92,202752
14057,0.000998,172.31.47.0-255,66,100383,92,202752
14058,0.001018,172.217.194.0-255,1484,101867,92,202752
14059,0.001029,172.31.47.0-255,66,101933,92,202752
14060,0.001046,172.217.194.0-255,4320,106253,92,202752
14061,0.001049,172.31.47.0-255,66,106319,92,202752
14062,0.001066,172.217.194.0-255,5738,112057,92,202752
14063,0.001071,172.31.47.0-255,66,112123,92,202752
14064,0.001084,172.217.194.0-255,5020,117143,92,202752
14065,0.001086,172.31.47.0-255,66,117209,92,202752
14066,0.001438,172.217.194.0-255,1484,118693,92,202752
14067,0.001444,172.217.194.0-255,2902,121595,92,202752
14068,0.001448,172.31.47.0-255,66,121661,92,202752
14069,0.001449,172.217.194.0-255,5738,127399,92,202752
14070,0.001451,172.31.47.0-255,66,127465,92,202752
14071,0.001481,172.31.47.0-255,66,127531,92,202752
14072,0.00152,172.217.194.0-255,4320,131851,92,202752
14073,0.001523,172.31.47.0-255,66,131917,92,202752
14074,0.001552,172.31.47.0-255,66,131983,92,202752
14075,0.001568,172.217.194.0-255,1484,133467,92,202752
14076,0.001572,172.217.194.0-255,2902,136369,92,202752
14077,0.001575,172.31.47.0-255,66,136435,92,202752
14078,0.001599,172.217.194.0-255,5738,142173,92,202752
14079,0.001602,172.31.47.0-255,66,142239,92,202752
14080,0.001615,172.31.47.0-255,66,142305,92,202752
14081,0.001658,172.217.194.0-255,5738,148043,92,202752
14082,0.001661,172.31.47.0-255,66,148109,92,202752
14083,0.001684,172.217.194.0-255,4320,152429,92,202752
14084,0.001687,172.31.47.0-255,66,152495,92,202752
14085,0.00169,172.217.194.0-255,766,153261,92,202752
14086,0.001692,172.217.194.0-255,1484,154745,92,202752
14087,0.001694,172.31.47.0-255,66,154811,92,202752
14088,0.001698,172.217.194.0-255,4320,159131,92,202752
14089,0.0017,172.31.47.0-255,66,159197,92,202752
14090,0.001704,172.217.194.0-255,2902,162099,92,202752
14091,0.001707,172.31.47.0-255,66,162165,92,202752
14092,0.00177,172.217.194.0-255,7156,169321,92,202752
14093,0.001774,172.31.47.0-255,66,169387,92,202752
14094,0.001789,172.31.47.0-255,66,169453,92,202752
14095,0.001792,172.217.194.0-255,6438,175891,92,202752
14096,0.001794,172.31.47.0-255,66,175957,92,202752
14097,0.001795,172.217.194.0-255,2902,178859,92,202752
14098,0.001797,172.31.47.0-255,66,178925,92,202752
14099,0.00182,172.217.194.0-255,4320,183245,92,202752
14100,0.001823,172.31.47.0-255,66,183311,92,202752
14101,0.001836,172.31.47.0-255,66,183377,92,202752
14102,0.001859,172.217.194.0-255,4320,187697,92,202752
14103,0.001862,172.31.47.0-255,66,187763,92,202752
14104,0.001864,172.217.194.0-255,1484,189247,92,202752
14105,0.001868,172.217.194.0-255,1484,190731,92,202752
14106,0.001869,172.31.47.0-255,66,190797,92,202752
14107,0.001885,172.217.194.0-255,5738,196535,92,202752
14108,0.001891,172.31.47.0-255,66,196601,92,202752
14109,0.001923,172.31.47.0-255,66,196667,92,202752
14110,0.001926,172.217.194.0-255,1484,198151,92,202752
14111,0.001945,172.31.47.0-255,66,198217,92,202752
14112,0.001949,172.217.194.0-255,4193,202410,92,202752
14113,0.001953,172.31.47.0-255,66,202476,92,202752
14114,0.001976,172.217.194.0-255,105,202581,92,202752
14115,0.007551,172.31.47.0-255,66,202647,92,202752
14116,0.007576,172.31.47.0-255,105,202752,92,202752
14117,0.0,74.125.130.0-255,297,297,92,192480
14118,2.2e-05,172.31.47.0-255,66,363,92,192480
14119,2.8e-05,74.125.130.0-255,1484,1847,92,192480
14120,3.1e-05,172.31.47.0-255,66,1913,92,192480
14121,3.6e-05,74.125.130.0-255,2902,4815,92,192480
14122,3.8e-05,172.31.47.0-255,66,4881,92,192480
14123,6.1e-05,74.125.130.0-255,2902,7783,92,192480
14124,6.4e-05,172.31.47.0-255,66,7849,92,192480
14125,8.6e-05,74.125.130.0-255,1484,9333,92,192480
14126,8.8e-05,172.31.47.0-255,66,9399,92,192480
14127,9.5e-05,74.125.130.0-255,2902,12301,92,192480
14128,9.7e-05,172.31.47.0-255,66,12367,92,192480
14129,0.00012,74.125.130.0-255,3283,15650,92,192480
14130,0.000122,172.31.47.0-255,66,15716,92,192480
14131,0.00015,172.31.47.0-255,66,15782,92,192480
14132,0.000186,74.125.130.0-255,5738,21520,92,192480
14133,0.000188,172.31.47.0-255,66,21586,92,192480
14134,0.000212,74.125.130.0-255,1125,22711,92,192480
14135,0.000214,172.31.47.0-255,66,22777,92,192480
14136,0.000309,74.125.130.0-255,1484,24261,92,192480
14137,0.000312,172.31.47.0-255,66,24327,92,192480
14138,0.000316,74.125.130.0-255,2902,27229,92,192480
14139,0.000319,172.31.47.0-255,66,27295,92,192480
14140,0.000321,74.125.130.0-255,1484,28779,92,192480
14141,0.000323,172.31.47.0-255,66,28845,92,192480
14142,0.000361,74.125.130.0-255,5738,34583,92,192480
14143,0.000364,172.31.47.0-255,66,34649,92,192480
14144,0.000388,74.125.130.0-255,5379,40028,92,192480
14145,0.00039,172.31.47.0-255,66,40094,92,192480
14146,0.00042,74.125.130.0-255,5738,45832,92,192480
14147,0.000423,172.31.47.0-255,66,45898,92,192480
14148,0.000425,74.125.130.0-255,1484,47382,92,192480
14149,0.00045,74.125.130.0-255,4320,51702,92,192480
14150,0.000452,172.31.47.0-255,66,51768,92,192480
14151,0.000503,74.125.130.0-255,5669,57437,92,192480
14152,0.000506,172.31.47.0-255,66,57503,92,192480
14153,0.00056,74.125.130.0-255,365,57868,92,192480
14154,0.000762,74.125.130.0-255,1484,59352,92,192480
14155,0.000767,172.31.47.0-255,66,59418,92,192480
14156,0.000772,74.125.130.0-255,1484,60902,92,192480
14157,0.000796,74.125.130.0-255,1484,62386,92,192480
14158,0.000799,74.125.130.0-255,1484,63870,92,192480
14159,0.000805,172.31.47.0-255,66,63936,92,192480
14160,0.000829,74.125.130.0-255,2902,66838,92,192480
14161,0.000832,172.31.47.0-255,66,66904,92,192480
14162,0.000835,74.125.130.0-255,1484,68388,92,192480
14163,0.000859,74.125.130.0-255,2902,71290,92,192480
14164,0.000862,172.31.47.0-255,66,71356,92,192480
14165,0.000887,74.125.130.0-255,5738,77094,92,192480
14166,0.00089,172.31.47.0-255,66,77160,92,192480
14167,0.000892,74.125.130.0-255,1484,78644,92,192480
14168,0.000938,172.31.47.0-255,66,78710,92,192480
14169,0.000942,74.125.130.0-255,2902,81612,92,192480
14170,0.000944,172.31.47.0-255,66,81678,92,192480
14171,0.000991,74.125.130.0-255,2184,83862,92,192480
14172,0.000995,172.31.47.0-255,66,83928,92,192480
14173,0.001136,74.125.130.0-255,1484,85412,92,192480
14174,0.001155,74.125.130.0-255,2902,88314,92,192480
14175,0.001159,172.31.47.0-255,66,88380,92,192480
14176,0.001188,74.125.130.0-255,5738,94118,92,192480
14177,0.001191,172.31.47.0-255,66,94184,92,192480
14178,0.001196,74.125.130.0-255,2902,97086,92,192480
14179,0.001199,172.31.47.0-255,66,97152,92,192480
14180,0.001203,74.125.130.0-255,2902,100054,92,192480
14181,0.00121,172.31.47.0-255,66,100120,92,192480
14182,0.00124,74.125.130.0-255,1484,101604,92,192480
14183,0.001252,172.31.47.0-255,66,101670,92,192480
14184,0.001263,172.31.47.0-255,66,101736,92,192480
14185,0.001295,74.125.130.0-255,4320,106056,92,192480
14186,0.001298,172.31.47.0-255,66,106122,92,192480
14187,0.001318,74.125.130.0-255,2902,109024,92,192480
14188,0.001321,172.31.47.0-255,66,109090,92,192480
14189,0.00133,172.31.47.0-255,66,109156,92,192480
14190,0.00138,172.31.47.0-255,66,109222,92,192480
14191,0.001405,74.125.130.0-255,5020,114242,92,192480
14192,0.001409,172.31.47.0-255,66,114308,92,192480
14193,0.00146,74.125.130.0-255,1484,115792,92,192480
14194,0.001474,74.125.130.0-255,2902,118694,92,192480
14195,0.001479,172.31.47.0-255,66,118760,92,192480
14196,0.001499,74.125.130.0-255,5738,124498,92,192480
14197,0.001501,172.31.47.0-255,66,124564,92,192480
14198,0.001504,74.125.130.0-255,2902,127466,92,192480
14199,0.001507,172.31.47.0-255,66,127532,92,192480
14200,0.001531,74.125.130.0-255,4320,131852,92,192480
14201,0.001536,172.31.47.0-255,66,131918,92,192480
14202,0.001542,74.125.130.0-255,5738,137656,92,192480
14203,0.001543,172.31.47.0-255,66,137722,92,192480
14204,0.001566,74.125.130.0-255,2902,140624,92,192480
14205,0.001568,172.31.47.0-255,66,140690,92,192480
14206,0.001572,74.125.130.0-255,4320,145010,92,192480
14207,0.001574,172.31.47.0-255,66,145076,92,192480
14208,0.001609,74.125.130.0-255,3602,148678,92,192480
14209,0.001612,172.31.47.0-255,66,148744,92,192480
14210,0.00196,74.125.130.0-255,1484,150228,92,192480
14211,0.001964,74.125.130.0-255,1484,151712,92,192480
14212,0.001966,172.31.47.0-255,66,151778,92,192480
14213,0.001988,74.125.130.0-255,1484,153262,92,192480
14214,0.001993,74.125.130.0-255,4320,157582,92,192480
14215,0.001994,172.31.47.0-255,66,157648,92,192480
14216,0.002016,74.125.130.0-255,1484,159132,92,192480
14217,0.002021,74.125.130.0-255,5738,164870,92,192480
14218,0.002023,172.31.47.0-255,66,164936,92,192480
14219,0.002047,74.125.130.0-255,1484,166420,92,192480
14220,0.002056,172.31.47.0-255,66,166486,92,192480
14221,0.002058,74.125.130.0-255,1484,167970,92,192480
14222,0.002077,74.125.130.0-255,2902,170872,92,192480
14223,0.002079,172.31.47.0-255,66,170938,92,192480
14224,0.00211,74.125.130.0-255,3602,174540,92,192480
14225,0.002112,172.31.47.0-255,66,174606,92,192480
14226,0.002557,74.125.130.0-255,1484,176090,92,192480
14227,0.002583,74.125.130.0-255,1484,177574,92,192480
14228,0.002586,172.31.47.0-255,66,177640,92,192480
14229,0.004676,74.125.130.0-255,2902,180542,92,192480
14230,0.004681,172.31.47.0-255,66,180608,92,192480
14231,0.005146,74.125.130.0-255,2902,183510,92,192480
14232,0.005148,172.31.47.0-255,66,183576,92,192480
14233,0.007244,74.125.130.0-255,2902,186478,92,192480
14234,0.007255,172.31.47.0-255,66,186544,92,192480
14235,0.007712,74.125.130.0-255,2902,189446,92,192480
14236,0.007719,172.31.47.0-255,66,189512,92,192480
14237,0.00981,74.125.130.0-255,2902,192414,92,192480
14238,0.009817,172.31.47.0-255,66,192480,92,192480
14239,0.0,172.217.194.0-255,153,153,92,154940
14240,3e-05,172.31.47.0-255,66,219,92,154940
14241,3.7e-05,172.217.194.0-255,1484,1703,92,154940
14242,4.1e-05,172.31.47.0-255,66,1769,92,154940
14243,4.6e-05,172.217.194.0-255,2902,4671,92,154940
14244,4.8e-05,172.31.47.0-255,66,4737,92,154940
14245,7e-05,172.217.194.0-255,1484,6221,92,154940
14246,7.2e-05,172.31.47.0-255,66,6287,92,154940
14247,9.3e-05,172.217.194.0-255,5738,12025,92,154940
14248,9.5e-05,172.31.47.0-255,66,12091,92,154940
14249,9.9e-05,172.217.194.0-255,1949,14040,92,154940
14250,0.0001,172.31.47.0-255,66,14106,92,154940
14251,0.000137,172.31.47.0-255,66,14172,92,154940
14252,0.000143,172.217.194.0-255,5379,19551,92,154940
14253,0.000145,172.31.47.0-255,66,19617,92,154940
14254,0.000233,172.217.194.0-255,1484,21101,92,154940
14255,0.000236,172.31.47.0-255,66,21167,92,154940
14256,0.000239,172.217.194.0-255,1484,22651,92,154940
14257,0.000241,172.31.47.0-255,66,22717,92,154940
14258,0.000255,172.217.194.0-255,2902,25619,92,154940
14259,0.000262,172.31.47.0-255,66,25685,92,154940
14260,0.000266,172.217.194.0-255,1484,27169,92,154940
14261,0.000269,172.31.47.0-255,66,27235,92,154940
14262,0.00029,172.217.194.0-255,4320,31555,92,154940
14263,0.000293,172.31.47.0-255,66,31621,92,154940
14264,0.000329,172.217.194.0-255,1484,33105,92,154940
14265,0.000332,172.31.47.0-255,66,33171,92,154940
14266,0.000354,172.217.194.0-255,5379,38550,92,154940
14267,0.000357,172.31.47.0-255,66,38616,92,154940
14268,0.000364,172.217.194.0-255,7156,45772,92,154940
14269,0.000366,172.31.47.0-255,66,45838,92,154940
14270,0.000376,172.31.47.0-255,66,45904,92,154940
14271,0.000378,172.217.194.0-255,398,46302,92,154940
14272,0.000659,172.217.194.0-255,1484,47786,92,154940
14273,0.000663,172.31.47.0-255,66,47852,92,154940
14274,0.000668,172.217.194.0-255,2902,50754,92,154940
14275,0.00067,172.31.47.0-255,66,50820,92,154940
14276,0.000689,172.217.194.0-255,5738,56558,92,154940
14277,0.000692,172.31.47.0-255,66,56624,92,154940
14278,0.000698,172.217.194.0-255,5738,62362,92,154940
14279,0.0007,172.31.47.0-255,66,62428,92,154940
14280,0.000738,172.31.47.0-255,66,62494,92,154940
14281,0.000743,172.217.194.0-255,4320,66814,92,154940
14282,0.000745,172.31.47.0-255,66,66880,92,154940
14283,0.000757,172.217.194.0-255,766,67646,92,154940
14284,0.000911,172.31.47.0-255,66,67712,92,154940
14285,0.001032,172.217.194.0-255,1484,69196,92,154940
14286,0.00104,172.217.194.0-255,2902,72098,92,154940
14287,0.001043,172.31.47.0-255,66,72164,92,154940
14288,0.00105,172.217.194.0-255,5738,77902,92,154940
14289,0.001052,172.31.47.0-255,66,77968,92,154940
14290,0.001069,172.217.194.0-255,4320,82288,92,154940
14291,0.001072,172.31.47.0-255,66,82354,92,154940
14292,0.001092,172.31.47.0-255,66,82420,92,154940
14293,0.001096,172.217.194.0-255,1484,83904,92,154940
14294,0.001123,172.31.47.0-255,66,83970,92,154940
14295,0.001155,172.31.47.0-255,66,84036,92,154940
14296,0.001167,172.31.47.0-255,66,84102,92,154940
14297,0.001227,172.217.194.0-255,2902,87004,92,154940
14298,0.001231,172.31.47.0-255,66,87070,92,154940
14299,0.001263,172.31.47.0-255,66,87136,92,154940
14300,0.001277,172.31.47.0-255,66,87202,92,154940
14301,0.00129,172.31.47.0-255,66,87268,92,154940
14302,0.001321,172.217.194.0-255,6438,93706,92,154940
14303,0.001324,172.31.47.0-255,66,93772,92,154940
14304,0.001364,172.217.194.0-255,1484,95256,92,154940
14305,0.001379,172.217.194.0-255,2902,98158,92,154940
14306,0.001383,172.31.47.0-255,66,98224,92,154940
14307,0.001386,172.217.194.0-255,1484,99708,92,154940
14308,0.001407,172.217.194.0-255,4320,104028,92,154940
14309,0.001411,172.31.47.0-255,66,104094,92,154940
14310,0.001418,172.217.194.0-255,7156,111250,92,154940
14311,0.00142,172.31.47.0-255,66,111316,92,154940
14312,0.001446,172.217.194.0-255,5738,117054,92,154940
14313,0.001449,172.31.47.0-255,66,117120,92,154940
14314,0.001461,172.31.47.0-255,66,117186,92,154940
14315,0.001526,172.31.47.0-255,66,117252,92,154940
14316,0.001543,172.31.47.0-255,66,117318,92,154940
14317,0.001562,172.31.47.0-255,66,117384,92,154940
14318,0.00161,172.31.47.0-255,66,117450,92,154940
14319,0.001626,172.31.47.0-255,66,117516,92,154940
14320,0.001628,172.217.194.0-255,766,118282,92,154940
14321,0.001661,172.217.194.0-255,1484,119766,92,154940
14322,0.001665,172.31.47.0-255,66,119832,92,154940
14323,0.00167,172.217.194.0-255,4320,124152,92,154940
14324,0.001673,172.31.47.0-255,66,124218,92,154940
14325,0.001677,172.217.194.0-255,2902,127120,92,154940
14326,0.001679,172.31.47.0-255,66,127186,92,154940
14327,0.001695,172.217.194.0-255,4320,131506,92,154940
14328,0.001698,172.31.47.0-255,66,131572,92,154940
14329,0.001707,172.31.47.0-255,66,131638,92,154940
14330,0.001753,172.31.47.0-255,66,131704,92,154940
14331,0.001791,172.217.194.0-255,7156,138860,92,154940
14332,0.001794,172.31.47.0-255,66,138926,92,154940
14333,0.001803,172.31.47.0-255,66,138992,92,154940
14334,0.001824,172.217.194.0-255,1484,140476,92,154940
14335,0.001856,172.31.47.0-255,66,140542,92,154940
14336,0.001859,172.217.194.0-255,766,141308,92,154940
14337,0.00189,172.217.194.0-255,5738,147046,92,154940
14338,0.001894,172.31.47.0-255,66,147112,92,154940
14339,0.001914,172.217.194.0-255,5738,152850,92,154940
14340,0.001917,172.31.47.0-255,66,152916,92,154940
14341,0.001928,172.31.47.0-255,66,152982,92,154940
14342,0.001931,172.217.194.0-255,1484,154466,92,154940
14343,0.001964,172.31.47.0-255,66,154532,92,154940
14344,0.001975,172.31.47.0-255,66,154598,92,154940
14345,0.002008,172.31.47.0-255,66,154664,92,154940
14346,0.002055,172.217.194.0-255,105,154769,92,154940
14347,0.008572,172.31.47.0-255,66,154835,92,154940
14348,0.008594,172.31.47.0-255,105,154940,92,154940
14349,0.0,172.31.47.0-255,66,66,92,66
14350,0.0,172.217.27.0-255,298,298,92,179906
14351,1.6e-05,172.31.47.0-255,66,364,92,179906
14352,2.1e-05,172.217.27.0-255,1484,1848,92,179906
14353,2.5e-05,172.31.47.0-255,66,1914,92,179906
14354,2.8e-05,172.217.27.0-255,1484,3398,92,179906
14355,3e-05,172.31.47.0-255,66,3464,92,179906
14356,5.4e-05,172.217.27.0-255,1484,4948,92,179906
14357,5.7e-05,172.31.47.0-255,66,5014,92,179906
14358,6.4e-05,172.217.27.0-255,5738,10752,92,179906
14359,6.6e-05,172.31.47.0-255,66,10818,92,179906
14360,0.0001,172.31.47.0-255,66,10884,92,179906
14361,0.000105,172.217.27.0-255,4320,15204,92,179906
14362,0.000107,172.31.47.0-255,66,15270,92,179906
14363,0.000128,172.217.27.0-255,5738,21008,92,179906
14364,0.00013,172.31.47.0-255,66,21074,92,179906
14365,0.000133,172.217.27.0-255,1125,22199,92,179906
14366,0.000135,172.31.47.0-255,66,22265,92,179906
14367,0.000236,172.217.27.0-255,1484,23749,92,179906
14368,0.000241,172.31.47.0-255,66,23815,92,179906
14369,0.000245,172.217.27.0-255,2902,26717,92,179906
14370,0.000247,172.31.47.0-255,66,26783,92,179906
14371,0.000255,172.217.27.0-255,4320,31103,92,179906
14372,0.000257,172.31.47.0-255,66,31169,92,179906
14373,0.00027,172.217.27.0-255,1484,32653,92,179906
14374,0.000272,172.31.47.0-255,66,32719,92,179906
14375,0.000289,172.217.27.0-255,4320,37039,92,179906
14376,0.000292,172.31.47.0-255,66,37105,92,179906
14377,0.000321,172.217.27.0-255,6797,43902,92,179906
14378,0.000324,172.31.47.0-255,66,43968,92,179906
14379,0.000336,172.31.47.0-255,66,44034,92,179906
14380,0.000338,172.217.27.0-255,1395,45429,92,179906
14381,0.000564,172.217.27.0-255,385,45814,92,179906
14382,0.000569,172.31.47.0-255,66,45880,92,179906
14383,0.000767,172.217.27.0-255,1484,47364,92,179906
14384,0.000774,172.217.27.0-255,2902,50266,92,179906
14385,0.000777,172.31.47.0-255,66,50332,92,179906
14386,0.000784,172.217.27.0-255,5738,56070,92,179906
14387,0.000786,172.31.47.0-255,66,56136,92,179906
14388,0.000809,172.217.27.0-255,2902,59038,92,179906
14389,0.000812,172.31.47.0-255,66,59104,92,179906
14390,0.000843,172.31.47.0-255,66,59170,92,179906
14391,0.000865,172.217.27.0-255,7156,66326,92,179906
14392,0.000868,172.31.47.0-255,66,66392,92,179906
14393,0.000893,172.217.27.0-255,3961,70353,92,179906
14394,0.000896,172.217.27.0-255,1484,71837,92,179906
14395,0.000899,172.217.27.0-255,2902,74739,92,179906
14396,0.000904,172.31.47.0-255,66,74805,92,179906
14397,0.000911,172.31.47.0-255,66,74871,92,179906
14398,0.000916,172.217.27.0-255,4320,79191,92,179906
14399,0.000918,172.31.47.0-255,66,79257,92,179906
14400,0.000934,172.217.27.0-255,1484,80741,92,179906
14401,0.00094,172.217.27.0-255,5738,86479,92,179906
14402,0.000943,172.31.47.0-255,66,86545,92,179906
14403,0.000948,172.217.27.0-255,5738,92283,92,179906
14404,0.00095,172.31.47.0-255,66,92349,92,179906
14405,0.000969,172.217.27.0-255,1484,93833,92,179906
14406,0.000983,172.217.27.0-255,1484,95317,92,179906
14407,0.000987,172.31.47.0-255,66,95383,92,179906
14408,0.000999,172.217.27.0-255,5738,101121,92,179906
14409,0.001002,172.31.47.0-255,66,101187,92,179906
14410,0.001017,172.217.27.0-255,3053,104240,92,179906
14411,0.00102,172.31.47.0-255,66,104306,92,179906
14412,0.001061,172.217.27.0-255,1484,105790,92,179906
14413,0.001079,172.217.27.0-255,2902,108692,92,179906
14414,0.001083,172.31.47.0-255,66,108758,92,179906
14415,0.001086,172.217.27.0-255,1484,110242,92,179906
14416,0.001106,172.217.27.0-255,4320,114562,92,179906
14417,0.00111,172.31.47.0-255,66,114628,92,179906
14418,0.001118,172.217.27.0-255,7156,121784,92,179906
14419,0.00112,172.31.47.0-255,66,121850,92,179906
14420,0.001184,172.31.47.0-255,66,121916,92,179906
14421,0.001198,172.217.27.0-255,2902,124818,92,179906
14422,0.001201,172.31.47.0-255,66,124884,92,179906
14423,0.001205,172.217.27.0-255,2184,127068,92,179906
14424,0.001207,172.31.47.0-255,66,127134,92,179906
14425,0.001468,172.217.27.0-255,1484,128618,92,179906
14426,0.001474,172.217.27.0-255,2902,131520,92,179906
14427,0.001478,172.31.47.0-255,66,131586,92,179906
14428,0.00151,172.217.27.0-255,4320,135906,92,179906
14429,0.001513,172.31.47.0-255,66,135972,92,179906
14430,0.001527,172.217.27.0-255,1484,137456,92,179906
14431,0.001543,172.217.27.0-255,4320,141776,92,179906
14432,0.001546,172.31.47.0-255,66,141842,92,179906
14433,0.00157,172.217.27.0-255,2902,144744,92,179906
14434,0.001573,172.31.47.0-255,66,144810,92,179906
14435,0.001586,172.31.47.0-255,66,144876,92,179906
14436,0.001589,172.217.27.0-255,2184,147060,92,179906
14437,0.001592,172.31.47.0-255,66,147126,92,179906
14438,0.001663,172.217.27.0-255,1484,148610,92,179906
14439,0.001666,172.217.27.0-255,1484,150094,92,179906
14440,0.001669,172.31.47.0-255,66,150160,92,179906
14441,0.003224,172.217.27.0-255,2902,153062,92,179906
14442,0.00323,172.31.47.0-255,66,153128,92,179906
14443,0.003297,172.217.27.0-255,1484,154612,92,179906
14444,0.003309,172.217.27.0-255,1484,156096,92,179906
14445,0.003311,172.31.47.0-255,66,156162,92,179906
14446,0.004865,172.217.27.0-255,2902,159064,92,179906
14447,0.004868,172.31.47.0-255,66,159130,92,179906
14448,0.004936,172.217.27.0-255,2902,162032,92,179906
14449,0.004938,172.31.47.0-255,66,162098,92,179906
14450,0.006517,172.217.27.0-255,2902,165000,92,179906
14451,0.006522,172.31.47.0-255,66,165066,92,179906
14452,0.006571,172.217.27.0-255,2902,167968,92,179906
14453,0.006574,172.31.47.0-255,66,168034,92,179906
14454,0.008173,172.217.27.0-255,2902,170936,92,179906
14455,0.008179,172.31.47.0-255,66,171002,92,179906
14456,0.008207,172.217.27.0-255,2902,173904,92,179906
14457,0.00821,172.31.47.0-255,66,173970,92,179906
14458,0.009824,172.217.27.0-255,2902,176872,92,179906
14459,0.00983,172.31.47.0-255,66,176938,92,179906
14460,0.009849,172.217.27.0-255,2902,179840,92,179906
14461,0.009852,172.31.47.0-255,66,179906,92,179906
14462,0.0,172.31.47.0-255,105,105,92,276
14463,0.001791,157.240.13.0-255,105,210,92,276
14464,0.001804,172.31.47.0-255,66,276,92,276
14465,0.0,74.125.24.0-255,152,152,92,252949
14466,1.4e-05,172.31.47.0-255,66,218,92,252949
14467,2e-05,74.125.24.0-255,1484,1702,92,252949
14468,2.4e-05,172.31.47.0-255,66,1768,92,252949
14469,2.7e-05,74.125.24.0-255,1484,3252,92,252949
14470,2.9e-05,172.31.47.0-255,66,3318,92,252949
14471,6e-05,74.125.24.0-255,1484,4802,92,252949
14472,6.3e-05,172.31.47.0-255,66,4868,92,252949
14473,6.6e-05,74.125.24.0-255,1484,6352,92,252949
14474,6.7e-05,172.31.47.0-255,66,6418,92,252949
14475,7.2e-05,74.125.24.0-255,2902,9320,92,252949
14476,7.4e-05,172.31.47.0-255,66,9386,92,252949
14477,9.4e-05,74.125.24.0-255,6394,15780,92,252949
14478,0.0001,172.31.47.0-255,66,15846,92,252949
14479,0.00011,74.125.24.0-255,4320,20166,92,252949
14480,0.000114,172.31.47.0-255,66,20232,92,252949
14481,0.000135,74.125.24.0-255,2902,23134,92,252949
14482,0.000137,172.31.47.0-255,66,23200,92,252949
14483,0.000147,172.31.47.0-255,66,23266,92,252949
14484,0.000181,74.125.24.0-255,7156,30422,92,252949
14485,0.000184,172.31.47.0-255,66,30488,92,252949
14486,0.000193,172.31.47.0-255,66,30554,92,252949
14487,0.000195,74.125.24.0-255,766,31320,92,252949
14488,0.000197,172.31.47.0-255,66,31386,92,252949
14489,0.000227,74.125.24.0-255,1484,32870,92,252949
14490,0.000233,172.31.47.0-255,66,32936,92,252949
14491,0.000238,74.125.24.0-255,4320,37256,92,252949
14492,0.000241,172.31.47.0-255,66,37322,92,252949
14493,0.000243,74.125.24.0-255,1484,38806,92,252949
14494,0.000245,172.31.47.0-255,66,38872,92,252949
14495,0.000278,74.125.24.0-255,5738,44610,92,252949
14496,0.000281,172.31.47.0-255,66,44676,92,252949
14497,0.000303,74.125.24.0-255,2902,47578,92,252949
14498,0.000305,172.31.47.0-255,66,47644,92,252949
14499,0.000319,74.125.24.0-255,1707,49351,92,252949
14500,0.000321,172.31.47.0-255,66,49417,92,252949
14501,0.000529,74.125.24.0-255,1484,50901,92,252949
14502,0.000534,74.125.24.0-255,1484,52385,92,252949
14503,0.000537,172.31.47.0-255,66,52451,92,252949
14504,0.000561,74.125.24.0-255,1484,53935,92,252949
14505,0.000567,74.125.24.0-255,5738,59673,92,252949
14506,0.000569,172.31.47.0-255,66,59739,92,252949
14507,0.000574,74.125.24.0-255,4320,64059,92,252949
14508,0.000576,172.31.47.0-255,66,64125,92,252949
14509,0.000581,74.125.24.0-255,5738,69863,92,252949
14510,0.000583,172.31.47.0-255,66,69929,92,252949
14511,0.000611,74.125.24.0-255,5738,75667,92,252949
14512,0.000614,172.31.47.0-255,66,75733,92,252949
14513,0.000624,172.31.47.0-255,66,75799,92,252949
14514,0.000655,74.125.24.0-255,1484,77283,92,252949
14515,0.000669,74.125.24.0-255,2902,80185,92,252949
14516,0.000671,74.125.24.0-255,1484,81669,92,252949
14517,0.000673,172.31.47.0-255,66,81735,92,252949
14518,0.000702,74.125.24.0-255,4320,86055,92,252949
14519,0.000704,172.31.47.0-255,66,86121,92,252949
14520,0.000716,172.31.47.0-255,66,86187,92,252949
14521,0.000731,172.31.47.0-255,66,86253,92,252949
14522,0.000758,74.125.24.0-255,2184,88437,92,252949
14523,0.000761,172.31.47.0-255,66,88503,92,252949
14524,0.000797,74.125.24.0-255,2902,91405,92,252949
14525,0.0008,172.31.47.0-255,66,91471,92,252949
14526,0.000804,74.125.24.0-255,2902,94373,92,252949
14527,0.000806,172.31.47.0-255,66,94439,92,252949
14528,0.000826,74.125.24.0-255,4320,98759,92,252949
14529,0.000829,172.31.47.0-255,66,98825,92,252949
14530,0.000845,172.31.47.0-255,66,98891,92,252949
14531,0.000879,172.31.47.0-255,66,98957,92,252949
14532,0.001009,74.125.24.0-255,1484,100441,92,252949
14533,0.001015,74.125.24.0-255,2902,103343,92,252949
14534,0.001017,172.31.47.0-255,66,103409,92,252949
14535,0.00102,74.125.24.0-255,1484,104893,92,252949
14536,0.001042,74.125.24.0-255,4320,109213,92,252949
14537,0.001045,172.31.47.0-255,66,109279,92,252949
14538,0.001049,74.125.24.0-255,4320,113599,92,252949
14539,0.001052,172.31.47.0-255,66,113665,92,252949
14540,0.001083,172.31.47.0-255,66,113731,92,252949
14541,0.001089,74.125.24.0-255,7156,120887,92,252949
14542,0.001091,172.31.47.0-255,66,120953,92,252949
14543,0.001116,74.125.24.0-255,1484,122437,92,252949
14544,0.001131,74.125.24.0-255,2184,124621,92,252949
14545,0.001134,172.31.47.0-255,66,124687,92,252949
14546,0.001259,74.125.24.0-255,1484,126171,92,252949
14547,0.001262,74.125.24.0-255,1484,127655,92,252949
14548,0.001266,172.31.47.0-255,66,127721,92,252949
14549,0.001273,74.125.24.0-255,1484,129205,92,252949
14550,0.001277,74.125.24.0-255,2902,132107,92,252949
14551,0.001279,172.31.47.0-255,66,132173,92,252949
14552,0.001306,74.125.24.0-255,2902,135075,92,252949
14553,0.001309,172.31.47.0-255,66,135141,92,252949
14554,0.001319,172.31.47.0-255,66,135207,92,252949
14555,0.001345,74.125.24.0-255,4320,139527,92,252949
14556,0.001348,172.31.47.0-255,66,139593,92,252949
14557,0.001354,74.125.24.0-255,5738,145331,92,252949
14558,0.001355,172.31.47.0-255,66,145397,92,252949
14559,0.001416,74.125.24.0-255,5020,150417,92,252949
14560,0.00142,172.31.47.0-255,66,150483,92,252949
14561,0.001482,74.125.24.0-255,1484,151967,92,252949
14562,0.001497,74.125.24.0-255,2902,154869,92,252949
14563,0.0015,172.31.47.0-255,66,154935,92,252949
14564,0.001504,74.125.24.0-255,4320,159255,92,252949
14565,0.001506,172.31.47.0-255,66,159321,92,252949
14566,0.001535,74.125.24.0-255,1484,160805,92,252949
14567,0.001551,172.31.47.0-255,66,160871,92,252949
14568,0.001556,74.125.24.0-255,5738,166609,92,252949
14569,0.001559,172.31.47.0-255,66,166675,92,252949
14570,0.001584,74.125.24.0-255,6438,173113,92,252949
14571,0.001587,172.31.47.0-255,66,173179,92,252949
14572,0.001589,74.125.24.0-255,1484,174663,92,252949
14573,0.001608,74.125.24.0-255,2902,177565,92,252949
14574,0.00161,172.31.47.0-255,66,177631,92,252949
14575,0.001635,74.125.24.0-255,5738,183369,92,252949
14576,0.001637,172.31.47.0-255,66,183435,92,252949
14577,0.001643,74.125.24.0-255,7156,190591,92,252949
14578,0.001645,172.31.47.0-255,66,190657,92,252949
14579,0.001649,74.125.24.0-255,4320,194977,92,252949
14580,0.001656,172.31.47.0-255,66,195043,92,252949
14581,0.001697,172.31.47.0-255,66,195109,92,252949
14582,0.001703,74.125.24.0-255,6438,201547,92,252949
14583,0.001705,172.31.47.0-255,66,201613,92,252949
14584,0.001708,74.125.24.0-255,1484,203097,92,252949
14585,0.001751,172.31.47.0-255,66,203163,92,252949
14586,0.001752,74.125.24.0-255,6438,209601,92,252949
14587,0.001755,172.31.47.0-255,66,209667,92,252949
14588,0.001791,74.125.24.0-255,5738,215405,92,252949
14589,0.001794,172.31.47.0-255,66,215471,92,252949
14590,0.001844,172.31.47.0-255,66,215537,92,252949
14591,0.001847,74.125.24.0-255,2184,217721,92,252949
14592,0.001849,172.31.47.0-255,66,217787,92,252949
14593,0.00187,74.125.24.0-255,2902,220689,92,252949
14594,0.001873,172.31.47.0-255,66,220755,92,252949
14595,0.00188,74.125.24.0-255,1484,222239,92,252949
14596,0.001902,74.125.24.0-255,2902,225141,92,252949
14597,0.001905,172.31.47.0-255,66,225207,92,252949
14598,0.001915,172.31.47.0-255,66,225273,92,252949
14599,0.001936,74.125.24.0-255,7156,232429,92,252949
14600,0.001939,172.31.47.0-255,66,232495,92,252949
14601,0.001967,74.125.24.0-255,5738,238233,92,252949
14602,0.00197,172.31.47.0-255,66,238299,92,252949
14603,0.001981,172.31.47.0-255,66,238365,92,252949
14604,0.002006,74.125.24.0-255,2184,240549,92,252949
14605,0.002009,172.31.47.0-255,66,240615,92,252949
14606,0.002015,74.125.24.0-255,7156,247771,92,252949
14607,0.002017,172.31.47.0-255,66,247837,92,252949
14608,0.002048,74.125.24.0-255,1484,249321,92,252949
14609,0.002074,74.125.24.0-255,3457,252778,92,252949
14610,0.002077,172.31.47.0-255,66,252844,92,252949
14611,0.00208,74.125.24.0-255,105,252949,92,252949
14612,0.0,74.125.24.0-255,153,153,92,109160
14613,3.8e-05,172.31.47.0-255,66,219,92,109160
14614,4.6e-05,74.125.24.0-255,1484,1703,92,109160
14615,5e-05,172.31.47.0-255,66,1769,92,109160
14616,5.6e-05,74.125.24.0-255,2902,4671,92,109160
14617,5.9e-05,172.31.47.0-255,66,4737,92,109160
14618,6.6e-05,74.125.24.0-255,7156,11893,92,109160
14619,6.9e-05,172.31.47.0-255,66,11959,92,109160
14620,7.4e-05,74.125.24.0-255,2014,13973,92,109160
14621,7.7e-05,172.31.47.0-255,66,14039,92,109160
14622,0.000549,74.125.24.0-255,1484,15523,92,109160
14623,0.000555,172.31.47.0-255,66,15589,92,109160
14624,0.000564,74.125.24.0-255,2902,18491,92,109160
14625,0.000566,172.31.47.0-255,66,18557,92,109160
14626,0.000573,74.125.24.0-255,5738,24295,92,109160
14627,0.000575,172.31.47.0-255,66,24361,92,109160
14628,0.000597,74.125.24.0-255,1484,25845,92,109160
14629,0.000599,172.31.47.0-255,66,25911,92,109160
14630,0.000629,172.31.47.0-255,66,25977,92,109160
14631,0.000639,172.31.47.0-255,66,26043,92,109160
14632,0.000677,172.31.47.0-255,66,26109,92,109160
14633,0.000688,172.31.47.0-255,66,26175,92,109160
14634,0.000709,74.125.24.0-255,1437,27612,92,109160
14635,0.000713,172.31.47.0-255,66,27678,92,109160
14636,0.000757,74.125.24.0-255,112,27790,92,109160
14637,0.00076,172.31.47.0-255,66,27856,92,109160
14638,0.000903,74.125.24.0-255,1484,29340,92,109160
14639,0.000909,172.31.47.0-255,66,29406,92,109160
14640,0.000915,74.125.24.0-255,2902,32308,92,109160
14641,0.000917,172.31.47.0-255,66,32374,92,109160
14642,0.000923,74.125.24.0-255,5738,38112,92,109160
14643,0.000925,172.31.47.0-255,66,38178,92,109160
14644,0.00097,74.125.24.0-255,2902,41080,92,109160
14645,0.000973,172.31.47.0-255,66,41146,92,109160
14646,0.00102,74.125.24.0-255,1484,42630,92,109160
14647,0.001609,74.125.24.0-255,1484,44114,92,109160
14648,0.001624,74.125.24.0-255,2902,47016,92,109160
14649,0.001644,74.125.24.0-255,5738,52754,92,109160
14650,0.001666,74.125.24.0-255,7156,59910,92,109160
14651,0.001674,74.125.24.0-255,1484,61394,92,109160
14652,0.001712,74.125.24.0-255,5738,67132,92,109160
14653,0.001724,74.125.24.0-255,4320,71452,92,109160
14654,0.001738,74.125.24.0-255,5020,76472,92,109160
14655,0.001827,74.125.24.0-255,1484,77956,92,109160
14656,0.001831,74.125.24.0-255,1484,79440,92,109160
14657,0.00184,74.125.24.0-255,1484,80924,92,109160
14658,0.001847,74.125.24.0-255,5738,86662,92,109160
14659,0.001883,74.125.24.0-255,1484,88146,92,109160
14660,0.001903,74.125.24.0-255,4320,92466,92,109160
14661,0.00192,74.125.24.0-255,5020,97486,92,109160
14662,0.003898,172.31.47.0-255,66,97552,92,109160
14663,0.006182,74.125.24.0-255,5738,103290,92,109160
14664,0.006193,172.31.47.0-255,66,103356,92,109160
14665,0.008656,74.125.24.0-255,5738,109094,92,109160
14666,0.008717,172.31.47.0-255,66,109160,92,109160
14667,0.0,172.31.47.0-255,105,105,92,276
14668,0.00206,157.240.13.0-255,105,210,92,276
14669,0.002075,172.31.47.0-255,66,276,92,276
14670,0.0,172.217.194.0-255,153,153,92,234853
14671,1.4e-05,172.31.47.0-255,66,219,92,234853
14672,2e-05,172.217.194.0-255,1484,1703,92,234853
14673,2.3e-05,172.31.47.0-255,66,1769,92,234853
14674,2.8e-05,172.217.194.0-255,2902,4671,92,234853
14675,3e-05,172.31.47.0-255,66,4737,92,234853
14676,4.2e-05,172.217.194.0-255,7156,11893,92,234853
14677,4.4e-05,172.31.47.0-255,66,11959,92,234853
14678,9.3e-05,172.31.47.0-255,66,12025,92,234853
14679,9.7e-05,172.217.194.0-255,2543,14568,92,234853
14680,9.9e-05,172.31.47.0-255,66,14634,92,234853
14681,0.000137,172.217.194.0-255,1484,16118,92,234853
14682,0.000139,172.31.47.0-255,66,16184,92,234853
14683,0.000143,172.217.194.0-255,2902,19086,92,234853
14684,0.000145,172.31.47.0-255,66,19152,92,234853
14685,0.00015,172.217.194.0-255,5738,24890,92,234853
14686,0.000151,172.31.47.0-255,66,24956,92,234853
14687,0.000203,172.31.47.0-255,66,25022,92,234853
14688,0.000212,172.31.47.0-255,66,25088,92,234853
14689,0.000226,172.217.194.0-255,1484,26572,92,234853
14690,0.000228,172.31.47.0-255,66,26638,92,234853
14691,0.00023,172.217.194.0-255,1484,28122,92,234853
14692,0.000232,172.31.47.0-255,66,28188,92,234853
14693,0.00025,172.217.194.0-255,2543,30731,92,234853
14694,0.000252,172.31.47.0-255,66,30797,92,234853
14695,0.000447,172.217.194.0-255,369,31166,92,234853
14696,0.000452,172.31.47.0-255,66,31232,92,234853
14697,0.000456,172.217.194.0-255,375,31607,92,234853
14698,0.000458,172.31.47.0-255,66,31673,92,234853
14699,0.000573,172.217.194.0-255,1484,33157,92,234853
14700,0.000577,172.217.194.0-255,2902,36059,92,234853
14701,0.000593,172.217.194.0-255,5738,41797,92,234853
14702,0.000603,172.31.47.0-255,66,41863,92,234853
14703,0.000612,172.217.194.0-255,4320,46183,92,234853
14704,0.000623,172.31.47.0-255,66,46249,92,234853
14705,0.000645,172.217.194.0-255,4320,50569,92,234853
14706,0.000679,172.31.47.0-255,66,50635,92,234853
14707,0.000723,172.31.47.0-255,66,50701,92,234853
14708,0.000749,172.217.194.0-255,5379,56080,92,234853
14709,0.000755,172.31.47.0-255,66,56146,92,234853
14710,0.00077,172.217.194.0-255,1484,57630,92,234853
14711,0.000783,172.217.194.0-255,4320,61950,92,234853
14712,0.000787,172.217.194.0-255,4320,66270,92,234853
14713,0.000804,172.217.194.0-255,2902,69172,92,234853
14714,0.000807,172.31.47.0-255,66,69238,92,234853
14715,0.000812,172.31.47.0-255,66,69304,92,234853
14716,0.000856,172.217.194.0-255,3961,73265,92,234853
14717,0.000869,172.31.47.0-255,66,73331,92,234853
14718,0.00093,172.217.194.0-255,1484,74815,92,234853
14719,0.000934,172.217.194.0-255,2902,77717,92,234853
14720,0.000942,172.31.47.0-255,66,77783,92,234853
14721,0.000952,172.217.194.0-255,5738,83521,92,234853
14722,0.000975,172.217.194.0-255,7156,90677,92,234853
14723,0.000978,172.31.47.0-255,66,90743,92,234853
14724,0.001003,172.217.194.0-255,5738,96481,92,234853
14725,0.001044,172.217.194.0-255,5738,102219,92,234853
14726,0.001047,172.31.47.0-255,66,102285,92,234853
14727,0.001052,172.31.47.0-255,66,102351,92,234853
14728,0.001072,172.217.194.0-255,5738,108089,92,234853
14729,0.001158,172.217.194.0-255,1484,109573,92,234853
14730,0.001167,172.31.47.0-255,66,109639,92,234853
14731,0.001192,172.31.47.0-255,66,109705,92,234853
14732,0.001228,172.31.47.0-255,66,109771,92,234853
14733,0.001268,172.217.194.0-255,7156,116927,92,234853
14734,0.001293,172.217.194.0-255,2902,119829,92,234853
14735,0.001298,172.217.194.0-255,4320,124149,92,234853
14736,0.001306,172.31.47.0-255,66,124215,92,234853
14737,0.001316,172.217.194.0-255,2543,126758,92,234853
14738,0.001322,172.31.47.0-255,66,126824,92,234853
14739,0.001342,172.217.194.0-255,7156,133980,92,234853
14740,0.001395,172.31.47.0-255,66,134046,92,234853
14741,0.001408,172.217.194.0-255,5738,139784,92,234853
14742,0.001426,172.217.194.0-255,5020,144804,92,234853
14743,0.001431,172.31.47.0-255,66,144870,92,234853
14744,0.001462,172.217.194.0-255,7156,152026,92,234853
14745,0.001466,172.217.194.0-255,1484,153510,92,234853
14746,0.001489,172.217.194.0-255,7156,160666,92,234853
14747,0.0015,172.31.47.0-255,66,160732,92,234853
14748,0.001507,172.31.47.0-255,66,160798,92,234853
14749,0.001527,172.217.194.0-255,766,161564,92,234853
14750,0.001553,172.217.194.0-255,1484,163048,92,234853
14751,0.001573,172.217.194.0-255,2902,165950,92,234853
14752,0.001577,172.217.194.0-255,1484,167434,92,234853
14753,0.001593,172.217.194.0-255,4320,171754,92,234853
14754,0.0016,172.217.194.0-255,7156,178910,92,234853
14755,0.001616,172.31.47.0-255,66,178976,92,234853
14756,0.001623,172.217.194.0-255,5738,184714,92,234853
14757,0.001632,172.217.194.0-255,7156,191870,92,234853
14758,0.001639,172.31.47.0-255,66,191936,92,234853
14759,0.001665,172.217.194.0-255,7156,199092,92,234853
14760,0.001677,172.217.194.0-255,3602,202694,92,234853
14761,0.001683,172.217.194.0-255,7156,209850,92,234853
14762,0.001692,172.31.47.0-255,66,209916,92,234853
14763,0.001701,172.217.194.0-255,4320,214236,92,234853
14764,0.001745,172.217.194.0-255,5738,219974,92,234853
14765,0.001773,172.31.47.0-255,66,220040,92,234853
14766,0.001889,172.217.194.0-255,1484,221524,92,234853
14767,0.001894,172.217.194.0-255,2902,224426,92,234853
14768,0.001906,172.31.47.0-255,66,224492,92,234853
14769,0.001922,172.217.194.0-255,5738,230230,92,234853
14770,0.001937,172.31.47.0-255,66,230296,92,234853
14771,0.00198,172.217.194.0-255,4320,234616,92,234853
14772,0.001987,172.31.47.0-255,66,234682,92,234853
14773,0.00201,172.217.194.0-255,105,234787,92,234853
14774,0.002028,172.31.47.0-255,66,234853,92,234853
14775,0.0,74.125.68.0-255,153,153,92,196577
14776,2.4e-05,172.31.47.0-255,66,219,92,196577
14777,3.2e-05,74.125.68.0-255,1484,1703,92,196577
14778,3.7e-05,172.31.47.0-255,66,1769,92,196577
14779,4.3e-05,74.125.68.0-255,2902,4671,92,196577
14780,5.3e-05,172.31.47.0-255,66,4737,92,196577
14781,9e-05,74.125.68.0-255,1484,6221,92,196577
14782,9.3e-05,172.31.47.0-255,66,6287,92,196577
14783,9.8e-05,74.125.68.0-255,2902,9189,92,196577
14784,0.000101,172.31.47.0-255,66,9255,92,196577
14785,0.000108,74.125.68.0-255,6382,15637,92,196577
14786,0.000111,172.31.47.0-255,66,15703,92,196577
14787,0.000114,74.125.68.0-255,1484,17187,92,196577
14788,0.000116,172.31.47.0-255,66,17253,92,196577
14789,0.000121,74.125.68.0-255,2902,20155,92,196577
14790,0.000124,172.31.47.0-255,66,20221,92,196577
14791,0.000158,74.125.68.0-255,5738,25959,92,196577
14792,0.000161,172.31.47.0-255,66,26025,92,196577
14793,0.000165,74.125.68.0-255,2902,28927,92,196577
14794,0.000168,172.31.47.0-255,66,28993,92,196577
14795,0.000199,74.125.68.0-255,2543,31536,92,196577
14796,0.000202,172.31.47.0-255,66,31602,92,196577
14797,0.000268,74.125.68.0-255,1484,33086,92,196577
14798,0.000271,172.31.47.0-255,66,33152,92,196577
14799,0.0003,74.125.68.0-255,2902,36054,92,196577
14800,0.000304,172.31.47.0-255,66,36120,92,196577
14801,0.000311,74.125.68.0-255,5738,41858,92,196577
14802,0.000313,172.31.47.0-255,66,41924,92,196577
14803,0.000317,74.125.68.0-255,2902,44826,92,196577
14804,0.000319,172.31.47.0-255,66,44892,92,196577
14805,0.00037,74.125.68.0-255,5379,50271,92,196577
14806,0.000373,172.31.47.0-255,66,50337,92,196577
14807,0.00038,74.125.68.0-255,5738,56075,92,196577
14808,0.000445,74.125.68.0-255,112,56187,92,196577
14809,0.000531,74.125.68.0-255,1484,57671,92,196577
14810,0.000535,74.125.68.0-255,1484,59155,92,196577
14811,0.000551,74.125.68.0-255,1484,60639,92,196577
14812,0.000564,74.125.68.0-255,2902,63541,92,196577
14813,0.000586,74.125.68.0-255,2902,66443,92,196577
14814,0.000594,74.125.68.0-255,7156,73599,92,196577
14815,0.000639,74.125.68.0-255,2902,76501,92,196577
14816,0.000665,172.31.47.0-255,66,76567,92,196577
14817,0.000672,74.125.68.0-255,3288,79855,92,196577
14818,0.000678,172.31.47.0-255,66,79921,92,196577
14819,0.000711,74.125.68.0-255,4320,84241,92,196577
14820,0.000715,74.125.68.0-255,1484,85725,92,196577
14821,0.000728,74.125.68.0-255,1484,87209,92,196577
14822,0.000742,74.125.68.0-255,4320,91529,92,196577
14823,0.000758,74.125.68.0-255,1484,93013,92,196577
14824,0.000765,172.31.47.0-255,66,93079,92,196577
14825,0.000788,74.125.68.0-255,2902,95981,92,196577
14826,0.000802,172.31.47.0-255,66,96047,92,196577
14827,0.000828,172.31.47.0-255,66,96113,92,196577
14828,0.000855,74.125.68.0-255,6438,102551,92,196577
14829,0.000872,172.31.47.0-255,66,102617,92,196577
14830,0.000901,74.125.68.0-255,1484,104101,92,196577
14831,0.000914,74.125.68.0-255,2902,107003,92,196577
14832,0.000917,74.125.68.0-255,1484,108487,92,196577
14833,0.000931,74.125.68.0-255,2902,111389,92,196577
14834,0.000935,172.31.47.0-255,66,111455,92,196577
14835,0.00094,172.31.47.0-255,66,111521,92,196577
14836,0.000955,74.125.68.0-255,5738,117259,92,196577
14837,0.000995,172.31.47.0-255,66,117325,92,196577
14838,0.00103,74.125.68.0-255,2902,120227,92,196577
14839,0.001037,172.31.47.0-255,66,120293,92,196577
14840,0.001066,74.125.68.0-255,6438,126731,92,196577
14841,0.001075,172.31.47.0-255,66,126797,92,196577
14842,0.001102,74.125.68.0-255,2902,129699,92,196577
14843,0.001107,74.125.68.0-255,4320,134019,92,196577
14844,0.001113,74.125.68.0-255,4320,138339,92,196577
14845,0.001128,172.31.47.0-255,66,138405,92,196577
14846,0.001148,74.125.68.0-255,4320,142725,92,196577
14847,0.001153,74.125.68.0-255,4320,147045,92,196577
14848,0.00116,74.125.68.0-255,5738,152783,92,196577
14849,0.001176,172.31.47.0-255,66,152849,92,196577
14850,0.001215,172.31.47.0-255,66,152915,92,196577
14851,0.00128,74.125.68.0-255,1484,154399,92,196577
14852,0.001284,74.125.68.0-255,1484,155883,92,196577
14853,0.001303,74.125.68.0-255,1484,157367,92,196577
14854,0.001313,172.31.47.0-255,66,157433,92,196577
14855,0.001334,74.125.68.0-255,5738,163171,92,196577
14856,0.001341,74.125.68.0-255,7156,170327,92,196577
14857,0.001358,74.125.68.0-255,4320,174647,92,196577
14858,0.001368,172.31.47.0-255,66,174713,92,196577
14859,0.001374,74.125.68.0-255,4320,179033,92,196577
14860,0.001437,172.31.47.0-255,66,179099,92,196577
14861,0.001464,172.31.47.0-255,66,179165,92,196577
14862,0.003737,74.125.68.0-255,5738,184903,92,196577
14863,0.003749,172.31.47.0-255,66,184969,92,196577
14864,0.006006,74.125.68.0-255,5738,190707,92,196577
14865,0.007605,172.31.47.0-255,66,190773,92,196577
14866,0.009877,74.125.68.0-255,5738,196511,92,196577
14867,0.009888,172.31.47.0-255,66,196577,92,196577
14868,0.0,172.217.194.0-255,297,297,92,195374
14869,1.5e-05,172.31.47.0-255,66,363,92,195374
14870,2.1e-05,172.217.194.0-255,1484,1847,92,195374
14871,2.5e-05,172.31.47.0-255,66,1913,92,195374
14872,3.9e-05,172.217.194.0-255,4320,6233,92,195374
14873,4.2e-05,172.31.47.0-255,66,6299,92,195374
14874,4.5e-05,172.217.194.0-255,1484,7783,92,195374
14875,4.7e-05,172.31.47.0-255,66,7849,92,195374
14876,8.1e-05,172.31.47.0-255,66,7915,92,195374
14877,9.7e-05,172.31.47.0-255,66,7981,92,195374
14878,0.000145,172.217.194.0-255,6797,14778,92,195374
14879,0.00015,172.31.47.0-255,66,14844,92,195374
14880,0.000185,172.217.194.0-255,1484,16328,92,195374
14881,0.000187,172.31.47.0-255,66,16394,92,195374
14882,0.000192,172.217.194.0-255,2902,19296,92,195374
14883,0.000194,172.31.47.0-255,66,19362,92,195374
14884,0.000197,172.217.194.0-255,1484,20846,92,195374
14885,0.000199,172.31.47.0-255,66,20912,92,195374
14886,0.000233,172.217.194.0-255,4320,25232,92,195374
14887,0.000236,172.31.47.0-255,66,25298,92,195374
14888,0.000243,172.217.194.0-255,6797,32095,92,195374
14889,0.000246,172.31.47.0-255,66,32161,92,195374
14890,0.000254,172.217.194.0-255,1484,33645,92,195374
14891,0.000257,172.31.47.0-255,66,33711,92,195374
14892,0.000305,172.217.194.0-255,2796,36507,92,195374
14893,0.000306,172.31.47.0-255,66,36573,92,195374
14894,0.000307,172.217.194.0-255,118,36691,92,195374
14895,0.00031,172.31.47.0-255,66,36757,92,195374
14896,0.000313,172.31.47.0-255,66,36823,92,195374
14897,0.000342,172.217.194.0-255,1484,38307,92,195374
14898,0.000348,172.217.194.0-255,2902,41209,92,195374
14899,0.000351,172.31.47.0-255,66,41275,92,195374
14900,0.000357,172.217.194.0-255,4320,45595,92,195374
14901,0.00036,172.31.47.0-255,66,45661,92,195374
14902,0.000384,172.217.194.0-255,2902,48563,92,195374
14903,0.000388,172.31.47.0-255,66,48629,92,195374
14904,0.000394,172.217.194.0-255,5379,54008,92,195374
14905,0.000398,172.31.47.0-255,66,54074,92,195374
14906,0.000425,172.217.194.0-255,1799,55873,92,195374
14907,0.000429,172.31.47.0-255,66,55939,92,195374
14908,0.000433,172.217.194.0-255,2902,58841,92,195374
14909,0.000435,172.31.47.0-255,66,58907,92,195374
14910,0.000438,172.217.194.0-255,1484,60391,92,195374
14911,0.000467,172.217.194.0-255,5738,66129,92,195374
14912,0.00047,172.31.47.0-255,66,66195,92,195374
14913,0.00049,172.217.194.0-255,5379,71574,92,195374
14914,0.000494,172.31.47.0-255,66,71640,92,195374
14915,0.000808,172.217.194.0-255,1484,73124,92,195374
14916,0.000813,172.217.194.0-255,2902,76026,92,195374
14917,0.000816,172.31.47.0-255,66,76092,92,195374
14918,0.000819,172.217.194.0-255,1484,77576,92,195374
14919,0.000836,172.217.194.0-255,4320,81896,92,195374
14920,0.000838,172.31.47.0-255,66,81962,92,195374
14921,0.000844,172.217.194.0-255,5738,87700,92,195374
14922,0.000846,172.31.47.0-255,66,87766,92,195374
14923,0.000898,172.217.194.0-255,4320,92086,92,195374
14924,0.000901,172.31.47.0-255,66,92152,92,195374
14925,0.000935,172.31.47.0-255,66,92218,92,195374
14926,0.000961,172.31.47.0-255,66,92284,92,195374
14927,0.000991,172.31.47.0-255,66,92350,92,195374
14928,0.001015,172.217.194.0-255,7156,99506,92,195374
14929,0.001018,172.31.47.0-255,66,99572,92,195374
14930,0.001049,172.31.47.0-255,66,99638,92,195374
14931,0.001077,172.217.194.0-255,1484,101122,92,195374
14932,0.001088,172.217.194.0-255,2902,104024,92,195374
14933,0.001091,172.31.47.0-255,66,104090,92,195374
14934,0.001094,172.217.194.0-255,2902,106992,92,195374
14935,0.001096,172.31.47.0-255,66,107058,92,195374
14936,0.001118,172.217.194.0-255,2902,109960,92,195374
14937,0.001125,172.31.47.0-255,66,110026,92,195374
14938,0.001137,172.31.47.0-255,66,110092,92,195374
14939,0.001139,172.217.194.0-255,1484,111576,92,195374
14940,0.001178,172.31.47.0-255,66,111642,92,195374
14941,0.001201,172.217.194.0-255,1484,113126,92,195374
14942,0.001215,172.217.194.0-255,2902,116028,92,195374
14943,0.001218,172.31.47.0-255,66,116094,92,195374
14944,0.00128,172.217.194.0-255,5738,121832,92,195374
14945,0.001283,172.31.47.0-255,66,121898,92,195374
14946,0.001293,172.31.47.0-255,66,121964,92,195374
14947,0.001328,172.31.47.0-255,66,122030,92,195374
14948,0.001374,172.217.194.0-255,1484,123514,92,195374
14949,0.001378,172.217.194.0-255,1484,124998,92,195374
14950,0.00138,172.31.47.0-255,66,125064,92,195374
14951,0.001405,172.217.194.0-255,1484,126548,92,195374
14952,0.001411,172.217.194.0-255,5738,132286,92,195374
14953,0.001413,172.31.47.0-255,66,132352,92,195374
14954,0.001419,172.217.194.0-255,5738,138090,92,195374
14955,0.001421,172.31.47.0-255,66,138156,92,195374
14956,0.001423,172.217.194.0-255,1484,139640,92,195374
14957,0.001453,172.31.47.0-255,66,139706,92,195374
14958,0.001459,172.217.194.0-255,5020,144726,92,195374
14959,0.00146,172.31.47.0-255,66,144792,92,195374
14960,0.001509,172.217.194.0-255,1484,146276,92,195374
14961,0.001513,172.217.194.0-255,1484,147760,92,195374
14962,0.001515,172.31.47.0-255,66,147826,92,195374
14963,0.001538,172.217.194.0-255,1484,149310,92,195374
14964,0.001544,172.217.194.0-255,5738,155048,92,195374
14965,0.001546,172.31.47.0-255,66,155114,92,195374
14966,0.00155,172.217.194.0-255,2902,158016,92,195374
14967,0.001552,172.31.47.0-255,66,158082,92,195374
14968,0.001578,172.217.194.0-255,5738,163820,92,195374
14969,0.001577,172.31.47.0-255,66,163886,92,195374
14970,0.001584,172.31.47.0-255,66,163952,92,195374
14971,0.001606,172.217.194.0-255,5020,168972,92,195374
14972,0.001613,172.31.47.0-255,66,169038,92,195374
14973,0.001694,172.217.194.0-255,1484,170522,92,195374
14974,0.001699,172.217.194.0-255,2902,173424,92,195374
14975,0.001703,172.31.47.0-255,66,173490,92,195374
14976,0.001703,172.217.194.0-255,5738,179228,92,195374
14977,0.001706,172.31.47.0-255,66,179294,92,195374
14978,0.001707,172.217.194.0-255,4320,183614,92,195374
14979,0.001709,172.31.47.0-255,66,183680,92,195374
14980,0.001742,172.31.47.0-255,66,183746,92,195374
14981,0.001745,172.217.194.0-255,1484,185230,92,195374
14982,0.00179,172.31.47.0-255,66,185296,92,195374
14983,0.001793,172.217.194.0-255,1484,186780,92,195374
14984,0.001833,172.31.47.0-255,66,186846,92,195374
14985,0.001867,172.217.194.0-255,2902,189748,92,195374
14986,0.00187,172.31.47.0-255,66,189814,92,195374
14987,0.001924,172.31.47.0-255,66,189880,92,195374
14988,0.00196,172.217.194.0-255,5020,194900,92,195374
14989,0.001962,172.31.47.0-255,66,194966,92,195374
14990,0.001965,172.31.47.0-255,66,195032,92,195374
14991,0.001983,172.31.47.0-255,66,195098,92,195374
14992,0.001985,172.217.194.0-255,105,195203,92,195374
14993,0.003173,172.31.47.0-255,66,195269,92,195374
14994,0.008061,172.31.47.0-255,105,195374,92,195374
14995,0.0,172.217.194.0-255,153,153,92,108511
14996,2.6e-05,172.31.47.0-255,66,219,92,108511
14997,3.3e-05,172.217.194.0-255,1484,1703,92,108511
14998,3.7e-05,172.31.47.0-255,66,1769,92,108511
14999,4.3e-05,172.217.194.0-255,2902,4671,92,108511
15000,4.8e-05,172.31.47.0-255,66,4737,92,108511
15001,5.5e-05,172.217.194.0-255,7156,11893,92,108511
15002,5.8e-05,172.31.47.0-255,66,11959,92,108511
15003,6.2e-05,172.217.194.0-255,2173,14132,92,108511
15004,6.5e-05,172.31.47.0-255,66,14198,92,108511
15005,9.1e-05,172.217.194.0-255,5738,19936,92,108511
15006,9.4e-05,172.31.47.0-255,66,20002,92,108511
15007,0.000108,172.217.194.0-255,5738,25740,92,108511
15008,0.00011,172.31.47.0-255,66,25806,92,108511
15009,0.000116,172.217.194.0-255,5379,31185,92,108511
15010,0.000118,172.31.47.0-255,66,31251,92,108511
15011,0.000209,172.217.194.0-255,1484,32735,92,108511
15012,0.000212,172.31.47.0-255,66,32801,92,108511
15013,0.000231,172.217.194.0-255,2902,35703,92,108511
15014,0.000234,172.31.47.0-255,66,35769,92,108511
15015,0.00024,172.217.194.0-255,5738,41507,92,108511
15016,0.000242,172.31.47.0-255,66,41573,92,108511
15017,0.000272,172.31.47.0-255,66,41639,92,108511
15018,0.000314,172.217.194.0-255,2902,44541,92,108511
15019,0.000316,172.31.47.0-255,66,44607,92,108511
15020,0.000349,172.31.47.0-255,66,44673,92,108511
15021,0.000352,172.217.194.0-255,646,45319,92,108511
15022,0.000353,172.31.47.0-255,66,45385,92,108511
15023,0.00123,172.217.194.0-255,1484,46869,92,108511
15024,0.001237,172.31.47.0-255,66,46935,92,108511
15025,0.001258,172.217.194.0-255,2902,49837,92,108511
15026,0.001266,172.217.194.0-255,5738,55575,92,108511
15027,0.001268,172.217.194.0-255,1484,57059,92,108511
15028,0.00128,172.217.194.0-255,1484,58543,92,108511
15029,0.001308,172.217.194.0-255,7156,65699,92,108511
15030,0.001331,172.217.194.0-255,2902,68601,92,108511
15031,0.001338,172.217.194.0-255,7156,75757,92,108511
15032,0.001396,172.217.194.0-255,3602,79359,92,108511
15033,0.001553,172.217.194.0-255,1484,80843,92,108511
15034,0.001573,172.217.194.0-255,2902,83745,92,108511
15035,0.001584,172.217.194.0-255,1484,85229,92,108511
15036,0.001597,172.217.194.0-255,4320,89549,92,108511
15037,0.001622,172.217.194.0-255,2902,92451,92,108511
15038,0.002029,172.217.194.0-255,1484,93935,92,108511
15039,0.002046,172.217.194.0-255,2902,96837,92,108511
15040,0.002063,172.217.194.0-255,4320,101157,92,108511
15041,0.002073,172.217.194.0-255,1484,102641,92,108511
15042,0.00616,172.31.47.0-255,66,102707,92,108511
15043,0.008205,172.217.194.0-255,5738,108445,92,108511
15044,0.008214,172.31.47.0-255,66,108511,92,108511
15045,0.0,74.125.24.0-255,153,153,92,180979
15046,3.2e-05,172.31.47.0-255,66,219,92,180979
15047,4e-05,74.125.24.0-255,1484,1703,92,180979
15048,4.4e-05,172.31.47.0-255,66,1769,92,180979
15049,4.8e-05,74.125.24.0-255,2902,4671,92,180979
15050,5e-05,172.31.47.0-255,66,4737,92,180979
15051,5.2e-05,74.125.24.0-255,1484,6221,92,180979
15052,5.4e-05,172.31.47.0-255,66,6287,92,180979
15053,8.4e-05,74.125.24.0-255,4320,10607,92,180979
15054,8.7e-05,172.31.47.0-255,66,10673,92,180979
15055,9.3e-05,74.125.24.0-255,6414,17087,92,180979
15056,9.5e-05,172.31.47.0-255,66,17153,92,180979
15057,0.000122,74.125.24.0-255,7156,24309,92,180979
15058,0.000124,172.31.47.0-255,66,24375,92,180979
15059,0.000146,74.125.24.0-255,6797,31172,92,180979
15060,0.000148,172.31.47.0-255,66,31238,92,180979
15061,0.000157,74.125.24.0-255,1484,32722,92,180979
15062,0.000159,172.31.47.0-255,66,32788,92,180979
15063,0.000173,74.125.24.0-255,2902,35690,92,180979
15064,0.000175,172.31.47.0-255,66,35756,92,180979
15065,0.00018,74.125.24.0-255,1484,37240,92,180979
15066,0.000182,172.31.47.0-255,66,37306,92,180979
15067,0.000206,74.125.24.0-255,4320,41626,92,180979
15068,0.000209,172.31.47.0-255,66,41692,92,180979
15069,0.000226,172.31.47.0-255,66,41758,92,180979
15070,0.00028,172.31.47.0-255,66,41824,92,180979
15071,0.000282,74.125.24.0-255,367,42191,92,180979
15072,0.000286,172.31.47.0-255,66,42257,92,180979
15073,0.000537,74.125.24.0-255,129,42386,92,180979
15074,0.00054,172.31.47.0-255,66,42452,92,180979
15075,0.000574,74.125.24.0-255,1484,43936,92,180979
15076,0.00058,74.125.24.0-255,2902,46838,92,180979
15077,0.000582,172.31.47.0-255,66,46904,92,180979
15078,0.000585,74.125.24.0-255,1484,48388,92,180979
15079,0.000603,74.125.24.0-255,5738,54126,92,180979
15080,0.000605,172.31.47.0-255,66,54192,92,180979
15081,0.000621,74.125.24.0-255,2902,57094,92,180979
15082,0.000623,172.31.47.0-255,66,57160,92,180979
15083,0.000637,74.125.24.0-255,2543,59703,92,180979
15084,0.00064,172.31.47.0-255,66,59769,92,180979
15085,0.000671,74.125.24.0-255,2902,62671,92,180979
15086,0.000673,172.31.47.0-255,66,62737,92,180979
15087,0.000676,74.125.24.0-255,1484,64221,92,180979
15088,0.00069,74.125.24.0-255,2902,67123,92,180979
15089,0.000692,172.31.47.0-255,66,67189,92,180979
15090,0.000713,74.125.24.0-255,2902,70091,92,180979
15091,0.000715,172.31.47.0-255,66,70157,92,180979
15092,0.00072,74.125.24.0-255,4320,74477,92,180979
15093,0.000721,172.31.47.0-255,66,74543,92,180979
15094,0.000733,172.31.47.0-255,66,74609,92,180979
15095,0.000756,74.125.24.0-255,6136,80745,92,180979
15096,0.000759,172.31.47.0-255,66,80811,92,180979
15097,0.000905,74.125.24.0-255,1484,82295,92,180979
15098,0.000918,74.125.24.0-255,2902,85197,92,180979
15099,0.000922,172.31.47.0-255,66,85263,92,180979
15100,0.000925,74.125.24.0-255,2902,88165,92,180979
15101,0.000927,172.31.47.0-255,66,88231,92,180979
15102,0.000948,74.125.24.0-255,2902,91133,92,180979
15103,0.000952,172.31.47.0-255,66,91199,92,180979
15104,0.000953,74.125.24.0-255,7156,98355,92,180979
15105,0.000955,172.31.47.0-255,66,98421,92,180979
15106,0.000972,74.125.24.0-255,2902,101323,92,180979
15107,0.000975,172.31.47.0-255,66,101389,92,180979
15108,0.001005,172.31.47.0-255,66,101455,92,180979
15109,0.001044,74.125.24.0-255,2184,103639,92,180979
15110,0.001049,172.31.47.0-255,66,103705,92,180979
15111,0.001159,74.125.24.0-255,1484,105189,92,180979
15112,0.001176,74.125.24.0-255,2902,108091,92,180979
15113,0.001178,172.31.47.0-255,66,108157,92,180979
15114,0.001198,74.125.24.0-255,5738,113895,92,180979
15115,0.001201,172.31.47.0-255,66,113961,92,180979
15116,0.001223,74.125.24.0-255,1484,115445,92,180979
15117,0.001237,74.125.24.0-255,7156,122601,92,180979
15118,0.001239,172.31.47.0-255,66,122667,92,180979
15119,0.001258,74.125.24.0-255,4320,126987,92,180979
15120,0.00126,172.31.47.0-255,66,127053,92,180979
15121,0.001264,74.125.24.0-255,4320,131373,92,180979
15122,0.001266,172.31.47.0-255,66,131439,92,180979
15123,0.001284,74.125.24.0-255,6438,137877,92,180979
15124,0.001286,172.31.47.0-255,66,137943,92,180979
15125,0.001854,74.125.24.0-255,1484,139427,92,180979
15126,0.001874,74.125.24.0-255,2902,142329,92,180979
15127,0.001878,172.31.47.0-255,66,142395,92,180979
15128,0.001882,74.125.24.0-255,1484,143879,92,180979
15129,0.0019,74.125.24.0-255,4320,148199,92,180979
15130,0.001902,172.31.47.0-255,66,148265,92,180979
15131,0.001931,172.31.47.0-255,66,148331,92,180979
15132,0.001994,172.31.47.0-255,66,148397,92,180979
15133,0.002242,74.125.24.0-255,1484,149881,92,180979
15134,0.00226,74.125.24.0-255,2902,152783,92,180979
15135,0.002262,172.31.47.0-255,66,152849,92,180979
15136,0.002267,74.125.24.0-255,4320,157169,92,180979
15137,0.002269,172.31.47.0-255,66,157235,92,180979
15138,0.00228,74.125.24.0-255,1484,158719,92,180979
15139,0.002304,74.125.24.0-255,1484,160203,92,180979
15140,0.002306,172.31.47.0-255,66,160269,92,180979
15141,0.002336,172.31.47.0-255,66,160335,92,180979
15142,0.002339,74.125.24.0-255,1484,161819,92,180979
15143,0.002353,74.125.24.0-255,1484,163303,92,180979
15144,0.002355,172.31.47.0-255,66,163369,92,180979
15145,0.002383,172.31.47.0-255,66,163435,92,180979
15146,0.004701,74.125.24.0-255,5738,169173,92,180979
15147,0.004706,172.31.47.0-255,66,169239,92,180979
15148,0.00699,74.125.24.0-255,2902,172141,92,180979
15149,0.006996,172.31.47.0-255,66,172207,92,180979
15150,0.007017,74.125.24.0-255,2902,175109,92,180979
15151,0.00702,172.31.47.0-255,66,175175,92,180979
15152,0.009318,74.125.24.0-255,5738,180913,92,180979
15153,0.009327,172.31.47.0-255,66,180979,92,180979
15154,0.0,172.31.47.0-255,105,105,92,105
15155,0.0,216.58.221.0-255,153,153,92,345194
15156,1.2e-05,172.31.47.0-255,66,219,92,345194
15157,3.9e-05,216.58.221.0-255,1484,1703,92,345194
15158,4.2e-05,172.31.47.0-255,66,1769,92,345194
15159,8.8e-05,216.58.221.0-255,2902,4671,92,345194
15160,9.2e-05,172.31.47.0-255,66,4737,92,345194
15161,9.7e-05,216.58.221.0-255,4320,9057,92,345194
15162,0.000101,172.31.47.0-255,66,9123,92,345194
15163,0.000105,216.58.221.0-255,1484,10607,92,345194
15164,0.000107,172.31.47.0-255,66,10673,92,345194
15165,0.000132,216.58.221.0-255,6509,17182,92,345194
15166,0.000134,172.31.47.0-255,66,17248,92,345194
15167,0.000173,216.58.221.0-255,7156,24404,92,345194
15168,0.000176,172.31.47.0-255,66,24470,92,345194
15169,0.000214,216.58.221.0-255,6797,31267,92,345194
15170,0.000217,172.31.47.0-255,66,31333,92,345194
15171,0.000325,216.58.221.0-255,1484,32817,92,345194
15172,0.000329,172.31.47.0-255,66,32883,92,345194
15173,0.000333,216.58.221.0-255,1484,34367,92,345194
15174,0.000336,172.31.47.0-255,66,34433,92,345194
15175,0.000349,216.58.221.0-255,1484,35917,92,345194
15176,0.000352,172.31.47.0-255,66,35983,92,345194
15177,0.000359,216.58.221.0-255,5738,41721,92,345194
15178,0.000361,172.31.47.0-255,66,41787,92,345194
15179,0.000391,216.58.221.0-255,6797,48584,92,345194
15180,0.000394,172.31.47.0-255,66,48650,92,345194
15181,0.000532,216.58.221.0-255,1484,50134,92,345194
15182,0.000536,172.31.47.0-255,66,50200,92,345194
15183,0.00054,216.58.221.0-255,1484,51684,92,345194
15184,0.000543,172.31.47.0-255,66,51750,92,345194
15185,0.000566,216.58.221.0-255,1484,53234,92,345194
15186,0.000569,172.31.47.0-255,66,53300,92,345194
15187,0.000576,216.58.221.0-255,5738,59038,92,345194
15188,0.000578,172.31.47.0-255,66,59104,92,345194
15189,0.000583,216.58.221.0-255,4320,63424,92,345194
15190,0.000586,172.31.47.0-255,66,63490,92,345194
15191,0.000622,216.58.221.0-255,2833,66323,92,345194
15192,0.000625,172.31.47.0-255,66,66389,92,345194
15193,0.001147,216.58.221.0-255,387,66776,92,345194
15194,0.001329,216.58.221.0-255,1484,68260,92,345194
15195,0.001336,172.31.47.0-255,66,68326,92,345194
15196,0.001342,216.58.221.0-255,2902,71228,92,345194
15197,0.001344,172.31.47.0-255,66,71294,92,345194
15198,0.001369,216.58.221.0-255,5738,77032,92,345194
15199,0.001372,172.31.47.0-255,66,77098,92,345194
15200,0.001379,216.58.221.0-255,6797,83895,92,345194
15201,0.001381,172.31.47.0-255,66,83961,92,345194
15202,0.001395,216.58.221.0-255,1484,85445,92,345194
15203,0.001413,216.58.221.0-255,5738,91183,92,345194
15204,0.001416,172.31.47.0-255,66,91249,92,345194
15205,0.001469,216.58.221.0-255,7156,98405,92,345194
15206,0.001472,172.31.47.0-255,66,98471,92,345194
15207,0.001532,216.58.221.0-255,2543,101014,92,345194
15208,0.001535,172.31.47.0-255,66,101080,92,345194
15209,0.001614,216.58.221.0-255,1484,102564,92,345194
15210,0.001619,216.58.221.0-255,1484,104048,92,345194
15211,0.001622,172.31.47.0-255,66,104114,92,345194
15212,0.001626,216.58.221.0-255,1484,105598,92,345194
15213,0.001641,216.58.221.0-255,1484,107082,92,345194
15214,0.001644,172.31.47.0-255,66,107148,92,345194
15215,0.00165,216.58.221.0-255,4320,111468,92,345194
15216,0.001653,172.31.47.0-255,66,111534,92,345194
15217,0.00166,216.58.221.0-255,5738,117272,92,345194
15218,0.001662,172.31.47.0-255,66,117338,92,345194
15219,0.001698,172.31.47.0-255,66,117404,92,345194
15220,0.001726,216.58.221.0-255,2902,120306,92,345194
15221,0.001728,172.31.47.0-255,66,120372,92,345194
15222,0.001746,216.58.221.0-255,3602,123974,92,345194
15223,0.001748,172.31.47.0-255,66,124040,92,345194
15224,0.001762,216.58.221.0-255,2902,126942,92,345194
15225,0.001765,172.31.47.0-255,66,127008,92,345194
15226,0.001782,216.58.221.0-255,4320,131328,92,345194
15227,0.001784,172.31.47.0-255,66,131394,92,345194
15228,0.001789,216.58.221.0-255,5738,137132,92,345194
15229,0.001791,172.31.47.0-255,66,137198,92,345194
15230,0.001798,216.58.221.0-255,7156,144354,92,345194
15231,0.0018,172.31.47.0-255,66,144420,92,345194
15232,0.001834,216.58.221.0-255,1484,145904,92,345194
15233,0.001852,216.58.221.0-255,4320,150224,92,345194
15234,0.001854,172.31.47.0-255,66,150290,92,345194
15235,0.001857,216.58.221.0-255,1484,151774,92,345194
15236,0.001876,216.58.221.0-255,5738,157512,92,345194
15237,0.001878,172.31.47.0-255,66,157578,92,345194
15238,0.00188,216.58.221.0-255,766,158344,92,345194
15239,0.001904,216.58.221.0-255,1484,159828,92,345194
15240,0.001906,172.31.47.0-255,66,159894,92,345194
15241,0.001923,216.58.221.0-255,2902,162796,92,345194
15242,0.001926,172.31.47.0-255,66,162862,92,345194
15243,0.00193,216.58.221.0-255,2902,165764,92,345194
15244,0.001933,172.31.47.0-255,66,165830,92,345194
15245,0.001938,216.58.221.0-255,4320,170150,92,345194
15246,0.00194,172.31.47.0-255,66,170216,92,345194
15247,0.001966,172.31.47.0-255,66,170282,92,345194
15248,0.001972,216.58.221.0-255,7156,177438,92,345194
15249,0.001974,172.31.47.0-255,66,177504,92,345194
15250,0.001977,216.58.221.0-255,1484,178988,92,345194
15251,0.001996,216.58.221.0-255,5020,184008,92,345194
15252,0.001998,172.31.47.0-255,66,184074,92,345194
15253,0.002147,216.58.221.0-255,1484,185558,92,345194
15254,0.002157,216.58.221.0-255,1484,187042,92,345194
15255,0.002159,172.31.47.0-255,66,187108,92,345194
15256,0.002178,216.58.221.0-255,1484,188592,92,345194
15257,0.002184,216.58.221.0-255,5738,194330,92,345194
15258,0.002186,172.31.47.0-255,66,194396,92,345194
15259,0.002191,216.58.221.0-255,4320,198716,92,345194
15260,0.002193,172.31.47.0-255,66,198782,92,345194
15261,0.002199,216.58.221.0-255,5738,204520,92,345194
15262,0.002201,172.31.47.0-255,66,204586,92,345194
15263,0.002237,172.31.47.0-255,66,204652,92,345194
15264,0.002239,216.58.221.0-255,1484,206136,92,345194
15265,0.002242,216.58.221.0-255,766,206902,92,345194
15266,0.002244,172.31.47.0-255,66,206968,92,345194
15267,0.002624,216.58.221.0-255,1484,208452,92,345194
15268,0.002644,216.58.221.0-255,1484,209936,92,345194
15269,0.002646,172.31.47.0-255,66,210002,92,345194
15270,0.002661,216.58.221.0-255,2902,212904,92,345194
15271,0.002663,172.31.47.0-255,66,212970,92,345194
15272,0.002692,216.58.221.0-255,5738,218708,92,345194
15273,0.002694,172.31.47.0-255,66,218774,92,345194
15274,0.002736,216.58.221.0-255,2902,221676,92,345194
15275,0.002738,172.31.47.0-255,66,221742,92,345194
15276,0.002761,216.58.221.0-255,7156,228898,92,345194
15277,0.002763,172.31.47.0-255,66,228964,92,345194
15278,0.002774,172.31.47.0-255,66,229030,92,345194
15279,0.002777,216.58.221.0-255,766,229796,92,345194
15280,0.002889,216.58.221.0-255,1484,231280,92,345194
15281,0.002891,172.31.47.0-255,66,231346,92,345194
15282,0.002902,216.58.221.0-255,1484,232830,92,345194
15283,0.002918,216.58.221.0-255,1484,234314,92,345194
15284,0.002921,172.31.47.0-255,66,234380,92,345194
15285,0.002926,216.58.221.0-255,5738,240118,92,345194
15286,0.002928,172.31.47.0-255,66,240184,92,345194
15287,0.002934,216.58.221.0-255,5738,245922,92,345194
15288,0.002936,172.31.47.0-255,66,245988,92,345194
15289,0.002957,216.58.221.0-255,7156,253144,92,345194
15290,0.00296,172.31.47.0-255,66,253210,92,345194
15291,0.002964,216.58.221.0-255,4320,257530,92,345194
15292,0.002966,172.31.47.0-255,66,257596,92,345194
15293,0.002985,216.58.221.0-255,4320,261916,92,345194
15294,0.002988,172.31.47.0-255,66,261982,92,345194
15295,0.003021,216.58.221.0-255,2902,264884,92,345194
15296,0.003024,172.31.47.0-255,66,264950,92,345194
15297,0.003043,216.58.221.0-255,6438,271388,92,345194
15298,0.003045,172.31.47.0-255,66,271454,92,345194
15299,0.003051,216.58.221.0-255,7156,278610,92,345194
15300,0.003053,172.31.47.0-255,66,278676,92,345194
15301,0.003078,216.58.221.0-255,2902,281578,92,345194
15302,0.00308,172.31.47.0-255,66,281644,92,345194
15303,0.003086,216.58.221.0-255,7156,288800,92,345194
15304,0.003088,172.31.47.0-255,66,288866,92,345194
15305,0.003122,172.31.47.0-255,66,288932,92,345194
15306,0.003147,216.58.221.0-255,1484,290416,92,345194
15307,0.00317,172.31.47.0-255,66,290482,92,345194
15308,0.003172,216.58.221.0-255,1484,291966,92,345194
15309,0.003187,216.58.221.0-255,2902,294868,92,345194
15310,0.003189,172.31.47.0-255,66,294934,92,345194
15311,0.003207,216.58.221.0-255,7156,302090,92,345194
15312,0.003209,172.31.47.0-255,66,302156,92,345194
15313,0.00324,172.31.47.0-255,66,302222,92,345194
15314,0.003257,216.58.221.0-255,1484,303706,92,345194
15315,0.003261,216.58.221.0-255,2902,306608,92,345194
15316,0.003263,172.31.47.0-255,66,306674,92,345194
15317,0.003267,216.58.221.0-255,2902,309576,92,345194
15318,0.003269,172.31.47.0-255,66,309642,92,345194
15319,0.003282,216.58.221.0-255,2902,312544,92,345194
15320,0.003285,172.31.47.0-255,66,312610,92,345194
15321,0.003314,172.31.47.0-255,66,312676,92,345194
15322,0.003316,216.58.221.0-255,1484,314160,92,345194
15323,0.003335,216.58.221.0-255,7156,321316,92,345194
15324,0.003337,172.31.47.0-255,66,321382,92,345194
15325,0.003352,216.58.221.0-255,1484,322866,92,345194
15326,0.003355,216.58.221.0-255,1484,324350,92,345194
15327,0.003356,172.31.47.0-255,66,324416,92,345194
15328,0.00336,216.58.221.0-255,2902,327318,92,345194
15329,0.003362,172.31.47.0-255,66,327384,92,345194
15330,0.00338,216.58.221.0-255,2902,330286,92,345194
15331,0.003382,172.31.47.0-255,66,330352,92,345194
15332,0.003403,216.58.221.0-255,3602,333954,92,345194
15333,0.003406,172.31.47.0-255,66,334020,92,345194
15334,0.003412,216.58.221.0-255,7156,341176,92,345194
15335,0.003414,172.31.47.0-255,66,341242,92,345194
15336,0.003418,216.58.221.0-255,3684,344926,92,345194
15337,0.003421,172.31.47.0-255,66,344992,92,345194
15338,0.003423,216.58.221.0-255,97,345089,92,345194
15339,0.003467,216.58.221.0-255,105,345194,92,345194
15340,0.0,74.125.68.0-255,153,153,92,163478
15341,2.7e-05,172.31.47.0-255,66,219,92,163478
15342,3.3e-05,74.125.68.0-255,1484,1703,92,163478
15343,3.8e-05,172.31.47.0-255,66,1769,92,163478
15344,5.1e-05,74.125.68.0-255,2902,4671,92,163478
15345,5.5e-05,172.31.47.0-255,66,4737,92,163478
15346,6.3e-05,74.125.68.0-255,7156,11893,92,163478
15347,6.6e-05,172.31.47.0-255,66,11959,92,163478
15348,7.1e-05,74.125.68.0-255,3463,15422,92,163478
15349,7.3e-05,172.31.47.0-255,66,15488,92,163478
15350,0.000109,74.125.68.0-255,4320,19808,92,163478
15351,0.000113,172.31.47.0-255,66,19874,92,163478
15352,0.000125,172.31.47.0-255,66,19940,92,163478
15353,0.000137,74.125.68.0-255,1125,21065,92,163478
15354,0.00014,172.31.47.0-255,66,21131,92,163478
15355,0.000526,74.125.68.0-255,1484,22615,92,163478
15356,0.000531,74.125.68.0-255,2902,25517,92,163478
15357,0.000534,172.31.47.0-255,66,25583,92,163478
15358,0.000538,172.31.47.0-255,66,25649,92,163478
15359,0.000563,74.125.68.0-255,5738,31387,92,163478
15360,0.000571,172.31.47.0-255,66,31453,92,163478
15361,0.000574,74.125.68.0-255,1484,32937,92,163478
15362,0.000577,172.31.47.0-255,66,33003,92,163478
15363,0.000621,172.31.47.0-255,66,33069,92,163478
15364,0.000624,74.125.68.0-255,1484,34553,92,163478
15365,0.000626,172.31.47.0-255,66,34619,92,163478
15366,0.000665,74.125.68.0-255,645,35264,92,163478
15367,0.000667,172.31.47.0-255,66,35330,92,163478
15368,0.00067,172.31.47.0-255,66,35396,92,163478
15369,0.000781,74.125.68.0-255,1484,36880,92,163478
15370,0.000796,74.125.68.0-255,2902,39782,92,163478
15371,0.0008,172.31.47.0-255,66,39848,92,163478
15372,0.000804,74.125.68.0-255,1484,41332,92,163478
15373,0.000829,74.125.68.0-255,4320,45652,92,163478
15374,0.000832,172.31.47.0-255,66,45718,92,163478
15375,0.000839,74.125.68.0-255,7156,52874,92,163478
15376,0.000841,172.31.47.0-255,66,52940,92,163478
15377,0.000857,74.125.68.0-255,1484,54424,92,163478
15378,0.000872,172.31.47.0-255,66,54490,92,163478
15379,0.0009,74.125.68.0-255,1484,55974,92,163478
15380,0.000908,74.125.68.0-255,5020,60994,92,163478
15381,0.000911,172.31.47.0-255,66,61060,92,163478
15382,0.000951,74.125.68.0-255,1484,62544,92,163478
15383,0.000965,74.125.68.0-255,2902,65446,92,163478
15384,0.000969,172.31.47.0-255,66,65512,92,163478
15385,0.000972,74.125.68.0-255,1484,66996,92,163478
15386,0.000995,74.125.68.0-255,2902,69898,92,163478
15387,0.000998,172.31.47.0-255,66,69964,92,163478
15388,0.001001,74.125.68.0-255,1484,71448,92,163478
15389,0.001027,74.125.68.0-255,4320,75768,92,163478
15390,0.001029,74.125.68.0-255,1484,77252,92,163478
15391,0.001031,172.31.47.0-255,66,77318,92,163478
15392,0.00107,172.31.47.0-255,66,77384,92,163478
15393,0.001094,74.125.68.0-255,6438,83822,92,163478
15394,0.001097,172.31.47.0-255,66,83888,92,163478
15395,0.001159,74.125.68.0-255,1484,85372,92,163478
15396,0.001164,74.125.68.0-255,2902,88274,92,163478
15397,0.001167,172.31.47.0-255,66,88340,92,163478
15398,0.001197,74.125.68.0-255,4320,92660,92,163478
15399,0.001201,172.31.47.0-255,66,92726,92,163478
15400,0.001206,74.125.68.0-255,5738,98464,92,163478
15401,0.001209,172.31.47.0-255,66,98530,92,163478
15402,0.001243,172.31.47.0-255,66,98596,92,163478
15403,0.001248,74.125.68.0-255,4320,102916,92,163478
15404,0.00125,172.31.47.0-255,66,102982,92,163478
15405,0.001318,74.125.68.0-255,3602,106584,92,163478
15406,0.001323,172.31.47.0-255,66,106650,92,163478
15407,0.001395,74.125.68.0-255,1484,108134,92,163478
15408,0.001408,74.125.68.0-255,2902,111036,92,163478
15409,0.001411,172.31.47.0-255,66,111102,92,163478
15410,0.001468,74.125.68.0-255,4320,115422,92,163478
15411,0.001472,172.31.47.0-255,66,115488,92,163478
15412,0.001496,74.125.68.0-255,1484,116972,92,163478
15413,0.0015,74.125.68.0-255,2902,119874,92,163478
15414,0.001503,172.31.47.0-255,66,119940,92,163478
15415,0.001513,172.31.47.0-255,66,120006,92,163478
15416,0.001529,172.31.47.0-255,66,120072,92,163478
15417,0.001531,74.125.68.0-255,766,120838,92,163478
15418,0.001782,74.125.68.0-255,1484,122322,92,163478
15419,0.001786,172.31.47.0-255,66,122388,92,163478
15420,0.00179,74.125.68.0-255,1484,123872,92,163478
15421,0.001813,74.125.68.0-255,1484,125356,92,163478
15422,0.001816,172.31.47.0-255,66,125422,92,163478
15423,0.001821,74.125.68.0-255,4320,129742,92,163478
15424,0.001823,172.31.47.0-255,66,129808,92,163478
15425,0.001826,74.125.68.0-255,1484,131292,92,163478
15426,0.001853,74.125.68.0-255,7156,138448,92,163478
15427,0.001856,172.31.47.0-255,66,138514,92,163478
15428,0.001861,74.125.68.0-255,4320,142834,92,163478
15429,0.001863,172.31.47.0-255,66,142900,92,163478
15430,0.001899,74.125.68.0-255,4320,147220,92,163478
15431,0.001902,172.31.47.0-255,66,147286,92,163478
15432,0.001937,172.31.47.0-255,66,147352,92,163478
15433,0.002232,74.125.68.0-255,1484,148836,92,163478
15434,0.004161,74.125.68.0-255,4320,153156,92,163478
15435,0.004167,172.31.47.0-255,66,153222,92,163478
15436,0.006384,74.125.68.0-255,4320,157542,92,163478
15437,0.006389,172.31.47.0-255,66,157608,92,163478
15438,0.006417,74.125.68.0-255,1484,159092,92,163478
15439,0.008607,74.125.68.0-255,4320,163412,92,163478
15440,0.008612,172.31.47.0-255,66,163478,92,163478
15441,0.0,74.125.24.0-255,153,153,92,162559
15442,3.7e-05,172.31.47.0-255,66,219,92,162559
15443,4.4e-05,74.125.24.0-255,1484,1703,92,162559
15444,4.8e-05,172.31.47.0-255,66,1769,92,162559
15445,5.3e-05,74.125.24.0-255,2902,4671,92,162559
15446,5.5e-05,172.31.47.0-255,66,4737,92,162559
15447,6.8e-05,74.125.24.0-255,4320,9057,92,162559
15448,7.1e-05,172.31.47.0-255,66,9123,92,162559
15449,7.8e-05,74.125.24.0-255,7156,16279,92,162559
15450,8.1e-05,172.31.47.0-255,66,16345,92,162559
15451,0.000109,74.125.24.0-255,4853,21198,92,162559
15452,0.000112,172.31.47.0-255,66,21264,92,162559
15453,0.00013,172.31.47.0-255,66,21330,92,162559
15454,0.000155,74.125.24.0-255,1484,22814,92,162559
15455,0.000158,172.31.47.0-255,66,22880,92,162559
15456,0.000168,74.125.24.0-255,2902,25782,92,162559
15457,0.00017,172.31.47.0-255,66,25848,92,162559
15458,0.000178,74.125.24.0-255,5738,31586,92,162559
15459,0.000181,172.31.47.0-255,66,31652,92,162559
15460,0.000211,74.125.24.0-255,6797,38449,92,162559
15461,0.000215,172.31.47.0-255,66,38515,92,162559
15462,0.000236,172.31.47.0-255,66,38581,92,162559
15463,0.00024,74.125.24.0-255,2816,41397,92,162559
15464,0.000243,172.31.47.0-255,66,41463,92,162559
15465,0.000291,74.125.24.0-255,134,41597,92,162559
15466,0.000295,172.31.47.0-255,66,41663,92,162559
15467,0.000298,74.125.24.0-255,348,42011,92,162559
15468,0.000301,172.31.47.0-255,66,42077,92,162559
15469,0.000598,74.125.24.0-255,1484,43561,92,162559
15470,0.000603,172.31.47.0-255,66,43627,92,162559
15471,0.000609,74.125.24.0-255,2902,46529,92,162559
15472,0.000612,172.31.47.0-255,66,46595,92,162559
15473,0.000617,74.125.24.0-255,4320,50915,92,162559
15474,0.000626,172.31.47.0-255,66,50981,92,162559
15475,0.000657,74.125.24.0-255,1484,52465,92,162559
15476,0.000673,172.31.47.0-255,66,52531,92,162559
15477,0.00068,74.125.24.0-255,7156,59687,92,162559
15478,0.000683,172.31.47.0-255,66,59753,92,162559
15479,0.000693,74.125.24.0-255,3602,63355,92,162559
15480,0.000696,172.31.47.0-255,66,63421,92,162559
15481,0.001567,74.125.24.0-255,1484,64905,92,162559
15482,0.001578,74.125.24.0-255,2902,67807,92,162559
15483,0.001583,172.31.47.0-255,66,67873,92,162559
15484,0.001591,74.125.24.0-255,5738,73611,92,162559
15485,0.001593,172.31.47.0-255,66,73677,92,162559
15486,0.001613,172.31.47.0-255,66,73743,92,162559
15487,0.001634,74.125.24.0-255,4320,78063,92,162559
15488,0.001637,172.31.47.0-255,66,78129,92,162559
15489,0.001646,74.125.24.0-255,1484,79613,92,162559
15490,0.001649,74.125.24.0-255,1484,81097,92,162559
15491,0.001651,172.31.47.0-255,66,81163,92,162559
15492,0.001689,172.31.47.0-255,66,81229,92,162559
15493,0.00176,74.125.24.0-255,1484,82713,92,162559
15494,0.001764,74.125.24.0-255,1484,84197,92,162559
15495,0.001771,172.31.47.0-255,66,84263,92,162559
15496,0.001775,74.125.24.0-255,1484,85747,92,162559
15497,0.00178,74.125.24.0-255,5738,91485,92,162559
15498,0.001782,172.31.47.0-255,66,91551,92,162559
15499,0.001806,74.125.24.0-255,5738,97289,92,162559
15500,0.001808,172.31.47.0-255,66,97355,92,162559
15501,0.001835,74.125.24.0-255,7156,104511,92,162559
15502,0.001838,172.31.47.0-255,66,104577,92,162559
15503,0.001843,74.125.24.0-255,5738,110315,92,162559
15504,0.001845,172.31.47.0-255,66,110381,92,162559
15505,0.001863,74.125.24.0-255,2902,113283,92,162559
15506,0.001865,172.31.47.0-255,66,113349,92,162559
15507,0.001903,172.31.47.0-255,66,113415,92,162559
15508,0.001911,172.31.47.0-255,66,113481,92,162559
15509,0.001913,74.125.24.0-255,1484,114965,92,162559
15510,0.001939,172.31.47.0-255,66,115031,92,162559
15511,0.001944,74.125.24.0-255,4320,119351,92,162559
15512,0.001945,172.31.47.0-255,66,119417,92,162559
15513,0.001965,74.125.24.0-255,5738,125155,92,162559
15514,0.001968,172.31.47.0-255,66,125221,92,162559
15515,0.001973,74.125.24.0-255,7156,132377,92,162559
15516,0.001975,172.31.47.0-255,66,132443,92,162559
15517,0.002014,172.31.47.0-255,66,132509,92,162559
15518,0.002017,74.125.24.0-255,2184,134693,92,162559
15519,0.002019,172.31.47.0-255,66,134759,92,162559
15520,0.002291,74.125.24.0-255,1484,136243,92,162559
15521,0.002295,74.125.24.0-255,1484,137727,92,162559
15522,0.002297,172.31.47.0-255,66,137793,92,162559
15523,0.002322,74.125.24.0-255,1484,139277,92,162559
15524,0.002327,74.125.24.0-255,5738,145015,92,162559
15525,0.002365,172.31.47.0-255,66,145081,92,162559
15526,0.002367,74.125.24.0-255,1484,146565,92,162559
15527,0.004641,74.125.24.0-255,4320,150885,92,162559
15528,0.004646,172.31.47.0-255,66,150951,92,162559
15529,0.00693,74.125.24.0-255,5738,156689,92,162559
15530,0.006937,172.31.47.0-255,66,156755,92,162559
15531,0.009214,74.125.24.0-255,5738,162493,92,162559
15532,0.009222,172.31.47.0-255,66,162559,92,162559
15533,0.0,74.125.24.0-255,152,152,92,92477
15534,3.1e-05,172.31.47.0-255,66,218,92,92477
15535,4e-05,74.125.24.0-255,1484,1702,92,92477
15536,4.5e-05,172.31.47.0-255,66,1768,92,92477
15537,5.1e-05,74.125.24.0-255,2902,4670,92,92477
15538,5.4e-05,172.31.47.0-255,66,4736,92,92477
15539,6.2e-05,74.125.24.0-255,7156,11892,92,92477
15540,6.5e-05,172.31.47.0-255,66,11958,92,92477
15541,7e-05,74.125.24.0-255,2161,14119,92,92477
15542,7.3e-05,172.31.47.0-255,66,14185,92,92477
15543,0.000179,74.125.24.0-255,1484,15669,92,92477
15544,0.000184,74.125.24.0-255,2902,18571,92,92477
15545,0.000193,172.31.47.0-255,66,18637,92,92477
15546,0.000197,172.31.47.0-255,66,18703,92,92477
15547,0.000206,74.125.24.0-255,5738,24441,92,92477
15548,0.000208,172.31.47.0-255,66,24507,92,92477
15549,0.000242,74.125.24.0-255,6797,31304,92,92477
15550,0.000245,172.31.47.0-255,66,31370,92,92477
15551,0.000258,172.31.47.0-255,66,31436,92,92477
15552,0.000274,74.125.24.0-255,5738,37174,92,92477
15553,0.000277,172.31.47.0-255,66,37240,92,92477
15554,0.000285,74.125.24.0-255,7156,44396,92,92477
15555,0.000288,172.31.47.0-255,66,44462,92,92477
15556,0.000316,74.125.24.0-255,2902,47364,92,92477
15557,0.000319,172.31.47.0-255,66,47430,92,92477
15558,0.000349,172.31.47.0-255,66,47496,92,92477
15559,0.000352,74.125.24.0-255,131,47627,92,92477
15560,0.000354,172.31.47.0-255,66,47693,92,92477
15561,0.000579,74.125.24.0-255,348,48041,92,92477
15562,0.000584,172.31.47.0-255,66,48107,92,92477
15563,0.001089,74.125.24.0-255,1484,49591,92,92477
15564,0.001107,74.125.24.0-255,2902,52493,92,92477
15565,0.001111,172.31.47.0-255,66,52559,92,92477
15566,0.001117,74.125.24.0-255,2902,55461,92,92477
15567,0.001133,74.125.24.0-255,2902,58363,92,92477
15568,0.001141,74.125.24.0-255,4320,62683,92,92477
15569,0.001155,172.31.47.0-255,66,62749,92,92477
15570,0.001189,74.125.24.0-255,1994,64743,92,92477
15571,0.001202,172.31.47.0-255,66,64809,92,92477
15572,0.001705,74.125.24.0-255,1484,66293,92,92477
15573,0.001718,74.125.24.0-255,2902,69195,92,92477
15574,0.001723,172.31.47.0-255,66,69261,92,92477
15575,0.001733,74.125.24.0-255,5738,74999,92,92477
15576,0.001862,172.31.47.0-255,66,75065,92,92477
15577,0.003969,74.125.24.0-255,5738,80803,92,92477
15578,0.003988,172.31.47.0-255,66,80869,92,92477
15579,0.00604,74.125.24.0-255,5738,86607,92,92477
15580,0.006047,172.31.47.0-255,66,86673,92,92477
15581,0.008119,74.125.24.0-255,5738,92411,92,92477
15582,0.008137,172.31.47.0-255,66,92477,92,92477
15583,0.0,172.31.47.0-255,105,105,92,276
15584,0.001776,157.240.13.0-255,105,210,92,276
15585,0.001788,172.31.47.0-255,66,276,92,276
15586,0.0,74.125.68.0-255,153,153,92,279241
15587,1.7e-05,172.31.47.0-255,66,219,92,279241
15588,2.3e-05,74.125.68.0-255,1484,1703,92,279241
15589,2.7e-05,172.31.47.0-255,66,1769,92,279241
15590,7.1e-05,74.125.68.0-255,2902,4671,92,279241
15591,7.6e-05,172.31.47.0-255,66,4737,92,279241
15592,7.9e-05,74.125.68.0-255,1484,6221,92,279241
15593,8.1e-05,172.31.47.0-255,66,6287,92,279241
15594,8.6e-05,74.125.68.0-255,2902,9189,92,279241
15595,8.9e-05,172.31.47.0-255,66,9255,92,279241
15596,0.000117,74.125.68.0-255,4891,14146,92,279241
15597,0.000123,172.31.47.0-255,66,14212,92,279241
15598,0.000222,74.125.68.0-255,1484,15696,92,279241
15599,0.000226,172.31.47.0-255,66,15762,92,279241
15600,0.000232,74.125.68.0-255,2902,18664,92,279241
15601,0.000233,172.31.47.0-255,66,18730,92,279241
15602,0.00024,74.125.68.0-255,5738,24468,92,279241
15603,0.000249,172.31.47.0-255,66,24534,92,279241
15604,0.000254,74.125.68.0-255,4320,28854,92,279241
15605,0.000256,172.31.47.0-255,66,28920,92,279241
15606,0.000289,74.125.68.0-255,5379,34299,92,279241
15607,0.000293,172.31.47.0-255,66,34365,92,279241
15608,0.000333,172.31.47.0-255,66,34431,92,279241
15609,0.00034,74.125.68.0-255,7156,41587,92,279241
15610,0.000342,172.31.47.0-255,66,41653,92,279241
15611,0.000362,74.125.68.0-255,2902,44555,92,279241
15612,0.000364,172.31.47.0-255,66,44621,92,279241
15613,0.000374,172.31.47.0-255,66,44687,92,279241
15614,0.000405,74.125.68.0-255,2563,47250,92,279241
15615,0.000407,172.31.47.0-255,66,47316,92,279241
15616,0.000836,74.125.68.0-255,329,47645,92,279241
15617,0.001088,74.125.68.0-255,1484,49129,92,279241
15618,0.001095,172.31.47.0-255,66,49195,92,279241
15619,0.0011,74.125.68.0-255,2902,52097,92,279241
15620,0.001102,172.31.47.0-255,66,52163,92,279241
15621,0.001107,74.125.68.0-255,2902,55065,92,279241
15622,0.001114,172.31.47.0-255,66,55131,92,279241
15623,0.001118,74.125.68.0-255,2902,58033,92,279241
15624,0.00112,172.31.47.0-255,66,58099,92,279241
15625,0.001149,74.125.68.0-255,1484,59583,92,279241
15626,0.00116,172.31.47.0-255,66,59649,92,279241
15627,0.001167,74.125.68.0-255,5738,65387,92,279241
15628,0.001169,172.31.47.0-255,66,65453,92,279241
15629,0.001184,74.125.68.0-255,4320,69773,92,279241
15630,0.001186,172.31.47.0-255,66,69839,92,279241
15631,0.001218,74.125.68.0-255,2902,72741,92,279241
15632,0.001221,172.31.47.0-255,66,72807,92,279241
15633,0.001224,74.125.68.0-255,766,73573,92,279241
15634,0.001457,74.125.68.0-255,1484,75057,92,279241
15635,0.001461,172.31.47.0-255,66,75123,92,279241
15636,0.00148,74.125.68.0-255,2902,78025,92,279241
15637,0.001482,172.31.47.0-255,66,78091,92,279241
15638,0.001485,74.125.68.0-255,1484,79575,92,279241
15639,0.001512,74.125.68.0-255,4320,83895,92,279241
15640,0.001514,172.31.47.0-255,66,83961,92,279241
15641,0.001521,74.125.68.0-255,6248,90209,92,279241
15642,0.001523,172.31.47.0-255,66,90275,92,279241
15643,0.00161,74.125.68.0-255,1484,91759,92,279241
15644,0.001627,74.125.68.0-255,1484,93243,92,279241
15645,0.001629,172.31.47.0-255,66,93309,92,279241
15646,0.001651,74.125.68.0-255,1484,94793,92,279241
15647,0.001657,74.125.68.0-255,5738,100531,92,279241
15648,0.001659,172.31.47.0-255,66,100597,92,279241
15649,0.001663,74.125.68.0-255,2902,103499,92,279241
15650,0.001665,172.31.47.0-255,66,103565,92,279241
15651,0.001693,74.125.68.0-255,5738,109303,92,279241
15652,0.001695,172.31.47.0-255,66,109369,92,279241
15653,0.001706,172.31.47.0-255,66,109435,92,279241
15654,0.001713,74.125.68.0-255,1484,110919,92,279241
15655,0.001734,74.125.68.0-255,3602,114521,92,279241
15656,0.001736,172.31.47.0-255,66,114587,92,279241
15657,0.001758,74.125.68.0-255,1484,116071,92,279241
15658,0.00177,74.125.68.0-255,2902,118973,92,279241
15659,0.001772,172.31.47.0-255,66,119039,92,279241
15660,0.001794,74.125.68.0-255,2902,121941,92,279241
15661,0.001796,172.31.47.0-255,66,122007,92,279241
15662,0.001813,74.125.68.0-255,2902,124909,92,279241
15663,0.001815,172.31.47.0-255,66,124975,92,279241
15664,0.001822,74.125.68.0-255,7156,132131,92,279241
15665,0.001824,172.31.47.0-255,66,132197,92,279241
15666,0.001827,74.125.68.0-255,1484,133681,92,279241
15667,0.001861,74.125.68.0-255,7156,140837,92,279241
15668,0.001864,172.31.47.0-255,66,140903,92,279241
15669,0.00191,74.125.68.0-255,7156,148059,92,279241
15670,0.001913,172.31.47.0-255,66,148125,92,279241
15671,0.001936,74.125.68.0-255,766,148891,92,279241
15672,0.002151,74.125.68.0-255,1484,150375,92,279241
15673,0.002154,172.31.47.0-255,66,150441,92,279241
15674,0.002176,74.125.68.0-255,1484,151925,92,279241
15675,0.00218,74.125.68.0-255,2902,154827,92,279241
15676,0.002182,172.31.47.0-255,66,154893,92,279241
15677,0.002213,74.125.68.0-255,5738,160631,92,279241
15678,0.002215,172.31.47.0-255,66,160697,92,279241
15679,0.002219,74.125.68.0-255,2902,163599,92,279241
15680,0.002221,172.31.47.0-255,66,163665,92,279241
15681,0.002255,74.125.68.0-255,5738,169403,92,279241
15682,0.002257,172.31.47.0-255,66,169469,92,279241
15683,0.002268,172.31.47.0-255,66,169535,92,279241
15684,0.002277,74.125.68.0-255,3602,173137,92,279241
15685,0.002279,172.31.47.0-255,66,173203,92,279241
15686,0.002361,74.125.68.0-255,1484,174687,92,279241
15687,0.002372,74.125.68.0-255,2902,177589,92,279241
15688,0.002374,172.31.47.0-255,66,177655,92,279241
15689,0.002399,74.125.68.0-255,5738,183393,92,279241
15690,0.002401,172.31.47.0-255,66,183459,92,279241
15691,0.002427,74.125.68.0-255,4320,187779,92,279241
15692,0.002429,172.31.47.0-255,66,187845,92,279241
15693,0.002457,74.125.68.0-255,5738,193583,92,279241
15694,0.00246,172.31.47.0-255,66,193649,92,279241
15695,0.002469,172.31.47.0-255,66,193715,92,279241
15696,0.0025,74.125.68.0-255,2902,196617,92,279241
15697,0.002503,172.31.47.0-255,66,196683,92,279241
15698,0.002508,74.125.68.0-255,2184,198867,92,279241
15699,0.00251,172.31.47.0-255,66,198933,92,279241
15700,0.002946,74.125.68.0-255,1484,200417,92,279241
15701,0.002964,74.125.68.0-255,2902,203319,92,279241
15702,0.002968,172.31.47.0-255,66,203385,92,279241
15703,0.002971,74.125.68.0-255,1484,204869,92,279241
15704,0.002991,74.125.68.0-255,2902,207771,92,279241
15705,0.002995,172.31.47.0-255,66,207837,92,279241
15706,0.003001,74.125.68.0-255,5738,213575,92,279241
15707,0.003003,172.31.47.0-255,66,213641,92,279241
15708,0.003041,74.125.68.0-255,2902,216543,92,279241
15709,0.003044,172.31.47.0-255,66,216609,92,279241
15710,0.003079,172.31.47.0-255,66,216675,92,279241
15711,0.003084,74.125.68.0-255,2902,219577,92,279241
15712,0.003086,172.31.47.0-255,66,219643,92,279241
15713,0.003125,74.125.68.0-255,1484,221127,92,279241
15714,0.003128,172.31.47.0-255,66,221193,92,279241
15715,0.003151,172.31.47.0-255,66,221259,92,279241
15716,0.003154,74.125.68.0-255,1484,222743,92,279241
15717,0.003181,172.31.47.0-255,66,222809,92,279241
15718,0.003185,74.125.68.0-255,2184,224993,92,279241
15719,0.003187,172.31.47.0-255,66,225059,92,279241
15720,0.003276,74.125.68.0-255,1484,226543,92,279241
15721,0.003291,74.125.68.0-255,2902,229445,92,279241
15722,0.003294,172.31.47.0-255,66,229511,92,279241
15723,0.003329,74.125.68.0-255,2902,232413,92,279241
15724,0.003332,172.31.47.0-255,66,232479,92,279241
15725,0.00336,74.125.68.0-255,2902,235381,92,279241
15726,0.003364,172.31.47.0-255,66,235447,92,279241
15727,0.003381,172.31.47.0-255,66,235513,92,279241
15728,0.003386,74.125.68.0-255,2902,238415,92,279241
15729,0.003389,172.31.47.0-255,66,238481,92,279241
15730,0.00343,172.31.47.0-255,66,238547,92,279241
15731,0.003435,74.125.68.0-255,2184,240731,92,279241
15732,0.003438,74.125.68.0-255,2902,243633,92,279241
15733,0.003439,172.31.47.0-255,66,243699,92,279241
15734,0.003442,74.125.68.0-255,2902,246601,92,279241
15735,0.003442,172.31.47.0-255,66,246667,92,279241
15736,0.003445,172.31.47.0-255,66,246733,92,279241
15737,0.003484,74.125.68.0-255,4320,251053,92,279241
15738,0.003488,172.31.47.0-255,66,251119,92,279241
15739,0.003493,74.125.68.0-255,4320,255439,92,279241
15740,0.003495,172.31.47.0-255,66,255505,92,279241
15741,0.003507,74.125.68.0-255,5738,261243,92,279241
15742,0.00351,172.31.47.0-255,66,261309,92,279241
15743,0.00352,172.31.47.0-255,66,261375,92,279241
15744,0.003587,74.125.68.0-255,6438,267813,92,279241
15745,0.003591,172.31.47.0-255,66,267879,92,279241
15746,0.003597,74.125.68.0-255,7156,275035,92,279241
15747,0.0036,172.31.47.0-255,66,275101,92,279241
15748,0.003621,172.31.47.0-255,66,275167,92,279241
15749,0.00366,74.125.68.0-255,1484,276651,92,279241
15750,0.003665,172.31.47.0-255,66,276717,92,279241
15751,0.003673,74.125.68.0-255,1484,278201,92,279241
15752,0.003676,74.125.68.0-255,698,278899,92,279241
15753,0.00369,172.31.47.0-255,66,278965,92,279241
15754,0.003741,74.125.68.0-255,105,279070,92,279241
15755,0.009709,172.31.47.0-255,66,279136,92,279241
15756,0.009736,172.31.47.0-255,105,279241,92,279241
15757,0.0,172.31.47.0-255,66,66,92,66
15758,0.0,172.31.47.0-255,105,105,92,105
15759,0.0,172.31.47.0-255,105,105,92,105
15760,0.0,172.217.194.0-255,153,153,92,96832
15761,3.2e-05,172.31.47.0-255,66,219,92,96832
15762,4e-05,172.217.194.0-255,1484,1703,92,96832
15763,4.4e-05,172.31.47.0-255,66,1769,92,96832
15764,4.9e-05,172.217.194.0-255,2902,4671,92,96832
15765,5.1e-05,172.31.47.0-255,66,4737,92,96832
15766,5.7e-05,172.217.194.0-255,7156,11893,92,96832
15767,6e-05,172.31.47.0-255,66,11959,92,96832
15768,6.3e-05,172.217.194.0-255,2215,14174,92,96832
15769,6.6e-05,172.31.47.0-255,66,14240,92,96832
15770,0.000165,172.217.194.0-255,1484,15724,92,96832
15771,0.000169,172.31.47.0-255,66,15790,92,96832
15772,0.000175,172.217.194.0-255,2902,18692,92,96832
15773,0.000177,172.31.47.0-255,66,18758,92,96832
15774,0.000185,172.217.194.0-255,5738,24496,92,96832
15775,0.000187,172.31.47.0-255,66,24562,92,96832
15776,0.000245,172.217.194.0-255,6797,31359,92,96832
15777,0.000249,172.31.47.0-255,66,31425,92,96832
15778,0.0003,172.217.194.0-255,1484,32909,92,96832
15779,0.000304,172.31.47.0-255,66,32975,92,96832
15780,0.000309,172.217.194.0-255,2902,35877,92,96832
15781,0.000311,172.31.47.0-255,66,35943,92,96832
15782,0.000332,172.217.194.0-255,5738,41681,92,96832
15783,0.000336,172.31.47.0-255,66,41747,92,96832
15784,0.000372,172.31.47.0-255,66,41813,92,96832
15785,0.000397,172.217.194.0-255,5379,47192,92,96832
15786,0.0004,172.31.47.0-255,66,47258,92,96832
15787,0.000411,172.31.47.0-255,66,47324,92,96832
15788,0.000564,172.217.194.0-255,364,47688,92,96832
15789,0.000568,172.31.47.0-255,66,47754,92,96832
15790,0.001929,172.217.194.0-255,1484,49238,92,96832
15791,0.00194,172.217.194.0-255,2902,52140,92,96832
15792,0.001944,172.31.47.0-255,66,52206,92,96832
15793,0.001952,172.217.194.0-255,5738,57944,92,96832
15794,0.001954,172.31.47.0-255,66,58010,92,96832
15795,0.001987,172.31.47.0-255,66,58076,92,96832
15796,0.002014,172.31.47.0-255,66,58142,92,96832
15797,0.002032,172.217.194.0-255,2902,61044,92,96832
15798,0.002034,172.31.47.0-255,66,61110,92,96832
15799,0.002045,172.217.194.0-255,2184,63294,92,96832
15800,0.002047,172.31.47.0-255,66,63360,92,96832
15801,0.002249,172.217.194.0-255,1484,64844,92,96832
15802,0.00229,172.217.194.0-255,2902,67746,92,96832
15803,0.002293,172.31.47.0-255,66,67812,92,96832
15804,0.002298,172.217.194.0-255,5738,73550,92,96832
15805,0.0023,172.31.47.0-255,66,73616,92,96832
15806,0.002306,172.217.194.0-255,5738,79354,92,96832
15807,0.002308,172.31.47.0-255,66,79420,92,96832
15808,0.00456,172.217.194.0-255,5738,85158,92,96832
15809,0.004565,172.31.47.0-255,66,85224,92,96832
15810,0.006831,172.217.194.0-255,5738,90962,92,96832
15811,0.006836,172.31.47.0-255,66,91028,92,96832
15812,0.0091,172.217.194.0-255,5738,96766,92,96832
15813,0.009105,172.31.47.0-255,66,96832,92,96832
15814,0.0,172.217.194.0-255,153,153,92,107148
15815,2.6e-05,172.31.47.0-255,66,219,92,107148
15816,3e-05,172.217.194.0-255,1484,1703,92,107148
15817,3.4e-05,172.31.47.0-255,66,1769,92,107148
15818,3.9e-05,172.217.194.0-255,2902,4671,92,107148
15819,4.7e-05,172.31.47.0-255,66,4737,92,107148
15820,5.7e-05,172.217.194.0-255,2902,7639,92,107148
15821,5.9e-05,172.31.47.0-255,66,7705,92,107148
15822,8.7e-05,172.217.194.0-255,4320,12025,92,107148
15823,8.9e-05,172.31.47.0-255,66,12091,92,107148
15824,9.6e-05,172.217.194.0-255,1484,13575,92,107148
15825,9.9e-05,172.31.47.0-255,66,13641,92,107148
15826,0.000138,172.31.47.0-255,66,13707,92,107148
15827,0.00015,172.31.47.0-255,66,13773,92,107148
15828,0.000186,172.31.47.0-255,66,13839,92,107148
15829,0.000215,172.217.194.0-255,2184,16023,92,107148
15830,0.000217,172.31.47.0-255,66,16089,92,107148
15831,0.00022,172.217.194.0-255,1484,17573,92,107148
15832,0.000223,172.31.47.0-255,66,17639,92,107148
15833,0.000228,172.217.194.0-255,2902,20541,92,107148
15834,0.000235,172.31.47.0-255,66,20607,92,107148
15835,0.000239,172.217.194.0-255,4320,24927,92,107148
15836,0.000242,172.31.47.0-255,66,24993,92,107148
15837,0.000275,172.217.194.0-255,1484,26477,92,107148
15838,0.000277,172.31.47.0-255,66,26543,92,107148
15839,0.000284,172.217.194.0-255,6797,33340,92,107148
15840,0.000287,172.31.47.0-255,66,33406,92,107148
15841,0.000321,172.217.194.0-255,1484,34890,92,107148
15842,0.000324,172.31.47.0-255,66,34956,92,107148
15843,0.000338,172.217.194.0-255,2902,37858,92,107148
15844,0.00034,172.31.47.0-255,66,37924,92,107148
15845,0.000352,172.217.194.0-255,5738,43662,92,107148
15846,0.000354,172.31.47.0-255,66,43728,92,107148
15847,0.000363,172.217.194.0-255,1484,45212,92,107148
15848,0.000394,172.217.194.0-255,5958,51170,92,107148
15849,0.000398,172.31.47.0-255,66,51236,92,107148
15850,0.000408,172.31.47.0-255,66,51302,92,107148
15851,0.000454,172.31.47.0-255,66,51368,92,107148
15852,0.000922,172.217.194.0-255,1484,52852,92,107148
15853,0.000928,172.217.194.0-255,2902,55754,92,107148
15854,0.000931,172.31.47.0-255,66,55820,92,107148
15855,0.000959,172.217.194.0-255,5738,61558,92,107148
15856,0.000962,172.31.47.0-255,66,61624,92,107148
15857,0.000965,172.217.194.0-255,1484,63108,92,107148
15858,0.000997,172.31.47.0-255,66,63174,92,107148
15859,0.001003,172.217.194.0-255,7156,70330,92,107148
15860,0.001005,172.31.47.0-255,66,70396,92,107148
15861,0.001037,172.217.194.0-255,3602,73998,92,107148
15862,0.001044,172.31.47.0-255,66,74064,92,107148
15863,0.001148,172.217.194.0-255,1484,75548,92,107148
15864,0.001153,172.217.194.0-255,2902,78450,92,107148
15865,0.001155,172.31.47.0-255,66,78516,92,107148
15866,0.001207,172.217.194.0-255,5738,84254,92,107148
15867,0.001211,172.31.47.0-255,66,84320,92,107148
15868,0.001223,172.31.47.0-255,66,84386,92,107148
15869,0.001237,172.31.47.0-255,66,84452,92,107148
15870,0.001239,172.217.194.0-255,766,85218,92,107148
15871,0.001412,172.31.47.0-255,66,85284,92,107148
15872,0.003283,172.217.194.0-255,4320,89604,92,107148
15873,0.003288,172.31.47.0-255,66,89670,92,107148
15874,0.003451,172.217.194.0-255,1484,91154,92,107148
15875,0.005357,172.217.194.0-255,4320,95474,92,107148
15876,0.005364,172.31.47.0-255,66,95540,92,107148
15877,0.007391,172.217.194.0-255,5738,101278,92,107148
15878,0.007399,172.31.47.0-255,66,101344,92,107148
15879,0.009422,172.217.194.0-255,5738,107082,92,107148
15880,0.00943,172.31.47.0-255,66,107148,92,107148
15881,0.0,104.244.42.0-255,66,66,92,66
15882,0.0,172.217.194.0-255,153,153,92,125370
15883,3.2e-05,172.31.47.0-255,66,219,92,125370
15884,3.9e-05,172.217.194.0-255,1484,1703,92,125370
15885,4.4e-05,172.31.47.0-255,66,1769,92,125370
15886,4.9e-05,172.217.194.0-255,2902,4671,92,125370
15887,5.1e-05,172.31.47.0-255,66,4737,92,125370
15888,5.7e-05,172.217.194.0-255,7156,11893,92,125370
15889,6e-05,172.31.47.0-255,66,11959,92,125370
15890,6.6e-05,172.217.194.0-255,5738,17697,92,125370
15891,6.8e-05,172.31.47.0-255,66,17763,92,125370
15892,9.3e-05,172.217.194.0-255,719,18482,92,125370
15893,9.5e-05,172.31.47.0-255,66,18548,92,125370
15894,0.000125,172.217.194.0-255,4320,22868,92,125370
15895,0.000128,172.31.47.0-255,66,22934,92,125370
15896,0.000156,172.31.47.0-255,66,23000,92,125370
15897,0.00022,172.217.194.0-255,1484,24484,92,125370
15898,0.000225,172.31.47.0-255,66,24550,92,125370
15899,0.00023,172.217.194.0-255,2902,27452,92,125370
15900,0.000232,172.31.47.0-255,66,27518,92,125370
15901,0.000235,172.217.194.0-255,1484,29002,92,125370
15902,0.000237,172.31.47.0-255,66,29068,92,125370
15903,0.000259,172.217.194.0-255,4320,33388,92,125370
15904,0.000262,172.31.47.0-255,66,33454,92,125370
15905,0.000269,172.217.194.0-255,4320,37774,92,125370
15906,0.000271,172.31.47.0-255,66,37840,92,125370
15907,0.00029,172.217.194.0-255,2543,40383,92,125370
15908,0.000292,172.31.47.0-255,66,40449,92,125370
15909,0.000299,172.217.194.0-255,7156,47605,92,125370
15910,0.000302,172.31.47.0-255,66,47671,92,125370
15911,0.000347,172.217.194.0-255,2902,50573,92,125370
15912,0.000352,172.31.47.0-255,66,50639,92,125370
15913,0.000376,172.217.194.0-255,6797,57436,92,125370
15914,0.000379,172.31.47.0-255,66,57502,92,125370
15915,0.000536,172.217.194.0-255,360,57862,92,125370
15916,0.000539,172.31.47.0-255,66,57928,92,125370
15917,0.000642,172.217.194.0-255,384,58312,92,125370
15918,0.000645,172.31.47.0-255,66,58378,92,125370
15919,0.000917,172.217.194.0-255,1484,59862,92,125370
15920,0.000921,172.31.47.0-255,66,59928,92,125370
15921,0.000929,172.217.194.0-255,2902,62830,92,125370
15922,0.000931,172.31.47.0-255,66,62896,92,125370
15923,0.000938,172.217.194.0-255,5738,68634,92,125370
15924,0.00094,172.31.47.0-255,66,68700,92,125370
15925,0.000962,172.217.194.0-255,4320,73020,92,125370
15926,0.000964,172.31.47.0-255,66,73086,92,125370
15927,0.001442,172.217.194.0-255,1484,74570,92,125370
15928,0.00145,172.217.194.0-255,2902,77472,92,125370
15929,0.001453,172.217.194.0-255,1484,78956,92,125370
15930,0.001467,172.217.194.0-255,4320,83276,92,125370
15931,0.001523,172.217.194.0-255,766,84042,92,125370
15932,0.001698,172.217.194.0-255,1484,85526,92,125370
15933,0.001702,172.217.194.0-255,2902,88428,92,125370
15934,0.001716,172.217.194.0-255,2902,91330,92,125370
15935,0.001728,172.217.194.0-255,2902,94232,92,125370
15936,0.001802,172.217.194.0-255,4320,98552,92,125370
15937,0.00182,172.217.194.0-255,6438,104990,92,125370
15938,0.001914,172.217.194.0-255,1484,106474,92,125370
15939,0.001918,172.217.194.0-255,2902,109376,92,125370
15940,0.001949,172.217.194.0-255,5738,115114,92,125370
15941,0.001989,172.217.194.0-255,1484,116598,92,125370
15942,0.002005,172.217.194.0-255,2902,119500,92,125370
15943,0.005439,172.31.47.0-255,66,119566,92,125370
15944,0.00777,172.217.194.0-255,5738,125304,92,125370
15945,0.007777,172.31.47.0-255,66,125370,92,125370
15946,0.0,74.125.68.0-255,153,153,92,391168
15947,2.1e-05,172.31.47.0-255,66,219,92,391168
15948,2.8e-05,74.125.68.0-255,1484,1703,92,391168
15949,3.2e-05,172.31.47.0-255,66,1769,92,391168
15950,3.7e-05,74.125.68.0-255,2902,4671,92,391168
15951,4.5e-05,172.31.47.0-255,66,4737,92,391168
15952,4.8e-05,74.125.68.0-255,1484,6221,92,391168
15953,5e-05,172.31.47.0-255,66,6287,92,391168
15954,5.5e-05,74.125.68.0-255,2902,9189,92,391168
15955,5.7e-05,172.31.47.0-255,66,9255,92,391168
15956,9.9e-05,74.125.68.0-255,2902,12157,92,391168
15957,0.000102,172.31.47.0-255,66,12223,92,391168
15958,0.000125,74.125.68.0-255,1997,14220,92,391168
15959,0.000128,172.31.47.0-255,66,14286,92,391168
15960,0.000857,74.125.68.0-255,1484,15770,92,391168
15961,0.000863,172.31.47.0-255,66,15836,92,391168
15962,0.000872,74.125.68.0-255,2902,18738,92,391168
15963,0.000874,172.31.47.0-255,66,18804,92,391168
15964,0.00092,74.125.68.0-255,1484,20288,92,391168
15965,0.000923,172.31.47.0-255,66,20354,92,391168
15966,0.000949,74.125.68.0-255,4320,24674,92,391168
15967,0.000952,172.31.47.0-255,66,24740,92,391168
15968,0.000959,74.125.68.0-255,6797,31537,92,391168
15969,0.000962,172.31.47.0-255,66,31603,92,391168
15970,0.000986,74.125.68.0-255,1484,33087,92,391168
15971,0.000988,172.31.47.0-255,66,33153,92,391168
15972,0.000993,74.125.68.0-255,2902,36055,92,391168
15973,0.000995,172.31.47.0-255,66,36121,92,391168
15974,0.001023,74.125.68.0-255,1484,37605,92,391168
15975,0.001025,172.31.47.0-255,66,37671,92,391168
15976,0.00103,74.125.68.0-255,2902,40573,92,391168
15977,0.001032,172.31.47.0-255,66,40639,92,391168
15978,0.001057,74.125.68.0-255,5738,46377,92,391168
15979,0.00106,172.31.47.0-255,66,46443,92,391168
15980,0.001063,74.125.68.0-255,1484,47927,92,391168
15981,0.001111,74.125.68.0-255,1125,49052,92,391168
15982,0.001113,172.31.47.0-255,66,49118,92,391168
15983,0.001327,74.125.68.0-255,1484,50602,92,391168
15984,0.001343,74.125.68.0-255,1484,52086,92,391168
15985,0.001346,172.31.47.0-255,66,52152,92,391168
15986,0.001368,74.125.68.0-255,1484,53636,92,391168
15987,0.001371,74.125.68.0-255,1484,55120,92,391168
15988,0.001373,172.31.47.0-255,66,55186,92,391168
15989,0.001395,74.125.68.0-255,4320,59506,92,391168
15990,0.001398,172.31.47.0-255,66,59572,92,391168
15991,0.001419,74.125.68.0-255,1484,61056,92,391168
15992,0.001424,74.125.68.0-255,4320,65376,92,391168
15993,0.001426,172.31.47.0-255,66,65442,92,391168
15994,0.001453,74.125.68.0-255,1125,66567,92,391168
15995,0.002213,74.125.68.0-255,1484,68051,92,391168
15996,0.002216,172.31.47.0-255,66,68117,92,391168
15997,0.002233,74.125.68.0-255,2902,71019,92,391168
15998,0.002235,172.31.47.0-255,66,71085,92,391168
15999,0.002261,74.125.68.0-255,5738,76823,92,391168
16000,0.002264,172.31.47.0-255,66,76889,92,391168
16001,0.002268,74.125.68.0-255,4320,81209,92,391168
16002,0.00227,172.31.47.0-255,66,81275,92,391168
16003,0.002273,74.125.68.0-255,1484,82759,92,391168
16004,0.002298,74.125.68.0-255,4320,87079,92,391168
16005,0.0023,172.31.47.0-255,66,87145,92,391168
16006,0.002347,172.31.47.0-255,66,87211,92,391168
16007,0.002351,74.125.68.0-255,2184,89395,92,391168
16008,0.002352,172.31.47.0-255,66,89461,92,391168
16009,0.002486,74.125.68.0-255,1484,90945,92,391168
16010,0.002503,74.125.68.0-255,2902,93847,92,391168
16011,0.002506,172.31.47.0-255,66,93913,92,391168
16012,0.002532,74.125.68.0-255,5738,99651,92,391168
16013,0.002534,172.31.47.0-255,66,99717,92,391168
16014,0.002537,74.125.68.0-255,1484,101201,92,391168
16015,0.002599,74.125.68.0-255,2902,104103,92,391168
16016,0.002601,172.31.47.0-255,66,104169,92,391168
16017,0.002629,74.125.68.0-255,5738,109907,92,391168
16018,0.002632,172.31.47.0-255,66,109973,92,391168
16019,0.002634,74.125.68.0-255,1484,111457,92,391168
16020,0.002654,74.125.68.0-255,2902,114359,92,391168
16021,0.002657,172.31.47.0-255,66,114425,92,391168
16022,0.002697,172.31.47.0-255,66,114491,92,391168
16023,0.002699,74.125.68.0-255,766,115257,92,391168
16024,0.002735,172.31.47.0-255,66,115323,92,391168
16025,0.002747,172.31.47.0-255,66,115389,92,391168
16026,0.002755,74.125.68.0-255,2902,118291,92,391168
16027,0.002757,172.31.47.0-255,66,118357,92,391168
16028,0.0028,74.125.68.0-255,2902,121259,92,391168
16029,0.002803,172.31.47.0-255,66,121325,92,391168
16030,0.002834,74.125.68.0-255,6438,127763,92,391168
16031,0.002836,172.31.47.0-255,66,127829,92,391168
16032,0.002903,74.125.68.0-255,1484,129313,92,391168
16033,0.00292,74.125.68.0-255,2902,132215,92,391168
16034,0.002924,172.31.47.0-255,66,132281,92,391168
16035,0.002953,74.125.68.0-255,2902,135183,92,391168
16036,0.002956,172.31.47.0-255,66,135249,92,391168
16037,0.002978,74.125.68.0-255,1484,136733,92,391168
16038,0.002984,74.125.68.0-255,5738,142471,92,391168
16039,0.002987,172.31.47.0-255,66,142537,92,391168
16040,0.003011,74.125.68.0-255,1484,144021,92,391168
16041,0.003014,74.125.68.0-255,1484,145505,92,391168
16042,0.003016,172.31.47.0-255,66,145571,92,391168
16043,0.003019,74.125.68.0-255,1484,147055,92,391168
16044,0.003037,74.125.68.0-255,1484,148539,92,391168
16045,0.003039,172.31.47.0-255,66,148605,92,391168
16046,0.003043,74.125.68.0-255,1484,150089,92,391168
16047,0.003062,74.125.68.0-255,1484,151573,92,391168
16048,0.003065,172.31.47.0-255,66,151639,92,391168
16049,0.00307,74.125.68.0-255,4320,155959,92,391168
16050,0.003072,172.31.47.0-255,66,156025,92,391168
16051,0.003102,74.125.68.0-255,2902,158927,92,391168
16052,0.003105,172.31.47.0-255,66,158993,92,391168
16053,0.00313,74.125.68.0-255,3602,162595,92,391168
16054,0.003133,172.31.47.0-255,66,162661,92,391168
16055,0.003374,74.125.68.0-255,647,163308,92,391168
16056,0.003417,74.125.68.0-255,1484,164792,92,391168
16057,0.003421,172.31.47.0-255,66,164858,92,391168
16058,0.00344,74.125.68.0-255,4320,169178,92,391168
16059,0.003442,172.31.47.0-255,66,169244,92,391168
16060,0.003445,74.125.68.0-255,1484,170728,92,391168
16061,0.003465,74.125.68.0-255,1484,172212,92,391168
16062,0.003466,172.31.47.0-255,66,172278,92,391168
16063,0.00349,74.125.68.0-255,1484,173762,92,391168
16064,0.003497,74.125.68.0-255,5738,179500,92,391168
16065,0.003499,172.31.47.0-255,66,179566,92,391168
16066,0.003502,74.125.68.0-255,1484,181050,92,391168
16067,0.003528,74.125.68.0-255,2902,183952,92,391168
16068,0.00353,172.31.47.0-255,66,184018,92,391168
16069,0.003554,74.125.68.0-255,1484,185502,92,391168
16070,0.00357,74.125.68.0-255,2902,188404,92,391168
16071,0.003572,172.31.47.0-255,66,188470,92,391168
16072,0.003577,74.125.68.0-255,4320,192790,92,391168
16073,0.003579,172.31.47.0-255,66,192856,92,391168
16074,0.003607,74.125.68.0-255,1484,194340,92,391168
16075,0.003612,74.125.68.0-255,3602,197942,92,391168
16076,0.003614,172.31.47.0-255,66,198008,92,391168
16077,0.003824,74.125.68.0-255,1484,199492,92,391168
16078,0.003852,74.125.68.0-255,2902,202394,92,391168
16079,0.003855,172.31.47.0-255,66,202460,92,391168
16080,0.003859,74.125.68.0-255,1484,203944,92,391168
16081,0.003881,74.125.68.0-255,1484,205428,92,391168
16082,0.003883,172.31.47.0-255,66,205494,92,391168
16083,0.003886,74.125.68.0-255,1484,206978,92,391168
16084,0.003913,74.125.68.0-255,1484,208462,92,391168
16085,0.003916,172.31.47.0-255,66,208528,92,391168
16086,0.00394,74.125.68.0-255,1484,210012,92,391168
16087,0.003946,74.125.68.0-255,5738,215750,92,391168
16088,0.003948,172.31.47.0-255,66,215816,92,391168
16089,0.003956,74.125.68.0-255,7156,222972,92,391168
16090,0.003957,172.31.47.0-255,66,223038,92,391168
16091,0.003964,74.125.68.0-255,1484,224522,92,391168
16092,0.003982,74.125.68.0-255,4320,228842,92,391168
16093,0.003985,172.31.47.0-255,66,228908,92,391168
16094,0.004011,74.125.68.0-255,3602,232510,92,391168
16095,0.004013,172.31.47.0-255,66,232576,92,391168
16096,0.004064,74.125.68.0-255,1484,234060,92,391168
16097,0.004082,74.125.68.0-255,2902,236962,92,391168
16098,0.004085,172.31.47.0-255,66,237028,92,391168
16099,0.004108,74.125.68.0-255,2902,239930,92,391168
16100,0.004111,172.31.47.0-255,66,239996,92,391168
16101,0.004127,74.125.68.0-255,2902,242898,92,391168
16102,0.004129,172.31.47.0-255,66,242964,92,391168
16103,0.004132,74.125.68.0-255,1484,244448,92,391168
16104,0.004156,74.125.68.0-255,4320,248768,92,391168
16105,0.004158,172.31.47.0-255,66,248834,92,391168
16106,0.004188,74.125.68.0-255,4320,253154,92,391168
16107,0.00419,172.31.47.0-255,66,253220,92,391168
16108,0.004195,74.125.68.0-255,4320,257540,92,391168
16109,0.004197,172.31.47.0-255,66,257606,92,391168
16110,0.004199,74.125.68.0-255,1484,259090,92,391168
16111,0.004227,74.125.68.0-255,7156,266246,92,391168
16112,0.004229,172.31.47.0-255,66,266312,92,391168
16113,0.004232,74.125.68.0-255,766,267078,92,391168
16114,0.004258,74.125.68.0-255,1484,268562,92,391168
16115,0.004261,172.31.47.0-255,66,268628,92,391168
16116,0.004288,74.125.68.0-255,1484,270112,92,391168
16117,0.004292,74.125.68.0-255,2902,273014,92,391168
16118,0.004294,172.31.47.0-255,66,273080,92,391168
16119,0.004297,74.125.68.0-255,1484,274564,92,391168
16120,0.004316,74.125.68.0-255,1484,276048,92,391168
16121,0.004318,172.31.47.0-255,66,276114,92,391168
16122,0.004346,74.125.68.0-255,2902,279016,92,391168
16123,0.004349,172.31.47.0-255,66,279082,92,391168
16124,0.004371,74.125.68.0-255,4320,283402,92,391168
16125,0.004374,172.31.47.0-255,66,283468,92,391168
16126,0.004399,74.125.68.0-255,1484,284952,92,391168
16127,0.004402,74.125.68.0-255,1484,286436,92,391168
16128,0.004404,172.31.47.0-255,66,286502,92,391168
16129,0.004409,74.125.68.0-255,4320,290822,92,391168
16130,0.004411,172.31.47.0-255,66,290888,92,391168
16131,0.004443,74.125.68.0-255,4320,295208,92,391168
16132,0.004445,172.31.47.0-255,66,295274,92,391168
16133,0.004453,74.125.68.0-255,6438,301712,92,391168
16134,0.004455,172.31.47.0-255,66,301778,92,391168
16135,0.004461,74.125.68.0-255,1484,303262,92,391168
16136,0.004464,74.125.68.0-255,1484,304746,92,391168
16137,0.004466,172.31.47.0-255,66,304812,92,391168
16138,0.004492,74.125.68.0-255,1484,306296,92,391168
16139,0.004498,74.125.68.0-255,4320,310616,92,391168
16140,0.0045,172.31.47.0-255,66,310682,92,391168
16141,0.004528,74.125.68.0-255,1484,312166,92,391168
16142,0.004531,74.125.68.0-255,1484,313650,92,391168
16143,0.004533,172.31.47.0-255,66,313716,92,391168
16144,0.004539,74.125.68.0-255,5738,319454,92,391168
16145,0.004541,172.31.47.0-255,66,319520,92,391168
16146,0.00457,74.125.68.0-255,7156,326676,92,391168
16147,0.004573,172.31.47.0-255,66,326742,92,391168
16148,0.004575,74.125.68.0-255,1484,328226,92,391168
16149,0.00458,74.125.68.0-255,4320,332546,92,391168
16150,0.004582,172.31.47.0-255,66,332612,92,391168
16151,0.004588,74.125.68.0-255,1484,334096,92,391168
16152,0.004607,74.125.68.0-255,2184,336280,92,391168
16153,0.004609,172.31.47.0-255,66,336346,92,391168
16154,0.004619,74.125.68.0-255,1484,337830,92,391168
16155,0.004635,74.125.68.0-255,1484,339314,92,391168
16156,0.004637,172.31.47.0-255,66,339380,92,391168
16157,0.004667,74.125.68.0-255,4320,343700,92,391168
16158,0.00467,172.31.47.0-255,66,343766,92,391168
16159,0.004675,74.125.68.0-255,4320,348086,92,391168
16160,0.004677,172.31.47.0-255,66,348152,92,391168
16161,0.004682,74.125.68.0-255,4320,352472,92,391168
16162,0.004689,172.31.47.0-255,66,352538,92,391168
16163,0.004692,74.125.68.0-255,1484,354022,92,391168
16164,0.004749,74.125.68.0-255,1484,355506,92,391168
16165,0.004751,172.31.47.0-255,66,355572,92,391168
16166,0.004758,74.125.68.0-255,5738,361310,92,391168
16167,0.00476,172.31.47.0-255,66,361376,92,391168
16168,0.004769,74.125.68.0-255,4320,365696,92,391168
16169,0.004771,172.31.47.0-255,66,365762,92,391168
16170,0.004773,74.125.68.0-255,1484,367246,92,391168
16171,0.004778,74.125.68.0-255,3602,370848,92,391168
16172,0.00478,172.31.47.0-255,66,370914,92,391168
16173,0.004805,74.125.68.0-255,1484,372398,92,391168
16174,0.004822,74.125.68.0-255,2902,375300,92,391168
16175,0.004825,172.31.47.0-255,66,375366,92,391168
16176,0.004849,74.125.68.0-255,4320,379686,92,391168
16177,0.004852,172.31.47.0-255,66,379752,92,391168
16178,0.004857,74.125.68.0-255,5738,385490,92,391168
16179,0.004859,172.31.47.0-255,66,385556,92,391168
16180,0.004886,74.125.68.0-255,2902,388458,92,391168
16181,0.004889,172.31.47.0-255,66,388524,92,391168
16182,0.004891,74.125.68.0-255,1484,390008,92,391168
16183,0.004893,74.125.68.0-255,892,390900,92,391168
16184,0.004895,172.31.47.0-255,66,390966,92,391168
16185,0.004898,74.125.68.0-255,97,391063,92,391168
16186,0.004951,74.125.68.0-255,105,391168,92,391168
16187,0.0,74.125.24.0-255,153,153,92,138097
16188,1.7e-05,172.31.47.0-255,66,219,92,138097
16189,2.3e-05,74.125.24.0-255,1484,1703,92,138097
16190,2.7e-05,172.31.47.0-255,66,1769,92,138097
16191,3.1e-05,74.125.24.0-255,2902,4671,92,138097
16192,3.4e-05,172.31.47.0-255,66,4737,92,138097
16193,6e-05,74.125.24.0-255,5738,10475,92,138097
16194,6.3e-05,172.31.47.0-255,66,10541,92,138097
16195,8.1e-05,74.125.24.0-255,1484,12025,92,138097
16196,8.4e-05,172.31.47.0-255,66,12091,92,138097
16197,8.8e-05,74.125.24.0-255,1949,14040,92,138097
16198,8.9e-05,172.31.47.0-255,66,14106,92,138097
16199,0.000556,74.125.24.0-255,1484,15590,92,138097
16200,0.000562,172.31.47.0-255,66,15656,92,138097
16201,0.00057,74.125.24.0-255,2902,18558,92,138097
16202,0.000571,172.31.47.0-255,66,18624,92,138097
16203,0.000577,74.125.24.0-255,4320,22944,92,138097
16204,0.000578,172.31.47.0-255,66,23010,92,138097
16205,0.000596,74.125.24.0-255,1484,24494,92,138097
16206,0.000599,172.31.47.0-255,66,24560,92,138097
16207,0.000603,74.125.24.0-255,2902,27462,92,138097
16208,0.000605,172.31.47.0-255,66,27528,92,138097
16209,0.000636,172.31.47.0-255,66,27594,92,138097
16210,0.000641,74.125.24.0-255,5738,33332,92,138097
16211,0.000643,172.31.47.0-255,66,33398,92,138097
16212,0.00066,74.125.24.0-255,2902,36300,92,138097
16213,0.000662,172.31.47.0-255,66,36366,92,138097
16214,0.000681,74.125.24.0-255,7156,43522,92,138097
16215,0.000684,172.31.47.0-255,66,43588,92,138097
16216,0.000718,172.31.47.0-255,66,43654,92,138097
16217,0.000827,74.125.24.0-255,397,44051,92,138097
16218,0.000844,74.125.24.0-255,112,44163,92,138097
16219,0.000956,74.125.24.0-255,1484,45647,92,138097
16220,0.000962,74.125.24.0-255,2902,48549,92,138097
16221,0.000992,74.125.24.0-255,5738,54287,92,138097
16222,0.001009,74.125.24.0-255,5738,60025,92,138097
16223,0.001035,74.125.24.0-255,7156,67181,92,138097
16224,0.001079,74.125.24.0-255,2184,69365,92,138097
16225,0.001121,74.125.24.0-255,1484,70849,92,138097
16226,0.001125,74.125.24.0-255,1484,72333,92,138097
16227,0.001136,74.125.24.0-255,1484,73817,92,138097
16228,0.001139,74.125.24.0-255,1484,75301,92,138097
16229,0.001159,74.125.24.0-255,4320,79621,92,138097
16230,0.001174,74.125.24.0-255,5738,85359,92,138097
16231,0.001194,74.125.24.0-255,7156,92515,92,138097
16232,0.001715,74.125.24.0-255,1484,93999,92,138097
16233,0.001722,74.125.24.0-255,2902,96901,92,138097
16234,0.001743,74.125.24.0-255,5738,102639,92,138097
16235,0.001749,74.125.24.0-255,4320,106959,92,138097
16236,0.001752,74.125.24.0-255,1484,108443,92,138097
16237,0.001765,74.125.24.0-255,2902,111345,92,138097
16238,0.001778,74.125.24.0-255,4320,115665,92,138097
16239,0.001793,74.125.24.0-255,7156,122821,92,138097
16240,0.001798,74.125.24.0-255,3602,126423,92,138097
16241,0.00361,172.31.47.0-255,66,126489,92,138097
16242,0.005994,74.125.24.0-255,5738,132227,92,138097
16243,0.006009,172.31.47.0-255,66,132293,92,138097
16244,0.008354,74.125.24.0-255,5738,138031,92,138097
16245,0.008366,172.31.47.0-255,66,138097,92,138097
16246,0.0,172.31.47.0-255,105,105,92,105
16247,0.0,172.31.47.0-255,66,66,92,66
16248,0.0,172.31.47.0-255,66,66,92,66
16249,0.0,74.125.24.0-255,153,153,92,229663
16250,1.2e-05,172.31.47.0-255,66,219,92,229663
16251,1.8e-05,74.125.24.0-255,1484,1703,92,229663
16252,2.2e-05,172.31.47.0-255,66,1769,92,229663
16253,2.7e-05,74.125.24.0-255,2902,4671,92,229663
16254,3.6e-05,172.31.47.0-255,66,4737,92,229663
16255,4.4e-05,74.125.24.0-255,7156,11893,92,229663
16256,4.6e-05,172.31.47.0-255,66,11959,92,229663
16257,6.9e-05,74.125.24.0-255,5738,17697,92,229663
16258,7.5e-05,172.31.47.0-255,66,17763,92,229663
16259,0.000111,172.31.47.0-255,66,17829,92,229663
16260,0.000115,74.125.24.0-255,2543,20372,92,229663
16261,0.000117,172.31.47.0-255,66,20438,92,229663
16262,0.000157,74.125.24.0-255,1484,21922,92,229663
16263,0.000159,172.31.47.0-255,66,21988,92,229663
16264,0.000164,74.125.24.0-255,2902,24890,92,229663
16265,0.000166,172.31.47.0-255,66,24956,92,229663
16266,0.000195,74.125.24.0-255,5738,30694,92,229663
16267,0.000198,172.31.47.0-255,66,30760,92,229663
16268,0.000231,172.31.47.0-255,66,30826,92,229663
16269,0.000234,74.125.24.0-255,1484,32310,92,229663
16270,0.000235,172.31.47.0-255,66,32376,92,229663
16271,0.000273,172.31.47.0-255,66,32442,92,229663
16272,0.000276,74.125.24.0-255,363,32805,92,229663
16273,0.000277,172.31.47.0-255,66,32871,92,229663
16274,0.000309,74.125.24.0-255,412,33283,92,229663
16275,0.000311,172.31.47.0-255,66,33349,92,229663
16276,0.000603,74.125.24.0-255,1484,34833,92,229663
16277,0.000608,172.31.47.0-255,66,34899,92,229663
16278,0.000613,74.125.24.0-255,2902,37801,92,229663
16279,0.000615,172.31.47.0-255,66,37867,92,229663
16280,0.000625,74.125.24.0-255,5738,43605,92,229663
16281,0.000628,172.31.47.0-255,66,43671,92,229663
16282,0.000634,74.125.24.0-255,7156,50827,92,229663
16283,0.000636,172.31.47.0-255,66,50893,92,229663
16284,0.000678,172.31.47.0-255,66,50959,92,229663
16285,0.000682,74.125.24.0-255,2184,53143,92,229663
16286,0.000683,172.31.47.0-255,66,53209,92,229663
16287,0.001212,74.125.24.0-255,1484,54693,92,229663
16288,0.001218,74.125.24.0-255,2902,57595,92,229663
16289,0.001221,172.31.47.0-255,66,57661,92,229663
16290,0.001252,74.125.24.0-255,5738,63399,92,229663
16291,0.001254,172.31.47.0-255,66,63465,92,229663
16292,0.00126,74.125.24.0-255,2902,66367,92,229663
16293,0.001261,172.31.47.0-255,66,66433,92,229663
16294,0.001275,172.31.47.0-255,66,66499,92,229663
16295,0.001303,74.125.24.0-255,1484,67983,92,229663
16296,0.001314,172.31.47.0-255,66,68049,92,229663
16297,0.001386,74.125.24.0-255,1484,69533,92,229663
16298,0.00139,74.125.24.0-255,1484,71017,92,229663
16299,0.001393,172.31.47.0-255,66,71083,92,229663
16300,0.001419,74.125.24.0-255,1484,72567,92,229663
16301,0.001425,74.125.24.0-255,5738,78305,92,229663
16302,0.001427,172.31.47.0-255,66,78371,92,229663
16303,0.001436,172.31.47.0-255,66,78437,92,229663
16304,0.001462,74.125.24.0-255,4320,82757,92,229663
16305,0.001465,172.31.47.0-255,66,82823,92,229663
16306,0.001476,172.31.47.0-255,66,82889,92,229663
16307,0.001536,74.125.24.0-255,2184,85073,92,229663
16308,0.001539,172.31.47.0-255,66,85139,92,229663
16309,0.001543,74.125.24.0-255,2902,88041,92,229663
16310,0.001545,172.31.47.0-255,66,88107,92,229663
16311,0.001552,74.125.24.0-255,7156,95263,92,229663
16312,0.001554,172.31.47.0-255,66,95329,92,229663
16313,0.001569,172.31.47.0-255,66,95395,92,229663
16314,0.001576,74.125.24.0-255,6438,101833,92,229663
16315,0.001578,172.31.47.0-255,66,101899,92,229663
16316,0.001607,74.125.24.0-255,5738,107637,92,229663
16317,0.001609,172.31.47.0-255,66,107703,92,229663
16318,0.001616,74.125.24.0-255,5738,113441,92,229663
16319,0.001618,172.31.47.0-255,66,113507,92,229663
16320,0.001649,74.125.24.0-255,1484,114991,92,229663
16321,0.001665,172.31.47.0-255,66,115057,92,229663
16322,0.001672,74.125.24.0-255,6438,121495,92,229663
16323,0.001675,172.31.47.0-255,66,121561,92,229663
16324,0.001697,74.125.24.0-255,1484,123045,92,229663
16325,0.001701,74.125.24.0-255,2902,125947,92,229663
16326,0.001703,172.31.47.0-255,66,126013,92,229663
16327,0.001734,74.125.24.0-255,5738,131751,92,229663
16328,0.001737,172.31.47.0-255,66,131817,92,229663
16329,0.001745,74.125.24.0-255,7156,138973,92,229663
16330,0.001747,172.31.47.0-255,66,139039,92,229663
16331,0.001787,74.125.24.0-255,5738,144777,92,229663
16332,0.00179,172.31.47.0-255,66,144843,92,229663
16333,0.001798,74.125.24.0-255,7156,151999,92,229663
16334,0.0018,172.31.47.0-255,66,152065,92,229663
16335,0.001805,74.125.24.0-255,3602,155667,92,229663
16336,0.001807,172.31.47.0-255,66,155733,92,229663
16337,0.001837,74.125.24.0-255,1484,157217,92,229663
16338,0.001849,74.125.24.0-255,2902,160119,92,229663
16339,0.001852,172.31.47.0-255,66,160185,92,229663
16340,0.001857,74.125.24.0-255,4320,164505,92,229663
16341,0.001859,172.31.47.0-255,66,164571,92,229663
16342,0.001893,172.31.47.0-255,66,164637,92,229663
16343,0.001936,172.31.47.0-255,66,164703,92,229663
16344,0.001967,74.125.24.0-255,1484,166187,92,229663
16345,0.001983,74.125.24.0-255,2902,169089,92,229663
16346,0.001986,172.31.47.0-255,66,169155,92,229663
16347,0.001993,74.125.24.0-255,5738,174893,92,229663
16348,0.001995,172.31.47.0-255,66,174959,92,229663
16349,0.002033,74.125.24.0-255,7156,182115,92,229663
16350,0.002036,172.31.47.0-255,66,182181,92,229663
16351,0.002055,172.31.47.0-255,66,182247,92,229663
16352,0.002059,74.125.24.0-255,2184,184431,92,229663
16353,0.00206,172.31.47.0-255,66,184497,92,229663
16354,0.002105,74.125.24.0-255,2902,187399,92,229663
16355,0.002108,172.31.47.0-255,66,187465,92,229663
16356,0.002116,74.125.24.0-255,7156,194621,92,229663
16357,0.002118,172.31.47.0-255,66,194687,92,229663
16358,0.002124,74.125.24.0-255,5738,200425,92,229663
16359,0.002126,172.31.47.0-255,66,200491,92,229663
16360,0.002172,172.31.47.0-255,66,200557,92,229663
16361,0.002204,74.125.24.0-255,5738,206295,92,229663
16362,0.002207,172.31.47.0-255,66,206361,92,229663
16363,0.002212,74.125.24.0-255,3602,209963,92,229663
16364,0.002215,172.31.47.0-255,66,210029,92,229663
16365,0.00222,74.125.24.0-255,4320,214349,92,229663
16366,0.002222,172.31.47.0-255,66,214415,92,229663
16367,0.002227,74.125.24.0-255,2902,217317,92,229663
16368,0.002229,172.31.47.0-255,66,217383,92,229663
16369,0.00224,172.31.47.0-255,66,217449,92,229663
16370,0.002285,172.31.47.0-255,66,217515,92,229663
16371,0.002349,74.125.24.0-255,1484,218999,92,229663
16372,0.002369,74.125.24.0-255,2902,221901,92,229663
16373,0.002373,172.31.47.0-255,66,221967,92,229663
16374,0.002379,74.125.24.0-255,5738,227705,92,229663
16375,0.002381,172.31.47.0-255,66,227771,92,229663
16376,0.002388,74.125.24.0-255,1484,229255,92,229663
16377,0.002419,172.31.47.0-255,66,229321,92,229663
16378,0.002455,74.125.24.0-255,105,229426,92,229663
16379,0.007501,172.31.47.0-255,66,229492,92,229663
16380,0.007541,172.31.47.0-255,105,229597,92,229663
16381,0.009872,74.125.24.0-255,66,229663,92,229663
16382,0.0,172.217.194.0-255,153,153,92,190489
16383,3.3e-05,172.31.47.0-255,66,219,92,190489
16384,4e-05,172.217.194.0-255,1484,1703,92,190489
16385,4.4e-05,172.31.47.0-255,66,1769,92,190489
16386,4.9e-05,172.217.194.0-255,2902,4671,92,190489
16387,5.1e-05,172.31.47.0-255,66,4737,92,190489
16388,5.9e-05,172.217.194.0-255,7156,11893,92,190489
16389,6.1e-05,172.31.47.0-255,66,11959,92,190489
16390,8.5e-05,172.31.47.0-255,66,12025,92,190489
16391,0.000106,172.217.194.0-255,3546,15571,92,190489
16392,0.000108,172.31.47.0-255,66,15637,92,190489
16393,0.000145,172.217.194.0-255,6797,22434,92,190489
16394,0.000148,172.31.47.0-255,66,22500,92,190489
16395,0.000197,172.217.194.0-255,1484,23984,92,190489
16396,0.0002,172.31.47.0-255,66,24050,92,190489
16397,0.000205,172.217.194.0-255,2902,26952,92,190489
16398,0.000207,172.31.47.0-255,66,27018,92,190489
16399,0.000209,172.217.194.0-255,1484,28502,92,190489
16400,0.000211,172.31.47.0-255,66,28568,92,190489
16401,0.000224,172.217.194.0-255,4320,32888,92,190489
16402,0.000227,172.31.47.0-255,66,32954,92,190489
16403,0.000229,172.217.194.0-255,1484,34438,92,190489
16404,0.000231,172.31.47.0-255,66,34504,92,190489
16405,0.000246,172.217.194.0-255,7156,41660,92,190489
16406,0.000248,172.31.47.0-255,66,41726,92,190489
16407,0.000284,172.217.194.0-255,4320,46046,92,190489
16408,0.000288,172.31.47.0-255,66,46112,92,190489
16409,0.000318,172.31.47.0-255,66,46178,92,190489
16410,0.000393,172.217.194.0-255,367,46545,92,190489
16411,0.000396,172.31.47.0-255,66,46611,92,190489
16412,0.000628,172.217.194.0-255,1484,48095,92,190489
16413,0.000634,172.217.194.0-255,2902,50997,92,190489
16414,0.000637,172.31.47.0-255,66,51063,92,190489
16415,0.000644,172.217.194.0-255,4320,55383,92,190489
16416,0.000646,172.31.47.0-255,66,55449,92,190489
16417,0.000655,172.217.194.0-255,1484,56933,92,190489
16418,0.000669,172.217.194.0-255,5738,62671,92,190489
16419,0.000671,172.31.47.0-255,66,62737,92,190489
16420,0.000695,172.217.194.0-255,7156,69893,92,190489
16421,0.000698,172.31.47.0-255,66,69959,92,190489
16422,0.000708,172.31.47.0-255,66,70025,92,190489
16423,0.001855,172.217.194.0-255,1484,71509,92,190489
16424,0.001865,172.217.194.0-255,2902,74411,92,190489
16425,0.001868,172.31.47.0-255,66,74477,92,190489
16426,0.001891,172.217.194.0-255,5738,80215,92,190489
16427,0.001893,172.31.47.0-255,66,80281,92,190489
16428,0.001921,172.217.194.0-255,7156,87437,92,190489
16429,0.001923,172.31.47.0-255,66,87503,92,190489
16430,0.001925,172.217.194.0-255,1484,88987,92,190489
16431,0.001946,172.217.194.0-255,7156,96143,92,190489
16432,0.001948,172.31.47.0-255,66,96209,92,190489
16433,0.001953,172.217.194.0-255,5738,101947,92,190489
16434,0.001955,172.31.47.0-255,66,102013,92,190489
16435,0.001969,172.217.194.0-255,2184,104197,92,190489
16436,0.001971,172.31.47.0-255,66,104263,92,190489
16437,0.002063,172.217.194.0-255,1484,105747,92,190489
16438,0.002068,172.217.194.0-255,2902,108649,92,190489
16439,0.00207,172.31.47.0-255,66,108715,92,190489
16440,0.00209,172.217.194.0-255,2902,111617,92,190489
16441,0.002092,172.31.47.0-255,66,111683,92,190489
16442,0.002115,172.217.194.0-255,2902,114585,92,190489
16443,0.002117,172.31.47.0-255,66,114651,92,190489
16444,0.002127,172.31.47.0-255,66,114717,92,190489
16445,0.002151,172.217.194.0-255,4320,119037,92,190489
16446,0.002153,172.31.47.0-255,66,119103,92,190489
16447,0.002194,172.31.47.0-255,66,119169,92,190489
16448,0.002197,172.31.47.0-255,66,119235,92,190489
16449,0.002217,172.217.194.0-255,1484,120719,92,190489
16450,0.00224,172.31.47.0-255,66,120785,92,190489
16451,0.002269,172.31.47.0-255,66,120851,92,190489
16452,0.00232,172.31.47.0-255,66,120917,92,190489
16453,0.002344,172.31.47.0-255,66,120983,92,190489
16454,0.002359,172.217.194.0-255,5738,126721,92,190489
16455,0.002362,172.31.47.0-255,66,126787,92,190489
16456,0.00238,172.217.194.0-255,3602,130389,92,190489
16457,0.002383,172.31.47.0-255,66,130455,92,190489
16458,0.002436,172.217.194.0-255,1484,131939,92,190489
16459,0.002452,172.217.194.0-255,2902,134841,92,190489
16460,0.002455,172.31.47.0-255,66,134907,92,190489
16461,0.002458,172.217.194.0-255,1484,136391,92,190489
16462,0.002474,172.217.194.0-255,4320,140711,92,190489
16463,0.002477,172.31.47.0-255,66,140777,92,190489
16464,0.002483,172.217.194.0-255,5738,146515,92,190489
16465,0.002485,172.31.47.0-255,66,146581,92,190489
16466,0.002505,172.217.194.0-255,2902,149483,92,190489
16467,0.002508,172.31.47.0-255,66,149549,92,190489
16468,0.002545,172.31.47.0-255,66,149615,92,190489
16469,0.002551,172.217.194.0-255,5020,154635,92,190489
16470,0.002553,172.31.47.0-255,66,154701,92,190489
16471,0.002559,172.217.194.0-255,5738,160439,92,190489
16472,0.002561,172.31.47.0-255,66,160505,92,190489
16473,0.002574,172.31.47.0-255,66,160571,92,190489
16474,0.002579,172.217.194.0-255,5738,166309,92,190489
16475,0.002582,172.31.47.0-255,66,166375,92,190489
16476,0.002616,172.31.47.0-255,66,166441,92,190489
16477,0.002641,172.217.194.0-255,7156,173597,92,190489
16478,0.002645,172.31.47.0-255,66,173663,92,190489
16479,0.00268,172.31.47.0-255,66,173729,92,190489
16480,0.002701,172.217.194.0-255,5020,178749,92,190489
16481,0.002705,172.31.47.0-255,66,178815,92,190489
16482,0.002708,172.217.194.0-255,1484,180299,92,190489
16483,0.005299,172.217.194.0-255,4320,184619,92,190489
16484,0.005305,172.31.47.0-255,66,184685,92,190489
16485,0.007944,172.217.194.0-255,5738,190423,92,190489
16486,0.00795,172.31.47.0-255,66,190489,92,190489
16487,0.0,74.125.200.0-255,153,153,92,154421
16488,1.6e-05,172.31.47.0-255,66,219,92,154421
16489,2.2e-05,74.125.200.0-255,1484,1703,92,154421
16490,2.5e-05,172.31.47.0-255,66,1769,92,154421
16491,3.1e-05,74.125.200.0-255,2902,4671,92,154421
16492,3.4e-05,172.31.47.0-255,66,4737,92,154421
16493,3.7e-05,74.125.200.0-255,1484,6221,92,154421
16494,4e-05,172.31.47.0-255,66,6287,92,154421
16495,4.5e-05,74.125.200.0-255,2902,9189,92,154421
16496,4.8e-05,172.31.47.0-255,66,9255,92,154421
16497,7.2e-05,74.125.200.0-255,4320,13575,92,154421
16498,7.5e-05,172.31.47.0-255,66,13641,92,154421
16499,9.5e-05,74.125.200.0-255,2056,15697,92,154421
16500,9.6e-05,172.31.47.0-255,66,15763,92,154421
16501,0.000101,74.125.200.0-255,2902,18665,92,154421
16502,0.000103,172.31.47.0-255,66,18731,92,154421
16503,0.000105,74.125.200.0-255,1484,20215,92,154421
16504,0.000107,172.31.47.0-255,66,20281,92,154421
16505,0.000144,172.31.47.0-255,66,20347,92,154421
16506,0.000146,74.125.200.0-255,1125,21472,92,154421
16507,0.000148,172.31.47.0-255,66,21538,92,154421
16508,0.000218,74.125.200.0-255,1484,23022,92,154421
16509,0.000221,172.31.47.0-255,66,23088,92,154421
16510,0.000238,74.125.200.0-255,1484,24572,92,154421
16511,0.00024,172.31.47.0-255,66,24638,92,154421
16512,0.000244,74.125.200.0-255,2902,27540,92,154421
16513,0.000246,172.31.47.0-255,66,27606,92,154421
16514,0.000288,74.125.200.0-255,5738,33344,92,154421
16515,0.000291,172.31.47.0-255,66,33410,92,154421
16516,0.000325,74.125.200.0-255,2902,36312,92,154421
16517,0.000327,172.31.47.0-255,66,36378,92,154421
16518,0.000343,74.125.200.0-255,3961,40339,92,154421
16519,0.000346,74.125.200.0-255,1484,41823,92,154421
16520,0.00035,74.125.200.0-255,2902,44725,92,154421
16521,0.000396,74.125.200.0-255,2902,47627,92,154421
16522,0.000409,74.125.200.0-255,2902,50529,92,154421
16523,0.000421,172.31.47.0-255,66,50595,92,154421
16524,0.000448,74.125.200.0-255,5687,56282,92,154421
16525,0.000466,74.125.200.0-255,115,56397,92,154421
16526,0.000469,172.31.47.0-255,66,56463,92,154421
16527,0.000565,74.125.200.0-255,1484,57947,92,154421
16528,0.000584,74.125.200.0-255,2902,60849,92,154421
16529,0.00059,172.31.47.0-255,66,60915,92,154421
16530,0.000607,74.125.200.0-255,4320,65235,92,154421
16531,0.000614,172.31.47.0-255,66,65301,92,154421
16532,0.00064,74.125.200.0-255,2902,68203,92,154421
16533,0.000657,172.31.47.0-255,66,68269,92,154421
16534,0.000688,74.125.200.0-255,5738,74007,92,154421
16535,0.000697,172.31.47.0-255,66,74073,92,154421
16536,0.000715,74.125.200.0-255,7156,81229,92,154421
16537,0.000717,74.125.200.0-255,766,81995,92,154421
16538,0.000719,74.125.200.0-255,330,82325,92,154421
16539,0.000733,172.31.47.0-255,66,82391,92,154421
16540,0.001226,74.125.200.0-255,1484,83875,92,154421
16541,0.00123,172.31.47.0-255,66,83941,92,154421
16542,0.001244,74.125.200.0-255,2902,86843,92,154421
16543,0.001267,74.125.200.0-255,4320,91163,92,154421
16544,0.001285,172.31.47.0-255,66,91229,92,154421
16545,0.001297,74.125.200.0-255,2902,94131,92,154421
16546,0.00131,74.125.200.0-255,2902,97033,92,154421
16547,0.001324,74.125.200.0-255,4320,101353,92,154421
16548,0.001328,172.31.47.0-255,66,101419,92,154421
16549,0.001341,74.125.200.0-255,2902,104321,92,154421
16550,0.001353,74.125.200.0-255,4320,108641,92,154421
16551,0.001367,74.125.200.0-255,1484,110125,92,154421
16552,0.001373,172.31.47.0-255,66,110191,92,154421
16553,0.001383,74.125.200.0-255,4320,114511,92,154421
16554,0.001396,74.125.200.0-255,2184,116695,92,154421
16555,0.001403,172.31.47.0-255,66,116761,92,154421
16556,0.002164,74.125.200.0-255,1484,118245,92,154421
16557,0.002173,74.125.200.0-255,2902,121147,92,154421
16558,0.002177,172.31.47.0-255,66,121213,92,154421
16559,0.002197,74.125.200.0-255,5738,126951,92,154421
16560,0.00221,74.125.200.0-255,5738,132689,92,154421
16561,0.002241,74.125.200.0-255,7156,139845,92,154421
16562,0.002258,74.125.200.0-255,2902,142747,92,154421
16563,0.003762,172.31.47.0-255,66,142813,92,154421
16564,0.006132,74.125.200.0-255,5738,148551,92,154421
16565,0.006137,172.31.47.0-255,66,148617,92,154421
16566,0.008486,74.125.200.0-255,5738,154355,92,154421
16567,0.008492,172.31.47.0-255,66,154421,92,154421
16568,0.0,172.217.194.0-255,153,153,92,210257
16569,1.5e-05,172.31.47.0-255,66,219,92,210257
16570,2e-05,172.217.194.0-255,1484,1703,92,210257
16571,2.6e-05,172.31.47.0-255,66,1769,92,210257
16572,3.9e-05,172.217.194.0-255,2902,4671,92,210257
16573,4.2e-05,172.31.47.0-255,66,4737,92,210257
16574,4.9e-05,172.217.194.0-255,7156,11893,92,210257
16575,5.2e-05,172.31.47.0-255,66,11959,92,210257
16576,5.6e-05,172.217.194.0-255,2013,13972,92,210257
16577,5.8e-05,172.31.47.0-255,66,14038,92,210257
16578,0.0001,172.31.47.0-255,66,14104,92,210257
16579,0.000104,172.217.194.0-255,2902,17006,92,210257
16580,0.000106,172.31.47.0-255,66,17072,92,210257
16581,0.000143,172.31.47.0-255,66,17138,92,210257
16582,0.000196,172.217.194.0-255,6438,23576,92,210257
16583,0.0002,172.31.47.0-255,66,23642,92,210257
16584,0.000617,172.217.194.0-255,1484,25126,92,210257
16585,0.000623,172.31.47.0-255,66,25192,92,210257
16586,0.00063,172.217.194.0-255,2902,28094,92,210257
16587,0.000632,172.31.47.0-255,66,28160,92,210257
16588,0.000635,172.217.194.0-255,1484,29644,92,210257
16589,0.000644,172.31.47.0-255,66,29710,92,210257
16590,0.00068,172.217.194.0-255,4320,34030,92,210257
16591,0.000683,172.31.47.0-255,66,34096,92,210257
16592,0.00069,172.217.194.0-255,6797,40893,92,210257
16593,0.000692,172.31.47.0-255,66,40959,92,210257
16594,0.000726,172.217.194.0-255,7156,48115,92,210257
16595,0.000739,172.31.47.0-255,66,48181,92,210257
16596,0.000742,172.31.47.0-255,66,48247,92,210257
16597,0.000771,172.217.194.0-255,1705,49952,92,210257
16598,0.000774,172.31.47.0-255,66,50018,92,210257
16599,0.000811,172.217.194.0-255,2902,52920,92,210257
16600,0.000834,172.217.194.0-255,5738,58658,92,210257
16601,0.000839,172.31.47.0-255,66,58724,92,210257
16602,0.000868,172.217.194.0-255,5738,64462,92,210257
16603,0.000879,172.31.47.0-255,66,64528,92,210257
16604,0.000884,172.217.194.0-255,2543,67071,92,210257
16605,0.000888,172.31.47.0-255,66,67137,92,210257
16606,0.001082,172.217.194.0-255,1484,68621,92,210257
16607,0.001089,172.217.194.0-255,2902,71523,92,210257
16608,0.001092,172.31.47.0-255,66,71589,92,210257
16609,0.001123,172.217.194.0-255,5738,77327,92,210257
16610,0.001126,172.217.194.0-255,1484,78811,92,210257
16611,0.001132,172.31.47.0-255,66,78877,92,210257
16612,0.00116,172.217.194.0-255,4816,83693,92,210257
16613,0.001168,172.31.47.0-255,66,83759,92,210257
16614,0.001191,172.217.194.0-255,1484,85243,92,210257
16615,0.001195,172.217.194.0-255,2902,88145,92,210257
16616,0.001198,172.217.194.0-255,1484,89629,92,210257
16617,0.001204,172.31.47.0-255,66,89695,92,210257
16618,0.001213,172.217.194.0-255,4320,94015,92,210257
16619,0.001237,172.217.194.0-255,5738,99753,92,210257
16620,0.00125,172.31.47.0-255,66,99819,92,210257
16621,0.001262,172.217.194.0-255,1484,101303,92,210257
16622,0.001283,172.217.194.0-255,2184,103487,92,210257
16623,0.0013,172.31.47.0-255,66,103553,92,210257
16624,0.001347,172.217.194.0-255,1484,105037,92,210257
16625,0.001368,172.217.194.0-255,2902,107939,92,210257
16626,0.001372,172.217.194.0-255,1484,109423,92,210257
16627,0.00139,172.217.194.0-255,4320,113743,92,210257
16628,0.001393,172.217.194.0-255,1484,115227,92,210257
16629,0.001411,172.217.194.0-255,5738,120965,92,210257
16630,0.001418,172.217.194.0-255,7156,128121,92,210257
16631,0.001421,172.31.47.0-255,66,128187,92,210257
16632,0.001427,172.31.47.0-255,66,128253,92,210257
16633,0.001456,172.217.194.0-255,7156,135409,92,210257
16634,0.001466,172.217.194.0-255,2184,137593,92,210257
16635,0.00147,172.217.194.0-255,2902,140495,92,210257
16636,0.001482,172.217.194.0-255,4320,144815,92,210257
16637,0.001495,172.217.194.0-255,2902,147717,92,210257
16638,0.001503,172.217.194.0-255,7156,154873,92,210257
16639,0.001508,172.31.47.0-255,66,154939,92,210257
16640,0.001535,172.217.194.0-255,5738,160677,92,210257
16641,0.001541,172.217.194.0-255,4320,164997,92,210257
16642,0.001553,172.31.47.0-255,66,165063,92,210257
16643,0.001571,172.217.194.0-255,6438,171501,92,210257
16644,0.001626,172.217.194.0-255,1484,172985,92,210257
16645,0.001692,172.217.194.0-255,4320,177305,92,210257
16646,0.001718,172.31.47.0-255,66,177371,92,210257
16647,0.002449,172.217.194.0-255,1484,178855,92,210257
16648,0.002454,172.217.194.0-255,2902,181757,92,210257
16649,0.002457,172.31.47.0-255,66,181823,92,210257
16650,0.00246,172.217.194.0-255,1484,183307,92,210257
16651,0.002492,172.217.194.0-255,4320,187627,92,210257
16652,0.002514,172.217.194.0-255,4320,191947,92,210257
16653,0.00252,172.217.194.0-255,5738,197685,92,210257
16654,0.002528,172.31.47.0-255,66,197751,92,210257
16655,0.002537,172.217.194.0-255,5020,202771,92,210257
16656,0.002541,172.31.47.0-255,66,202837,92,210257
16657,0.005193,172.217.194.0-255,1484,204321,92,210257
16658,0.005199,172.31.47.0-255,66,204387,92,210257
16659,0.005215,172.217.194.0-255,4320,208707,92,210257
16660,0.007788,172.217.194.0-255,1484,210191,92,210257
16661,0.008864,172.31.47.0-255,66,210257,92,210257
16662,0.0,74.125.200.0-255,153,153,92,159559
16663,2.5e-05,172.31.47.0-255,66,219,92,159559
16664,3.3e-05,74.125.200.0-255,1484,1703,92,159559
16665,3.8e-05,172.31.47.0-255,66,1769,92,159559
16666,4.4e-05,74.125.200.0-255,2902,4671,92,159559
16667,4.7e-05,172.31.47.0-255,66,4737,92,159559
16668,5.3e-05,74.125.200.0-255,4320,9057,92,159559
16669,5.6e-05,172.31.47.0-255,66,9123,92,159559
16670,6.3e-05,74.125.200.0-255,4898,14021,92,159559
16671,6.6e-05,172.31.47.0-255,66,14087,92,159559
16672,9.2e-05,74.125.200.0-255,5738,19825,92,159559
16673,9.4e-05,172.31.47.0-255,66,19891,92,159559
16674,0.000116,74.125.200.0-255,5738,25629,92,159559
16675,0.000118,172.31.47.0-255,66,25695,92,159559
16676,0.000136,74.125.200.0-255,1484,27179,92,159559
16677,0.000138,172.31.47.0-255,66,27245,92,159559
16678,0.000156,74.125.200.0-255,3961,31206,92,159559
16679,0.000159,172.31.47.0-255,66,31272,92,159559
16680,0.00019,74.125.200.0-255,1484,32756,92,159559
16681,0.000192,172.31.47.0-255,66,32822,92,159559
16682,0.000197,74.125.200.0-255,2902,35724,92,159559
16683,0.000199,172.31.47.0-255,66,35790,92,159559
16684,0.000228,74.125.200.0-255,5738,41528,92,159559
16685,0.000231,172.31.47.0-255,66,41594,92,159559
16686,0.000234,74.125.200.0-255,1484,43078,92,159559
16687,0.000236,172.31.47.0-255,66,43144,92,159559
16688,0.000255,74.125.200.0-255,5738,48882,92,159559
16689,0.000258,172.31.47.0-255,66,48948,92,159559
16690,0.000263,74.125.200.0-255,4320,53268,92,159559
16691,0.000265,172.31.47.0-255,66,53334,92,159559
16692,0.000289,74.125.200.0-255,4320,57654,92,159559
16693,0.000291,172.31.47.0-255,66,57720,92,159559
16694,0.000298,74.125.200.0-255,5738,63458,92,159559
16695,0.0003,172.31.47.0-255,66,63524,92,159559
16696,0.000325,74.125.200.0-255,2184,65708,92,159559
16697,0.000327,172.31.47.0-255,66,65774,92,159559
16698,0.00033,74.125.200.0-255,396,66170,92,159559
16699,0.000332,172.31.47.0-255,66,66236,92,159559
16700,0.000352,74.125.200.0-255,114,66350,92,159559
16701,0.000355,172.31.47.0-255,66,66416,92,159559
16702,0.000569,74.125.200.0-255,1484,67900,92,159559
16703,0.000575,172.31.47.0-255,66,67966,92,159559
16704,0.000581,74.125.200.0-255,2902,70868,92,159559
16705,0.000584,172.31.47.0-255,66,70934,92,159559
16706,0.000607,74.125.200.0-255,2902,73836,92,159559
16707,0.00061,172.31.47.0-255,66,73902,92,159559
16708,0.000613,74.125.200.0-255,1484,75386,92,159559
16709,0.000616,172.31.47.0-255,66,75452,92,159559
16710,0.000632,74.125.200.0-255,2902,78354,92,159559
16711,0.000635,172.31.47.0-255,66,78420,92,159559
16712,0.000671,172.31.47.0-255,66,78486,92,159559
16713,0.000703,74.125.200.0-255,7156,85642,92,159559
16714,0.000705,172.31.47.0-255,66,85708,92,159559
16715,0.000728,74.125.200.0-255,2902,88610,92,159559
16716,0.000731,172.31.47.0-255,66,88676,92,159559
16717,0.000736,74.125.200.0-255,3602,92278,92,159559
16718,0.000739,172.31.47.0-255,66,92344,92,159559
16719,0.000741,74.125.200.0-255,329,92673,92,159559
16720,0.001503,172.31.47.0-255,66,92739,92,159559
16721,0.001996,74.125.200.0-255,1484,94223,92,159559
16722,0.002005,74.125.200.0-255,1484,95707,92,159559
16723,0.00201,172.31.47.0-255,66,95773,92,159559
16724,0.002014,74.125.200.0-255,1484,97257,92,159559
16725,0.002029,74.125.200.0-255,1484,98741,92,159559
16726,0.002031,172.31.47.0-255,66,98807,92,159559
16727,0.002036,74.125.200.0-255,2902,101709,92,159559
16728,0.002038,172.31.47.0-255,66,101775,92,159559
16729,0.002052,74.125.200.0-255,2902,104677,92,159559
16730,0.002054,172.31.47.0-255,66,104743,92,159559
16731,0.00208,172.31.47.0-255,66,104809,92,159559
16732,0.002091,172.31.47.0-255,66,104875,92,159559
16733,0.002103,74.125.200.0-255,1484,106359,92,159559
16734,0.002109,74.125.200.0-255,3602,109961,92,159559
16735,0.002111,172.31.47.0-255,66,110027,92,159559
16736,0.002235,74.125.200.0-255,1484,111511,92,159559
16737,0.002258,74.125.200.0-255,2902,114413,92,159559
16738,0.002262,172.31.47.0-255,66,114479,92,159559
16739,0.002265,74.125.200.0-255,1484,115963,92,159559
16740,0.00227,74.125.200.0-255,2902,118865,92,159559
16741,0.002272,172.31.47.0-255,66,118931,92,159559
16742,0.002295,74.125.200.0-255,5738,124669,92,159559
16743,0.002297,172.31.47.0-255,66,124735,92,159559
16744,0.002313,74.125.200.0-255,5738,130473,92,159559
16745,0.002315,172.31.47.0-255,66,130539,92,159559
16746,0.002338,74.125.200.0-255,4320,134859,92,159559
16747,0.00234,172.31.47.0-255,66,134925,92,159559
16748,0.002348,74.125.200.0-255,7156,142081,92,159559
16749,0.00235,172.31.47.0-255,66,142147,92,159559
16750,0.004653,74.125.200.0-255,5738,147885,92,159559
16751,0.004659,172.31.47.0-255,66,147951,92,159559
16752,0.006967,74.125.200.0-255,5738,153689,92,159559
16753,0.006974,172.31.47.0-255,66,153755,92,159559
16754,0.009316,74.125.200.0-255,5738,159493,92,159559
16755,0.009328,172.31.47.0-255,66,159559,92,159559
16756,0.0,172.217.194.0-255,153,153,92,264484
16757,2.6e-05,172.31.47.0-255,66,219,92,264484
16758,3.2e-05,172.217.194.0-255,1484,1703,92,264484
16759,3.6e-05,172.31.47.0-255,66,1769,92,264484
16760,4e-05,172.217.194.0-255,2902,4671,92,264484
16761,4.2e-05,172.31.47.0-255,66,4737,92,264484
16762,5.6e-05,172.217.194.0-255,2902,7639,92,264484
16763,5.8e-05,172.31.47.0-255,66,7705,92,264484
16764,7e-05,172.217.194.0-255,2902,10607,92,264484
16765,7.2e-05,172.31.47.0-255,66,10673,92,264484
16766,8.3e-05,172.217.194.0-255,1484,12157,92,264484
16767,8.4e-05,172.31.47.0-255,66,12223,92,264484
16768,0.000105,172.217.194.0-255,2902,15125,92,264484
16769,0.000107,172.31.47.0-255,66,15191,92,264484
16770,0.000134,172.31.47.0-255,66,15257,92,264484
16771,0.000151,172.217.194.0-255,3519,18776,92,264484
16772,0.000152,172.31.47.0-255,66,18842,92,264484
16773,0.000174,172.217.194.0-255,2543,21385,92,264484
16774,0.000176,172.31.47.0-255,66,21451,92,264484
16775,0.000179,172.217.194.0-255,1484,22935,92,264484
16776,0.00018,172.31.47.0-255,66,23001,92,264484
16777,0.000196,172.217.194.0-255,1484,24485,92,264484
16778,0.000198,172.31.47.0-255,66,24551,92,264484
16779,0.000226,172.217.194.0-255,5738,30289,92,264484
16780,0.000229,172.31.47.0-255,66,30355,92,264484
16781,0.000234,172.217.194.0-255,7156,37511,92,264484
16782,0.000236,172.31.47.0-255,66,37577,92,264484
16783,0.000268,172.31.47.0-255,66,37643,92,264484
16784,0.000272,172.217.194.0-255,3602,41245,92,264484
16785,0.000273,172.31.47.0-255,66,41311,92,264484
16786,0.000276,172.217.194.0-255,710,42021,92,264484
16787,0.000409,172.217.194.0-255,1484,43505,92,264484
16788,0.000413,172.31.47.0-255,66,43571,92,264484
16789,0.000417,172.217.194.0-255,2902,46473,92,264484
16790,0.000419,172.31.47.0-255,66,46539,92,264484
16791,0.000432,172.217.194.0-255,4320,50859,92,264484
16792,0.000434,172.31.47.0-255,66,50925,92,264484
16793,0.000452,172.217.194.0-255,1484,52409,92,264484
16794,0.000455,172.217.194.0-255,1484,53893,92,264484
16795,0.000457,172.31.47.0-255,66,53959,92,264484
16796,0.000462,172.217.194.0-255,4320,58279,92,264484
16797,0.000463,172.31.47.0-255,66,58345,92,264484
16798,0.000478,172.217.194.0-255,4320,62665,92,264484
16799,0.00048,172.31.47.0-255,66,62731,92,264484
16800,0.000518,172.217.194.0-255,2902,65633,92,264484
16801,0.000521,172.31.47.0-255,66,65699,92,264484
16802,0.000547,172.31.47.0-255,66,65765,92,264484
16803,0.00081,172.217.194.0-255,1484,67249,92,264484
16804,0.000825,172.217.194.0-255,2902,70151,92,264484
16805,0.000828,172.31.47.0-255,66,70217,92,264484
16806,0.000857,172.217.194.0-255,4320,74537,92,264484
16807,0.000859,172.31.47.0-255,66,74603,92,264484
16808,0.000872,172.217.194.0-255,4320,78923,92,264484
16809,0.000875,172.31.47.0-255,66,78989,92,264484
16810,0.000891,172.217.194.0-255,4320,83309,92,264484
16811,0.000894,172.217.194.0-255,2902,86211,92,264484
16812,0.000895,172.31.47.0-255,66,86277,92,264484
16813,0.000898,172.31.47.0-255,66,86343,92,264484
16814,0.000904,172.217.194.0-255,4320,90663,92,264484
16815,0.000906,172.31.47.0-255,66,90729,92,264484
16816,0.000918,172.217.194.0-255,1484,92213,92,264484
16817,0.000945,172.217.194.0-255,2902,95115,92,264484
16818,0.000948,172.31.47.0-255,66,95181,92,264484
16819,0.000969,172.217.194.0-255,5020,100201,92,264484
16820,0.000972,172.31.47.0-255,66,100267,92,264484
16821,0.001023,172.217.194.0-255,1484,101751,92,264484
16822,0.001027,172.217.194.0-255,2902,104653,92,264484
16823,0.001029,172.31.47.0-255,66,104719,92,264484
16824,0.001047,172.217.194.0-255,5738,110457,92,264484
16825,0.00105,172.31.47.0-255,66,110523,92,264484
16826,0.00109,172.31.47.0-255,66,110589,92,264484
16827,0.001093,172.217.194.0-255,1484,112073,92,264484
16828,0.00111,172.217.194.0-255,7156,119229,92,264484
16829,0.001112,172.31.47.0-255,66,119295,92,264484
16830,0.001123,172.217.194.0-255,2184,121479,92,264484
16831,0.001125,172.31.47.0-255,66,121545,92,264484
16832,0.001595,172.217.194.0-255,1484,123029,92,264484
16833,0.001603,172.217.194.0-255,2902,125931,92,264484
16834,0.001606,172.31.47.0-255,66,125997,92,264484
16835,0.001625,172.217.194.0-255,2902,128899,92,264484
16836,0.001628,172.31.47.0-255,66,128965,92,264484
16837,0.001645,172.217.194.0-255,2902,131867,92,264484
16838,0.001647,172.31.47.0-255,66,131933,92,264484
16839,0.001652,172.217.194.0-255,4320,136253,92,264484
16840,0.001653,172.31.47.0-255,66,136319,92,264484
16841,0.001682,172.31.47.0-255,66,136385,92,264484
16842,0.001706,172.31.47.0-255,66,136451,92,264484
16843,0.001725,172.217.194.0-255,766,137217,92,264484
16844,0.001728,172.217.194.0-255,1484,138701,92,264484
16845,0.00173,172.31.47.0-255,66,138767,92,264484
16846,0.001733,172.217.194.0-255,1484,140251,92,264484
16847,0.001751,172.217.194.0-255,2902,143153,92,264484
16848,0.001753,172.31.47.0-255,66,143219,92,264484
16849,0.001758,172.217.194.0-255,4320,147539,92,264484
16850,0.001759,172.31.47.0-255,66,147605,92,264484
16851,0.001774,172.217.194.0-255,5738,153343,92,264484
16852,0.001777,172.31.47.0-255,66,153409,92,264484
16853,0.001779,172.217.194.0-255,1484,154893,92,264484
16854,0.001808,172.31.47.0-255,66,154959,92,264484
16855,0.001827,172.217.194.0-255,1484,156443,92,264484
16856,0.001832,172.217.194.0-255,3602,160045,92,264484
16857,0.001834,172.31.47.0-255,66,160111,92,264484
16858,0.001845,172.217.194.0-255,1484,161595,92,264484
16859,0.001856,172.217.194.0-255,2902,164497,92,264484
16860,0.001859,172.31.47.0-255,66,164563,92,264484
16861,0.001862,172.217.194.0-255,2902,167465,92,264484
16862,0.001864,172.31.47.0-255,66,167531,92,264484
16863,0.001878,172.217.194.0-255,1484,169015,92,264484
16864,0.001897,172.217.194.0-255,7156,176171,92,264484
16865,0.001899,172.31.47.0-255,66,176237,92,264484
16866,0.001917,172.217.194.0-255,2902,179139,92,264484
16867,0.001919,172.31.47.0-255,66,179205,92,264484
16868,0.001929,172.31.47.0-255,66,179271,92,264484
16869,0.001961,172.217.194.0-255,2902,182173,92,264484
16870,0.001963,172.31.47.0-255,66,182239,92,264484
16871,0.001984,172.31.47.0-255,66,182305,92,264484
16872,0.002026,172.217.194.0-255,7156,189461,92,264484
16873,0.002041,172.31.47.0-255,66,189527,92,264484
16874,0.002058,172.217.194.0-255,7156,196683,92,264484
16875,0.002061,172.31.47.0-255,66,196749,92,264484
16876,0.002065,172.217.194.0-255,4320,201069,92,264484
16877,0.002066,172.31.47.0-255,66,201135,92,264484
16878,0.002069,172.217.194.0-255,1484,202619,92,264484
16879,0.002099,172.217.194.0-255,2184,204803,92,264484
16880,0.002102,172.31.47.0-255,66,204869,92,264484
16881,0.002106,172.217.194.0-255,4320,209189,92,264484
16882,0.002108,172.31.47.0-255,66,209255,92,264484
16883,0.002113,172.217.194.0-255,5738,214993,92,264484
16884,0.002116,172.31.47.0-255,66,215059,92,264484
16885,0.002139,172.217.194.0-255,4320,219379,92,264484
16886,0.002142,172.31.47.0-255,66,219445,92,264484
16887,0.002145,172.217.194.0-255,1484,220929,92,264484
16888,0.002168,172.31.47.0-255,66,220995,92,264484
16889,0.002188,172.217.194.0-255,7156,228151,92,264484
16890,0.002191,172.31.47.0-255,66,228217,92,264484
16891,0.002209,172.217.194.0-255,766,228983,92,264484
16892,0.002256,172.217.194.0-255,1484,230467,92,264484
16893,0.002259,172.31.47.0-255,66,230533,92,264484
16894,0.002262,172.217.194.0-255,1484,232017,92,264484
16895,0.002276,172.217.194.0-255,1484,233501,92,264484
16896,0.002278,172.31.47.0-255,66,233567,92,264484
16897,0.002284,172.217.194.0-255,5738,239305,92,264484
16898,0.002286,172.31.47.0-255,66,239371,92,264484
16899,0.002322,172.31.47.0-255,66,239437,92,264484
16900,0.002325,172.217.194.0-255,1484,240921,92,264484
16901,0.002327,172.217.194.0-255,1484,242405,92,264484
16902,0.002329,172.31.47.0-255,66,242471,92,264484
16903,0.002362,172.31.47.0-255,66,242537,92,264484
16904,0.002377,172.217.194.0-255,1484,244021,92,264484
16905,0.002392,172.217.194.0-255,2902,246923,92,264484
16906,0.002395,172.31.47.0-255,66,246989,92,264484
16907,0.002398,172.217.194.0-255,1484,248473,92,264484
16908,0.0024,172.217.194.0-255,1484,249957,92,264484
16909,0.002402,172.31.47.0-255,66,250023,92,264484
16910,0.002415,172.217.194.0-255,1484,251507,92,264484
16911,0.002419,172.217.194.0-255,2902,254409,92,264484
16912,0.002421,172.31.47.0-255,66,254475,92,264484
16913,0.002455,172.217.194.0-255,2902,257377,92,264484
16914,0.002461,172.31.47.0-255,66,257443,92,264484
16915,0.002484,172.31.47.0-255,66,257509,92,264484
16916,0.002487,172.217.194.0-255,1484,258993,92,264484
16917,0.002508,172.31.47.0-255,66,259059,92,264484
16918,0.002526,172.31.47.0-255,66,259125,92,264484
16919,0.002533,172.217.194.0-255,5091,264216,92,264484
16920,0.002538,172.31.47.0-255,66,264282,92,264484
16921,0.002544,172.217.194.0-255,97,264379,92,264484
16922,0.002569,172.217.194.0-255,105,264484,92,264484
16923,0.0,74.125.24.0-255,153,153,92,235803
16924,2.6e-05,172.31.47.0-255,66,219,92,235803
16925,3.2e-05,74.125.24.0-255,1484,1703,92,235803
16926,3.6e-05,172.31.47.0-255,66,1769,92,235803
16927,4.8e-05,74.125.24.0-255,2902,4671,92,235803
16928,5.2e-05,172.31.47.0-255,66,4737,92,235803
16929,5.8e-05,74.125.24.0-255,7156,11893,92,235803
16930,6.1e-05,172.31.47.0-255,66,11959,92,235803
16931,8.6e-05,74.125.24.0-255,1484,13443,92,235803
16932,9.5e-05,172.31.47.0-255,66,13509,92,235803
16933,0.000128,172.31.47.0-255,66,13575,92,235803
16934,0.000134,74.125.24.0-255,5379,18954,92,235803
16935,0.000139,172.31.47.0-255,66,19020,92,235803
16936,0.00019,74.125.24.0-255,1484,20504,92,235803
16937,0.000194,172.31.47.0-255,66,20570,92,235803
16938,0.000199,74.125.24.0-255,2902,23472,92,235803
16939,0.000204,172.31.47.0-255,66,23538,92,235803
16940,0.000217,74.125.24.0-255,5738,29276,92,235803
16941,0.00022,172.31.47.0-255,66,29342,92,235803
16942,0.000256,172.31.47.0-255,66,29408,92,235803
16943,0.000262,74.125.24.0-255,4320,33728,92,235803
16944,0.000264,172.31.47.0-255,66,33794,92,235803
16945,0.000293,74.125.24.0-255,5738,39532,92,235803
16946,0.000301,172.31.47.0-255,66,39598,92,235803
16947,0.000306,74.125.24.0-255,4240,43838,92,235803
16948,0.00031,172.31.47.0-255,66,43904,92,235803
16949,0.000427,74.125.24.0-255,130,44034,92,235803
16950,0.000431,172.31.47.0-255,66,44100,92,235803
16951,0.000473,74.125.24.0-255,1484,45584,92,235803
16952,0.000478,172.31.47.0-255,66,45650,92,235803
16953,0.000485,74.125.24.0-255,2902,48552,92,235803
16954,0.000488,172.31.47.0-255,66,48618,92,235803
16955,0.000497,74.125.24.0-255,2902,51520,92,235803
16956,0.000499,172.31.47.0-255,66,51586,92,235803
16957,0.000526,74.125.24.0-255,4320,55906,92,235803
16958,0.000534,172.31.47.0-255,66,55972,92,235803
16959,0.000541,74.125.24.0-255,5379,61351,92,235803
16960,0.000544,172.31.47.0-255,66,61417,92,235803
16961,0.000568,74.125.24.0-255,2902,64319,92,235803
16962,0.000571,172.31.47.0-255,66,64385,92,235803
16963,0.000595,74.125.24.0-255,1484,65869,92,235803
16964,0.000608,74.125.24.0-255,5738,71607,92,235803
16965,0.000612,172.31.47.0-255,66,71673,92,235803
16966,0.000615,74.125.24.0-255,1484,73157,92,235803
16967,0.000643,74.125.24.0-255,5656,78813,92,235803
16968,0.000647,172.31.47.0-255,66,78879,92,235803
16969,0.000755,74.125.24.0-255,1484,80363,92,235803
16970,0.00076,74.125.24.0-255,1484,81847,92,235803
16971,0.000762,172.31.47.0-255,66,81913,92,235803
16972,0.00079,74.125.24.0-255,1484,83397,92,235803
16973,0.000797,74.125.24.0-255,5738,89135,92,235803
16974,0.0008,172.31.47.0-255,66,89201,92,235803
16975,0.000836,172.31.47.0-255,66,89267,92,235803
16976,0.000842,74.125.24.0-255,5738,95005,92,235803
16977,0.000844,172.31.47.0-255,66,95071,92,235803
16978,0.000882,74.125.24.0-255,4320,99391,92,235803
16979,0.000886,172.31.47.0-255,66,99457,92,235803
16980,0.000911,74.125.24.0-255,217,99674,92,235803
16981,0.000944,74.125.24.0-255,1484,101158,92,235803
16982,0.000947,172.31.47.0-255,66,101224,92,235803
16983,0.000952,74.125.24.0-255,2902,104126,92,235803
16984,0.000955,172.31.47.0-255,66,104192,92,235803
16985,0.000987,74.125.24.0-255,5738,109930,92,235803
16986,0.00099,172.31.47.0-255,66,109996,92,235803
16987,0.000995,74.125.24.0-255,2902,112898,92,235803
16988,0.000997,172.31.47.0-255,66,112964,92,235803
16989,0.001015,74.125.24.0-255,5738,118702,92,235803
16990,0.001018,172.31.47.0-255,66,118768,92,235803
16991,0.001043,74.125.24.0-255,4320,123088,92,235803
16992,0.001046,172.31.47.0-255,66,123154,92,235803
16993,0.001063,172.31.47.0-255,66,123220,92,235803
16994,0.001066,74.125.24.0-255,766,123986,92,235803
16995,0.001116,74.125.24.0-255,1484,125470,92,235803
16996,0.001119,172.31.47.0-255,66,125536,92,235803
16997,0.001142,74.125.24.0-255,2902,128438,92,235803
16998,0.001145,172.31.47.0-255,66,128504,92,235803
16999,0.001151,74.125.24.0-255,5738,134242,92,235803
17000,0.001154,172.31.47.0-255,66,134308,92,235803
17001,0.001228,172.31.47.0-255,66,134374,92,235803
17002,0.001231,74.125.24.0-255,1484,135858,92,235803
17003,0.001264,172.31.47.0-255,66,135924,92,235803
17004,0.001291,74.125.24.0-255,1484,137408,92,235803
17005,0.001295,74.125.24.0-255,2902,140310,92,235803
17006,0.001298,172.31.47.0-255,66,140376,92,235803
17007,0.001326,74.125.24.0-255,5738,146114,92,235803
17008,0.001329,172.31.47.0-255,66,146180,92,235803
17009,0.001349,74.125.24.0-255,4320,150500,92,235803
17010,0.001353,172.31.47.0-255,66,150566,92,235803
17011,0.001376,74.125.24.0-255,2902,153468,92,235803
17012,0.001379,172.31.47.0-255,66,153534,92,235803
17013,0.001383,74.125.24.0-255,2902,156436,92,235803
17014,0.001385,172.31.47.0-255,66,156502,92,235803
17015,0.001413,74.125.24.0-255,5738,162240,92,235803
17016,0.001416,172.31.47.0-255,66,162306,92,235803
17017,0.001426,172.31.47.0-255,66,162372,92,235803
17018,0.001455,74.125.24.0-255,1484,163856,92,235803
17019,0.00146,74.125.24.0-255,2902,166758,92,235803
17020,0.001462,172.31.47.0-255,66,166824,92,235803
17021,0.001468,74.125.24.0-255,5738,172562,92,235803
17022,0.001471,172.31.47.0-255,66,172628,92,235803
17023,0.001508,74.125.24.0-255,7156,179784,92,235803
17024,0.001513,172.31.47.0-255,66,179850,92,235803
17025,0.00154,74.125.24.0-255,5738,185588,92,235803
17026,0.001543,172.31.47.0-255,66,185654,92,235803
17027,0.001557,172.31.47.0-255,66,185720,92,235803
17028,0.00156,74.125.24.0-255,1484,187204,92,235803
17029,0.001596,172.31.47.0-255,66,187270,92,235803
17030,0.001613,172.31.47.0-255,66,187336,92,235803
17031,0.001661,172.31.47.0-255,66,187402,92,235803
17032,0.001691,172.31.47.0-255,66,187468,92,235803
17033,0.001698,74.125.24.0-255,7156,194624,92,235803
17034,0.001699,172.31.47.0-255,66,194690,92,235803
17035,0.001743,74.125.24.0-255,4320,199010,92,235803
17036,0.001747,172.31.47.0-255,66,199076,92,235803
17037,0.001785,172.31.47.0-255,66,199142,92,235803
17038,0.001809,74.125.24.0-255,1484,200626,92,235803
17039,0.001814,74.125.24.0-255,2902,203528,92,235803
17040,0.001816,172.31.47.0-255,66,203594,92,235803
17041,0.001821,74.125.24.0-255,5738,209332,92,235803
17042,0.001823,172.31.47.0-255,66,209398,92,235803
17043,0.001865,74.125.24.0-255,5738,215136,92,235803
17044,0.001869,172.31.47.0-255,66,215202,92,235803
17045,0.001896,74.125.24.0-255,7156,222358,92,235803
17046,0.001899,172.31.47.0-255,66,222424,92,235803
17047,0.001943,172.31.47.0-255,66,222490,92,235803
17048,0.00197,74.125.24.0-255,766,223256,92,235803
17049,0.001982,172.31.47.0-255,66,223322,92,235803
17050,0.001992,172.31.47.0-255,66,223388,92,235803
17051,0.002003,74.125.24.0-255,7156,230544,92,235803
17052,0.002006,172.31.47.0-255,66,230610,92,235803
17053,0.002052,172.31.47.0-255,66,230676,92,235803
17054,0.00207,172.31.47.0-255,66,230742,92,235803
17055,0.002076,74.125.24.0-255,4719,235461,92,235803
17056,0.00208,172.31.47.0-255,66,235527,92,235803
17057,0.002101,74.125.24.0-255,105,235632,92,235803
17058,0.008574,172.31.47.0-255,66,235698,92,235803
17059,0.008598,172.31.47.0-255,105,235803,92,235803
17060,0.0,172.31.47.0-255,105,105,92,276
17061,0.001768,157.240.13.0-255,105,210,92,276
17062,0.001781,172.31.47.0-255,66,276,92,276
17063,0.0,172.31.47.0-255,105,105,92,105
17064,0.0,74.125.24.0-255,153,153,92,113396
17065,2.9e-05,172.31.47.0-255,66,219,92,113396
17066,3.5e-05,74.125.24.0-255,1484,1703,92,113396
17067,3.9e-05,172.31.47.0-255,66,1769,92,113396
17068,4.4e-05,74.125.24.0-255,2902,4671,92,113396
17069,4.7e-05,172.31.47.0-255,66,4737,92,113396
17070,5.3e-05,74.125.24.0-255,7156,11893,92,113396
17071,5.6e-05,172.31.47.0-255,66,11959,92,113396
17072,7.2e-05,74.125.24.0-255,2254,14213,92,113396
17073,7.5e-05,172.31.47.0-255,66,14279,92,113396
17074,0.000109,74.125.24.0-255,1484,15763,92,113396
17075,0.000112,172.31.47.0-255,66,15829,92,113396
17076,0.000117,74.125.24.0-255,2902,18731,92,113396
17077,0.00012,172.31.47.0-255,66,18797,92,113396
17078,0.000125,74.125.24.0-255,4320,23117,92,113396
17079,0.000126,172.31.47.0-255,66,23183,92,113396
17080,0.00015,74.125.24.0-255,1484,24667,92,113396
17081,0.000152,172.31.47.0-255,66,24733,92,113396
17082,0.000163,74.125.24.0-255,6797,31530,92,113396
17083,0.000165,172.31.47.0-255,66,31596,92,113396
17084,0.000895,74.125.24.0-255,1484,33080,92,113396
17085,0.000901,172.31.47.0-255,66,33146,92,113396
17086,0.00091,74.125.24.0-255,2902,36048,92,113396
17087,0.000913,172.31.47.0-255,66,36114,92,113396
17088,0.000925,74.125.24.0-255,5738,41852,92,113396
17089,0.000927,172.31.47.0-255,66,41918,92,113396
17090,0.000961,74.125.24.0-255,4320,46238,92,113396
17091,0.000964,172.31.47.0-255,66,46304,92,113396
17092,0.000999,74.125.24.0-255,2543,48847,92,113396
17093,0.001002,172.31.47.0-255,66,48913,92,113396
17094,0.001016,172.31.47.0-255,66,48979,92,113396
17095,0.00102,74.125.24.0-255,2818,51797,92,113396
17096,0.001241,74.125.24.0-255,382,52179,92,113396
17097,0.001395,74.125.24.0-255,1484,53663,92,113396
17098,0.001414,74.125.24.0-255,2902,56565,92,113396
17099,0.001419,74.125.24.0-255,5738,62303,92,113396
17100,0.001432,74.125.24.0-255,1484,63787,92,113396
17101,0.001484,74.125.24.0-255,5379,69166,92,113396
17102,0.001493,74.125.24.0-255,1484,70650,92,113396
17103,0.001508,74.125.24.0-255,4320,74970,92,113396
17104,0.001532,74.125.24.0-255,1484,76454,92,113396
17105,0.001821,74.125.24.0-255,1484,77938,92,113396
17106,0.001836,74.125.24.0-255,2902,80840,92,113396
17107,0.001855,74.125.24.0-255,5738,86578,92,113396
17108,0.001881,74.125.24.0-255,4320,90898,92,113396
17109,0.001911,74.125.24.0-255,4320,95218,92,113396
17110,0.001916,74.125.24.0-255,5738,100956,92,113396
17111,0.001929,74.125.24.0-255,766,101722,92,113396
17112,0.003577,172.31.47.0-255,66,101788,92,113396
17113,0.005966,74.125.24.0-255,5738,107526,92,113396
17114,0.005974,172.31.47.0-255,66,107592,92,113396
17115,0.008288,74.125.24.0-255,5738,113330,92,113396
17116,0.008296,172.31.47.0-255,66,113396,92,113396
17117,0.0,74.125.24.0-255,153,153,92,246520
17118,1.5e-05,172.31.47.0-255,66,219,92,246520
17119,3.1e-05,74.125.24.0-255,1484,1703,92,246520
17120,3.6e-05,172.31.47.0-255,66,1769,92,246520
17121,4.1e-05,74.125.24.0-255,2902,4671,92,246520
17122,4.4e-05,172.31.47.0-255,66,4737,92,246520
17123,7.7e-05,74.125.24.0-255,7156,11893,92,246520
17124,8e-05,172.31.47.0-255,66,11959,92,246520
17125,8.3e-05,74.125.24.0-255,2063,14022,92,246520
17126,8.5e-05,172.31.47.0-255,66,14088,92,246520
17127,0.000101,74.125.24.0-255,2902,16990,92,246520
17128,0.000103,172.31.47.0-255,66,17056,92,246520
17129,0.000131,172.31.47.0-255,66,17122,92,246520
17130,0.000136,74.125.24.0-255,5379,22501,92,246520
17131,0.000138,172.31.47.0-255,66,22567,92,246520
17132,0.000189,74.125.24.0-255,1484,24051,92,246520
17133,0.000192,172.31.47.0-255,66,24117,92,246520
17134,0.000196,74.125.24.0-255,2902,27019,92,246520
17135,0.000198,172.31.47.0-255,66,27085,92,246520
17136,0.000209,74.125.24.0-255,1484,28569,92,246520
17137,0.000211,172.31.47.0-255,66,28635,92,246520
17138,0.000234,74.125.24.0-255,4320,32955,92,246520
17139,0.000237,172.31.47.0-255,66,33021,92,246520
17140,0.000277,172.31.47.0-255,66,33087,92,246520
17141,0.000281,74.125.24.0-255,4320,37407,92,246520
17142,0.000283,172.31.47.0-255,66,37473,92,246520
17143,0.000304,172.31.47.0-255,66,37539,92,246520
17144,0.000326,74.125.24.0-255,445,37984,92,246520
17145,0.000328,172.31.47.0-255,66,38050,92,246520
17146,0.000423,74.125.24.0-255,329,38379,92,246520
17147,0.000675,74.125.24.0-255,1484,39863,92,246520
17148,0.000679,172.31.47.0-255,66,39929,92,246520
17149,0.000684,74.125.24.0-255,2902,42831,92,246520
17150,0.000685,172.31.47.0-255,66,42897,92,246520
17151,0.000699,74.125.24.0-255,4320,47217,92,246520
17152,0.000702,172.31.47.0-255,66,47283,92,246520
17153,0.000718,74.125.24.0-255,1484,48767,92,246520
17154,0.000759,172.31.47.0-255,66,48833,92,246520
17155,0.000779,74.125.24.0-255,2902,51735,92,246520
17156,0.000781,172.31.47.0-255,66,51801,92,246520
17157,0.0008,74.125.24.0-255,5738,57539,92,246520
17158,0.000803,172.31.47.0-255,66,57605,92,246520
17159,0.000806,74.125.24.0-255,1125,58730,92,246520
17160,0.001258,74.125.24.0-255,1484,60214,92,246520
17161,0.001264,172.31.47.0-255,66,60280,92,246520
17162,0.001269,74.125.24.0-255,2902,63182,92,246520
17163,0.001271,172.31.47.0-255,66,63248,92,246520
17164,0.001277,74.125.24.0-255,4320,67568,92,246520
17165,0.001279,172.31.47.0-255,66,67634,92,246520
17166,0.001298,74.125.24.0-255,1484,69118,92,246520
17167,0.001309,172.31.47.0-255,66,69184,92,246520
17168,0.001337,74.125.24.0-255,4320,73504,92,246520
17169,0.00134,172.31.47.0-255,66,73570,92,246520
17170,0.001351,172.31.47.0-255,66,73636,92,246520
17171,0.001373,74.125.24.0-255,1484,75120,92,246520
17172,0.001395,74.125.24.0-255,2902,78022,92,246520
17173,0.001399,172.31.47.0-255,66,78088,92,246520
17174,0.001404,74.125.24.0-255,5738,83826,92,246520
17175,0.001407,172.31.47.0-255,66,83892,92,246520
17176,0.00144,172.31.47.0-255,66,83958,92,246520
17177,0.001465,74.125.24.0-255,1484,85442,92,246520
17178,0.001483,172.31.47.0-255,66,85508,92,246520
17179,0.001518,74.125.24.0-255,4320,89828,92,246520
17180,0.001521,172.31.47.0-255,66,89894,92,246520
17181,0.001554,172.31.47.0-255,66,89960,92,246520
17182,0.001565,172.31.47.0-255,66,90026,92,246520
17183,0.001603,74.125.24.0-255,7156,97182,92,246520
17184,0.001606,172.31.47.0-255,66,97248,92,246520
17185,0.001625,74.125.24.0-255,3602,100850,92,246520
17186,0.001627,172.31.47.0-255,66,100916,92,246520
17187,0.001735,74.125.24.0-255,1484,102400,92,246520
17188,0.001739,74.125.24.0-255,1484,103884,92,246520
17189,0.001742,172.31.47.0-255,66,103950,92,246520
17190,0.001762,74.125.24.0-255,1484,105434,92,246520
17191,0.001768,74.125.24.0-255,5738,111172,92,246520
17192,0.001772,172.31.47.0-255,66,111238,92,246520
17193,0.00178,74.125.24.0-255,1484,112722,92,246520
17194,0.001801,172.31.47.0-255,66,112788,92,246520
17195,0.001804,74.125.24.0-255,1484,114272,92,246520
17196,0.001819,74.125.24.0-255,1484,115756,92,246520
17197,0.001821,172.31.47.0-255,66,115822,92,246520
17198,0.001867,74.125.24.0-255,4320,120142,92,246520
17199,0.001872,172.31.47.0-255,66,120208,92,246520
17200,0.001881,74.125.24.0-255,3602,123810,92,246520
17201,0.001884,172.31.47.0-255,66,123876,92,246520
17202,0.002014,74.125.24.0-255,1484,125360,92,246520
17203,0.002019,74.125.24.0-255,2902,128262,92,246520
17204,0.002044,172.31.47.0-255,66,128328,92,246520
17205,0.00205,74.125.24.0-255,5738,134066,92,246520
17206,0.002053,172.31.47.0-255,66,134132,92,246520
17207,0.002058,74.125.24.0-255,4320,138452,92,246520
17208,0.00206,172.31.47.0-255,66,138518,92,246520
17209,0.002084,74.125.24.0-255,2902,141420,92,246520
17210,0.002087,172.31.47.0-255,66,141486,92,246520
17211,0.002101,172.31.47.0-255,66,141552,92,246520
17212,0.002104,74.125.24.0-255,2184,143736,92,246520
17213,0.002106,172.31.47.0-255,66,143802,92,246520
17214,0.00262,74.125.24.0-255,1484,145286,92,246520
17215,0.00264,74.125.24.0-255,2902,148188,92,246520
17216,0.002644,172.31.47.0-255,66,148254,92,246520
17217,0.00265,74.125.24.0-255,5738,153992,92,246520
17218,0.002651,172.31.47.0-255,66,154058,92,246520
17219,0.0027,74.125.24.0-255,4320,158378,92,246520
17220,0.002702,172.31.47.0-255,66,158444,92,246520
17221,0.002707,74.125.24.0-255,5738,164182,92,246520
17222,0.002709,172.31.47.0-255,66,164248,92,246520
17223,0.002718,172.31.47.0-255,66,164314,92,246520
17224,0.002721,74.125.24.0-255,1484,165798,92,246520
17225,0.002743,74.125.24.0-255,3602,169400,92,246520
17226,0.002745,172.31.47.0-255,66,169466,92,246520
17227,0.002748,74.125.24.0-255,1484,170950,92,246520
17228,0.002765,74.125.24.0-255,5738,176688,92,246520
17229,0.002767,172.31.47.0-255,66,176754,92,246520
17230,0.00277,74.125.24.0-255,1484,178238,92,246520
17231,0.002789,74.125.24.0-255,4320,182558,92,246520
17232,0.002792,172.31.47.0-255,66,182624,92,246520
17233,0.002796,74.125.24.0-255,2902,185526,92,246520
17234,0.002797,172.31.47.0-255,66,185592,92,246520
17235,0.002819,74.125.24.0-255,4320,189912,92,246520
17236,0.002821,172.31.47.0-255,66,189978,92,246520
17237,0.002851,172.31.47.0-255,66,190044,92,246520
17238,0.002863,74.125.24.0-255,2184,192228,92,246520
17239,0.002865,172.31.47.0-255,66,192294,92,246520
17240,0.002902,74.125.24.0-255,1484,193778,92,246520
17241,0.002921,74.125.24.0-255,2902,196680,92,246520
17242,0.002923,172.31.47.0-255,66,196746,92,246520
17243,0.002945,74.125.24.0-255,4320,201066,92,246520
17244,0.002947,172.31.47.0-255,66,201132,92,246520
17245,0.002964,74.125.24.0-255,1484,202616,92,246520
17246,0.002975,172.31.47.0-255,66,202682,92,246520
17247,0.002995,74.125.24.0-255,4320,207002,92,246520
17248,0.002997,172.31.47.0-255,66,207068,92,246520
17249,0.003019,74.125.24.0-255,1484,208552,92,246520
17250,0.00304,172.31.47.0-255,66,208618,92,246520
17251,0.003364,74.125.24.0-255,1484,210102,92,246520
17252,0.003369,74.125.24.0-255,2902,213004,92,246520
17253,0.003372,172.31.47.0-255,66,213070,92,246520
17254,0.003387,74.125.24.0-255,5738,218808,92,246520
17255,0.003389,172.31.47.0-255,66,218874,92,246520
17256,0.003391,74.125.24.0-255,1484,220358,92,246520
17257,0.003422,74.125.24.0-255,1484,221842,92,246520
17258,0.003424,172.31.47.0-255,66,221908,92,246520
17259,0.003449,172.31.47.0-255,66,221974,92,246520
17260,0.003454,74.125.24.0-255,5738,227712,92,246520
17261,0.003455,172.31.47.0-255,66,227778,92,246520
17262,0.003472,74.125.24.0-255,6438,234216,92,246520
17263,0.003474,172.31.47.0-255,66,234282,92,246520
17264,0.003477,74.125.24.0-255,1484,235766,92,246520
17265,0.0035,74.125.24.0-255,4320,240086,92,246520
17266,0.003502,172.31.47.0-255,66,240152,92,246520
17267,0.00352,74.125.24.0-255,2902,243054,92,246520
17268,0.003522,172.31.47.0-255,66,243120,92,246520
17269,0.003552,172.31.47.0-255,66,243186,92,246520
17270,0.003555,74.125.24.0-255,1484,244670,92,246520
17271,0.003557,74.125.24.0-255,1154,245824,92,246520
17272,0.003558,172.31.47.0-255,66,245890,92,246520
17273,0.003587,74.125.24.0-255,105,245995,92,246520
17274,0.004567,172.31.47.0-255,105,246100,92,246520
17275,0.004733,172.31.47.0-255,90,246190,92,246520
17276,0.00474,172.31.47.0-255,66,246256,92,246520
17277,0.006531,74.125.24.0-255,66,246322,92,246520
17278,0.00669,74.125.24.0-255,66,246388,92,246520
17279,0.008348,74.125.24.0-255,66,246454,92,246520
17280,0.008356,172.31.47.0-255,66,246520,92,246520
17281,0.0,74.125.130.0-255,153,153,92,243837
17282,2.2e-05,172.31.47.0-255,66,219,92,243837
17283,2.8e-05,74.125.130.0-255,1484,1703,92,243837
17284,3.2e-05,172.31.47.0-255,66,1769,92,243837
17285,3.6e-05,74.125.130.0-255,2902,4671,92,243837
17286,3.9e-05,172.31.47.0-255,66,4737,92,243837
17287,6.2e-05,74.125.130.0-255,5738,10475,92,243837
17288,6.5e-05,172.31.47.0-255,66,10541,92,243837
17289,0.000101,74.125.130.0-255,6318,16859,92,243837
17290,0.000104,172.31.47.0-255,66,16925,92,243837
17291,0.000107,74.125.130.0-255,4320,21245,92,243837
17292,0.000109,172.31.47.0-255,66,21311,92,243837
17293,0.000142,74.125.130.0-255,5738,27049,92,243837
17294,0.000145,172.31.47.0-255,66,27115,92,243837
17295,0.000156,74.125.130.0-255,3961,31076,92,243837
17296,0.000158,172.31.47.0-255,66,31142,92,243837
17297,0.000301,74.125.130.0-255,1484,32626,92,243837
17298,0.000304,172.31.47.0-255,66,32692,92,243837
17299,0.000308,74.125.130.0-255,1484,34176,92,243837
17300,0.00031,172.31.47.0-255,66,34242,92,243837
17301,0.000328,74.125.130.0-255,1484,35726,92,243837
17302,0.000332,172.31.47.0-255,66,35792,92,243837
17303,0.000334,74.125.130.0-255,5738,41530,92,243837
17304,0.00034,172.31.47.0-255,66,41596,92,243837
17305,0.000369,74.125.130.0-255,6797,48393,92,243837
17306,0.000372,172.31.47.0-255,66,48459,92,243837
17307,0.000374,74.125.130.0-255,1484,49943,92,243837
17308,0.000379,172.31.47.0-255,66,50009,92,243837
17309,0.00039,74.125.130.0-255,5738,55747,92,243837
17310,0.000393,172.31.47.0-255,66,55813,92,243837
17311,0.000415,74.125.130.0-255,7156,62969,92,243837
17312,0.000418,172.31.47.0-255,66,63035,92,243837
17313,0.00044,74.125.130.0-255,1484,64519,92,243837
17314,0.000458,74.125.130.0-255,1415,65934,92,243837
17315,0.000471,172.31.47.0-255,66,66000,92,243837
17316,0.000488,74.125.130.0-255,365,66365,92,243837
17317,0.000581,74.125.130.0-255,1484,67849,92,243837
17318,0.000597,172.31.47.0-255,66,67915,92,243837
17319,0.0006,74.125.130.0-255,2902,70817,92,243837
17320,0.000603,172.31.47.0-255,66,70883,92,243837
17321,0.000616,74.125.130.0-255,2902,73785,92,243837
17322,0.000626,172.31.47.0-255,66,73851,92,243837
17323,0.000635,74.125.130.0-255,1484,75335,92,243837
17324,0.000641,74.125.130.0-255,5738,81073,92,243837
17325,0.000648,172.31.47.0-255,66,81139,92,243837
17326,0.000703,172.31.47.0-255,66,81205,92,243837
17327,0.000715,74.125.130.0-255,1484,82689,92,243837
17328,0.000735,74.125.130.0-255,6438,89127,92,243837
17329,0.000742,172.31.47.0-255,66,89193,92,243837
17330,0.000805,74.125.130.0-255,1484,90677,92,243837
17331,0.00082,74.125.130.0-255,2902,93579,92,243837
17332,0.000823,172.31.47.0-255,66,93645,92,243837
17333,0.000854,74.125.130.0-255,5738,99383,92,243837
17334,0.000863,172.31.47.0-255,66,99449,92,243837
17335,0.000875,74.125.130.0-255,2902,102351,92,243837
17336,0.000878,172.31.47.0-255,66,102417,92,243837
17337,0.000901,74.125.130.0-255,3412,105829,92,243837
17338,0.000904,172.31.47.0-255,66,105895,92,243837
17339,0.00091,74.125.130.0-255,7156,113051,92,243837
17340,0.000921,172.31.47.0-255,66,113117,92,243837
17341,0.000933,74.125.130.0-255,7156,120273,92,243837
17342,0.000944,172.31.47.0-255,66,120339,92,243837
17343,0.00096,74.125.130.0-255,2902,123241,92,243837
17344,0.000964,172.31.47.0-255,66,123307,92,243837
17345,0.000976,74.125.130.0-255,5020,128327,92,243837
17346,0.000977,172.31.47.0-255,66,128393,92,243837
17347,0.000981,172.31.47.0-255,66,128459,92,243837
17348,0.001113,74.125.130.0-255,1484,129943,92,243837
17349,0.001125,74.125.130.0-255,2902,132845,92,243837
17350,0.001128,172.31.47.0-255,66,132911,92,243837
17351,0.001147,74.125.130.0-255,4320,137231,92,243837
17352,0.00115,172.31.47.0-255,66,137297,92,243837
17353,0.001167,74.125.130.0-255,1484,138781,92,243837
17354,0.001172,74.125.130.0-255,4320,143101,92,243837
17355,0.001179,172.31.47.0-255,66,143167,92,243837
17356,0.0012,74.125.130.0-255,5738,148905,92,243837
17357,0.001204,172.31.47.0-255,66,148971,92,243837
17358,0.00121,172.31.47.0-255,66,149037,92,243837
17359,0.001238,74.125.130.0-255,2902,151939,92,243837
17360,0.001242,74.125.130.0-255,2184,154123,92,243837
17361,0.001243,172.31.47.0-255,66,154189,92,243837
17362,0.001246,172.31.47.0-255,66,154255,92,243837
17363,0.001269,74.125.130.0-255,1484,155739,92,243837
17364,0.001278,74.125.130.0-255,2902,158641,92,243837
17365,0.001292,172.31.47.0-255,66,158707,92,243837
17366,0.00132,74.125.130.0-255,5738,164445,92,243837
17367,0.001326,74.125.130.0-255,5738,170183,92,243837
17368,0.00133,172.31.47.0-255,66,170249,92,243837
17369,0.001352,74.125.130.0-255,7156,177405,92,243837
17370,0.001359,172.31.47.0-255,66,177471,92,243837
17371,0.00138,172.31.47.0-255,66,177537,92,243837
17372,0.001405,74.125.130.0-255,2184,179721,92,243837
17373,0.001417,172.31.47.0-255,66,179787,92,243837
17374,0.001421,172.31.47.0-255,66,179853,92,243837
17375,0.001448,74.125.130.0-255,2902,182755,92,243837
17376,0.001458,172.31.47.0-255,66,182821,92,243837
17377,0.001459,74.125.130.0-255,4320,187141,92,243837
17378,0.001462,172.31.47.0-255,66,187207,92,243837
17379,0.001503,74.125.130.0-255,766,187973,92,243837
17380,0.001509,172.31.47.0-255,66,188039,92,243837
17381,0.00163,74.125.130.0-255,1484,189523,92,243837
17382,0.001647,74.125.130.0-255,2902,192425,92,243837
17383,0.001651,172.31.47.0-255,66,192491,92,243837
17384,0.001658,74.125.130.0-255,5738,198229,92,243837
17385,0.001669,172.31.47.0-255,66,198295,92,243837
17386,0.001726,172.31.47.0-255,66,198361,92,243837
17387,0.001741,74.125.130.0-255,2902,201263,92,243837
17388,0.001745,172.31.47.0-255,66,201329,92,243837
17389,0.00176,172.31.47.0-255,66,201395,92,243837
17390,0.001877,74.125.130.0-255,1484,202879,92,243837
17391,0.001883,74.125.130.0-255,2902,205781,92,243837
17392,0.001886,172.31.47.0-255,66,205847,92,243837
17393,0.001911,74.125.130.0-255,1484,207331,92,243837
17394,0.001915,74.125.130.0-255,2902,210233,92,243837
17395,0.00192,74.125.130.0-255,2902,213135,92,243837
17396,0.001925,172.31.47.0-255,66,213201,92,243837
17397,0.001951,74.125.130.0-255,2902,216103,92,243837
17398,0.001959,74.125.130.0-255,7156,223259,92,243837
17399,0.00196,172.31.47.0-255,66,223325,92,243837
17400,0.001964,172.31.47.0-255,66,223391,92,243837
17401,0.001991,74.125.130.0-255,2902,226293,92,243837
17402,0.002001,172.31.47.0-255,66,226359,92,243837
17403,0.002044,172.31.47.0-255,66,226425,92,243837
17404,0.004078,74.125.130.0-255,5738,232163,92,243837
17405,0.004086,172.31.47.0-255,66,232229,92,243837
17406,0.006108,74.125.130.0-255,5738,237967,92,243837
17407,0.006114,172.31.47.0-255,66,238033,92,243837
17408,0.008142,74.125.130.0-255,5738,243771,92,243837
17409,0.008147,172.31.47.0-255,66,243837,92,243837
17410,0.0,74.125.24.0-255,298,298,92,105553
17411,1.5e-05,172.31.47.0-255,66,364,92,105553
17412,2.2e-05,74.125.24.0-255,1484,1848,92,105553
17413,2.5e-05,172.31.47.0-255,66,1914,92,105553
17414,3.2e-05,74.125.24.0-255,4320,6234,92,105553
17415,4.2e-05,172.31.47.0-255,66,6300,92,105553
17416,6.2e-05,74.125.24.0-255,1484,7784,92,105553
17417,6.5e-05,172.31.47.0-255,66,7850,92,105553
17418,0.000101,74.125.24.0-255,6120,13970,92,105553
17419,0.000104,172.31.47.0-255,66,14036,92,105553
17420,0.000125,74.125.24.0-255,1484,15520,92,105553
17421,0.000127,172.31.47.0-255,66,15586,92,105553
17422,0.000131,74.125.24.0-255,2902,18488,92,105553
17423,0.000133,172.31.47.0-255,66,18554,92,105553
17424,0.000155,74.125.24.0-255,5738,24292,92,105553
17425,0.00016,172.31.47.0-255,66,24358,92,105553
17426,0.000189,74.125.24.0-255,2902,27260,92,105553
17427,0.000191,172.31.47.0-255,66,27326,92,105553
17428,0.000224,172.31.47.0-255,66,27392,92,105553
17429,0.000234,172.31.47.0-255,66,27458,92,105553
17430,0.000236,74.125.24.0-255,1125,28583,92,105553
17431,0.000242,172.31.47.0-255,66,28649,92,105553
17432,0.000267,74.125.24.0-255,1484,30133,92,105553
17433,0.000269,172.31.47.0-255,66,30199,92,105553
17434,0.000273,74.125.24.0-255,2902,33101,92,105553
17435,0.000275,172.31.47.0-255,66,33167,92,105553
17436,0.000293,74.125.24.0-255,1484,34651,92,105553
17437,0.000295,172.31.47.0-255,66,34717,92,105553
17438,0.00031,172.31.47.0-255,66,34783,92,105553
17439,0.000312,74.125.24.0-255,1125,35908,92,105553
17440,0.000313,172.31.47.0-255,66,35974,92,105553
17441,0.000355,74.125.24.0-255,442,36416,92,105553
17442,0.000358,172.31.47.0-255,66,36482,92,105553
17443,0.000467,74.125.24.0-255,331,36813,92,105553
17444,0.000648,74.125.24.0-255,1484,38297,92,105553
17445,0.000662,172.31.47.0-255,66,38363,92,105553
17446,0.000667,74.125.24.0-255,2902,41265,92,105553
17447,0.000672,172.31.47.0-255,66,41331,92,105553
17448,0.0007,74.125.24.0-255,5738,47069,92,105553
17449,0.000703,74.125.24.0-255,1484,48553,92,105553
17450,0.000711,172.31.47.0-255,66,48619,92,105553
17451,0.000743,74.125.24.0-255,2902,51521,92,105553
17452,0.000757,172.31.47.0-255,66,51587,92,105553
17453,0.000769,172.31.47.0-255,66,51653,92,105553
17454,0.000784,74.125.24.0-255,2184,53837,92,105553
17455,0.000801,172.31.47.0-255,66,53903,92,105553
17456,0.0011,74.125.24.0-255,1484,55387,92,105553
17457,0.001106,74.125.24.0-255,2902,58289,92,105553
17458,0.001109,172.31.47.0-255,66,58355,92,105553
17459,0.001154,74.125.24.0-255,2902,61257,92,105553
17460,0.001158,172.31.47.0-255,66,61323,92,105553
17461,0.00118,74.125.24.0-255,2902,64225,92,105553
17462,0.001186,74.125.24.0-255,5738,69963,92,105553
17463,0.001195,172.31.47.0-255,66,70029,92,105553
17464,0.001206,74.125.24.0-255,5738,75767,92,105553
17465,0.001219,74.125.24.0-255,1484,77251,92,105553
17466,0.001234,172.31.47.0-255,66,77317,92,105553
17467,0.001294,74.125.24.0-255,4320,81637,92,105553
17468,0.001319,74.125.24.0-255,6438,88075,92,105553
17469,0.001327,172.31.47.0-255,66,88141,92,105553
17470,0.003561,74.125.24.0-255,5738,93879,92,105553
17471,0.003567,172.31.47.0-255,66,93945,92,105553
17472,0.005846,74.125.24.0-255,5738,99683,92,105553
17473,0.005852,172.31.47.0-255,66,99749,92,105553
17474,0.008128,74.125.24.0-255,5738,105487,92,105553
17475,0.008134,172.31.47.0-255,66,105553,92,105553
17476,0.0,172.31.47.0-255,105,105,92,276
17477,0.001479,157.240.13.0-255,105,210,92,276
17478,0.001491,172.31.47.0-255,66,276,92,276
17479,0.0,74.125.24.0-255,153,153,92,215148
17480,3.4e-05,172.31.47.0-255,66,219,92,215148
17481,4.1e-05,74.125.24.0-255,1484,1703,92,215148
17482,4.6e-05,172.31.47.0-255,66,1769,92,215148
17483,5.1e-05,74.125.24.0-255,2902,4671,92,215148
17484,5.3e-05,172.31.47.0-255,66,4737,92,215148
17485,6.1e-05,74.125.24.0-255,7156,11893,92,215148
17486,6.4e-05,172.31.47.0-255,66,11959,92,215148
17487,6.8e-05,74.125.24.0-255,3463,15422,92,215148
17488,7.2e-05,172.31.47.0-255,66,15488,92,215148
17489,7.6e-05,74.125.24.0-255,2902,18390,92,215148
17490,7.9e-05,172.31.47.0-255,66,18456,92,215148
17491,0.00012,172.31.47.0-255,66,18522,92,215148
17492,0.000124,74.125.24.0-255,2543,21065,92,215148
17493,0.000126,172.31.47.0-255,66,21131,92,215148
17494,0.000175,74.125.24.0-255,1484,22615,92,215148
17495,0.000178,172.31.47.0-255,66,22681,92,215148
17496,0.000185,74.125.24.0-255,2902,25583,92,215148
17497,0.000187,172.31.47.0-255,66,25649,92,215148
17498,0.00022,74.125.24.0-255,5738,31387,92,215148
17499,0.000224,172.31.47.0-255,66,31453,92,215148
17500,0.000232,74.125.24.0-255,6797,38250,92,215148
17501,0.000235,172.31.47.0-255,66,38316,92,215148
17502,0.000241,74.125.24.0-255,2902,41218,92,215148
17503,0.000243,172.31.47.0-255,66,41284,92,215148
17504,0.000279,172.31.47.0-255,66,41350,92,215148
17505,0.000284,74.125.24.0-255,2856,44206,92,215148
17506,0.000285,172.31.47.0-255,66,44272,92,215148
17507,0.000309,74.125.24.0-255,110,44382,92,215148
17508,0.000311,172.31.47.0-255,66,44448,92,215148
17509,0.000405,74.125.24.0-255,1484,45932,92,215148
17510,0.000411,74.125.24.0-255,1484,47416,92,215148
17511,0.000414,172.31.47.0-255,66,47482,92,215148
17512,0.000434,74.125.24.0-255,1484,48966,92,215148
17513,0.000442,74.125.24.0-255,5738,54704,92,215148
17514,0.000445,172.31.47.0-255,66,54770,92,215148
17515,0.000477,74.125.24.0-255,6797,61567,92,215148
17516,0.00048,172.31.47.0-255,66,61633,92,215148
17517,0.000487,74.125.24.0-255,5738,67371,92,215148
17518,0.000489,172.31.47.0-255,66,67437,92,215148
17519,0.000503,74.125.24.0-255,1484,68921,92,215148
17520,0.000527,172.31.47.0-255,66,68987,92,215148
17521,0.000543,74.125.24.0-255,1389,70376,92,215148
17522,0.000855,74.125.24.0-255,1484,71860,92,215148
17523,0.000859,172.31.47.0-255,66,71926,92,215148
17524,0.000864,74.125.24.0-255,2902,74828,92,215148
17525,0.000865,172.31.47.0-255,66,74894,92,215148
17526,0.000869,74.125.24.0-255,2902,77796,92,215148
17527,0.000871,172.31.47.0-255,66,77862,92,215148
17528,0.000898,74.125.24.0-255,2902,80764,92,215148
17529,0.000901,172.31.47.0-255,66,80830,92,215148
17530,0.000912,172.31.47.0-255,66,80896,92,215148
17531,0.000943,74.125.24.0-255,4320,85216,92,215148
17532,0.000946,172.31.47.0-255,66,85282,92,215148
17533,0.000968,74.125.24.0-255,5888,91170,92,215148
17534,0.000971,172.31.47.0-255,66,91236,92,215148
17535,0.000986,74.125.24.0-255,1484,92720,92,215148
17536,0.000989,74.125.24.0-255,1484,94204,92,215148
17537,0.000991,172.31.47.0-255,66,94270,92,215148
17538,0.001011,74.125.24.0-255,1484,95754,92,215148
17539,0.001017,74.125.24.0-255,5738,101492,92,215148
17540,0.00102,74.125.24.0-255,2902,104394,92,215148
17541,0.001023,172.31.47.0-255,66,104460,92,215148
17542,0.001026,172.31.47.0-255,66,104526,92,215148
17543,0.001044,74.125.24.0-255,5738,110264,92,215148
17544,0.001046,172.31.47.0-255,66,110330,92,215148
17545,0.001103,172.31.47.0-255,66,110396,92,215148
17546,0.001164,74.125.24.0-255,1484,111880,92,215148
17547,0.001168,74.125.24.0-255,2902,114782,92,215148
17548,0.001172,172.31.47.0-255,66,114848,92,215148
17549,0.001179,74.125.24.0-255,1484,116332,92,215148
17550,0.001197,74.125.24.0-255,4320,120652,92,215148
17551,0.001199,172.31.47.0-255,66,120718,92,215148
17552,0.001228,172.31.47.0-255,66,120784,92,215148
17553,0.001246,74.125.24.0-255,1484,122268,92,215148
17554,0.001258,172.31.47.0-255,66,122334,92,215148
17555,0.00128,74.125.24.0-255,4320,126654,92,215148
17556,0.001283,172.31.47.0-255,66,126720,92,215148
17557,0.001302,74.125.24.0-255,2902,129622,92,215148
17558,0.001305,172.31.47.0-255,66,129688,92,215148
17559,0.001314,172.31.47.0-255,66,129754,92,215148
17560,0.001334,74.125.24.0-255,5738,135492,92,215148
17561,0.001337,172.31.47.0-255,66,135558,92,215148
17562,0.001373,172.31.47.0-255,66,135624,92,215148
17563,0.001375,74.125.24.0-255,766,136390,92,215148
17564,0.001391,74.125.24.0-255,2902,139292,92,215148
17565,0.001394,172.31.47.0-255,66,139358,92,215148
17566,0.001428,172.31.47.0-255,66,139424,92,215148
17567,0.001457,74.125.24.0-255,2902,142326,92,215148
17568,0.001461,172.31.47.0-255,66,142392,92,215148
17569,0.001494,172.31.47.0-255,66,142458,92,215148
17570,0.001519,74.125.24.0-255,1484,143942,92,215148
17571,0.001522,74.125.24.0-255,1484,145426,92,215148
17572,0.001524,172.31.47.0-255,66,145492,92,215148
17573,0.001542,74.125.24.0-255,1484,146976,92,215148
17574,0.001546,74.125.24.0-255,4320,151296,92,215148
17575,0.001549,172.31.47.0-255,66,151362,92,215148
17576,0.001569,74.125.24.0-255,1484,152846,92,215148
17577,0.001581,172.31.47.0-255,66,152912,92,215148
17578,0.001603,74.125.24.0-255,5738,158650,92,215148
17579,0.001605,172.31.47.0-255,66,158716,92,215148
17580,0.001624,74.125.24.0-255,5020,163736,92,215148
17581,0.001626,172.31.47.0-255,66,163802,92,215148
17582,0.002151,74.125.24.0-255,1484,165286,92,215148
17583,0.002163,74.125.24.0-255,2902,168188,92,215148
17584,0.002166,172.31.47.0-255,66,168254,92,215148
17585,0.002182,74.125.24.0-255,5738,173992,92,215148
17586,0.002185,172.31.47.0-255,66,174058,92,215148
17587,0.002225,172.31.47.0-255,66,174124,92,215148
17588,0.002237,172.31.47.0-255,66,174190,92,215148
17589,0.002287,74.125.24.0-255,1484,175674,92,215148
17590,0.002292,74.125.24.0-255,2902,178576,92,215148
17591,0.002295,172.31.47.0-255,66,178642,92,215148
17592,0.002301,74.125.24.0-255,5738,184380,92,215148
17593,0.002303,172.31.47.0-255,66,184446,92,215148
17594,0.002308,74.125.24.0-255,4320,188766,92,215148
17595,0.00231,172.31.47.0-255,66,188832,92,215148
17596,0.002332,172.31.47.0-255,66,188898,92,215148
17597,0.002337,74.125.24.0-255,4320,193218,92,215148
17598,0.002339,172.31.47.0-255,66,193284,92,215148
17599,0.002344,74.125.24.0-255,5738,199022,92,215148
17600,0.002347,172.31.47.0-255,66,199088,92,215148
17601,0.004713,74.125.24.0-255,5738,204826,92,215148
17602,0.004718,172.31.47.0-255,66,204892,92,215148
17603,0.007071,74.125.24.0-255,4320,209212,92,215148
17604,0.007074,172.31.47.0-255,66,209278,92,215148
17605,0.007087,74.125.24.0-255,1484,210762,92,215148
17606,0.009429,74.125.24.0-255,4320,215082,92,215148
17607,0.009435,172.31.47.0-255,66,215148,92,215148
17608,0.0,172.217.194.0-255,152,152,92,146448
17609,2.4e-05,172.31.47.0-255,66,218,92,146448
17610,3.1e-05,172.217.194.0-255,1484,1702,92,146448
17611,3.5e-05,172.31.47.0-255,66,1768,92,146448
17612,4e-05,172.217.194.0-255,2902,4670,92,146448
17613,4.2e-05,172.31.47.0-255,66,4736,92,146448
17614,4.9e-05,172.217.194.0-255,7156,11892,92,146448
17615,5.1e-05,172.31.47.0-255,66,11958,92,146448
17616,6.9e-05,172.217.194.0-255,1484,13442,92,146448
17617,7.1e-05,172.31.47.0-255,66,13508,92,146448
17618,0.000103,172.31.47.0-255,66,13574,92,146448
17619,0.000122,172.217.194.0-255,2078,15652,92,146448
17620,0.000125,172.31.47.0-255,66,15718,92,146448
17621,0.000139,172.31.47.0-255,66,15784,92,146448
17622,0.000144,172.217.194.0-255,5020,20804,92,146448
17623,0.000146,172.31.47.0-255,66,20870,92,146448
17624,0.000478,172.217.194.0-255,1484,22354,92,146448
17625,0.000485,172.31.47.0-255,66,22420,92,146448
17626,0.00049,172.217.194.0-255,2902,25322,92,146448
17627,0.000492,172.31.47.0-255,66,25388,92,146448
17628,0.000498,172.217.194.0-255,5738,31126,92,146448
17629,0.0005,172.31.47.0-255,66,31192,92,146448
17630,0.000533,172.217.194.0-255,7108,38300,92,146448
17631,0.000536,172.31.47.0-255,66,38366,92,146448
17632,0.000749,172.217.194.0-255,1484,39850,92,146448
17633,0.000753,172.31.47.0-255,66,39916,92,146448
17634,0.000767,172.217.194.0-255,2902,42818,92,146448
17635,0.00077,172.31.47.0-255,66,42884,92,146448
17636,0.000775,172.217.194.0-255,5738,48622,92,146448
17637,0.000778,172.31.47.0-255,66,48688,92,146448
17638,0.000781,172.217.194.0-255,1484,50172,92,146448
17639,0.000784,172.31.47.0-255,66,50238,92,146448
17640,0.000815,172.217.194.0-255,5738,55976,92,146448
17641,0.000818,172.31.47.0-255,66,56042,92,146448
17642,0.000842,172.217.194.0-255,7156,63198,92,146448
17643,0.000847,172.31.47.0-255,66,63264,92,146448
17644,0.000853,172.31.47.0-255,66,63330,92,146448
17645,0.000902,172.31.47.0-255,66,63396,92,146448
17646,0.000941,172.217.194.0-255,2902,66298,92,146448
17647,0.000945,172.31.47.0-255,66,66364,92,146448
17648,0.000956,172.31.47.0-255,66,66430,92,146448
17649,0.000969,172.31.47.0-255,66,66496,92,146448
17650,0.001005,172.31.47.0-255,66,66562,92,146448
17651,0.001015,172.31.47.0-255,66,66628,92,146448
17652,0.001113,172.217.194.0-255,1484,68112,92,146448
17653,0.001118,172.31.47.0-255,66,68178,92,146448
17654,0.001123,172.217.194.0-255,2902,71080,92,146448
17655,0.001126,172.31.47.0-255,66,71146,92,146448
17656,0.001179,172.217.194.0-255,5738,76884,92,146448
17657,0.00135,172.217.194.0-255,1484,78368,92,146448
17658,0.001355,172.217.194.0-255,1484,79852,92,146448
17659,0.001371,172.217.194.0-255,1484,81336,92,146448
17660,0.001387,172.217.194.0-255,4320,85656,92,146448
17661,0.001402,172.217.194.0-255,1484,87140,92,146448
17662,0.001421,172.217.194.0-255,2902,90042,92,146448
17663,0.001443,172.217.194.0-255,5738,95780,92,146448
17664,0.001455,172.217.194.0-255,1484,97264,92,146448
17665,0.001477,172.217.194.0-255,3602,100866,92,146448
17666,0.001512,172.217.194.0-255,1484,102350,92,146448
17667,0.001524,172.217.194.0-255,2902,105252,92,146448
17668,0.00154,172.217.194.0-255,1484,106736,92,146448
17669,0.001556,172.217.194.0-255,4320,111056,92,146448
17670,0.001558,172.217.194.0-255,1484,112540,92,146448
17671,0.001573,172.217.194.0-255,2902,115442,92,146448
17672,0.001578,172.217.194.0-255,4320,119762,92,146448
17673,0.001604,172.217.194.0-255,7156,126918,92,146448
17674,0.001663,172.217.194.0-255,4320,131238,92,146448
17675,0.00171,172.217.194.0-255,5738,136976,92,146448
17676,0.001727,172.217.194.0-255,3602,140578,92,146448
17677,0.005615,172.31.47.0-255,66,140644,92,146448
17678,0.008174,172.217.194.0-255,5738,146382,92,146448
17679,0.008179,172.31.47.0-255,66,146448,92,146448
17680,0.0,172.31.47.0-255,105,105,92,105
17681,0.0,172.31.47.0-255,105,105,92,210
17682,3.2e-05,172.31.47.0-255,105,210,92,210
17683,0.0,74.125.68.0-255,153,153,92,322455
17684,2.1e-05,172.31.47.0-255,66,219,92,322455
17685,2.8e-05,74.125.68.0-255,1484,1703,92,322455
17686,3.1e-05,172.31.47.0-255,66,1769,92,322455
17687,3.6e-05,74.125.68.0-255,2902,4671,92,322455
17688,3.9e-05,172.31.47.0-255,66,4737,92,322455
17689,7.6e-05,74.125.68.0-255,4320,9057,92,322455
17690,7.9e-05,172.31.47.0-255,66,9123,92,322455
17691,9.9e-05,74.125.68.0-255,2902,12025,92,322455
17692,0.000101,172.31.47.0-255,66,12091,92,322455
17693,0.000107,74.125.68.0-255,4803,16894,92,322455
17694,0.000109,172.31.47.0-255,66,16960,92,322455
17695,0.000147,172.31.47.0-255,66,17026,92,322455
17696,0.000299,74.125.68.0-255,1484,18510,92,322455
17697,0.000301,172.31.47.0-255,66,18576,92,322455
17698,0.000306,74.125.68.0-255,2902,21478,92,322455
17699,0.000308,172.31.47.0-255,66,21544,92,322455
17700,0.000325,74.125.68.0-255,1484,23028,92,322455
17701,0.000327,172.31.47.0-255,66,23094,92,322455
17702,0.000344,74.125.68.0-255,4320,27414,92,322455
17703,0.000346,172.31.47.0-255,66,27480,92,322455
17704,0.000349,74.125.68.0-255,1484,28964,92,322455
17705,0.000351,172.31.47.0-255,66,29030,92,322455
17706,0.000373,74.125.68.0-255,1484,30514,92,322455
17707,0.000375,172.31.47.0-255,66,30580,92,322455
17708,0.000403,172.31.47.0-255,66,30646,92,322455
17709,0.000408,74.125.68.0-255,4320,34966,92,322455
17710,0.00041,172.31.47.0-255,66,35032,92,322455
17711,0.000457,74.125.68.0-255,4320,39352,92,322455
17712,0.000459,172.31.47.0-255,66,39418,92,322455
17713,0.000479,74.125.68.0-255,4270,43688,92,322455
17714,0.00048,172.31.47.0-255,66,43754,92,322455
17715,0.000483,74.125.68.0-255,109,43863,92,322455
17716,0.000511,74.125.68.0-255,1484,45347,92,322455
17717,0.000513,172.31.47.0-255,66,45413,92,322455
17718,0.000527,74.125.68.0-255,2902,48315,92,322455
17719,0.00053,172.31.47.0-255,66,48381,92,322455
17720,0.000534,74.125.68.0-255,2902,51283,92,322455
17721,0.000536,172.31.47.0-255,66,51349,92,322455
17722,0.000574,74.125.68.0-255,4320,55669,92,322455
17723,0.000576,172.31.47.0-255,66,55735,92,322455
17724,0.000581,74.125.68.0-255,4320,60055,92,322455
17725,0.000583,172.31.47.0-255,66,60121,92,322455
17726,0.000598,74.125.68.0-255,4320,64441,92,322455
17727,0.0006,172.31.47.0-255,66,64507,92,322455
17728,0.000606,74.125.68.0-255,5738,70245,92,322455
17729,0.000607,172.31.47.0-255,66,70311,92,322455
17730,0.000644,74.125.68.0-255,4320,74631,92,322455
17731,0.000646,172.31.47.0-255,66,74697,92,322455
17732,0.000658,74.125.68.0-255,3870,78567,92,322455
17733,0.00066,172.31.47.0-255,66,78633,92,322455
17734,0.000729,74.125.68.0-255,1484,80117,92,322455
17735,0.000741,74.125.68.0-255,2902,83019,92,322455
17736,0.000744,172.31.47.0-255,66,83085,92,322455
17737,0.000767,74.125.68.0-255,4320,87405,92,322455
17738,0.00077,172.31.47.0-255,66,87471,92,322455
17739,0.000792,172.31.47.0-255,66,87537,92,322455
17740,0.000797,74.125.68.0-255,4320,91857,92,322455
17741,0.000799,172.31.47.0-255,66,91923,92,322455
17742,0.00081,74.125.68.0-255,1484,93407,92,322455
17743,0.000831,74.125.68.0-255,7156,100563,92,322455
17744,0.000833,172.31.47.0-255,66,100629,92,322455
17745,0.000851,74.125.68.0-255,3602,104231,92,322455
17746,0.000853,172.31.47.0-255,66,104297,92,322455
17747,0.000958,74.125.68.0-255,1484,105781,92,322455
17748,0.000976,74.125.68.0-255,2902,108683,92,322455
17749,0.000979,172.31.47.0-255,66,108749,92,322455
17750,0.001009,74.125.68.0-255,4320,113069,92,322455
17751,0.001011,172.31.47.0-255,66,113135,92,322455
17752,0.001026,74.125.68.0-255,5738,118873,92,322455
17753,0.001029,172.31.47.0-255,66,118939,92,322455
17754,0.001043,74.125.68.0-255,2902,121841,92,322455
17755,0.001045,172.31.47.0-255,66,121907,92,322455
17756,0.00105,74.125.68.0-255,2902,124809,92,322455
17757,0.001052,172.31.47.0-255,66,124875,92,322455
17758,0.001078,74.125.68.0-255,7156,132031,92,322455
17759,0.001081,172.31.47.0-255,66,132097,92,322455
17760,0.001087,74.125.68.0-255,5738,137835,92,322455
17761,0.00109,172.31.47.0-255,66,137901,92,322455
17762,0.001102,74.125.68.0-255,766,138667,92,322455
17763,0.001328,74.125.68.0-255,1484,140151,92,322455
17764,0.001334,172.31.47.0-255,66,140217,92,322455
17765,0.001339,74.125.68.0-255,2902,143119,92,322455
17766,0.001341,172.31.47.0-255,66,143185,92,322455
17767,0.001365,74.125.68.0-255,5738,148923,92,322455
17768,0.001368,172.31.47.0-255,66,148989,92,322455
17769,0.001402,172.31.47.0-255,66,149055,92,322455
17770,0.001449,74.125.68.0-255,2902,151957,92,322455
17771,0.001452,172.31.47.0-255,66,152023,92,322455
17772,0.001478,74.125.68.0-255,7156,159179,92,322455
17773,0.001482,172.31.47.0-255,66,159245,92,322455
17774,0.001487,74.125.68.0-255,5020,164265,92,322455
17775,0.001489,172.31.47.0-255,66,164331,92,322455
17776,0.001566,74.125.68.0-255,1484,165815,92,322455
17777,0.001576,74.125.68.0-255,1484,167299,92,322455
17778,0.00158,172.31.47.0-255,66,167365,92,322455
17779,0.0016,74.125.68.0-255,2902,170267,92,322455
17780,0.001603,172.31.47.0-255,66,170333,92,322455
17781,0.001607,74.125.68.0-255,2902,173235,92,322455
17782,0.001609,172.31.47.0-255,66,173301,92,322455
17783,0.001622,74.125.68.0-255,2902,176203,92,322455
17784,0.001626,172.31.47.0-255,66,176269,92,322455
17785,0.001638,74.125.68.0-255,5738,182007,92,322455
17786,0.00164,172.31.47.0-255,66,182073,92,322455
17787,0.001655,74.125.68.0-255,1484,183557,92,322455
17788,0.001671,74.125.68.0-255,5738,189295,92,322455
17789,0.001674,172.31.47.0-255,66,189361,92,322455
17790,0.001693,74.125.68.0-255,2902,192263,92,322455
17791,0.001695,172.31.47.0-255,66,192329,92,322455
17792,0.001699,74.125.68.0-255,2902,195231,92,322455
17793,0.001701,172.31.47.0-255,66,195297,92,322455
17794,0.001706,74.125.68.0-255,3602,198899,92,322455
17795,0.001709,172.31.47.0-255,66,198965,92,322455
17796,0.001885,74.125.68.0-255,1484,200449,92,322455
17797,0.001906,74.125.68.0-255,2902,203351,92,322455
17798,0.001909,172.31.47.0-255,66,203417,92,322455
17799,0.001947,74.125.68.0-255,5738,209155,92,322455
17800,0.00195,172.31.47.0-255,66,209221,92,322455
17801,0.00199,74.125.68.0-255,7156,216377,92,322455
17802,0.001993,172.31.47.0-255,66,216443,92,322455
17803,0.001998,74.125.68.0-255,4320,220763,92,322455
17804,0.002,172.31.47.0-255,66,220829,92,322455
17805,0.00202,74.125.68.0-255,5738,226567,92,322455
17806,0.002024,172.31.47.0-255,66,226633,92,322455
17807,0.002051,74.125.68.0-255,4320,230953,92,322455
17808,0.002054,172.31.47.0-255,66,231019,92,322455
17809,0.002092,74.125.68.0-255,2184,233203,92,322455
17810,0.002096,172.31.47.0-255,66,233269,92,322455
17811,0.002229,74.125.68.0-255,1484,234753,92,322455
17812,0.002246,74.125.68.0-255,1484,236237,92,322455
17813,0.00225,172.31.47.0-255,66,236303,92,322455
17814,0.002266,74.125.68.0-255,2902,239205,92,322455
17815,0.002269,172.31.47.0-255,66,239271,92,322455
17816,0.002289,74.125.68.0-255,5738,245009,92,322455
17817,0.002291,172.31.47.0-255,66,245075,92,322455
17818,0.002319,74.125.68.0-255,2902,247977,92,322455
17819,0.002322,172.31.47.0-255,66,248043,92,322455
17820,0.002342,74.125.68.0-255,4320,252363,92,322455
17821,0.002345,172.31.47.0-255,66,252429,92,322455
17822,0.002351,74.125.68.0-255,7156,259585,92,322455
17823,0.002353,172.31.47.0-255,66,259651,92,322455
17824,0.002357,74.125.68.0-255,2902,262553,92,322455
17825,0.00236,172.31.47.0-255,66,262619,92,322455
17826,0.002383,74.125.68.0-255,5020,267639,92,322455
17827,0.002385,172.31.47.0-255,66,267705,92,322455
17828,0.002402,74.125.68.0-255,1484,269189,92,322455
17829,0.002415,74.125.68.0-255,2902,272091,92,322455
17830,0.002435,74.125.68.0-255,1484,273575,92,322455
17831,0.002438,172.31.47.0-255,66,273641,92,322455
17832,0.002456,74.125.68.0-255,4320,277961,92,322455
17833,0.002459,74.125.68.0-255,1484,279445,92,322455
17834,0.002465,172.31.47.0-255,66,279511,92,322455
17835,0.002479,74.125.68.0-255,5738,285249,92,322455
17836,0.002488,172.31.47.0-255,66,285315,92,322455
17837,0.002497,74.125.68.0-255,4320,289635,92,322455
17838,0.002501,172.31.47.0-255,66,289701,92,322455
17839,0.002514,74.125.68.0-255,5738,295439,92,322455
17840,0.002531,172.31.47.0-255,66,295505,92,322455
17841,0.002545,74.125.68.0-255,4320,299825,92,322455
17842,0.002558,74.125.68.0-255,4320,304145,92,322455
17843,0.002564,172.31.47.0-255,66,304211,92,322455
17844,0.002582,74.125.68.0-255,2184,306395,92,322455
17845,0.002586,74.125.68.0-255,2902,309297,92,322455
17846,0.002588,74.125.68.0-255,1484,310781,92,322455
17847,0.002604,172.31.47.0-255,66,310847,92,322455
17848,0.005141,74.125.68.0-255,5738,316585,92,322455
17849,0.005147,172.31.47.0-255,66,316651,92,322455
17850,0.007697,74.125.68.0-255,5738,322389,92,322455
17851,0.007702,172.31.47.0-255,66,322455,92,322455
17852,0.0,172.217.26.0-255,297,297,92,127245
17853,2.4e-05,172.31.47.0-255,66,363,92,127245
17854,2.9e-05,172.217.26.0-255,1484,1847,92,127245
17855,3.3e-05,172.31.47.0-255,66,1913,92,127245
17856,3.9e-05,172.217.26.0-255,4320,6233,92,127245
17857,4.1e-05,172.31.47.0-255,66,6299,92,127245
17858,8e-05,172.31.47.0-255,66,6365,92,127245
17859,8.5e-05,172.217.26.0-255,2902,9267,92,127245
17860,8.7e-05,172.31.47.0-255,66,9333,92,127245
17861,0.000112,172.31.47.0-255,66,9399,92,127245
17862,0.000117,172.217.26.0-255,3961,13360,92,127245
17863,0.000119,172.31.47.0-255,66,13426,92,127245
17864,0.000203,172.217.26.0-255,1484,14910,92,127245
17865,0.000206,172.31.47.0-255,66,14976,92,127245
17866,0.000229,172.217.26.0-255,2902,17878,92,127245
17867,0.000231,172.31.47.0-255,66,17944,92,127245
17868,0.000235,172.217.26.0-255,4320,22264,92,127245
17869,0.000238,172.31.47.0-255,66,22330,92,127245
17870,0.000251,172.217.26.0-255,4320,26650,92,127245
17871,0.000254,172.31.47.0-255,66,26716,92,127245
17872,0.000267,172.217.26.0-255,5379,32095,92,127245
17873,0.00027,172.31.47.0-255,66,32161,92,127245
17874,0.000272,172.217.26.0-255,1484,33645,92,127245
17875,0.000274,172.31.47.0-255,66,33711,92,127245
17876,0.000294,172.31.47.0-255,66,33777,92,127245
17877,0.000319,172.217.26.0-255,5379,39156,92,127245
17878,0.000322,172.31.47.0-255,66,39222,92,127245
17879,0.000324,172.217.26.0-255,352,39574,92,127245
17880,0.000326,172.31.47.0-255,66,39640,92,127245
17881,0.001074,172.217.26.0-255,141,39781,92,127245
17882,0.001109,172.31.47.0-255,66,39847,92,127245
17883,0.001167,172.217.26.0-255,1484,41331,92,127245
17884,0.001172,172.217.26.0-255,2902,44233,92,127245
17885,0.001176,172.31.47.0-255,66,44299,92,127245
17886,0.00118,172.217.26.0-255,2902,47201,92,127245
17887,0.001182,172.31.47.0-255,66,47267,92,127245
17888,0.001185,172.217.26.0-255,1484,48751,92,127245
17889,0.001201,172.217.26.0-255,2902,51653,92,127245
17890,0.001203,172.31.47.0-255,66,51719,92,127245
17891,0.001245,172.217.26.0-255,5379,57098,92,127245
17892,0.001248,172.31.47.0-255,66,57164,92,127245
17893,0.001255,172.217.26.0-255,5738,62902,92,127245
17894,0.001257,172.31.47.0-255,66,62968,92,127245
17895,0.001326,172.31.47.0-255,66,63034,92,127245
17896,0.001345,172.217.26.0-255,2543,65577,92,127245
17897,0.001349,172.31.47.0-255,66,65643,92,127245
17898,0.001822,172.217.26.0-255,1484,67127,92,127245
17899,0.00183,172.217.26.0-255,2902,70029,92,127245
17900,0.001833,172.31.47.0-255,66,70095,92,127245
17901,0.001838,172.217.26.0-255,2902,72997,92,127245
17902,0.001839,172.31.47.0-255,66,73063,92,127245
17903,0.001842,172.217.26.0-255,1484,74547,92,127245
17904,0.001855,172.217.26.0-255,2902,77449,92,127245
17905,0.001857,172.31.47.0-255,66,77515,92,127245
17906,0.001861,172.217.26.0-255,2902,80417,92,127245
17907,0.001862,172.31.47.0-255,66,80483,92,127245
17908,0.001886,172.217.26.0-255,5738,86221,92,127245
17909,0.001888,172.31.47.0-255,66,86287,92,127245
17910,0.001893,172.217.26.0-255,4320,90607,92,127245
17911,0.001894,172.31.47.0-255,66,90673,92,127245
17912,0.001921,172.31.47.0-255,66,90739,92,127245
17913,0.00195,172.217.26.0-255,1484,92223,92,127245
17914,0.001952,172.217.26.0-255,1484,93707,92,127245
17915,0.001954,172.31.47.0-255,66,93773,92,127245
17916,0.001974,172.217.26.0-255,1484,95257,92,127245
17917,0.001979,172.217.26.0-255,5738,100995,92,127245
17918,0.001983,172.31.47.0-255,66,101061,92,127245
17919,0.00199,172.217.26.0-255,2902,103963,92,127245
17920,0.001991,172.31.47.0-255,66,104029,92,127245
17921,0.003926,172.217.26.0-255,5738,109767,92,127245
17922,0.003932,172.31.47.0-255,66,109833,92,127245
17923,0.005862,172.217.26.0-255,5738,115571,92,127245
17924,0.005869,172.31.47.0-255,66,115637,92,127245
17925,0.007838,172.217.26.0-255,5738,121375,92,127245
17926,0.007844,172.31.47.0-255,66,121441,92,127245
17927,0.009777,172.217.26.0-255,5738,127179,92,127245
17928,0.009783,172.31.47.0-255,66,127245,92,127245
17929,0.0,74.125.24.0-255,153,153,92,145339
17930,2.2e-05,172.31.47.0-255,66,219,92,145339
17931,2.8e-05,74.125.24.0-255,1484,1703,92,145339
17932,3.2e-05,172.31.47.0-255,66,1769,92,145339
17933,3.6e-05,74.125.24.0-255,2902,4671,92,145339
17934,3.8e-05,172.31.47.0-255,66,4737,92,145339
17935,5.1e-05,74.125.24.0-255,7156,11893,92,145339
17936,5.3e-05,172.31.47.0-255,66,11959,92,145339
17937,5.8e-05,74.125.24.0-255,2256,14215,92,145339
17938,6.1e-05,172.31.47.0-255,66,14281,92,145339
17939,0.000289,74.125.24.0-255,1484,15765,92,145339
17940,0.000295,172.31.47.0-255,66,15831,92,145339
17941,0.0003,74.125.24.0-255,2902,18733,92,145339
17942,0.000303,172.31.47.0-255,66,18799,92,145339
17943,0.000314,74.125.24.0-255,5738,24537,92,145339
17944,0.000317,172.31.47.0-255,66,24603,92,145339
17945,0.000348,74.125.24.0-255,4320,28923,92,145339
17946,0.000352,172.31.47.0-255,66,28989,92,145339
17947,0.000391,172.31.47.0-255,66,29055,92,145339
17948,0.000408,172.31.47.0-255,66,29121,92,145339
17949,0.000464,74.125.24.0-255,1484,30605,92,145339
17950,0.000468,172.31.47.0-255,66,30671,92,145339
17951,0.000481,74.125.24.0-255,2902,33573,92,145339
17952,0.000489,172.31.47.0-255,66,33639,92,145339
17953,0.000495,74.125.24.0-255,5738,39377,92,145339
17954,0.000497,172.31.47.0-255,66,39443,92,145339
17955,0.000532,74.125.24.0-255,7091,46534,92,145339
17956,0.000536,172.31.47.0-255,66,46600,92,145339
17957,0.000571,74.125.24.0-255,385,46985,92,145339
17958,0.000574,172.31.47.0-255,66,47051,92,145339
17959,0.000803,74.125.24.0-255,1484,48535,92,145339
17960,0.00081,74.125.24.0-255,2902,51437,92,145339
17961,0.000813,172.31.47.0-255,66,51503,92,145339
17962,0.000816,74.125.24.0-255,1484,52987,92,145339
17963,0.000842,74.125.24.0-255,4320,57307,92,145339
17964,0.000845,172.31.47.0-255,66,57373,92,145339
17965,0.000852,74.125.24.0-255,4320,61693,92,145339
17966,0.000853,172.31.47.0-255,66,61759,92,145339
17967,0.000865,74.125.24.0-255,5379,67138,92,145339
17968,0.000867,172.31.47.0-255,66,67204,92,145339
17969,0.000872,74.125.24.0-255,2902,70106,92,145339
17970,0.000874,172.31.47.0-255,66,70172,92,145339
17971,0.000888,74.125.24.0-255,7156,77328,92,145339
17972,0.00089,172.31.47.0-255,66,77394,92,145339
17973,0.000914,74.125.24.0-255,1484,78878,92,145339
17974,0.000924,74.125.24.0-255,2543,81421,92,145339
17975,0.000926,172.31.47.0-255,66,81487,92,145339
17976,0.001235,74.125.24.0-255,1484,82971,92,145339
17977,0.001243,74.125.24.0-255,2902,85873,92,145339
17978,0.001247,172.31.47.0-255,66,85939,92,145339
17979,0.001251,74.125.24.0-255,1484,87423,92,145339
17980,0.001275,74.125.24.0-255,4320,91743,92,145339
17981,0.001278,172.31.47.0-255,66,91809,92,145339
17982,0.001283,74.125.24.0-255,4320,96129,92,145339
17983,0.001285,172.31.47.0-255,66,96195,92,145339
17984,0.001311,74.125.24.0-255,7156,103351,92,145339
17985,0.001319,172.31.47.0-255,66,103417,92,145339
17986,0.001345,74.125.24.0-255,4320,107737,92,145339
17987,0.001348,172.31.47.0-255,66,107803,92,145339
17988,0.001357,172.31.47.0-255,66,107869,92,145339
17989,0.00199,74.125.24.0-255,1484,109353,92,145339
17990,0.001997,74.125.24.0-255,2902,112255,92,145339
17991,0.002001,172.31.47.0-255,66,112321,92,145339
17992,0.002027,74.125.24.0-255,5738,118059,92,145339
17993,0.002029,172.31.47.0-255,66,118125,92,145339
17994,0.002056,74.125.24.0-255,7156,125281,92,145339
17995,0.002058,172.31.47.0-255,66,125347,92,145339
17996,0.002089,172.31.47.0-255,66,125413,92,145339
17997,0.002092,74.125.24.0-255,2184,127597,92,145339
17998,0.002094,172.31.47.0-255,66,127663,92,145339
17999,0.004335,74.125.24.0-255,2902,130565,92,145339
18000,0.004337,172.31.47.0-255,66,130631,92,145339
18001,0.004363,74.125.24.0-255,2902,133533,92,145339
18002,0.004365,172.31.47.0-255,66,133599,92,145339
18003,0.006612,74.125.24.0-255,2902,136501,92,145339
18004,0.006618,172.31.47.0-255,66,136567,92,145339
18005,0.006654,74.125.24.0-255,2902,139469,92,145339
18006,0.006657,172.31.47.0-255,66,139535,92,145339
18007,0.008918,74.125.24.0-255,5738,145273,92,145339
18008,0.008925,172.31.47.0-255,66,145339,92,145339
18009,0.0,172.217.194.0-255,153,153,92,123611
18010,6.3e-05,172.31.47.0-255,66,219,92,123611
18011,7e-05,172.217.194.0-255,1484,1703,92,123611
18012,7.4e-05,172.31.47.0-255,66,1769,92,123611
18013,7.9e-05,172.217.194.0-255,2902,4671,92,123611
18014,8.1e-05,172.31.47.0-255,66,4737,92,123611
18015,8.7e-05,172.217.194.0-255,4320,9057,92,123611
18016,9e-05,172.31.47.0-255,66,9123,92,123611
18017,0.000101,172.31.47.0-255,66,9189,92,123611
18018,0.000114,172.31.47.0-255,66,9255,92,123611
18019,0.000171,172.31.47.0-255,66,9321,92,123611
18020,0.000185,172.31.47.0-255,66,9387,92,123611
18021,0.000191,172.217.194.0-255,6438,15825,92,123611
18022,0.000193,172.31.47.0-255,66,15891,92,123611
18023,0.000216,172.217.194.0-255,394,16285,92,123611
18024,0.000219,172.31.47.0-255,66,16351,92,123611
18025,0.000277,172.217.194.0-255,1799,18150,92,123611
18026,0.00028,172.31.47.0-255,66,18216,92,123611
18027,0.000283,172.217.194.0-255,1484,19700,92,123611
18028,0.000287,172.31.47.0-255,66,19766,92,123611
18029,0.000303,172.217.194.0-255,5738,25504,92,123611
18030,0.000306,172.31.47.0-255,66,25570,92,123611
18031,0.000346,172.31.47.0-255,66,25636,92,123611
18032,0.000376,172.31.47.0-255,66,25702,92,123611
18033,0.000391,172.217.194.0-255,5738,31440,92,123611
18034,0.000394,172.31.47.0-255,66,31506,92,123611
18035,0.000407,172.217.194.0-255,2543,34049,92,123611
18036,0.000409,172.31.47.0-255,66,34115,92,123611
18037,0.000742,172.217.194.0-255,1484,35599,92,123611
18038,0.000748,172.217.194.0-255,2902,38501,92,123611
18039,0.000751,172.31.47.0-255,66,38567,92,123611
18040,0.000774,172.217.194.0-255,5738,44305,92,123611
18041,0.000777,172.31.47.0-255,66,44371,92,123611
18042,0.000781,172.217.194.0-255,2902,47273,92,123611
18043,0.000784,172.31.47.0-255,66,47339,92,123611
18044,0.000807,172.31.47.0-255,66,47405,92,123611
18045,0.000818,172.31.47.0-255,66,47471,92,123611
18046,0.000948,172.217.194.0-255,1484,48955,92,123611
18047,0.000961,172.217.194.0-255,2902,51857,92,123611
18048,0.000965,172.31.47.0-255,66,51923,92,123611
18049,0.000971,172.217.194.0-255,5738,57661,92,123611
18050,0.000973,172.31.47.0-255,66,57727,92,123611
18051,0.001001,172.217.194.0-255,2902,60629,92,123611
18052,0.001004,172.31.47.0-255,66,60695,92,123611
18053,0.001009,172.217.194.0-255,4320,65015,92,123611
18054,0.001011,172.31.47.0-255,66,65081,92,123611
18055,0.001023,172.217.194.0-255,2902,67983,92,123611
18056,0.001026,172.31.47.0-255,66,68049,92,123611
18057,0.001048,172.217.194.0-255,5738,73787,92,123611
18058,0.001052,172.31.47.0-255,66,73853,92,123611
18059,0.001064,172.217.194.0-255,4320,78173,92,123611
18060,0.001066,172.31.47.0-255,66,78239,92,123611
18061,0.001091,172.217.194.0-255,3602,81841,92,123611
18062,0.001094,172.31.47.0-255,66,81907,92,123611
18063,0.001231,172.217.194.0-255,1484,83391,92,123611
18064,0.001243,172.217.194.0-255,2902,86293,92,123611
18065,0.001246,172.31.47.0-255,66,86359,92,123611
18066,0.001248,172.217.194.0-255,1484,87843,92,123611
18067,0.001266,172.217.194.0-255,4320,92163,92,123611
18068,0.001269,172.31.47.0-255,66,92229,92,123611
18069,0.001286,172.217.194.0-255,2902,95131,92,123611
18070,0.001288,172.31.47.0-255,66,95197,92,123611
18071,0.001307,172.31.47.0-255,66,95263,92,123611
18072,0.001334,172.217.194.0-255,1484,96747,92,123611
18073,0.001344,172.31.47.0-255,66,96813,92,123611
18074,0.001372,172.217.194.0-255,5738,102551,92,123611
18075,0.001376,172.31.47.0-255,66,102617,92,123611
18076,0.001391,172.217.194.0-255,2902,105519,92,123611
18077,0.001395,172.31.47.0-255,66,105585,92,123611
18078,0.001437,172.31.47.0-255,66,105651,92,123611
18079,0.00146,172.31.47.0-255,66,105717,92,123611
18080,0.001465,172.31.47.0-255,66,105783,92,123611
18081,0.001473,172.31.47.0-255,66,105849,92,123611
18082,0.001486,172.217.194.0-255,1484,107333,92,123611
18083,0.001511,172.31.47.0-255,66,107399,92,123611
18084,0.001521,172.31.47.0-255,66,107465,92,123611
18085,0.00156,172.31.47.0-255,66,107531,92,123611
18086,0.001566,172.217.194.0-255,5738,113269,92,123611
18087,0.001567,172.31.47.0-255,66,113335,92,123611
18088,0.00159,172.31.47.0-255,66,113401,92,123611
18089,0.001618,172.217.194.0-255,4320,117721,92,123611
18090,0.001621,172.31.47.0-255,66,117787,92,123611
18091,0.001656,172.31.47.0-255,66,117853,92,123611
18092,0.001681,172.217.194.0-255,5020,122873,92,123611
18093,0.001684,172.31.47.0-255,66,122939,92,123611
18094,0.001697,172.31.47.0-255,66,123005,92,123611
18095,0.001711,172.31.47.0-255,66,123071,92,123611
18096,0.001753,172.31.47.0-255,66,123137,92,123611
18097,0.001768,172.31.47.0-255,66,123203,92,123611
18098,0.001809,172.31.47.0-255,66,123269,92,123611
18099,0.001868,172.31.47.0-255,66,123335,92,123611
18100,0.001871,172.217.194.0-255,105,123440,92,123611
18101,0.008049,172.31.47.0-255,66,123506,92,123611
18102,0.008073,172.31.47.0-255,105,123611,92,123611
18103,0.0,172.217.194.0-255,297,297,92,200472
18104,3.2e-05,172.31.47.0-255,66,363,92,200472
18105,3.9e-05,172.217.194.0-255,1484,1847,92,200472
18106,4.4e-05,172.31.47.0-255,66,1913,92,200472
18107,5.1e-05,172.217.194.0-255,4320,6233,92,200472
18108,5.3e-05,172.31.47.0-255,66,6299,92,200472
18109,6.2e-05,172.31.47.0-255,66,6365,92,200472
18110,0.000124,172.217.194.0-255,1484,7849,92,200472
18111,0.000127,172.31.47.0-255,66,7915,92,200472
18112,0.00013,172.217.194.0-255,1484,9399,92,200472
18113,0.000132,172.31.47.0-255,66,9465,92,200472
18114,0.000147,172.217.194.0-255,1484,10949,92,200472
18115,0.00015,172.31.47.0-255,66,11015,92,200472
18116,0.000156,172.217.194.0-255,5738,16753,92,200472
18117,0.000158,172.31.47.0-255,66,16819,92,200472
18118,0.000194,172.217.194.0-255,6797,23616,92,200472
18119,0.000198,172.31.47.0-255,66,23682,92,200472
18120,0.000348,172.217.194.0-255,1484,25166,92,200472
18121,0.000352,172.31.47.0-255,66,25232,92,200472
18122,0.000357,172.217.194.0-255,2902,28134,92,200472
18123,0.000359,172.31.47.0-255,66,28200,92,200472
18124,0.00037,172.217.194.0-255,1484,29684,92,200472
18125,0.000375,172.31.47.0-255,66,29750,92,200472
18126,0.000394,172.217.194.0-255,4320,34070,92,200472
18127,0.000397,172.31.47.0-255,66,34136,92,200472
18128,0.000426,172.31.47.0-255,66,34202,92,200472
18129,0.000447,172.217.194.0-255,5379,39581,92,200472
18130,0.000449,172.31.47.0-255,66,39647,92,200472
18131,0.000469,172.217.194.0-255,5738,45385,92,200472
18132,0.000472,172.31.47.0-255,66,45451,92,200472
18133,0.000493,172.217.194.0-255,4543,49994,92,200472
18134,0.000501,172.31.47.0-255,66,50060,92,200472
18135,0.000645,172.217.194.0-255,1484,51544,92,200472
18136,0.000649,172.217.194.0-255,2902,54446,92,200472
18137,0.000654,172.31.47.0-255,66,54512,92,200472
18138,0.00066,172.217.194.0-255,5738,60250,92,200472
18139,0.000677,172.31.47.0-255,66,60316,92,200472
18140,0.0007,172.217.194.0-255,1484,61800,92,200472
18141,0.0007,172.31.47.0-255,66,61866,92,200472
18142,0.000741,172.31.47.0-255,66,61932,92,200472
18143,0.000914,172.217.194.0-255,1484,63416,92,200472
18144,0.000919,172.217.194.0-255,2902,66318,92,200472
18145,0.000921,172.31.47.0-255,66,66384,92,200472
18146,0.000955,172.217.194.0-255,1484,67868,92,200472
18147,0.000974,172.217.194.0-255,4320,72188,92,200472
18148,0.000979,172.31.47.0-255,66,72254,92,200472
18149,0.00099,172.31.47.0-255,66,72320,92,200472
18150,0.00102,172.31.47.0-255,66,72386,92,200472
18151,0.001149,172.217.194.0-255,1484,73870,92,200472
18152,0.001153,172.217.194.0-255,2902,76772,92,200472
18153,0.001156,172.31.47.0-255,66,76838,92,200472
18154,0.001178,172.217.194.0-255,5738,82576,92,200472
18155,0.00119,172.31.47.0-255,66,82642,92,200472
18156,0.001191,172.217.194.0-255,7156,89798,92,200472
18157,0.001194,172.31.47.0-255,66,89864,92,200472
18158,0.001214,172.217.194.0-255,5738,95602,92,200472
18159,0.001227,172.31.47.0-255,66,95668,92,200472
18160,0.001326,172.217.194.0-255,1484,97152,92,200472
18161,0.001331,172.217.194.0-255,2902,100054,92,200472
18162,0.001333,172.31.47.0-255,66,100120,92,200472
18163,0.001356,172.217.194.0-255,5738,105858,92,200472
18164,0.001361,172.31.47.0-255,66,105924,92,200472
18165,0.001376,172.217.194.0-255,7156,113080,92,200472
18166,0.001379,172.31.47.0-255,66,113146,92,200472
18167,0.001413,172.217.194.0-255,2184,115330,92,200472
18168,0.001418,172.31.47.0-255,66,115396,92,200472
18169,0.001501,172.217.194.0-255,1484,116880,92,200472
18170,0.001504,172.217.194.0-255,1484,118364,92,200472
18171,0.001522,172.31.47.0-255,66,118430,92,200472
18172,0.001527,172.217.194.0-255,1484,119914,92,200472
18173,0.001533,172.217.194.0-255,5738,125652,92,200472
18174,0.001539,172.31.47.0-255,66,125718,92,200472
18175,0.001551,172.217.194.0-255,5738,131456,92,200472
18176,0.00156,172.31.47.0-255,66,131522,92,200472
18177,0.001573,172.217.194.0-255,7156,138678,92,200472
18178,0.001575,172.217.194.0-255,1484,140162,92,200472
18179,0.001583,172.31.47.0-255,66,140228,92,200472
18180,0.00162,172.217.194.0-255,5738,145966,92,200472
18181,0.001628,172.31.47.0-255,66,146032,92,200472
18182,0.001633,172.217.194.0-255,3602,149634,92,200472
18183,0.00164,172.31.47.0-255,66,149700,92,200472
18184,0.001867,172.217.194.0-255,1484,151184,92,200472
18185,0.001871,172.217.194.0-255,1484,152668,92,200472
18186,0.001874,172.31.47.0-255,66,152734,92,200472
18187,0.001892,172.217.194.0-255,1484,154218,92,200472
18188,0.001897,172.217.194.0-255,5738,159956,92,200472
18189,0.001903,172.31.47.0-255,66,160022,92,200472
18190,0.001929,172.31.47.0-255,66,160088,92,200472
18191,0.00193,172.217.194.0-255,4320,164408,92,200472
18192,0.001933,172.31.47.0-255,66,164474,92,200472
18193,0.001976,172.217.194.0-255,6438,170912,92,200472
18194,0.001979,172.31.47.0-255,66,170978,92,200472
18195,0.002031,172.217.194.0-255,1484,172462,92,200472
18196,0.002034,172.217.194.0-255,1484,173946,92,200472
18197,0.002043,172.217.194.0-255,1484,175430,92,200472
18198,0.002045,172.31.47.0-255,66,175496,92,200472
18199,0.002047,172.217.194.0-255,2902,178398,92,200472
18200,0.002049,172.31.47.0-255,66,178464,92,200472
18201,0.002059,172.217.194.0-255,2902,181366,92,200472
18202,0.002061,172.31.47.0-255,66,181432,92,200472
18203,0.002074,172.217.194.0-255,1484,182916,92,200472
18204,0.002078,172.31.47.0-255,78,182994,92,200472
18205,0.002089,172.31.47.0-255,66,183060,92,200472
18206,0.004141,172.217.194.0-255,5738,188798,92,200472
18207,0.004152,172.31.47.0-255,66,188864,92,200472
18208,0.006226,172.217.194.0-255,5738,194602,92,200472
18209,0.006242,172.31.47.0-255,66,194668,92,200472
18210,0.008296,172.217.194.0-255,5738,200406,92,200472
18211,0.008314,172.31.47.0-255,66,200472,92,200472
18212,0.0,172.31.47.0-255,105,105,92,105
18213,0.0,74.125.24.0-255,153,153,92,71760
18214,2.1e-05,172.31.47.0-255,66,219,92,71760
18215,2.9e-05,74.125.24.0-255,1484,1703,92,71760
18216,3.3e-05,172.31.47.0-255,66,1769,92,71760
18217,3.9e-05,74.125.24.0-255,2902,4671,92,71760
18218,5.3e-05,172.31.47.0-255,66,4737,92,71760
18219,5.8e-05,74.125.24.0-255,4320,9057,92,71760
18220,6.1e-05,172.31.47.0-255,66,9123,92,71760
18221,9.5e-05,74.125.24.0-255,2902,12025,92,71760
18222,9.8e-05,172.31.47.0-255,66,12091,92,71760
18223,0.000103,74.125.24.0-255,1957,14048,92,71760
18224,0.000105,172.31.47.0-255,66,14114,92,71760
18225,0.000513,74.125.24.0-255,1484,15598,92,71760
18226,0.00052,172.31.47.0-255,66,15664,92,71760
18227,0.000527,74.125.24.0-255,2902,18566,92,71760
18228,0.00053,172.31.47.0-255,66,18632,92,71760
18229,0.000542,74.125.24.0-255,5738,24370,92,71760
18230,0.000545,172.31.47.0-255,66,24436,92,71760
18231,0.000579,74.125.24.0-255,2902,27338,92,71760
18232,0.000582,172.31.47.0-255,66,27404,92,71760
18233,0.000612,74.125.24.0-255,3961,31365,92,71760
18234,0.000616,172.31.47.0-255,66,31431,92,71760
18235,0.000695,74.125.24.0-255,1484,32915,92,71760
18236,0.0007,172.31.47.0-255,66,32981,92,71760
18237,0.000705,74.125.24.0-255,2902,35883,92,71760
18238,0.000709,172.31.47.0-255,66,35949,92,71760
18239,0.00073,74.125.24.0-255,5738,41687,92,71760
18240,0.000738,172.31.47.0-255,66,41753,92,71760
18241,0.000744,74.125.24.0-255,4320,46073,92,71760
18242,0.000746,172.31.47.0-255,66,46139,92,71760
18243,0.000794,172.31.47.0-255,66,46205,92,71760
18244,0.000802,74.125.24.0-255,7108,53313,92,71760
18245,0.000805,172.31.47.0-255,66,53379,92,71760
18246,0.000808,74.125.24.0-255,110,53489,92,71760
18247,0.000832,74.125.24.0-255,331,53820,92,71760
18248,0.000987,172.31.47.0-255,66,53886,92,71760
18249,0.002334,74.125.24.0-255,1484,55370,92,71760
18250,0.003226,74.125.24.0-255,1484,56854,92,71760
18251,0.003231,172.31.47.0-255,66,56920,92,71760
18252,0.003248,74.125.24.0-255,2902,59822,92,71760
18253,0.00325,172.31.47.0-255,66,59888,92,71760
18254,0.005513,74.125.24.0-255,2902,62790,92,71760
18255,0.005515,172.31.47.0-255,66,62856,92,71760
18256,0.005539,74.125.24.0-255,2902,65758,92,71760
18257,0.00554,172.31.47.0-255,66,65824,92,71760
18258,0.007794,74.125.24.0-255,2902,68726,92,71760
18259,0.007802,172.31.47.0-255,66,68792,92,71760
18260,0.007852,74.125.24.0-255,2902,71694,92,71760
18261,0.007856,172.31.47.0-255,66,71760,92,71760
18262,0.0,172.217.194.0-255,153,153,92,242413
18263,1.5e-05,172.31.47.0-255,66,219,92,242413
18264,4.1e-05,172.217.194.0-255,1484,1703,92,242413
18265,4.6e-05,172.31.47.0-255,66,1769,92,242413
18266,5.1e-05,172.217.194.0-255,2902,4671,92,242413
18267,5.3e-05,172.31.47.0-255,66,4737,92,242413
18268,6.1e-05,172.217.194.0-255,7156,11893,92,242413
18269,6.3e-05,172.31.47.0-255,66,11959,92,242413
18270,8.8e-05,172.217.194.0-255,4938,16897,92,242413
18271,9.1e-05,172.31.47.0-255,66,16963,92,242413
18272,0.000131,172.31.47.0-255,66,17029,92,242413
18273,0.00018,172.217.194.0-255,4320,21349,92,242413
18274,0.000183,172.31.47.0-255,66,21415,92,242413
18275,0.000191,172.217.194.0-255,5738,27153,92,242413
18276,0.000193,172.31.47.0-255,66,27219,92,242413
18277,0.000212,172.217.194.0-255,2902,30121,92,242413
18278,0.000214,172.31.47.0-255,66,30187,92,242413
18279,0.00025,172.31.47.0-255,66,30253,92,242413
18280,0.000254,172.217.194.0-255,2902,33155,92,242413
18281,0.000256,172.31.47.0-255,66,33221,92,242413
18282,0.000307,172.31.47.0-255,66,33287,92,242413
18283,0.000324,172.217.194.0-255,120,33407,92,242413
18284,0.000326,172.31.47.0-255,66,33473,92,242413
18285,0.000354,172.217.194.0-255,380,33853,92,242413
18286,0.000358,172.31.47.0-255,66,33919,92,242413
18287,0.000669,172.217.194.0-255,1484,35403,92,242413
18288,0.000673,172.31.47.0-255,66,35469,92,242413
18289,0.000678,172.217.194.0-255,2902,38371,92,242413
18290,0.000679,172.31.47.0-255,66,38437,92,242413
18291,0.000697,172.217.194.0-255,5738,44175,92,242413
18292,0.0007,172.31.47.0-255,66,44241,92,242413
18293,0.000722,172.217.194.0-255,7156,51397,92,242413
18294,0.000725,172.31.47.0-255,66,51463,92,242413
18295,0.00075,172.217.194.0-255,5738,57201,92,242413
18296,0.000753,172.31.47.0-255,66,57267,92,242413
18297,0.000763,172.31.47.0-255,66,57333,92,242413
18298,0.001342,172.217.194.0-255,1484,58817,92,242413
18299,0.001347,172.31.47.0-255,66,58883,92,242413
18300,0.001382,172.217.194.0-255,2902,61785,92,242413
18301,0.001385,172.31.47.0-255,66,61851,92,242413
18302,0.001406,172.217.194.0-255,5738,67589,92,242413
18303,0.001408,172.31.47.0-255,66,67655,92,242413
18304,0.001411,172.217.194.0-255,1484,69139,92,242413
18305,0.001433,172.217.194.0-255,1484,70623,92,242413
18306,0.001435,172.31.47.0-255,66,70689,92,242413
18307,0.001458,172.217.194.0-255,4320,75009,92,242413
18308,0.001477,172.217.194.0-255,6438,81447,92,242413
18309,0.00149,172.217.194.0-255,4320,85767,92,242413
18310,0.001514,172.217.194.0-255,7156,92923,92,242413
18311,0.001543,172.217.194.0-255,5738,98661,92,242413
18312,0.001561,172.217.194.0-255,1484,100145,92,242413
18313,0.001572,172.217.194.0-255,4320,104465,92,242413
18314,0.001583,172.217.194.0-255,2184,106649,92,242413
18315,0.001661,172.217.194.0-255,1484,108133,92,242413
18316,0.001673,172.217.194.0-255,2902,111035,92,242413
18317,0.001695,172.217.194.0-255,5738,116773,92,242413
18318,0.001734,172.217.194.0-255,5738,122511,92,242413
18319,0.001749,172.217.194.0-255,4320,126831,92,242413
18320,0.001751,172.217.194.0-255,766,127597,92,242413
18321,0.001776,172.217.194.0-255,1484,129081,92,242413
18322,0.001795,172.217.194.0-255,4320,133401,92,242413
18323,0.001798,172.217.194.0-255,2902,136303,92,242413
18324,0.00182,172.217.194.0-255,7156,143459,92,242413
18325,0.001825,172.217.194.0-255,5738,149197,92,242413
18326,0.001842,172.217.194.0-255,4320,153517,92,242413
18327,0.001871,172.217.194.0-255,4320,157837,92,242413
18328,0.001884,172.217.194.0-255,3602,161439,92,242413
18329,0.00198,172.217.194.0-255,1484,162923,92,242413
18330,0.001984,172.217.194.0-255,2902,165825,92,242413
18331,0.00203,172.217.194.0-255,5738,171563,92,242413
18332,0.002035,172.217.194.0-255,7156,178719,92,242413
18333,0.002043,172.217.194.0-255,4320,183039,92,242413
18334,0.002056,172.217.194.0-255,4320,187359,92,242413
18335,0.002071,172.217.194.0-255,4320,191679,92,242413
18336,0.002083,172.217.194.0-255,3602,195281,92,242413
18337,0.002087,172.217.194.0-255,4320,199601,92,242413
18338,0.002102,172.217.194.0-255,4320,203921,92,242413
18339,0.002117,172.217.194.0-255,2902,206823,92,242413
18340,0.002153,172.217.194.0-255,4320,211143,92,242413
18341,0.002171,172.217.194.0-255,2184,213327,92,242413
18342,0.002263,172.217.194.0-255,1484,214811,92,242413
18343,0.002267,172.217.194.0-255,2902,217713,92,242413
18344,0.002301,172.217.194.0-255,2902,220615,92,242413
18345,0.002306,172.217.194.0-255,5738,226353,92,242413
18346,0.002317,172.217.194.0-255,1484,227837,92,242413
18347,0.002342,172.217.194.0-255,2902,230739,92,242413
18348,0.005188,172.31.47.0-255,66,230805,92,242413
18349,0.007513,172.217.194.0-255,5738,236543,92,242413
18350,0.007526,172.31.47.0-255,66,236609,92,242413
18351,0.009815,172.217.194.0-255,5738,242347,92,242413
18352,0.009823,172.31.47.0-255,66,242413,92,242413
18353,0.0,172.31.47.0-255,105,105,92,105
18354,0.0,172.217.26.0-255,153,153,92,98563
18355,1.5e-05,172.31.47.0-255,66,219,92,98563
18356,2e-05,172.217.26.0-255,1484,1703,92,98563
18357,2.4e-05,172.31.47.0-255,66,1769,92,98563
18358,2.8e-05,172.217.26.0-255,2902,4671,92,98563
18359,3e-05,172.31.47.0-255,66,4737,92,98563
18360,4.3e-05,172.217.26.0-255,7156,11893,92,98563
18361,4.6e-05,172.31.47.0-255,66,11959,92,98563
18362,5e-05,172.217.26.0-255,2216,14175,92,98563
18363,5.1e-05,172.31.47.0-255,66,14241,92,98563
18364,9.2e-05,172.217.26.0-255,1484,15725,92,98563
18365,9.4e-05,172.31.47.0-255,66,15791,92,98563
18366,9.7e-05,172.217.26.0-255,1484,17275,92,98563
18367,9.9e-05,172.31.47.0-255,66,17341,92,98563
18368,0.000119,172.217.26.0-255,1484,18825,92,98563
18369,0.00012,172.31.47.0-255,66,18891,92,98563
18370,0.000131,172.217.26.0-255,5738,24629,92,98563
18371,0.000133,172.31.47.0-255,66,24695,92,98563
18372,0.000163,172.217.26.0-255,6797,31492,92,98563
18373,0.000165,172.31.47.0-255,66,31558,92,98563
18374,0.000287,172.217.26.0-255,1484,33042,92,98563
18375,0.000291,172.31.47.0-255,66,33108,92,98563
18376,0.000303,172.217.26.0-255,2902,36010,92,98563
18377,0.000309,172.31.47.0-255,66,36076,92,98563
18378,0.000314,172.217.26.0-255,4320,40396,92,98563
18379,0.000315,172.31.47.0-255,66,40462,92,98563
18380,0.00033,172.217.26.0-255,1484,41946,92,98563
18381,0.000332,172.31.47.0-255,66,42012,92,98563
18382,0.000359,172.31.47.0-255,66,42078,92,98563
18383,0.000385,172.217.26.0-255,5379,47457,92,98563
18384,0.000388,172.31.47.0-255,66,47523,92,98563
18385,0.000413,172.217.26.0-255,1125,48648,92,98563
18386,0.000415,172.217.26.0-255,394,49042,92,98563
18387,0.000467,172.31.47.0-255,66,49108,92,98563
18388,0.001092,172.217.26.0-255,348,49456,92,98563
18389,0.001117,172.31.47.0-255,66,49522,92,98563
18390,0.001254,172.217.26.0-255,1484,51006,92,98563
18391,0.001261,172.217.26.0-255,1484,52490,92,98563
18392,0.001264,172.217.26.0-255,1484,53974,92,98563
18393,0.001276,172.217.26.0-255,1484,55458,92,98563
18394,0.001285,172.217.26.0-255,5738,61196,92,98563
18395,0.001307,172.217.26.0-255,2902,64098,92,98563
18396,0.001315,172.31.47.0-255,66,64164,92,98563
18397,0.001326,172.217.26.0-255,5738,69902,92,98563
18398,0.001345,172.217.26.0-255,5379,75281,92,98563
18399,0.00137,172.31.47.0-255,66,75347,92,98563
18400,0.003321,172.217.26.0-255,5738,81085,92,98563
18401,0.003325,172.31.47.0-255,66,81151,92,98563
18402,0.0053,172.217.26.0-255,5738,86889,92,98563
18403,0.005306,172.31.47.0-255,66,86955,92,98563
18404,0.007239,172.217.26.0-255,5738,92693,92,98563
18405,0.007244,172.31.47.0-255,66,92759,92,98563
18406,0.009206,172.217.26.0-255,5738,98497,92,98563
18407,0.009211,172.31.47.0-255,66,98563,92,98563
18408,0.0,172.217.27.0-255,153,153,92,165618
18409,2.3e-05,172.31.47.0-255,66,219,92,165618
18410,2.8e-05,172.217.27.0-255,1484,1703,92,165618
18411,3.2e-05,172.31.47.0-255,66,1769,92,165618
18412,3.4e-05,172.217.27.0-255,1484,3253,92,165618
18413,3.6e-05,172.31.47.0-255,66,3319,92,165618
18414,4e-05,172.217.27.0-255,2902,6221,92,165618
18415,4.3e-05,172.31.47.0-255,66,6287,92,165618
18416,4.8e-05,172.217.27.0-255,4320,10607,92,165618
18417,5e-05,172.31.47.0-255,66,10673,92,165618
18418,6.2e-05,172.217.27.0-255,1484,12157,92,165618
18419,6.5e-05,172.31.47.0-255,66,12223,92,165618
18420,8e-05,172.217.27.0-255,1949,14172,92,165618
18421,8.2e-05,172.31.47.0-255,66,14238,92,165618
18422,0.000107,172.217.27.0-255,2902,17140,92,165618
18423,0.00011,172.31.47.0-255,66,17206,92,165618
18424,0.000129,172.217.27.0-255,7156,24362,92,165618
18425,0.000131,172.31.47.0-255,66,24428,92,165618
18426,0.000133,172.217.27.0-255,1484,25912,92,165618
18427,0.000135,172.31.47.0-255,66,25978,92,165618
18428,0.000154,172.217.27.0-255,5379,31357,92,165618
18429,0.000156,172.31.47.0-255,66,31423,92,165618
18430,0.00019,172.217.27.0-255,1484,32907,92,165618
18431,0.000192,172.31.47.0-255,66,32973,92,165618
18432,0.000195,172.217.27.0-255,1484,34457,92,165618
18433,0.000196,172.31.47.0-255,66,34523,92,165618
18434,0.000209,172.217.27.0-255,1484,36007,92,165618
18435,0.000211,172.31.47.0-255,66,36073,92,165618
18436,0.000223,172.217.27.0-255,2902,38975,92,165618
18437,0.000225,172.31.47.0-255,66,39041,92,165618
18438,0.000236,172.217.27.0-255,1484,40525,92,165618
18439,0.000238,172.31.47.0-255,66,40591,92,165618
18440,0.000244,172.217.27.0-255,4320,44911,92,165618
18441,0.000246,172.31.47.0-255,66,44977,92,165618
18442,0.000292,172.217.27.0-255,2902,47879,92,165618
18443,0.000295,172.31.47.0-255,66,47945,92,165618
18444,0.000312,172.217.27.0-255,1125,49070,92,165618
18445,0.000317,172.217.27.0-255,4320,53390,92,165618
18446,0.000319,172.31.47.0-255,66,53456,92,165618
18447,0.000323,172.217.27.0-255,2902,56358,92,165618
18448,0.000325,172.31.47.0-255,66,56424,92,165618
18449,0.000342,172.217.27.0-255,7156,63580,92,165618
18450,0.000345,172.31.47.0-255,66,63646,92,165618
18451,0.000348,172.217.27.0-255,2543,66189,92,165618
18452,0.00035,172.31.47.0-255,66,66255,92,165618
18453,0.000371,172.217.27.0-255,393,66648,92,165618
18454,0.000665,172.31.47.0-255,66,66714,92,165618
18455,0.00068,172.217.27.0-255,114,66828,92,165618
18456,0.000717,172.31.47.0-255,66,66894,92,165618
18457,0.000824,172.217.27.0-255,1484,68378,92,165618
18458,0.000832,172.217.27.0-255,2902,71280,92,165618
18459,0.000836,172.31.47.0-255,66,71346,92,165618
18460,0.000842,172.217.27.0-255,5738,77084,92,165618
18461,0.000844,172.31.47.0-255,66,77150,92,165618
18462,0.000859,172.217.27.0-255,1484,78634,92,165618
18463,0.000877,172.217.27.0-255,6797,85431,92,165618
18464,0.00088,172.31.47.0-255,66,85497,92,165618
18465,0.000887,172.217.27.0-255,7156,92653,92,165618
18466,0.000889,172.31.47.0-255,66,92719,92,165618
18467,0.000909,172.217.27.0-255,1484,94203,92,165618
18468,0.000917,172.217.27.0-255,6797,101000,92,165618
18469,0.00092,172.31.47.0-255,66,101066,92,165618
18470,0.001154,172.217.27.0-255,1484,102550,92,165618
18471,0.001161,172.217.27.0-255,2902,105452,92,165618
18472,0.001166,172.31.47.0-255,66,105518,92,165618
18473,0.001172,172.217.27.0-255,4320,109838,92,165618
18474,0.001174,172.31.47.0-255,66,109904,92,165618
18475,0.001207,172.31.47.0-255,66,109970,92,165618
18476,0.001257,172.31.47.0-255,66,110036,92,165618
18477,0.001274,172.217.27.0-255,2184,112220,92,165618
18478,0.001276,172.31.47.0-255,66,112286,92,165618
18479,0.001412,172.217.27.0-255,1484,113770,92,165618
18480,0.00142,172.217.27.0-255,2902,116672,92,165618
18481,0.001424,172.31.47.0-255,66,116738,92,165618
18482,0.001427,172.217.27.0-255,1484,118222,92,165618
18483,0.001431,172.217.27.0-255,2902,121124,92,165618
18484,0.001433,172.31.47.0-255,66,121190,92,165618
18485,0.001438,172.217.27.0-255,5738,126928,92,165618
18486,0.00144,172.31.47.0-255,66,126994,92,165618
18487,0.001465,172.217.27.0-255,4320,131314,92,165618
18488,0.001467,172.31.47.0-255,66,131380,92,165618
18489,0.001495,172.31.47.0-255,66,131446,92,165618
18490,0.001502,172.217.27.0-255,6438,137884,92,165618
18491,0.001504,172.31.47.0-255,66,137950,92,165618
18492,0.003156,172.217.27.0-255,4320,142270,92,165618
18493,0.003161,172.31.47.0-255,66,142336,92,165618
18494,0.003177,172.217.27.0-255,1484,143820,92,165618
18495,0.00481,172.217.27.0-255,4320,148140,92,165618
18496,0.004815,172.31.47.0-255,66,148206,92,165618
18497,0.00648,172.217.27.0-255,5738,153944,92,165618
18498,0.006486,172.31.47.0-255,66,154010,92,165618
18499,0.008139,172.217.27.0-255,5738,159748,92,165618
18500,0.008146,172.31.47.0-255,66,159814,92,165618
18501,0.009883,172.217.27.0-255,5738,165552,92,165618
18502,0.009891,172.31.47.0-255,66,165618,92,165618
18503,0.0,74.125.24.0-255,143,143,92,170590
18504,3.3e-05,172.31.47.0-255,66,209,92,170590
18505,4e-05,74.125.24.0-255,1484,1693,92,170590
18506,4.4e-05,172.31.47.0-255,66,1759,92,170590
18507,4.9e-05,74.125.24.0-255,2902,4661,92,170590
18508,5.2e-05,172.31.47.0-255,66,4727,92,170590
18509,5.9e-05,74.125.24.0-255,7156,11883,92,170590
18510,6.2e-05,172.31.47.0-255,66,11949,92,170590
18511,6.6e-05,74.125.24.0-255,4320,16269,92,170590
18512,6.9e-05,172.31.47.0-255,66,16335,92,170590
18513,0.000108,172.31.47.0-255,66,16401,92,170590
18514,0.000112,74.125.24.0-255,2543,18944,92,170590
18515,0.000114,172.31.47.0-255,66,19010,92,170590
18516,0.000153,74.125.24.0-255,1484,20494,92,170590
18517,0.000156,172.31.47.0-255,66,20560,92,170590
18518,0.00016,74.125.24.0-255,2902,23462,92,170590
18519,0.000164,172.31.47.0-255,66,23528,92,170590
18520,0.000184,74.125.24.0-255,5738,29266,92,170590
18521,0.000187,172.31.47.0-255,66,29332,92,170590
18522,0.000203,74.125.24.0-255,2902,32234,92,170590
18523,0.000205,172.31.47.0-255,66,32300,92,170590
18524,0.000232,172.31.47.0-255,66,32366,92,170590
18525,0.000243,172.31.47.0-255,66,32432,92,170590
18526,0.000273,74.125.24.0-255,135,32567,92,170590
18527,0.000276,172.31.47.0-255,66,32633,92,170590
18528,0.00028,74.125.24.0-255,348,32981,92,170590
18529,0.000284,172.31.47.0-255,66,33047,92,170590
18530,0.0005,74.125.24.0-255,1484,34531,92,170590
18531,0.000505,172.31.47.0-255,66,34597,92,170590
18532,0.000511,74.125.24.0-255,2902,37499,92,170590
18533,0.000513,172.31.47.0-255,66,37565,92,170590
18534,0.000539,74.125.24.0-255,5738,43303,92,170590
18535,0.000543,172.31.47.0-255,66,43369,92,170590
18536,0.000548,74.125.24.0-255,4320,47689,92,170590
18537,0.00055,172.31.47.0-255,66,47755,92,170590
18538,0.000572,172.31.47.0-255,66,47821,92,170590
18539,0.000581,172.31.47.0-255,66,47887,92,170590
18540,0.000814,74.125.24.0-255,1484,49371,92,170590
18541,0.00082,74.125.24.0-255,2902,52273,92,170590
18542,0.000824,172.31.47.0-255,66,52339,92,170590
18543,0.000828,74.125.24.0-255,1484,53823,92,170590
18544,0.000847,74.125.24.0-255,4320,58143,92,170590
18545,0.00085,172.31.47.0-255,66,58209,92,170590
18546,0.000863,74.125.24.0-255,2902,61111,92,170590
18547,0.000866,172.31.47.0-255,66,61177,92,170590
18548,0.000902,172.31.47.0-255,66,61243,92,170590
18549,0.00095,172.31.47.0-255,66,61309,92,170590
18550,0.00109,74.125.24.0-255,1484,62793,92,170590
18551,0.001108,74.125.24.0-255,2902,65695,92,170590
18552,0.001111,172.31.47.0-255,66,65761,92,170590
18553,0.001117,74.125.24.0-255,5738,71499,92,170590
18554,0.00112,172.31.47.0-255,66,71565,92,170590
18555,0.001133,74.125.24.0-255,2902,74467,92,170590
18556,0.001137,172.31.47.0-255,66,74533,92,170590
18557,0.001159,172.31.47.0-255,66,74599,92,170590
18558,0.001164,74.125.24.0-255,4320,78919,92,170590
18559,0.001166,172.31.47.0-255,66,78985,92,170590
18560,0.001194,74.125.24.0-255,4320,83305,92,170590
18561,0.001197,172.31.47.0-255,66,83371,92,170590
18562,0.001202,74.125.24.0-255,2184,85555,92,170590
18563,0.001204,172.31.47.0-255,66,85621,92,170590
18564,0.001235,74.125.24.0-255,1484,87105,92,170590
18565,0.001247,74.125.24.0-255,1484,88589,92,170590
18566,0.00125,74.125.24.0-255,1484,90073,92,170590
18567,0.001253,172.31.47.0-255,66,90139,92,170590
18568,0.001275,74.125.24.0-255,5738,95877,92,170590
18569,0.001278,172.31.47.0-255,66,95943,92,170590
18570,0.001286,74.125.24.0-255,7156,103099,92,170590
18571,0.001288,172.31.47.0-255,66,103165,92,170590
18572,0.001307,74.125.24.0-255,4320,107485,92,170590
18573,0.00131,172.31.47.0-255,66,107551,92,170590
18574,0.001315,74.125.24.0-255,4320,111871,92,170590
18575,0.001318,172.31.47.0-255,66,111937,92,170590
18576,0.001342,172.31.47.0-255,66,112003,92,170590
18577,0.001559,74.125.24.0-255,1484,113487,92,170590
18578,0.001573,74.125.24.0-255,2902,116389,92,170590
18579,0.001577,172.31.47.0-255,66,116455,92,170590
18580,0.001583,74.125.24.0-255,5738,122193,92,170590
18581,0.001586,172.31.47.0-255,66,122259,92,170590
18582,0.001618,74.125.24.0-255,4320,126579,92,170590
18583,0.001621,172.31.47.0-255,66,126645,92,170590
18584,0.001641,74.125.24.0-255,1484,128129,92,170590
18585,0.001648,74.125.24.0-255,7156,135285,92,170590
18586,0.00165,172.31.47.0-255,66,135351,92,170590
18587,0.001669,74.125.24.0-255,4320,139671,92,170590
18588,0.001672,172.31.47.0-255,66,139737,92,170590
18589,0.001691,74.125.24.0-255,6438,146175,92,170590
18590,0.001694,172.31.47.0-255,66,146241,92,170590
18591,0.001861,74.125.24.0-255,1484,147725,92,170590
18592,0.001868,74.125.24.0-255,2902,150627,92,170590
18593,0.001872,172.31.47.0-255,66,150693,92,170590
18594,0.00189,74.125.24.0-255,5738,156431,92,170590
18595,0.001893,172.31.47.0-255,66,156497,92,170590
18596,0.001896,74.125.24.0-255,1484,157981,92,170590
18597,0.001934,172.31.47.0-255,66,158047,92,170590
18598,0.001946,172.31.47.0-255,66,158113,92,170590
18599,0.001978,74.125.24.0-255,2902,161015,92,170590
18600,0.001981,172.31.47.0-255,66,161081,92,170590
18601,0.002004,172.31.47.0-255,66,161147,92,170590
18602,0.002023,172.31.47.0-255,66,161213,92,170590
18603,0.002039,74.125.24.0-255,5738,166951,92,170590
18604,0.002041,172.31.47.0-255,66,167017,92,170590
18605,0.002084,172.31.47.0-255,66,167083,92,170590
18606,0.002102,172.31.47.0-255,66,167149,92,170590
18607,0.002105,74.125.24.0-255,766,167915,92,170590
18608,0.002187,172.31.47.0-255,66,167981,92,170590
18609,0.002198,172.31.47.0-255,66,168047,92,170590
18610,0.002209,172.31.47.0-255,66,168113,92,170590
18611,0.002252,172.31.47.0-255,66,168179,92,170590
18612,0.002263,172.31.47.0-255,66,168245,92,170590
18613,0.002289,172.31.47.0-255,66,168311,92,170590
18614,0.002293,74.125.24.0-255,1871,170182,92,170590
18615,0.0023,172.31.47.0-255,66,170248,92,170590
18616,0.00233,74.125.24.0-255,105,170353,92,170590
18617,0.003578,172.31.47.0-255,66,170419,92,170590
18618,0.003606,172.31.47.0-255,105,170524,92,170590
18619,0.0059,74.125.24.0-255,66,170590,92,170590
18620,0.0,74.125.68.0-255,153,153,92,384619
18621,3.3e-05,172.31.47.0-255,66,219,92,384619
18622,4e-05,74.125.68.0-255,1484,1703,92,384619
18623,4.4e-05,172.31.47.0-255,66,1769,92,384619
18624,8.2e-05,74.125.68.0-255,2902,4671,92,384619
18625,8.5e-05,172.31.47.0-255,66,4737,92,384619
18626,9.9e-05,74.125.68.0-255,1484,6221,92,384619
18627,0.000102,172.31.47.0-255,66,6287,92,384619
18628,0.000114,74.125.68.0-255,2902,9189,92,384619
18629,0.000117,172.31.47.0-255,66,9255,92,384619
18630,0.000131,74.125.68.0-255,1484,10739,92,384619
18631,0.000133,172.31.47.0-255,66,10805,92,384619
18632,0.000157,74.125.68.0-255,3420,14225,92,384619
18633,0.00016,172.31.47.0-255,66,14291,92,384619
18634,0.000166,74.125.68.0-255,5738,20029,92,384619
18635,0.000168,172.31.47.0-255,66,20095,92,384619
18636,0.000206,172.31.47.0-255,66,20161,92,384619
18637,0.000218,74.125.68.0-255,1125,21286,92,384619
18638,0.00022,172.31.47.0-255,66,21352,92,384619
18639,0.00035,74.125.68.0-255,1484,22836,92,384619
18640,0.000355,172.31.47.0-255,66,22902,92,384619
18641,0.000359,74.125.68.0-255,1484,24386,92,384619
18642,0.00036,172.31.47.0-255,66,24452,92,384619
18643,0.000378,74.125.68.0-255,1484,25936,92,384619
18644,0.000381,172.31.47.0-255,66,26002,92,384619
18645,0.000408,74.125.68.0-255,4320,30322,92,384619
18646,0.000412,172.31.47.0-255,66,30388,92,384619
18647,0.000415,74.125.68.0-255,1484,31872,92,384619
18648,0.000417,172.31.47.0-255,66,31938,92,384619
18649,0.000435,74.125.68.0-255,4320,36258,92,384619
18650,0.000438,172.31.47.0-255,66,36324,92,384619
18651,0.000464,74.125.68.0-255,6797,43121,92,384619
18652,0.000466,172.31.47.0-255,66,43187,92,384619
18653,0.000487,74.125.68.0-255,7156,50343,92,384619
18654,0.00049,172.31.47.0-255,66,50409,92,384619
18655,0.000511,74.125.68.0-255,5707,56116,92,384619
18656,0.000513,172.31.47.0-255,66,56182,92,384619
18657,0.000517,74.125.68.0-255,329,56511,92,384619
18658,0.000715,74.125.68.0-255,1484,57995,92,384619
18659,0.000719,172.31.47.0-255,66,58061,92,384619
18660,0.000741,74.125.68.0-255,2902,60963,92,384619
18661,0.000744,172.31.47.0-255,66,61029,92,384619
18662,0.000747,74.125.68.0-255,1484,62513,92,384619
18663,0.000765,74.125.68.0-255,4320,66833,92,384619
18664,0.000768,172.31.47.0-255,66,66899,92,384619
18665,0.000774,74.125.68.0-255,4320,71219,92,384619
18666,0.000776,172.31.47.0-255,66,71285,92,384619
18667,0.000788,74.125.68.0-255,1484,72769,92,384619
18668,0.000815,74.125.68.0-255,7156,79925,92,384619
18669,0.000818,172.31.47.0-255,66,79991,92,384619
18670,0.000821,74.125.68.0-255,1484,81475,92,384619
18671,0.000836,74.125.68.0-255,1484,82959,92,384619
18672,0.000838,172.31.47.0-255,66,83025,92,384619
18673,0.000843,74.125.68.0-255,2902,85927,92,384619
18674,0.000845,172.31.47.0-255,66,85993,92,384619
18675,0.000861,74.125.68.0-255,1484,87477,92,384619
18676,0.000879,74.125.68.0-255,3602,91079,92,384619
18677,0.000884,172.31.47.0-255,66,91145,92,384619
18678,0.001073,74.125.68.0-255,1484,92629,92,384619
18679,0.001091,74.125.68.0-255,2902,95531,92,384619
18680,0.001094,172.31.47.0-255,66,95597,92,384619
18681,0.001112,74.125.68.0-255,1484,97081,92,384619
18682,0.001133,74.125.68.0-255,2902,99983,92,384619
18683,0.001136,172.31.47.0-255,66,100049,92,384619
18684,0.001158,74.125.68.0-255,1484,101533,92,384619
18685,0.001177,74.125.68.0-255,4320,105853,92,384619
18686,0.00118,172.31.47.0-255,66,105919,92,384619
18687,0.001207,74.125.68.0-255,2902,108821,92,384619
18688,0.00121,172.31.47.0-255,66,108887,92,384619
18689,0.001214,74.125.68.0-255,1484,110371,92,384619
18690,0.001231,74.125.68.0-255,2902,113273,92,384619
18691,0.001233,172.31.47.0-255,66,113339,92,384619
18692,0.001282,74.125.68.0-255,7156,120495,92,384619
18693,0.001286,172.31.47.0-255,66,120561,92,384619
18694,0.001306,74.125.68.0-255,1484,122045,92,384619
18695,0.001323,74.125.68.0-255,2902,124947,92,384619
18696,0.001325,172.31.47.0-255,66,125013,92,384619
18697,0.001339,74.125.68.0-255,766,125779,92,384619
18698,0.001416,172.31.47.0-255,66,125845,92,384619
18699,0.001542,74.125.68.0-255,1484,127329,92,384619
18700,0.001568,74.125.68.0-255,1484,128813,92,384619
18701,0.001573,172.31.47.0-255,66,128879,92,384619
18702,0.001577,74.125.68.0-255,1484,130363,92,384619
18703,0.001593,74.125.68.0-255,1484,131847,92,384619
18704,0.001596,172.31.47.0-255,66,131913,92,384619
18705,0.00163,74.125.68.0-255,2902,134815,92,384619
18706,0.001633,172.31.47.0-255,66,134881,92,384619
18707,0.001649,74.125.68.0-255,1484,136365,92,384619
18708,0.001652,74.125.68.0-255,1484,137849,92,384619
18709,0.001654,172.31.47.0-255,66,137915,92,384619
18710,0.001671,74.125.68.0-255,1484,139399,92,384619
18711,0.001674,74.125.68.0-255,1484,140883,92,384619
18712,0.001676,172.31.47.0-255,66,140949,92,384619
18713,0.001697,74.125.68.0-255,2902,143851,92,384619
18714,0.001699,172.31.47.0-255,66,143917,92,384619
18715,0.001703,74.125.68.0-255,1484,145401,92,384619
18716,0.001721,74.125.68.0-255,7156,152557,92,384619
18717,0.001724,172.31.47.0-255,66,152623,92,384619
18718,0.001763,74.125.68.0-255,1484,154107,92,384619
18719,0.00178,74.125.68.0-255,4320,158427,92,384619
18720,0.001783,172.31.47.0-255,66,158493,92,384619
18721,0.001833,74.125.68.0-255,2184,160677,92,384619
18722,0.001837,172.31.47.0-255,66,160743,92,384619
18723,0.002087,74.125.68.0-255,1484,162227,92,384619
18724,0.002094,74.125.68.0-255,1484,163711,92,384619
18725,0.002098,172.31.47.0-255,66,163777,92,384619
18726,0.002111,74.125.68.0-255,1484,165261,92,384619
18727,0.002114,74.125.68.0-255,1484,166745,92,384619
18728,0.002117,172.31.47.0-255,66,166811,92,384619
18729,0.002139,74.125.68.0-255,2902,169713,92,384619
18730,0.002141,172.31.47.0-255,66,169779,92,384619
18731,0.002146,74.125.68.0-255,2902,172681,92,384619
18732,0.002148,172.31.47.0-255,66,172747,92,384619
18733,0.002154,74.125.68.0-255,4320,177067,92,384619
18734,0.002158,172.31.47.0-255,66,177133,92,384619
18735,0.002182,74.125.68.0-255,2902,180035,92,384619
18736,0.002184,172.31.47.0-255,66,180101,92,384619
18737,0.002198,74.125.68.0-255,4320,184421,92,384619
18738,0.0022,172.31.47.0-255,66,184487,92,384619
18739,0.002213,74.125.68.0-255,1484,185971,92,384619
18740,0.002228,74.125.68.0-255,2902,188873,92,384619
18741,0.00223,172.31.47.0-255,66,188939,92,384619
18742,0.002252,74.125.68.0-255,5738,194677,92,384619
18743,0.002254,172.31.47.0-255,66,194743,92,384619
18744,0.002256,74.125.68.0-255,766,195509,92,384619
18745,0.002408,74.125.68.0-255,1484,196993,92,384619
18746,0.002411,172.31.47.0-255,66,197059,92,384619
18747,0.002422,74.125.68.0-255,1484,198543,92,384619
18748,0.002436,74.125.68.0-255,2902,201445,92,384619
18749,0.002438,172.31.47.0-255,66,201511,92,384619
18750,0.002455,74.125.68.0-255,4320,205831,92,384619
18751,0.002458,172.31.47.0-255,66,205897,92,384619
18752,0.00246,74.125.68.0-255,1484,207381,92,384619
18753,0.002481,74.125.68.0-255,4320,211701,92,384619
18754,0.002483,172.31.47.0-255,66,211767,92,384619
18755,0.002486,74.125.68.0-255,1484,213251,92,384619
18756,0.002503,74.125.68.0-255,4320,217571,92,384619
18757,0.002506,172.31.47.0-255,66,217637,92,384619
18758,0.002508,74.125.68.0-255,1484,219121,92,384619
18759,0.002521,74.125.68.0-255,1484,220605,92,384619
18760,0.002523,172.31.47.0-255,66,220671,92,384619
18761,0.002541,74.125.68.0-255,4320,224991,92,384619
18762,0.002543,172.31.47.0-255,66,225057,92,384619
18763,0.002545,74.125.68.0-255,1484,226541,92,384619
18764,0.002574,74.125.68.0-255,2902,229443,92,384619
18765,0.002576,172.31.47.0-255,66,229509,92,384619
18766,0.002586,74.125.68.0-255,766,230275,92,384619
18767,0.002589,74.125.68.0-255,1484,231759,92,384619
18768,0.002591,172.31.47.0-255,66,231825,92,384619
18769,0.002612,74.125.68.0-255,2902,234727,92,384619
18770,0.002614,172.31.47.0-255,66,234793,92,384619
18771,0.002644,172.31.47.0-255,66,234859,92,384619
18772,0.002671,74.125.68.0-255,4320,239179,92,384619
18773,0.002673,172.31.47.0-255,66,239245,92,384619
18774,0.002691,74.125.68.0-255,7156,246401,92,384619
18775,0.002693,172.31.47.0-255,66,246467,92,384619
18776,0.002696,74.125.68.0-255,2902,249369,92,384619
18777,0.002698,172.31.47.0-255,66,249435,92,384619
18778,0.002715,74.125.68.0-255,1484,250919,92,384619
18779,0.002733,74.125.68.0-255,3602,254521,92,384619
18780,0.002735,172.31.47.0-255,66,254587,92,384619
18781,0.002752,74.125.68.0-255,4320,258907,92,384619
18782,0.002754,172.31.47.0-255,66,258973,92,384619
18783,0.002775,74.125.68.0-255,1484,260457,92,384619
18784,0.002789,74.125.68.0-255,5738,266195,92,384619
18785,0.002791,172.31.47.0-255,66,266261,92,384619
18786,0.002803,74.125.68.0-255,2902,269163,92,384619
18787,0.002805,172.31.47.0-255,66,269229,92,384619
18788,0.00284,74.125.68.0-255,5738,274967,92,384619
18789,0.002842,172.31.47.0-255,66,275033,92,384619
18790,0.002854,74.125.68.0-255,1484,276517,92,384619
18791,0.002856,74.125.68.0-255,1484,278001,92,384619
18792,0.002858,172.31.47.0-255,66,278067,92,384619
18793,0.002864,74.125.68.0-255,7156,285223,92,384619
18794,0.002865,172.31.47.0-255,66,285289,92,384619
18795,0.002869,74.125.68.0-255,3602,288891,92,384619
18796,0.002871,172.31.47.0-255,66,288957,92,384619
18797,0.002898,74.125.68.0-255,1484,290441,92,384619
18798,0.002912,74.125.68.0-255,2902,293343,92,384619
18799,0.002913,172.31.47.0-255,66,293409,92,384619
18800,0.002931,74.125.68.0-255,4320,297729,92,384619
18801,0.002932,172.31.47.0-255,66,297795,92,384619
18802,0.002945,74.125.68.0-255,1484,299279,92,384619
18803,0.002948,74.125.68.0-255,1484,300763,92,384619
18804,0.00295,172.31.47.0-255,66,300829,92,384619
18805,0.00296,74.125.68.0-255,5738,306567,92,384619
18806,0.002962,172.31.47.0-255,66,306633,92,384619
18807,0.002984,74.125.68.0-255,2902,309535,92,384619
18808,0.002986,172.31.47.0-255,66,309601,92,384619
18809,0.003003,74.125.68.0-255,5738,315339,92,384619
18810,0.003005,172.31.47.0-255,66,315405,92,384619
18811,0.003027,74.125.68.0-255,7156,322561,92,384619
18812,0.003029,172.31.47.0-255,66,322627,92,384619
18813,0.003042,74.125.68.0-255,2184,324811,92,384619
18814,0.003044,172.31.47.0-255,66,324877,92,384619
18815,0.003047,74.125.68.0-255,2902,327779,92,384619
18816,0.003049,172.31.47.0-255,66,327845,92,384619
18817,0.003077,74.125.68.0-255,1484,329329,92,384619
18818,0.003103,172.31.47.0-255,66,329395,92,384619
18819,0.003121,74.125.68.0-255,2902,332297,92,384619
18820,0.003123,172.31.47.0-255,66,332363,92,384619
18821,0.003127,74.125.68.0-255,4320,336683,92,384619
18822,0.003128,172.31.47.0-255,66,336749,92,384619
18823,0.003158,172.31.47.0-255,66,336815,92,384619
18824,0.003175,74.125.68.0-255,4320,341135,92,384619
18825,0.003177,172.31.47.0-255,66,341201,92,384619
18826,0.003191,74.125.68.0-255,1484,342685,92,384619
18827,0.003208,74.125.68.0-255,4320,347005,92,384619
18828,0.00321,172.31.47.0-255,66,347071,92,384619
18829,0.003212,74.125.68.0-255,1484,348555,92,384619
18830,0.003231,74.125.68.0-255,4320,352875,92,384619
18831,0.003233,172.31.47.0-255,66,352941,92,384619
18832,0.003255,74.125.68.0-255,7156,360097,92,384619
18833,0.003257,172.31.47.0-255,66,360163,92,384619
18834,0.003275,74.125.68.0-255,5738,365901,92,384619
18835,0.003277,172.31.47.0-255,66,365967,92,384619
18836,0.003281,74.125.68.0-255,4320,370287,92,384619
18837,0.003282,172.31.47.0-255,66,370353,92,384619
18838,0.003305,74.125.68.0-255,5020,375373,92,384619
18839,0.003306,172.31.47.0-255,66,375439,92,384619
18840,0.003309,74.125.68.0-255,1484,376923,92,384619
18841,0.003326,74.125.68.0-255,4320,381243,92,384619
18842,0.003328,172.31.47.0-255,66,381309,92,384619
18843,0.00335,74.125.68.0-255,2902,384211,92,384619
18844,0.003352,172.31.47.0-255,66,384277,92,384619
18845,0.003374,172.31.47.0-255,66,384343,92,384619
18846,0.003398,74.125.68.0-255,105,384448,92,384619
18847,0.009067,172.31.47.0-255,66,384514,92,384619
18848,0.00909,172.31.47.0-255,105,384619,92,384619
18849,0.0,172.31.47.0-255,66,66,92,66
18850,0.0,74.125.24.0-255,146,146,92,99633
18851,2.9e-05,172.31.47.0-255,66,212,92,99633
18852,3.6e-05,74.125.24.0-255,1484,1696,92,99633
18853,4.2e-05,172.31.47.0-255,66,1762,92,99633
18854,6.4e-05,74.125.24.0-255,2902,4664,92,99633
18855,7.1e-05,172.31.47.0-255,66,4730,92,99633
18856,7.9e-05,74.125.24.0-255,5738,10468,92,99633
18857,8.3e-05,172.31.47.0-255,66,10534,92,99633
18858,8.8e-05,74.125.24.0-255,3590,14124,92,99633
18859,9.2e-05,172.31.47.0-255,66,14190,92,99633
18860,0.000419,74.125.24.0-255,1484,15674,92,99633
18861,0.000426,172.31.47.0-255,66,15740,92,99633
18862,0.000431,74.125.24.0-255,2902,18642,92,99633
18863,0.000434,172.31.47.0-255,66,18708,92,99633
18864,0.00045,74.125.24.0-255,5738,24446,92,99633
18865,0.000454,172.31.47.0-255,66,24512,92,99633
18866,0.000491,74.125.24.0-255,6797,31309,92,99633
18867,0.000495,172.31.47.0-255,66,31375,92,99633
18868,0.000733,74.125.24.0-255,1484,32859,92,99633
18869,0.000739,172.31.47.0-255,66,32925,92,99633
18870,0.000745,74.125.24.0-255,2902,35827,92,99633
18871,0.000747,172.31.47.0-255,66,35893,92,99633
18872,0.000763,74.125.24.0-255,5738,41631,92,99633
18873,0.000768,172.31.47.0-255,66,41697,92,99633
18874,0.000807,74.125.24.0-255,6797,48494,92,99633
18875,0.000815,74.125.24.0-255,7156,55650,92,99633
18876,0.000864,172.31.47.0-255,66,55716,92,99633
18877,0.000868,172.31.47.0-255,66,55782,92,99633
18878,0.000871,172.31.47.0-255,66,55848,92,99633
18879,0.001149,74.125.24.0-255,115,55963,92,99633
18880,0.001154,172.31.47.0-255,66,56029,92,99633
18881,0.001432,74.125.24.0-255,1484,57513,92,99633
18882,0.001437,172.31.47.0-255,66,57579,92,99633
18883,0.001469,74.125.24.0-255,2902,60481,92,99633
18884,0.001474,172.31.47.0-255,66,60547,92,99633
18885,0.001483,74.125.24.0-255,5738,66285,92,99633
18886,0.001487,172.31.47.0-255,66,66351,92,99633
18887,0.00149,74.125.24.0-255,1484,67835,92,99633
18888,0.001493,172.31.47.0-255,66,67901,92,99633
18889,0.00154,74.125.24.0-255,6797,74698,92,99633
18890,0.001545,172.31.47.0-255,66,74764,92,99633
18891,0.001558,172.31.47.0-255,66,74830,92,99633
18892,0.001567,74.125.24.0-255,6797,81627,92,99633
18893,0.00157,172.31.47.0-255,66,81693,92,99633
18894,0.004498,74.125.24.0-255,1484,83177,92,99633
18895,0.004517,172.31.47.0-255,66,83243,92,99633
18896,0.004545,74.125.24.0-255,2902,86145,92,99633
18897,0.004551,172.31.47.0-255,66,86211,92,99633
18898,0.004555,74.125.24.0-255,1484,87695,92,99633
18899,0.004558,172.31.47.0-255,66,87761,92,99633
18900,0.006802,74.125.24.0-255,1484,89245,92,99633
18901,0.006817,172.31.47.0-255,66,89311,92,99633
18902,0.006862,74.125.24.0-255,4320,93631,92,99633
18903,0.006866,172.31.47.0-255,66,93697,92,99633
18904,0.009115,74.125.24.0-255,1484,95181,92,99633
18905,0.009129,172.31.47.0-255,66,95247,92,99633
18906,0.00917,74.125.24.0-255,4320,99567,92,99633
18907,0.009174,172.31.47.0-255,66,99633,92,99633
18908,0.0,172.217.26.0-255,226,226,92,46674
18909,2.4e-05,172.31.47.0-255,66,292,92,46674
18910,3.1e-05,172.217.26.0-255,1484,1776,92,46674
18911,3.5e-05,172.31.47.0-255,66,1842,92,46674
18912,7e-05,172.217.26.0-255,4320,6162,92,46674
18913,7.5e-05,172.31.47.0-255,66,6228,92,46674
18914,0.000199,172.217.26.0-255,5738,11966,92,46674
18915,0.000205,172.31.47.0-255,66,12032,92,46674
18916,0.000236,172.217.26.0-255,2126,14158,92,46674
18917,0.000239,172.31.47.0-255,66,14224,92,46674
18918,0.000458,172.217.26.0-255,5738,19962,92,46674
18919,0.000462,172.31.47.0-255,66,20028,92,46674
18920,0.000485,172.217.26.0-255,2902,22930,92,46674
18921,0.000488,172.31.47.0-255,66,22996,92,46674
18922,0.000746,172.31.47.0-255,66,23062,92,46674
18923,0.002644,172.217.26.0-255,5738,28800,92,46674
18924,0.002649,172.31.47.0-255,66,28866,92,46674
18925,0.004558,172.217.26.0-255,4320,33186,92,46674
18926,0.004563,172.31.47.0-255,66,33252,92,46674
18927,0.004596,172.217.26.0-255,1484,34736,92,46674
18928,0.004601,172.31.47.0-255,66,34802,92,46674
18929,0.006476,172.217.26.0-255,2902,37704,92,46674
18930,0.006481,172.31.47.0-255,66,37770,92,46674
18931,0.006513,172.217.26.0-255,2902,40672,92,46674
18932,0.006516,172.31.47.0-255,66,40738,92,46674
18933,0.008392,172.217.26.0-255,2902,43640,92,46674
18934,0.008399,172.31.47.0-255,66,43706,92,46674
18935,0.00843,172.217.26.0-255,2902,46608,92,46674
18936,0.008433,172.31.47.0-255,66,46674,92,46674
18937,0.0,172.31.47.0-255,105,105,92,459
18938,0.000282,172.31.47.0-255,90,195,92,459
18939,0.00029,172.31.47.0-255,66,261,92,459
18940,0.002815,172.217.194.0-255,66,327,92,459
18941,0.003459,172.217.194.0-255,66,393,92,459
18942,0.003467,172.31.47.0-255,66,459,92,459
18943,0.0,172.217.194.0-255,153,153,92,257743
18944,2.3e-05,172.31.47.0-255,66,219,92,257743
18945,2.8e-05,172.217.194.0-255,1484,1703,92,257743
18946,3.2e-05,172.31.47.0-255,66,1769,92,257743
18947,5.3e-05,172.217.194.0-255,1484,3253,92,257743
18948,5.5e-05,172.31.47.0-255,66,3319,92,257743
18949,5.9e-05,172.217.194.0-255,2902,6221,92,257743
18950,6.1e-05,172.31.47.0-255,66,6287,92,257743
18951,8e-05,172.217.194.0-255,4320,10607,92,257743
18952,8.2e-05,172.31.47.0-255,66,10673,92,257743
18953,0.000104,172.217.194.0-255,1484,12157,92,257743
18954,0.000106,172.31.47.0-255,66,12223,92,257743
18955,0.00011,172.217.194.0-255,2142,14365,92,257743
18956,0.000112,172.31.47.0-255,66,14431,92,257743
18957,0.000115,172.217.194.0-255,1484,15915,92,257743
18958,0.000116,172.31.47.0-255,66,15981,92,257743
18959,0.000139,172.31.47.0-255,66,16047,92,257743
18960,0.00017,172.217.194.0-255,4320,20367,92,257743
18961,0.000173,172.31.47.0-255,66,20433,92,257743
18962,0.000189,172.217.194.0-255,2543,22976,92,257743
18963,0.000191,172.31.47.0-255,66,23042,92,257743
18964,0.000623,172.217.194.0-255,1484,24526,92,257743
18965,0.000629,172.31.47.0-255,66,24592,92,257743
18966,0.000638,172.217.194.0-255,2902,27494,92,257743
18967,0.000641,172.31.47.0-255,66,27560,92,257743
18968,0.000675,172.217.194.0-255,5738,33298,92,257743
18969,0.000678,172.31.47.0-255,66,33364,92,257743
18970,0.000682,172.217.194.0-255,2902,36266,92,257743
18971,0.000684,172.31.47.0-255,66,36332,92,257743
18972,0.000717,172.31.47.0-255,66,36398,92,257743
18973,0.000724,172.217.194.0-255,5738,42136,92,257743
18974,0.000726,172.31.47.0-255,66,42202,92,257743
18975,0.000767,172.217.194.0-255,4236,46438,92,257743
18976,0.000772,172.31.47.0-255,66,46504,92,257743
18977,0.000815,172.217.194.0-255,1484,47988,92,257743
18978,0.000831,172.217.194.0-255,2902,50890,92,257743
18979,0.000834,172.31.47.0-255,66,50956,92,257743
18980,0.000838,172.217.194.0-255,1484,52440,92,257743
18981,0.000859,172.217.194.0-255,4320,56760,92,257743
18982,0.000862,172.31.47.0-255,66,56826,92,257743
18983,0.000866,172.217.194.0-255,2902,59728,92,257743
18984,0.000868,172.31.47.0-255,66,59794,92,257743
18985,0.000907,172.31.47.0-255,66,59860,92,257743
18986,0.000919,172.31.47.0-255,66,59926,92,257743
18987,0.001011,172.217.194.0-255,1484,61410,92,257743
18988,0.001017,172.217.194.0-255,2902,64312,92,257743
18989,0.001021,172.31.47.0-255,66,64378,92,257743
18990,0.001049,172.217.194.0-255,5738,70116,92,257743
18991,0.001053,172.31.47.0-255,66,70182,92,257743
18992,0.001082,172.217.194.0-255,7156,77338,92,257743
18993,0.001086,172.31.47.0-255,66,77404,92,257743
18994,0.001113,172.217.194.0-255,6411,83815,92,257743
18995,0.001117,172.31.47.0-255,66,83881,92,257743
18996,0.00112,172.217.194.0-255,1484,85365,92,257743
18997,0.001146,172.31.47.0-255,66,85431,92,257743
18998,0.001178,172.217.194.0-255,5738,91169,92,257743
18999,0.001181,172.31.47.0-255,66,91235,92,257743
19000,0.001184,172.217.194.0-255,1484,92719,92,257743
19001,0.001203,172.217.194.0-255,5738,98457,92,257743
19002,0.001205,172.31.47.0-255,66,98523,92,257743
19003,0.001222,172.217.194.0-255,1484,100007,92,257743
19004,0.001244,172.217.194.0-255,5738,105745,92,257743
19005,0.001247,172.31.47.0-255,66,105811,92,257743
19006,0.001252,172.217.194.0-255,4320,110131,92,257743
19007,0.001254,172.31.47.0-255,66,110197,92,257743
19008,0.00127,172.217.194.0-255,4320,114517,92,257743
19009,0.001272,172.31.47.0-255,66,114583,92,257743
19010,0.001277,172.217.194.0-255,5020,119603,92,257743
19011,0.001279,172.31.47.0-255,66,119669,92,257743
19012,0.00134,172.217.194.0-255,1484,121153,92,257743
19013,0.001354,172.217.194.0-255,2902,124055,92,257743
19014,0.001357,172.31.47.0-255,66,124121,92,257743
19015,0.001381,172.217.194.0-255,5738,129859,92,257743
19016,0.001383,172.31.47.0-255,66,129925,92,257743
19017,0.001386,172.217.194.0-255,1484,131409,92,257743
19018,0.001401,172.217.194.0-255,4320,135729,92,257743
19019,0.001403,172.31.47.0-255,66,135795,92,257743
19020,0.001418,172.217.194.0-255,4320,140115,92,257743
19021,0.001421,172.31.47.0-255,66,140181,92,257743
19022,0.001436,172.217.194.0-255,1484,141665,92,257743
19023,0.001467,172.31.47.0-255,66,141731,92,257743
19024,0.0015,172.217.194.0-255,1484,143215,92,257743
19025,0.001521,172.217.194.0-255,2902,146117,92,257743
19026,0.001523,172.31.47.0-255,66,146183,92,257743
19027,0.001526,172.217.194.0-255,1484,147667,92,257743
19028,0.001541,172.217.194.0-255,2902,150569,92,257743
19029,0.001544,172.31.47.0-255,66,150635,92,257743
19030,0.001548,172.217.194.0-255,2902,153537,92,257743
19031,0.00155,172.31.47.0-255,66,153603,92,257743
19032,0.001574,172.217.194.0-255,5738,159341,92,257743
19033,0.001577,172.31.47.0-255,66,159407,92,257743
19034,0.00161,172.31.47.0-255,66,159473,92,257743
19035,0.00163,172.217.194.0-255,3602,163075,92,257743
19036,0.001632,172.31.47.0-255,66,163141,92,257743
19037,0.001751,172.217.194.0-255,1484,164625,92,257743
19038,0.001753,172.217.194.0-255,1484,166109,92,257743
19039,0.00176,172.31.47.0-255,66,166175,92,257743
19040,0.001774,172.217.194.0-255,1484,167659,92,257743
19041,0.001779,172.217.194.0-255,2902,170561,92,257743
19042,0.001781,172.31.47.0-255,66,170627,92,257743
19043,0.001801,172.217.194.0-255,2902,173529,92,257743
19044,0.001803,172.31.47.0-255,66,173595,92,257743
19045,0.001807,172.217.194.0-255,2902,176497,92,257743
19046,0.001809,172.31.47.0-255,66,176563,92,257743
19047,0.001818,172.217.194.0-255,4320,180883,92,257743
19048,0.00182,172.31.47.0-255,66,180949,92,257743
19049,0.001843,172.217.194.0-255,5738,186687,92,257743
19050,0.001846,172.31.47.0-255,66,186753,92,257743
19051,0.001863,172.217.194.0-255,7156,193909,92,257743
19052,0.001865,172.31.47.0-255,66,193975,92,257743
19053,0.001887,172.217.194.0-255,3602,197577,92,257743
19054,0.001889,172.31.47.0-255,66,197643,92,257743
19055,0.001961,172.217.194.0-255,1484,199127,92,257743
19056,0.001965,172.217.194.0-255,1484,200611,92,257743
19057,0.001967,172.31.47.0-255,66,200677,92,257743
19058,0.001985,172.217.194.0-255,1484,202161,92,257743
19059,0.001991,172.217.194.0-255,5738,207899,92,257743
19060,0.001994,172.31.47.0-255,66,207965,92,257743
19061,0.001996,172.217.194.0-255,1484,209449,92,257743
19062,0.002019,172.31.47.0-255,66,209515,92,257743
19063,0.00204,172.217.194.0-255,7156,216671,92,257743
19064,0.002044,172.31.47.0-255,66,216737,92,257743
19065,0.002058,172.217.194.0-255,7156,223893,92,257743
19066,0.00206,172.31.47.0-255,66,223959,92,257743
19067,0.002072,172.217.194.0-255,3602,227561,92,257743
19068,0.002074,172.31.47.0-255,66,227627,92,257743
19069,0.002079,172.217.194.0-255,4320,231947,92,257743
19070,0.002081,172.31.47.0-255,66,232013,92,257743
19071,0.002116,172.31.47.0-255,66,232079,92,257743
19072,0.002121,172.217.194.0-255,4320,236399,92,257743
19073,0.002123,172.31.47.0-255,66,236465,92,257743
19074,0.002153,172.31.47.0-255,66,236531,92,257743
19075,0.002179,172.31.47.0-255,66,236597,92,257743
19076,0.002199,172.217.194.0-255,3602,240199,92,257743
19077,0.002202,172.31.47.0-255,66,240265,92,257743
19078,0.004294,172.217.194.0-255,1484,241749,92,257743
19079,0.004318,172.217.194.0-255,4320,246069,92,257743
19080,0.004325,172.31.47.0-255,66,246135,92,257743
19081,0.006418,172.217.194.0-255,5738,251873,92,257743
19082,0.006433,172.31.47.0-255,66,251939,92,257743
19083,0.008564,172.217.194.0-255,5738,257677,92,257743
19084,0.008575,172.31.47.0-255,66,257743,92,257743
19085,0.0,172.31.47.0-255,105,105,92,459
19086,0.000136,172.31.47.0-255,90,195,92,459
19087,0.000147,172.31.47.0-255,66,261,92,459
19088,0.002728,172.217.194.0-255,66,327,92,459
19089,0.002748,172.217.194.0-255,66,393,92,459
19090,0.002763,172.31.47.0-255,66,459,92,459
19091,0.0,74.125.24.0-255,153,153,92,172468
19092,0.0001,172.31.47.0-255,66,219,92,172468
19093,0.000107,74.125.24.0-255,1484,1703,92,172468
19094,0.000111,172.31.47.0-255,66,1769,92,172468
19095,0.000115,74.125.24.0-255,2902,4671,92,172468
19096,0.000124,172.31.47.0-255,66,4737,92,172468
19097,0.000132,74.125.24.0-255,7156,11893,92,172468
19098,0.000134,172.31.47.0-255,66,11959,92,172468
19099,0.000138,74.125.24.0-255,2161,14120,92,172468
19100,0.000141,172.31.47.0-255,66,14186,92,172468
19101,0.000252,74.125.24.0-255,1484,15670,92,172468
19102,0.000256,172.31.47.0-255,66,15736,92,172468
19103,0.000262,74.125.24.0-255,2902,18638,92,172468
19104,0.000265,172.31.47.0-255,66,18704,92,172468
19105,0.000277,74.125.24.0-255,5738,24442,92,172468
19106,0.000279,172.31.47.0-255,66,24508,92,172468
19107,0.000286,74.125.24.0-255,5738,30246,92,172468
19108,0.000288,172.31.47.0-255,66,30312,92,172468
19109,0.000335,74.125.24.0-255,6797,37109,92,172468
19110,0.000339,172.31.47.0-255,66,37175,92,172468
19111,0.000375,172.31.47.0-255,66,37241,92,172468
19112,0.000403,74.125.24.0-255,1125,38366,92,172468
19113,0.000408,172.31.47.0-255,66,38432,92,172468
19114,0.001075,74.125.24.0-255,1484,39916,92,172468
19115,0.001081,172.31.47.0-255,66,39982,92,172468
19116,0.001091,74.125.24.0-255,2902,42884,92,172468
19117,0.001093,172.31.47.0-255,66,42950,92,172468
19118,0.001105,74.125.24.0-255,5738,48688,92,172468
19119,0.001107,172.31.47.0-255,66,48754,92,172468
19120,0.001152,172.31.47.0-255,66,48820,92,172468
19121,0.001174,74.125.24.0-255,2902,51722,92,172468
19122,0.001177,172.31.47.0-255,66,51788,92,172468
19123,0.001197,74.125.24.0-255,5738,57526,92,172468
19124,0.0012,172.31.47.0-255,66,57592,92,172468
19125,0.001211,172.31.47.0-255,66,57658,92,172468
19126,0.00125,74.125.24.0-255,2902,60560,92,172468
19127,0.001253,172.31.47.0-255,66,60626,92,172468
19128,0.001294,172.31.47.0-255,66,60692,92,172468
19129,0.002084,74.125.24.0-255,1484,62176,92,172468
19130,0.002089,74.125.24.0-255,2902,65078,92,172468
19131,0.002092,172.31.47.0-255,66,65144,92,172468
19132,0.002094,74.125.24.0-255,1484,66628,92,172468
19133,0.002115,74.125.24.0-255,4320,70948,92,172468
19134,0.002117,172.31.47.0-255,66,71014,92,172468
19135,0.00215,74.125.24.0-255,1484,72498,92,172468
19136,0.002173,172.31.47.0-255,66,72564,92,172468
19137,0.002189,172.31.47.0-255,66,72630,92,172468
19138,0.002201,74.125.24.0-255,2902,75532,92,172468
19139,0.002208,172.31.47.0-255,66,75598,92,172468
19140,0.002233,172.31.47.0-255,66,75664,92,172468
19141,0.002245,172.31.47.0-255,66,75730,92,172468
19142,0.002265,74.125.24.0-255,1484,77214,92,172468
19143,0.002291,172.31.47.0-255,66,77280,92,172468
19144,0.002313,74.125.24.0-255,1484,78764,92,172468
19145,0.00233,74.125.24.0-255,2902,81666,92,172468
19146,0.002332,172.31.47.0-255,66,81732,92,172468
19147,0.002338,74.125.24.0-255,5738,87470,92,172468
19148,0.002341,172.31.47.0-255,66,87536,92,172468
19149,0.002368,74.125.24.0-255,5738,93274,92,172468
19150,0.00237,172.31.47.0-255,66,93340,92,172468
19151,0.00239,74.125.24.0-255,7156,100496,92,172468
19152,0.002392,172.31.47.0-255,66,100562,92,172468
19153,0.002418,74.125.24.0-255,5738,106300,92,172468
19154,0.00242,172.31.47.0-255,66,106366,92,172468
19155,0.002424,74.125.24.0-255,4320,110686,92,172468
19156,0.002426,172.31.47.0-255,66,110752,92,172468
19157,0.00244,74.125.24.0-255,766,111518,92,172468
19158,0.002442,74.125.24.0-255,1484,113002,92,172468
19159,0.002444,172.31.47.0-255,66,113068,92,172468
19160,0.002464,74.125.24.0-255,4320,117388,92,172468
19161,0.002466,172.31.47.0-255,66,117454,92,172468
19162,0.002472,74.125.24.0-255,7156,124610,92,172468
19163,0.002474,172.31.47.0-255,66,124676,92,172468
19164,0.002477,74.125.24.0-255,1484,126160,92,172468
19165,0.002507,172.31.47.0-255,66,126226,92,172468
19166,0.00251,74.125.24.0-255,2902,129128,92,172468
19167,0.002512,172.31.47.0-255,66,129194,92,172468
19168,0.002544,74.125.24.0-255,3602,132796,92,172468
19169,0.002546,172.31.47.0-255,66,132862,92,172468
19170,0.002548,74.125.24.0-255,1484,134346,92,172468
19171,0.002568,74.125.24.0-255,2902,137248,92,172468
19172,0.00257,172.31.47.0-255,66,137314,92,172468
19173,0.002573,74.125.24.0-255,2902,140216,92,172468
19174,0.002575,172.31.47.0-255,66,140282,92,172468
19175,0.002593,74.125.24.0-255,2902,143184,92,172468
19176,0.002595,172.31.47.0-255,66,143250,92,172468
19177,0.0026,74.125.24.0-255,5738,148988,92,172468
19178,0.002601,172.31.47.0-255,66,149054,92,172468
19179,0.00265,74.125.24.0-255,7156,156210,92,172468
19180,0.002652,172.31.47.0-255,66,156276,92,172468
19181,0.002664,172.31.47.0-255,66,156342,92,172468
19182,0.002676,172.31.47.0-255,66,156408,92,172468
19183,0.002704,74.125.24.0-255,5738,162146,92,172468
19184,0.002708,172.31.47.0-255,66,162212,92,172468
19185,0.005289,74.125.24.0-255,4320,166532,92,172468
19186,0.005294,172.31.47.0-255,66,166598,92,172468
19187,0.005314,74.125.24.0-255,1484,168082,92,172468
19188,0.007837,74.125.24.0-255,4320,172402,92,172468
19189,0.007844,172.31.47.0-255,66,172468,92,172468
19190,0.0,172.31.47.0-255,105,105,92,105
19191,0.0,74.125.200.0-255,153,153,92,240834
19192,2.1e-05,172.31.47.0-255,66,219,92,240834
19193,2.8e-05,74.125.200.0-255,1484,1703,92,240834
19194,3.2e-05,172.31.47.0-255,66,1769,92,240834
19195,3.5e-05,74.125.200.0-255,1484,3253,92,240834
19196,3.7e-05,172.31.47.0-255,66,3319,92,240834
19197,6e-05,74.125.200.0-255,2902,6221,92,240834
19198,6.2e-05,172.31.47.0-255,66,6287,92,240834
19199,6.8e-05,74.125.200.0-255,5738,12025,92,240834
19200,7e-05,172.31.47.0-255,66,12091,92,240834
19201,0.000103,74.125.200.0-255,6317,18408,92,240834
19202,0.000105,172.31.47.0-255,66,18474,92,240834
19203,0.000111,74.125.200.0-255,5738,24212,92,240834
19204,0.000113,172.31.47.0-255,66,24278,92,240834
19205,0.000123,74.125.200.0-255,1484,25762,92,240834
19206,0.000125,172.31.47.0-255,66,25828,92,240834
19207,0.000156,74.125.200.0-255,5379,31207,92,240834
19208,0.000159,172.31.47.0-255,66,31273,92,240834
19209,0.000259,74.125.200.0-255,1484,32757,92,240834
19210,0.000262,172.31.47.0-255,66,32823,92,240834
19211,0.000267,74.125.200.0-255,2902,35725,92,240834
19212,0.000269,172.31.47.0-255,66,35791,92,240834
19213,0.000272,74.125.200.0-255,1484,37275,92,240834
19214,0.000273,172.31.47.0-255,66,37341,92,240834
19215,0.000301,74.125.200.0-255,4320,41661,92,240834
19216,0.000304,172.31.47.0-255,66,41727,92,240834
19217,0.000309,74.125.200.0-255,4320,46047,92,240834
19218,0.000311,172.31.47.0-255,66,46113,92,240834
19219,0.000317,74.125.200.0-255,5379,51492,92,240834
19220,0.000319,172.31.47.0-255,66,51558,92,240834
19221,0.000344,74.125.200.0-255,1484,53042,92,240834
19222,0.000347,172.31.47.0-255,66,53108,92,240834
19223,0.000365,74.125.200.0-255,5738,58846,92,240834
19224,0.000367,172.31.47.0-255,66,58912,92,240834
19225,0.000422,74.125.200.0-255,4320,63232,92,240834
19226,0.000424,172.31.47.0-255,66,63298,92,240834
19227,0.000439,74.125.200.0-255,2543,65841,92,240834
19228,0.000441,172.31.47.0-255,66,65907,92,240834
19229,0.000444,74.125.200.0-255,677,66584,92,240834
19230,0.000658,74.125.200.0-255,1484,68068,92,240834
19231,0.000663,172.31.47.0-255,66,68134,92,240834
19232,0.000682,74.125.200.0-255,2902,71036,92,240834
19233,0.000684,172.31.47.0-255,66,71102,92,240834
19234,0.000708,74.125.200.0-255,5738,76840,92,240834
19235,0.00071,172.31.47.0-255,66,76906,92,240834
19236,0.000717,74.125.200.0-255,5738,82644,92,240834
19237,0.000719,172.31.47.0-255,66,82710,92,240834
19238,0.000734,74.125.200.0-255,2902,85612,92,240834
19239,0.000736,172.31.47.0-255,66,85678,92,240834
19240,0.000742,74.125.200.0-255,5738,91416,92,240834
19241,0.000743,172.31.47.0-255,66,91482,92,240834
19242,0.000764,74.125.200.0-255,4320,95802,92,240834
19243,0.000767,172.31.47.0-255,66,95868,92,240834
19244,0.000772,74.125.200.0-255,5020,100888,92,240834
19245,0.000774,172.31.47.0-255,66,100954,92,240834
19246,0.001386,74.125.200.0-255,1484,102438,92,240834
19247,0.001395,74.125.200.0-255,2902,105340,92,240834
19248,0.001398,172.31.47.0-255,66,105406,92,240834
19249,0.001403,74.125.200.0-255,1484,106890,92,240834
19250,0.001421,74.125.200.0-255,2902,109792,92,240834
19251,0.001424,172.31.47.0-255,66,109858,92,240834
19252,0.001445,74.125.200.0-255,5738,115596,92,240834
19253,0.001448,172.31.47.0-255,66,115662,92,240834
19254,0.00147,74.125.200.0-255,5738,121400,92,240834
19255,0.001472,172.31.47.0-255,66,121466,92,240834
19256,0.001484,74.125.200.0-255,2902,124368,92,240834
19257,0.001485,172.31.47.0-255,66,124434,92,240834
19258,0.001501,74.125.200.0-255,4320,128754,92,240834
19259,0.001503,172.31.47.0-255,66,128820,92,240834
19260,0.001537,74.125.200.0-255,5738,134558,92,240834
19261,0.00154,172.31.47.0-255,66,134624,92,240834
19262,0.001543,74.125.200.0-255,766,135390,92,240834
19263,0.001588,74.125.200.0-255,1484,136874,92,240834
19264,0.001591,172.31.47.0-255,66,136940,92,240834
19265,0.001605,74.125.200.0-255,2902,139842,92,240834
19266,0.001607,172.31.47.0-255,66,139908,92,240834
19267,0.001626,74.125.200.0-255,4320,144228,92,240834
19268,0.001628,172.31.47.0-255,66,144294,92,240834
19269,0.001645,74.125.200.0-255,2902,147196,92,240834
19270,0.001647,172.31.47.0-255,66,147262,92,240834
19271,0.001676,74.125.200.0-255,5738,153000,92,240834
19272,0.001678,172.31.47.0-255,66,153066,92,240834
19273,0.001687,172.31.47.0-255,66,153132,92,240834
19274,0.001715,74.125.200.0-255,2902,156034,92,240834
19275,0.001717,172.31.47.0-255,66,156100,92,240834
19276,0.001739,74.125.200.0-255,5020,161120,92,240834
19277,0.001741,172.31.47.0-255,66,161186,92,240834
19278,0.001757,74.125.200.0-255,1484,162670,92,240834
19279,0.001776,74.125.200.0-255,2902,165572,92,240834
19280,0.001778,172.31.47.0-255,66,165638,92,240834
19281,0.001802,74.125.200.0-255,5738,171376,92,240834
19282,0.001804,172.31.47.0-255,66,171442,92,240834
19283,0.001808,74.125.200.0-255,2902,174344,92,240834
19284,0.001811,172.31.47.0-255,66,174410,92,240834
19285,0.001827,74.125.200.0-255,5738,180148,92,240834
19286,0.001829,172.31.47.0-255,66,180214,92,240834
19287,0.001846,74.125.200.0-255,2902,183116,92,240834
19288,0.001848,172.31.47.0-255,66,183182,92,240834
19289,0.001871,74.125.200.0-255,7156,190338,92,240834
19290,0.001874,172.31.47.0-255,66,190404,92,240834
19291,0.001877,74.125.200.0-255,1484,191888,92,240834
19292,0.001916,74.125.200.0-255,3602,195490,92,240834
19293,0.001918,172.31.47.0-255,66,195556,92,240834
19294,0.001968,74.125.200.0-255,1484,197040,92,240834
19295,0.001983,74.125.200.0-255,2902,199942,92,240834
19296,0.001986,172.31.47.0-255,66,200008,92,240834
19297,0.001989,74.125.200.0-255,1484,201492,92,240834
19298,0.002009,74.125.200.0-255,4320,205812,92,240834
19299,0.002011,172.31.47.0-255,66,205878,92,240834
19300,0.002017,74.125.200.0-255,5738,211616,92,240834
19301,0.00202,172.31.47.0-255,66,211682,92,240834
19302,0.002022,74.125.200.0-255,1484,213166,92,240834
19303,0.002052,74.125.200.0-255,5738,218904,92,240834
19304,0.002055,172.31.47.0-255,66,218970,92,240834
19305,0.00206,74.125.200.0-255,4320,223290,92,240834
19306,0.002062,172.31.47.0-255,66,223356,92,240834
19307,0.004071,74.125.200.0-255,1484,224840,92,240834
19308,0.00409,74.125.200.0-255,4320,229160,92,240834
19309,0.004094,172.31.47.0-255,66,229226,92,240834
19310,0.006137,74.125.200.0-255,5738,234964,92,240834
19311,0.006144,172.31.47.0-255,66,235030,92,240834
19312,0.008215,74.125.200.0-255,5738,240768,92,240834
19313,0.008222,172.31.47.0-255,66,240834,92,240834
19314,0.0,74.125.24.0-255,153,153,92,219065
19315,3e-05,172.31.47.0-255,66,219,92,219065
19316,3.7e-05,74.125.24.0-255,1484,1703,92,219065
19317,4.1e-05,172.31.47.0-255,66,1769,92,219065
19318,4.6e-05,74.125.24.0-255,2902,4671,92,219065
19319,5.6e-05,172.31.47.0-255,66,4737,92,219065
19320,6.2e-05,74.125.24.0-255,5738,10475,92,219065
19321,6.5e-05,172.31.47.0-255,66,10541,92,219065
19322,9.8e-05,74.125.24.0-255,3668,14209,92,219065
19323,0.000101,172.31.47.0-255,66,14275,92,219065
19324,0.000137,74.125.24.0-255,1484,15759,92,219065
19325,0.000141,172.31.47.0-255,66,15825,92,219065
19326,0.000146,74.125.24.0-255,2902,18727,92,219065
19327,0.000148,172.31.47.0-255,66,18793,92,219065
19328,0.000173,74.125.24.0-255,5738,24531,92,219065
19329,0.000176,172.31.47.0-255,66,24597,92,219065
19330,0.000187,74.125.24.0-255,4320,28917,92,219065
19331,0.000189,172.31.47.0-255,66,28983,92,219065
19332,0.000216,74.125.24.0-255,2543,31526,92,219065
19333,0.000225,172.31.47.0-255,66,31592,92,219065
19334,0.000246,74.125.24.0-255,1484,33076,92,219065
19335,0.00025,74.125.24.0-255,2902,35978,92,219065
19336,0.000251,172.31.47.0-255,66,36044,92,219065
19337,0.000255,172.31.47.0-255,66,36110,92,219065
19338,0.000281,74.125.24.0-255,5738,41848,92,219065
19339,0.000284,172.31.47.0-255,66,41914,92,219065
19340,0.00029,74.125.24.0-255,4320,46234,92,219065
19341,0.000292,172.31.47.0-255,66,46300,92,219065
19342,0.000332,74.125.24.0-255,2543,48843,92,219065
19343,0.000336,172.31.47.0-255,66,48909,92,219065
19344,0.000407,74.125.24.0-255,1484,50393,92,219065
19345,0.000411,172.31.47.0-255,66,50459,92,219065
19346,0.000423,74.125.24.0-255,2902,53361,92,219065
19347,0.000427,172.31.47.0-255,66,53427,92,219065
19348,0.000438,74.125.24.0-255,5738,59165,92,219065
19349,0.000441,172.31.47.0-255,66,59231,92,219065
19350,0.000488,74.125.24.0-255,4320,63551,92,219065
19351,0.000491,172.31.47.0-255,66,63617,92,219065
19352,0.000508,74.125.24.0-255,3153,66770,92,219065
19353,0.000511,172.31.47.0-255,66,66836,92,219065
19354,0.000745,74.125.24.0-255,1484,68320,92,219065
19355,0.000761,74.125.24.0-255,2902,71222,92,219065
19356,0.000764,172.31.47.0-255,66,71288,92,219065
19357,0.00077,74.125.24.0-255,5738,77026,92,219065
19358,0.000772,172.31.47.0-255,66,77092,92,219065
19359,0.000807,172.31.47.0-255,66,77158,92,219065
19360,0.000842,74.125.24.0-255,1484,78642,92,219065
19361,0.00086,172.31.47.0-255,66,78708,92,219065
19362,0.000877,74.125.24.0-255,5020,83728,92,219065
19363,0.000879,172.31.47.0-255,66,83794,92,219065
19364,0.001197,74.125.24.0-255,1484,85278,92,219065
19365,0.001205,74.125.24.0-255,2902,88180,92,219065
19366,0.001208,172.31.47.0-255,66,88246,92,219065
19367,0.001244,74.125.24.0-255,5738,93984,92,219065
19368,0.001247,172.31.47.0-255,66,94050,92,219065
19369,0.001264,172.31.47.0-255,66,94116,92,219065
19370,0.001293,74.125.24.0-255,1484,95600,92,219065
19371,0.00132,172.31.47.0-255,66,95666,92,219065
19372,0.002362,74.125.24.0-255,1484,97150,92,219065
19373,0.002369,74.125.24.0-255,2902,100052,92,219065
19374,0.002372,172.31.47.0-255,66,100118,92,219065
19375,0.002406,74.125.24.0-255,1484,101602,92,219065
19376,0.002418,74.125.24.0-255,4320,105922,92,219065
19377,0.00242,172.31.47.0-255,66,105988,92,219065
19378,0.002434,172.31.47.0-255,66,106054,92,219065
19379,0.002454,74.125.24.0-255,4320,110374,92,219065
19380,0.002456,172.31.47.0-255,66,110440,92,219065
19381,0.002476,74.125.24.0-255,6438,116878,92,219065
19382,0.002478,172.31.47.0-255,66,116944,92,219065
19383,0.002507,74.125.24.0-255,1484,118428,92,219065
19384,0.00252,74.125.24.0-255,1484,119912,92,219065
19385,0.002522,172.31.47.0-255,66,119978,92,219065
19386,0.002549,74.125.24.0-255,1484,121462,92,219065
19387,0.002554,74.125.24.0-255,5738,127200,92,219065
19388,0.002556,172.31.47.0-255,66,127266,92,219065
19389,0.002558,74.125.24.0-255,1484,128750,92,219065
19390,0.002573,74.125.24.0-255,5738,134488,92,219065
19391,0.002575,172.31.47.0-255,66,134554,92,219065
19392,0.002603,74.125.24.0-255,4320,138874,92,219065
19393,0.002605,172.31.47.0-255,66,138940,92,219065
19394,0.002619,172.31.47.0-255,66,139006,92,219065
19395,0.002943,74.125.24.0-255,1484,140490,92,219065
19396,0.00296,74.125.24.0-255,2902,143392,92,219065
19397,0.002962,172.31.47.0-255,66,143458,92,219065
19398,0.002973,74.125.24.0-255,1484,144942,92,219065
19399,0.002996,74.125.24.0-255,4320,149262,92,219065
19400,0.002998,172.31.47.0-255,66,149328,92,219065
19401,0.003009,172.31.47.0-255,66,149394,92,219065
19402,0.003017,74.125.24.0-255,4320,153714,92,219065
19403,0.003019,172.31.47.0-255,66,153780,92,219065
19404,0.003025,74.125.24.0-255,6438,160218,92,219065
19405,0.003027,172.31.47.0-255,66,160284,92,219065
19406,0.003158,74.125.24.0-255,1484,161768,92,219065
19407,0.003171,74.125.24.0-255,2902,164670,92,219065
19408,0.003173,172.31.47.0-255,66,164736,92,219065
19409,0.003202,74.125.24.0-255,5738,170474,92,219065
19410,0.003204,172.31.47.0-255,66,170540,92,219065
19411,0.003208,74.125.24.0-255,2902,173442,92,219065
19412,0.003209,172.31.47.0-255,66,173508,92,219065
19413,0.003262,172.31.47.0-255,66,173574,92,219065
19414,0.00327,172.31.47.0-255,66,173640,92,219065
19415,0.003273,74.125.24.0-255,2184,175824,92,219065
19416,0.003279,172.31.47.0-255,66,175890,92,219065
19417,0.003323,74.125.24.0-255,1484,177374,92,219065
19418,0.003338,74.125.24.0-255,2902,180276,92,219065
19419,0.003342,172.31.47.0-255,66,180342,92,219065
19420,0.003346,74.125.24.0-255,4320,184662,92,219065
19421,0.003348,172.31.47.0-255,66,184728,92,219065
19422,0.003379,74.125.24.0-255,1484,186212,92,219065
19423,0.003392,172.31.47.0-255,66,186278,92,219065
19424,0.003401,172.31.47.0-255,66,186344,92,219065
19425,0.00341,74.125.24.0-255,3602,189946,92,219065
19426,0.003412,172.31.47.0-255,66,190012,92,219065
19427,0.003415,74.125.24.0-255,1484,191496,92,219065
19428,0.003448,74.125.24.0-255,7156,198652,92,219065
19429,0.003451,172.31.47.0-255,66,198718,92,219065
19430,0.003456,74.125.24.0-255,4320,203038,92,219065
19431,0.003457,172.31.47.0-255,66,203104,92,219065
19432,0.003494,172.31.47.0-255,66,203170,92,219065
19433,0.003504,172.31.47.0-255,66,203236,92,219065
19434,0.003551,74.125.24.0-255,5738,208974,92,219065
19435,0.003554,172.31.47.0-255,66,209040,92,219065
19436,0.003579,74.125.24.0-255,4320,213360,92,219065
19437,0.003583,172.31.47.0-255,66,213426,92,219065
19438,0.003602,172.31.47.0-255,66,213492,92,219065
19439,0.003615,172.31.47.0-255,66,213558,92,219065
19440,0.003622,172.31.47.0-255,66,213624,92,219065
19441,0.003705,172.31.47.0-255,66,213690,92,219065
19442,0.003714,74.125.24.0-255,5204,218894,92,219065
19443,0.003724,172.31.47.0-255,66,218960,92,219065
19444,0.003727,74.125.24.0-255,105,219065,92,219065
19445,0.0,74.125.200.0-255,153,153,92,227875
19446,2.4e-05,172.31.47.0-255,66,219,92,227875
19447,3.1e-05,74.125.200.0-255,1484,1703,92,227875
19448,3.4e-05,172.31.47.0-255,66,1769,92,227875
19449,3.8e-05,74.125.200.0-255,2902,4671,92,227875
19450,4e-05,172.31.47.0-255,66,4737,92,227875
19451,6.3e-05,74.125.200.0-255,4320,9057,92,227875
19452,6.6e-05,172.31.47.0-255,66,9123,92,227875
19453,9.6e-05,74.125.200.0-255,4997,14120,92,227875
19454,9.9e-05,172.31.47.0-255,66,14186,92,227875
19455,0.000123,74.125.200.0-255,5738,19924,92,227875
19456,0.000125,172.31.47.0-255,66,19990,92,227875
19457,0.00015,74.125.200.0-255,5738,25728,92,227875
19458,0.000154,172.31.47.0-255,66,25794,92,227875
19459,0.000182,74.125.200.0-255,5379,31173,92,227875
19460,0.000185,172.31.47.0-255,66,31239,92,227875
19461,0.00023,74.125.200.0-255,1484,32723,92,227875
19462,0.000233,172.31.47.0-255,66,32789,92,227875
19463,0.000236,74.125.200.0-255,1484,34273,92,227875
19464,0.000237,172.31.47.0-255,66,34339,92,227875
19465,0.000258,74.125.200.0-255,2902,37241,92,227875
19466,0.000261,172.31.47.0-255,66,37307,92,227875
19467,0.000289,74.125.200.0-255,5738,43045,92,227875
19468,0.000292,172.31.47.0-255,66,43111,92,227875
19469,0.000317,74.125.200.0-255,6797,49908,92,227875
19470,0.000321,172.31.47.0-255,66,49974,92,227875
19471,0.000339,74.125.200.0-255,1484,51458,92,227875
19472,0.000341,172.31.47.0-255,66,51524,92,227875
19473,0.000371,74.125.200.0-255,5738,57262,92,227875
19474,0.000375,172.31.47.0-255,66,57328,92,227875
19475,0.000381,74.125.200.0-255,7156,64484,92,227875
19476,0.000384,172.31.47.0-255,66,64550,92,227875
19477,0.000391,74.125.200.0-255,1125,65675,92,227875
19478,0.000422,74.125.200.0-255,646,66321,92,227875
19479,0.000425,172.31.47.0-255,66,66387,92,227875
19480,0.000879,74.125.200.0-255,1484,67871,92,227875
19481,0.000894,74.125.200.0-255,2902,70773,92,227875
19482,0.000898,172.31.47.0-255,66,70839,92,227875
19483,0.000903,74.125.200.0-255,2902,73741,92,227875
19484,0.000905,172.31.47.0-255,66,73807,92,227875
19485,0.000907,74.125.200.0-255,1484,75291,92,227875
19486,0.000931,74.125.200.0-255,2902,78193,92,227875
19487,0.000934,172.31.47.0-255,66,78259,92,227875
19488,0.000944,172.31.47.0-255,66,78325,92,227875
19489,0.000973,74.125.200.0-255,7156,85481,92,227875
19490,0.000976,172.31.47.0-255,66,85547,92,227875
19491,0.001012,74.125.200.0-255,6438,91985,92,227875
19492,0.001016,172.31.47.0-255,66,92051,92,227875
19493,0.001423,74.125.200.0-255,1484,93535,92,227875
19494,0.001442,74.125.200.0-255,2902,96437,92,227875
19495,0.001445,172.31.47.0-255,66,96503,92,227875
19496,0.001451,74.125.200.0-255,5738,102241,92,227875
19497,0.001453,172.31.47.0-255,66,102307,92,227875
19498,0.001455,74.125.200.0-255,1484,103791,92,227875
19499,0.001478,74.125.200.0-255,1484,105275,92,227875
19500,0.00148,172.31.47.0-255,66,105341,92,227875
19501,0.001482,74.125.200.0-255,1484,106825,92,227875
19502,0.001512,172.31.47.0-255,66,106891,92,227875
19503,0.001514,74.125.200.0-255,1484,108375,92,227875
19504,0.00154,172.31.47.0-255,66,108441,92,227875
19505,0.001591,74.125.200.0-255,1484,109925,92,227875
19506,0.001602,74.125.200.0-255,2902,112827,92,227875
19507,0.001604,172.31.47.0-255,66,112893,92,227875
19508,0.001606,74.125.200.0-255,1484,114377,92,227875
19509,0.001641,74.125.200.0-255,2902,117279,92,227875
19510,0.001643,172.31.47.0-255,66,117345,92,227875
19511,0.001648,74.125.200.0-255,5738,123083,92,227875
19512,0.00165,172.31.47.0-255,66,123149,92,227875
19513,0.001684,74.125.200.0-255,2902,126051,92,227875
19514,0.001686,172.31.47.0-255,66,126117,92,227875
19515,0.00171,74.125.200.0-255,2902,129019,92,227875
19516,0.001712,172.31.47.0-255,66,129085,92,227875
19517,0.001718,74.125.200.0-255,7156,136241,92,227875
19518,0.001719,172.31.47.0-255,66,136307,92,227875
19519,0.001723,74.125.200.0-255,4320,140627,92,227875
19520,0.001725,172.31.47.0-255,66,140693,92,227875
19521,0.001771,74.125.200.0-255,2184,142877,92,227875
19522,0.001774,172.31.47.0-255,66,142943,92,227875
19523,0.001802,74.125.200.0-255,2902,145845,92,227875
19524,0.001804,172.31.47.0-255,66,145911,92,227875
19525,0.00183,74.125.200.0-255,4320,150231,92,227875
19526,0.001832,172.31.47.0-255,66,150297,92,227875
19527,0.001835,74.125.200.0-255,2902,153199,92,227875
19528,0.001837,172.31.47.0-255,66,153265,92,227875
19529,0.001856,74.125.200.0-255,2902,156167,92,227875
19530,0.001858,172.31.47.0-255,66,156233,92,227875
19531,0.001863,74.125.200.0-255,4320,160553,92,227875
19532,0.001865,172.31.47.0-255,66,160619,92,227875
19533,0.001898,74.125.200.0-255,7156,167775,92,227875
19534,0.001901,172.31.47.0-255,66,167841,92,227875
19535,0.001905,74.125.200.0-255,4320,172161,92,227875
19536,0.001907,172.31.47.0-255,66,172227,92,227875
19537,0.001943,74.125.200.0-255,5020,177247,92,227875
19538,0.001945,172.31.47.0-255,66,177313,92,227875
19539,0.002175,74.125.200.0-255,1484,178797,92,227875
19540,0.002227,74.125.200.0-255,1484,180281,92,227875
19541,0.002229,172.31.47.0-255,66,180347,92,227875
19542,0.00224,74.125.200.0-255,1484,181831,92,227875
19543,0.002255,74.125.200.0-255,1484,183315,92,227875
19544,0.002257,172.31.47.0-255,66,183381,92,227875
19545,0.002261,74.125.200.0-255,2902,186283,92,227875
19546,0.002263,172.31.47.0-255,66,186349,92,227875
19547,0.002293,74.125.200.0-255,2902,189251,92,227875
19548,0.002295,172.31.47.0-255,66,189317,92,227875
19549,0.002301,74.125.200.0-255,4320,193637,92,227875
19550,0.002303,172.31.47.0-255,66,193703,92,227875
19551,0.002312,74.125.200.0-255,5738,199441,92,227875
19552,0.002315,172.31.47.0-255,66,199507,92,227875
19553,0.00232,74.125.200.0-255,5738,205245,92,227875
19554,0.002322,172.31.47.0-255,66,205311,92,227875
19555,0.002348,74.125.200.0-255,5738,211049,92,227875
19556,0.002355,172.31.47.0-255,66,211115,92,227875
19557,0.002357,74.125.200.0-255,766,211881,92,227875
19558,0.004714,74.125.200.0-255,4320,216201,92,227875
19559,0.004719,172.31.47.0-255,66,216267,92,227875
19560,0.00711,74.125.200.0-255,5738,222005,92,227875
19561,0.007116,172.31.47.0-255,66,222071,92,227875
19562,0.009488,74.125.200.0-255,5738,227809,92,227875
19563,0.009494,172.31.47.0-255,66,227875,92,227875
19564,0.0,172.31.47.0-255,105,105,92,276
19565,0.002187,157.240.7.0-255,105,210,92,276
19566,0.002202,172.31.47.0-255,66,276,92,276
19567,0.0,74.125.24.0-255,153,153,92,159778
19568,1.2e-05,172.31.47.0-255,66,219,92,159778
19569,2.7e-05,74.125.24.0-255,1484,1703,92,159778
19570,3.6e-05,172.31.47.0-255,66,1769,92,159778
19571,4.2e-05,74.125.24.0-255,2902,4671,92,159778
19572,4.5e-05,172.31.47.0-255,66,4737,92,159778
19573,4.8e-05,74.125.24.0-255,1484,6221,92,159778
19574,5e-05,172.31.47.0-255,66,6287,92,159778
19575,8.7e-05,74.125.24.0-255,5738,12025,92,159778
19576,8.9e-05,172.31.47.0-255,66,12091,92,159778
19577,0.000105,74.125.24.0-255,2127,14218,92,159778
19578,0.000118,172.31.47.0-255,66,14284,92,159778
19579,0.000123,74.125.24.0-255,2902,17186,92,159778
19580,0.000125,172.31.47.0-255,66,17252,92,159778
19581,0.000152,74.125.24.0-255,7156,24408,92,159778
19582,0.000155,172.31.47.0-255,66,24474,92,159778
19583,0.000184,74.125.24.0-255,6797,31271,92,159778
19584,0.000187,172.31.47.0-255,66,31337,92,159778
19585,0.000252,74.125.24.0-255,1484,32821,92,159778
19586,0.000255,172.31.47.0-255,66,32887,92,159778
19587,0.00026,74.125.24.0-255,2902,35789,92,159778
19588,0.000262,172.31.47.0-255,66,35855,92,159778
19589,0.00027,74.125.24.0-255,4320,40175,92,159778
19590,0.000272,172.31.47.0-255,66,40241,92,159778
19591,0.000299,74.125.24.0-255,1484,41725,92,159778
19592,0.0003,172.31.47.0-255,66,41791,92,159778
19593,0.000318,172.31.47.0-255,66,41857,92,159778
19594,0.000323,74.125.24.0-255,4320,46177,92,159778
19595,0.000325,172.31.47.0-255,66,46243,92,159778
19596,0.000363,74.125.24.0-255,5709,51952,92,159778
19597,0.000366,172.31.47.0-255,66,52018,92,159778
19598,0.000397,74.125.24.0-255,378,52396,92,159778
19599,0.000598,74.125.24.0-255,1484,53880,92,159778
19600,0.000614,172.31.47.0-255,66,53946,92,159778
19601,0.00062,74.125.24.0-255,2902,56848,92,159778
19602,0.000625,74.125.24.0-255,5738,62586,92,159778
19603,0.000639,172.31.47.0-255,66,62652,92,159778
19604,0.000647,74.125.24.0-255,1484,64136,92,159778
19605,0.000689,172.31.47.0-255,66,64202,92,159778
19606,0.000928,74.125.24.0-255,1484,65686,92,159778
19607,0.000934,74.125.24.0-255,2902,68588,92,159778
19608,0.000937,172.31.47.0-255,66,68654,92,159778
19609,0.000965,74.125.24.0-255,5738,74392,92,159778
19610,0.000969,74.125.24.0-255,2902,77294,92,159778
19611,0.000973,172.31.47.0-255,66,77360,92,159778
19612,0.001003,74.125.24.0-255,7156,84516,92,159778
19613,0.001011,172.31.47.0-255,66,84582,92,159778
19614,0.001073,172.31.47.0-255,66,84648,92,159778
19615,0.001395,74.125.24.0-255,1484,86132,92,159778
19616,0.001409,74.125.24.0-255,2902,89034,92,159778
19617,0.001413,172.31.47.0-255,66,89100,92,159778
19618,0.001437,74.125.24.0-255,4320,93420,92,159778
19619,0.001449,172.31.47.0-255,66,93486,92,159778
19620,0.001484,74.125.24.0-255,4320,97806,92,159778
19621,0.001489,172.31.47.0-255,66,97872,92,159778
19622,0.001532,172.31.47.0-255,66,97938,92,159778
19623,0.001685,74.125.24.0-255,1484,99422,92,159778
19624,0.001706,74.125.24.0-255,2902,102324,92,159778
19625,0.001709,172.31.47.0-255,66,102390,92,159778
19626,0.001715,74.125.24.0-255,5738,108128,92,159778
19627,0.001717,74.125.24.0-255,1484,109612,92,159778
19628,0.001733,172.31.47.0-255,66,109678,92,159778
19629,0.00174,74.125.24.0-255,7156,116834,92,159778
19630,0.001766,172.31.47.0-255,66,116900,92,159778
19631,0.001816,172.31.47.0-255,66,116966,92,159778
19632,0.001998,74.125.24.0-255,1484,118450,92,159778
19633,0.002003,74.125.24.0-255,2902,121352,92,159778
19634,0.002006,172.31.47.0-255,66,121418,92,159778
19635,0.002037,74.125.24.0-255,5738,127156,92,159778
19636,0.002044,74.125.24.0-255,5738,132894,92,159778
19637,0.002048,74.125.24.0-255,2902,135796,92,159778
19638,0.002058,172.31.47.0-255,66,135862,92,159778
19639,0.002098,74.125.24.0-255,5020,140882,92,159778
19640,0.002274,74.125.24.0-255,1484,142366,92,159778
19641,0.00228,74.125.24.0-255,2902,145268,92,159778
19642,0.002302,74.125.24.0-255,5738,151006,92,159778
19643,0.002346,74.125.24.0-255,2902,153908,92,159778
19644,0.007222,172.31.47.0-255,66,153974,92,159778
19645,0.009564,74.125.24.0-255,5738,159712,92,159778
19646,0.009573,172.31.47.0-255,66,159778,92,159778
19647,0.0,172.31.47.0-255,105,105,92,105
19648,0.0,172.31.47.0-255,105,105,92,210
19649,0.001779,157.240.13.0-255,105,210,92,210
19650,0.0,172.31.47.0-255,105,105,92,276
19651,0.001774,157.240.13.0-255,105,210,92,276
19652,0.001784,172.31.47.0-255,66,276,92,276
19653,0.0,172.31.47.0-255,105,105,92,276
19654,0.001784,157.240.13.0-255,105,210,92,276
19655,0.001797,172.31.47.0-255,66,276,92,276
19656,0.0,172.217.194.0-255,152,152,92,122964
19657,2.5e-05,172.31.47.0-255,66,218,92,122964
19658,3.2e-05,172.217.194.0-255,1484,1702,92,122964
19659,3.6e-05,172.31.47.0-255,66,1768,92,122964
19660,4.1e-05,172.217.194.0-255,2902,4670,92,122964
19661,4.4e-05,172.31.47.0-255,66,4736,92,122964
19662,5.8e-05,172.217.194.0-255,7156,11892,92,122964
19663,6.1e-05,172.31.47.0-255,66,11958,92,122964
19664,9.2e-05,172.217.194.0-255,7156,19114,92,122964
19665,9.5e-05,172.31.47.0-255,66,19180,92,122964
19666,0.000122,172.217.194.0-255,3375,22555,92,122964
19667,0.000126,172.31.47.0-255,66,22621,92,122964
19668,0.00013,172.217.194.0-255,2902,25523,92,122964
19669,0.000132,172.31.47.0-255,66,25589,92,122964
19670,0.000162,172.217.194.0-255,5379,30968,92,122964
19671,0.000167,172.31.47.0-255,66,31034,92,122964
19672,0.000239,172.217.194.0-255,1484,32518,92,122964
19673,0.000242,172.31.47.0-255,66,32584,92,122964
19674,0.000246,172.217.194.0-255,2902,35486,92,122964
19675,0.000248,172.31.47.0-255,66,35552,92,122964
19676,0.000279,172.217.194.0-255,5738,41290,92,122964
19677,0.000283,172.31.47.0-255,66,41356,92,122964
19678,0.000293,172.31.47.0-255,66,41422,92,122964
19679,0.000333,172.31.47.0-255,66,41488,92,122964
19680,0.00034,172.217.194.0-255,6797,48285,92,122964
19681,0.000342,172.31.47.0-255,66,48351,92,122964
19682,0.000976,172.217.194.0-255,647,48998,92,122964
19683,0.000981,172.31.47.0-255,66,49064,92,122964
19684,0.001008,172.217.194.0-255,1484,50548,92,122964
19685,0.001011,172.31.47.0-255,66,50614,92,122964
19686,0.001018,172.217.194.0-255,4320,54934,92,122964
19687,0.001021,172.31.47.0-255,66,55000,92,122964
19688,0.001057,172.31.47.0-255,66,55066,92,122964
19689,0.001068,172.31.47.0-255,66,55132,92,122964
19690,0.001097,172.217.194.0-255,2902,58034,92,122964
19691,0.0011,172.31.47.0-255,66,58100,92,122964
19692,0.001123,172.217.194.0-255,6438,64538,92,122964
19693,0.001126,172.31.47.0-255,66,64604,92,122964
19694,0.001625,172.217.194.0-255,1484,66088,92,122964
19695,0.001642,172.217.194.0-255,2902,68990,92,122964
19696,0.001646,172.31.47.0-255,66,69056,92,122964
19697,0.001651,172.217.194.0-255,2902,71958,92,122964
19698,0.001652,172.31.47.0-255,66,72024,92,122964
19699,0.00169,172.217.194.0-255,7156,79180,92,122964
19700,0.001692,172.31.47.0-255,66,79246,92,122964
19701,0.001731,172.217.194.0-255,5738,84984,92,122964
19702,0.001733,172.31.47.0-255,66,85050,92,122964
19703,0.001751,172.31.47.0-255,66,85116,92,122964
19704,0.00176,172.217.194.0-255,3602,88718,92,122964
19705,0.001763,172.31.47.0-255,66,88784,92,122964
19706,0.001781,172.31.47.0-255,66,88850,92,122964
19707,0.001794,172.31.47.0-255,66,88916,92,122964
19708,0.001796,172.217.194.0-255,766,89682,92,122964
19709,0.001913,172.217.194.0-255,1484,91166,92,122964
19710,0.001916,172.31.47.0-255,66,91232,92,122964
19711,0.00192,172.217.194.0-255,1484,92716,92,122964
19712,0.001938,172.217.194.0-255,1484,94200,92,122964
19713,0.00194,172.31.47.0-255,66,94266,92,122964
19714,0.001946,172.217.194.0-255,5738,100004,92,122964
19715,0.001949,172.31.47.0-255,66,100070,92,122964
19716,0.00198,172.31.47.0-255,66,100136,92,122964
19717,0.002006,172.217.194.0-255,4320,104456,92,122964
19718,0.002009,172.31.47.0-255,66,104522,92,122964
19719,0.002018,172.31.47.0-255,66,104588,92,122964
19720,0.002026,172.217.194.0-255,2184,106772,92,122964
19721,0.002028,172.31.47.0-255,66,106838,92,122964
19722,0.004116,172.217.194.0-255,4320,111158,92,122964
19723,0.004123,172.31.47.0-255,66,111224,92,122964
19724,0.004133,172.217.194.0-255,1484,112708,92,122964
19725,0.006217,172.217.194.0-255,4320,117028,92,122964
19726,0.006222,172.31.47.0-255,66,117094,92,122964
19727,0.008317,172.217.194.0-255,4320,121414,92,122964
19728,0.008323,172.31.47.0-255,66,121480,92,122964
19729,0.008352,172.217.194.0-255,1484,122964,92,122964
19730,0.0,172.217.194.0-255,153,153,92,138353
19731,1.3e-05,172.31.47.0-255,66,219,92,138353
19732,1.9e-05,172.217.194.0-255,1484,1703,92,138353
19733,2.4e-05,172.31.47.0-255,66,1769,92,138353
19734,3.6e-05,172.217.194.0-255,2902,4671,92,138353
19735,3.9e-05,172.31.47.0-255,66,4737,92,138353
19736,4.4e-05,172.217.194.0-255,2902,7639,92,138353
19737,4.7e-05,172.31.47.0-255,66,7705,92,138353
19738,7.1e-05,172.217.194.0-255,4320,12025,92,138353
19739,7.3e-05,172.31.47.0-255,66,12091,92,138353
19740,0.0001,172.217.194.0-255,2102,14193,92,138353
19741,0.000102,172.31.47.0-255,66,14259,92,138353
19742,0.000123,172.217.194.0-255,2902,17161,92,138353
19743,0.000125,172.31.47.0-255,66,17227,92,138353
19744,0.000151,172.217.194.0-255,4320,21547,92,138353
19745,0.000153,172.31.47.0-255,66,21613,92,138353
19746,0.000156,172.217.194.0-255,1484,23097,92,138353
19747,0.000158,172.31.47.0-255,66,23163,92,138353
19748,0.00019,172.217.194.0-255,7156,30319,92,138353
19749,0.000193,172.31.47.0-255,66,30385,92,138353
19750,0.000198,172.217.194.0-255,5379,35764,92,138353
19751,0.0002,172.31.47.0-255,66,35830,92,138353
19752,0.000206,172.217.194.0-255,5738,41568,92,138353
19753,0.000208,172.31.47.0-255,66,41634,92,138353
19754,0.00024,172.217.194.0-255,6797,48431,92,138353
19755,0.000242,172.31.47.0-255,66,48497,92,138353
19756,0.000598,172.217.194.0-255,1484,49981,92,138353
19757,0.000603,172.31.47.0-255,66,50047,92,138353
19758,0.000609,172.217.194.0-255,2902,52949,92,138353
19759,0.000611,172.31.47.0-255,66,53015,92,138353
19760,0.000617,172.217.194.0-255,5738,58753,92,138353
19761,0.000637,172.31.47.0-255,66,58819,92,138353
19762,0.000644,172.217.194.0-255,6797,65616,92,138353
19763,0.000646,172.31.47.0-255,66,65682,92,138353
19764,0.001018,172.217.194.0-255,1484,67166,92,138353
19765,0.001027,172.217.194.0-255,2902,70068,92,138353
19766,0.001031,172.31.47.0-255,66,70134,92,138353
19767,0.001067,172.217.194.0-255,5738,75872,92,138353
19768,0.001069,172.31.47.0-255,66,75938,92,138353
19769,0.001074,172.217.194.0-255,2902,78840,92,138353
19770,0.001076,172.31.47.0-255,66,78906,92,138353
19771,0.001116,172.31.47.0-255,66,78972,92,138353
19772,0.001129,172.31.47.0-255,66,79038,92,138353
19773,0.001146,172.31.47.0-255,66,79104,92,138353
19774,0.001154,172.217.194.0-255,7156,86260,92,138353
19775,0.001156,172.31.47.0-255,66,86326,92,138353
19776,0.001185,172.217.194.0-255,4320,90646,92,138353
19777,0.001189,172.31.47.0-255,66,90712,92,138353
19778,0.001202,172.31.47.0-255,66,90778,92,138353
19779,0.001213,172.31.47.0-255,66,90844,92,138353
19780,0.001282,172.31.47.0-255,66,90910,92,138353
19781,0.001309,172.31.47.0-255,66,90976,92,138353
19782,0.001312,172.217.194.0-255,766,91742,92,138353
19783,0.001338,172.217.194.0-255,5738,97480,92,138353
19784,0.00134,172.31.47.0-255,66,97546,92,138353
19785,0.001376,172.31.47.0-255,66,97612,92,138353
19786,0.001391,172.31.47.0-255,66,97678,92,138353
19787,0.001416,172.217.194.0-255,3602,101280,92,138353
19788,0.001419,172.31.47.0-255,66,101346,92,138353
19789,0.001645,172.217.194.0-255,1484,102830,92,138353
19790,0.001652,172.217.194.0-255,2902,105732,92,138353
19791,0.001656,172.31.47.0-255,66,105798,92,138353
19792,0.001686,172.217.194.0-255,5738,111536,92,138353
19793,0.00169,172.31.47.0-255,66,111602,92,138353
19794,0.001693,172.217.194.0-255,1484,113086,92,138353
19795,0.001736,172.31.47.0-255,66,113152,92,138353
19796,0.001753,172.31.47.0-255,66,113218,92,138353
19797,0.001876,172.217.194.0-255,1484,114702,92,138353
19798,0.001883,172.217.194.0-255,2902,117604,92,138353
19799,0.001887,172.31.47.0-255,66,117670,92,138353
19800,0.001919,172.217.194.0-255,5738,123408,92,138353
19801,0.001923,172.31.47.0-255,66,123474,92,138353
19802,0.001931,172.217.194.0-255,7156,130630,92,138353
19803,0.001933,172.31.47.0-255,66,130696,92,138353
19804,0.001981,172.217.194.0-255,1484,132180,92,138353
19805,0.002001,172.31.47.0-255,66,132246,92,138353
19806,0.002015,172.31.47.0-255,66,132312,92,138353
19807,0.002062,172.31.47.0-255,66,132378,92,138353
19808,0.0021,172.31.47.0-255,66,132444,92,138353
19809,0.002218,172.217.194.0-255,5738,138182,92,138353
19810,0.002294,172.217.194.0-255,105,138287,92,138353
19811,0.007503,172.31.47.0-255,66,138353,92,138353
19812,0.0,74.125.24.0-255,152,152,92,224680
19813,1.8e-05,172.31.47.0-255,66,218,92,224680
19814,3.6e-05,74.125.24.0-255,1484,1702,92,224680
19815,3.9e-05,172.31.47.0-255,66,1768,92,224680
19816,5.7e-05,74.125.24.0-255,2902,4670,92,224680
19817,6e-05,172.31.47.0-255,66,4736,92,224680
19818,6.2e-05,74.125.24.0-255,1484,6220,92,224680
19819,6.4e-05,172.31.47.0-255,66,6286,92,224680
19820,9.7e-05,74.125.24.0-255,5738,12024,92,224680
19821,9.9e-05,172.31.47.0-255,66,12090,92,224680
19822,0.000102,74.125.24.0-255,2103,14193,92,224680
19823,0.000105,172.31.47.0-255,66,14259,92,224680
19824,0.000124,74.125.24.0-255,2902,17161,92,224680
19825,0.000126,172.31.47.0-255,66,17227,92,224680
19826,0.000154,172.31.47.0-255,66,17293,92,224680
19827,0.000161,74.125.24.0-255,7156,24449,92,224680
19828,0.000163,172.31.47.0-255,66,24515,92,224680
19829,0.000205,74.125.24.0-255,7156,31671,92,224680
19830,0.000208,172.31.47.0-255,66,31737,92,224680
19831,0.000226,172.31.47.0-255,66,31803,92,224680
19832,0.000268,172.31.47.0-255,66,31869,92,224680
19833,0.000338,74.125.24.0-255,2883,34752,92,224680
19834,0.000342,172.31.47.0-255,66,34818,92,224680
19835,0.000416,74.125.24.0-255,1484,36302,92,224680
19836,0.000419,172.31.47.0-255,66,36368,92,224680
19837,0.000448,74.125.24.0-255,2902,39270,92,224680
19838,0.00045,172.31.47.0-255,66,39336,92,224680
19839,0.000456,74.125.24.0-255,5738,45074,92,224680
19840,0.000458,172.31.47.0-255,66,45140,92,224680
19841,0.00046,74.125.24.0-255,1484,46624,92,224680
19842,0.000494,74.125.24.0-255,7156,53780,92,224680
19843,0.000501,172.31.47.0-255,66,53846,92,224680
19844,0.000512,74.125.24.0-255,2543,56389,92,224680
19845,0.000515,74.125.24.0-255,4320,60709,92,224680
19846,0.000516,172.31.47.0-255,66,60775,92,224680
19847,0.000529,172.31.47.0-255,66,60841,92,224680
19848,0.000558,172.31.47.0-255,66,60907,92,224680
19849,0.000581,74.125.24.0-255,5738,66645,92,224680
19850,0.00059,74.125.24.0-255,466,67111,92,224680
19851,0.00059,172.31.47.0-255,66,67177,92,224680
19852,0.000595,172.31.47.0-255,66,67243,92,224680
19853,0.000622,74.125.24.0-255,1484,68727,92,224680
19854,0.000626,74.125.24.0-255,2902,71629,92,224680
19855,0.000635,172.31.47.0-255,66,71695,92,224680
19856,0.000643,74.125.24.0-255,1484,73179,92,224680
19857,0.000649,74.125.24.0-255,5738,78917,92,224680
19858,0.000659,172.31.47.0-255,66,78983,92,224680
19859,0.000668,74.125.24.0-255,4320,83303,92,224680
19860,0.000672,172.31.47.0-255,66,83369,92,224680
19861,0.000698,74.125.24.0-255,2902,86271,92,224680
19862,0.000701,172.31.47.0-255,66,86337,92,224680
19863,0.000717,74.125.24.0-255,3602,89939,92,224680
19864,0.00072,172.31.47.0-255,66,90005,92,224680
19865,0.00075,74.125.24.0-255,1484,91489,92,224680
19866,0.000769,74.125.24.0-255,4320,95809,92,224680
19867,0.000779,172.31.47.0-255,66,95875,92,224680
19868,0.000787,74.125.24.0-255,5738,101613,92,224680
19869,0.00079,172.31.47.0-255,66,101679,92,224680
19870,0.000797,74.125.24.0-255,1484,103163,92,224680
19871,0.000803,74.125.24.0-255,5738,108901,92,224680
19872,0.000815,172.31.47.0-255,66,108967,92,224680
19873,0.000841,74.125.24.0-255,6438,115405,92,224680
19874,0.000842,172.31.47.0-255,66,115471,92,224680
19875,0.000846,172.31.47.0-255,66,115537,92,224680
19876,0.000881,74.125.24.0-255,1484,117021,92,224680
19877,0.000901,74.125.24.0-255,2902,119923,92,224680
19878,0.000904,172.31.47.0-255,66,119989,92,224680
19879,0.000909,74.125.24.0-255,5738,125727,92,224680
19880,0.000915,172.31.47.0-255,66,125793,92,224680
19881,0.000922,74.125.24.0-255,4320,130113,92,224680
19882,0.000929,172.31.47.0-255,66,130179,92,224680
19883,0.000934,74.125.24.0-255,2902,133081,92,224680
19884,0.000938,74.125.24.0-255,2902,135983,92,224680
19885,0.00094,172.31.47.0-255,66,136049,92,224680
19886,0.000968,172.31.47.0-255,66,136115,92,224680
19887,0.001038,172.31.47.0-255,66,136181,92,224680
19888,0.001042,172.31.47.0-255,66,136247,92,224680
19889,0.001043,74.125.24.0-255,4320,140567,92,224680
19890,0.001053,172.31.47.0-255,66,140633,92,224680
19891,0.001081,74.125.24.0-255,4320,144953,92,224680
19892,0.001088,172.31.47.0-255,66,145019,92,224680
19893,0.001117,74.125.24.0-255,3961,148980,92,224680
19894,0.00112,172.31.47.0-255,66,149046,92,224680
19895,0.001121,74.125.24.0-255,4320,153366,92,224680
19896,0.001125,172.31.47.0-255,66,153432,92,224680
19897,0.001141,74.125.24.0-255,1484,154916,92,224680
19898,0.001173,172.31.47.0-255,66,154982,92,224680
19899,0.001175,74.125.24.0-255,4320,159302,92,224680
19900,0.001185,172.31.47.0-255,66,159368,92,224680
19901,0.001194,74.125.24.0-255,4320,163688,92,224680
19902,0.001197,172.31.47.0-255,66,163754,92,224680
19903,0.001205,74.125.24.0-255,2902,166656,92,224680
19904,0.001212,172.31.47.0-255,66,166722,92,224680
19905,0.001232,74.125.24.0-255,7156,173878,92,224680
19906,0.001235,74.125.24.0-255,766,174644,92,224680
19907,0.001246,172.31.47.0-255,66,174710,92,224680
19908,0.001411,74.125.24.0-255,1484,176194,92,224680
19909,0.001416,74.125.24.0-255,2902,179096,92,224680
19910,0.001419,172.31.47.0-255,66,179162,92,224680
19911,0.00144,74.125.24.0-255,5738,184900,92,224680
19912,0.00145,172.31.47.0-255,66,184966,92,224680
19913,0.001458,172.31.47.0-255,66,185032,92,224680
19914,0.001472,74.125.24.0-255,4320,189352,92,224680
19915,0.001476,74.125.24.0-255,4320,193672,92,224680
19916,0.001487,172.31.47.0-255,66,193738,92,224680
19917,0.001491,74.125.24.0-255,6438,200176,92,224680
19918,0.001498,172.31.47.0-255,66,200242,92,224680
19919,0.001545,74.125.24.0-255,1484,201726,92,224680
19920,0.001548,74.125.24.0-255,1484,203210,92,224680
19921,0.001563,172.31.47.0-255,66,203276,92,224680
19922,0.001563,74.125.24.0-255,1484,204760,92,224680
19923,0.001566,74.125.24.0-255,2902,207662,92,224680
19924,0.001575,172.31.47.0-255,66,207728,92,224680
19925,0.001577,74.125.24.0-255,2902,210630,92,224680
19926,0.001579,74.125.24.0-255,1484,212114,92,224680
19927,0.001579,172.31.47.0-255,66,212180,92,224680
19928,0.001602,74.125.24.0-255,7156,219336,92,224680
19929,0.001604,172.31.47.0-255,66,219402,92,224680
19930,0.00162,74.125.24.0-255,1484,220886,92,224680
19931,0.001656,172.31.47.0-255,66,220952,92,224680
19932,0.001666,74.125.24.0-255,1484,222436,92,224680
19933,0.001706,172.31.47.0-255,66,222502,92,224680
19934,0.001717,172.31.47.0-255,66,222568,92,224680
19935,0.001783,172.31.47.0-255,66,222634,92,224680
19936,0.001804,74.125.24.0-255,1638,224272,92,224680
19937,0.001806,172.31.47.0-255,66,224338,92,224680
19938,0.001806,74.125.24.0-255,105,224443,92,224680
19939,0.001818,172.31.47.0-255,66,224509,92,224680
19940,0.003169,172.31.47.0-255,105,224614,92,224680
19941,0.005483,74.125.24.0-255,66,224680,92,224680
19942,0.0,74.125.24.0-255,153,153,92,171846
19943,2.3e-05,172.31.47.0-255,66,219,92,171846
19944,2.9e-05,74.125.24.0-255,1484,1703,92,171846
19945,3.3e-05,172.31.47.0-255,66,1769,92,171846
19946,6.9e-05,74.125.24.0-255,2902,4671,92,171846
19947,7.3e-05,74.125.24.0-255,2902,7573,92,171846
19948,7.4e-05,172.31.47.0-255,66,7639,92,171846
19949,7.7e-05,172.31.47.0-255,66,7705,92,171846
19950,8.2e-05,74.125.24.0-255,1484,9189,92,171846
19951,8.4e-05,172.31.47.0-255,66,9255,92,171846
19952,0.000102,74.125.24.0-255,6388,15643,92,171846
19953,0.000105,172.31.47.0-255,66,15709,92,171846
19954,0.000113,74.125.24.0-255,4320,20029,92,171846
19955,0.000117,172.31.47.0-255,66,20095,92,171846
19956,0.000157,172.31.47.0-255,66,20161,92,171846
19957,0.000169,74.125.24.0-255,2543,22704,92,171846
19958,0.000171,172.31.47.0-255,66,22770,92,171846
19959,0.000223,74.125.24.0-255,1484,24254,92,171846
19960,0.000225,172.31.47.0-255,66,24320,92,171846
19961,0.000238,74.125.24.0-255,2902,27222,92,171846
19962,0.000246,172.31.47.0-255,66,27288,92,171846
19963,0.000252,74.125.24.0-255,5738,33026,92,171846
19964,0.000254,172.31.47.0-255,66,33092,92,171846
19965,0.000259,74.125.24.0-255,4320,37412,92,171846
19966,0.000261,172.31.47.0-255,66,37478,92,171846
19967,0.000303,74.125.24.0-255,5738,43216,92,171846
19968,0.000307,172.31.47.0-255,66,43282,92,171846
19969,0.000341,74.125.24.0-255,6797,50079,92,171846
19970,0.000345,172.31.47.0-255,66,50145,92,171846
19971,0.000353,74.125.24.0-255,7070,57215,92,171846
19972,0.000355,172.31.47.0-255,66,57281,92,171846
19973,0.000557,74.125.24.0-255,138,57419,92,171846
19974,0.000561,74.125.24.0-255,343,57762,92,171846
19975,0.000801,172.31.47.0-255,66,57828,92,171846
19976,0.001013,74.125.24.0-255,1484,59312,92,171846
19977,0.001021,74.125.24.0-255,1484,60796,92,171846
19978,0.001025,172.31.47.0-255,66,60862,92,171846
19979,0.001054,74.125.24.0-255,1484,62346,92,171846
19980,0.001059,74.125.24.0-255,2902,65248,92,171846
19981,0.001061,172.31.47.0-255,66,65314,92,171846
19982,0.001067,74.125.24.0-255,4320,69634,92,171846
19983,0.001069,172.31.47.0-255,66,69700,92,171846
19984,0.001085,172.31.47.0-255,66,69766,92,171846
19985,0.001141,172.31.47.0-255,66,69832,92,171846
19986,0.00133,74.125.24.0-255,1484,71316,92,171846
19987,0.001335,74.125.24.0-255,1484,72800,92,171846
19988,0.001339,172.31.47.0-255,66,72866,92,171846
19989,0.001366,74.125.24.0-255,1484,74350,92,171846
19990,0.001373,74.125.24.0-255,5738,80088,92,171846
19991,0.001375,172.31.47.0-255,66,80154,92,171846
19992,0.001382,74.125.24.0-255,7156,87310,92,171846
19993,0.001384,172.31.47.0-255,66,87376,92,171846
19994,0.001403,74.125.24.0-255,5738,93114,92,171846
19995,0.001409,172.31.47.0-255,66,93180,92,171846
19996,0.001426,74.125.24.0-255,4320,97500,92,171846
19997,0.001429,172.31.47.0-255,66,97566,92,171846
19998,0.001457,74.125.24.0-255,6438,104004,92,171846
19999,0.001459,172.31.47.0-255,66,104070,92,171846
20000,0.00147,172.31.47.0-255,66,104136,92,171846
20001,0.00148,74.125.24.0-255,7156,111292,92,171846
20002,0.001483,172.31.47.0-255,66,111358,92,171846
20003,0.001561,172.31.47.0-255,66,111424,92,171846
20004,0.001633,74.125.24.0-255,1484,112908,92,171846
20005,0.001642,74.125.24.0-255,2902,115810,92,171846
20006,0.001644,172.31.47.0-255,66,115876,92,171846
20007,0.001663,74.125.24.0-255,5738,121614,92,171846
20008,0.001665,172.31.47.0-255,66,121680,92,171846
20009,0.001701,172.31.47.0-255,66,121746,92,171846
20010,0.001705,74.125.24.0-255,2902,124648,92,171846
20011,0.001706,172.31.47.0-255,66,124714,92,171846
20012,0.001748,74.125.24.0-255,2902,127616,92,171846
20013,0.001768,74.125.24.0-255,5020,132636,92,171846
20014,0.002134,74.125.24.0-255,1484,134120,92,171846
20015,0.002151,74.125.24.0-255,2902,137022,92,171846
20016,0.002154,74.125.24.0-255,1484,138506,92,171846
20017,0.00217,74.125.24.0-255,4320,142826,92,171846
20018,0.002175,74.125.24.0-255,4320,147146,92,171846
20019,0.002214,74.125.24.0-255,5738,152884,92,171846
20020,0.002267,74.125.24.0-255,1484,154368,92,171846
20021,0.002725,172.31.47.0-255,66,154434,92,171846
20022,0.004954,74.125.24.0-255,5738,160172,92,171846
20023,0.00496,172.31.47.0-255,66,160238,92,171846
20024,0.007176,74.125.24.0-255,5738,165976,92,171846
20025,0.007181,172.31.47.0-255,66,166042,92,171846
20026,0.009404,74.125.24.0-255,5738,171780,92,171846
20027,0.009415,172.31.47.0-255,66,171846,92,171846
20028,0.0,74.125.68.0-255,66,66,92,66
20029,0.0,172.217.194.0-255,153,153,92,198297
20030,2.9e-05,172.31.47.0-255,66,219,92,198297
20031,3.6e-05,172.217.194.0-255,1484,1703,92,198297
20032,3.9e-05,172.31.47.0-255,66,1769,92,198297
20033,4.4e-05,172.217.194.0-255,2902,4671,92,198297
20034,4.6e-05,172.31.47.0-255,66,4737,92,198297
20035,5.2e-05,172.217.194.0-255,7156,11893,92,198297
20036,5.5e-05,172.31.47.0-255,66,11959,92,198297
20037,8.4e-05,172.217.194.0-255,4320,16279,92,198297
20038,8.7e-05,172.31.47.0-255,66,16345,92,198297
20039,0.000115,172.31.47.0-255,66,16411,92,198297
20040,0.000149,172.217.194.0-255,6797,23208,92,198297
20041,0.000154,172.31.47.0-255,66,23274,92,198297
20042,0.000159,172.217.194.0-255,7156,30430,92,198297
20043,0.000161,172.31.47.0-255,66,30496,92,198297
20044,0.00018,172.217.194.0-255,2902,33398,92,198297
20045,0.000182,172.31.47.0-255,66,33464,92,198297
20046,0.000198,172.217.194.0-255,2543,36007,92,198297
20047,0.0002,172.31.47.0-255,66,36073,92,198297
20048,0.000205,172.217.194.0-255,4320,40393,92,198297
20049,0.000207,172.31.47.0-255,66,40459,92,198297
20050,0.000216,172.217.194.0-255,1484,41943,92,198297
20051,0.000217,172.31.47.0-255,66,42009,92,198297
20052,0.000234,172.217.194.0-255,5738,47747,92,198297
20053,0.000236,172.31.47.0-255,66,47813,92,198297
20054,0.000258,172.217.194.0-255,5691,53504,92,198297
20055,0.00026,172.31.47.0-255,66,53570,92,198297
20056,0.00029,172.217.194.0-255,98,53668,92,198297
20057,0.000293,172.31.47.0-255,66,53734,92,198297
20058,0.000325,172.217.194.0-255,364,54098,92,198297
20059,0.000328,172.31.47.0-255,66,54164,92,198297
20060,0.000458,172.217.194.0-255,1484,55648,92,198297
20061,0.000462,172.217.194.0-255,1484,57132,92,198297
20062,0.000467,172.31.47.0-255,66,57198,92,198297
20063,0.00048,172.217.194.0-255,1484,58682,92,198297
20064,0.000486,172.217.194.0-255,5738,64420,92,198297
20065,0.000488,172.217.194.0-255,1484,65904,92,198297
20066,0.000489,172.31.47.0-255,66,65970,92,198297
20067,0.000505,172.217.194.0-255,4320,70290,92,198297
20068,0.000508,172.31.47.0-255,66,70356,92,198297
20069,0.000512,172.217.194.0-255,2902,73258,92,198297
20070,0.000514,172.31.47.0-255,66,73324,92,198297
20071,0.000528,172.217.194.0-255,5738,79062,92,198297
20072,0.00053,172.31.47.0-255,66,79128,92,198297
20073,0.000547,172.217.194.0-255,4320,83448,92,198297
20074,0.000549,172.31.47.0-255,66,83514,92,198297
20075,0.000552,172.217.194.0-255,1484,84998,92,198297
20076,0.000571,172.217.194.0-255,3602,88600,92,198297
20077,0.000573,172.31.47.0-255,66,88666,92,198297
20078,0.000599,172.217.194.0-255,1484,90150,92,198297
20079,0.000611,172.217.194.0-255,2902,93052,92,198297
20080,0.000613,172.31.47.0-255,66,93118,92,198297
20081,0.000627,172.217.194.0-255,5738,98856,92,198297
20082,0.00063,172.31.47.0-255,66,98922,92,198297
20083,0.000663,172.31.47.0-255,66,98988,92,198297
20084,0.000677,172.217.194.0-255,1484,100472,92,198297
20085,0.000695,172.217.194.0-255,4320,104792,92,198297
20086,0.000698,172.31.47.0-255,66,104858,92,198297
20087,0.000724,172.31.47.0-255,66,104924,92,198297
20088,0.000764,172.31.47.0-255,66,104990,92,198297
20089,0.000783,172.217.194.0-255,1484,106474,92,198297
20090,0.000795,172.31.47.0-255,66,106540,92,198297
20091,0.000814,172.217.194.0-255,1484,108024,92,198297
20092,0.000818,172.217.194.0-255,2902,110926,92,198297
20093,0.00082,172.31.47.0-255,66,110992,92,198297
20094,0.000837,172.217.194.0-255,3602,114594,92,198297
20095,0.00084,172.31.47.0-255,66,114660,92,198297
20096,0.000844,172.217.194.0-255,2902,117562,92,198297
20097,0.000847,172.31.47.0-255,66,117628,92,198297
20098,0.000867,172.217.194.0-255,4320,121948,92,198297
20099,0.000869,172.31.47.0-255,66,122014,92,198297
20100,0.000909,172.217.194.0-255,4320,126334,92,198297
20101,0.000913,172.31.47.0-255,66,126400,92,198297
20102,0.000943,172.31.47.0-255,66,126466,92,198297
20103,0.000956,172.31.47.0-255,66,126532,92,198297
20104,0.000969,172.217.194.0-255,1125,127657,92,198297
20105,0.00152,172.217.194.0-255,1484,129141,92,198297
20106,0.001525,172.31.47.0-255,66,129207,92,198297
20107,0.001529,172.217.194.0-255,2902,132109,92,198297
20108,0.001531,172.31.47.0-255,66,132175,92,198297
20109,0.001568,172.217.194.0-255,4320,136495,92,198297
20110,0.001571,172.31.47.0-255,66,136561,92,198297
20111,0.001584,172.217.194.0-255,1484,138045,92,198297
20112,0.001595,172.31.47.0-255,66,138111,92,198297
20113,0.001615,172.31.47.0-255,66,138177,92,198297
20114,0.001631,172.217.194.0-255,2184,140361,92,198297
20115,0.001634,172.31.47.0-255,66,140427,92,198297
20116,0.001814,172.217.194.0-255,1484,141911,92,198297
20117,0.00182,172.217.194.0-255,2902,144813,92,198297
20118,0.001822,172.31.47.0-255,66,144879,92,198297
20119,0.001829,172.217.194.0-255,5738,150617,92,198297
20120,0.001831,172.31.47.0-255,66,150683,92,198297
20121,0.001853,172.217.194.0-255,5738,156421,92,198297
20122,0.001856,172.31.47.0-255,66,156487,92,198297
20123,0.001881,172.217.194.0-255,7156,163643,92,198297
20124,0.001884,172.31.47.0-255,66,163709,92,198297
20125,0.001892,172.217.194.0-255,7156,170865,92,198297
20126,0.001894,172.31.47.0-255,66,170931,92,198297
20127,0.001915,172.217.194.0-255,2902,173833,92,198297
20128,0.001918,172.31.47.0-255,66,173899,92,198297
20129,0.001938,172.31.47.0-255,66,173965,92,198297
20130,0.001974,172.31.47.0-255,66,174031,92,198297
20131,0.002025,172.217.194.0-255,5738,179769,92,198297
20132,0.002029,172.31.47.0-255,66,179835,92,198297
20133,0.002049,172.217.194.0-255,3602,183437,92,198297
20134,0.002052,172.31.47.0-255,66,183503,92,198297
20135,0.002056,172.217.194.0-255,2902,186405,92,198297
20136,0.002058,172.31.47.0-255,66,186471,92,198297
20137,0.002088,172.31.47.0-255,66,186537,92,198297
20138,0.002111,172.31.47.0-255,66,186603,92,198297
20139,0.002156,172.217.194.0-255,1484,188087,92,198297
20140,0.002178,172.31.47.0-255,66,188153,92,198297
20141,0.002218,172.31.47.0-255,66,188219,92,198297
20142,0.002297,172.217.194.0-255,5020,193239,92,198297
20143,0.0023,172.31.47.0-255,66,193305,92,198297
20144,0.00233,172.31.47.0-255,66,193371,92,198297
20145,0.002394,172.31.47.0-255,66,193437,92,198297
20146,0.00241,172.31.47.0-255,66,193503,92,198297
20147,0.002484,172.217.194.0-255,4320,197823,92,198297
20148,0.002487,172.31.47.0-255,66,197889,92,198297
20149,0.002512,172.31.47.0-255,66,197955,92,198297
20150,0.002514,172.217.194.0-255,105,198060,92,198297
20151,0.003365,172.31.47.0-255,66,198126,92,198297
20152,0.003388,172.31.47.0-255,105,198231,92,198297
20153,0.005937,172.217.194.0-255,66,198297,92,198297
20154,0.0,172.253.118.0-255,153,153,92,184996
20155,1.7e-05,172.31.47.0-255,66,219,92,184996
20156,2.4e-05,172.253.118.0-255,1484,1703,92,184996
20157,2.9e-05,172.31.47.0-255,66,1769,92,184996
20158,3.5e-05,172.253.118.0-255,2902,4671,92,184996
20159,4.5e-05,172.31.47.0-255,66,4737,92,184996
20160,5.3e-05,172.253.118.0-255,7156,11893,92,184996
20161,5.7e-05,172.31.47.0-255,66,11959,92,184996
20162,6.1e-05,172.253.118.0-255,2066,14025,92,184996
20163,6.3e-05,172.31.47.0-255,66,14091,92,184996
20164,7.1e-05,172.253.118.0-255,7156,21247,92,184996
20165,7.4e-05,172.31.47.0-255,66,21313,92,184996
20166,9.8e-05,172.253.118.0-255,4320,25633,92,184996
20167,0.000105,172.31.47.0-255,66,25699,92,184996
20168,0.000111,172.253.118.0-255,5379,31078,92,184996
20169,0.000114,172.31.47.0-255,66,31144,92,184996
20170,0.00017,172.253.118.0-255,1484,32628,92,184996
20171,0.000173,172.31.47.0-255,66,32694,92,184996
20172,0.000177,172.253.118.0-255,1484,34178,92,184996
20173,0.000179,172.31.47.0-255,66,34244,92,184996
20174,0.000211,172.253.118.0-255,1484,35728,92,184996
20175,0.000214,172.31.47.0-255,66,35794,92,184996
20176,0.000221,172.253.118.0-255,5738,41532,92,184996
20177,0.000224,172.31.47.0-255,66,41598,92,184996
20178,0.00025,172.253.118.0-255,6797,48395,92,184996
20179,0.000253,172.31.47.0-255,66,48461,92,184996
20180,0.000521,172.253.118.0-255,1484,49945,92,184996
20181,0.000527,172.31.47.0-255,66,50011,92,184996
20182,0.000534,172.253.118.0-255,2902,52913,92,184996
20183,0.000536,172.31.47.0-255,66,52979,92,184996
20184,0.000542,172.253.118.0-255,5738,58717,92,184996
20185,0.000551,172.31.47.0-255,66,58783,92,184996
20186,0.000595,172.31.47.0-255,66,58849,92,184996
20187,0.000618,172.253.118.0-255,7156,66005,92,184996
20188,0.000621,172.31.47.0-255,66,66071,92,184996
20189,0.000646,172.253.118.0-255,3122,69193,92,184996
20190,0.000648,172.31.47.0-255,66,69259,92,184996
20191,0.000743,172.253.118.0-255,1484,70743,92,184996
20192,0.000748,172.253.118.0-255,1484,72227,92,184996
20193,0.000751,172.31.47.0-255,66,72293,92,184996
20194,0.000777,172.253.118.0-255,1484,73777,92,184996
20195,0.000785,172.253.118.0-255,5738,79515,92,184996
20196,0.000788,172.31.47.0-255,66,79581,92,184996
20197,0.000796,172.253.118.0-255,7156,86737,92,184996
20198,0.000798,172.31.47.0-255,66,86803,92,184996
20199,0.000819,172.253.118.0-255,5738,92541,92,184996
20200,0.000822,172.31.47.0-255,66,92607,92,184996
20201,0.000833,172.253.118.0-255,7156,99763,92,184996
20202,0.000835,172.31.47.0-255,66,99829,92,184996
20203,0.000874,172.253.118.0-255,2939,102768,92,184996
20204,0.000879,172.31.47.0-255,66,102834,92,184996
20205,0.000944,172.253.118.0-255,1484,104318,92,184996
20206,0.000959,172.253.118.0-255,2902,107220,92,184996
20207,0.000962,172.31.47.0-255,66,107286,92,184996
20208,0.000967,172.253.118.0-255,2902,110188,92,184996
20209,0.00097,172.31.47.0-255,66,110254,92,184996
20210,0.001001,172.253.118.0-255,2902,113156,92,184996
20211,0.001003,172.31.47.0-255,66,113222,92,184996
20212,0.001022,172.31.47.0-255,66,113288,92,184996
20213,0.001027,172.253.118.0-255,4320,117608,92,184996
20214,0.00103,172.31.47.0-255,66,117674,92,184996
20215,0.001076,172.253.118.0-255,6438,124112,92,184996
20216,0.001079,172.31.47.0-255,66,124178,92,184996
20217,0.001087,172.253.118.0-255,7156,131334,92,184996
20218,0.001089,172.31.47.0-255,66,131400,92,184996
20219,0.00116,172.31.47.0-255,66,131466,92,184996
20220,0.001675,172.253.118.0-255,1484,132950,92,184996
20221,0.0017,172.253.118.0-255,2902,135852,92,184996
20222,0.001704,172.31.47.0-255,66,135918,92,184996
20223,0.001708,172.253.118.0-255,1484,137402,92,184996
20224,0.001732,172.253.118.0-255,4320,141722,92,184996
20225,0.001735,172.31.47.0-255,66,141788,92,184996
20226,0.001743,172.253.118.0-255,7156,148944,92,184996
20227,0.001745,172.31.47.0-255,66,149010,92,184996
20228,0.001782,172.31.47.0-255,66,149076,92,184996
20229,0.001812,172.253.118.0-255,3602,152678,92,184996
20230,0.001815,172.31.47.0-255,66,152744,92,184996
20231,0.00199,172.253.118.0-255,1484,154228,92,184996
20232,0.001997,172.253.118.0-255,2902,157130,92,184996
20233,0.002,172.31.47.0-255,66,157196,92,184996
20234,0.002007,172.253.118.0-255,5738,162934,92,184996
20235,0.002009,172.31.47.0-255,66,163000,92,184996
20236,0.002018,172.253.118.0-255,2902,165902,92,184996
20237,0.002021,172.31.47.0-255,66,165968,92,184996
20238,0.002065,172.31.47.0-255,66,166034,92,184996
20239,0.002069,172.253.118.0-255,1484,167518,92,184996
20240,0.002102,172.31.47.0-255,66,167584,92,184996
20241,0.004438,172.253.118.0-255,5738,173322,92,184996
20242,0.004445,172.31.47.0-255,66,173388,92,184996
20243,0.006781,172.253.118.0-255,5738,179126,92,184996
20244,0.006785,172.31.47.0-255,66,179192,92,184996
20245,0.009112,172.253.118.0-255,5738,184930,92,184996
20246,0.009118,172.31.47.0-255,66,184996,92,184996
20247,0.0,172.31.47.0-255,105,105,92,276
20248,0.001754,157.240.7.0-255,105,210,92,276
20249,0.001766,172.31.47.0-255,66,276,92,276
20250,0.0,31.13.82.0-255,105,105,92,171
20251,1.5e-05,172.31.47.0-255,66,171,92,171
20252,0.0,74.125.200.0-255,298,298,92,236522
20253,2.4e-05,172.31.47.0-255,66,364,92,236522
20254,3e-05,74.125.200.0-255,1484,1848,92,236522
20255,3.4e-05,172.31.47.0-255,66,1914,92,236522
20256,3.8e-05,74.125.200.0-255,2902,4816,92,236522
20257,4e-05,172.31.47.0-255,66,4882,92,236522
20258,6.6e-05,74.125.200.0-255,5738,10620,92,236522
20259,6.8e-05,172.31.47.0-255,66,10686,92,236522
20260,8.5e-05,74.125.200.0-255,1484,12170,92,236522
20261,8.6e-05,172.31.47.0-255,66,12236,92,236522
20262,0.000112,172.31.47.0-255,66,12302,92,236522
20263,0.000128,74.125.200.0-255,5738,18040,92,236522
20264,0.00013,172.31.47.0-255,66,18106,92,236522
20265,0.000146,74.125.200.0-255,4320,22426,92,236522
20266,0.000148,172.31.47.0-255,66,22492,92,236522
20267,0.000151,74.125.200.0-255,1125,23617,92,236522
20268,0.000152,172.31.47.0-255,66,23683,92,236522
20269,0.000184,74.125.200.0-255,1484,25167,92,236522
20270,0.000187,172.31.47.0-255,66,25233,92,236522
20271,0.000199,74.125.200.0-255,2902,28135,92,236522
20272,0.000201,172.31.47.0-255,66,28201,92,236522
20273,0.000204,74.125.200.0-255,1484,29685,92,236522
20274,0.000205,172.31.47.0-255,66,29751,92,236522
20275,0.000231,74.125.200.0-255,4320,34071,92,236522
20276,0.000233,172.31.47.0-255,66,34137,92,236522
20277,0.000238,74.125.200.0-255,4320,38457,92,236522
20278,0.00024,172.31.47.0-255,66,38523,92,236522
20279,0.000273,74.125.200.0-255,2543,41066,92,236522
20280,0.000276,172.31.47.0-255,66,41132,92,236522
20281,0.000472,74.125.200.0-255,1484,42616,92,236522
20282,0.000477,172.31.47.0-255,66,42682,92,236522
20283,0.00048,74.125.200.0-255,1484,44166,92,236522
20284,0.000482,172.31.47.0-255,66,44232,92,236522
20285,0.000497,74.125.200.0-255,2902,47134,92,236522
20286,0.000499,172.31.47.0-255,66,47200,92,236522
20287,0.000502,74.125.200.0-255,1484,48684,92,236522
20288,0.000504,172.31.47.0-255,66,48750,92,236522
20289,0.000525,74.125.200.0-255,4320,53070,92,236522
20290,0.000528,172.31.47.0-255,66,53136,92,236522
20291,0.000532,74.125.200.0-255,2902,56038,92,236522
20292,0.000534,172.31.47.0-255,66,56104,92,236522
20293,0.000546,74.125.200.0-255,2543,58647,92,236522
20294,0.000548,172.31.47.0-255,66,58713,92,236522
20295,0.000633,74.125.200.0-255,1484,60197,92,236522
20296,0.000636,172.31.47.0-255,66,60263,92,236522
20297,0.00065,74.125.200.0-255,2902,63165,92,236522
20298,0.000652,172.31.47.0-255,66,63231,92,236522
20299,0.000676,74.125.200.0-255,5738,68969,92,236522
20300,0.000679,172.31.47.0-255,66,69035,92,236522
20301,0.000698,74.125.200.0-255,6797,75832,92,236522
20302,0.0007,172.31.47.0-255,66,75898,92,236522
20303,0.000703,74.125.200.0-255,1484,77382,92,236522
20304,0.000705,172.31.47.0-255,66,77448,92,236522
20305,0.000729,74.125.200.0-255,5738,83186,92,236522
20306,0.000732,172.31.47.0-255,66,83252,92,236522
20307,0.000734,74.125.200.0-255,1484,84736,92,236522
20308,0.000736,172.31.47.0-255,66,84802,92,236522
20309,0.000753,74.125.200.0-255,7156,91958,92,236522
20310,0.000755,172.31.47.0-255,66,92024,92,236522
20311,0.000766,74.125.200.0-255,2902,94926,92,236522
20312,0.000769,172.31.47.0-255,66,94992,92,236522
20313,0.000771,74.125.200.0-255,1484,96476,92,236522
20314,0.000792,172.31.47.0-255,66,96542,92,236522
20315,0.000796,74.125.200.0-255,2170,98712,92,236522
20316,0.0008,172.31.47.0-255,66,98778,92,236522
20317,0.000926,74.125.200.0-255,1484,100262,92,236522
20318,0.000939,74.125.200.0-255,2902,103164,92,236522
20319,0.000941,172.31.47.0-255,66,103230,92,236522
20320,0.000945,74.125.200.0-255,1484,104714,92,236522
20321,0.000962,74.125.200.0-255,4320,109034,92,236522
20322,0.000965,172.31.47.0-255,66,109100,92,236522
20323,0.000981,74.125.200.0-255,1484,110584,92,236522
20324,0.000992,74.125.200.0-255,2902,113486,92,236522
20325,0.000995,172.31.47.0-255,66,113552,92,236522
20326,0.001036,74.125.200.0-255,5738,119290,92,236522
20327,0.00104,172.31.47.0-255,66,119356,92,236522
20328,0.001064,74.125.200.0-255,2902,122258,92,236522
20329,0.001066,172.31.47.0-255,66,122324,92,236522
20330,0.001071,74.125.200.0-255,4320,126644,92,236522
20331,0.001074,172.31.47.0-255,66,126710,92,236522
20332,0.00108,74.125.200.0-255,6438,133148,92,236522
20333,0.001083,172.31.47.0-255,66,133214,92,236522
20334,0.001121,74.125.200.0-255,1484,134698,92,236522
20335,0.001126,74.125.200.0-255,2902,137600,92,236522
20336,0.001128,172.31.47.0-255,66,137666,92,236522
20337,0.001146,74.125.200.0-255,1484,139150,92,236522
20338,0.00115,74.125.200.0-255,2902,142052,92,236522
20339,0.001152,172.31.47.0-255,66,142118,92,236522
20340,0.001171,74.125.200.0-255,5738,147856,92,236522
20341,0.001175,172.31.47.0-255,66,147922,92,236522
20342,0.001199,74.125.200.0-255,1484,149406,92,236522
20343,0.001215,74.125.200.0-255,5738,155144,92,236522
20344,0.001219,172.31.47.0-255,66,155210,92,236522
20345,0.001238,74.125.200.0-255,5738,160948,92,236522
20346,0.001241,172.31.47.0-255,66,161014,92,236522
20347,0.001264,74.125.200.0-255,6438,167452,92,236522
20348,0.001266,172.31.47.0-255,66,167518,92,236522
20349,0.001525,74.125.200.0-255,1484,169002,92,236522
20350,0.001544,74.125.200.0-255,2902,171904,92,236522
20351,0.001548,172.31.47.0-255,66,171970,92,236522
20352,0.001552,74.125.200.0-255,1484,173454,92,236522
20353,0.001556,74.125.200.0-255,2902,176356,92,236522
20354,0.001558,172.31.47.0-255,66,176422,92,236522
20355,0.001584,74.125.200.0-255,5738,182160,92,236522
20356,0.001587,172.31.47.0-255,66,182226,92,236522
20357,0.001614,172.31.47.0-255,66,182292,92,236522
20358,0.001629,74.125.200.0-255,4320,186612,92,236522
20359,0.001632,172.31.47.0-255,66,186678,92,236522
20360,0.001668,74.125.200.0-255,6438,193116,92,236522
20361,0.001672,172.31.47.0-255,66,193182,92,236522
20362,0.001737,74.125.200.0-255,1484,194666,92,236522
20363,0.001756,74.125.200.0-255,1484,196150,92,236522
20364,0.00176,172.31.47.0-255,66,196216,92,236522
20365,0.001771,74.125.200.0-255,1484,197700,92,236522
20366,0.001788,74.125.200.0-255,1484,199184,92,236522
20367,0.001791,172.31.47.0-255,66,199250,92,236522
20368,0.001798,74.125.200.0-255,5738,204988,92,236522
20369,0.001801,172.31.47.0-255,66,205054,92,236522
20370,0.001804,74.125.200.0-255,2902,207956,92,236522
20371,0.001806,172.31.47.0-255,66,208022,92,236522
20372,0.00184,172.31.47.0-255,66,208088,92,236522
20373,0.001845,74.125.200.0-255,1484,209572,92,236522
20374,0.001866,74.125.200.0-255,5738,215310,92,236522
20375,0.001869,172.31.47.0-255,66,215376,92,236522
20376,0.001888,74.125.200.0-255,3602,218978,92,236522
20377,0.00189,172.31.47.0-255,66,219044,92,236522
20378,0.004155,74.125.200.0-255,1484,220528,92,236522
20379,0.004183,74.125.200.0-255,4320,224848,92,236522
20380,0.004188,172.31.47.0-255,66,224914,92,236522
20381,0.00649,74.125.200.0-255,5738,230652,92,236522
20382,0.006497,172.31.47.0-255,66,230718,92,236522
20383,0.0088,74.125.200.0-255,5738,236456,92,236522
20384,0.008806,172.31.47.0-255,66,236522,92,236522
20385,0.0,74.125.200.0-255,153,153,92,286822
20386,2.5e-05,172.31.47.0-255,66,219,92,286822
20387,3.1e-05,74.125.200.0-255,1484,1703,92,286822
20388,3.5e-05,172.31.47.0-255,66,1769,92,286822
20389,5.7e-05,74.125.200.0-255,1484,3253,92,286822
20390,5.8e-05,172.31.47.0-255,66,3319,92,286822
20391,7.9e-05,74.125.200.0-255,1484,4803,92,286822
20392,8.1e-05,172.31.47.0-255,66,4869,92,286822
20393,8.7e-05,74.125.200.0-255,5738,10607,92,286822
20394,9e-05,172.31.47.0-255,66,10673,92,286822
20395,0.000118,74.125.200.0-255,2902,13575,92,286822
20396,0.000121,172.31.47.0-255,66,13641,92,286822
20397,0.000131,74.125.200.0-255,623,14264,92,286822
20398,0.000137,172.31.47.0-255,66,14330,92,286822
20399,0.00021,74.125.200.0-255,1484,15814,92,286822
20400,0.000212,172.31.47.0-255,66,15880,92,286822
20401,0.000249,74.125.200.0-255,2902,18782,92,286822
20402,0.000253,172.31.47.0-255,66,18848,92,286822
20403,0.000277,74.125.200.0-255,4320,23168,92,286822
20404,0.000281,172.31.47.0-255,66,23234,92,286822
20405,0.000284,74.125.200.0-255,2902,26136,92,286822
20406,0.000286,172.31.47.0-255,66,26202,92,286822
20407,0.000313,74.125.200.0-255,4320,30522,92,286822
20408,0.000317,172.31.47.0-255,66,30588,92,286822
20409,0.000344,74.125.200.0-255,2543,33131,92,286822
20410,0.000347,172.31.47.0-255,66,33197,92,286822
20411,0.00035,74.125.200.0-255,2902,36099,92,286822
20412,0.000352,172.31.47.0-255,66,36165,92,286822
20413,0.000372,74.125.200.0-255,7156,43321,92,286822
20414,0.000375,172.31.47.0-255,66,43387,92,286822
20415,0.000404,172.31.47.0-255,66,43453,92,286822
20416,0.000436,74.125.200.0-255,1484,44937,92,286822
20417,0.00044,172.31.47.0-255,66,45003,92,286822
20418,0.000448,74.125.200.0-255,2184,47187,92,286822
20419,0.000453,172.31.47.0-255,66,47253,92,286822
20420,0.000466,74.125.200.0-255,396,47649,92,286822
20421,0.000515,74.125.200.0-255,347,47996,92,286822
20422,0.000691,172.31.47.0-255,66,48062,92,286822
20423,0.000806,74.125.200.0-255,1484,49546,92,286822
20424,0.000811,172.31.47.0-255,66,49612,92,286822
20425,0.000819,74.125.200.0-255,2902,52514,92,286822
20426,0.000838,74.125.200.0-255,2902,55416,92,286822
20427,0.000851,74.125.200.0-255,2902,58318,92,286822
20428,0.000855,74.125.200.0-255,2902,61220,92,286822
20429,0.000874,74.125.200.0-255,4320,65540,92,286822
20430,0.000899,74.125.200.0-255,5738,71278,92,286822
20431,0.000913,74.125.200.0-255,2902,74180,92,286822
20432,0.000956,74.125.200.0-255,2902,77082,92,286822
20433,0.000979,74.125.200.0-255,5738,82820,92,286822
20434,0.000983,74.125.200.0-255,2902,85722,92,286822
20435,0.000988,74.125.200.0-255,7156,92878,92,286822
20436,0.001012,74.125.200.0-255,5738,98616,92,286822
20437,0.001016,74.125.200.0-255,2902,101518,92,286822
20438,0.00103,74.125.200.0-255,4320,105838,92,286822
20439,0.001049,74.125.200.0-255,1484,107322,92,286822
20440,0.001061,74.125.200.0-255,5738,113060,92,286822
20441,0.001096,74.125.200.0-255,2902,115962,92,286822
20442,0.001109,74.125.200.0-255,4320,120282,92,286822
20443,0.001111,74.125.200.0-255,1484,121766,92,286822
20444,0.001115,74.125.200.0-255,2902,124668,92,286822
20445,0.001133,74.125.200.0-255,5738,130406,92,286822
20446,0.001148,74.125.200.0-255,2184,132590,92,286822
20447,0.001197,74.125.200.0-255,1484,134074,92,286822
20448,0.001211,74.125.200.0-255,2902,136976,92,286822
20449,0.00124,74.125.200.0-255,5738,142714,92,286822
20450,0.001262,74.125.200.0-255,7156,149870,92,286822
20451,0.001273,74.125.200.0-255,2902,152772,92,286822
20452,0.001276,74.125.200.0-255,2902,155674,92,286822
20453,0.001303,74.125.200.0-255,1484,157158,92,286822
20454,0.001313,74.125.200.0-255,766,157924,92,286822
20455,0.00156,74.125.200.0-255,1484,159408,92,286822
20456,0.001572,74.125.200.0-255,2902,162310,92,286822
20457,0.001586,74.125.200.0-255,2902,165212,92,286822
20458,0.0016,74.125.200.0-255,2902,168114,92,286822
20459,0.001625,74.125.200.0-255,2902,171016,92,286822
20460,0.001645,74.125.200.0-255,2902,173918,92,286822
20461,0.00165,74.125.200.0-255,7156,181074,92,286822
20462,0.001716,74.125.200.0-255,1484,182558,92,286822
20463,0.001726,74.125.200.0-255,1484,184042,92,286822
20464,0.001736,74.125.200.0-255,1484,185526,92,286822
20465,0.001761,74.125.200.0-255,1484,187010,92,286822
20466,0.001776,74.125.200.0-255,2902,189912,92,286822
20467,0.001784,74.125.200.0-255,1484,191396,92,286822
20468,0.001797,74.125.200.0-255,4320,195716,92,286822
20469,0.001827,74.125.200.0-255,4320,200036,92,286822
20470,0.001843,74.125.200.0-255,5738,205774,92,286822
20471,0.001866,74.125.200.0-255,2902,208676,92,286822
20472,0.001886,74.125.200.0-255,6438,215114,92,286822
20473,0.001923,74.125.200.0-255,1484,216598,92,286822
20474,0.001965,74.125.200.0-255,2902,219500,92,286822
20475,0.001971,74.125.200.0-255,5738,225238,92,286822
20476,0.001975,74.125.200.0-255,2902,228140,92,286822
20477,0.001977,74.125.200.0-255,1484,229624,92,286822
20478,0.001991,74.125.200.0-255,2902,232526,92,286822
20479,0.002008,74.125.200.0-255,4320,236846,92,286822
20480,0.002019,74.125.200.0-255,4320,241166,92,286822
20481,0.002025,74.125.200.0-255,5738,246904,92,286822
20482,0.002069,74.125.200.0-255,2184,249088,92,286822
20483,0.002158,172.31.47.0-255,66,249154,92,286822
20484,0.002302,74.125.200.0-255,1484,250638,92,286822
20485,0.002321,74.125.200.0-255,2902,253540,92,286822
20486,0.002335,172.31.47.0-255,66,253606,92,286822
20487,0.002346,74.125.200.0-255,4320,257926,92,286822
20488,0.00235,172.31.47.0-255,66,257992,92,286822
20489,0.002374,74.125.200.0-255,4320,262312,92,286822
20490,0.002379,172.31.47.0-255,66,262378,92,286822
20491,0.002406,74.125.200.0-255,4320,266698,92,286822
20492,0.002417,172.31.47.0-255,66,266764,92,286822
20493,0.002422,172.31.47.0-255,66,266830,92,286822
20494,0.002448,74.125.200.0-255,5738,272568,92,286822
20495,0.002451,74.125.200.0-255,766,273334,92,286822
20496,0.002452,172.31.47.0-255,66,273400,92,286822
20497,0.002585,74.125.200.0-255,1484,274884,92,286822
20498,0.002593,172.31.47.0-255,66,274950,92,286822
20499,0.005002,74.125.200.0-255,2902,277852,92,286822
20500,0.005009,172.31.47.0-255,66,277918,92,286822
20501,0.005141,74.125.200.0-255,2902,280820,92,286822
20502,0.005157,172.31.47.0-255,66,280886,92,286822
20503,0.007558,74.125.200.0-255,2902,283788,92,286822
20504,0.007565,172.31.47.0-255,66,283854,92,286822
20505,0.007712,74.125.200.0-255,2902,286756,92,286822
20506,0.007716,172.31.47.0-255,66,286822,92,286822
20507,0.0,172.217.194.0-255,153,153,92,222813
20508,3.1e-05,172.31.47.0-255,66,219,92,222813
20509,3.7e-05,172.217.194.0-255,1484,1703,92,222813
20510,4.1e-05,172.31.47.0-255,66,1769,92,222813
20511,4.5e-05,172.217.194.0-255,2902,4671,92,222813
20512,4.8e-05,172.31.47.0-255,66,4737,92,222813
20513,5.6e-05,172.217.194.0-255,7156,11893,92,222813
20514,5.9e-05,172.31.47.0-255,66,11959,92,222813
20515,6.2e-05,172.217.194.0-255,1978,13937,92,222813
20516,6.4e-05,172.31.47.0-255,66,14003,92,222813
20517,9.8e-05,172.217.194.0-255,1484,15487,92,222813
20518,0.0001,172.31.47.0-255,66,15553,92,222813
20519,0.000106,172.217.194.0-255,2902,18455,92,222813
20520,0.000109,172.31.47.0-255,66,18521,92,222813
20521,0.000115,172.217.194.0-255,4320,22841,92,222813
20522,0.000117,172.31.47.0-255,66,22907,92,222813
20523,0.000133,172.217.194.0-255,1484,24391,92,222813
20524,0.000136,172.31.47.0-255,66,24457,92,222813
20525,0.000171,172.31.47.0-255,66,24523,92,222813
20526,0.000227,172.217.194.0-255,5738,30261,92,222813
20527,0.000231,172.31.47.0-255,66,30327,92,222813
20528,0.000249,172.217.194.0-255,3961,34288,92,222813
20529,0.000251,172.31.47.0-255,66,34354,92,222813
20530,0.000389,172.217.194.0-255,1484,35838,92,222813
20531,0.000393,172.31.47.0-255,66,35904,92,222813
20532,0.000408,172.217.194.0-255,2902,38806,92,222813
20533,0.000411,172.31.47.0-255,66,38872,92,222813
20534,0.000436,172.217.194.0-255,4320,43192,92,222813
20535,0.000438,172.31.47.0-255,66,43258,92,222813
20536,0.000456,172.217.194.0-255,1484,44742,92,222813
20537,0.000459,172.31.47.0-255,66,44808,92,222813
20538,0.000471,172.31.47.0-255,66,44874,92,222813
20539,0.000514,172.217.194.0-255,1484,46358,92,222813
20540,0.000517,172.31.47.0-255,66,46424,92,222813
20541,0.000541,172.31.47.0-255,66,46490,92,222813
20542,0.00056,172.217.194.0-255,2765,49255,92,222813
20543,0.000562,172.31.47.0-255,66,49321,92,222813
20544,0.000803,172.217.194.0-255,1484,50805,92,222813
20545,0.000808,172.217.194.0-255,2902,53707,92,222813
20546,0.000811,172.31.47.0-255,66,53773,92,222813
20547,0.000832,172.217.194.0-255,5738,59511,92,222813
20548,0.000835,172.31.47.0-255,66,59577,92,222813
20549,0.000856,172.217.194.0-255,7156,66733,92,222813
20550,0.00086,172.31.47.0-255,66,66799,92,222813
20551,0.000875,172.217.194.0-255,5738,72537,92,222813
20552,0.000878,172.31.47.0-255,66,72603,92,222813
20553,0.000883,172.217.194.0-255,4320,76923,92,222813
20554,0.000885,172.31.47.0-255,66,76989,92,222813
20555,0.000914,172.217.194.0-255,6438,83427,92,222813
20556,0.000918,172.31.47.0-255,66,83493,92,222813
20557,0.000963,172.217.194.0-255,1484,84977,92,222813
20558,0.000966,172.217.194.0-255,1484,86461,92,222813
20559,0.00097,172.31.47.0-255,66,86527,92,222813
20560,0.000983,172.217.194.0-255,1484,88011,92,222813
20561,0.00099,172.217.194.0-255,5738,93749,92,222813
20562,0.000992,172.31.47.0-255,66,93815,92,222813
20563,0.001022,172.31.47.0-255,66,93881,92,222813
20564,0.001042,172.217.194.0-255,1484,95365,92,222813
20565,0.001054,172.31.47.0-255,66,95431,92,222813
20566,0.001208,172.217.194.0-255,1484,96915,92,222813
20567,0.001213,172.217.194.0-255,2902,99817,92,222813
20568,0.001217,172.31.47.0-255,66,99883,92,222813
20569,0.001239,172.217.194.0-255,5738,105621,92,222813
20570,0.001243,172.31.47.0-255,66,105687,92,222813
20571,0.001271,172.31.47.0-255,66,105753,92,222813
20572,0.001277,172.217.194.0-255,4320,110073,92,222813
20573,0.001279,172.31.47.0-255,66,110139,92,222813
20574,0.001309,172.217.194.0-255,6438,116577,92,222813
20575,0.001312,172.31.47.0-255,66,116643,92,222813
20576,0.001319,172.217.194.0-255,5738,122381,92,222813
20577,0.001321,172.31.47.0-255,66,122447,92,222813
20578,0.001352,172.217.194.0-255,5738,128185,92,222813
20579,0.001355,172.31.47.0-255,66,128251,92,222813
20580,0.001366,172.31.47.0-255,66,128317,92,222813
20581,0.00138,172.217.194.0-255,4320,132637,92,222813
20582,0.001382,172.31.47.0-255,66,132703,92,222813
20583,0.001411,172.31.47.0-255,66,132769,92,222813
20584,0.001601,172.217.194.0-255,1484,134253,92,222813
20585,0.001622,172.217.194.0-255,2902,137155,92,222813
20586,0.001626,172.31.47.0-255,66,137221,92,222813
20587,0.001635,172.217.194.0-255,5738,142959,92,222813
20588,0.001637,172.31.47.0-255,66,143025,92,222813
20589,0.001678,172.217.194.0-255,1484,144509,92,222813
20590,0.001712,172.31.47.0-255,66,144575,92,222813
20591,0.001725,172.31.47.0-255,66,144641,92,222813
20592,0.001837,172.217.194.0-255,1484,146125,92,222813
20593,0.001851,172.217.194.0-255,1484,147609,92,222813
20594,0.001856,172.31.47.0-255,66,147675,92,222813
20595,0.001873,172.217.194.0-255,1484,149159,92,222813
20596,0.001886,172.217.194.0-255,1484,150643,92,222813
20597,0.001889,172.31.47.0-255,66,150709,92,222813
20598,0.001907,172.217.194.0-255,4320,155029,92,222813
20599,0.001909,172.31.47.0-255,66,155095,92,222813
20600,0.00192,172.31.47.0-255,66,155161,92,222813
20601,0.001943,172.217.194.0-255,2902,158063,92,222813
20602,0.001945,172.31.47.0-255,66,158129,92,222813
20603,0.001956,172.31.47.0-255,66,158195,92,222813
20604,0.001987,172.217.194.0-255,1484,159679,92,222813
20605,0.002008,172.217.194.0-255,2902,162581,92,222813
20606,0.00201,172.31.47.0-255,66,162647,92,222813
20607,0.002013,172.217.194.0-255,1484,164131,92,222813
20608,0.00203,172.217.194.0-255,4320,168451,92,222813
20609,0.002033,172.31.47.0-255,66,168517,92,222813
20610,0.002068,172.31.47.0-255,66,168583,92,222813
20611,0.002078,172.31.47.0-255,66,168649,92,222813
20612,0.002102,172.217.194.0-255,2184,170833,92,222813
20613,0.002105,172.31.47.0-255,66,170899,92,222813
20614,0.00214,172.217.194.0-255,1484,172383,92,222813
20615,0.002152,172.217.194.0-255,2902,175285,92,222813
20616,0.002155,172.31.47.0-255,66,175351,92,222813
20617,0.002177,172.217.194.0-255,1484,176835,92,222813
20618,0.002199,172.217.194.0-255,4320,181155,92,222813
20619,0.002202,172.31.47.0-255,66,181221,92,222813
20620,0.002214,172.31.47.0-255,66,181287,92,222813
20621,0.002219,172.217.194.0-255,4320,185607,92,222813
20622,0.002221,172.31.47.0-255,66,185673,92,222813
20623,0.002241,172.217.194.0-255,6438,192111,92,222813
20624,0.002243,172.31.47.0-255,66,192177,92,222813
20625,0.002282,172.217.194.0-255,7156,199333,92,222813
20626,0.002284,172.31.47.0-255,66,199399,92,222813
20627,0.002305,172.217.194.0-255,4320,203719,92,222813
20628,0.002307,172.31.47.0-255,66,203785,92,222813
20629,0.00231,172.217.194.0-255,2902,206687,92,222813
20630,0.002311,172.31.47.0-255,66,206753,92,222813
20631,0.00456,172.217.194.0-255,4320,211073,92,222813
20632,0.004563,172.31.47.0-255,66,211139,92,222813
20633,0.004577,172.217.194.0-255,1484,212623,92,222813
20634,0.006832,172.217.194.0-255,4320,216943,92,222813
20635,0.006839,172.31.47.0-255,66,217009,92,222813
20636,0.009072,172.217.194.0-255,5738,222747,92,222813
20637,0.009078,172.31.47.0-255,66,222813,92,222813
20638,0.0,172.217.194.0-255,152,152,92,185411
20639,1.6e-05,172.31.47.0-255,66,218,92,185411
20640,2.3e-05,172.217.194.0-255,1484,1702,92,185411
20641,2.8e-05,172.31.47.0-255,66,1768,92,185411
20642,3.3e-05,172.217.194.0-255,2902,4670,92,185411
20643,4.6e-05,172.31.47.0-255,66,4736,92,185411
20644,5.3e-05,172.217.194.0-255,5738,10474,92,185411
20645,5.7e-05,172.31.47.0-255,66,10540,92,185411
20646,8.3e-05,172.217.194.0-255,1484,12024,92,185411
20647,8.5e-05,172.31.47.0-255,66,12090,92,185411
20648,9.9e-05,172.31.47.0-255,66,12156,92,185411
20649,0.000128,172.217.194.0-255,6797,18953,92,185411
20650,0.000131,172.31.47.0-255,66,19019,92,185411
20651,0.000375,172.217.194.0-255,1484,20503,92,185411
20652,0.00038,172.31.47.0-255,66,20569,92,185411
20653,0.000386,172.217.194.0-255,2902,23471,92,185411
20654,0.000388,172.31.47.0-255,66,23537,92,185411
20655,0.000424,172.217.194.0-255,5738,29275,92,185411
20656,0.000426,172.217.194.0-255,1484,30759,92,185411
20657,0.000428,172.31.47.0-255,66,30825,92,185411
20658,0.000431,172.31.47.0-255,66,30891,92,185411
20659,0.000471,172.31.47.0-255,66,30957,92,185411
20660,0.000483,172.31.47.0-255,66,31023,92,185411
20661,0.000486,172.217.194.0-255,676,31699,92,185411
20662,0.000487,172.31.47.0-255,66,31765,92,185411
20663,0.000755,172.217.194.0-255,1484,33249,92,185411
20664,0.000759,172.31.47.0-255,66,33315,92,185411
20665,0.000763,172.217.194.0-255,2902,36217,92,185411
20666,0.000764,172.31.47.0-255,66,36283,92,185411
20667,0.000768,172.217.194.0-255,2902,39185,92,185411
20668,0.000772,172.31.47.0-255,66,39251,92,185411
20669,0.000801,172.217.194.0-255,2902,42153,92,185411
20670,0.000806,172.31.47.0-255,66,42219,92,185411
20671,0.000818,172.31.47.0-255,66,42285,92,185411
20672,0.000831,172.217.194.0-255,2902,45187,92,185411
20673,0.000837,172.217.194.0-255,7156,52343,92,185411
20674,0.00084,172.31.47.0-255,66,52409,92,185411
20675,0.000863,172.217.194.0-255,3602,56011,92,185411
20676,0.00087,172.31.47.0-255,66,56077,92,185411
20677,0.001423,172.217.194.0-255,1484,57561,92,185411
20678,0.001432,172.217.194.0-255,2902,60463,92,185411
20679,0.001436,172.31.47.0-255,66,60529,92,185411
20680,0.001469,172.217.194.0-255,5738,66267,92,185411
20681,0.001472,172.217.194.0-255,1484,67751,92,185411
20682,0.001486,172.217.194.0-255,2902,70653,92,185411
20683,0.00149,172.217.194.0-255,2902,73555,92,185411
20684,0.001561,172.217.194.0-255,1484,75039,92,185411
20685,0.001576,172.217.194.0-255,5738,80777,92,185411
20686,0.00159,172.217.194.0-255,1484,82261,92,185411
20687,0.001595,172.217.194.0-255,4320,86581,92,185411
20688,0.001609,172.217.194.0-255,5738,92319,92,185411
20689,0.001624,172.217.194.0-255,2902,95221,92,185411
20690,0.001695,172.217.194.0-255,1484,96705,92,185411
20691,0.001712,172.217.194.0-255,2184,98889,92,185411
20692,0.001716,172.217.194.0-255,4320,103209,92,185411
20693,0.001734,172.217.194.0-255,7156,110365,92,185411
20694,0.001766,172.217.194.0-255,2902,113267,92,185411
20695,0.001776,172.217.194.0-255,2902,116169,92,185411
20696,0.001789,172.217.194.0-255,6438,122607,92,185411
20697,0.001885,172.217.194.0-255,1484,124091,92,185411
20698,0.0019,172.217.194.0-255,2902,126993,92,185411
20699,0.001914,172.217.194.0-255,1484,128477,92,185411
20700,0.00193,172.217.194.0-255,4320,132797,92,185411
20701,0.001932,172.217.194.0-255,1484,134281,92,185411
20702,0.001953,172.217.194.0-255,5738,140019,92,185411
20703,0.001973,172.217.194.0-255,2902,142921,92,185411
20704,0.002007,172.217.194.0-255,1484,144405,92,185411
20705,0.002009,172.217.194.0-255,766,145171,92,185411
20706,0.002122,172.217.194.0-255,1484,146655,92,185411
20707,0.002134,172.217.194.0-255,2902,149557,92,185411
20708,0.002137,172.31.47.0-255,66,149623,92,185411
20709,0.002143,172.31.47.0-255,66,149689,92,185411
20710,0.002174,172.217.194.0-255,5738,155427,92,185411
20711,0.002179,172.217.194.0-255,1484,156911,92,185411
20712,0.002188,172.31.47.0-255,66,156977,92,185411
20713,0.002226,172.31.47.0-255,66,157043,92,185411
20714,0.00225,172.217.194.0-255,7156,164199,92,185411
20715,0.002254,172.31.47.0-255,66,164265,92,185411
20716,0.002279,172.217.194.0-255,3602,167867,92,185411
20717,0.002292,172.31.47.0-255,66,167933,92,185411
20718,0.004503,172.217.194.0-255,1484,169417,92,185411
20719,0.004551,172.217.194.0-255,4320,173737,92,185411
20720,0.004556,172.31.47.0-255,66,173803,92,185411
20721,0.006837,172.217.194.0-255,5738,179541,92,185411
20722,0.006842,172.31.47.0-255,66,179607,92,185411
20723,0.009153,172.217.194.0-255,5738,185345,92,185411
20724,0.00916,172.31.47.0-255,66,185411,92,185411
20725,0.0,74.125.68.0-255,153,153,92,215439
20726,2.6e-05,172.31.47.0-255,66,219,92,215439
20727,3.3e-05,74.125.68.0-255,1484,1703,92,215439
20728,3.7e-05,172.31.47.0-255,66,1769,92,215439
20729,4e-05,74.125.68.0-255,1484,3253,92,215439
20730,4.2e-05,172.31.47.0-255,66,3319,92,215439
20731,6.4e-05,74.125.68.0-255,2902,6221,92,215439
20732,6.7e-05,172.31.47.0-255,66,6287,92,215439
20733,0.000101,74.125.68.0-255,5738,12025,92,215439
20734,0.000104,172.31.47.0-255,66,12091,92,215439
20735,0.000107,74.125.68.0-255,1484,13575,92,215439
20736,0.000109,172.31.47.0-255,66,13641,92,215439
20737,0.000151,74.125.68.0-255,2902,16543,92,215439
20738,0.000156,172.31.47.0-255,66,16609,92,215439
20739,0.000179,74.125.68.0-255,6319,22928,92,215439
20740,0.000182,172.31.47.0-255,66,22994,92,215439
20741,0.000198,74.125.68.0-255,1484,24478,92,215439
20742,0.000201,172.31.47.0-255,66,24544,92,215439
20743,0.000224,74.125.68.0-255,6797,31341,92,215439
20744,0.000227,172.31.47.0-255,66,31407,92,215439
20745,0.000488,74.125.68.0-255,1484,32891,92,215439
20746,0.000493,172.31.47.0-255,66,32957,92,215439
20747,0.000512,74.125.68.0-255,2902,35859,92,215439
20748,0.000515,172.31.47.0-255,66,35925,92,215439
20749,0.000518,74.125.68.0-255,1484,37409,92,215439
20750,0.00052,172.31.47.0-255,66,37475,92,215439
20751,0.00054,74.125.68.0-255,2902,40377,92,215439
20752,0.000542,172.31.47.0-255,66,40443,92,215439
20753,0.000564,74.125.68.0-255,2902,43345,92,215439
20754,0.000567,172.31.47.0-255,66,43411,92,215439
20755,0.000579,74.125.68.0-255,4320,47731,92,215439
20756,0.000582,172.31.47.0-255,66,47797,92,215439
20757,0.000619,74.125.68.0-255,2902,50699,92,215439
20758,0.000622,172.31.47.0-255,66,50765,92,215439
20759,0.000641,74.125.68.0-255,1484,52249,92,215439
20760,0.000648,74.125.68.0-255,5738,57987,92,215439
20761,0.000652,172.31.47.0-255,66,58053,92,215439
20762,0.000659,74.125.68.0-255,1484,59537,92,215439
20763,0.000673,74.125.68.0-255,4320,63857,92,215439
20764,0.000678,172.31.47.0-255,66,63923,92,215439
20765,0.000714,74.125.68.0-255,2184,66107,92,215439
20766,0.000728,172.31.47.0-255,66,66173,92,215439
20767,0.000737,74.125.68.0-255,442,66615,92,215439
20768,0.000802,74.125.68.0-255,1484,68099,92,215439
20769,0.000807,172.31.47.0-255,66,68165,92,215439
20770,0.000849,74.125.68.0-255,2902,71067,92,215439
20771,0.000853,172.31.47.0-255,66,71133,92,215439
20772,0.000859,74.125.68.0-255,5738,76871,92,215439
20773,0.000862,74.125.68.0-255,1484,78355,92,215439
20774,0.000875,74.125.68.0-255,4320,82675,92,215439
20775,0.000876,172.31.47.0-255,66,82741,92,215439
20776,0.000881,172.31.47.0-255,66,82807,92,215439
20777,0.00091,74.125.68.0-255,4320,87127,92,215439
20778,0.000921,172.31.47.0-255,66,87193,92,215439
20779,0.000922,74.125.68.0-255,2184,89377,92,215439
20780,0.000927,172.31.47.0-255,66,89443,92,215439
20781,0.001041,74.125.68.0-255,1484,90927,92,215439
20782,0.001063,74.125.68.0-255,2902,93829,92,215439
20783,0.001065,172.31.47.0-255,66,93895,92,215439
20784,0.001068,74.125.68.0-255,1484,95379,92,215439
20785,0.001085,74.125.68.0-255,2902,98281,92,215439
20786,0.001095,172.31.47.0-255,66,98347,92,215439
20787,0.001107,74.125.68.0-255,5738,104085,92,215439
20788,0.001115,172.31.47.0-255,66,104151,92,215439
20789,0.001131,74.125.68.0-255,4320,108471,92,215439
20790,0.001135,172.31.47.0-255,66,108537,92,215439
20791,0.00115,74.125.68.0-255,5738,114275,92,215439
20792,0.00116,172.31.47.0-255,66,114341,92,215439
20793,0.001169,74.125.68.0-255,1484,115825,92,215439
20794,0.001185,172.31.47.0-255,66,115891,92,215439
20795,0.001424,74.125.68.0-255,1484,117375,92,215439
20796,0.001429,172.31.47.0-255,66,117441,92,215439
20797,0.001436,74.125.68.0-255,2902,120343,92,215439
20798,0.001449,74.125.68.0-255,1484,121827,92,215439
20799,0.001469,74.125.68.0-255,4320,126147,92,215439
20800,0.001483,74.125.68.0-255,1484,127631,92,215439
20801,0.001507,74.125.68.0-255,7156,134787,92,215439
20802,0.00154,74.125.68.0-255,2902,137689,92,215439
20803,0.001565,74.125.68.0-255,7156,144845,92,215439
20804,0.001599,74.125.68.0-255,1484,146329,92,215439
20805,0.001621,74.125.68.0-255,2902,149231,92,215439
20806,0.001667,74.125.68.0-255,766,149997,92,215439
20807,0.001862,74.125.68.0-255,1484,151481,92,215439
20808,0.001866,74.125.68.0-255,1484,152965,92,215439
20809,0.00188,74.125.68.0-255,1484,154449,92,215439
20810,0.001882,74.125.68.0-255,1484,155933,92,215439
20811,0.001886,74.125.68.0-255,2902,158835,92,215439
20812,0.001902,74.125.68.0-255,1484,160319,92,215439
20813,0.001918,74.125.68.0-255,4320,164639,92,215439
20814,0.001934,74.125.68.0-255,4320,168959,92,215439
20815,0.001954,74.125.68.0-255,5738,174697,92,215439
20816,0.001999,74.125.68.0-255,4320,179017,92,215439
20817,0.002022,74.125.68.0-255,5020,184037,92,215439
20818,0.002196,74.125.68.0-255,1484,185521,92,215439
20819,0.0022,74.125.68.0-255,2902,188423,92,215439
20820,0.002216,74.125.68.0-255,2902,191325,92,215439
20821,0.002224,74.125.68.0-255,1484,192809,92,215439
20822,0.002238,74.125.68.0-255,1484,194293,92,215439
20823,0.002241,74.125.68.0-255,4320,198613,92,215439
20824,0.002245,74.125.68.0-255,2902,201515,92,215439
20825,0.002258,74.125.68.0-255,2902,204417,92,215439
20826,0.002279,74.125.68.0-255,2902,207319,92,215439
20827,0.002304,74.125.68.0-255,1484,208803,92,215439
20828,0.002306,74.125.68.0-255,766,209569,92,215439
20829,0.005897,172.31.47.0-255,66,209635,92,215439
20830,0.008202,74.125.68.0-255,5738,215373,92,215439
20831,0.008209,172.31.47.0-255,66,215439,92,215439
20832,0.0,172.217.194.0-255,153,153,92,262059
20833,3.1e-05,172.31.47.0-255,66,219,92,262059
20834,3.6e-05,172.217.194.0-255,1484,1703,92,262059
20835,4e-05,172.31.47.0-255,66,1769,92,262059
20836,4.6e-05,172.217.194.0-255,2902,4671,92,262059
20837,4.9e-05,172.31.47.0-255,66,4737,92,262059
20838,5.6e-05,172.217.194.0-255,7156,11893,92,262059
20839,5.9e-05,172.31.47.0-255,66,11959,92,262059
20840,6.5e-05,172.217.194.0-255,6230,18189,92,262059
20841,6.8e-05,172.31.47.0-255,66,18255,92,262059
20842,0.000117,172.217.194.0-255,5738,23993,92,262059
20843,0.00012,172.31.47.0-255,66,24059,92,262059
20844,0.000146,172.217.194.0-255,6797,30856,92,262059
20845,0.000149,172.31.47.0-255,66,30922,92,262059
20846,0.000175,172.217.194.0-255,1484,32406,92,262059
20847,0.000178,172.31.47.0-255,66,32472,92,262059
20848,0.000182,172.217.194.0-255,2902,35374,92,262059
20849,0.000184,172.31.47.0-255,66,35440,92,262059
20850,0.000189,172.217.194.0-255,5738,41178,92,262059
20851,0.000191,172.31.47.0-255,66,41244,92,262059
20852,0.000233,172.31.47.0-255,66,41310,92,262059
20853,0.000242,172.31.47.0-255,66,41376,92,262059
20854,0.000265,172.217.194.0-255,1449,42825,92,262059
20855,0.000268,172.31.47.0-255,66,42891,92,262059
20856,0.000346,172.217.194.0-255,1484,44375,92,262059
20857,0.00035,172.31.47.0-255,66,44441,92,262059
20858,0.000355,172.217.194.0-255,2902,47343,92,262059
20859,0.000358,172.31.47.0-255,66,47409,92,262059
20860,0.000363,172.217.194.0-255,2902,50311,92,262059
20861,0.000365,172.31.47.0-255,66,50377,92,262059
20862,0.000387,172.217.194.0-255,2902,53279,92,262059
20863,0.000391,172.31.47.0-255,66,53345,92,262059
20864,0.000397,172.217.194.0-255,4320,57665,92,262059
20865,0.000399,172.31.47.0-255,66,57731,92,262059
20866,0.00042,172.31.47.0-255,66,57797,92,262059
20867,0.000444,172.217.194.0-255,3961,61758,92,262059
20868,0.000447,172.31.47.0-255,66,61824,92,262059
20869,0.000453,172.217.194.0-255,6513,68337,92,262059
20870,0.000455,172.31.47.0-255,66,68403,92,262059
20871,0.000476,172.217.194.0-255,4320,72723,92,262059
20872,0.000479,172.31.47.0-255,66,72789,92,262059
20873,0.000484,172.217.194.0-255,4320,77109,92,262059
20874,0.00049,172.31.47.0-255,66,77175,92,262059
20875,0.000495,172.217.194.0-255,1484,78659,92,262059
20876,0.000515,172.31.47.0-255,66,78725,92,262059
20877,0.000525,172.217.194.0-255,2902,81627,92,262059
20878,0.00053,172.31.47.0-255,66,81693,92,262059
20879,0.000531,172.217.194.0-255,5738,87431,92,262059
20880,0.000533,172.31.47.0-255,66,87497,92,262059
20881,0.000553,172.217.194.0-255,6438,93935,92,262059
20882,0.000571,172.31.47.0-255,66,94001,92,262059
20883,0.000862,172.217.194.0-255,1484,95485,92,262059
20884,0.000867,172.217.194.0-255,2902,98387,92,262059
20885,0.000871,172.31.47.0-255,66,98453,92,262059
20886,0.000875,172.217.194.0-255,1484,99937,92,262059
20887,0.000894,172.217.194.0-255,2902,102839,92,262059
20888,0.000897,172.217.194.0-255,1484,104323,92,262059
20889,0.000899,172.31.47.0-255,66,104389,92,262059
20890,0.000921,172.217.194.0-255,4320,108709,92,262059
20891,0.000926,172.31.47.0-255,66,108775,92,262059
20892,0.000964,172.31.47.0-255,66,108841,92,262059
20893,0.000969,172.217.194.0-255,2902,111743,92,262059
20894,0.000975,172.217.194.0-255,7156,118899,92,262059
20895,0.000976,172.31.47.0-255,66,118965,92,262059
20896,0.00098,172.31.47.0-255,66,119031,92,262059
20897,0.000993,172.217.194.0-255,7156,126187,92,262059
20898,0.001005,172.31.47.0-255,66,126253,92,262059
20899,0.001011,172.217.194.0-255,2184,128437,92,262059
20900,0.001018,172.31.47.0-255,66,128503,92,262059
20901,0.001022,172.31.47.0-255,66,128569,92,262059
20902,0.00103,172.217.194.0-255,1484,130053,92,262059
20903,0.001044,172.217.194.0-255,4320,134373,92,262059
20904,0.001047,172.31.47.0-255,66,134439,92,262059
20905,0.001084,172.31.47.0-255,66,134505,92,262059
20906,0.001101,172.217.194.0-255,5738,140243,92,262059
20907,0.001108,172.217.194.0-255,7156,147399,92,262059
20908,0.001112,172.31.47.0-255,66,147465,92,262059
20909,0.001166,172.217.194.0-255,6438,153903,92,262059
20910,0.001166,172.31.47.0-255,66,153969,92,262059
20911,0.001171,172.31.47.0-255,66,154035,92,262059
20912,0.001209,172.217.194.0-255,5738,159773,92,262059
20913,0.001214,172.31.47.0-255,66,159839,92,262059
20914,0.001223,172.217.194.0-255,4320,164159,92,262059
20915,0.001228,172.31.47.0-255,66,164225,92,262059
20916,0.001238,172.31.47.0-255,66,164291,92,262059
20917,0.001277,172.31.47.0-255,66,164357,92,262059
20918,0.001298,172.217.194.0-255,1484,165841,92,262059
20919,0.001326,172.31.47.0-255,66,165907,92,262059
20920,0.001328,172.217.194.0-255,7156,173063,92,262059
20921,0.001338,172.31.47.0-255,66,173129,92,262059
20922,0.001351,172.217.194.0-255,7156,180285,92,262059
20923,0.001357,172.217.194.0-255,6438,186723,92,262059
20924,0.001358,172.31.47.0-255,66,186789,92,262059
20925,0.001371,172.31.47.0-255,66,186855,92,262059
20926,0.001425,172.217.194.0-255,1484,188339,92,262059
20927,0.001443,172.217.194.0-255,2902,191241,92,262059
20928,0.001448,172.217.194.0-255,4320,195561,92,262059
20929,0.001448,172.31.47.0-255,66,195627,92,262059
20930,0.001452,172.31.47.0-255,66,195693,92,262059
20931,0.001467,172.217.194.0-255,1484,197177,92,262059
20932,0.001474,172.217.194.0-255,7156,204333,92,262059
20933,0.001482,172.31.47.0-255,66,204399,92,262059
20934,0.001491,172.217.194.0-255,5738,210137,92,262059
20935,0.001495,172.31.47.0-255,66,210203,92,262059
20936,0.001509,172.217.194.0-255,4320,214523,92,262059
20937,0.001517,172.31.47.0-255,66,214589,92,262059
20938,0.001536,172.217.194.0-255,6438,221027,92,262059
20939,0.001549,172.31.47.0-255,66,221093,92,262059
20940,0.001569,172.217.194.0-255,7156,228249,92,262059
20941,0.001572,172.31.47.0-255,66,228315,92,262059
20942,0.001595,172.217.194.0-255,4320,232635,92,262059
20943,0.001604,172.31.47.0-255,66,232701,92,262059
20944,0.001608,172.217.194.0-255,7156,239857,92,262059
20945,0.001608,172.31.47.0-255,66,239923,92,262059
20946,0.00162,172.31.47.0-255,66,239989,92,262059
20947,0.001633,172.217.194.0-255,5020,245009,92,262059
20948,0.001637,172.31.47.0-255,66,245075,92,262059
20949,0.001676,172.217.194.0-255,7156,252231,92,262059
20950,0.001687,172.31.47.0-255,66,252297,92,262059
20951,0.001708,172.217.194.0-255,2902,255199,92,262059
20952,0.001715,172.31.47.0-255,66,255265,92,262059
20953,0.001739,172.31.47.0-255,66,255331,92,262059
20954,0.001743,172.31.47.0-255,66,255397,92,262059
20955,0.001764,172.217.194.0-255,6254,261651,92,262059
20956,0.001774,172.31.47.0-255,66,261717,92,262059
20957,0.001819,172.217.194.0-255,105,261822,92,262059
20958,0.003395,172.31.47.0-255,66,261888,92,262059
20959,0.003418,172.31.47.0-255,105,261993,92,262059
20960,0.005567,172.217.194.0-255,66,262059,92,262059
20961,0.0,172.217.194.0-255,153,153,92,142229
20962,2.5e-05,172.31.47.0-255,66,219,92,142229
20963,3.1e-05,172.217.194.0-255,1484,1703,92,142229
20964,3.6e-05,172.31.47.0-255,66,1769,92,142229
20965,4.1e-05,172.217.194.0-255,2902,4671,92,142229
20966,4.4e-05,172.31.47.0-255,66,4737,92,142229
20967,5.9e-05,172.217.194.0-255,7156,11893,92,142229
20968,6.3e-05,172.31.47.0-255,66,11959,92,142229
20969,8.8e-05,172.217.194.0-255,2039,13998,92,142229
20970,9e-05,172.31.47.0-255,66,14064,92,142229
20971,0.00013,172.217.194.0-255,1484,15548,92,142229
20972,0.000134,172.31.47.0-255,66,15614,92,142229
20973,0.000137,172.217.194.0-255,1484,17098,92,142229
20974,0.00014,172.31.47.0-255,66,17164,92,142229
20975,0.000161,172.217.194.0-255,1484,18648,92,142229
20976,0.00017,172.31.47.0-255,66,18714,92,142229
20977,0.000178,172.217.194.0-255,5738,24452,92,142229
20978,0.000182,172.31.47.0-255,66,24518,92,142229
20979,0.000188,172.217.194.0-255,6797,31315,92,142229
20980,0.00019,172.31.47.0-255,66,31381,92,142229
20981,0.000242,172.217.194.0-255,1484,32865,92,142229
20982,0.000245,172.31.47.0-255,66,32931,92,142229
20983,0.000249,172.217.194.0-255,2902,35833,92,142229
20984,0.000252,172.31.47.0-255,66,35899,92,142229
20985,0.000265,172.217.194.0-255,5738,41637,92,142229
20986,0.000267,172.31.47.0-255,66,41703,92,142229
20987,0.000314,172.217.194.0-255,6797,48500,92,142229
20988,0.000318,172.31.47.0-255,66,48566,92,142229
20989,0.000859,172.217.194.0-255,1484,50050,92,142229
20990,0.000863,172.31.47.0-255,66,50116,92,142229
20991,0.000871,172.217.194.0-255,2902,53018,92,142229
20992,0.000874,172.31.47.0-255,66,53084,92,142229
20993,0.000878,172.217.194.0-255,2902,55986,92,142229
20994,0.000886,172.31.47.0-255,66,56052,92,142229
20995,0.00092,172.217.194.0-255,2902,58954,92,142229
20996,0.000924,172.31.47.0-255,66,59020,92,142229
20997,0.000929,172.217.194.0-255,5738,64758,92,142229
20998,0.000931,172.31.47.0-255,66,64824,92,142229
20999,0.000934,172.217.194.0-255,1484,66308,92,142229
21000,0.000941,172.31.47.0-255,66,66374,92,142229
21001,0.000965,172.217.194.0-255,2543,68917,92,142229
21002,0.000967,172.31.47.0-255,66,68983,92,142229
21003,0.000972,172.217.194.0-255,4320,73303,92,142229
21004,0.000974,172.31.47.0-255,66,73369,92,142229
21005,0.000988,172.31.47.0-255,66,73435,92,142229
21006,0.001006,172.217.194.0-255,1125,74560,92,142229
21007,0.001008,172.31.47.0-255,66,74626,92,142229
21008,0.001011,172.217.194.0-255,646,75272,92,142229
21009,0.001013,172.31.47.0-255,66,75338,92,142229
21010,0.001015,172.217.194.0-255,1484,76822,92,142229
21011,0.001017,172.31.47.0-255,66,76888,92,142229
21012,0.001023,172.217.194.0-255,4320,81208,92,142229
21013,0.001032,172.31.47.0-255,66,81274,92,142229
21014,0.001075,172.31.47.0-255,66,81340,92,142229
21015,0.001078,172.217.194.0-255,1125,82465,92,142229
21016,0.00108,172.31.47.0-255,66,82531,92,142229
21017,0.001636,172.217.194.0-255,1484,84015,92,142229
21018,0.001642,172.31.47.0-255,66,84081,92,142229
21019,0.001649,172.217.194.0-255,2902,86983,92,142229
21020,0.001651,172.31.47.0-255,66,87049,92,142229
21021,0.001683,172.217.194.0-255,5738,92787,92,142229
21022,0.001686,172.31.47.0-255,66,92853,92,142229
21023,0.00169,172.217.194.0-255,2902,95755,92,142229
21024,0.001692,172.31.47.0-255,66,95821,92,142229
21025,0.001713,172.217.194.0-255,3398,99219,92,142229
21026,0.00194,172.217.194.0-255,1484,100703,92,142229
21027,0.001953,172.217.194.0-255,2902,103605,92,142229
21028,0.001956,172.217.194.0-255,1484,105089,92,142229
21029,0.001973,172.217.194.0-255,4320,109409,92,142229
21030,0.001991,172.217.194.0-255,4320,113729,92,142229
21031,0.002021,172.217.194.0-255,1484,115213,92,142229
21032,0.002036,172.217.194.0-255,7156,122369,92,142229
21033,0.002047,172.217.194.0-255,2184,124553,92,142229
21034,0.002344,172.31.47.0-255,66,124619,92,142229
21035,0.004482,172.217.194.0-255,4320,128939,92,142229
21036,0.004487,172.31.47.0-255,66,129005,92,142229
21037,0.004509,172.217.194.0-255,1484,130489,92,142229
21038,0.00451,172.31.47.0-255,66,130555,92,142229
21039,0.006562,172.217.194.0-255,5738,136293,92,142229
21040,0.006567,172.31.47.0-255,66,136359,92,142229
21041,0.008634,172.217.194.0-255,2902,139261,92,142229
21042,0.008641,172.31.47.0-255,66,139327,92,142229
21043,0.008671,172.217.194.0-255,2902,142229,92,142229
21044,0.0,74.125.24.0-255,152,152,92,159941
21045,2.4e-05,172.31.47.0-255,66,218,92,159941
21046,2.9e-05,74.125.24.0-255,1484,1702,92,159941
21047,3.3e-05,172.31.47.0-255,66,1768,92,159941
21048,3.6e-05,74.125.24.0-255,2902,4670,92,159941
21049,3.9e-05,172.31.47.0-255,66,4736,92,159941
21050,6.3e-05,74.125.24.0-255,7156,11892,92,159941
21051,6.6e-05,172.31.47.0-255,66,11958,92,159941
21052,7e-05,74.125.24.0-255,2172,14130,92,159941
21053,7.1e-05,172.31.47.0-255,66,14196,92,159941
21054,0.000107,172.31.47.0-255,66,14262,92,159941
21055,0.000111,74.125.24.0-255,4320,18582,92,159941
21056,0.000115,172.31.47.0-255,66,18648,92,159941
21057,0.000125,74.125.24.0-255,1125,19773,92,159941
21058,0.000127,172.31.47.0-255,66,19839,92,159941
21059,0.0002,74.125.24.0-255,1484,21323,92,159941
21060,0.000203,172.31.47.0-255,66,21389,92,159941
21061,0.000208,74.125.24.0-255,2902,24291,92,159941
21062,0.00021,172.31.47.0-255,66,24357,92,159941
21063,0.000233,74.125.24.0-255,5738,30095,92,159941
21064,0.000236,172.31.47.0-255,66,30161,92,159941
21065,0.000251,74.125.24.0-255,4320,34481,92,159941
21066,0.000253,172.31.47.0-255,66,34547,92,159941
21067,0.000274,172.31.47.0-255,66,34613,92,159941
21068,0.000284,172.31.47.0-255,66,34679,92,159941
21069,0.000321,74.125.24.0-255,1437,36116,92,159941
21070,0.000324,172.31.47.0-255,66,36182,92,159941
21071,0.000348,74.125.24.0-255,111,36293,92,159941
21072,0.000351,172.31.47.0-255,66,36359,92,159941
21073,0.00042,74.125.24.0-255,1484,37843,92,159941
21074,0.000425,74.125.24.0-255,2902,40745,92,159941
21075,0.000428,172.31.47.0-255,66,40811,92,159941
21076,0.000434,74.125.24.0-255,7156,47967,92,159941
21077,0.000436,172.31.47.0-255,66,48033,92,159941
21078,0.000446,172.31.47.0-255,66,48099,92,159941
21079,0.000463,74.125.24.0-255,2902,51001,92,159941
21080,0.000464,172.31.47.0-255,66,51067,92,159941
21081,0.000494,172.31.47.0-255,66,51133,92,159941
21082,0.001087,74.125.24.0-255,1484,52617,92,159941
21083,0.001104,74.125.24.0-255,2902,55519,92,159941
21084,0.001108,172.31.47.0-255,66,55585,92,159941
21085,0.001114,74.125.24.0-255,5738,61323,92,159941
21086,0.001116,172.31.47.0-255,66,61389,92,159941
21087,0.001152,172.31.47.0-255,66,61455,92,159941
21088,0.001196,74.125.24.0-255,1484,62939,92,159941
21089,0.001221,172.31.47.0-255,66,63005,92,159941
21090,0.001352,74.125.24.0-255,1484,64489,92,159941
21091,0.001365,74.125.24.0-255,2902,67391,92,159941
21092,0.001367,172.31.47.0-255,66,67457,92,159941
21093,0.001369,74.125.24.0-255,1484,68941,92,159941
21094,0.001391,74.125.24.0-255,4320,73261,92,159941
21095,0.001393,172.31.47.0-255,66,73327,92,159941
21096,0.001401,172.31.47.0-255,66,73393,92,159941
21097,0.001412,74.125.24.0-255,2902,76295,92,159941
21098,0.001414,172.31.47.0-255,66,76361,92,159941
21099,0.001427,74.125.24.0-255,1484,77845,92,159941
21100,0.001443,172.31.47.0-255,66,77911,92,159941
21101,0.001891,74.125.24.0-255,1484,79395,92,159941
21102,0.001909,74.125.24.0-255,2902,82297,92,159941
21103,0.001912,172.31.47.0-255,66,82363,92,159941
21104,0.001918,74.125.24.0-255,5738,88101,92,159941
21105,0.00192,172.31.47.0-255,66,88167,92,159941
21106,0.001927,74.125.24.0-255,7156,95323,92,159941
21107,0.001929,172.31.47.0-255,66,95389,92,159941
21108,0.001954,74.125.24.0-255,5738,101127,92,159941
21109,0.001956,172.31.47.0-255,66,101193,92,159941
21110,0.001965,172.31.47.0-255,66,101259,92,159941
21111,0.001997,74.125.24.0-255,5738,106997,92,159941
21112,0.002,172.31.47.0-255,66,107063,92,159941
21113,0.002029,172.31.47.0-255,66,107129,92,159941
21114,0.002039,172.31.47.0-255,66,107195,92,159941
21115,0.002059,172.31.47.0-255,66,107261,92,159941
21116,0.002071,172.31.47.0-255,66,107327,92,159941
21117,0.002094,74.125.24.0-255,1484,108811,92,159941
21118,0.002113,74.125.24.0-255,2902,111713,92,159941
21119,0.002115,172.31.47.0-255,66,111779,92,159941
21120,0.002144,172.31.47.0-255,66,111845,92,159941
21121,0.002147,74.125.24.0-255,1484,113329,92,159941
21122,0.002151,74.125.24.0-255,2902,116231,92,159941
21123,0.002153,172.31.47.0-255,66,116297,92,159941
21124,0.002171,74.125.24.0-255,5738,122035,92,159941
21125,0.002174,172.31.47.0-255,66,122101,92,159941
21126,0.002222,74.125.24.0-255,1484,123585,92,159941
21127,0.002235,74.125.24.0-255,766,124351,92,159941
21128,0.002266,74.125.24.0-255,1484,125835,92,159941
21129,0.002278,74.125.24.0-255,4320,130155,92,159941
21130,0.002294,74.125.24.0-255,1484,131639,92,159941
21131,0.002328,74.125.24.0-255,5738,137377,92,159941
21132,0.002344,74.125.24.0-255,5738,143115,92,159941
21133,0.002359,74.125.24.0-255,4320,147435,92,159941
21134,0.002519,74.125.24.0-255,2184,149619,92,159941
21135,0.003627,172.31.47.0-255,66,149685,92,159941
21136,0.00618,74.125.24.0-255,4320,154005,92,159941
21137,0.006186,172.31.47.0-255,66,154071,92,159941
21138,0.006203,74.125.24.0-255,1484,155555,92,159941
21139,0.00889,74.125.24.0-255,4320,159875,92,159941
21140,0.008952,172.31.47.0-255,66,159941,92,159941
21141,0.0,172.217.194.0-255,153,153,92,166554
21142,2.6e-05,172.31.47.0-255,66,219,92,166554
21143,3.2e-05,172.217.194.0-255,1484,1703,92,166554
21144,3.7e-05,172.31.47.0-255,66,1769,92,166554
21145,4.2e-05,172.217.194.0-255,2902,4671,92,166554
21146,5.1e-05,172.31.47.0-255,66,4737,92,166554
21147,6e-05,172.217.194.0-255,7156,11893,92,166554
21148,6.2e-05,172.31.47.0-255,66,11959,92,166554
21149,6.8e-05,172.217.194.0-255,5738,17697,92,166554
21150,7.1e-05,172.31.47.0-255,66,17763,92,166554
21151,9.6e-05,172.217.194.0-255,612,18375,92,166554
21152,9.9e-05,172.31.47.0-255,66,18441,92,166554
21153,0.000135,172.31.47.0-255,66,18507,92,166554
21154,0.000208,172.31.47.0-255,66,18573,92,166554
21155,0.000214,172.217.194.0-255,3961,22534,92,166554
21156,0.000216,172.31.47.0-255,66,22600,92,166554
21157,0.000326,172.217.194.0-255,1484,24084,92,166554
21158,0.00033,172.31.47.0-255,66,24150,92,166554
21159,0.000333,172.217.194.0-255,1484,25634,92,166554
21160,0.000336,172.31.47.0-255,66,25700,92,166554
21161,0.000356,172.217.194.0-255,1484,27184,92,166554
21162,0.000364,172.31.47.0-255,66,27250,92,166554
21163,0.000371,172.217.194.0-255,5738,32988,92,166554
21164,0.000374,172.31.47.0-255,66,33054,92,166554
21165,0.000381,172.217.194.0-255,6797,39851,92,166554
21166,0.000384,172.31.47.0-255,66,39917,92,166554
21167,0.000412,172.217.194.0-255,647,40564,92,166554
21168,0.000415,172.31.47.0-255,66,40630,92,166554
21169,0.000442,172.217.194.0-255,1484,42114,92,166554
21170,0.000445,172.31.47.0-255,66,42180,92,166554
21171,0.000451,172.217.194.0-255,4320,46500,92,166554
21172,0.000453,172.31.47.0-255,66,46566,92,166554
21173,0.000481,172.217.194.0-255,7156,53722,92,166554
21174,0.000485,172.31.47.0-255,66,53788,92,166554
21175,0.000514,172.217.194.0-255,7156,60944,92,166554
21176,0.000518,172.31.47.0-255,66,61010,92,166554
21177,0.000546,172.217.194.0-255,1125,62135,92,166554
21178,0.00056,172.31.47.0-255,66,62201,92,166554
21179,0.00059,172.217.194.0-255,2543,64744,92,166554
21180,0.000593,172.31.47.0-255,66,64810,92,166554
21181,0.001212,172.217.194.0-255,1484,66294,92,166554
21182,0.001221,172.217.194.0-255,2902,69196,92,166554
21183,0.001226,172.31.47.0-255,66,69262,92,166554
21184,0.001231,172.217.194.0-255,2902,72164,92,166554
21185,0.001234,172.31.47.0-255,66,72230,92,166554
21186,0.001252,172.217.194.0-255,2902,75132,92,166554
21187,0.001255,172.31.47.0-255,66,75198,92,166554
21188,0.001271,172.31.47.0-255,66,75264,92,166554
21189,0.001306,172.217.194.0-255,1484,76748,92,166554
21190,0.001324,172.31.47.0-255,66,76814,92,166554
21191,0.001574,172.217.194.0-255,1484,78298,92,166554
21192,0.001581,172.217.194.0-255,2902,81200,92,166554
21193,0.001585,172.31.47.0-255,66,81266,92,166554
21194,0.001615,172.217.194.0-255,5738,87004,92,166554
21195,0.001617,172.31.47.0-255,66,87070,92,166554
21196,0.00163,172.31.47.0-255,66,87136,92,166554
21197,0.001669,172.31.47.0-255,66,87202,92,166554
21198,0.001694,172.217.194.0-255,1484,88686,92,166554
21199,0.001697,172.217.194.0-255,1484,90170,92,166554
21200,0.001699,172.31.47.0-255,66,90236,92,166554
21201,0.001709,172.217.194.0-255,1484,91720,92,166554
21202,0.001719,172.217.194.0-255,5738,97458,92,166554
21203,0.001722,172.31.47.0-255,66,97524,92,166554
21204,0.001725,172.217.194.0-255,1484,99008,92,166554
21205,0.001755,172.31.47.0-255,66,99074,92,166554
21206,0.001766,172.31.47.0-255,66,99140,92,166554
21207,0.001854,172.217.194.0-255,1484,100624,92,166554
21208,0.001857,172.217.194.0-255,1484,102108,92,166554
21209,0.001859,172.31.47.0-255,66,102174,92,166554
21210,0.00188,172.217.194.0-255,1484,103658,92,166554
21211,0.001887,172.217.194.0-255,5738,109396,92,166554
21212,0.001889,172.31.47.0-255,66,109462,92,166554
21213,0.001937,172.217.194.0-255,1484,110946,92,166554
21214,0.001959,172.31.47.0-255,66,111012,92,166554
21215,0.001974,172.31.47.0-255,66,111078,92,166554
21216,0.002071,172.217.194.0-255,1484,112562,92,166554
21217,0.002075,172.217.194.0-255,2902,115464,92,166554
21218,0.002077,172.31.47.0-255,66,115530,92,166554
21219,0.00208,172.217.194.0-255,1484,117014,92,166554
21220,0.002102,172.217.194.0-255,4320,121334,92,166554
21221,0.002104,172.31.47.0-255,66,121400,92,166554
21222,0.00211,172.217.194.0-255,5738,127138,92,166554
21223,0.002113,172.31.47.0-255,66,127204,92,166554
21224,0.002163,172.31.47.0-255,66,127270,92,166554
21225,0.002173,172.31.47.0-255,66,127336,92,166554
21226,0.002189,172.217.194.0-255,3602,130938,92,166554
21227,0.002191,172.31.47.0-255,66,131004,92,166554
21228,0.002221,172.217.194.0-255,4320,135324,92,166554
21229,0.002223,172.31.47.0-255,66,135390,92,166554
21230,0.002264,172.31.47.0-255,66,135456,92,166554
21231,0.002269,172.217.194.0-255,4320,139776,92,166554
21232,0.002271,172.31.47.0-255,66,139842,92,166554
21233,0.002311,172.31.47.0-255,66,139908,92,166554
21234,0.002341,172.217.194.0-255,1484,141392,92,166554
21235,0.002352,172.31.47.0-255,66,141458,92,166554
21236,0.002374,172.31.47.0-255,66,141524,92,166554
21237,0.002401,172.217.194.0-255,2902,144426,92,166554
21238,0.002404,172.31.47.0-255,66,144492,92,166554
21239,0.002427,172.31.47.0-255,66,144558,92,166554
21240,0.002432,172.217.194.0-255,5738,150296,92,166554
21241,0.002435,172.31.47.0-255,66,150362,92,166554
21242,0.00247,172.31.47.0-255,66,150428,92,166554
21243,0.00248,172.31.47.0-255,66,150494,92,166554
21244,0.004862,172.217.194.0-255,4320,154814,92,166554
21245,0.004868,172.31.47.0-255,66,154880,92,166554
21246,0.004893,172.217.194.0-255,1484,156364,92,166554
21247,0.007266,172.217.194.0-255,4320,160684,92,166554
21248,0.00727,172.31.47.0-255,66,160750,92,166554
21249,0.00963,172.217.194.0-255,5738,166488,92,166554
21250,0.009636,172.31.47.0-255,66,166554,92,166554
21251,0.0,172.31.47.0-255,130,130,92,1591
21252,0.001482,172.31.47.0-255,236,366,92,1591
21253,0.001563,172.31.47.0-255,366,732,92,1591
21254,0.002506,74.125.200.0-255,630,1362,92,1591
21255,0.005157,74.125.200.0-255,66,1428,92,1591
21256,0.006229,74.125.200.0-255,97,1525,92,1591
21257,0.006239,172.31.47.0-255,66,1591,92,1591
21258,0.0,31.13.82.0-255,105,105,92,171
21259,2.1e-05,172.31.47.0-255,66,171,92,171
21260,0.0,172.253.118.0-255,66,66,92,66
21261,0.0,172.31.47.0-255,66,66,92,66
21262,0.0,74.125.130.0-255,153,153,92,230809
21263,3.2e-05,172.31.47.0-255,66,219,92,230809
21264,3.9e-05,74.125.130.0-255,1484,1703,92,230809
21265,4.3e-05,172.31.47.0-255,66,1769,92,230809
21266,5.4e-05,74.125.130.0-255,1484,3253,92,230809
21267,5.6e-05,172.31.47.0-255,66,3319,92,230809
21268,6.9e-05,74.125.130.0-255,1484,4803,92,230809
21269,7.1e-05,172.31.47.0-255,66,4869,92,230809
21270,8.2e-05,74.125.130.0-255,2902,7771,92,230809
21271,8.4e-05,172.31.47.0-255,66,7837,92,230809
21272,8.9e-05,74.125.130.0-255,4320,12157,92,230809
21273,9.2e-05,172.31.47.0-255,66,12223,92,230809
21274,0.000125,74.125.130.0-255,4320,16543,92,230809
21275,0.000128,172.31.47.0-255,66,16609,92,230809
21276,0.000149,74.125.130.0-255,3385,19994,92,230809
21277,0.000151,172.31.47.0-255,66,20060,92,230809
21278,0.00016,172.31.47.0-255,66,20126,92,230809
21279,0.000184,74.125.130.0-255,2543,22669,92,230809
21280,0.000186,172.31.47.0-255,66,22735,92,230809
21281,0.00039,74.125.130.0-255,1484,24219,92,230809
21282,0.000394,172.31.47.0-255,66,24285,92,230809
21283,0.000416,74.125.130.0-255,1484,25769,92,230809
21284,0.000418,172.31.47.0-255,66,25835,92,230809
21285,0.000435,74.125.130.0-255,1484,27319,92,230809
21286,0.00044,74.125.130.0-255,5738,33057,92,230809
21287,0.00044,172.31.47.0-255,66,33123,92,230809
21288,0.000444,172.31.47.0-255,66,33189,92,230809
21289,0.000445,74.125.130.0-255,6797,39986,92,230809
21290,0.000448,172.31.47.0-255,66,40052,92,230809
21291,0.000471,74.125.130.0-255,1484,41536,92,230809
21292,0.000473,172.31.47.0-255,66,41602,92,230809
21293,0.000495,74.125.130.0-255,7156,48758,92,230809
21294,0.000499,172.31.47.0-255,66,48824,92,230809
21295,0.000541,172.31.47.0-255,66,48890,92,230809
21296,0.000582,74.125.130.0-255,98,48988,92,230809
21297,0.000674,172.31.47.0-255,66,49054,92,230809
21298,0.000777,74.125.130.0-255,1484,50538,92,230809
21299,0.000792,74.125.130.0-255,2902,53440,92,230809
21300,0.000795,172.31.47.0-255,66,53506,92,230809
21301,0.000811,74.125.130.0-255,1484,54990,92,230809
21302,0.000834,74.125.130.0-255,4320,59310,92,230809
21303,0.000837,172.31.47.0-255,66,59376,92,230809
21304,0.00084,74.125.130.0-255,1484,60860,92,230809
21305,0.000878,74.125.130.0-255,2902,63762,92,230809
21306,0.000881,172.31.47.0-255,66,63828,92,230809
21307,0.000903,74.125.130.0-255,6797,70625,92,230809
21308,0.000906,172.31.47.0-255,66,70691,92,230809
21309,0.000918,74.125.130.0-255,1484,72175,92,230809
21310,0.000938,172.31.47.0-255,66,72241,92,230809
21311,0.000941,74.125.130.0-255,1484,73725,92,230809
21312,0.00098,74.125.130.0-255,1400,75125,92,230809
21313,0.000983,172.31.47.0-255,66,75191,92,230809
21314,0.001194,74.125.130.0-255,1484,76675,92,230809
21315,0.001214,74.125.130.0-255,2902,79577,92,230809
21316,0.001218,172.31.47.0-255,66,79643,92,230809
21317,0.001221,74.125.130.0-255,1484,81127,92,230809
21318,0.001239,74.125.130.0-255,4320,85447,92,230809
21319,0.001242,172.31.47.0-255,66,85513,92,230809
21320,0.001245,74.125.130.0-255,2902,88415,92,230809
21321,0.001247,172.31.47.0-255,66,88481,92,230809
21322,0.001256,74.125.130.0-255,1484,89965,92,230809
21323,0.001272,74.125.130.0-255,2902,92867,92,230809
21324,0.001274,172.31.47.0-255,66,92933,92,230809
21325,0.001279,74.125.130.0-255,7156,100089,92,230809
21326,0.001281,172.31.47.0-255,66,100155,92,230809
21327,0.001291,74.125.130.0-255,1484,101639,92,230809
21328,0.001295,74.125.130.0-255,4320,105959,92,230809
21329,0.001297,172.31.47.0-255,66,106025,92,230809
21330,0.001339,74.125.130.0-255,1484,107509,92,230809
21331,0.001349,74.125.130.0-255,2184,109693,92,230809
21332,0.001351,172.31.47.0-255,66,109759,92,230809
21333,0.001447,74.125.130.0-255,1484,111243,92,230809
21334,0.001462,74.125.130.0-255,2902,114145,92,230809
21335,0.001464,172.31.47.0-255,66,114211,92,230809
21336,0.001466,74.125.130.0-255,1484,115695,92,230809
21337,0.001483,74.125.130.0-255,4320,120015,92,230809
21338,0.001485,172.31.47.0-255,66,120081,92,230809
21339,0.001493,74.125.130.0-255,1484,121565,92,230809
21340,0.001504,74.125.130.0-255,4320,125885,92,230809
21341,0.001506,172.31.47.0-255,66,125951,92,230809
21342,0.001526,74.125.130.0-255,7156,133107,92,230809
21343,0.001528,172.31.47.0-255,66,133173,92,230809
21344,0.001551,74.125.130.0-255,7156,140329,92,230809
21345,0.001552,172.31.47.0-255,66,140395,92,230809
21346,0.001569,74.125.130.0-255,2902,143297,92,230809
21347,0.001571,172.31.47.0-255,66,143363,92,230809
21348,0.001586,74.125.130.0-255,766,144129,92,230809
21349,0.001667,74.125.130.0-255,1484,145613,92,230809
21350,0.001669,172.31.47.0-255,66,145679,92,230809
21351,0.00168,74.125.130.0-255,2902,148581,92,230809
21352,0.001682,172.31.47.0-255,66,148647,92,230809
21353,0.001708,74.125.130.0-255,1484,150131,92,230809
21354,0.001712,74.125.130.0-255,2902,153033,92,230809
21355,0.001714,172.31.47.0-255,66,153099,92,230809
21356,0.001719,74.125.130.0-255,5738,158837,92,230809
21357,0.001721,172.31.47.0-255,66,158903,92,230809
21358,0.001743,74.125.130.0-255,2902,161805,92,230809
21359,0.001744,172.31.47.0-255,66,161871,92,230809
21360,0.001766,74.125.130.0-255,7156,169027,92,230809
21361,0.001768,172.31.47.0-255,66,169093,92,230809
21362,0.001813,74.125.130.0-255,4320,173413,92,230809
21363,0.001815,172.31.47.0-255,66,173479,92,230809
21364,0.001835,74.125.130.0-255,5020,178499,92,230809
21365,0.001837,172.31.47.0-255,66,178565,92,230809
21366,0.002019,74.125.130.0-255,1484,180049,92,230809
21367,0.002034,74.125.130.0-255,2902,182951,92,230809
21368,0.002036,172.31.47.0-255,66,183017,92,230809
21369,0.002054,74.125.130.0-255,4320,187337,92,230809
21370,0.002056,172.31.47.0-255,66,187403,92,230809
21371,0.00207,74.125.130.0-255,1484,188887,92,230809
21372,0.002089,74.125.130.0-255,4320,193207,92,230809
21373,0.002091,172.31.47.0-255,66,193273,92,230809
21374,0.002136,74.125.130.0-255,5738,199011,92,230809
21375,0.002138,172.31.47.0-255,66,199077,92,230809
21376,0.002143,74.125.130.0-255,7156,206233,92,230809
21377,0.002145,172.31.47.0-255,66,206299,92,230809
21378,0.002147,74.125.130.0-255,1484,207783,92,230809
21379,0.002169,74.125.130.0-255,2902,210685,92,230809
21380,0.00217,172.31.47.0-255,66,210751,92,230809
21381,0.00221,74.125.130.0-255,2184,212935,92,230809
21382,0.002212,172.31.47.0-255,66,213001,92,230809
21383,0.004693,74.125.130.0-255,2902,215903,92,230809
21384,0.004698,172.31.47.0-255,66,215969,92,230809
21385,0.004733,74.125.130.0-255,2902,218871,92,230809
21386,0.004735,172.31.47.0-255,66,218937,92,230809
21387,0.00725,74.125.130.0-255,2902,221839,92,230809
21388,0.007258,172.31.47.0-255,66,221905,92,230809
21389,0.007278,74.125.130.0-255,2902,224807,92,230809
21390,0.007284,172.31.47.0-255,66,224873,92,230809
21391,0.009793,74.125.130.0-255,2902,227775,92,230809
21392,0.009801,172.31.47.0-255,66,227841,92,230809
21393,0.009821,74.125.130.0-255,2902,230743,92,230809
21394,0.009824,172.31.47.0-255,66,230809,92,230809
21395,0.0,74.125.24.0-255,297,297,92,146091
21396,4.3e-05,172.31.47.0-255,66,363,92,146091
21397,5e-05,74.125.24.0-255,1484,1847,92,146091
21398,5.5e-05,172.31.47.0-255,66,1913,92,146091
21399,6e-05,74.125.24.0-255,2902,4815,92,146091
21400,6.3e-05,172.31.47.0-255,66,4881,92,146091
21401,8.6e-05,74.125.24.0-255,5738,10619,92,146091
21402,8.9e-05,172.31.47.0-255,66,10685,92,146091
21403,0.000114,74.125.24.0-255,4320,15005,92,146091
21404,0.000119,172.31.47.0-255,66,15071,92,146091
21405,0.000127,74.125.24.0-255,1967,17038,92,146091
21406,0.000129,172.31.47.0-255,66,17104,92,146091
21407,0.000132,74.125.24.0-255,1484,18588,92,146091
21408,0.000134,172.31.47.0-255,66,18654,92,146091
21409,0.000163,74.125.24.0-255,7156,25810,92,146091
21410,0.000165,172.31.47.0-255,66,25876,92,146091
21411,0.000184,74.125.24.0-255,5379,31255,92,146091
21412,0.000187,172.31.47.0-255,66,31321,92,146091
21413,0.00034,74.125.24.0-255,1484,32805,92,146091
21414,0.000347,172.31.47.0-255,66,32871,92,146091
21415,0.000354,74.125.24.0-255,2902,35773,92,146091
21416,0.000356,172.31.47.0-255,66,35839,92,146091
21417,0.000362,74.125.24.0-255,5738,41577,92,146091
21418,0.000365,172.31.47.0-255,66,41643,92,146091
21419,0.000402,172.31.47.0-255,66,41709,92,146091
21420,0.000433,74.125.24.0-255,5379,47088,92,146091
21421,0.000438,74.125.24.0-255,4320,51408,92,146091
21422,0.000438,172.31.47.0-255,66,51474,92,146091
21423,0.000444,172.31.47.0-255,66,51540,92,146091
21424,0.000481,74.125.24.0-255,5652,57192,92,146091
21425,0.000486,172.31.47.0-255,66,57258,92,146091
21426,0.001044,74.125.24.0-255,130,57388,92,146091
21427,0.001081,172.31.47.0-255,66,57454,92,146091
21428,0.001132,74.125.24.0-255,1484,58938,92,146091
21429,0.001138,74.125.24.0-255,2902,61840,92,146091
21430,0.001142,172.31.47.0-255,66,61906,92,146091
21431,0.001149,74.125.24.0-255,5738,67644,92,146091
21432,0.001151,172.31.47.0-255,66,67710,92,146091
21433,0.001154,74.125.24.0-255,1484,69194,92,146091
21434,0.001172,74.125.24.0-255,4320,73514,92,146091
21435,0.001175,172.31.47.0-255,66,73580,92,146091
21436,0.00122,172.31.47.0-255,66,73646,92,146091
21437,0.001225,74.125.24.0-255,3961,77607,92,146091
21438,0.001228,172.31.47.0-255,66,77673,92,146091
21439,0.002103,74.125.24.0-255,1484,79157,92,146091
21440,0.002115,74.125.24.0-255,2902,82059,92,146091
21441,0.002122,172.31.47.0-255,66,82125,92,146091
21442,0.002131,74.125.24.0-255,5738,87863,92,146091
21443,0.002134,172.31.47.0-255,66,87929,92,146091
21444,0.002139,74.125.24.0-255,2902,90831,92,146091
21445,0.00214,172.31.47.0-255,66,90897,92,146091
21446,0.002146,74.125.24.0-255,4320,95217,92,146091
21447,0.002148,172.31.47.0-255,66,95283,92,146091
21448,0.002185,74.125.24.0-255,1484,96767,92,146091
21449,0.002188,172.31.47.0-255,66,96833,92,146091
21450,0.002233,74.125.24.0-255,2902,99735,92,146091
21451,0.002237,172.31.47.0-255,66,99801,92,146091
21452,0.002256,74.125.24.0-255,3602,103403,92,146091
21453,0.002259,172.31.47.0-255,66,103469,92,146091
21454,0.002451,74.125.24.0-255,1484,104953,92,146091
21455,0.002458,74.125.24.0-255,2902,107855,92,146091
21456,0.002462,172.31.47.0-255,66,107921,92,146091
21457,0.002484,74.125.24.0-255,5738,113659,92,146091
21458,0.002487,172.31.47.0-255,66,113725,92,146091
21459,0.002491,74.125.24.0-255,2902,116627,92,146091
21460,0.002493,172.31.47.0-255,66,116693,92,146091
21461,0.002515,74.125.24.0-255,4320,121013,92,146091
21462,0.002519,172.31.47.0-255,66,121079,92,146091
21463,0.002525,74.125.24.0-255,5738,126817,92,146091
21464,0.002527,172.31.47.0-255,66,126883,92,146091
21465,0.002564,172.31.47.0-255,66,126949,92,146091
21466,0.002568,74.125.24.0-255,2184,129133,92,146091
21467,0.00257,172.31.47.0-255,66,129199,92,146091
21468,0.002601,172.31.47.0-255,66,129265,92,146091
21469,0.00264,172.31.47.0-255,66,129331,92,146091
21470,0.002651,172.31.47.0-255,66,129397,92,146091
21471,0.002657,74.125.24.0-255,5020,134417,92,146091
21472,0.002659,172.31.47.0-255,66,134483,92,146091
21473,0.005256,74.125.24.0-255,5738,140221,92,146091
21474,0.005272,172.31.47.0-255,66,140287,92,146091
21475,0.007904,74.125.24.0-255,5738,146025,92,146091
21476,0.00792,172.31.47.0-255,66,146091,92,146091
21477,0.0,74.125.24.0-255,297,297,92,163251
21478,2.4e-05,172.31.47.0-255,66,363,92,163251
21479,3e-05,74.125.24.0-255,1484,1847,92,163251
21480,3.3e-05,172.31.47.0-255,66,1913,92,163251
21481,3.8e-05,74.125.24.0-255,4320,6233,92,163251
21482,4.6e-05,172.31.47.0-255,66,6299,92,163251
21483,5.7e-05,172.31.47.0-255,66,6365,92,163251
21484,9.5e-05,172.31.47.0-255,66,6431,92,163251
21485,0.000114,74.125.24.0-255,3961,10392,92,163251
21486,0.000117,172.31.47.0-255,66,10458,92,163251
21487,0.000139,74.125.24.0-255,1484,11942,92,163251
21488,0.000141,172.31.47.0-255,66,12008,92,163251
21489,0.000144,74.125.24.0-255,1484,13492,92,163251
21490,0.000146,172.31.47.0-255,66,13558,92,163251
21491,0.000176,74.125.24.0-255,1484,15042,92,163251
21492,0.000178,172.31.47.0-255,66,15108,92,163251
21493,0.000184,74.125.24.0-255,5738,20846,92,163251
21494,0.000186,172.31.47.0-255,66,20912,92,163251
21495,0.000192,74.125.24.0-255,6797,27709,92,163251
21496,0.000194,172.31.47.0-255,66,27775,92,163251
21497,0.000196,74.125.24.0-255,1484,29259,92,163251
21498,0.000198,172.31.47.0-255,66,29325,92,163251
21499,0.000235,172.31.47.0-255,66,29391,92,163251
21500,0.000238,74.125.24.0-255,1484,30875,92,163251
21501,0.000241,172.31.47.0-255,66,30941,92,163251
21502,0.000264,74.125.24.0-255,1395,32336,92,163251
21503,0.000267,172.31.47.0-255,66,32402,92,163251
21504,0.00027,74.125.24.0-255,130,32532,92,163251
21505,0.000272,172.31.47.0-255,66,32598,92,163251
21506,0.000344,74.125.24.0-255,1484,34082,92,163251
21507,0.000366,74.125.24.0-255,2902,36984,92,163251
21508,0.000369,172.31.47.0-255,66,37050,92,163251
21509,0.000375,74.125.24.0-255,5738,42788,92,163251
21510,0.000376,172.31.47.0-255,66,42854,92,163251
21511,0.000379,74.125.24.0-255,1484,44338,92,163251
21512,0.000402,74.125.24.0-255,5379,49717,92,163251
21513,0.000405,172.31.47.0-255,66,49783,92,163251
21514,0.000432,74.125.24.0-255,4320,54103,92,163251
21515,0.000434,172.31.47.0-255,66,54169,92,163251
21516,0.000471,172.31.47.0-255,66,54235,92,163251
21517,0.000475,74.125.24.0-255,2249,56484,92,163251
21518,0.000476,172.31.47.0-255,66,56550,92,163251
21519,0.0005,74.125.24.0-255,5738,62288,92,163251
21520,0.000503,172.31.47.0-255,66,62354,92,163251
21521,0.000524,74.125.24.0-255,2902,65256,92,163251
21522,0.000528,172.31.47.0-255,66,65322,92,163251
21523,0.000535,74.125.24.0-255,5738,71060,92,163251
21524,0.000536,172.31.47.0-255,66,71126,92,163251
21525,0.000566,74.125.24.0-255,3961,75087,92,163251
21526,0.000569,172.31.47.0-255,66,75153,92,163251
21527,0.000575,74.125.24.0-255,7156,82309,92,163251
21528,0.000577,172.31.47.0-255,66,82375,92,163251
21529,0.00061,172.31.47.0-255,66,82441,92,163251
21530,0.000868,74.125.24.0-255,1484,83925,92,163251
21531,0.000873,74.125.24.0-255,2902,86827,92,163251
21532,0.000876,172.31.47.0-255,66,86893,92,163251
21533,0.000881,74.125.24.0-255,5738,92631,92,163251
21534,0.000882,172.31.47.0-255,66,92697,92,163251
21535,0.000948,74.125.24.0-255,6797,99494,92,163251
21536,0.000951,172.31.47.0-255,66,99560,92,163251
21537,0.001083,74.125.24.0-255,1484,101044,92,163251
21538,0.001088,74.125.24.0-255,2902,103946,92,163251
21539,0.001091,172.31.47.0-255,66,104012,92,163251
21540,0.001115,74.125.24.0-255,5738,109750,92,163251
21541,0.001118,172.31.47.0-255,66,109816,92,163251
21542,0.001169,74.125.24.0-255,4320,114136,92,163251
21543,0.001172,172.31.47.0-255,66,114202,92,163251
21544,0.00119,74.125.24.0-255,2543,116745,92,163251
21545,0.001193,172.31.47.0-255,66,116811,92,163251
21546,0.001657,74.125.24.0-255,1484,118295,92,163251
21547,0.001667,74.125.24.0-255,2902,121197,92,163251
21548,0.001671,172.31.47.0-255,66,121263,92,163251
21549,0.001677,74.125.24.0-255,5738,127001,92,163251
21550,0.001679,172.31.47.0-255,66,127067,92,163251
21551,0.001709,74.125.24.0-255,2902,129969,92,163251
21552,0.001711,172.31.47.0-255,66,130035,92,163251
21553,0.001756,74.125.24.0-255,766,130801,92,163251
21554,0.001761,172.31.47.0-255,66,130867,92,163251
21555,0.001763,172.31.47.0-255,66,130933,92,163251
21556,0.001893,74.125.24.0-255,1484,132417,92,163251
21557,0.001898,172.31.47.0-255,66,132483,92,163251
21558,0.001903,74.125.24.0-255,2902,135385,92,163251
21559,0.001905,172.31.47.0-255,66,135451,92,163251
21560,0.001909,74.125.24.0-255,5738,141189,92,163251
21561,0.001911,172.31.47.0-255,66,141255,92,163251
21562,0.001947,172.31.47.0-255,66,141321,92,163251
21563,0.001984,74.125.24.0-255,5738,147059,92,163251
21564,0.001987,172.31.47.0-255,66,147125,92,163251
21565,0.00202,172.31.47.0-255,66,147191,92,163251
21566,0.004295,74.125.24.0-255,5738,152929,92,163251
21567,0.004301,172.31.47.0-255,66,152995,92,163251
21568,0.00654,74.125.24.0-255,4320,157315,92,163251
21569,0.006544,172.31.47.0-255,66,157381,92,163251
21570,0.006566,74.125.24.0-255,1484,158865,92,163251
21571,0.008811,74.125.24.0-255,4320,163185,92,163251
21572,0.008819,172.31.47.0-255,66,163251,92,163251
21573,0.0,172.31.47.0-255,105,105,92,105
21574,0.0,74.125.68.0-255,153,153,92,323204
21575,2.7e-05,172.31.47.0-255,66,219,92,323204
21576,3.3e-05,74.125.68.0-255,1484,1703,92,323204
21577,3.8e-05,172.31.47.0-255,66,1769,92,323204
21578,5.6e-05,74.125.68.0-255,2902,4671,92,323204
21579,5.9e-05,172.31.47.0-255,66,4737,92,323204
21580,6.2e-05,74.125.68.0-255,1484,6221,92,323204
21581,6.4e-05,172.31.47.0-255,66,6287,92,323204
21582,6.8e-05,74.125.68.0-255,2902,9189,92,323204
21583,7e-05,172.31.47.0-255,66,9255,92,323204
21584,0.000117,74.125.68.0-255,2902,12157,92,323204
21585,0.00012,172.31.47.0-255,66,12223,92,323204
21586,0.000139,74.125.68.0-255,2064,14287,92,323204
21587,0.000142,172.31.47.0-255,66,14353,92,323204
21588,0.00025,74.125.68.0-255,1484,15837,92,323204
21589,0.000254,172.31.47.0-255,66,15903,92,323204
21590,0.000268,74.125.68.0-255,2902,18805,92,323204
21591,0.000271,172.31.47.0-255,66,18871,92,323204
21592,0.000291,74.125.68.0-255,5738,24609,92,323204
21593,0.000294,172.31.47.0-255,66,24675,92,323204
21594,0.000309,74.125.68.0-255,1484,26159,92,323204
21595,0.000311,172.31.47.0-255,66,26225,92,323204
21596,0.00033,74.125.68.0-255,5379,31604,92,323204
21597,0.000333,172.31.47.0-255,66,31670,92,323204
21598,0.000352,74.125.68.0-255,7156,38826,92,323204
21599,0.000355,172.31.47.0-255,66,38892,92,323204
21600,0.00036,74.125.68.0-255,2902,41794,92,323204
21601,0.000362,172.31.47.0-255,66,41860,92,323204
21602,0.000388,74.125.68.0-255,4320,46180,92,323204
21603,0.000391,172.31.47.0-255,66,46246,92,323204
21604,0.000402,172.31.47.0-255,66,46312,92,323204
21605,0.000448,172.31.47.0-255,66,46378,92,323204
21606,0.00045,74.125.68.0-255,412,46790,92,323204
21607,0.000481,74.125.68.0-255,332,47122,92,323204
21608,0.000699,74.125.68.0-255,1484,48606,92,323204
21609,0.000703,172.31.47.0-255,66,48672,92,323204
21610,0.000708,74.125.68.0-255,2902,51574,92,323204
21611,0.00071,172.31.47.0-255,66,51640,92,323204
21612,0.000713,74.125.68.0-255,1484,53124,92,323204
21613,0.000717,74.125.68.0-255,2902,56026,92,323204
21614,0.00072,172.31.47.0-255,66,56092,92,323204
21615,0.000747,74.125.68.0-255,5738,61830,92,323204
21616,0.000749,172.31.47.0-255,66,61896,92,323204
21617,0.000767,74.125.68.0-255,4320,66216,92,323204
21618,0.00077,172.31.47.0-255,66,66282,92,323204
21619,0.000787,74.125.68.0-255,2902,69184,92,323204
21620,0.00079,172.31.47.0-255,66,69250,92,323204
21621,0.000796,74.125.68.0-255,7156,76406,92,323204
21622,0.000798,172.31.47.0-255,66,76472,92,323204
21623,0.000816,74.125.68.0-255,1484,77956,92,323204
21624,0.000821,74.125.68.0-255,3602,81558,92,323204
21625,0.000823,172.31.47.0-255,66,81624,92,323204
21626,0.00087,74.125.68.0-255,1484,83108,92,323204
21627,0.000884,74.125.68.0-255,2902,86010,92,323204
21628,0.000886,172.31.47.0-255,66,86076,92,323204
21629,0.000904,74.125.68.0-255,5738,91814,92,323204
21630,0.000907,172.31.47.0-255,66,91880,92,323204
21631,0.000911,74.125.68.0-255,2902,94782,92,323204
21632,0.000912,172.31.47.0-255,66,94848,92,323204
21633,0.000937,74.125.68.0-255,1484,96332,92,323204
21634,0.000963,172.31.47.0-255,66,96398,92,323204
21635,0.000968,74.125.68.0-255,4320,100718,92,323204
21636,0.000971,172.31.47.0-255,66,100784,92,323204
21637,0.000985,74.125.68.0-255,4320,105104,92,323204
21638,0.000988,172.31.47.0-255,66,105170,92,323204
21639,0.001018,74.125.68.0-255,2184,107354,92,323204
21640,0.001021,172.31.47.0-255,66,107420,92,323204
21641,0.001045,74.125.68.0-255,2902,110322,92,323204
21642,0.001048,172.31.47.0-255,66,110388,92,323204
21643,0.001059,74.125.68.0-255,1484,111872,92,323204
21644,0.001074,74.125.68.0-255,2902,114774,92,323204
21645,0.001076,172.31.47.0-255,66,114840,92,323204
21646,0.001082,74.125.68.0-255,5738,120578,92,323204
21647,0.001084,172.31.47.0-255,66,120644,92,323204
21648,0.001114,74.125.68.0-255,5738,126382,92,323204
21649,0.001117,172.31.47.0-255,66,126448,92,323204
21650,0.001139,74.125.68.0-255,5738,132186,92,323204
21651,0.001142,172.31.47.0-255,66,132252,92,323204
21652,0.001146,74.125.68.0-255,4320,136572,92,323204
21653,0.001148,172.31.47.0-255,66,136638,92,323204
21654,0.001177,74.125.68.0-255,5020,141658,92,323204
21655,0.001181,172.31.47.0-255,66,141724,92,323204
21656,0.001231,74.125.68.0-255,1484,143208,92,323204
21657,0.001258,74.125.68.0-255,2902,146110,92,323204
21658,0.001261,172.31.47.0-255,66,146176,92,323204
21659,0.001275,74.125.68.0-255,4320,150496,92,323204
21660,0.001278,172.31.47.0-255,66,150562,92,323204
21661,0.001281,74.125.68.0-255,1484,152046,92,323204
21662,0.001302,74.125.68.0-255,4320,156366,92,323204
21663,0.001304,172.31.47.0-255,66,156432,92,323204
21664,0.001316,74.125.68.0-255,4320,160752,92,323204
21665,0.001319,172.31.47.0-255,66,160818,92,323204
21666,0.001333,74.125.68.0-255,7156,167974,92,323204
21667,0.001336,172.31.47.0-255,66,168040,92,323204
21668,0.001339,74.125.68.0-255,2902,170942,92,323204
21669,0.001341,172.31.47.0-255,66,171008,92,323204
21670,0.001375,74.125.68.0-255,1484,172492,92,323204
21671,0.001391,74.125.68.0-255,3602,176094,92,323204
21672,0.001393,172.31.47.0-255,66,176160,92,323204
21673,0.001447,74.125.68.0-255,1484,177644,92,323204
21674,0.001458,74.125.68.0-255,2902,180546,92,323204
21675,0.001461,172.31.47.0-255,66,180612,92,323204
21676,0.001482,74.125.68.0-255,4320,184932,92,323204
21677,0.001484,172.31.47.0-255,66,184998,92,323204
21678,0.001504,74.125.68.0-255,1484,186482,92,323204
21679,0.00151,74.125.68.0-255,7156,193638,92,323204
21680,0.001513,172.31.47.0-255,66,193704,92,323204
21681,0.001536,74.125.68.0-255,1484,195188,92,323204
21682,0.001549,74.125.68.0-255,4320,199508,92,323204
21683,0.001551,172.31.47.0-255,66,199574,92,323204
21684,0.001575,74.125.68.0-255,7156,206730,92,323204
21685,0.001578,172.31.47.0-255,66,206796,92,323204
21686,0.001597,74.125.68.0-255,3602,210398,92,323204
21687,0.0016,172.31.47.0-255,66,210464,92,323204
21688,0.001638,74.125.68.0-255,1484,211948,92,323204
21689,0.001641,74.125.68.0-255,1484,213432,92,323204
21690,0.001643,172.31.47.0-255,66,213498,92,323204
21691,0.001658,74.125.68.0-255,1484,214982,92,323204
21692,0.001686,74.125.68.0-255,5738,220720,92,323204
21693,0.001689,172.31.47.0-255,66,220786,92,323204
21694,0.001692,74.125.68.0-255,1484,222270,92,323204
21695,0.001698,74.125.68.0-255,1484,223754,92,323204
21696,0.0017,172.31.47.0-255,66,223820,92,323204
21697,0.001712,74.125.68.0-255,1484,225304,92,323204
21698,0.001734,74.125.68.0-255,5738,231042,92,323204
21699,0.001737,172.31.47.0-255,66,231108,92,323204
21700,0.00174,74.125.68.0-255,1484,232592,92,323204
21701,0.001757,74.125.68.0-255,2902,235494,92,323204
21702,0.001759,172.31.47.0-255,66,235560,92,323204
21703,0.001775,74.125.68.0-255,4320,239880,92,323204
21704,0.001777,172.31.47.0-255,66,239946,92,323204
21705,0.001795,74.125.68.0-255,1484,241430,92,323204
21706,0.001799,74.125.68.0-255,3602,245032,92,323204
21707,0.001801,172.31.47.0-255,66,245098,92,323204
21708,0.001811,74.125.68.0-255,1484,246582,92,323204
21709,0.001827,74.125.68.0-255,2902,249484,92,323204
21710,0.001829,172.31.47.0-255,66,249550,92,323204
21711,0.001832,74.125.68.0-255,1484,251034,92,323204
21712,0.001851,74.125.68.0-255,5738,256772,92,323204
21713,0.001853,172.31.47.0-255,66,256838,92,323204
21714,0.001882,172.31.47.0-255,66,256904,92,323204
21715,0.001913,172.31.47.0-255,66,256970,92,323204
21716,0.001939,74.125.68.0-255,2184,259154,92,323204
21717,0.001943,172.31.47.0-255,66,259220,92,323204
21718,0.001975,74.125.68.0-255,2902,262122,92,323204
21719,0.001978,172.31.47.0-255,66,262188,92,323204
21720,0.00199,74.125.68.0-255,4320,266508,92,323204
21721,0.001992,172.31.47.0-255,66,266574,92,323204
21722,0.002011,74.125.68.0-255,2902,269476,92,323204
21723,0.002014,172.31.47.0-255,66,269542,92,323204
21724,0.002023,172.31.47.0-255,66,269608,92,323204
21725,0.002039,74.125.68.0-255,2902,272510,92,323204
21726,0.002042,172.31.47.0-255,66,272576,92,323204
21727,0.002059,172.31.47.0-255,66,272642,92,323204
21728,0.002095,74.125.68.0-255,2902,275544,92,323204
21729,0.002098,172.31.47.0-255,66,275610,92,323204
21730,0.002129,172.31.47.0-255,66,275676,92,323204
21731,0.002133,74.125.68.0-255,4320,279996,92,323204
21732,0.002139,172.31.47.0-255,66,280062,92,323204
21733,0.00218,172.31.47.0-255,66,280128,92,323204
21734,0.002185,74.125.68.0-255,5738,285866,92,323204
21735,0.002187,172.31.47.0-255,66,285932,92,323204
21736,0.002192,74.125.68.0-255,6438,292370,92,323204
21737,0.002194,172.31.47.0-255,66,292436,92,323204
21738,0.002273,74.125.68.0-255,1484,293920,92,323204
21739,0.002288,74.125.68.0-255,2902,296822,92,323204
21740,0.002292,172.31.47.0-255,66,296888,92,323204
21741,0.002296,74.125.68.0-255,1484,298372,92,323204
21742,0.002316,74.125.68.0-255,2902,301274,92,323204
21743,0.00232,172.31.47.0-255,66,301340,92,323204
21744,0.002353,74.125.68.0-255,5738,307078,92,323204
21745,0.002357,172.31.47.0-255,66,307144,92,323204
21746,0.004658,74.125.68.0-255,4320,311464,92,323204
21747,0.004664,172.31.47.0-255,66,311530,92,323204
21748,0.004682,74.125.68.0-255,1484,313014,92,323204
21749,0.006969,74.125.68.0-255,4320,317334,92,323204
21750,0.006975,172.31.47.0-255,66,317400,92,323204
21751,0.009284,74.125.68.0-255,5738,323138,92,323204
21752,0.009289,172.31.47.0-255,66,323204,92,323204
21753,0.0,172.31.47.0-255,105,105,92,105
21754,0.0,172.217.194.0-255,431,431,92,56132
21755,2.8e-05,172.217.194.0-255,1484,1915,92,56132
21756,3.9e-05,172.31.47.0-255,66,1981,92,56132
21757,4.7e-05,172.217.194.0-255,4320,6301,92,56132
21758,5e-05,172.31.47.0-255,66,6367,92,56132
21759,8.1e-05,172.31.47.0-255,66,6433,92,56132
21760,0.000841,172.217.194.0-255,1484,7917,92,56132
21761,0.000851,172.217.194.0-255,2902,10819,92,56132
21762,0.000855,172.31.47.0-255,66,10885,92,56132
21763,0.000958,172.217.194.0-255,5738,16623,92,56132
21764,0.000962,172.31.47.0-255,66,16689,92,56132
21765,0.00117,172.217.194.0-255,2902,19591,92,56132
21766,0.001172,172.31.47.0-255,66,19657,92,56132
21767,0.001208,172.217.194.0-255,2805,22462,92,56132
21768,0.00121,172.31.47.0-255,66,22528,92,56132
21769,0.002094,172.217.194.0-255,4320,26848,92,56132
21770,0.002097,172.31.47.0-255,66,26914,92,56132
21771,0.00234,172.217.194.0-255,4320,31234,92,56132
21772,0.003018,172.217.194.0-255,5738,36972,92,56132
21773,0.003191,172.31.47.0-255,66,37038,92,56132
21774,0.003379,172.217.194.0-255,1484,38522,92,56132
21775,0.003417,172.31.47.0-255,66,38588,92,56132
21776,0.003615,172.31.47.0-255,66,38654,92,56132
21777,0.004137,172.31.47.0-255,66,38720,92,56132
21778,0.00417,172.217.194.0-255,5738,44458,92,56132
21779,0.004318,172.31.47.0-255,66,44524,92,56132
21780,0.005242,172.217.194.0-255,4320,48844,92,56132
21781,0.005248,172.31.47.0-255,66,48910,92,56132
21782,0.006233,172.217.194.0-255,7156,56066,92,56132
21783,0.007982,172.31.47.0-255,66,56132,92,56132
21784,0.0,172.31.47.0-255,105,105,92,105
21785,0.0,74.125.24.0-255,153,153,92,147884
21786,1.4e-05,172.31.47.0-255,66,219,92,147884
21787,4.7e-05,74.125.24.0-255,1484,1703,92,147884
21788,5.2e-05,172.31.47.0-255,66,1769,92,147884
21789,5.7e-05,74.125.24.0-255,2902,4671,92,147884
21790,5.9e-05,172.31.47.0-255,66,4737,92,147884
21791,6.2e-05,74.125.24.0-255,2902,7639,92,147884
21792,6.5e-05,172.31.47.0-255,66,7705,92,147884
21793,8e-05,74.125.24.0-255,2902,10607,92,147884
21794,8.2e-05,172.31.47.0-255,66,10673,92,147884
21795,0.000103,74.125.24.0-255,1484,12157,92,147884
21796,0.000105,172.31.47.0-255,66,12223,92,147884
21797,0.000118,74.125.24.0-255,2185,14408,92,147884
21798,0.00012,172.31.47.0-255,66,14474,92,147884
21799,0.000141,74.125.24.0-255,2902,17376,92,147884
21800,0.000143,172.31.47.0-255,66,17442,92,147884
21801,0.00016,74.125.24.0-255,1484,18926,92,147884
21802,0.000161,172.31.47.0-255,66,18992,92,147884
21803,0.000178,74.125.24.0-255,2902,21894,92,147884
21804,0.00018,172.31.47.0-255,66,21960,92,147884
21805,0.000189,172.31.47.0-255,66,22026,92,147884
21806,0.000192,74.125.24.0-255,1125,23151,92,147884
21807,0.000194,172.31.47.0-255,66,23217,92,147884
21808,0.000264,74.125.24.0-255,1484,24701,92,147884
21809,0.000267,172.31.47.0-255,66,24767,92,147884
21810,0.000293,74.125.24.0-255,2902,27669,92,147884
21811,0.000296,172.31.47.0-255,66,27735,92,147884
21812,0.000315,74.125.24.0-255,4320,32055,92,147884
21813,0.000317,172.31.47.0-255,66,32121,92,147884
21814,0.000333,74.125.24.0-255,1484,33605,92,147884
21815,0.000335,172.31.47.0-255,66,33671,92,147884
21816,0.000363,172.31.47.0-255,66,33737,92,147884
21817,0.00037,74.125.24.0-255,7156,40893,92,147884
21818,0.000372,172.31.47.0-255,66,40959,92,147884
21819,0.000386,74.125.24.0-255,4320,45279,92,147884
21820,0.000388,172.31.47.0-255,66,45345,92,147884
21821,0.000409,74.125.24.0-255,4271,49616,92,147884
21822,0.000414,172.31.47.0-255,66,49682,92,147884
21823,0.000428,74.125.24.0-255,108,49790,92,147884
21824,0.00043,172.31.47.0-255,66,49856,92,147884
21825,0.00073,74.125.24.0-255,334,50190,92,147884
21826,0.000735,172.31.47.0-255,66,50256,92,147884
21827,0.000862,74.125.24.0-255,1484,51740,92,147884
21828,0.000866,172.31.47.0-255,66,51806,92,147884
21829,0.00087,74.125.24.0-255,1484,53290,92,147884
21830,0.000872,172.31.47.0-255,66,53356,92,147884
21831,0.000886,74.125.24.0-255,1484,54840,92,147884
21832,0.000889,172.31.47.0-255,66,54906,92,147884
21833,0.000895,74.125.24.0-255,4320,59226,92,147884
21834,0.000897,172.31.47.0-255,66,59292,92,147884
21835,0.000913,74.125.24.0-255,1484,60776,92,147884
21836,0.000915,172.31.47.0-255,66,60842,92,147884
21837,0.000923,74.125.24.0-255,7156,67998,92,147884
21838,0.000933,172.31.47.0-255,66,68064,92,147884
21839,0.00095,74.125.24.0-255,5738,73802,92,147884
21840,0.000957,74.125.24.0-255,7156,80958,92,147884
21841,0.000959,172.31.47.0-255,66,81024,92,147884
21842,0.000964,172.31.47.0-255,66,81090,92,147884
21843,0.000987,74.125.24.0-255,3602,84692,92,147884
21844,0.000998,172.31.47.0-255,66,84758,92,147884
21845,0.00149,74.125.24.0-255,1484,86242,92,147884
21846,0.001496,172.31.47.0-255,66,86308,92,147884
21847,0.001504,74.125.24.0-255,2902,89210,92,147884
21848,0.001507,172.31.47.0-255,66,89276,92,147884
21849,0.00151,74.125.24.0-255,1484,90760,92,147884
21850,0.001536,74.125.24.0-255,4320,95080,92,147884
21851,0.001542,74.125.24.0-255,5738,100818,92,147884
21852,0.001559,74.125.24.0-255,1484,102302,92,147884
21853,0.001586,74.125.24.0-255,5020,107322,92,147884
21854,0.002603,74.125.24.0-255,1484,108806,92,147884
21855,0.002609,74.125.24.0-255,1484,110290,92,147884
21856,0.002623,74.125.24.0-255,1484,111774,92,147884
21857,0.002629,74.125.24.0-255,5738,117512,92,147884
21858,0.002657,74.125.24.0-255,5738,123250,92,147884
21859,0.002674,74.125.24.0-255,7156,130406,92,147884
21860,0.00268,74.125.24.0-255,7156,137562,92,147884
21861,0.004208,172.31.47.0-255,66,137628,92,147884
21862,0.006812,74.125.24.0-255,4320,141948,92,147884
21863,0.006819,172.31.47.0-255,66,142014,92,147884
21864,0.006832,74.125.24.0-255,1484,143498,92,147884
21865,0.009465,74.125.24.0-255,4320,147818,92,147884
21866,0.009471,172.31.47.0-255,66,147884,92,147884
21867,0.0,74.125.200.0-255,226,226,92,48919
21868,3.1e-05,172.31.47.0-255,66,292,92,48919
21869,6.4e-05,74.125.200.0-255,1484,1776,92,48919
21870,6.9e-05,172.31.47.0-255,66,1842,92,48919
21871,8e-05,74.125.200.0-255,1484,3326,92,48919
21872,8.9e-05,172.31.47.0-255,66,3392,92,48919
21873,0.000135,74.125.200.0-255,2902,6294,92,48919
21874,0.00014,172.31.47.0-255,66,6360,92,48919
21875,0.000255,74.125.200.0-255,5738,12098,92,48919
21876,0.000259,172.31.47.0-255,66,12164,92,48919
21877,0.00048,74.125.200.0-255,2092,14256,92,48919
21878,0.000485,172.31.47.0-255,66,14322,92,48919
21879,0.000583,74.125.200.0-255,2902,17224,92,48919
21880,0.000587,172.31.47.0-255,66,17290,92,48919
21881,0.000618,74.125.200.0-255,7156,24446,92,48919
21882,0.000621,172.31.47.0-255,66,24512,92,48919
21883,0.000975,74.125.200.0-255,6797,31309,92,48919
21884,0.000984,172.31.47.0-255,66,31375,92,48919
21885,0.00328,74.125.200.0-255,5738,37113,92,48919
21886,0.003285,172.31.47.0-255,66,37179,92,48919
21887,0.005575,74.125.200.0-255,5738,42917,92,48919
21888,0.005581,172.31.47.0-255,66,42983,92,48919
21889,0.00788,74.125.200.0-255,2902,45885,92,48919
21890,0.007887,172.31.47.0-255,66,45951,92,48919
21891,0.007917,74.125.200.0-255,2902,48853,92,48919
21892,0.00792,172.31.47.0-255,66,48919,92,48919
21893,0.0,172.217.160.0-255,153,153,92,224585
21894,2.8e-05,172.31.47.0-255,66,219,92,224585
21895,3.4e-05,172.217.160.0-255,1484,1703,92,224585
21896,3.9e-05,172.31.47.0-255,66,1769,92,224585
21897,4.4e-05,172.217.160.0-255,2902,4671,92,224585
21898,4.6e-05,172.31.47.0-255,66,4737,92,224585
21899,5.3e-05,172.217.160.0-255,7156,11893,92,224585
21900,5.6e-05,172.31.47.0-255,66,11959,92,224585
21901,9e-05,172.31.47.0-255,66,12025,92,224585
21902,0.000113,172.217.160.0-255,6477,18502,92,224585
21903,0.000115,172.31.47.0-255,66,18568,92,224585
21904,0.000128,172.217.160.0-255,2543,21111,92,224585
21905,0.000131,172.31.47.0-255,66,21177,92,224585
21906,0.000135,172.217.160.0-255,2902,24079,92,224585
21907,0.000137,172.31.47.0-255,66,24145,92,224585
21908,0.000171,172.217.160.0-255,7156,31301,92,224585
21909,0.000175,172.31.47.0-255,66,31367,92,224585
21910,0.000182,172.217.160.0-255,6797,38164,92,224585
21911,0.000184,172.31.47.0-255,66,38230,92,224585
21912,0.000222,172.217.160.0-255,4320,42550,92,224585
21913,0.000225,172.31.47.0-255,66,42616,92,224585
21914,0.000246,172.217.160.0-255,2902,45518,92,224585
21915,0.000251,172.31.47.0-255,66,45584,92,224585
21916,0.000256,172.31.47.0-255,66,45650,92,224585
21917,0.000269,172.217.160.0-255,1394,47044,92,224585
21918,0.000272,172.31.47.0-255,66,47110,92,224585
21919,0.000843,172.217.160.0-255,125,47235,92,224585
21920,0.000848,172.31.47.0-255,66,47301,92,224585
21921,0.000913,172.217.160.0-255,1484,48785,92,224585
21922,0.000918,172.31.47.0-255,66,48851,92,224585
21923,0.000921,172.217.160.0-255,1484,50335,92,224585
21924,0.000942,172.217.160.0-255,1484,51819,92,224585
21925,0.000946,172.31.47.0-255,66,51885,92,224585
21926,0.000953,172.217.160.0-255,5738,57623,92,224585
21927,0.000955,172.31.47.0-255,66,57689,92,224585
21928,0.001011,172.31.47.0-255,66,57755,92,224585
21929,0.001032,172.217.160.0-255,2543,60298,92,224585
21930,0.001036,172.31.47.0-255,66,60364,92,224585
21931,0.001044,172.217.160.0-255,7156,67520,92,224585
21932,0.001046,172.31.47.0-255,66,67586,92,224585
21933,0.00105,172.217.160.0-255,2543,70129,92,224585
21934,0.001053,172.31.47.0-255,66,70195,92,224585
21935,0.001217,172.217.160.0-255,1484,71679,92,224585
21936,0.001224,172.217.160.0-255,2902,74581,92,224585
21937,0.001228,172.31.47.0-255,66,74647,92,224585
21938,0.001233,172.217.160.0-255,2902,77549,92,224585
21939,0.001234,172.31.47.0-255,66,77615,92,224585
21940,0.001253,172.217.160.0-255,2902,80517,92,224585
21941,0.001255,172.31.47.0-255,66,80583,92,224585
21942,0.00126,172.217.160.0-255,4320,84903,92,224585
21943,0.001262,172.31.47.0-255,66,84969,92,224585
21944,0.001268,172.217.160.0-255,5738,90707,92,224585
21945,0.001269,172.31.47.0-255,66,90773,92,224585
21946,0.001291,172.217.160.0-255,4320,95093,92,224585
21947,0.001294,172.31.47.0-255,66,95159,92,224585
21948,0.00133,172.217.160.0-255,7156,102315,92,224585
21949,0.001333,172.31.47.0-255,66,102381,92,224585
21950,0.001337,172.217.160.0-255,2184,104565,92,224585
21951,0.00134,172.31.47.0-255,66,104631,92,224585
21952,0.001343,172.217.160.0-255,2902,107533,92,224585
21953,0.001345,172.31.47.0-255,66,107599,92,224585
21954,0.00135,172.217.160.0-255,7156,114755,92,224585
21955,0.001352,172.31.47.0-255,66,114821,92,224585
21956,0.001362,172.31.47.0-255,66,114887,92,224585
21957,0.001389,172.217.160.0-255,1484,116371,92,224585
21958,0.001396,172.217.160.0-255,4320,120691,92,224585
21959,0.001399,172.31.47.0-255,66,120757,92,224585
21960,0.00142,172.31.47.0-255,66,120823,92,224585
21961,0.00146,172.217.160.0-255,1484,122307,92,224585
21962,0.001463,172.217.160.0-255,1484,123791,92,224585
21963,0.001471,172.31.47.0-255,66,123857,92,224585
21964,0.001474,172.217.160.0-255,1484,125341,92,224585
21965,0.00148,172.217.160.0-255,5738,131079,92,224585
21966,0.001481,172.31.47.0-255,66,131145,92,224585
21967,0.001507,172.217.160.0-255,5738,136883,92,224585
21968,0.00151,172.31.47.0-255,66,136949,92,224585
21969,0.001515,172.217.160.0-255,5738,142687,92,224585
21970,0.001516,172.31.47.0-255,66,142753,92,224585
21971,0.00153,172.217.160.0-255,1484,144237,92,224585
21972,0.001561,172.217.160.0-255,5738,149975,92,224585
21973,0.001564,172.31.47.0-255,66,150041,92,224585
21974,0.001586,172.217.160.0-255,5020,155061,92,224585
21975,0.001588,172.31.47.0-255,66,155127,92,224585
21976,0.001641,172.217.160.0-255,1484,156611,92,224585
21977,0.001663,172.217.160.0-255,2902,159513,92,224585
21978,0.001666,172.31.47.0-255,66,159579,92,224585
21979,0.001671,172.217.160.0-255,5738,165317,92,224585
21980,0.001673,172.31.47.0-255,66,165383,92,224585
21981,0.001713,172.31.47.0-255,66,165449,92,224585
21982,0.001731,172.217.160.0-255,1484,166933,92,224585
21983,0.001736,172.217.160.0-255,5738,172671,92,224585
21984,0.00174,172.31.47.0-255,66,172737,92,224585
21985,0.001769,172.217.160.0-255,4320,177057,92,224585
21986,0.001771,172.31.47.0-255,66,177123,92,224585
21987,0.001785,172.217.160.0-255,766,177889,92,224585
21988,0.001895,172.217.160.0-255,1484,179373,92,224585
21989,0.001898,172.31.47.0-255,66,179439,92,224585
21990,0.001903,172.217.160.0-255,2902,182341,92,224585
21991,0.001904,172.31.47.0-255,66,182407,92,224585
21992,0.001917,172.217.160.0-255,1484,183891,92,224585
21993,0.001936,172.217.160.0-255,4320,188211,92,224585
21994,0.001938,172.31.47.0-255,66,188277,92,224585
21995,0.001949,172.217.160.0-255,7156,195433,92,224585
21996,0.00195,172.31.47.0-255,66,195499,92,224585
21997,0.001971,172.217.160.0-255,5738,201237,92,224585
21998,0.001974,172.31.47.0-255,66,201303,92,224585
21999,0.001984,172.31.47.0-255,66,201369,92,224585
22000,0.00391,172.217.160.0-255,5738,207107,92,224585
22001,0.003915,172.31.47.0-255,66,207173,92,224585
22002,0.005841,172.217.160.0-255,5738,212911,92,224585
22003,0.005846,172.31.47.0-255,66,212977,92,224585
22004,0.007772,172.217.160.0-255,5738,218715,92,224585
22005,0.007779,172.31.47.0-255,66,218781,92,224585
22006,0.009716,172.217.160.0-255,5738,224519,92,224585
22007,0.009724,172.31.47.0-255,66,224585,92,224585
22008,0.0,74.125.24.0-255,297,297,92,226929
22009,2.3e-05,172.31.47.0-255,66,363,92,226929
22010,2.8e-05,74.125.24.0-255,1484,1847,92,226929
22011,3.2e-05,172.31.47.0-255,66,1913,92,226929
22012,3.6e-05,74.125.24.0-255,4320,6233,92,226929
22013,3.8e-05,172.31.47.0-255,66,6299,92,226929
22014,5.3e-05,74.125.24.0-255,2902,9201,92,226929
22015,5.5e-05,172.31.47.0-255,66,9267,92,226929
22016,6.8e-05,74.125.24.0-255,2902,12169,92,226929
22017,7e-05,172.31.47.0-255,66,12235,92,226929
22018,0.000106,172.31.47.0-255,66,12301,92,226929
22019,0.000121,74.125.24.0-255,6266,18567,92,226929
22020,0.000123,172.31.47.0-255,66,18633,92,226929
22021,0.000127,74.125.24.0-255,3961,22594,92,226929
22022,0.00013,172.31.47.0-255,66,22660,92,226929
22023,0.000288,74.125.24.0-255,1484,24144,92,226929
22024,0.000293,172.31.47.0-255,66,24210,92,226929
22025,0.000297,74.125.24.0-255,2902,27112,92,226929
22026,0.0003,172.31.47.0-255,66,27178,92,226929
22027,0.000302,74.125.24.0-255,1484,28662,92,226929
22028,0.000304,172.31.47.0-255,66,28728,92,226929
22029,0.000325,74.125.24.0-255,4320,33048,92,226929
22030,0.000329,172.31.47.0-255,66,33114,92,226929
22031,0.000333,74.125.24.0-255,2902,36016,92,226929
22032,0.000335,172.31.47.0-255,66,36082,92,226929
22033,0.000358,172.31.47.0-255,66,36148,92,226929
22034,0.000382,172.31.47.0-255,66,36214,92,226929
22035,0.000401,74.125.24.0-255,2481,38695,92,226929
22036,0.000404,172.31.47.0-255,66,38761,92,226929
22037,0.000445,74.125.24.0-255,130,38891,92,226929
22038,0.000677,172.31.47.0-255,66,38957,92,226929
22039,0.00105,74.125.24.0-255,1484,40441,92,226929
22040,0.001056,172.31.47.0-255,66,40507,92,226929
22041,0.001064,74.125.24.0-255,2902,43409,92,226929
22042,0.001086,74.125.24.0-255,5738,49147,92,226929
22043,0.00109,74.125.24.0-255,2902,52049,92,226929
22044,0.001115,74.125.24.0-255,7156,59205,92,226929
22045,0.001134,74.125.24.0-255,4320,63525,92,226929
22046,0.002411,74.125.24.0-255,1484,65009,92,226929
22047,0.002428,74.125.24.0-255,2902,67911,92,226929
22048,0.002442,74.125.24.0-255,1484,69395,92,226929
22049,0.002454,74.125.24.0-255,4320,73715,92,226929
22050,0.002456,74.125.24.0-255,1484,75199,92,226929
22051,0.002895,74.125.24.0-255,1484,76683,92,226929
22052,0.002906,74.125.24.0-255,2902,79585,92,226929
22053,0.002924,74.125.24.0-255,5738,85323,92,226929
22054,0.00294,74.125.24.0-255,2902,88225,92,226929
22055,0.002953,74.125.24.0-255,4320,92545,92,226929
22056,0.002968,74.125.24.0-255,5738,98283,92,226929
22057,0.002986,74.125.24.0-255,1484,99767,92,226929
22058,0.003158,74.125.24.0-255,1484,101251,92,226929
22059,0.003173,74.125.24.0-255,2902,104153,92,226929
22060,0.003191,74.125.24.0-255,1484,105637,92,226929
22061,0.003203,74.125.24.0-255,4320,109957,92,226929
22062,0.003222,74.125.24.0-255,5738,115695,92,226929
22063,0.00324,74.125.24.0-255,4320,120015,92,226929
22064,0.003251,74.125.24.0-255,2902,122917,92,226929
22065,0.003283,74.125.24.0-255,2902,125819,92,226929
22066,0.003697,74.125.24.0-255,1484,127303,92,226929
22067,0.003715,74.125.24.0-255,2902,130205,92,226929
22068,0.003733,74.125.24.0-255,5738,135943,92,226929
22069,0.003744,74.125.24.0-255,4320,140263,92,226929
22070,0.003991,74.125.24.0-255,1484,141747,92,226929
22071,0.004004,74.125.24.0-255,1484,143231,92,226929
22072,0.004027,74.125.24.0-255,1484,144715,92,226929
22073,0.004033,74.125.24.0-255,5738,150453,92,226929
22074,0.004035,74.125.24.0-255,1484,151937,92,226929
22075,0.004058,74.125.24.0-255,5738,157675,92,226929
22076,0.004084,74.125.24.0-255,7156,164831,92,226929
22077,0.004115,74.125.24.0-255,2902,167733,92,226929
22078,0.004135,74.125.24.0-255,6438,174171,92,226929
22079,0.0046,74.125.24.0-255,1484,175655,92,226929
22080,0.004607,74.125.24.0-255,2902,178557,92,226929
22081,0.004668,74.125.24.0-255,5738,184295,92,226929
22082,0.004693,74.125.24.0-255,4320,188615,92,226929
22083,0.004709,74.125.24.0-255,4320,192935,92,226929
22084,0.00472,74.125.24.0-255,4320,197255,92,226929
22085,0.004776,74.125.24.0-255,1484,198739,92,226929
22086,0.004779,172.31.47.0-255,66,198805,92,226929
22087,0.004815,172.31.47.0-255,66,198871,92,226929
22088,0.004829,74.125.24.0-255,5020,203891,92,226929
22089,0.004831,74.125.24.0-255,1484,205375,92,226929
22090,0.004853,172.31.47.0-255,66,205441,92,226929
22091,0.004887,74.125.24.0-255,5738,211179,92,226929
22092,0.004887,172.31.47.0-255,66,211245,92,226929
22093,0.004892,172.31.47.0-255,66,211311,92,226929
22094,0.004912,74.125.24.0-255,6438,217749,92,226929
22095,0.004924,74.125.24.0-255,1484,219233,92,226929
22096,0.004926,172.31.47.0-255,66,219299,92,226929
22097,0.004962,172.31.47.0-255,66,219365,92,226929
22098,0.00497,74.125.24.0-255,7156,226521,92,226929
22099,0.004977,172.31.47.0-255,66,226587,92,226929
22100,0.004984,74.125.24.0-255,105,226692,92,226929
22101,0.004991,172.31.47.0-255,66,226758,92,226929
22102,0.007388,172.31.47.0-255,105,226863,92,226929
22103,0.009638,74.125.24.0-255,66,226929,92,226929
22104,0.0,172.217.194.0-255,153,153,92,205854
22105,2.6e-05,172.31.47.0-255,66,219,92,205854
22106,3.3e-05,172.217.194.0-255,1484,1703,92,205854
22107,3.6e-05,172.31.47.0-255,66,1769,92,205854
22108,4.1e-05,172.217.194.0-255,2902,4671,92,205854
22109,4.4e-05,172.31.47.0-255,66,4737,92,205854
22110,4.8e-05,172.217.194.0-255,2902,7639,92,205854
22111,5.1e-05,172.31.47.0-255,66,7705,92,205854
22112,9.9e-05,172.217.194.0-255,4320,12025,92,205854
22113,0.000103,172.31.47.0-255,66,12091,92,205854
22114,0.000119,172.217.194.0-255,1975,14066,92,205854
22115,0.000122,172.31.47.0-255,66,14132,92,205854
22116,0.000249,172.217.194.0-255,1484,15616,92,205854
22117,0.000252,172.31.47.0-255,66,15682,92,205854
22118,0.000258,172.217.194.0-255,2902,18584,92,205854
22119,0.00026,172.31.47.0-255,66,18650,92,205854
22120,0.000272,172.217.194.0-255,1484,20134,92,205854
22121,0.000274,172.31.47.0-255,66,20200,92,205854
22122,0.000297,172.217.194.0-255,4320,24520,92,205854
22123,0.0003,172.31.47.0-255,66,24586,92,205854
22124,0.000307,172.217.194.0-255,6797,31383,92,205854
22125,0.00031,172.31.47.0-255,66,31449,92,205854
22126,0.000509,172.217.194.0-255,1484,32933,92,205854
22127,0.000513,172.31.47.0-255,66,32999,92,205854
22128,0.000522,172.217.194.0-255,2902,35901,92,205854
22129,0.000524,172.31.47.0-255,66,35967,92,205854
22130,0.000539,172.217.194.0-255,4320,40287,92,205854
22131,0.000542,172.31.47.0-255,66,40353,92,205854
22132,0.000568,172.217.194.0-255,1484,41837,92,205854
22133,0.000571,172.31.47.0-255,66,41903,92,205854
22134,0.000578,172.217.194.0-255,6797,48700,92,205854
22135,0.00058,172.31.47.0-255,66,48766,92,205854
22136,0.000598,172.217.194.0-255,4320,53086,92,205854
22137,0.000601,172.31.47.0-255,66,53152,92,205854
22138,0.000627,172.31.47.0-255,66,53218,92,205854
22139,0.00065,172.217.194.0-255,2543,55761,92,205854
22140,0.000654,172.31.47.0-255,66,55827,92,205854
22141,0.00075,172.217.194.0-255,647,56474,92,205854
22142,0.000839,172.217.194.0-255,1484,57958,92,205854
22143,0.000844,172.31.47.0-255,66,58024,92,205854
22144,0.000849,172.217.194.0-255,2902,60926,92,205854
22145,0.000851,172.31.47.0-255,66,60992,92,205854
22146,0.000853,172.217.194.0-255,1484,62476,92,205854
22147,0.000881,172.217.194.0-255,4320,66796,92,205854
22148,0.000884,172.31.47.0-255,66,66862,92,205854
22149,0.000887,172.217.194.0-255,1484,68346,92,205854
22150,0.000925,172.31.47.0-255,66,68412,92,205854
22151,0.000934,172.31.47.0-255,66,68478,92,205854
22152,0.000983,172.31.47.0-255,66,68544,92,205854
22153,0.000993,172.31.47.0-255,66,68610,92,205854
22154,0.001028,172.31.47.0-255,66,68676,92,205854
22155,0.001047,172.217.194.0-255,7156,75832,92,205854
22156,0.00105,172.31.47.0-255,66,75898,92,205854
22157,0.001064,172.217.194.0-255,2902,78800,92,205854
22158,0.001066,172.31.47.0-255,66,78866,92,205854
22159,0.001069,172.217.194.0-255,766,79632,92,205854
22160,0.001075,172.217.194.0-255,5738,85370,92,205854
22161,0.001077,172.31.47.0-255,66,85436,92,205854
22162,0.001081,172.217.194.0-255,2902,88338,92,205854
22163,0.001083,172.31.47.0-255,66,88404,92,205854
22164,0.001106,172.217.194.0-255,4320,92724,92,205854
22165,0.001109,172.31.47.0-255,66,92790,92,205854
22166,0.001114,172.217.194.0-255,5738,98528,92,205854
22167,0.001117,172.31.47.0-255,66,98594,92,205854
22168,0.001155,172.217.194.0-255,6438,105032,92,205854
22169,0.001188,172.31.47.0-255,66,105098,92,205854
22170,0.00119,172.31.47.0-255,66,105164,92,205854
22171,0.001224,172.31.47.0-255,66,105230,92,205854
22172,0.001237,172.31.47.0-255,66,105296,92,205854
22173,0.001248,172.217.194.0-255,1484,106780,92,205854
22174,0.00125,172.217.194.0-255,766,107546,92,205854
22175,0.001252,172.31.47.0-255,66,107612,92,205854
22176,0.00129,172.217.194.0-255,2902,110514,92,205854
22177,0.001293,172.31.47.0-255,66,110580,92,205854
22178,0.001321,172.31.47.0-255,66,110646,92,205854
22179,0.00135,172.217.194.0-255,2902,113548,92,205854
22180,0.001352,172.31.47.0-255,66,113614,92,205854
22181,0.001364,172.31.47.0-255,66,113680,92,205854
22182,0.001366,172.217.194.0-255,1484,115164,92,205854
22183,0.001369,172.217.194.0-255,2902,118066,92,205854
22184,0.001372,172.31.47.0-255,66,118132,92,205854
22185,0.001377,172.217.194.0-255,5738,123870,92,205854
22186,0.001379,172.31.47.0-255,66,123936,92,205854
22187,0.001389,172.217.194.0-255,7156,131092,92,205854
22188,0.001391,172.31.47.0-255,66,131158,92,205854
22189,0.001393,172.217.194.0-255,1484,132642,92,205854
22190,0.001427,172.31.47.0-255,66,132708,92,205854
22191,0.001442,172.217.194.0-255,1484,134192,92,205854
22192,0.001462,172.217.194.0-255,2184,136376,92,205854
22193,0.001464,172.31.47.0-255,66,136442,92,205854
22194,0.001529,172.217.194.0-255,1484,137926,92,205854
22195,0.001547,172.217.194.0-255,2902,140828,92,205854
22196,0.00155,172.31.47.0-255,66,140894,92,205854
22197,0.001555,172.217.194.0-255,5738,146632,92,205854
22198,0.001557,172.31.47.0-255,66,146698,92,205854
22199,0.001606,172.31.47.0-255,66,146764,92,205854
22200,0.001616,172.31.47.0-255,66,146830,92,205854
22201,0.00165,172.217.194.0-255,1484,148314,92,205854
22202,0.001679,172.217.194.0-255,2902,151216,92,205854
22203,0.001682,172.31.47.0-255,66,151282,92,205854
22204,0.001688,172.217.194.0-255,5738,157020,92,205854
22205,0.001689,172.31.47.0-255,66,157086,92,205854
22206,0.001707,172.217.194.0-255,7156,164242,92,205854
22207,0.001709,172.31.47.0-255,66,164308,92,205854
22208,0.001726,172.217.194.0-255,2902,167210,92,205854
22209,0.001728,172.31.47.0-255,66,167276,92,205854
22210,0.001749,172.217.194.0-255,5738,173014,92,205854
22211,0.001751,172.31.47.0-255,66,173080,92,205854
22212,0.001774,172.31.47.0-255,66,173146,92,205854
22213,0.001784,172.217.194.0-255,2902,176048,92,205854
22214,0.001786,172.31.47.0-255,66,176114,92,205854
22215,0.001803,172.217.194.0-255,2184,178298,92,205854
22216,0.001805,172.31.47.0-255,66,178364,92,205854
22217,0.001808,172.217.194.0-255,2902,181266,92,205854
22218,0.001809,172.31.47.0-255,66,181332,92,205854
22219,0.001869,172.31.47.0-255,66,181398,92,205854
22220,0.00189,172.217.194.0-255,5738,187136,92,205854
22221,0.001908,172.31.47.0-255,66,187202,92,205854
22222,0.001914,172.31.47.0-255,66,187268,92,205854
22223,0.00192,172.217.194.0-255,7156,194424,92,205854
22224,0.001921,172.31.47.0-255,66,194490,92,205854
22225,0.00194,172.217.194.0-255,5020,199510,92,205854
22226,0.001949,172.31.47.0-255,66,199576,92,205854
22227,0.001952,172.31.47.0-255,66,199642,92,205854
22228,0.00196,172.217.194.0-255,5738,205380,92,205854
22229,0.001962,172.31.47.0-255,66,205446,92,205854
22230,0.001989,172.31.47.0-255,66,205512,92,205854
22231,0.001991,172.217.194.0-255,105,205617,92,205854
22232,0.003874,172.31.47.0-255,66,205683,92,205854
22233,0.003913,172.31.47.0-255,105,205788,92,205854
22234,0.005902,172.217.194.0-255,66,205854,92,205854
22235,0.0,74.125.24.0-255,153,153,92,224275
22236,2.4e-05,172.31.47.0-255,66,219,92,224275
22237,3e-05,74.125.24.0-255,1484,1703,92,224275
22238,3.3e-05,172.31.47.0-255,66,1769,92,224275
22239,3.8e-05,74.125.24.0-255,2902,4671,92,224275
22240,4.7e-05,172.31.47.0-255,66,4737,92,224275
22241,5.3e-05,74.125.24.0-255,7156,11893,92,224275
22242,5.5e-05,172.31.47.0-255,66,11959,92,224275
22243,8.6e-05,74.125.24.0-255,2173,14132,92,224275
22244,8.8e-05,172.31.47.0-255,66,14198,92,224275
22245,0.000166,74.125.24.0-255,1484,15682,92,224275
22246,0.00017,172.31.47.0-255,66,15748,92,224275
22247,0.000175,74.125.24.0-255,2902,18650,92,224275
22248,0.000178,172.31.47.0-255,66,18716,92,224275
22249,0.000182,74.125.24.0-255,2902,21618,92,224275
22250,0.000189,172.31.47.0-255,66,21684,92,224275
22251,0.000215,74.125.24.0-255,2902,24586,92,224275
22252,0.000218,172.31.47.0-255,66,24652,92,224275
22253,0.000224,74.125.24.0-255,7156,31808,92,224275
22254,0.000226,172.31.47.0-255,66,31874,92,224275
22255,0.000256,74.125.24.0-255,6797,38671,92,224275
22256,0.00026,172.31.47.0-255,66,38737,92,224275
22257,0.000277,172.31.47.0-255,66,38803,92,224275
22258,0.000313,74.125.24.0-255,4320,43123,92,224275
22259,0.000317,172.31.47.0-255,66,43189,92,224275
22260,0.000353,172.31.47.0-255,66,43255,92,224275
22261,0.000355,74.125.24.0-255,362,43617,92,224275
22262,0.000358,172.31.47.0-255,66,43683,92,224275
22263,0.000382,74.125.24.0-255,129,43812,92,224275
22264,0.000386,172.31.47.0-255,66,43878,92,224275
22265,0.000554,74.125.24.0-255,1484,45362,92,224275
22266,0.000557,172.31.47.0-255,66,45428,92,224275
22267,0.000562,74.125.24.0-255,2902,48330,92,224275
22268,0.000568,172.31.47.0-255,66,48396,92,224275
22269,0.000598,74.125.24.0-255,5738,54134,92,224275
22270,0.000604,74.125.24.0-255,7156,61290,92,224275
22271,0.000604,172.31.47.0-255,66,61356,92,224275
22272,0.000609,172.31.47.0-255,66,61422,92,224275
22273,0.000633,74.125.24.0-255,5738,67160,92,224275
22274,0.000642,74.125.24.0-255,5738,72898,92,224275
22275,0.000643,172.31.47.0-255,66,72964,92,224275
22276,0.000648,172.31.47.0-255,66,73030,92,224275
22277,0.000658,74.125.24.0-255,5020,78050,92,224275
22278,0.000668,172.31.47.0-255,66,78116,92,224275
22279,0.00068,74.125.24.0-255,1484,79600,92,224275
22280,0.000687,74.125.24.0-255,2902,82502,92,224275
22281,0.000691,172.31.47.0-255,66,82568,92,224275
22282,0.00072,74.125.24.0-255,5738,88306,92,224275
22283,0.000724,74.125.24.0-255,2902,91208,92,224275
22284,0.000729,172.31.47.0-255,66,91274,92,224275
22285,0.000768,74.125.24.0-255,7156,98430,92,224275
22286,0.000772,172.31.47.0-255,66,98496,92,224275
22287,0.000802,74.125.24.0-255,3602,102098,92,224275
22288,0.000805,172.31.47.0-255,66,102164,92,224275
22289,0.00081,74.125.24.0-255,4320,106484,92,224275
22290,0.000813,172.31.47.0-255,66,106550,92,224275
22291,0.000846,74.125.24.0-255,5738,112288,92,224275
22292,0.00085,172.31.47.0-255,66,112354,92,224275
22293,0.000887,74.125.24.0-255,2902,115256,92,224275
22294,0.000896,172.31.47.0-255,66,115322,92,224275
22295,0.000925,172.31.47.0-255,66,115388,92,224275
22296,0.000936,74.125.24.0-255,4320,119708,92,224275
22297,0.00094,172.31.47.0-255,66,119774,92,224275
22298,0.000969,74.125.24.0-255,5738,125512,92,224275
22299,0.000972,172.31.47.0-255,66,125578,92,224275
22300,0.000988,172.31.47.0-255,66,125644,92,224275
22301,0.001032,172.31.47.0-255,66,125710,92,224275
22302,0.001054,74.125.24.0-255,1484,127194,92,224275
22303,0.001058,74.125.24.0-255,2902,130096,92,224275
22304,0.001061,172.31.47.0-255,66,130162,92,224275
22305,0.001081,74.125.24.0-255,5738,135900,92,224275
22306,0.001087,74.125.24.0-255,5738,141638,92,224275
22307,0.00109,172.31.47.0-255,66,141704,92,224275
22308,0.0011,74.125.24.0-255,1484,143188,92,224275
22309,0.001142,172.31.47.0-255,66,143254,92,224275
22310,0.001143,74.125.24.0-255,2184,145438,92,224275
22311,0.001157,172.31.47.0-255,66,145504,92,224275
22312,0.001185,74.125.24.0-255,2902,148406,92,224275
22313,0.001192,172.31.47.0-255,66,148472,92,224275
22314,0.001233,74.125.24.0-255,4320,152792,92,224275
22315,0.001236,172.31.47.0-255,66,152858,92,224275
22316,0.001255,172.31.47.0-255,66,152924,92,224275
22317,0.001259,172.31.47.0-255,66,152990,92,224275
22318,0.001279,74.125.24.0-255,1484,154474,92,224275
22319,0.001297,172.31.47.0-255,66,154540,92,224275
22320,0.001298,74.125.24.0-255,4320,158860,92,224275
22321,0.00131,172.31.47.0-255,66,158926,92,224275
22322,0.001338,172.31.47.0-255,66,158992,92,224275
22323,0.001345,74.125.24.0-255,1484,160476,92,224275
22324,0.001375,74.125.24.0-255,351,160827,92,224275
22325,0.001381,172.31.47.0-255,66,160893,92,224275
22326,0.001404,74.125.24.0-255,1484,162377,92,224275
22327,0.001407,74.125.24.0-255,1484,163861,92,224275
22328,0.001417,172.31.47.0-255,66,163927,92,224275
22329,0.001423,74.125.24.0-255,2902,166829,92,224275
22330,0.001428,172.31.47.0-255,66,166895,92,224275
22331,0.001457,74.125.24.0-255,5738,172633,92,224275
22332,0.001459,172.31.47.0-255,66,172699,92,224275
22333,0.001463,172.31.47.0-255,66,172765,92,224275
22334,0.001502,74.125.24.0-255,5738,178503,92,224275
22335,0.00152,172.31.47.0-255,66,178569,92,224275
22336,0.001522,74.125.24.0-255,6438,185007,92,224275
22337,0.001533,172.31.47.0-255,66,185073,92,224275
22338,0.001554,74.125.24.0-255,7156,192229,92,224275
22339,0.001556,74.125.24.0-255,1484,193713,92,224275
22340,0.001566,172.31.47.0-255,66,193779,92,224275
22341,0.001584,74.125.24.0-255,7156,200935,92,224275
22342,0.001588,172.31.47.0-255,66,201001,92,224275
22343,0.001591,74.125.24.0-255,7156,208157,92,224275
22344,0.001598,172.31.47.0-255,66,208223,92,224275
22345,0.001625,74.125.24.0-255,766,208989,92,224275
22346,0.001626,172.31.47.0-255,66,209055,92,224275
22347,0.001675,172.31.47.0-255,66,209121,92,224275
22348,0.001697,74.125.24.0-255,5738,214859,92,224275
22349,0.001705,172.31.47.0-255,66,214925,92,224275
22350,0.001722,74.125.24.0-255,7156,222081,92,224275
22351,0.001726,74.125.24.0-255,1484,223565,92,224275
22352,0.001726,172.31.47.0-255,66,223631,92,224275
22353,0.001789,172.31.47.0-255,66,223697,92,224275
22354,0.001793,74.125.24.0-255,236,223933,92,224275
22355,0.001795,74.125.24.0-255,105,224038,92,224275
22356,0.00339,172.31.47.0-255,66,224104,92,224275
22357,0.003416,172.31.47.0-255,105,224209,92,224275
22358,0.005623,74.125.24.0-255,66,224275,92,224275
22359,0.0,216.58.203.0-255,153,153,92,80594
22360,1.9e-05,172.31.47.0-255,66,219,92,80594
22361,2.6e-05,216.58.203.0-255,1484,1703,92,80594
22362,3.1e-05,172.31.47.0-255,66,1769,92,80594
22363,3.7e-05,216.58.203.0-255,2902,4671,92,80594
22364,4e-05,172.31.47.0-255,66,4737,92,80594
22365,5.7e-05,216.58.203.0-255,7156,11893,92,80594
22366,6.1e-05,172.31.47.0-255,66,11959,92,80594
22367,0.000117,216.58.203.0-255,2146,14105,92,80594
22368,0.00012,172.31.47.0-255,66,14171,92,80594
22369,0.000571,216.58.203.0-255,1484,15655,92,80594
22370,0.000578,172.31.47.0-255,66,15721,92,80594
22371,0.000588,216.58.203.0-255,2902,18623,92,80594
22372,0.000591,172.31.47.0-255,66,18689,92,80594
22373,0.000598,216.58.203.0-255,5738,24427,92,80594
22374,0.0006,172.31.47.0-255,66,24493,92,80594
22375,0.000672,216.58.203.0-255,6797,31290,92,80594
22376,0.000677,172.31.47.0-255,66,31356,92,80594
22377,0.000734,216.58.203.0-255,2902,34258,92,80594
22378,0.000737,172.31.47.0-255,66,34324,92,80594
22379,0.000775,216.58.203.0-255,2902,37226,92,80594
22380,0.000778,172.31.47.0-255,66,37292,92,80594
22381,0.000809,172.31.47.0-255,66,37358,92,80594
22382,0.000905,216.58.203.0-255,2902,40260,92,80594
22383,0.000909,172.31.47.0-255,66,40326,92,80594
22384,0.000928,216.58.203.0-255,5738,46064,92,80594
22385,0.000932,172.31.47.0-255,66,46130,92,80594
22386,0.001005,216.58.203.0-255,5738,51868,92,80594
22387,0.001011,172.31.47.0-255,66,51934,92,80594
22388,0.001029,216.58.203.0-255,5312,57246,92,80594
22389,0.001032,172.31.47.0-255,66,57312,92,80594
22390,0.002681,216.58.203.0-255,4320,61632,92,80594
22391,0.002703,216.58.203.0-255,1484,63116,92,80594
22392,0.003264,172.31.47.0-255,66,63182,92,80594
22393,0.004913,216.58.203.0-255,5738,68920,92,80594
22394,0.004919,172.31.47.0-255,66,68986,92,80594
22395,0.006574,216.58.203.0-255,5738,74724,92,80594
22396,0.00728,172.31.47.0-255,66,74790,92,80594
22397,0.008938,216.58.203.0-255,5738,80528,92,80594
22398,0.008946,172.31.47.0-255,66,80594,92,80594
22399,0.0,74.125.200.0-255,153,153,92,246389
22400,8e-05,172.31.47.0-255,66,219,92,246389
22401,8.7e-05,74.125.200.0-255,1484,1703,92,246389
22402,9.2e-05,172.31.47.0-255,66,1769,92,246389
22403,9.6e-05,74.125.200.0-255,2902,4671,92,246389
22404,0.000106,172.31.47.0-255,66,4737,92,246389
22405,0.000113,74.125.200.0-255,7156,11893,92,246389
22406,0.000116,172.31.47.0-255,66,11959,92,246389
22407,0.000119,74.125.200.0-255,2102,14061,92,246389
22408,0.000122,172.31.47.0-255,66,14127,92,246389
22409,0.000126,74.125.200.0-255,2902,17029,92,246389
22410,0.000128,172.31.47.0-255,66,17095,92,246389
22411,0.000134,74.125.200.0-255,7156,24251,92,246389
22412,0.000138,172.31.47.0-255,66,24317,92,246389
22413,0.000145,74.125.200.0-255,6797,31114,92,246389
22414,0.000148,172.31.47.0-255,66,31180,92,246389
22415,0.00025,74.125.200.0-255,1484,32664,92,246389
22416,0.000256,172.31.47.0-255,66,32730,92,246389
22417,0.000262,74.125.200.0-255,2902,35632,92,246389
22418,0.000265,172.31.47.0-255,66,35698,92,246389
22419,0.000269,74.125.200.0-255,2902,38600,92,246389
22420,0.000271,172.31.47.0-255,66,38666,92,246389
22421,0.000299,74.125.200.0-255,1484,40150,92,246389
22422,0.000301,172.31.47.0-255,66,40216,92,246389
22423,0.000308,74.125.200.0-255,5738,45954,92,246389
22424,0.00031,172.31.47.0-255,66,46020,92,246389
22425,0.000348,172.31.47.0-255,66,46086,92,246389
22426,0.000377,74.125.200.0-255,4320,50406,92,246389
22427,0.00038,172.31.47.0-255,66,50472,92,246389
22428,0.000399,74.125.200.0-255,4237,54709,92,246389
22429,0.000403,172.31.47.0-255,66,54775,92,246389
22430,0.000406,74.125.200.0-255,129,54904,92,246389
22431,0.000456,74.125.200.0-255,1484,56388,92,246389
22432,0.00046,172.31.47.0-255,66,56454,92,246389
22433,0.000463,74.125.200.0-255,1484,57938,92,246389
22434,0.000487,74.125.200.0-255,2902,60840,92,246389
22435,0.000491,172.31.47.0-255,66,60906,92,246389
22436,0.00051,74.125.200.0-255,2902,63808,92,246389
22437,0.000513,172.31.47.0-255,66,63874,92,246389
22438,0.000542,74.125.200.0-255,2902,66776,92,246389
22439,0.000545,172.31.47.0-255,66,66842,92,246389
22440,0.000552,74.125.200.0-255,7156,73998,92,246389
22441,0.000555,172.31.47.0-255,66,74064,92,246389
22442,0.000572,74.125.200.0-255,2902,76966,92,246389
22443,0.000573,172.31.47.0-255,66,77032,92,246389
22444,0.000577,172.31.47.0-255,66,77098,92,246389
22445,0.000607,74.125.200.0-255,3303,80401,92,246389
22446,0.00061,172.31.47.0-255,66,80467,92,246389
22447,0.000801,74.125.200.0-255,1484,81951,92,246389
22448,0.000817,74.125.200.0-255,2902,84853,92,246389
22449,0.00082,172.31.47.0-255,66,84919,92,246389
22450,0.000824,74.125.200.0-255,1484,86403,92,246389
22451,0.000851,74.125.200.0-255,4320,90723,92,246389
22452,0.000854,172.31.47.0-255,66,90789,92,246389
22453,0.000859,74.125.200.0-255,4320,95109,92,246389
22454,0.000861,172.31.47.0-255,66,95175,92,246389
22455,0.000873,74.125.200.0-255,5738,100913,92,246389
22456,0.000875,172.31.47.0-255,66,100979,92,246389
22457,0.000914,172.31.47.0-255,66,101045,92,246389
22458,0.000917,74.125.200.0-255,1484,102529,92,246389
22459,0.000973,74.125.200.0-255,766,103295,92,246389
22460,0.000977,172.31.47.0-255,66,103361,92,246389
22461,0.001072,74.125.200.0-255,1484,104845,92,246389
22462,0.001089,74.125.200.0-255,2902,107747,92,246389
22463,0.001092,172.31.47.0-255,66,107813,92,246389
22464,0.001118,74.125.200.0-255,5738,113551,92,246389
22465,0.001121,172.31.47.0-255,66,113617,92,246389
22466,0.001129,74.125.200.0-255,7156,120773,92,246389
22467,0.001131,172.31.47.0-255,66,120839,92,246389
22468,0.001155,74.125.200.0-255,4320,125159,92,246389
22469,0.001159,172.31.47.0-255,66,125225,92,246389
22470,0.001211,74.125.200.0-255,2902,128127,92,246389
22471,0.001215,172.31.47.0-255,66,128193,92,246389
22472,0.001245,74.125.200.0-255,4320,132513,92,246389
22473,0.001249,172.31.47.0-255,66,132579,92,246389
22474,0.001279,74.125.200.0-255,5020,137599,92,246389
22475,0.001283,172.31.47.0-255,66,137665,92,246389
22476,0.001407,74.125.200.0-255,1484,139149,92,246389
22477,0.001463,74.125.200.0-255,2902,142051,92,246389
22478,0.001466,172.31.47.0-255,66,142117,92,246389
22479,0.001472,74.125.200.0-255,4320,146437,92,246389
22480,0.001474,172.31.47.0-255,66,146503,92,246389
22481,0.001497,74.125.200.0-255,2902,149405,92,246389
22482,0.0015,172.31.47.0-255,66,149471,92,246389
22483,0.001531,74.125.200.0-255,5738,155209,92,246389
22484,0.001535,74.125.200.0-255,2902,158111,92,246389
22485,0.001535,172.31.47.0-255,66,158177,92,246389
22486,0.001539,172.31.47.0-255,66,158243,92,246389
22487,0.001577,74.125.200.0-255,4320,162563,92,246389
22488,0.00158,74.125.200.0-255,1484,164047,92,246389
22489,0.001581,172.31.47.0-255,66,164113,92,246389
22490,0.001583,74.125.200.0-255,2902,167015,92,246389
22491,0.001585,172.31.47.0-255,66,167081,92,246389
22492,0.001613,74.125.200.0-255,2902,169983,92,246389
22493,0.001616,172.31.47.0-255,66,170049,92,246389
22494,0.001654,74.125.200.0-255,2184,172233,92,246389
22495,0.001657,172.31.47.0-255,66,172299,92,246389
22496,0.001798,74.125.200.0-255,1484,173783,92,246389
22497,0.001809,74.125.200.0-255,2902,176685,92,246389
22498,0.001813,172.31.47.0-255,66,176751,92,246389
22499,0.001858,74.125.200.0-255,5738,182489,92,246389
22500,0.001862,172.31.47.0-255,66,182555,92,246389
22501,0.001873,172.31.47.0-255,66,182621,92,246389
22502,0.00191,172.31.47.0-255,66,182687,92,246389
22503,0.001927,74.125.200.0-255,2902,185589,92,246389
22504,0.001929,172.31.47.0-255,66,185655,92,246389
22505,0.001933,74.125.200.0-255,2184,187839,92,246389
22506,0.001935,172.31.47.0-255,66,187905,92,246389
22507,0.002138,74.125.200.0-255,1484,189389,92,246389
22508,0.002144,74.125.200.0-255,1484,190873,92,246389
22509,0.002147,172.31.47.0-255,66,190939,92,246389
22510,0.002177,74.125.200.0-255,1484,192423,92,246389
22511,0.002182,74.125.200.0-255,4320,196743,92,246389
22512,0.002185,172.31.47.0-255,66,196809,92,246389
22513,0.002201,74.125.200.0-255,5738,202547,92,246389
22514,0.002204,172.31.47.0-255,66,202613,92,246389
22515,0.002239,172.31.47.0-255,66,202679,92,246389
22516,0.002265,74.125.200.0-255,4320,206999,92,246389
22517,0.00227,172.31.47.0-255,66,207065,92,246389
22518,0.002298,74.125.200.0-255,6438,213503,92,246389
22519,0.002301,172.31.47.0-255,66,213569,92,246389
22520,0.002306,74.125.200.0-255,4320,217889,92,246389
22521,0.002309,172.31.47.0-255,66,217955,92,246389
22522,0.002349,172.31.47.0-255,66,218021,92,246389
22523,0.002356,74.125.200.0-255,5738,223759,92,246389
22524,0.002358,172.31.47.0-255,66,223825,92,246389
22525,0.002391,74.125.200.0-255,5020,228845,92,246389
22526,0.002395,172.31.47.0-255,66,228911,92,246389
22527,0.004767,74.125.200.0-255,1484,230395,92,246389
22528,0.004782,74.125.200.0-255,4320,234715,92,246389
22529,0.004786,172.31.47.0-255,66,234781,92,246389
22530,0.007212,74.125.200.0-255,5738,240519,92,246389
22531,0.007221,172.31.47.0-255,66,240585,92,246389
22532,0.009614,74.125.200.0-255,5738,246323,92,246389
22533,0.009623,172.31.47.0-255,66,246389,92,246389
22534,0.0,172.217.194.0-255,153,153,92,121373
22535,1.7e-05,172.31.47.0-255,66,219,92,121373
22536,2.4e-05,172.217.194.0-255,1484,1703,92,121373
22537,2.7e-05,172.31.47.0-255,66,1769,92,121373
22538,3.2e-05,172.217.194.0-255,2902,4671,92,121373
22539,3.4e-05,172.31.47.0-255,66,4737,92,121373
22540,6.4e-05,172.217.194.0-255,4320,9057,92,121373
22541,6.7e-05,172.31.47.0-255,66,9123,92,121373
22542,8.6e-05,172.217.194.0-255,2902,12025,92,121373
22543,8.9e-05,172.31.47.0-255,66,12091,92,121373
22544,9.2e-05,172.217.194.0-255,2141,14232,92,121373
22545,9.4e-05,172.31.47.0-255,66,14298,92,121373
22546,0.000104,172.217.194.0-255,1484,15782,92,121373
22547,0.000106,172.31.47.0-255,66,15848,92,121373
22548,0.000126,172.217.194.0-255,1484,17332,92,121373
22549,0.000128,172.31.47.0-255,66,17398,92,121373
22550,0.000133,172.217.194.0-255,4320,21718,92,121373
22551,0.000134,172.31.47.0-255,66,21784,92,121373
22552,0.000139,172.217.194.0-255,4320,26104,92,121373
22553,0.000141,172.31.47.0-255,66,26170,92,121373
22554,0.000164,172.217.194.0-255,4320,30490,92,121373
22555,0.000166,172.31.47.0-255,66,30556,92,121373
22556,0.000168,172.217.194.0-255,1125,31681,92,121373
22557,0.00017,172.31.47.0-255,66,31747,92,121373
22558,0.00022,172.217.194.0-255,1484,33231,92,121373
22559,0.000222,172.31.47.0-255,66,33297,92,121373
22560,0.000227,172.217.194.0-255,2902,36199,92,121373
22561,0.000229,172.31.47.0-255,66,36265,92,121373
22562,0.000243,172.217.194.0-255,4320,40585,92,121373
22563,0.000245,172.31.47.0-255,66,40651,92,121373
22564,0.000264,172.217.194.0-255,1484,42135,92,121373
22565,0.000266,172.31.47.0-255,66,42201,92,121373
22566,0.000271,172.217.194.0-255,4320,46521,92,121373
22567,0.000273,172.31.47.0-255,66,46587,92,121373
22568,0.000294,172.217.194.0-255,2543,49130,92,121373
22569,0.000296,172.31.47.0-255,66,49196,92,121373
22570,0.000302,172.217.194.0-255,7156,56352,92,121373
22571,0.000304,172.31.47.0-255,66,56418,92,121373
22572,0.000333,172.217.194.0-255,1484,57902,92,121373
22573,0.000335,172.31.47.0-255,66,57968,92,121373
22574,0.000365,172.31.47.0-255,66,58034,92,121373
22575,0.000367,172.217.194.0-255,339,58373,92,121373
22576,0.000369,172.31.47.0-255,66,58439,92,121373
22577,0.000688,172.217.194.0-255,119,58558,92,121373
22578,0.000693,172.31.47.0-255,66,58624,92,121373
22579,0.000788,172.217.194.0-255,381,59005,92,121373
22580,0.000791,172.31.47.0-255,66,59071,92,121373
22581,0.001023,172.217.194.0-255,1484,60555,92,121373
22582,0.001028,172.31.47.0-255,66,60621,92,121373
22583,0.001035,172.217.194.0-255,2902,63523,92,121373
22584,0.001036,172.31.47.0-255,66,63589,92,121373
22585,0.001052,172.217.194.0-255,4320,67909,92,121373
22586,0.001054,172.31.47.0-255,66,67975,92,121373
22587,0.001074,172.217.194.0-255,1484,69459,92,121373
22588,0.001076,172.31.47.0-255,66,69525,92,121373
22589,0.001103,172.31.47.0-255,66,69591,92,121373
22590,0.001117,172.217.194.0-255,1484,71075,92,121373
22591,0.001119,172.31.47.0-255,66,71141,92,121373
22592,0.001136,172.217.194.0-255,5738,76879,92,121373
22593,0.001138,172.31.47.0-255,66,76945,92,121373
22594,0.001165,172.217.194.0-255,4320,81265,92,121373
22595,0.001169,172.217.194.0-255,2184,83449,92,121373
22596,0.001784,172.217.194.0-255,1484,84933,92,121373
22597,0.00179,172.217.194.0-255,2902,87835,92,121373
22598,0.001814,172.217.194.0-255,5738,93573,92,121373
22599,0.001828,172.217.194.0-255,4320,97893,92,121373
22600,0.001847,172.217.194.0-255,1484,99377,92,121373
22601,0.002313,172.217.194.0-255,1484,100861,92,121373
22602,0.002326,172.217.194.0-255,2902,103763,92,121373
22603,0.002836,172.31.47.0-255,66,103829,92,121373
22604,0.005169,172.217.194.0-255,5738,109567,92,121373
22605,0.005175,172.31.47.0-255,66,109633,92,121373
22606,0.007491,172.217.194.0-255,4320,113953,92,121373
22607,0.007497,172.31.47.0-255,66,114019,92,121373
22608,0.007515,172.217.194.0-255,1484,115503,92,121373
22609,0.007517,172.31.47.0-255,66,115569,92,121373
22610,0.009772,172.217.194.0-255,5738,121307,92,121373
22611,0.009778,172.31.47.0-255,66,121373,92,121373
22612,0.0,74.125.24.0-255,153,153,92,122865
22613,2.6e-05,172.31.47.0-255,66,219,92,122865
22614,3.4e-05,74.125.24.0-255,1484,1703,92,122865
22615,3.8e-05,172.31.47.0-255,66,1769,92,122865
22616,4.2e-05,74.125.24.0-255,2902,4671,92,122865
22617,5.3e-05,172.31.47.0-255,66,4737,92,122865
22618,6e-05,74.125.24.0-255,7156,11893,92,122865
22619,6.3e-05,172.31.47.0-255,66,11959,92,122865
22620,6.7e-05,74.125.24.0-255,2174,14133,92,122865
22621,7e-05,172.31.47.0-255,66,14199,92,122865
22622,7.5e-05,74.125.24.0-255,4320,18519,92,122865
22623,7.7e-05,172.31.47.0-255,66,18585,92,122865
22624,0.000118,74.125.24.0-255,7156,25741,92,122865
22625,0.000122,172.31.47.0-255,66,25807,92,122865
22626,0.000128,74.125.24.0-255,5379,31186,92,122865
22627,0.00013,172.31.47.0-255,66,31252,92,122865
22628,0.000206,74.125.24.0-255,1484,32736,92,122865
22629,0.000209,172.31.47.0-255,66,32802,92,122865
22630,0.000214,74.125.24.0-255,2902,35704,92,122865
22631,0.000217,172.31.47.0-255,66,35770,92,122865
22632,0.000243,74.125.24.0-255,5738,41508,92,122865
22633,0.000246,172.31.47.0-255,66,41574,92,122865
22634,0.00025,74.125.24.0-255,2902,44476,92,122865
22635,0.000252,172.31.47.0-255,66,44542,92,122865
22636,0.000287,172.31.47.0-255,66,44608,92,122865
22637,0.000294,74.125.24.0-255,7156,51764,92,122865
22638,0.000297,172.31.47.0-255,66,51830,92,122865
22639,0.000343,74.125.24.0-255,2839,54669,92,122865
22640,0.000347,172.31.47.0-255,66,54735,92,122865
22641,0.00035,74.125.24.0-255,132,54867,92,122865
22642,0.000353,172.31.47.0-255,66,54933,92,122865
22643,0.000463,74.125.24.0-255,346,55279,92,122865
22644,0.000787,172.31.47.0-255,66,55345,92,122865
22645,0.001172,74.125.24.0-255,1484,56829,92,122865
22646,0.001182,74.125.24.0-255,2902,59731,92,122865
22647,0.001185,172.31.47.0-255,66,59797,92,122865
22648,0.001191,74.125.24.0-255,4320,64117,92,122865
22649,0.001193,172.31.47.0-255,66,64183,92,122865
22650,0.001216,74.125.24.0-255,1484,65667,92,122865
22651,0.001231,172.31.47.0-255,66,65733,92,122865
22652,0.001258,74.125.24.0-255,2902,68635,92,122865
22653,0.001261,172.31.47.0-255,66,68701,92,122865
22654,0.001264,74.125.24.0-255,1484,70185,92,122865
22655,0.001268,74.125.24.0-255,2902,73087,92,122865
22656,0.00127,172.31.47.0-255,66,73153,92,122865
22657,0.001324,172.31.47.0-255,66,73219,92,122865
22658,0.001336,172.31.47.0-255,66,73285,92,122865
22659,0.001339,74.125.24.0-255,1484,74769,92,122865
22660,0.001375,74.125.24.0-255,6438,81207,92,122865
22661,0.00139,172.31.47.0-255,66,81273,92,122865
22662,0.002065,74.125.24.0-255,1484,82757,92,122865
22663,0.002072,74.125.24.0-255,2902,85659,92,122865
22664,0.002075,172.31.47.0-255,66,85725,92,122865
22665,0.002104,74.125.24.0-255,5738,91463,92,122865
22666,0.002107,172.31.47.0-255,66,91529,92,122865
22667,0.00211,74.125.24.0-255,2902,94431,92,122865
22668,0.002112,172.31.47.0-255,66,94497,92,122865
22669,0.002145,172.31.47.0-255,66,94563,92,122865
22670,0.00215,74.125.24.0-255,5738,100301,92,122865
22671,0.002152,172.31.47.0-255,66,100367,92,122865
22672,0.002176,74.125.24.0-255,5020,105387,92,122865
22673,0.002178,172.31.47.0-255,66,105453,92,122865
22674,0.004558,74.125.24.0-255,5738,111191,92,122865
22675,0.004562,172.31.47.0-255,66,111257,92,122865
22676,0.006924,74.125.24.0-255,5738,116995,92,122865
22677,0.00693,172.31.47.0-255,66,117061,92,122865
22678,0.009294,74.125.24.0-255,5738,122799,92,122865
22679,0.009302,172.31.47.0-255,66,122865,92,122865
22680,0.0,172.31.47.0-255,105,105,92,105
22681,0.0,172.31.47.0-255,105,105,92,105
22682,0.0,172.217.194.0-255,152,152,92,168526
22683,3.8e-05,172.31.47.0-255,66,218,92,168526
22684,4.8e-05,172.217.194.0-255,1484,1702,92,168526
22685,5.4e-05,172.31.47.0-255,66,1768,92,168526
22686,7.4e-05,172.217.194.0-255,2902,4670,92,168526
22687,7.8e-05,172.31.47.0-255,66,4736,92,168526
22688,9e-05,172.217.194.0-255,7156,11892,92,168526
22689,9.3e-05,172.31.47.0-255,66,11958,92,168526
22690,0.000103,172.217.194.0-255,6356,18314,92,168526
22691,0.000108,172.31.47.0-255,66,18380,92,168526
22692,0.000118,172.217.194.0-255,7156,25536,92,168526
22693,0.000121,172.31.47.0-255,66,25602,92,168526
22694,0.00013,172.217.194.0-255,5379,30981,92,168526
22695,0.000134,172.31.47.0-255,66,31047,92,168526
22696,0.000213,172.217.194.0-255,1484,32531,92,168526
22697,0.000218,172.31.47.0-255,66,32597,92,168526
22698,0.000225,172.217.194.0-255,2902,35499,92,168526
22699,0.000229,172.31.47.0-255,66,35565,92,168526
22700,0.00024,172.217.194.0-255,1484,37049,92,168526
22701,0.000244,172.31.47.0-255,66,37115,92,168526
22702,0.000268,172.217.194.0-255,4320,41435,92,168526
22703,0.000273,172.31.47.0-255,66,41501,92,168526
22704,0.000291,172.31.47.0-255,66,41567,92,168526
22705,0.000339,172.31.47.0-255,66,41633,92,168526
22706,0.000343,172.217.194.0-255,1125,42758,92,168526
22707,0.000345,172.31.47.0-255,66,42824,92,168526
22708,0.000405,172.217.194.0-255,645,43469,92,168526
22709,0.000409,172.31.47.0-255,66,43535,92,168526
22710,0.000643,172.217.194.0-255,1484,45019,92,168526
22711,0.000652,172.31.47.0-255,66,45085,92,168526
22712,0.000659,172.217.194.0-255,2902,47987,92,168526
22713,0.000663,172.31.47.0-255,66,48053,92,168526
22714,0.000678,172.217.194.0-255,5738,53791,92,168526
22715,0.000682,172.31.47.0-255,66,53857,92,168526
22716,0.000688,172.217.194.0-255,4320,58177,92,168526
22717,0.000692,172.31.47.0-255,66,58243,92,168526
22718,0.000736,172.31.47.0-255,66,58309,92,168526
22719,0.00075,172.31.47.0-255,66,58375,92,168526
22720,0.000827,172.217.194.0-255,1484,59859,92,168526
22721,0.000836,172.217.194.0-255,2902,62761,92,168526
22722,0.000839,172.31.47.0-255,66,62827,92,168526
22723,0.000888,172.217.194.0-255,5738,68565,92,168526
22724,0.000893,172.31.47.0-255,66,68631,92,168526
22725,0.000907,172.217.194.0-255,6249,74880,92,168526
22726,0.000912,172.31.47.0-255,66,74946,92,168526
22727,0.000951,172.217.194.0-255,1484,76430,92,168526
22728,0.000959,172.217.194.0-255,2902,79332,92,168526
22729,0.000962,172.31.47.0-255,66,79398,92,168526
22730,0.000969,172.217.194.0-255,1484,80882,92,168526
22731,0.001028,172.217.194.0-255,4320,85202,92,168526
22732,0.001034,172.31.47.0-255,66,85268,92,168526
22733,0.001041,172.217.194.0-255,2902,88170,92,168526
22734,0.001047,172.31.47.0-255,66,88236,92,168526
22735,0.001065,172.31.47.0-255,66,88302,92,168526
22736,0.001086,172.31.47.0-255,66,88368,92,168526
22737,0.001304,172.217.194.0-255,1484,89852,92,168526
22738,0.001311,172.217.194.0-255,2902,92754,92,168526
22739,0.001315,172.31.47.0-255,66,92820,92,168526
22740,0.001359,172.217.194.0-255,5738,98558,92,168526
22741,0.001364,172.31.47.0-255,66,98624,92,168526
22742,0.001372,172.217.194.0-255,4320,102944,92,168526
22743,0.001377,172.31.47.0-255,66,103010,92,168526
22744,0.001393,172.31.47.0-255,66,103076,92,168526
22745,0.00143,172.217.194.0-255,1484,104560,92,168526
22746,0.001438,172.217.194.0-255,5738,110298,92,168526
22747,0.001442,172.217.194.0-255,2184,112482,92,168526
22748,0.001461,172.31.47.0-255,66,112548,92,168526
22749,0.001465,172.31.47.0-255,66,112614,92,168526
22750,0.00152,172.217.194.0-255,1484,114098,92,168526
22751,0.001527,172.217.194.0-255,2902,117000,92,168526
22752,0.001531,172.31.47.0-255,66,117066,92,168526
22753,0.001541,172.217.194.0-255,5738,122804,92,168526
22754,0.001544,172.31.47.0-255,66,122870,92,168526
22755,0.001594,172.31.47.0-255,66,122936,92,168526
22756,0.001604,172.217.194.0-255,5738,128674,92,168526
22757,0.001608,172.31.47.0-255,66,128740,92,168526
22758,0.001652,172.217.194.0-255,7156,135896,92,168526
22759,0.001656,172.31.47.0-255,66,135962,92,168526
22760,0.001659,172.217.194.0-255,766,136728,92,168526
22761,0.001755,172.217.194.0-255,1484,138212,92,168526
22762,0.00176,172.31.47.0-255,66,138278,92,168526
22763,0.001766,172.217.194.0-255,2902,141180,92,168526
22764,0.00177,172.31.47.0-255,66,141246,92,168526
22765,0.00178,172.217.194.0-255,1484,142730,92,168526
22766,0.001814,172.217.194.0-255,4320,147050,92,168526
22767,0.001818,172.31.47.0-255,66,147116,92,168526
22768,0.001825,172.217.194.0-255,7156,154272,92,168526
22769,0.001827,172.31.47.0-255,66,154338,92,168526
22770,0.001877,172.31.47.0-255,66,154404,92,168526
22771,0.001882,172.217.194.0-255,2184,156588,92,168526
22772,0.00189,172.31.47.0-255,66,156654,92,168526
22773,0.001986,172.217.194.0-255,1484,158138,92,168526
22774,0.002006,172.217.194.0-255,2902,161040,92,168526
22775,0.002009,172.31.47.0-255,66,161106,92,168526
22776,0.002012,172.217.194.0-255,1484,162590,92,168526
22777,0.002043,172.217.194.0-255,4320,166910,92,168526
22778,0.002049,172.31.47.0-255,66,166976,92,168526
22779,0.00209,172.31.47.0-255,66,167042,92,168526
22780,0.002104,172.217.194.0-255,1484,168526,92,168526
22781,0.0,172.31.47.0-255,162,162,92,228
22782,0.00789,74.125.24.0-255,66,228,92,228
22783,0.0,74.125.130.0-255,153,153,92,226806
22784,2.1e-05,172.31.47.0-255,66,219,92,226806
22785,2.7e-05,74.125.130.0-255,1484,1703,92,226806
22786,3.2e-05,172.31.47.0-255,66,1769,92,226806
22787,3.7e-05,74.125.130.0-255,2902,4671,92,226806
22788,3.9e-05,172.31.47.0-255,66,4737,92,226806
22789,6.2e-05,74.125.130.0-255,1484,6221,92,226806
22790,6.4e-05,172.31.47.0-255,66,6287,92,226806
22791,9e-05,74.125.130.0-255,4320,10607,92,226806
22792,9.3e-05,172.31.47.0-255,66,10673,92,226806
22793,9.7e-05,74.125.130.0-255,3545,14218,92,226806
22794,9.9e-05,172.31.47.0-255,66,14284,92,226806
22795,0.000104,74.125.130.0-255,4320,18604,92,226806
22796,0.000106,172.31.47.0-255,66,18670,92,226806
22797,0.000135,172.31.47.0-255,66,18736,92,226806
22798,0.000178,74.125.130.0-255,3961,22697,92,226806
22799,0.000181,172.31.47.0-255,66,22763,92,226806
22800,0.000359,74.125.130.0-255,1484,24247,92,226806
22801,0.000364,74.125.130.0-255,2902,27149,92,226806
22802,0.000369,172.31.47.0-255,66,27215,92,226806
22803,0.000373,172.31.47.0-255,66,27281,92,226806
22804,0.000385,74.125.130.0-255,4320,31601,92,226806
22805,0.000388,172.31.47.0-255,66,31667,92,226806
22806,0.000421,74.125.130.0-255,5738,37405,92,226806
22807,0.000424,172.31.47.0-255,66,37471,92,226806
22808,0.000439,74.125.130.0-255,3961,41432,92,226806
22809,0.000441,172.31.47.0-255,66,41498,92,226806
22810,0.000445,74.125.130.0-255,2902,44400,92,226806
22811,0.000447,172.31.47.0-255,66,44466,92,226806
22812,0.000488,74.125.130.0-255,4320,48786,92,226806
22813,0.000491,172.31.47.0-255,66,48852,92,226806
22814,0.000519,74.125.130.0-255,366,49218,92,226806
22815,0.000527,172.31.47.0-255,66,49284,92,226806
22816,0.000645,74.125.130.0-255,1484,50768,92,226806
22817,0.000664,74.125.130.0-255,2902,53670,92,226806
22818,0.000669,74.125.130.0-255,4320,57990,92,226806
22819,0.000683,74.125.130.0-255,1484,59474,92,226806
22820,0.000685,74.125.130.0-255,1484,60958,92,226806
22821,0.000689,74.125.130.0-255,2902,63860,92,226806
22822,0.000694,172.31.47.0-255,66,63926,92,226806
22823,0.000717,74.125.130.0-255,6797,70723,92,226806
22824,0.000732,74.125.130.0-255,4320,75043,92,226806
22825,0.000738,172.31.47.0-255,66,75109,92,226806
22826,0.000752,74.125.130.0-255,5738,80847,92,226806
22827,0.000769,172.31.47.0-255,66,80913,92,226806
22828,0.00078,74.125.130.0-255,2543,83456,92,226806
22829,0.000796,172.31.47.0-255,66,83522,92,226806
22830,0.001003,74.125.130.0-255,1484,85006,92,226806
22831,0.001014,74.125.130.0-255,1484,86490,92,226806
22832,0.001017,172.31.47.0-255,66,86556,92,226806
22833,0.001028,74.125.130.0-255,1484,88040,92,226806
22834,0.00103,74.125.130.0-255,1484,89524,92,226806
22835,0.001041,74.125.130.0-255,1484,91008,92,226806
22836,0.001051,74.125.130.0-255,1484,92492,92,226806
22837,0.001057,172.31.47.0-255,66,92558,92,226806
22838,0.001077,74.125.130.0-255,5738,98296,92,226806
22839,0.00108,172.31.47.0-255,66,98362,92,226806
22840,0.001097,74.125.130.0-255,1484,99846,92,226806
22841,0.001101,74.125.130.0-255,2902,102748,92,226806
22842,0.001115,172.31.47.0-255,66,102814,92,226806
22843,0.001126,74.125.130.0-255,5738,108552,92,226806
22844,0.00113,74.125.130.0-255,2902,111454,92,226806
22845,0.001154,74.125.130.0-255,4320,115774,92,226806
22846,0.001157,172.31.47.0-255,66,115840,92,226806
22847,0.001161,172.31.47.0-255,66,115906,92,226806
22848,0.001178,74.125.130.0-255,2184,118090,92,226806
22849,0.00119,172.31.47.0-255,66,118156,92,226806
22850,0.001249,74.125.130.0-255,1484,119640,92,226806
22851,0.001262,74.125.130.0-255,2902,122542,92,226806
22852,0.001269,172.31.47.0-255,66,122608,92,226806
22853,0.001289,74.125.130.0-255,5738,128346,92,226806
22854,0.001294,74.125.130.0-255,2902,131248,92,226806
22855,0.001297,74.125.130.0-255,2902,134150,92,226806
22856,0.001303,172.31.47.0-255,66,134216,92,226806
22857,0.001316,74.125.130.0-255,1484,135700,92,226806
22858,0.001323,74.125.130.0-255,5738,141438,92,226806
22859,0.001341,74.125.130.0-255,2902,144340,92,226806
22860,0.001345,74.125.130.0-255,4320,148660,92,226806
22861,0.001355,172.31.47.0-255,66,148726,92,226806
22862,0.001388,74.125.130.0-255,3602,152328,92,226806
22863,0.001395,172.31.47.0-255,66,152394,92,226806
22864,0.00148,74.125.130.0-255,1484,153878,92,226806
22865,0.00153,74.125.130.0-255,2902,156780,92,226806
22866,0.001533,172.31.47.0-255,66,156846,92,226806
22867,0.001539,74.125.130.0-255,5738,162584,92,226806
22868,0.001541,74.125.130.0-255,1484,164068,92,226806
22869,0.001546,172.31.47.0-255,66,164134,92,226806
22870,0.001575,74.125.130.0-255,5738,169872,92,226806
22871,0.001595,74.125.130.0-255,6438,176310,92,226806
22872,0.001598,172.31.47.0-255,66,176376,92,226806
22873,0.001603,172.31.47.0-255,66,176442,92,226806
22874,0.001811,74.125.130.0-255,1484,177926,92,226806
22875,0.001823,74.125.130.0-255,2902,180828,92,226806
22876,0.001826,172.31.47.0-255,66,180894,92,226806
22877,0.00185,74.125.130.0-255,4320,185214,92,226806
22878,0.001855,74.125.130.0-255,4320,189534,92,226806
22879,0.001859,172.31.47.0-255,66,189600,92,226806
22880,0.001867,74.125.130.0-255,1484,191084,92,226806
22881,0.001891,74.125.130.0-255,5738,196822,92,226806
22882,0.001906,74.125.130.0-255,5738,202560,92,226806
22883,0.00191,172.31.47.0-255,66,202626,92,226806
22884,0.001914,172.31.47.0-255,66,202692,92,226806
22885,0.001938,74.125.130.0-255,2902,205594,92,226806
22886,0.001946,172.31.47.0-255,66,205660,92,226806
22887,0.001963,74.125.130.0-255,5020,210680,92,226806
22888,0.001969,172.31.47.0-255,66,210746,92,226806
22889,0.002239,74.125.130.0-255,1484,212230,92,226806
22890,0.002256,74.125.130.0-255,2902,215132,92,226806
22891,0.002259,172.31.47.0-255,66,215198,92,226806
22892,0.002263,74.125.130.0-255,1484,216682,92,226806
22893,0.002285,74.125.130.0-255,4320,221002,92,226806
22894,0.002291,172.31.47.0-255,66,221068,92,226806
22895,0.00231,74.125.130.0-255,5738,226806,92,226806
22896,0.0,172.217.194.0-255,152,152,92,219591
22897,2e-05,172.31.47.0-255,66,218,92,219591
22898,2.7e-05,172.217.194.0-255,1484,1702,92,219591
22899,3.1e-05,172.31.47.0-255,66,1768,92,219591
22900,3.5e-05,172.217.194.0-255,2902,4670,92,219591
22901,3.8e-05,172.31.47.0-255,66,4736,92,219591
22902,4.2e-05,172.217.194.0-255,2902,7638,92,219591
22903,4.3e-05,172.31.47.0-255,66,7704,92,219591
22904,7.2e-05,172.217.194.0-255,4320,12024,92,219591
22905,7.4e-05,172.31.47.0-255,66,12090,92,219591
22906,7.7e-05,172.217.194.0-255,2902,14992,92,219591
22907,7.9e-05,172.31.47.0-255,66,15058,92,219591
22908,0.000105,172.31.47.0-255,66,15124,92,219591
22909,0.000108,172.217.194.0-255,2543,17667,92,219591
22910,0.000109,172.31.47.0-255,66,17733,92,219591
22911,0.000149,172.217.194.0-255,1484,19217,92,219591
22912,0.000151,172.31.47.0-255,66,19283,92,219591
22913,0.00018,172.31.47.0-255,66,19349,92,219591
22914,0.000586,172.217.194.0-255,1484,20833,92,219591
22915,0.00059,172.31.47.0-255,66,20899,92,219591
22916,0.000594,172.217.194.0-255,2902,23801,92,219591
22917,0.000595,172.31.47.0-255,66,23867,92,219591
22918,0.0006,172.217.194.0-255,5738,29605,92,219591
22919,0.000602,172.31.47.0-255,66,29671,92,219591
22920,0.000657,172.217.194.0-255,1484,31155,92,219591
22921,0.000659,172.31.47.0-255,66,31221,92,219591
22922,0.000683,172.217.194.0-255,5379,36600,92,219591
22923,0.000685,172.31.47.0-255,66,36666,92,219591
22924,0.000691,172.217.194.0-255,7156,43822,92,219591
22925,0.000692,172.31.47.0-255,66,43888,92,219591
22926,0.000709,172.217.194.0-255,4320,48208,92,219591
22927,0.000711,172.31.47.0-255,66,48274,92,219591
22928,0.000722,172.217.194.0-255,2902,51176,92,219591
22929,0.000723,172.31.47.0-255,66,51242,92,219591
22930,0.000745,172.217.194.0-255,5379,56621,92,219591
22931,0.000747,172.31.47.0-255,66,56687,92,219591
22932,0.00075,172.217.194.0-255,2902,59589,92,219591
22933,0.000751,172.31.47.0-255,66,59655,92,219591
22934,0.000784,172.31.47.0-255,66,59721,92,219591
22935,0.000787,172.217.194.0-255,1705,61426,92,219591
22936,0.000789,172.31.47.0-255,66,61492,92,219591
22937,0.001114,172.217.194.0-255,1484,62976,92,219591
22938,0.001123,172.217.194.0-255,2902,65878,92,219591
22939,0.001126,172.31.47.0-255,66,65944,92,219591
22940,0.001129,172.217.194.0-255,1484,67428,92,219591
22941,0.001146,172.217.194.0-255,4320,71748,92,219591
22942,0.001148,172.31.47.0-255,66,71814,92,219591
22943,0.001166,172.217.194.0-255,1484,73298,92,219591
22944,0.00118,172.217.194.0-255,5738,79036,92,219591
22945,0.001182,172.31.47.0-255,66,79102,92,219591
22946,0.001197,172.217.194.0-255,5738,84840,92,219591
22947,0.001198,172.31.47.0-255,66,84906,92,219591
22948,0.001208,172.31.47.0-255,66,84972,92,219591
22949,0.00121,172.217.194.0-255,1484,86456,92,219591
22950,0.00124,172.217.194.0-255,4320,90776,92,219591
22951,0.001243,172.31.47.0-255,66,90842,92,219591
22952,0.001248,172.217.194.0-255,7156,97998,92,219591
22953,0.00125,172.31.47.0-255,66,98064,92,219591
22954,0.001282,172.31.47.0-255,66,98130,92,219591
22955,0.001305,172.217.194.0-255,2902,101032,92,219591
22956,0.001307,172.31.47.0-255,66,101098,92,219591
22957,0.001313,172.217.194.0-255,6438,107536,92,219591
22958,0.001315,172.31.47.0-255,66,107602,92,219591
22959,0.001414,172.217.194.0-255,1484,109086,92,219591
22960,0.001428,172.217.194.0-255,2902,111988,92,219591
22961,0.00143,172.31.47.0-255,66,112054,92,219591
22962,0.001433,172.217.194.0-255,1484,113538,92,219591
22963,0.00145,172.217.194.0-255,4320,117858,92,219591
22964,0.001453,172.31.47.0-255,66,117924,92,219591
22965,0.001456,172.217.194.0-255,2902,120826,92,219591
22966,0.001457,172.31.47.0-255,66,120892,92,219591
22967,0.001498,172.31.47.0-255,66,120958,92,219591
22968,0.001506,172.31.47.0-255,66,121024,92,219591
22969,0.00152,172.217.194.0-255,1484,122508,92,219591
22970,0.001541,172.217.194.0-255,3602,126110,92,219591
22971,0.001542,172.31.47.0-255,66,126176,92,219591
22972,0.001562,172.217.194.0-255,5738,131914,92,219591
22973,0.001565,172.31.47.0-255,66,131980,92,219591
22974,0.00157,172.217.194.0-255,5738,137718,92,219591
22975,0.001572,172.31.47.0-255,66,137784,92,219591
22976,0.001601,172.217.194.0-255,7156,144940,92,219591
22977,0.001604,172.31.47.0-255,66,145006,92,219591
22978,0.001613,172.31.47.0-255,66,145072,92,219591
22979,0.00163,172.217.194.0-255,4320,149392,92,219591
22980,0.001631,172.31.47.0-255,66,149458,92,219591
22981,0.001655,172.217.194.0-255,5738,155196,92,219591
22982,0.001657,172.31.47.0-255,66,155262,92,219591
22983,0.001659,172.217.194.0-255,1484,156746,92,219591
22984,0.001689,172.31.47.0-255,66,156812,92,219591
22985,0.001699,172.31.47.0-255,66,156878,92,219591
22986,0.001709,172.217.194.0-255,766,157644,92,219591
22987,0.001801,172.217.194.0-255,1484,159128,92,219591
22988,0.001805,172.31.47.0-255,66,159194,92,219591
22989,0.001809,172.217.194.0-255,2902,162096,92,219591
22990,0.001811,172.31.47.0-255,66,162162,92,219591
22991,0.001813,172.217.194.0-255,1484,163646,92,219591
22992,0.001827,172.217.194.0-255,4320,167966,92,219591
22993,0.001829,172.31.47.0-255,66,168032,92,219591
22994,0.001833,172.217.194.0-255,2902,170934,92,219591
22995,0.001835,172.31.47.0-255,66,171000,92,219591
22996,0.001852,172.217.194.0-255,1484,172484,92,219591
22997,0.001856,172.217.194.0-255,4320,176804,92,219591
22998,0.001858,172.31.47.0-255,66,176870,92,219591
22999,0.001874,172.217.194.0-255,7156,184026,92,219591
23000,0.001876,172.31.47.0-255,66,184092,92,219591
23001,0.0019,172.31.47.0-255,66,184158,92,219591
23002,0.001985,172.217.194.0-255,1484,185642,92,219591
23003,0.001998,172.217.194.0-255,2902,188544,92,219591
23004,0.002,172.31.47.0-255,66,188610,92,219591
23005,0.002021,172.217.194.0-255,5738,194348,92,219591
23006,0.002023,172.31.47.0-255,66,194414,92,219591
23007,0.002049,172.31.47.0-255,66,194480,92,219591
23008,0.002068,172.217.194.0-255,2902,197382,92,219591
23009,0.002069,172.31.47.0-255,66,197448,92,219591
23010,0.002077,172.31.47.0-255,66,197514,92,219591
23011,0.002096,172.217.194.0-255,1484,198998,92,219591
23012,0.002142,172.31.47.0-255,66,199064,92,219591
23013,0.002161,172.31.47.0-255,66,199130,92,219591
23014,0.002171,172.31.47.0-255,66,199196,92,219591
23015,0.002208,172.217.194.0-255,6438,205634,92,219591
23016,0.00221,172.31.47.0-255,66,205700,92,219591
23017,0.002223,172.31.47.0-255,66,205766,92,219591
23018,0.002229,172.217.194.0-255,6438,212204,92,219591
23019,0.00223,172.31.47.0-255,66,212270,92,219591
23020,0.002247,172.217.194.0-255,1484,213754,92,219591
23021,0.002261,172.217.194.0-255,4320,218074,92,219591
23022,0.002263,172.31.47.0-255,66,218140,92,219591
23023,0.00229,172.31.47.0-255,66,218206,92,219591
23024,0.002305,172.217.194.0-255,1109,219315,92,219591
23025,0.002307,172.217.194.0-255,105,219420,92,219591
23026,0.009145,172.31.47.0-255,66,219486,92,219591
23027,0.009171,172.31.47.0-255,105,219591,92,219591
23028,0.0,74.125.68.0-255,152,152,92,222226
23029,3.1e-05,172.31.47.0-255,66,218,92,222226
23030,3.7e-05,74.125.68.0-255,1484,1702,92,222226
23031,4e-05,172.31.47.0-255,66,1768,92,222226
23032,4.4e-05,74.125.68.0-255,2902,4670,92,222226
23033,4.6e-05,172.31.47.0-255,66,4736,92,222226
23034,5e-05,74.125.68.0-255,4320,9056,92,222226
23035,5.2e-05,172.31.47.0-255,66,9122,92,222226
23036,7.6e-05,74.125.68.0-255,1484,10606,92,222226
23037,7.8e-05,172.31.47.0-255,66,10672,92,222226
23038,0.000107,172.31.47.0-255,66,10738,92,222226
23039,0.000112,74.125.68.0-255,4320,15058,92,222226
23040,0.000113,172.31.47.0-255,66,15124,92,222226
23041,0.00015,74.125.68.0-255,2902,18026,92,222226
23042,0.000154,172.31.47.0-255,66,18092,92,222226
23043,0.00017,74.125.68.0-255,5379,23471,92,222226
23044,0.000174,172.31.47.0-255,66,23537,92,222226
23045,0.000209,74.125.68.0-255,1484,25021,92,222226
23046,0.000212,172.31.47.0-255,66,25087,92,222226
23047,0.000222,74.125.68.0-255,2902,27989,92,222226
23048,0.000224,172.31.47.0-255,66,28055,92,222226
23049,0.000262,74.125.68.0-255,2902,30957,92,222226
23050,0.000264,172.31.47.0-255,66,31023,92,222226
23051,0.000269,74.125.68.0-255,2902,33925,92,222226
23052,0.000271,172.31.47.0-255,66,33991,92,222226
23053,0.000284,74.125.68.0-255,1484,35475,92,222226
23054,0.000286,172.31.47.0-255,66,35541,92,222226
23055,0.000309,74.125.68.0-255,2902,38443,92,222226
23056,0.000312,172.31.47.0-255,66,38509,92,222226
23057,0.000332,74.125.68.0-255,6797,45306,92,222226
23058,0.000335,172.31.47.0-255,66,45372,92,222226
23059,0.000345,172.31.47.0-255,66,45438,92,222226
23060,0.000364,74.125.68.0-255,1484,46922,92,222226
23061,0.000369,74.125.68.0-255,2813,49735,92,222226
23062,0.000371,172.31.47.0-255,66,49801,92,222226
23063,0.000373,74.125.68.0-255,133,49934,92,222226
23064,0.000401,74.125.68.0-255,350,50284,92,222226
23065,0.000562,74.125.68.0-255,1484,51768,92,222226
23066,0.000566,172.31.47.0-255,66,51834,92,222226
23067,0.000578,74.125.68.0-255,1484,53318,92,222226
23068,0.000595,74.125.68.0-255,1484,54802,92,222226
23069,0.000597,172.31.47.0-255,66,54868,92,222226
23070,0.000603,74.125.68.0-255,5738,60606,92,222226
23071,0.000605,172.31.47.0-255,66,60672,92,222226
23072,0.00061,74.125.68.0-255,4320,64992,92,222226
23073,0.000611,172.31.47.0-255,66,65058,92,222226
23074,0.000615,74.125.68.0-255,2902,67960,92,222226
23075,0.000617,172.31.47.0-255,66,68026,92,222226
23076,0.000636,74.125.68.0-255,2902,70928,92,222226
23077,0.000639,172.31.47.0-255,66,70994,92,222226
23078,0.000664,74.125.68.0-255,4320,75314,92,222226
23079,0.000668,172.31.47.0-255,66,75380,92,222226
23080,0.000683,74.125.68.0-255,4320,79700,92,222226
23081,0.000686,172.31.47.0-255,66,79766,92,222226
23082,0.000704,74.125.68.0-255,1484,81250,92,222226
23083,0.000718,74.125.68.0-255,3602,84852,92,222226
23084,0.000721,172.31.47.0-255,66,84918,92,222226
23085,0.001024,74.125.68.0-255,1484,86402,92,222226
23086,0.00103,74.125.68.0-255,1484,87886,92,222226
23087,0.001033,172.31.47.0-255,66,87952,92,222226
23088,0.00105,74.125.68.0-255,1484,89436,92,222226
23089,0.001054,74.125.68.0-255,2902,92338,92,222226
23090,0.001056,172.31.47.0-255,66,92404,92,222226
23091,0.001076,74.125.68.0-255,2902,95306,92,222226
23092,0.001078,172.31.47.0-255,66,95372,92,222226
23093,0.001108,74.125.68.0-255,4320,99692,92,222226
23094,0.001111,172.31.47.0-255,66,99758,92,222226
23095,0.001134,74.125.68.0-255,5738,105496,92,222226
23096,0.001136,172.31.47.0-255,66,105562,92,222226
23097,0.001139,74.125.68.0-255,1484,107046,92,222226
23098,0.001155,74.125.68.0-255,2902,109948,92,222226
23099,0.001157,172.31.47.0-255,66,110014,92,222226
23100,0.00118,74.125.68.0-255,7156,117170,92,222226
23101,0.001183,172.31.47.0-255,66,117236,92,222226
23102,0.001187,74.125.68.0-255,2184,119420,92,222226
23103,0.001188,172.31.47.0-255,66,119486,92,222226
23104,0.001229,74.125.68.0-255,1484,120970,92,222226
23105,0.001246,74.125.68.0-255,2902,123872,92,222226
23106,0.001248,172.31.47.0-255,66,123938,92,222226
23107,0.001266,74.125.68.0-255,4320,128258,92,222226
23108,0.001268,172.31.47.0-255,66,128324,92,222226
23109,0.001284,74.125.68.0-255,1484,129808,92,222226
23110,0.001289,74.125.68.0-255,4320,134128,92,222226
23111,0.00129,172.31.47.0-255,66,134194,92,222226
23112,0.001303,74.125.68.0-255,2902,137096,92,222226
23113,0.001304,172.31.47.0-255,66,137162,92,222226
23114,0.001322,74.125.68.0-255,7156,144318,92,222226
23115,0.001324,172.31.47.0-255,66,144384,92,222226
23116,0.001347,74.125.68.0-255,4320,148704,92,222226
23117,0.00135,172.31.47.0-255,66,148770,92,222226
23118,0.001378,74.125.68.0-255,5020,153790,92,222226
23119,0.001381,172.31.47.0-255,66,153856,92,222226
23120,0.001698,74.125.68.0-255,1484,155340,92,222226
23121,0.001704,74.125.68.0-255,2902,158242,92,222226
23122,0.001707,172.31.47.0-255,66,158308,92,222226
23123,0.001711,74.125.68.0-255,1484,159792,92,222226
23124,0.001724,74.125.68.0-255,1484,161276,92,222226
23125,0.001725,172.31.47.0-255,66,161342,92,222226
23126,0.001738,74.125.68.0-255,1484,162826,92,222226
23127,0.001743,74.125.68.0-255,4320,167146,92,222226
23128,0.001745,172.31.47.0-255,66,167212,92,222226
23129,0.001763,74.125.68.0-255,1484,168696,92,222226
23130,0.001766,74.125.68.0-255,1484,170180,92,222226
23131,0.001767,172.31.47.0-255,66,170246,92,222226
23132,0.001783,172.31.47.0-255,66,170312,92,222226
23133,0.001795,74.125.68.0-255,1484,171796,92,222226
23134,0.001815,74.125.68.0-255,1484,173280,92,222226
23135,0.001817,172.31.47.0-255,66,173346,92,222226
23136,0.001837,74.125.68.0-255,6438,179784,92,222226
23137,0.001839,172.31.47.0-255,66,179850,92,222226
23138,0.001936,74.125.68.0-255,1484,181334,92,222226
23139,0.00199,74.125.68.0-255,2902,184236,92,222226
23140,0.001993,172.31.47.0-255,66,184302,92,222226
23141,0.001998,74.125.68.0-255,5738,190040,92,222226
23142,0.002,172.31.47.0-255,66,190106,92,222226
23143,0.002005,74.125.68.0-255,7156,197262,92,222226
23144,0.002007,172.31.47.0-255,66,197328,92,222226
23145,0.002041,74.125.68.0-255,4320,201648,92,222226
23146,0.002043,172.31.47.0-255,66,201714,92,222226
23147,0.003983,74.125.68.0-255,1484,203198,92,222226
23148,0.004007,74.125.68.0-255,2902,206100,92,222226
23149,0.004009,172.31.47.0-255,66,206166,92,222226
23150,0.004024,74.125.68.0-255,1484,207650,92,222226
23151,0.005997,74.125.68.0-255,4320,211970,92,222226
23152,0.006005,172.31.47.0-255,66,212036,92,222226
23153,0.007997,74.125.68.0-255,5738,217774,92,222226
23154,0.008002,172.31.47.0-255,66,217840,92,222226
23155,0.009986,74.125.68.0-255,4320,222160,92,222226
23156,0.009993,172.31.47.0-255,66,222226,92,222226
23157,0.0,172.217.194.0-255,226,226,92,114870
23158,2e-05,172.31.47.0-255,66,292,92,114870
23159,3.2e-05,172.217.194.0-255,1484,1776,92,114870
23160,4e-05,172.31.47.0-255,66,1842,92,114870
23161,7e-05,172.217.194.0-255,2902,4744,92,114870
23162,7.3e-05,172.31.47.0-255,66,4810,92,114870
23163,9.4e-05,172.217.194.0-255,1484,6294,92,114870
23164,9.6e-05,172.31.47.0-255,66,6360,92,114870
23165,0.000247,172.217.194.0-255,5738,12098,92,114870
23166,0.000252,172.31.47.0-255,66,12164,92,114870
23167,0.000276,172.217.194.0-255,2205,14369,92,114870
23168,0.000279,172.31.47.0-255,66,14435,92,114870
23169,0.00057,172.217.194.0-255,2902,17337,92,114870
23170,0.000575,172.31.47.0-255,66,17403,92,114870
23171,0.000596,172.217.194.0-255,5738,23141,92,114870
23172,0.000599,172.31.47.0-255,66,23207,92,114870
23173,0.000924,172.217.194.0-255,5738,28945,92,114870
23174,0.000929,172.31.47.0-255,66,29011,92,114870
23175,0.000952,172.217.194.0-255,2579,31590,92,114870
23176,0.000955,172.31.47.0-255,66,31656,92,114870
23177,0.002336,172.217.194.0-255,2902,34558,92,114870
23178,0.002339,172.31.47.0-255,66,34624,92,114870
23179,0.002354,172.217.194.0-255,2648,37272,92,114870
23180,0.002356,172.31.47.0-255,66,37338,92,114870
23181,0.002437,172.217.194.0-255,4320,41658,92,114870
23182,0.00244,172.31.47.0-255,66,41724,92,114870
23183,0.00247,172.217.194.0-255,4408,46132,92,114870
23184,0.002474,172.31.47.0-255,66,46198,92,114870
23185,0.002777,172.217.194.0-255,232,46430,92,114870
23186,0.002784,172.31.47.0-255,66,46496,92,114870
23187,0.002803,172.217.194.0-255,4134,50630,92,114870
23188,0.002807,172.31.47.0-255,66,50696,92,114870
23189,0.00297,172.217.194.0-255,2902,53598,92,114870
23190,0.002974,172.31.47.0-255,66,53664,92,114870
23191,0.003013,172.31.47.0-255,66,53730,92,114870
23192,0.003414,172.217.194.0-255,5738,59468,92,114870
23193,0.00342,172.31.47.0-255,66,59534,92,114870
23194,0.003635,172.217.194.0-255,7156,66690,92,114870
23195,0.003641,172.31.47.0-255,66,66756,92,114870
23196,0.003667,172.217.194.0-255,1484,68240,92,114870
23197,0.003669,172.31.47.0-255,66,68306,92,114870
23198,0.003976,172.217.194.0-255,5738,74044,92,114870
23199,0.003982,172.31.47.0-255,66,74110,92,114870
23200,0.00401,172.217.194.0-255,2902,77012,92,114870
23201,0.004013,172.31.47.0-255,66,77078,92,114870
23202,0.004341,172.217.194.0-255,5738,82816,92,114870
23203,0.004346,172.31.47.0-255,66,82882,92,114870
23204,0.004526,172.217.194.0-255,7156,90038,92,114870
23205,0.004531,172.31.47.0-255,66,90104,92,114870
23206,0.004556,172.217.194.0-255,4320,94424,92,114870
23207,0.004559,172.31.47.0-255,66,94490,92,114870
23208,0.004921,172.217.194.0-255,2902,97392,92,114870
23209,0.004926,172.31.47.0-255,66,97458,92,114870
23210,0.00501,172.217.194.0-255,4320,101778,92,114870
23211,0.005014,172.31.47.0-255,66,101844,92,114870
23212,0.005312,172.217.194.0-255,4320,106164,92,114870
23213,0.00589,172.217.194.0-255,5738,111902,92,114870
23214,0.006134,172.217.194.0-255,2902,114804,92,114870
23215,0.007783,172.31.47.0-255,66,114870,92,114870
23216,0.0,74.125.130.0-255,153,153,92,246763
23217,2.9e-05,172.31.47.0-255,66,219,92,246763
23218,3.6e-05,74.125.130.0-255,1484,1703,92,246763
23219,4e-05,172.31.47.0-255,66,1769,92,246763
23220,4.3e-05,74.125.130.0-255,1484,3253,92,246763
23221,4.4e-05,172.31.47.0-255,66,3319,92,246763
23222,9.1e-05,74.125.130.0-255,2902,6221,92,246763
23223,9.4e-05,172.31.47.0-255,66,6287,92,246763
23224,9.9e-05,74.125.130.0-255,5738,12025,92,246763
23225,0.000101,172.31.47.0-255,66,12091,92,246763
23226,0.000104,74.125.130.0-255,2127,14218,92,246763
23227,0.000106,172.31.47.0-255,66,14284,92,246763
23228,0.000156,74.125.130.0-255,1484,15768,92,246763
23229,0.00016,172.31.47.0-255,66,15834,92,246763
23230,0.000168,74.125.130.0-255,2902,18736,92,246763
23231,0.00017,172.31.47.0-255,66,18802,92,246763
23232,0.000173,74.125.130.0-255,1484,20286,92,246763
23233,0.00018,172.31.47.0-255,66,20352,92,246763
23234,0.000209,74.125.130.0-255,4320,24672,92,246763
23235,0.000212,172.31.47.0-255,66,24738,92,246763
23236,0.000217,74.125.130.0-255,4320,29058,92,246763
23237,0.00022,172.31.47.0-255,66,29124,92,246763
23238,0.000255,74.125.130.0-255,2543,31667,92,246763
23239,0.000258,172.31.47.0-255,66,31733,92,246763
23240,0.000348,74.125.130.0-255,1484,33217,92,246763
23241,0.000353,172.31.47.0-255,66,33283,92,246763
23242,0.000357,74.125.130.0-255,1484,34767,92,246763
23243,0.000361,172.31.47.0-255,66,34833,92,246763
23244,0.000379,74.125.130.0-255,1484,36317,92,246763
23245,0.000383,172.31.47.0-255,66,36383,92,246763
23246,0.000389,74.125.130.0-255,5738,42121,92,246763
23247,0.000392,172.31.47.0-255,66,42187,92,246763
23248,0.000396,74.125.130.0-255,2902,45089,92,246763
23249,0.000398,172.31.47.0-255,66,45155,92,246763
23250,0.000436,74.125.130.0-255,4320,49475,92,246763
23251,0.000446,172.31.47.0-255,66,49541,92,246763
23252,0.000473,74.125.130.0-255,6797,56338,92,246763
23253,0.000477,74.125.130.0-255,4320,60658,92,246763
23254,0.000477,172.31.47.0-255,66,60724,92,246763
23255,0.00048,172.31.47.0-255,66,60790,92,246763
23256,0.000509,74.125.130.0-255,5669,66459,92,246763
23257,0.000512,172.31.47.0-255,66,66525,92,246763
23258,0.000536,74.125.130.0-255,366,66891,92,246763
23259,0.000606,74.125.130.0-255,1484,68375,92,246763
23260,0.000609,74.125.130.0-255,1484,69859,92,246763
23261,0.00061,172.31.47.0-255,66,69925,92,246763
23262,0.000635,74.125.130.0-255,1484,71409,92,246763
23263,0.000639,172.31.47.0-255,66,71475,92,246763
23264,0.000641,74.125.130.0-255,5738,77213,92,246763
23265,0.000643,74.125.130.0-255,1484,78697,92,246763
23266,0.000644,172.31.47.0-255,66,78763,92,246763
23267,0.000671,74.125.130.0-255,2902,81665,92,246763
23268,0.000676,74.125.130.0-255,5738,87403,92,246763
23269,0.000676,172.31.47.0-255,66,87469,92,246763
23270,0.000679,172.31.47.0-255,66,87535,92,246763
23271,0.000723,172.31.47.0-255,66,87601,92,246763
23272,0.000727,74.125.130.0-255,2184,89785,92,246763
23273,0.000729,172.31.47.0-255,66,89851,92,246763
23274,0.000789,74.125.130.0-255,1484,91335,92,246763
23275,0.000807,74.125.130.0-255,2902,94237,92,246763
23276,0.000811,172.31.47.0-255,66,94303,92,246763
23277,0.000815,74.125.130.0-255,1484,95787,92,246763
23278,0.000831,74.125.130.0-255,2902,98689,92,246763
23279,0.000834,172.31.47.0-255,66,98755,92,246763
23280,0.000864,172.31.47.0-255,66,98821,92,246763
23281,0.000867,74.125.130.0-255,2902,101723,92,246763
23282,0.00087,172.31.47.0-255,66,101789,92,246763
23283,0.00091,172.31.47.0-255,66,101855,92,246763
23284,0.000926,74.125.130.0-255,4320,106175,92,246763
23285,0.00093,172.31.47.0-255,66,106241,92,246763
23286,0.000933,74.125.130.0-255,766,107007,92,246763
23287,0.000981,74.125.130.0-255,1484,108491,92,246763
23288,0.000984,172.31.47.0-255,66,108557,92,246763
23289,0.001002,74.125.130.0-255,2902,111459,92,246763
23290,0.001005,172.31.47.0-255,66,111525,92,246763
23291,0.001008,74.125.130.0-255,1484,113009,92,246763
23292,0.001037,74.125.130.0-255,2902,115911,92,246763
23293,0.00104,172.31.47.0-255,66,115977,92,246763
23294,0.001046,74.125.130.0-255,5738,121715,92,246763
23295,0.001049,172.31.47.0-255,66,121781,92,246763
23296,0.001082,172.31.47.0-255,66,121847,92,246763
23297,0.001107,74.125.130.0-255,2902,124749,92,246763
23298,0.001109,172.31.47.0-255,66,124815,92,246763
23299,0.001114,74.125.130.0-255,4320,129135,92,246763
23300,0.001117,172.31.47.0-255,66,129201,92,246763
23301,0.001146,74.125.130.0-255,3602,132803,92,246763
23302,0.00115,172.31.47.0-255,66,132869,92,246763
23303,0.001241,74.125.130.0-255,1484,134353,92,246763
23304,0.001257,74.125.130.0-255,1484,135837,92,246763
23305,0.001261,172.31.47.0-255,66,135903,92,246763
23306,0.001278,74.125.130.0-255,2902,138805,92,246763
23307,0.001281,172.31.47.0-255,66,138871,92,246763
23308,0.001308,74.125.130.0-255,5738,144609,92,246763
23309,0.001312,172.31.47.0-255,66,144675,92,246763
23310,0.001315,74.125.130.0-255,1484,146159,92,246763
23311,0.001344,74.125.130.0-255,2902,149061,92,246763
23312,0.001347,172.31.47.0-255,66,149127,92,246763
23313,0.001353,74.125.130.0-255,5738,154865,92,246763
23314,0.001355,172.31.47.0-255,66,154931,92,246763
23315,0.001406,74.125.130.0-255,1484,156415,92,246763
23316,0.001435,74.125.130.0-255,5738,162153,92,246763
23317,0.00144,172.31.47.0-255,66,162219,92,246763
23318,0.001445,74.125.130.0-255,5020,167239,92,246763
23319,0.001447,172.31.47.0-255,66,167305,92,246763
23320,0.001468,74.125.130.0-255,1484,168789,92,246763
23321,0.00149,74.125.130.0-255,2902,171691,92,246763
23322,0.001493,172.31.47.0-255,66,171757,92,246763
23323,0.001528,74.125.130.0-255,5738,177495,92,246763
23324,0.001532,172.31.47.0-255,66,177561,92,246763
23325,0.001537,74.125.130.0-255,4320,181881,92,246763
23326,0.001539,172.31.47.0-255,66,181947,92,246763
23327,0.001546,74.125.130.0-255,5738,187685,92,246763
23328,0.001548,172.31.47.0-255,66,187751,92,246763
23329,0.001595,172.31.47.0-255,66,187817,92,246763
23330,0.001599,74.125.130.0-255,2184,190001,92,246763
23331,0.001601,172.31.47.0-255,66,190067,92,246763
23332,0.001653,74.125.130.0-255,1484,191551,92,246763
23333,0.001665,74.125.130.0-255,1484,193035,92,246763
23334,0.001668,172.31.47.0-255,66,193101,92,246763
23335,0.001695,74.125.130.0-255,2902,196003,92,246763
23336,0.001698,172.31.47.0-255,66,196069,92,246763
23337,0.001704,74.125.130.0-255,5738,201807,92,246763
23338,0.001706,172.31.47.0-255,66,201873,92,246763
23339,0.001744,74.125.130.0-255,7156,209029,92,246763
23340,0.001749,172.31.47.0-255,66,209095,92,246763
23341,0.001777,74.125.130.0-255,1484,210579,92,246763
23342,0.001788,172.31.47.0-255,66,210645,92,246763
23343,0.001793,74.125.130.0-255,3602,214247,92,246763
23344,0.001795,172.31.47.0-255,66,214313,92,246763
23345,0.00186,74.125.130.0-255,1484,215797,92,246763
23346,0.001872,74.125.130.0-255,1484,217281,92,246763
23347,0.001875,172.31.47.0-255,66,217347,92,246763
23348,0.001897,74.125.130.0-255,1484,218831,92,246763
23349,0.001904,74.125.130.0-255,5738,224569,92,246763
23350,0.001907,172.31.47.0-255,66,224635,92,246763
23351,0.001935,74.125.130.0-255,1484,226119,92,246763
23352,0.001958,172.31.47.0-255,66,226185,92,246763
23353,0.001983,74.125.130.0-255,2902,229087,92,246763
23354,0.001986,172.31.47.0-255,66,229153,92,246763
23355,0.001998,172.31.47.0-255,66,229219,92,246763
23356,0.004026,74.125.130.0-255,5738,234957,92,246763
23357,0.004033,172.31.47.0-255,66,235023,92,246763
23358,0.006077,74.125.130.0-255,5738,240761,92,246763
23359,0.006081,172.31.47.0-255,66,240827,92,246763
23360,0.008111,74.125.130.0-255,2902,243729,92,246763
23361,0.008117,172.31.47.0-255,66,243795,92,246763
23362,0.008142,74.125.130.0-255,2902,246697,92,246763
23363,0.008145,172.31.47.0-255,66,246763,92,246763
23364,0.0,74.125.24.0-255,153,153,92,290461
23365,3.2e-05,172.31.47.0-255,66,219,92,290461
23366,3.8e-05,74.125.24.0-255,1484,1703,92,290461
23367,4.2e-05,172.31.47.0-255,66,1769,92,290461
23368,4.6e-05,74.125.24.0-255,2902,4671,92,290461
23369,4.8e-05,172.31.47.0-255,66,4737,92,290461
23370,6.3e-05,74.125.24.0-255,7156,11893,92,290461
23371,6.5e-05,172.31.47.0-255,66,11959,92,290461
23372,7.2e-05,74.125.24.0-255,6373,18332,92,290461
23373,7.4e-05,172.31.47.0-255,66,18398,92,290461
23374,8e-05,74.125.24.0-255,5738,24136,92,290461
23375,8.3e-05,172.31.47.0-255,66,24202,92,290461
23376,0.000113,74.125.24.0-255,1484,25686,92,290461
23377,0.000115,172.31.47.0-255,66,25752,92,290461
23378,0.000121,74.125.24.0-255,5379,31131,92,290461
23379,0.000123,172.31.47.0-255,66,31197,92,290461
23380,0.000189,74.125.24.0-255,1484,32681,92,290461
23381,0.000194,172.31.47.0-255,66,32747,92,290461
23382,0.000201,74.125.24.0-255,2902,35649,92,290461
23383,0.000202,172.31.47.0-255,66,35715,92,290461
23384,0.000219,74.125.24.0-255,1484,37199,92,290461
23385,0.000221,172.31.47.0-255,66,37265,92,290461
23386,0.000256,74.125.24.0-255,4320,41585,92,290461
23387,0.000258,172.31.47.0-255,66,41651,92,290461
23388,0.000268,172.31.47.0-255,66,41717,92,290461
23389,0.000294,74.125.24.0-255,5379,47096,92,290461
23390,0.000297,172.31.47.0-255,66,47162,92,290461
23391,0.0003,74.125.24.0-255,1484,48646,92,290461
23392,0.000302,172.31.47.0-255,66,48712,92,290461
23393,0.00033,74.125.24.0-255,5738,54450,92,290461
23394,0.000334,172.31.47.0-255,66,54516,92,290461
23395,0.000356,74.125.24.0-255,2856,57372,92,290461
23396,0.00036,172.31.47.0-255,66,57438,92,290461
23397,0.000382,74.125.24.0-255,111,57549,92,290461
23398,0.000409,74.125.24.0-255,1484,59033,92,290461
23399,0.000422,172.31.47.0-255,66,59099,92,290461
23400,0.000438,74.125.24.0-255,2902,62001,92,290461
23401,0.000445,172.31.47.0-255,66,62067,92,290461
23402,0.000456,74.125.24.0-255,2902,64969,92,290461
23403,0.000467,172.31.47.0-255,66,65035,92,290461
23404,0.000478,74.125.24.0-255,4320,69355,92,290461
23405,0.000485,172.31.47.0-255,66,69421,92,290461
23406,0.000508,74.125.24.0-255,2902,72323,92,290461
23407,0.000517,172.31.47.0-255,66,72389,92,290461
23408,0.000523,74.125.24.0-255,2543,74932,92,290461
23409,0.000529,172.31.47.0-255,66,74998,92,290461
23410,0.000538,74.125.24.0-255,1484,76482,92,290461
23411,0.00056,74.125.24.0-255,4585,81067,92,290461
23412,0.000563,172.31.47.0-255,66,81133,92,290461
23413,0.000565,74.125.24.0-255,4320,85453,92,290461
23414,0.000583,74.125.24.0-255,2902,88355,92,290461
23415,0.000586,172.31.47.0-255,66,88421,92,290461
23416,0.00061,74.125.24.0-255,3961,92382,92,290461
23417,0.000619,172.31.47.0-255,66,92448,92,290461
23418,0.001026,74.125.24.0-255,1484,93932,92,290461
23419,0.001039,74.125.24.0-255,2902,96834,92,290461
23420,0.001042,172.31.47.0-255,66,96900,92,290461
23421,0.001048,74.125.24.0-255,4320,101220,92,290461
23422,0.001063,172.31.47.0-255,66,101286,92,290461
23423,0.001068,74.125.24.0-255,1484,102770,92,290461
23424,0.001072,74.125.24.0-255,2902,105672,92,290461
23425,0.001076,74.125.24.0-255,2902,108574,92,290461
23426,0.001084,172.31.47.0-255,66,108640,92,290461
23427,0.001091,74.125.24.0-255,1484,110124,92,290461
23428,0.001122,172.31.47.0-255,66,110190,92,290461
23429,0.001159,74.125.24.0-255,1484,111674,92,290461
23430,0.001162,74.125.24.0-255,1484,113158,92,290461
23431,0.001171,172.31.47.0-255,66,113224,92,290461
23432,0.001176,74.125.24.0-255,1484,114708,92,290461
23433,0.001181,74.125.24.0-255,5738,120446,92,290461
23434,0.001184,172.31.47.0-255,66,120512,92,290461
23435,0.001213,74.125.24.0-255,7156,127668,92,290461
23436,0.001222,172.31.47.0-255,66,127734,92,290461
23437,0.001249,74.125.24.0-255,5738,133472,92,290461
23438,0.001254,172.31.47.0-255,66,133538,92,290461
23439,0.001256,74.125.24.0-255,7156,140694,92,290461
23440,0.001267,172.31.47.0-255,66,140760,92,290461
23441,0.001276,74.125.24.0-255,2902,143662,92,290461
23442,0.00128,172.31.47.0-255,66,143728,92,290461
23443,0.001289,74.125.24.0-255,766,144494,92,290461
23444,0.001329,74.125.24.0-255,1484,145978,92,290461
23445,0.001333,74.125.24.0-255,2902,148880,92,290461
23446,0.001335,172.31.47.0-255,66,148946,92,290461
23447,0.001339,172.31.47.0-255,66,149012,92,290461
23448,0.001367,74.125.24.0-255,5738,154750,92,290461
23449,0.001374,172.31.47.0-255,66,154816,92,290461
23450,0.001413,172.31.47.0-255,66,154882,92,290461
23451,0.001423,74.125.24.0-255,4320,159202,92,290461
23452,0.001425,172.31.47.0-255,66,159268,92,290461
23453,0.001457,172.31.47.0-255,66,159334,92,290461
23454,0.001747,74.125.24.0-255,1484,160818,92,290461
23455,0.001761,74.125.24.0-255,2902,163720,92,290461
23456,0.001764,172.31.47.0-255,66,163786,92,290461
23457,0.00177,74.125.24.0-255,5738,169524,92,290461
23458,0.001777,172.31.47.0-255,66,169590,92,290461
23459,0.001814,172.31.47.0-255,66,169656,92,290461
23460,0.001824,74.125.24.0-255,4320,173976,92,290461
23461,0.001827,172.31.47.0-255,66,174042,92,290461
23462,0.001848,74.125.24.0-255,6438,180480,92,290461
23463,0.001855,172.31.47.0-255,66,180546,92,290461
23464,0.002136,74.125.24.0-255,1484,182030,92,290461
23465,0.002145,74.125.24.0-255,2902,184932,92,290461
23466,0.002148,172.31.47.0-255,66,184998,92,290461
23467,0.002171,74.125.24.0-255,1484,186482,92,290461
23468,0.002182,74.125.24.0-255,1484,187966,92,290461
23469,0.002222,74.125.24.0-255,2902,190868,92,290461
23470,0.002232,74.125.24.0-255,7156,198024,92,290461
23471,0.002237,74.125.24.0-255,4320,202344,92,290461
23472,0.002276,74.125.24.0-255,2902,205246,92,290461
23473,0.002301,74.125.24.0-255,4320,209566,92,290461
23474,0.002305,74.125.24.0-255,2902,212468,92,290461
23475,0.002319,74.125.24.0-255,1484,213952,92,290461
23476,0.002322,74.125.24.0-255,766,214718,92,290461
23477,0.002473,74.125.24.0-255,1484,216202,92,290461
23478,0.002489,74.125.24.0-255,2902,219104,92,290461
23479,0.002491,74.125.24.0-255,1484,220588,92,290461
23480,0.00251,74.125.24.0-255,4320,224908,92,290461
23481,0.002516,74.125.24.0-255,4320,229228,92,290461
23482,0.002518,74.125.24.0-255,1484,230712,92,290461
23483,0.002531,74.125.24.0-255,1484,232196,92,290461
23484,0.002548,74.125.24.0-255,5738,237934,92,290461
23485,0.002564,74.125.24.0-255,4320,242254,92,290461
23486,0.002579,74.125.24.0-255,2902,245156,92,290461
23487,0.0026,74.125.24.0-255,7156,252312,92,290461
23488,0.002624,74.125.24.0-255,6438,258750,92,290461
23489,0.002629,74.125.24.0-255,4320,263070,92,290461
23490,0.002632,74.125.24.0-255,1484,264554,92,290461
23491,0.002636,172.31.47.0-255,78,264632,92,290461
23492,0.002646,172.31.47.0-255,78,264710,92,290461
23493,0.002685,74.125.24.0-255,7156,271866,92,290461
23494,0.00269,74.125.24.0-255,2184,274050,92,290461
23495,0.002705,74.125.24.0-255,4320,278370,92,290461
23496,0.002708,74.125.24.0-255,2902,281272,92,290461
23497,0.002774,74.125.24.0-255,1484,282756,92,290461
23498,0.002777,172.31.47.0-255,78,282834,92,290461
23499,0.002782,74.125.24.0-255,4320,287154,92,290461
23500,0.002784,172.31.47.0-255,78,287232,92,290461
23501,0.002818,172.31.47.0-255,78,287310,92,290461
23502,0.002849,74.125.24.0-255,2902,290212,92,290461
23503,0.0029,74.125.24.0-255,105,290317,92,290461
23504,0.009378,172.31.47.0-255,66,290383,92,290461
23505,0.009392,172.31.47.0-255,78,290461,92,290461
23506,0.0,74.125.24.0-255,153,153,92,113322
23507,2.8e-05,172.31.47.0-255,66,219,92,113322
23508,3.4e-05,74.125.24.0-255,1484,1703,92,113322
23509,3.8e-05,172.31.47.0-255,66,1769,92,113322
23510,4.3e-05,74.125.24.0-255,2902,4671,92,113322
23511,5.2e-05,172.31.47.0-255,66,4737,92,113322
23512,5.7e-05,74.125.24.0-255,5738,10475,92,113322
23513,5.9e-05,172.31.47.0-255,66,10541,92,113322
23514,8.2e-05,74.125.24.0-255,1484,12025,92,113322
23515,8.7e-05,172.31.47.0-255,66,12091,92,113322
23516,9.2e-05,74.125.24.0-255,3481,15572,92,113322
23517,9.4e-05,172.31.47.0-255,66,15638,92,113322
23518,9.7e-05,74.125.24.0-255,2902,18540,92,113322
23519,0.0001,172.31.47.0-255,66,18606,92,113322
23520,0.000129,172.31.47.0-255,66,18672,92,113322
23521,0.000132,74.125.24.0-255,2543,21215,92,113322
23522,0.000134,172.31.47.0-255,66,21281,92,113322
23523,0.000212,74.125.24.0-255,1484,22765,92,113322
23524,0.000216,172.31.47.0-255,66,22831,92,113322
23525,0.000243,74.125.24.0-255,2902,25733,92,113322
23526,0.000245,172.31.47.0-255,66,25799,92,113322
23527,0.000252,74.125.24.0-255,5738,31537,92,113322
23528,0.000254,172.31.47.0-255,66,31603,92,113322
23529,0.000287,172.31.47.0-255,66,31669,92,113322
23530,0.000313,74.125.24.0-255,2902,34571,92,113322
23531,0.000316,172.31.47.0-255,66,34637,92,113322
23532,0.000333,172.31.47.0-255,66,34703,92,113322
23533,0.000579,74.125.24.0-255,645,35348,92,113322
23534,0.000583,172.31.47.0-255,66,35414,92,113322
23535,0.000927,74.125.24.0-255,1484,36898,92,113322
23536,0.000935,74.125.24.0-255,2902,39800,92,113322
23537,0.000938,172.31.47.0-255,66,39866,92,113322
23538,0.000946,74.125.24.0-255,5738,45604,92,113322
23539,0.000947,172.31.47.0-255,66,45670,92,113322
23540,0.000972,172.31.47.0-255,66,45736,92,113322
23541,0.000991,74.125.24.0-255,2902,48638,92,113322
23542,0.000993,172.31.47.0-255,66,48704,92,113322
23543,0.001005,74.125.24.0-255,4320,53024,92,113322
23544,0.001007,172.31.47.0-255,66,53090,92,113322
23545,0.00103,74.125.24.0-255,6438,59528,92,113322
23546,0.001033,172.31.47.0-255,66,59594,92,113322
23547,0.001454,74.125.24.0-255,1484,61078,92,113322
23548,0.00146,74.125.24.0-255,2902,63980,92,113322
23549,0.001463,172.31.47.0-255,66,64046,92,113322
23550,0.001467,74.125.24.0-255,1484,65530,92,113322
23551,0.001488,74.125.24.0-255,4320,69850,92,113322
23552,0.001489,172.31.47.0-255,66,69916,92,113322
23553,0.001502,74.125.24.0-255,2902,72818,92,113322
23554,0.001507,172.31.47.0-255,66,72884,92,113322
23555,0.001538,172.31.47.0-255,66,72950,92,113322
23556,0.001548,172.31.47.0-255,66,73016,92,113322
23557,0.001926,74.125.24.0-255,1484,74500,92,113322
23558,0.001937,74.125.24.0-255,2902,77402,92,113322
23559,0.001939,172.31.47.0-255,66,77468,92,113322
23560,0.001963,74.125.24.0-255,5738,83206,92,113322
23561,0.001965,172.31.47.0-255,66,83272,92,113322
23562,0.001967,74.125.24.0-255,1484,84756,92,113322
23563,0.001997,172.31.47.0-255,66,84822,92,113322
23564,0.002003,74.125.24.0-255,7156,91978,92,113322
23565,0.002004,172.31.47.0-255,66,92044,92,113322
23566,0.002049,74.125.24.0-255,3602,95646,92,113322
23567,0.002051,172.31.47.0-255,66,95712,92,113322
23568,0.004206,74.125.24.0-255,1484,97196,92,113322
23569,0.004246,74.125.24.0-255,1484,98680,92,113322
23570,0.004248,172.31.47.0-255,66,98746,92,113322
23571,0.00427,74.125.24.0-255,2902,101648,92,113322
23572,0.004272,172.31.47.0-255,66,101714,92,113322
23573,0.006491,74.125.24.0-255,5738,107452,92,113322
23574,0.006496,172.31.47.0-255,66,107518,92,113322
23575,0.008737,74.125.24.0-255,5738,113256,92,113322
23576,0.00875,172.31.47.0-255,66,113322,92,113322
23577,0.0,172.31.47.0-255,74,74,92,2067
23578,0.002309,172.217.194.0-255,74,148,92,2067
23579,0.002327,172.31.47.0-255,66,214,92,2067
23580,0.003863,172.31.47.0-255,697,911,92,2067
23581,0.006147,172.217.194.0-255,66,977,92,2067
23582,0.006565,172.217.194.0-255,278,1255,92,2067
23583,0.006573,172.31.47.0-255,66,1321,92,2067
23584,0.007227,172.31.47.0-255,130,1451,92,2067
23585,0.008884,172.31.47.0-255,236,1687,92,2067
23586,0.008909,172.31.47.0-255,380,2067,92,2067
23587,0.0,172.217.194.0-255,153,153,92,262411
23588,2.3e-05,172.31.47.0-255,66,219,92,262411
23589,2.9e-05,172.217.194.0-255,1484,1703,92,262411
23590,3.2e-05,172.31.47.0-255,66,1769,92,262411
23591,3.7e-05,172.217.194.0-255,2902,4671,92,262411
23592,3.9e-05,172.31.47.0-255,66,4737,92,262411
23593,5e-05,172.217.194.0-255,2902,7639,92,262411
23594,5.2e-05,172.31.47.0-255,66,7705,92,262411
23595,8e-05,172.217.194.0-255,4320,12025,92,262411
23596,8.3e-05,172.31.47.0-255,66,12091,92,262411
23597,8.8e-05,172.217.194.0-255,3590,15681,92,262411
23598,8.9e-05,172.31.47.0-255,66,15747,92,262411
23599,9.3e-05,172.217.194.0-255,2902,18649,92,262411
23600,9.4e-05,172.31.47.0-255,66,18715,92,262411
23601,0.000133,172.31.47.0-255,66,18781,92,262411
23602,0.000162,172.217.194.0-255,2902,21683,92,262411
23603,0.000165,172.31.47.0-255,66,21749,92,262411
23604,0.000194,172.31.47.0-255,66,21815,92,262411
23605,0.00023,172.31.47.0-255,66,21881,92,262411
23606,0.000236,172.217.194.0-255,7156,29037,92,262411
23607,0.000238,172.31.47.0-255,66,29103,92,262411
23608,0.000251,172.31.47.0-255,66,29169,92,262411
23609,0.000253,172.217.194.0-255,1378,30547,92,262411
23610,0.000255,172.31.47.0-255,66,30613,92,262411
23611,0.000281,172.217.194.0-255,1484,32097,92,262411
23612,0.000284,172.31.47.0-255,66,32163,92,262411
23613,0.000306,172.217.194.0-255,2902,35065,92,262411
23614,0.000311,172.31.47.0-255,66,35131,92,262411
23615,0.000311,172.217.194.0-255,4320,39451,92,262411
23616,0.000314,172.31.47.0-255,66,39517,92,262411
23617,0.000342,172.217.194.0-255,1484,41001,92,262411
23618,0.000354,172.31.47.0-255,66,41067,92,262411
23619,0.000389,172.217.194.0-255,4320,45387,92,262411
23620,0.000393,172.31.47.0-255,66,45453,92,262411
23621,0.000423,172.31.47.0-255,66,45519,92,262411
23622,0.000484,172.217.194.0-255,1484,47003,92,262411
23623,0.000489,172.217.194.0-255,2902,49905,92,262411
23624,0.000491,172.31.47.0-255,66,49971,92,262411
23625,0.000516,172.217.194.0-255,4320,54291,92,262411
23626,0.000519,172.31.47.0-255,66,54357,92,262411
23627,0.00053,172.217.194.0-255,1484,55841,92,262411
23628,0.000539,172.217.194.0-255,4320,60161,92,262411
23629,0.000541,172.31.47.0-255,66,60227,92,262411
23630,0.000568,172.217.194.0-255,2902,63129,92,262411
23631,0.000571,172.31.47.0-255,66,63195,92,262411
23632,0.000604,172.31.47.0-255,66,63261,92,262411
23633,0.000609,172.217.194.0-255,5738,68999,92,262411
23634,0.000611,172.31.47.0-255,66,69065,92,262411
23635,0.000646,172.217.194.0-255,2184,71249,92,262411
23636,0.00065,172.31.47.0-255,66,71315,92,262411
23637,0.0007,172.217.194.0-255,1484,72799,92,262411
23638,0.000711,172.217.194.0-255,2902,75701,92,262411
23639,0.000714,172.31.47.0-255,66,75767,92,262411
23640,0.000739,172.217.194.0-255,5738,81505,92,262411
23641,0.000742,172.31.47.0-255,66,81571,92,262411
23642,0.000745,172.217.194.0-255,1484,83055,92,262411
23643,0.000772,172.217.194.0-255,4320,87375,92,262411
23644,0.000775,172.31.47.0-255,66,87441,92,262411
23645,0.000788,172.217.194.0-255,4320,91761,92,262411
23646,0.000794,172.31.47.0-255,66,91827,92,262411
23647,0.000801,172.217.194.0-255,7156,98983,92,262411
23648,0.000803,172.31.47.0-255,66,99049,92,262411
23649,0.00084,172.217.194.0-255,4320,103369,92,262411
23650,0.000843,172.31.47.0-255,66,103435,92,262411
23651,0.000869,172.217.194.0-255,5020,108455,92,262411
23652,0.000871,172.31.47.0-255,66,108521,92,262411
23653,0.000881,172.31.47.0-255,66,108587,92,262411
23654,0.000905,172.217.194.0-255,1484,110071,92,262411
23655,0.000911,172.217.194.0-255,5738,115809,92,262411
23656,0.000913,172.31.47.0-255,66,115875,92,262411
23657,0.000985,172.31.47.0-255,66,115941,92,262411
23658,0.001204,172.217.194.0-255,1484,117425,92,262411
23659,0.001241,172.217.194.0-255,1484,118909,92,262411
23660,0.001244,172.31.47.0-255,66,118975,92,262411
23661,0.001262,172.217.194.0-255,1484,120459,92,262411
23662,0.001272,172.217.194.0-255,1484,121943,92,262411
23663,0.001274,172.31.47.0-255,66,122009,92,262411
23664,0.001299,172.217.194.0-255,4320,126329,92,262411
23665,0.001301,172.31.47.0-255,66,126395,92,262411
23666,0.001305,172.217.194.0-255,2902,129297,92,262411
23667,0.001307,172.31.47.0-255,66,129363,92,262411
23668,0.00132,172.31.47.0-255,66,129429,92,262411
23669,0.001326,172.217.194.0-255,5738,135167,92,262411
23670,0.001329,172.31.47.0-255,66,135233,92,262411
23671,0.001358,172.217.194.0-255,1484,136717,92,262411
23672,0.001363,172.217.194.0-255,3602,140319,92,262411
23673,0.001366,172.31.47.0-255,66,140385,92,262411
23674,0.001466,172.217.194.0-255,1484,141869,92,262411
23675,0.00148,172.217.194.0-255,2902,144771,92,262411
23676,0.001483,172.31.47.0-255,66,144837,92,262411
23677,0.001512,172.217.194.0-255,5738,150575,92,262411
23678,0.001515,172.31.47.0-255,66,150641,92,262411
23679,0.001519,172.217.194.0-255,2902,153543,92,262411
23680,0.001521,172.31.47.0-255,66,153609,92,262411
23681,0.001562,172.31.47.0-255,66,153675,92,262411
23682,0.001568,172.217.194.0-255,5738,159413,92,262411
23683,0.001571,172.31.47.0-255,66,159479,92,262411
23684,0.0016,172.217.194.0-255,5020,164499,92,262411
23685,0.001604,172.31.47.0-255,66,164565,92,262411
23686,0.001681,172.217.194.0-255,1484,166049,92,262411
23687,0.001686,172.217.194.0-255,2902,168951,92,262411
23688,0.001689,172.31.47.0-255,66,169017,92,262411
23689,0.001692,172.217.194.0-255,1484,170501,92,262411
23690,0.001718,172.217.194.0-255,4320,174821,92,262411
23691,0.001721,172.31.47.0-255,66,174887,92,262411
23692,0.001727,172.217.194.0-255,2902,177789,92,262411
23693,0.001729,172.31.47.0-255,66,177855,92,262411
23694,0.001733,172.217.194.0-255,2902,180757,92,262411
23695,0.001734,172.31.47.0-255,66,180823,92,262411
23696,0.001753,172.217.194.0-255,7156,187979,92,262411
23697,0.001756,172.31.47.0-255,66,188045,92,262411
23698,0.001766,172.217.194.0-255,4320,192365,92,262411
23699,0.001768,172.31.47.0-255,66,192431,92,262411
23700,0.001791,172.217.194.0-255,1484,193915,92,262411
23701,0.001795,172.217.194.0-255,1484,195399,92,262411
23702,0.001802,172.31.47.0-255,66,195465,92,262411
23703,0.001823,172.217.194.0-255,5020,200485,92,262411
23704,0.001826,172.31.47.0-255,66,200551,92,262411
23705,0.001831,172.217.194.0-255,5738,206289,92,262411
23706,0.001833,172.31.47.0-255,66,206355,92,262411
23707,0.001856,172.217.194.0-255,4320,210675,92,262411
23708,0.001863,172.31.47.0-255,66,210741,92,262411
23709,0.001901,172.31.47.0-255,66,210807,92,262411
23710,0.001902,172.217.194.0-255,5738,216545,92,262411
23711,0.001904,172.31.47.0-255,66,216611,92,262411
23712,0.001943,172.31.47.0-255,66,216677,92,262411
23713,0.001949,172.217.194.0-255,4320,220997,92,262411
23714,0.001951,172.31.47.0-255,66,221063,92,262411
23715,0.001973,172.217.194.0-255,5738,226801,92,262411
23716,0.001976,172.31.47.0-255,66,226867,92,262411
23717,0.001988,172.217.194.0-255,4320,231187,92,262411
23718,0.001991,172.31.47.0-255,66,231253,92,262411
23719,0.00203,172.31.47.0-255,66,231319,92,262411
23720,0.002033,172.217.194.0-255,1484,232803,92,262411
23721,0.002058,172.217.194.0-255,6438,239241,92,262411
23722,0.002061,172.31.47.0-255,66,239307,92,262411
23723,0.002111,172.217.194.0-255,5738,245045,92,262411
23724,0.002114,172.31.47.0-255,66,245111,92,262411
23725,0.002145,172.217.194.0-255,2902,248013,92,262411
23726,0.002148,172.31.47.0-255,66,248079,92,262411
23727,0.002154,172.217.194.0-255,5738,253817,92,262411
23728,0.002156,172.31.47.0-255,66,253883,92,262411
23729,0.002178,172.31.47.0-255,66,253949,92,262411
23730,0.002183,172.217.194.0-255,3602,257551,92,262411
23731,0.002185,172.31.47.0-255,66,257617,92,262411
23732,0.002191,172.217.194.0-255,4320,261937,92,262411
23733,0.002194,172.31.47.0-255,66,262003,92,262411
23734,0.002235,172.31.47.0-255,66,262069,92,262411
23735,0.002238,172.217.194.0-255,105,262174,92,262411
23736,0.003353,172.31.47.0-255,66,262240,92,262411
23737,0.003377,172.31.47.0-255,105,262345,92,262411
23738,0.005584,172.217.194.0-255,66,262411,92,262411
23739,0.0,172.31.47.0-255,105,105,92,105
23740,0.0,74.125.200.0-255,153,153,92,170275
23741,2.3e-05,172.31.47.0-255,66,219,92,170275
23742,3e-05,74.125.200.0-255,1484,1703,92,170275
23743,3.5e-05,172.31.47.0-255,66,1769,92,170275
23744,6.3e-05,74.125.200.0-255,2902,4671,92,170275
23745,6.7e-05,172.31.47.0-255,66,4737,92,170275
23746,7.3e-05,74.125.200.0-255,4320,9057,92,170275
23747,7.6e-05,172.31.47.0-255,66,9123,92,170275
23748,0.000112,74.125.200.0-255,4983,14106,92,170275
23749,0.000115,172.31.47.0-255,66,14172,92,170275
23750,0.000139,74.125.200.0-255,1484,15656,92,170275
23751,0.000142,172.31.47.0-255,66,15722,92,170275
23752,0.000166,74.125.200.0-255,4320,20042,92,170275
23753,0.000169,172.31.47.0-255,66,20108,92,170275
23754,0.000172,74.125.200.0-255,1484,21592,92,170275
23755,0.000175,172.31.47.0-255,66,21658,92,170275
23756,0.000179,74.125.200.0-255,2902,24560,92,170275
23757,0.000182,172.31.47.0-255,66,24626,92,170275
23758,0.00021,74.125.200.0-255,5738,30364,92,170275
23759,0.000214,172.31.47.0-255,66,30430,92,170275
23760,0.000217,74.125.200.0-255,1125,31555,92,170275
23761,0.00022,172.31.47.0-255,66,31621,92,170275
23762,0.000801,74.125.200.0-255,1484,33105,92,170275
23763,0.000807,172.31.47.0-255,66,33171,92,170275
23764,0.000817,74.125.200.0-255,2902,36073,92,170275
23765,0.000819,172.31.47.0-255,66,36139,92,170275
23766,0.000825,74.125.200.0-255,4320,40459,92,170275
23767,0.000827,172.31.47.0-255,66,40525,92,170275
23768,0.000868,74.125.200.0-255,2902,43427,92,170275
23769,0.000872,172.31.47.0-255,66,43493,92,170275
23770,0.000892,74.125.200.0-255,5379,48872,92,170275
23771,0.000895,172.31.47.0-255,66,48938,92,170275
23772,0.000983,74.125.200.0-255,1484,50422,92,170275
23773,0.001021,74.125.200.0-255,1484,51906,92,170275
23774,0.001025,172.31.47.0-255,66,51972,92,170275
23775,0.001029,74.125.200.0-255,1484,53456,92,170275
23776,0.001047,74.125.200.0-255,1484,54940,92,170275
23777,0.00105,172.31.47.0-255,66,55006,92,170275
23778,0.001057,74.125.200.0-255,5738,60744,92,170275
23779,0.001059,172.31.47.0-255,66,60810,92,170275
23780,0.001065,74.125.200.0-255,4320,65130,92,170275
23781,0.001068,172.31.47.0-255,66,65196,92,170275
23782,0.001092,74.125.200.0-255,1125,66321,92,170275
23783,0.001098,74.125.200.0-255,5738,72059,92,170275
23784,0.001117,172.31.47.0-255,66,72125,92,170275
23785,0.001142,172.31.47.0-255,66,72191,92,170275
23786,0.00116,172.31.47.0-255,66,72257,92,170275
23787,0.001169,74.125.200.0-255,6438,78695,92,170275
23788,0.001172,172.31.47.0-255,66,78761,92,170275
23789,0.001244,74.125.200.0-255,646,79407,92,170275
23790,0.001269,74.125.200.0-255,1484,80891,92,170275
23791,0.001272,172.31.47.0-255,66,80957,92,170275
23792,0.001276,74.125.200.0-255,1484,82441,92,170275
23793,0.001293,74.125.200.0-255,1484,83925,92,170275
23794,0.001296,172.31.47.0-255,66,83991,92,170275
23795,0.001303,74.125.200.0-255,5738,89729,92,170275
23796,0.001306,172.31.47.0-255,66,89795,92,170275
23797,0.001334,74.125.200.0-255,7156,96951,92,170275
23798,0.001337,172.31.47.0-255,66,97017,92,170275
23799,0.001341,74.125.200.0-255,2902,99919,92,170275
23800,0.001344,172.31.47.0-255,66,99985,92,170275
23801,0.001372,74.125.200.0-255,5738,105723,92,170275
23802,0.001375,172.31.47.0-255,66,105789,92,170275
23803,0.001388,172.31.47.0-255,66,105855,92,170275
23804,0.002001,74.125.200.0-255,1484,107339,92,170275
23805,0.002023,74.125.200.0-255,2902,110241,92,170275
23806,0.002028,172.31.47.0-255,66,110307,92,170275
23807,0.002032,74.125.200.0-255,1484,111791,92,170275
23808,0.002036,74.125.200.0-255,2902,114693,92,170275
23809,0.002038,172.31.47.0-255,66,114759,92,170275
23810,0.002059,74.125.200.0-255,5738,120497,92,170275
23811,0.002062,172.31.47.0-255,66,120563,92,170275
23812,0.002107,172.31.47.0-255,66,120629,92,170275
23813,0.002143,74.125.200.0-255,6438,127067,92,170275
23814,0.002146,172.31.47.0-255,66,127133,92,170275
23815,0.002184,74.125.200.0-255,1484,128617,92,170275
23816,0.00221,74.125.200.0-255,2902,131519,92,170275
23817,0.002213,172.31.47.0-255,66,131585,92,170275
23818,0.002223,74.125.200.0-255,5738,137323,92,170275
23819,0.002226,172.31.47.0-255,66,137389,92,170275
23820,0.002231,74.125.200.0-255,2902,140291,92,170275
23821,0.002234,172.31.47.0-255,66,140357,92,170275
23822,0.002261,74.125.200.0-255,4320,144677,92,170275
23823,0.002263,172.31.47.0-255,66,144743,92,170275
23824,0.002278,172.31.47.0-255,66,144809,92,170275
23825,0.002282,74.125.200.0-255,2902,147711,92,170275
23826,0.002284,172.31.47.0-255,66,147777,92,170275
23827,0.002315,74.125.200.0-255,5020,152797,92,170275
23828,0.002318,172.31.47.0-255,66,152863,92,170275
23829,0.004657,74.125.200.0-255,5738,158601,92,170275
23830,0.004677,172.31.47.0-255,66,158667,92,170275
23831,0.006999,74.125.200.0-255,5738,164405,92,170275
23832,0.007016,172.31.47.0-255,66,164471,92,170275
23833,0.009332,74.125.200.0-255,5738,170209,92,170275
23834,0.009347,172.31.47.0-255,66,170275,92,170275
23835,0.0,172.31.47.0-255,105,105,92,276
23836,0.001787,157.240.13.0-255,105,210,92,276
23837,0.0018,172.31.47.0-255,66,276,92,276
23838,0.0,74.125.24.0-255,152,152,92,201141
23839,4e-05,172.31.47.0-255,66,218,92,201141
23840,4.8e-05,74.125.24.0-255,1484,1702,92,201141
23841,5.4e-05,172.31.47.0-255,66,1768,92,201141
23842,5.9e-05,74.125.24.0-255,2902,4670,92,201141
23843,6.1e-05,172.31.47.0-255,66,4736,92,201141
23844,7.6e-05,74.125.24.0-255,7156,11892,92,201141
23845,7.9e-05,172.31.47.0-255,66,11958,92,201141
23846,8.6e-05,74.125.24.0-255,6355,18313,92,201141
23847,8.8e-05,172.31.47.0-255,66,18379,92,201141
23848,9.5e-05,74.125.24.0-255,7156,25535,92,201141
23849,9.9e-05,172.31.47.0-255,66,25601,92,201141
23850,0.00014,74.125.24.0-255,5379,30980,92,201141
23851,0.000143,172.31.47.0-255,66,31046,92,201141
23852,0.000171,74.125.24.0-255,1484,32530,92,201141
23853,0.000174,172.31.47.0-255,66,32596,92,201141
23854,0.000178,74.125.24.0-255,1484,34080,92,201141
23855,0.00018,172.31.47.0-255,66,34146,92,201141
23856,0.000211,74.125.24.0-255,1484,35630,92,201141
23857,0.000213,172.31.47.0-255,66,35696,92,201141
23858,0.000219,74.125.24.0-255,5738,41434,92,201141
23859,0.000221,172.31.47.0-255,66,41500,92,201141
23860,0.000256,172.31.47.0-255,66,41566,92,201141
23861,0.000276,172.31.47.0-255,66,41632,92,201141
23862,0.000282,74.125.24.0-255,5020,46652,92,201141
23863,0.000286,172.31.47.0-255,66,46718,92,201141
23864,0.000314,74.125.24.0-255,677,47395,92,201141
23865,0.000317,172.31.47.0-255,66,47461,92,201141
23866,0.000348,74.125.24.0-255,1484,48945,92,201141
23867,0.00035,172.31.47.0-255,66,49011,92,201141
23868,0.000357,74.125.24.0-255,4320,53331,92,201141
23869,0.000359,172.31.47.0-255,66,53397,92,201141
23870,0.000408,172.31.47.0-255,66,53463,92,201141
23871,0.000434,74.125.24.0-255,1994,55457,92,201141
23872,0.000445,172.31.47.0-255,66,55523,92,201141
23873,0.000681,74.125.24.0-255,1484,57007,92,201141
23874,0.0007,74.125.24.0-255,2902,59909,92,201141
23875,0.000704,172.31.47.0-255,66,59975,92,201141
23876,0.000711,74.125.24.0-255,5738,65713,92,201141
23877,0.000723,172.31.47.0-255,66,65779,92,201141
23878,0.000753,172.31.47.0-255,66,65845,92,201141
23879,0.000756,74.125.24.0-255,2902,68747,92,201141
23880,0.00077,172.31.47.0-255,66,68813,92,201141
23881,0.000816,74.125.24.0-255,7156,75969,92,201141
23882,0.000821,172.31.47.0-255,66,76035,92,201141
23883,0.000847,74.125.24.0-255,3602,79637,92,201141
23884,0.000856,172.31.47.0-255,66,79703,92,201141
23885,0.000987,74.125.24.0-255,1484,81187,92,201141
23886,0.001023,74.125.24.0-255,2902,84089,92,201141
23887,0.001027,172.31.47.0-255,66,84155,92,201141
23888,0.001033,74.125.24.0-255,4320,88475,92,201141
23889,0.001043,172.31.47.0-255,66,88541,92,201141
23890,0.001058,74.125.24.0-255,1484,90025,92,201141
23891,0.001069,74.125.24.0-255,5738,95763,92,201141
23892,0.001081,172.31.47.0-255,66,95829,92,201141
23893,0.001085,74.125.24.0-255,5020,100849,92,201141
23894,0.001087,172.31.47.0-255,66,100915,92,201141
23895,0.001104,172.31.47.0-255,66,100981,92,201141
23896,0.001277,74.125.24.0-255,1484,102465,92,201141
23897,0.001281,74.125.24.0-255,1484,103949,92,201141
23898,0.001284,172.31.47.0-255,66,104015,92,201141
23899,0.001305,74.125.24.0-255,1484,105499,92,201141
23900,0.001313,74.125.24.0-255,5738,111237,92,201141
23901,0.001325,172.31.47.0-255,66,111303,92,201141
23902,0.001337,74.125.24.0-255,5738,117041,92,201141
23903,0.001341,172.31.47.0-255,66,117107,92,201141
23904,0.001364,74.125.24.0-255,7156,124263,92,201141
23905,0.001377,172.31.47.0-255,66,124329,92,201141
23906,0.001419,172.31.47.0-255,66,124395,92,201141
23907,0.001478,74.125.24.0-255,1484,125879,92,201141
23908,0.001493,74.125.24.0-255,2902,128781,92,201141
23909,0.001496,172.31.47.0-255,66,128847,92,201141
23910,0.001523,74.125.24.0-255,4320,133167,92,201141
23911,0.001529,172.31.47.0-255,66,133233,92,201141
23912,0.001534,74.125.24.0-255,1484,134717,92,201141
23913,0.001541,74.125.24.0-255,5738,140455,92,201141
23914,0.001555,172.31.47.0-255,66,140521,92,201141
23915,0.001561,74.125.24.0-255,7156,147677,92,201141
23916,0.001581,172.31.47.0-255,66,147743,92,201141
23917,0.001599,74.125.24.0-255,2184,149927,92,201141
23918,0.001606,172.31.47.0-255,66,149993,92,201141
23919,0.001824,74.125.24.0-255,1484,151477,92,201141
23920,0.001845,74.125.24.0-255,2902,154379,92,201141
23921,0.001849,172.31.47.0-255,66,154445,92,201141
23922,0.001857,74.125.24.0-255,4320,158765,92,201141
23923,0.001865,172.31.47.0-255,66,158831,92,201141
23924,0.001895,74.125.24.0-255,7156,165987,92,201141
23925,0.001903,172.31.47.0-255,66,166053,92,201141
23926,0.001931,74.125.24.0-255,1484,167537,92,201141
23927,0.001951,172.31.47.0-255,66,167603,92,201141
23928,0.002177,74.125.24.0-255,1484,169087,92,201141
23929,0.002184,74.125.24.0-255,2902,171989,92,201141
23930,0.002188,172.31.47.0-255,66,172055,92,201141
23931,0.002195,74.125.24.0-255,5738,177793,92,201141
23932,0.002213,74.125.24.0-255,2902,180695,92,201141
23933,0.002259,74.125.24.0-255,1484,182179,92,201141
23934,0.002323,74.125.24.0-255,1484,183663,92,201141
23935,0.002613,172.31.47.0-255,66,183729,92,201141
23936,0.004886,74.125.24.0-255,5738,189467,92,201141
23937,0.004903,172.31.47.0-255,66,189533,92,201141
23938,0.007142,74.125.24.0-255,5738,195271,92,201141
23939,0.00716,172.31.47.0-255,66,195337,92,201141
23940,0.009393,74.125.24.0-255,5738,201075,92,201141
23941,0.009405,172.31.47.0-255,66,201141,92,201141
23942,0.0,52.33.61.0-255,97,97,92,260
23943,0.000144,172.31.47.0-255,97,194,92,260
23944,0.000155,172.31.47.0-255,66,260,92,260
23945,0.0,172.217.194.0-255,226,226,92,40758
23946,2.7e-05,172.31.47.0-255,66,292,92,40758
23947,3.3e-05,172.217.194.0-255,1484,1776,92,40758
23948,3.7e-05,172.31.47.0-255,66,1842,92,40758
23949,5.6e-05,172.217.194.0-255,1484,3326,92,40758
23950,5.8e-05,172.31.47.0-255,66,3392,92,40758
23951,7.8e-05,172.217.194.0-255,2902,6294,92,40758
23952,8.3e-05,172.31.47.0-255,66,6360,92,40758
23953,0.000261,172.217.194.0-255,1484,7844,92,40758
23954,0.000266,172.31.47.0-255,66,7910,92,40758
23955,0.000297,172.217.194.0-255,6462,14372,92,40758
23956,0.0003,172.31.47.0-255,66,14438,92,40758
23957,0.000643,172.31.47.0-255,66,14504,92,40758
23958,0.001009,172.217.194.0-255,7156,21660,92,40758
23959,0.001014,172.31.47.0-255,66,21726,92,40758
23960,0.001044,172.217.194.0-255,1158,22884,92,40758
23961,0.001047,172.31.47.0-255,66,22950,92,40758
23962,0.003363,172.217.194.0-255,4320,27270,92,40758
23963,0.003368,172.31.47.0-255,66,27336,92,40758
23964,0.003448,172.217.194.0-255,1484,28820,92,40758
23965,0.003451,172.31.47.0-255,66,28886,92,40758
23966,0.00573,172.217.194.0-255,4320,33206,92,40758
23967,0.005737,172.31.47.0-255,66,33272,92,40758
23968,0.005807,172.217.194.0-255,1484,34756,92,40758
23969,0.005812,172.31.47.0-255,66,34822,92,40758
23970,0.008099,172.217.194.0-255,2902,37724,92,40758
23971,0.008105,172.31.47.0-255,66,37790,92,40758
23972,0.00816,172.217.194.0-255,2902,40692,92,40758
23973,0.008165,172.31.47.0-255,66,40758,92,40758
23974,0.0,74.125.24.0-255,153,153,92,304108
23975,2e-05,172.31.47.0-255,66,219,92,304108
23976,2.8e-05,74.125.24.0-255,1484,1703,92,304108
23977,3.2e-05,172.31.47.0-255,66,1769,92,304108
23978,6.7e-05,74.125.24.0-255,2902,4671,92,304108
23979,7.1e-05,172.31.47.0-255,66,4737,92,304108
23980,9.9e-05,74.125.24.0-255,5738,10475,92,304108
23981,0.000102,172.31.47.0-255,66,10541,92,304108
23982,0.000106,74.125.24.0-255,2902,13443,92,304108
23983,0.000109,172.31.47.0-255,66,13509,92,304108
23984,0.000161,172.31.47.0-255,66,13575,92,304108
23985,0.000165,74.125.24.0-255,1484,15059,92,304108
23986,0.000167,172.31.47.0-255,66,15125,92,304108
23987,0.000214,74.125.24.0-255,2902,18027,92,304108
23988,0.000216,172.31.47.0-255,66,18093,92,304108
23989,0.00024,74.125.24.0-255,2543,20636,92,304108
23990,0.000242,172.31.47.0-255,66,20702,92,304108
23991,0.000936,74.125.24.0-255,1484,22186,92,304108
23992,0.000943,172.31.47.0-255,66,22252,92,304108
23993,0.00095,74.125.24.0-255,2902,25154,92,304108
23994,0.000953,172.31.47.0-255,66,25220,92,304108
23995,0.000964,74.125.24.0-255,5738,30958,92,304108
23996,0.000966,172.31.47.0-255,66,31024,92,304108
23997,0.000972,74.125.24.0-255,6797,37821,92,304108
23998,0.000975,172.31.47.0-255,66,37887,92,304108
23999,0.000983,74.125.24.0-255,7156,45043,92,304108
24000,0.000986,172.31.47.0-255,66,45109,92,304108
24001,0.001021,172.31.47.0-255,66,45175,92,304108
24002,0.001391,74.125.24.0-255,110,45285,92,304108
24003,0.001397,172.31.47.0-255,66,45351,92,304108
24004,0.00159,74.125.24.0-255,1484,46835,92,304108
24005,0.001597,74.125.24.0-255,2902,49737,92,304108
24006,0.001633,74.125.24.0-255,5738,55475,92,304108
24007,0.001653,74.125.24.0-255,5738,61213,92,304108
24008,0.001675,74.125.24.0-255,4320,65533,92,304108
24009,0.001698,74.125.24.0-255,5020,70553,92,304108
24010,0.001747,74.125.24.0-255,4320,74873,92,304108
24011,0.001775,74.125.24.0-255,2229,77102,92,304108
24012,0.002622,74.125.24.0-255,1484,78586,92,304108
24013,0.002635,74.125.24.0-255,2902,81488,92,304108
24014,0.002658,74.125.24.0-255,5738,87226,92,304108
24015,0.002676,74.125.24.0-255,2902,90128,92,304108
24016,0.002697,74.125.24.0-255,4320,94448,92,304108
24017,0.002704,74.125.24.0-255,7156,101604,92,304108
24018,0.002707,74.125.24.0-255,1484,103088,92,304108
24019,0.002709,74.125.24.0-255,1484,104572,92,304108
24020,0.002732,74.125.24.0-255,6438,111010,92,304108
24021,0.002809,74.125.24.0-255,1484,112494,92,304108
24022,0.002833,74.125.24.0-255,2902,115396,92,304108
24023,0.002845,74.125.24.0-255,4320,119716,92,304108
24024,0.002872,74.125.24.0-255,5738,125454,92,304108
24025,0.002885,74.125.24.0-255,2902,128356,92,304108
24026,0.002897,74.125.24.0-255,2902,131258,92,304108
24027,0.002944,74.125.24.0-255,3602,134860,92,304108
24028,0.003988,74.125.24.0-255,1484,136344,92,304108
24029,0.004,74.125.24.0-255,2902,139246,92,304108
24030,0.004003,74.125.24.0-255,1484,140730,92,304108
24031,0.004022,74.125.24.0-255,2902,143632,92,304108
24032,0.004037,74.125.24.0-255,5738,149370,92,304108
24033,0.004052,74.125.24.0-255,2902,152272,92,304108
24034,0.004065,74.125.24.0-255,4320,156592,92,304108
24035,0.004081,74.125.24.0-255,4320,160912,92,304108
24036,0.004101,74.125.24.0-255,4320,165232,92,304108
24037,0.004151,74.125.24.0-255,3602,168834,92,304108
24038,0.004286,74.125.24.0-255,1484,170318,92,304108
24039,0.004304,74.125.24.0-255,2902,173220,92,304108
24040,0.004327,74.125.24.0-255,5738,178958,92,304108
24041,0.00433,74.125.24.0-255,1484,180442,92,304108
24042,0.004367,74.125.24.0-255,2902,183344,92,304108
24043,0.004378,74.125.24.0-255,2902,186246,92,304108
24044,0.004456,74.125.24.0-255,1484,187730,92,304108
24045,0.004459,74.125.24.0-255,1484,189214,92,304108
24046,0.004477,74.125.24.0-255,1484,190698,92,304108
24047,0.004484,74.125.24.0-255,5738,196436,92,304108
24048,0.004519,74.125.24.0-255,5738,202174,92,304108
24049,0.004543,74.125.24.0-255,7156,209330,92,304108
24050,0.00455,74.125.24.0-255,5738,215068,92,304108
24051,0.004584,74.125.24.0-255,5020,220088,92,304108
24052,0.004624,74.125.24.0-255,4320,224408,92,304108
24053,0.004645,74.125.24.0-255,5738,230146,92,304108
24054,0.004649,74.125.24.0-255,1484,231630,92,304108
24055,0.004678,74.125.24.0-255,2902,234532,92,304108
24056,0.004759,74.125.24.0-255,1484,236016,92,304108
24057,0.004771,74.125.24.0-255,2902,238918,92,304108
24058,0.004775,74.125.24.0-255,1484,240402,92,304108
24059,0.004788,74.125.24.0-255,4320,244722,92,304108
24060,0.00484,74.125.24.0-255,4320,249042,92,304108
24061,0.004847,74.125.24.0-255,7156,256198,92,304108
24062,0.004882,74.125.24.0-255,3602,259800,92,304108
24063,0.004929,74.125.24.0-255,2902,262702,92,304108
24064,0.004942,74.125.24.0-255,1484,264186,92,304108
24065,0.004945,74.125.24.0-255,1484,265670,92,304108
24066,0.004965,74.125.24.0-255,4320,269990,92,304108
24067,0.00497,74.125.24.0-255,2902,272892,92,304108
24068,0.004999,74.125.24.0-255,7156,280048,92,304108
24069,0.005009,74.125.24.0-255,1484,281532,92,304108
24070,0.005037,74.125.24.0-255,3602,285134,92,304108
24071,0.005055,74.125.24.0-255,4320,289454,92,304108
24072,0.005072,74.125.24.0-255,2902,292356,92,304108
24073,0.005103,74.125.24.0-255,7156,299512,92,304108
24074,0.005146,74.125.24.0-255,4320,303832,92,304108
24075,0.005175,74.125.24.0-255,105,303937,92,304108
24076,0.005328,172.31.47.0-255,66,304003,92,304108
24077,0.00834,172.31.47.0-255,105,304108,92,304108
24078,0.0,172.217.160.0-255,153,153,92,107522
24079,3.4e-05,172.31.47.0-255,66,219,92,107522
24080,4e-05,172.217.160.0-255,1484,1703,92,107522
24081,4.5e-05,172.31.47.0-255,66,1769,92,107522
24082,4.7e-05,172.217.160.0-255,1484,3253,92,107522
24083,4.9e-05,172.31.47.0-255,66,3319,92,107522
24084,7.6e-05,172.217.160.0-255,1484,4803,92,107522
24085,7.8e-05,172.31.47.0-255,66,4869,92,107522
24086,8.6e-05,172.217.160.0-255,7156,12025,92,107522
24087,8.8e-05,172.31.47.0-255,66,12091,92,107522
24088,0.000103,172.31.47.0-255,66,12157,92,107522
24089,0.000107,172.217.160.0-255,4320,16477,92,107522
24090,0.00011,172.31.47.0-255,66,16543,92,107522
24091,0.000131,172.217.160.0-255,2543,19086,92,107522
24092,0.000135,172.31.47.0-255,66,19152,92,107522
24093,0.00014,172.217.160.0-255,4320,23472,92,107522
24094,0.000142,172.31.47.0-255,66,23538,92,107522
24095,0.000159,172.217.160.0-255,2902,26440,92,107522
24096,0.000163,172.31.47.0-255,66,26506,92,107522
24097,0.000171,172.217.160.0-255,5738,32244,92,107522
24098,0.000174,172.31.47.0-255,66,32310,92,107522
24099,0.000215,172.217.160.0-255,6797,39107,92,107522
24100,0.000219,172.31.47.0-255,66,39173,92,107522
24101,0.000223,172.217.160.0-255,2902,42075,92,107522
24102,0.000225,172.31.47.0-255,66,42141,92,107522
24103,0.00024,172.217.160.0-255,4320,46461,92,107522
24104,0.000243,172.31.47.0-255,66,46527,92,107522
24105,0.000251,172.217.160.0-255,6797,53324,92,107522
24106,0.000253,172.31.47.0-255,66,53390,92,107522
24107,0.000267,172.217.160.0-255,373,53763,92,107522
24108,0.000269,172.31.47.0-255,66,53829,92,107522
24109,0.000589,172.217.160.0-255,100,53929,92,107522
24110,0.000642,172.217.160.0-255,1484,55413,92,107522
24111,0.000646,172.217.160.0-255,2902,58315,92,107522
24112,0.000647,172.31.47.0-255,66,58381,92,107522
24113,0.00065,172.31.47.0-255,66,58447,92,107522
24114,0.000655,172.217.160.0-255,1484,59931,92,107522
24115,0.000673,172.217.160.0-255,4320,64251,92,107522
24116,0.000676,172.31.47.0-255,66,64317,92,107522
24117,0.00072,172.217.160.0-255,5738,70055,92,107522
24118,0.000722,172.31.47.0-255,66,70121,92,107522
24119,0.000752,172.31.47.0-255,66,70187,92,107522
24120,0.000761,172.31.47.0-255,66,70253,92,107522
24121,0.000913,172.217.160.0-255,367,70620,92,107522
24122,0.000951,172.31.47.0-255,66,70686,92,107522
24123,0.001528,172.217.160.0-255,1484,72170,92,107522
24124,0.001537,172.217.160.0-255,2902,75072,92,107522
24125,0.001541,172.31.47.0-255,66,75138,92,107522
24126,0.001547,172.217.160.0-255,5738,80876,92,107522
24127,0.001549,172.31.47.0-255,66,80942,92,107522
24128,0.001603,172.31.47.0-255,66,81008,92,107522
24129,0.001612,172.31.47.0-255,66,81074,92,107522
24130,0.003266,172.217.160.0-255,4320,85394,92,107522
24131,0.003269,172.31.47.0-255,66,85460,92,107522
24132,0.003279,172.217.160.0-255,1484,86944,92,107522
24133,0.004924,172.217.160.0-255,2902,89846,92,107522
24134,0.004927,172.31.47.0-255,66,89912,92,107522
24135,0.004939,172.217.160.0-255,1484,91396,92,107522
24136,0.006598,172.217.160.0-255,4320,95716,92,107522
24137,0.006604,172.31.47.0-255,66,95782,92,107522
24138,0.008265,172.217.160.0-255,2902,98684,92,107522
24139,0.008271,172.31.47.0-255,66,98750,92,107522
24140,0.00829,172.217.160.0-255,2902,101652,92,107522
24141,0.008293,172.31.47.0-255,66,101718,92,107522
24142,0.009952,172.217.160.0-255,5738,107456,92,107522
24143,0.009959,172.31.47.0-255,66,107522,92,107522
24144,0.0,74.125.24.0-255,153,153,92,210443
24145,2.9e-05,172.31.47.0-255,66,219,92,210443
24146,3.5e-05,74.125.24.0-255,1484,1703,92,210443
24147,3.9e-05,172.31.47.0-255,66,1769,92,210443
24148,4.3e-05,74.125.24.0-255,2902,4671,92,210443
24149,4.5e-05,172.31.47.0-255,66,4737,92,210443
24150,5.1e-05,74.125.24.0-255,7156,11893,92,210443
24151,5.4e-05,172.31.47.0-255,66,11959,92,210443
24152,7.7e-05,74.125.24.0-255,2110,14069,92,210443
24153,7.8e-05,172.31.47.0-255,66,14135,92,210443
24154,0.000107,74.125.24.0-255,2902,17037,92,210443
24155,0.000109,172.31.47.0-255,66,17103,92,210443
24156,0.00013,74.125.24.0-255,4320,21423,92,210443
24157,0.000132,172.31.47.0-255,66,21489,92,210443
24158,0.000136,74.125.24.0-255,2902,24391,92,210443
24159,0.000137,172.31.47.0-255,66,24457,92,210443
24160,0.000158,74.125.24.0-255,5738,30195,92,210443
24161,0.00016,172.31.47.0-255,66,30261,92,210443
24162,0.000181,74.125.24.0-255,5738,35999,92,210443
24163,0.000186,172.31.47.0-255,66,36065,92,210443
24164,0.000211,74.125.24.0-255,6797,42862,92,210443
24165,0.000214,172.31.47.0-255,66,42928,92,210443
24166,0.000226,74.125.24.0-255,2902,45830,92,210443
24167,0.000228,172.31.47.0-255,66,45896,92,210443
24168,0.000242,74.125.24.0-255,2543,48439,92,210443
24169,0.000244,172.31.47.0-255,66,48505,92,210443
24170,0.000552,74.125.24.0-255,1484,49989,92,210443
24171,0.000556,172.31.47.0-255,66,50055,92,210443
24172,0.000561,74.125.24.0-255,2902,52957,92,210443
24173,0.000563,172.31.47.0-255,66,53023,92,210443
24174,0.000592,74.125.24.0-255,5738,58761,92,210443
24175,0.000598,172.31.47.0-255,66,58827,92,210443
24176,0.000623,74.125.24.0-255,1484,60311,92,210443
24177,0.000646,74.125.24.0-255,5726,66037,92,210443
24178,0.000649,172.31.47.0-255,66,66103,92,210443
24179,0.000718,74.125.24.0-255,330,66433,92,210443
24180,0.000724,172.31.47.0-255,66,66499,92,210443
24181,0.001033,74.125.24.0-255,1484,67983,92,210443
24182,0.001052,74.125.24.0-255,2902,70885,92,210443
24183,0.001058,172.31.47.0-255,66,70951,92,210443
24184,0.001083,74.125.24.0-255,5738,76689,92,210443
24185,0.001086,172.31.47.0-255,66,76755,92,210443
24186,0.001089,74.125.24.0-255,1484,78239,92,210443
24187,0.001117,172.31.47.0-255,66,78305,92,210443
24188,0.001126,172.31.47.0-255,66,78371,92,210443
24189,0.001144,74.125.24.0-255,2902,81273,92,210443
24190,0.001147,172.31.47.0-255,66,81339,92,210443
24191,0.00115,74.125.24.0-255,2184,83523,92,210443
24192,0.001152,172.31.47.0-255,66,83589,92,210443
24193,0.001227,74.125.24.0-255,1484,85073,92,210443
24194,0.001233,74.125.24.0-255,2902,87975,92,210443
24195,0.001236,172.31.47.0-255,66,88041,92,210443
24196,0.00126,74.125.24.0-255,5738,93779,92,210443
24197,0.001264,172.31.47.0-255,66,93845,92,210443
24198,0.001271,74.125.24.0-255,7156,101001,92,210443
24199,0.001273,172.31.47.0-255,66,101067,92,210443
24200,0.00129,74.125.24.0-255,5738,106805,92,210443
24201,0.001292,172.31.47.0-255,66,106871,92,210443
24202,0.001298,74.125.24.0-255,4320,111191,92,210443
24203,0.0013,172.31.47.0-255,66,111257,92,210443
24204,0.00133,74.125.24.0-255,6438,117695,92,210443
24205,0.001335,172.31.47.0-255,66,117761,92,210443
24206,0.001495,74.125.24.0-255,1484,119245,92,210443
24207,0.0015,74.125.24.0-255,2902,122147,92,210443
24208,0.001503,172.31.47.0-255,66,122213,92,210443
24209,0.001506,74.125.24.0-255,1484,123697,92,210443
24210,0.001521,74.125.24.0-255,4320,128017,92,210443
24211,0.001523,172.31.47.0-255,66,128083,92,210443
24212,0.001542,74.125.24.0-255,2902,130985,92,210443
24213,0.001544,172.31.47.0-255,66,131051,92,210443
24214,0.001566,172.31.47.0-255,66,131117,92,210443
24215,0.00159,74.125.24.0-255,4320,135437,92,210443
24216,0.001593,172.31.47.0-255,66,135503,92,210443
24217,0.001609,74.125.24.0-255,6438,141941,92,210443
24218,0.001611,172.31.47.0-255,66,142007,92,210443
24219,0.001991,74.125.24.0-255,1484,143491,92,210443
24220,0.001998,74.125.24.0-255,2902,146393,92,210443
24221,0.002001,172.31.47.0-255,66,146459,92,210443
24222,0.002019,74.125.24.0-255,4320,150779,92,210443
24223,0.002021,172.31.47.0-255,66,150845,92,210443
24224,0.002052,172.31.47.0-255,66,150911,92,210443
24225,0.002072,74.125.24.0-255,4320,155231,92,210443
24226,0.002074,172.31.47.0-255,66,155297,92,210443
24227,0.002104,172.31.47.0-255,66,155363,92,210443
24228,0.002363,74.125.24.0-255,1484,156847,92,210443
24229,0.00237,74.125.24.0-255,2902,159749,92,210443
24230,0.002373,172.31.47.0-255,66,159815,92,210443
24231,0.002397,74.125.24.0-255,5738,165553,92,210443
24232,0.0024,172.31.47.0-255,66,165619,92,210443
24233,0.002427,172.31.47.0-255,66,165685,92,210443
24234,0.002449,74.125.24.0-255,2902,168587,92,210443
24235,0.002451,172.31.47.0-255,66,168653,92,210443
24236,0.002456,74.125.24.0-255,5738,174391,92,210443
24237,0.002458,172.31.47.0-255,66,174457,92,210443
24238,0.002469,74.125.24.0-255,1484,175941,92,210443
24239,0.002488,74.125.24.0-255,3602,179543,92,210443
24240,0.00249,172.31.47.0-255,66,179609,92,210443
24241,0.002605,74.125.24.0-255,1484,181093,92,210443
24242,0.00261,74.125.24.0-255,2902,183995,92,210443
24243,0.002612,172.31.47.0-255,66,184061,92,210443
24244,0.002652,74.125.24.0-255,5738,189799,92,210443
24245,0.002654,172.31.47.0-255,66,189865,92,210443
24246,0.002659,74.125.24.0-255,4320,194185,92,210443
24247,0.00266,172.31.47.0-255,66,194251,92,210443
24248,0.00269,172.31.47.0-255,66,194317,92,210443
24249,0.0027,172.31.47.0-255,66,194383,92,210443
24250,0.002727,74.125.24.0-255,4320,198703,92,210443
24251,0.00273,172.31.47.0-255,66,198769,92,210443
24252,0.005325,74.125.24.0-255,1484,200253,92,210443
24253,0.005383,74.125.24.0-255,4320,204573,92,210443
24254,0.005387,172.31.47.0-255,66,204639,92,210443
24255,0.008065,74.125.24.0-255,5738,210377,92,210443
24256,0.008082,172.31.47.0-255,66,210443,92,210443
24257,0.0,172.31.47.0-255,105,105,92,105
24258,0.0,172.31.47.0-255,105,105,92,210
24259,0.001783,157.240.13.0-255,105,210,92,210
24260,0.0,74.125.68.0-255,152,152,92,94298
24261,2.6e-05,172.31.47.0-255,66,218,92,94298
24262,5.8e-05,74.125.68.0-255,1484,1702,92,94298
24263,6.2e-05,172.31.47.0-255,66,1768,92,94298
24264,6.6e-05,74.125.68.0-255,2902,4670,92,94298
24265,6.8e-05,172.31.47.0-255,66,4736,92,94298
24266,7.1e-05,74.125.68.0-255,1484,6220,92,94298
24267,7.7e-05,172.31.47.0-255,66,6286,92,94298
24268,8.1e-05,74.125.68.0-255,2902,9188,92,94298
24269,8.4e-05,172.31.47.0-255,66,9254,92,94298
24270,0.000121,74.125.68.0-255,4320,13574,92,94298
24271,0.000124,172.31.47.0-255,66,13640,92,94298
24272,0.000148,74.125.68.0-255,550,14190,92,94298
24273,0.00015,172.31.47.0-255,66,14256,92,94298
24274,0.000457,74.125.68.0-255,1484,15740,92,94298
24275,0.000463,172.31.47.0-255,66,15806,92,94298
24276,0.000473,74.125.68.0-255,2902,18708,92,94298
24277,0.000482,172.31.47.0-255,66,18774,92,94298
24278,0.000489,74.125.68.0-255,4320,23094,92,94298
24279,0.000492,172.31.47.0-255,66,23160,92,94298
24280,0.000553,172.31.47.0-255,66,23226,92,94298
24281,0.000592,172.31.47.0-255,66,23292,92,94298
24282,0.000597,74.125.68.0-255,2902,26194,92,94298
24283,0.0006,172.31.47.0-255,66,26260,92,94298
24284,0.000602,74.125.68.0-255,1484,27744,92,94298
24285,0.000612,172.31.47.0-255,66,27810,92,94298
24286,0.00066,172.31.47.0-255,66,27876,92,94298
24287,0.000666,74.125.68.0-255,5738,33614,92,94298
24288,0.000668,172.31.47.0-255,66,33680,92,94298
24289,0.000699,74.125.68.0-255,3933,37613,92,94298
24290,0.000702,172.31.47.0-255,66,37679,92,94298
24291,0.000783,74.125.68.0-255,109,37788,92,94298
24292,0.000972,74.125.68.0-255,1484,39272,92,94298
24293,0.000978,172.31.47.0-255,66,39338,92,94298
24294,0.001003,74.125.68.0-255,1484,40822,92,94298
24295,0.001006,74.125.68.0-255,1484,42306,92,94298
24296,0.00101,172.31.47.0-255,66,42372,92,94298
24297,0.001017,74.125.68.0-255,1484,43856,92,94298
24298,0.001022,74.125.68.0-255,2902,46758,92,94298
24299,0.001023,172.31.47.0-255,66,46824,92,94298
24300,0.001039,74.125.68.0-255,2902,49726,92,94298
24301,0.001041,172.31.47.0-255,66,49792,92,94298
24302,0.001056,172.31.47.0-255,66,49858,92,94298
24303,0.001113,74.125.68.0-255,7156,57014,92,94298
24304,0.001117,172.31.47.0-255,66,57080,92,94298
24305,0.001146,74.125.68.0-255,4320,61400,92,94298
24306,0.001149,172.31.47.0-255,66,61466,92,94298
24307,0.001152,74.125.68.0-255,1034,62500,92,94298
24308,0.001546,172.31.47.0-255,66,62566,92,94298
24309,0.001602,74.125.68.0-255,1484,64050,92,94298
24310,0.001608,74.125.68.0-255,2902,66952,92,94298
24311,0.001611,172.31.47.0-255,66,67018,92,94298
24312,0.001637,74.125.68.0-255,5738,72756,92,94298
24313,0.001639,172.31.47.0-255,66,72822,92,94298
24314,0.001643,74.125.68.0-255,2902,75724,92,94298
24315,0.001644,172.31.47.0-255,66,75790,92,94298
24316,0.001677,172.31.47.0-255,66,75856,92,94298
24317,0.001696,74.125.68.0-255,1484,77340,92,94298
24318,0.001706,172.31.47.0-255,66,77406,92,94298
24319,0.001726,74.125.68.0-255,766,78172,92,94298
24320,0.001916,172.31.47.0-255,66,78238,92,94298
24321,0.004027,74.125.68.0-255,4320,82558,92,94298
24322,0.004033,172.31.47.0-255,66,82624,92,94298
24323,0.004223,74.125.68.0-255,1484,84108,92,94298
24324,0.006346,74.125.68.0-255,4320,88428,92,94298
24325,0.006354,172.31.47.0-255,66,88494,92,94298
24326,0.008679,74.125.68.0-255,5738,94232,92,94298
24327,0.008685,172.31.47.0-255,66,94298,92,94298
24328,0.0,172.217.194.0-255,298,298,92,213695
24329,1.7e-05,172.31.47.0-255,66,364,92,213695
24330,2.3e-05,172.217.194.0-255,1484,1848,92,213695
24331,2.7e-05,172.31.47.0-255,66,1914,92,213695
24332,3.4e-05,172.217.194.0-255,4320,6234,92,213695
24333,3.7e-05,172.31.47.0-255,66,6300,92,213695
24334,6.5e-05,172.217.194.0-255,7156,13456,92,213695
24335,6.7e-05,172.31.47.0-255,66,13522,92,213695
24336,0.000105,172.217.194.0-255,471,13993,92,213695
24337,0.000107,172.31.47.0-255,66,14059,92,213695
24338,0.000159,172.217.194.0-255,1484,15543,92,213695
24339,0.000161,172.31.47.0-255,66,15609,92,213695
24340,0.000177,172.217.194.0-255,2902,18511,92,213695
24341,0.000179,172.31.47.0-255,66,18577,92,213695
24342,0.000182,172.217.194.0-255,1484,20061,92,213695
24343,0.000184,172.31.47.0-255,66,20127,92,213695
24344,0.000205,172.217.194.0-255,4320,24447,92,213695
24345,0.000207,172.31.47.0-255,66,24513,92,213695
24346,0.000211,172.217.194.0-255,2902,27415,92,213695
24347,0.000213,172.31.47.0-255,66,27481,92,213695
24348,0.000232,172.217.194.0-255,3961,31442,92,213695
24349,0.000234,172.31.47.0-255,66,31508,92,213695
24350,0.000263,172.31.47.0-255,66,31574,92,213695
24351,0.000281,172.217.194.0-255,2902,34476,92,213695
24352,0.000283,172.31.47.0-255,66,34542,92,213695
24353,0.000287,172.217.194.0-255,2543,37085,92,213695
24354,0.000289,172.31.47.0-255,66,37151,92,213695
24355,0.000442,172.217.194.0-255,1484,38635,92,213695
24356,0.000446,172.31.47.0-255,66,38701,92,213695
24357,0.000473,172.217.194.0-255,1484,40185,92,213695
24358,0.000476,172.31.47.0-255,66,40251,92,213695
24359,0.00048,172.217.194.0-255,2902,43153,92,213695
24360,0.000482,172.31.47.0-255,66,43219,92,213695
24361,0.000493,172.217.194.0-255,1484,44703,92,213695
24362,0.000514,172.217.194.0-255,4320,49023,92,213695
24363,0.000519,172.217.194.0-255,5379,54402,92,213695
24364,0.000523,172.31.47.0-255,66,54468,92,213695
24365,0.000526,172.31.47.0-255,66,54534,92,213695
24366,0.00054,172.217.194.0-255,346,54880,92,213695
24367,0.000595,172.217.194.0-255,117,54997,92,213695
24368,0.000636,172.217.194.0-255,1484,56481,92,213695
24369,0.00064,172.31.47.0-255,66,56547,92,213695
24370,0.000644,172.217.194.0-255,2902,59449,92,213695
24371,0.000647,172.31.47.0-255,66,59515,92,213695
24372,0.000662,172.217.194.0-255,4320,63835,92,213695
24373,0.000664,172.31.47.0-255,66,63901,92,213695
24374,0.000689,172.217.194.0-255,2902,66803,92,213695
24375,0.000692,172.31.47.0-255,66,66869,92,213695
24376,0.000698,172.217.194.0-255,5379,72248,92,213695
24377,0.0007,172.31.47.0-255,66,72314,92,213695
24378,0.000731,172.217.194.0-255,5738,78052,92,213695
24379,0.000734,172.31.47.0-255,66,78118,92,213695
24380,0.000756,172.217.194.0-255,5738,83856,92,213695
24381,0.000758,172.31.47.0-255,66,83922,92,213695
24382,0.000773,172.217.194.0-255,1484,85406,92,213695
24383,0.000788,172.217.194.0-255,4271,89677,92,213695
24384,0.000793,172.31.47.0-255,66,89743,92,213695
24385,0.001056,172.217.194.0-255,1484,91227,92,213695
24386,0.001077,172.217.194.0-255,1484,92711,92,213695
24387,0.001081,172.31.47.0-255,66,92777,92,213695
24388,0.001086,172.217.194.0-255,2902,95679,92,213695
24389,0.001088,172.31.47.0-255,66,95745,92,213695
24390,0.001095,172.217.194.0-255,5738,101483,92,213695
24391,0.001097,172.31.47.0-255,66,101549,92,213695
24392,0.00113,172.31.47.0-255,66,101615,92,213695
24393,0.001149,172.217.194.0-255,2902,104517,92,213695
24394,0.001152,172.31.47.0-255,66,104583,92,213695
24395,0.00116,172.217.194.0-255,7156,111739,92,213695
24396,0.001162,172.31.47.0-255,66,111805,92,213695
24397,0.001184,172.217.194.0-255,2184,113989,92,213695
24398,0.001186,172.31.47.0-255,66,114055,92,213695
24399,0.001226,172.217.194.0-255,2902,116957,92,213695
24400,0.001229,172.31.47.0-255,66,117023,92,213695
24401,0.001233,172.217.194.0-255,2902,119925,92,213695
24402,0.001235,172.31.47.0-255,66,119991,92,213695
24403,0.001258,172.217.194.0-255,7156,127147,92,213695
24404,0.001261,172.31.47.0-255,66,127213,92,213695
24405,0.00132,172.217.194.0-255,4320,131533,92,213695
24406,0.001323,172.31.47.0-255,66,131599,92,213695
24407,0.001353,172.31.47.0-255,66,131665,92,213695
24408,0.001429,172.31.47.0-255,66,131731,92,213695
24409,0.001481,172.31.47.0-255,66,131797,92,213695
24410,0.001498,172.217.194.0-255,1484,133281,92,213695
24411,0.001505,172.217.194.0-255,5020,138301,92,213695
24412,0.001508,172.31.47.0-255,66,138367,92,213695
24413,0.002232,172.217.194.0-255,1484,139851,92,213695
24414,0.002241,172.217.194.0-255,2902,142753,92,213695
24415,0.002246,172.31.47.0-255,66,142819,92,213695
24416,0.002251,172.217.194.0-255,1484,144303,92,213695
24417,0.002264,172.217.194.0-255,2902,147205,92,213695
24418,0.002267,172.31.47.0-255,66,147271,92,213695
24419,0.00228,172.217.194.0-255,1484,148755,92,213695
24420,0.002287,172.217.194.0-255,7156,155911,92,213695
24421,0.00229,172.31.47.0-255,66,155977,92,213695
24422,0.00232,172.217.194.0-255,2902,158879,92,213695
24423,0.002323,172.31.47.0-255,66,158945,92,213695
24424,0.002328,172.217.194.0-255,4320,163265,92,213695
24425,0.002331,172.31.47.0-255,66,163331,92,213695
24426,0.002361,172.217.194.0-255,5738,169069,92,213695
24427,0.002364,172.31.47.0-255,66,169135,92,213695
24428,0.002382,172.217.194.0-255,2902,172037,92,213695
24429,0.002385,172.31.47.0-255,66,172103,92,213695
24430,0.002388,172.217.194.0-255,766,172869,92,213695
24431,0.002572,172.217.194.0-255,1484,174353,92,213695
24432,0.002578,172.31.47.0-255,66,174419,92,213695
24433,0.002584,172.217.194.0-255,2902,177321,92,213695
24434,0.002587,172.31.47.0-255,66,177387,92,213695
24435,0.00259,172.217.194.0-255,1484,178871,92,213695
24436,0.002608,172.217.194.0-255,4320,183191,92,213695
24437,0.002611,172.31.47.0-255,66,183257,92,213695
24438,0.002623,172.217.194.0-255,5738,188995,92,213695
24439,0.002625,172.31.47.0-255,66,189061,92,213695
24440,0.002652,172.217.194.0-255,5738,194799,92,213695
24441,0.002654,172.31.47.0-255,66,194865,92,213695
24442,0.002661,172.217.194.0-255,7156,202021,92,213695
24443,0.002664,172.31.47.0-255,66,202087,92,213695
24444,0.005277,172.217.194.0-255,5738,207825,92,213695
24445,0.005281,172.31.47.0-255,66,207891,92,213695
24446,0.007926,172.217.194.0-255,5738,213629,92,213695
24447,0.007933,172.31.47.0-255,66,213695,92,213695
24448,0.0,74.125.24.0-255,153,153,92,173834
24449,2.1e-05,172.31.47.0-255,66,219,92,173834
24450,2.7e-05,74.125.24.0-255,1484,1703,92,173834
24451,3.1e-05,172.31.47.0-255,66,1769,92,173834
24452,3.6e-05,74.125.24.0-255,2902,4671,92,173834
24453,4.6e-05,172.31.47.0-255,66,4737,92,173834
24454,5.3e-05,74.125.24.0-255,7156,11893,92,173834
24455,5.6e-05,172.31.47.0-255,66,11959,92,173834
24456,6.8e-05,172.31.47.0-255,66,12025,92,173834
24457,9.9e-05,74.125.24.0-255,3432,15457,92,173834
24458,0.000101,172.31.47.0-255,66,15523,92,173834
24459,0.000106,74.125.24.0-255,2543,18066,92,173834
24460,0.000108,172.31.47.0-255,66,18132,92,173834
24461,0.000111,74.125.24.0-255,1484,19616,92,173834
24462,0.000112,172.31.47.0-255,66,19682,92,173834
24463,0.000117,74.125.24.0-255,2902,22584,92,173834
24464,0.000119,172.31.47.0-255,66,22650,92,173834
24465,0.00015,74.125.24.0-255,5738,28388,92,173834
24466,0.000153,172.31.47.0-255,66,28454,92,173834
24467,0.000155,74.125.24.0-255,1484,29938,92,173834
24468,0.000157,172.31.47.0-255,66,30004,92,173834
24469,0.000184,74.125.24.0-255,5379,35383,92,173834
24470,0.000187,172.31.47.0-255,66,35449,92,173834
24471,0.000194,74.125.24.0-255,7156,42605,92,173834
24472,0.000199,172.31.47.0-255,66,42671,92,173834
24473,0.000234,172.31.47.0-255,66,42737,92,173834
24474,0.000284,74.125.24.0-255,130,42867,92,173834
24475,0.000286,172.31.47.0-255,66,42933,92,173834
24476,0.000319,74.125.24.0-255,350,43283,92,173834
24477,0.000322,172.31.47.0-255,66,43349,92,173834
24478,0.000428,74.125.24.0-255,1484,44833,92,173834
24479,0.000431,172.31.47.0-255,66,44899,92,173834
24480,0.000436,74.125.24.0-255,2902,47801,92,173834
24481,0.000438,172.31.47.0-255,66,47867,92,173834
24482,0.000464,74.125.24.0-255,5738,53605,92,173834
24483,0.000467,172.31.47.0-255,66,53671,92,173834
24484,0.00047,74.125.24.0-255,1484,55155,92,173834
24485,0.000471,172.31.47.0-255,66,55221,92,173834
24486,0.000502,74.125.24.0-255,5379,60600,92,173834
24487,0.000509,74.125.24.0-255,7156,67756,92,173834
24488,0.000534,172.31.47.0-255,66,67822,92,173834
24489,0.000553,172.31.47.0-255,66,67888,92,173834
24490,0.000913,74.125.24.0-255,1484,69372,92,173834
24491,0.000919,74.125.24.0-255,2902,72274,92,173834
24492,0.000922,172.31.47.0-255,66,72340,92,173834
24493,0.000927,74.125.24.0-255,2902,75242,92,173834
24494,0.000928,172.31.47.0-255,66,75308,92,173834
24495,0.000946,74.125.24.0-255,2902,78210,92,173834
24496,0.000953,74.125.24.0-255,7156,85366,92,173834
24497,0.000967,172.31.47.0-255,66,85432,92,173834
24498,0.000979,74.125.24.0-255,5738,91170,92,173834
24499,0.001009,172.31.47.0-255,66,91236,92,173834
24500,0.001419,74.125.24.0-255,1484,92720,92,173834
24501,0.001439,74.125.24.0-255,2902,95622,92,173834
24502,0.001442,172.31.47.0-255,66,95688,92,173834
24503,0.001449,74.125.24.0-255,5738,101426,92,173834
24504,0.001451,172.31.47.0-255,66,101492,92,173834
24505,0.001482,74.125.24.0-255,2902,104394,92,173834
24506,0.001484,172.31.47.0-255,66,104460,92,173834
24507,0.001513,172.31.47.0-255,66,104526,92,173834
24508,0.001519,74.125.24.0-255,5738,110264,92,173834
24509,0.001521,172.31.47.0-255,66,110330,92,173834
24510,0.001526,74.125.24.0-255,5020,115350,92,173834
24511,0.001528,172.31.47.0-255,66,115416,92,173834
24512,0.00203,74.125.24.0-255,1484,116900,92,173834
24513,0.002039,74.125.24.0-255,2902,119802,92,173834
24514,0.002042,172.31.47.0-255,66,119868,92,173834
24515,0.002049,74.125.24.0-255,4320,124188,92,173834
24516,0.002051,172.31.47.0-255,66,124254,92,173834
24517,0.002077,74.125.24.0-255,1484,125738,92,173834
24518,0.002088,172.31.47.0-255,66,125804,92,173834
24519,0.002094,74.125.24.0-255,5738,131542,92,173834
24520,0.002096,172.31.47.0-255,66,131608,92,173834
24521,0.002116,74.125.24.0-255,4320,135928,92,173834
24522,0.002118,172.31.47.0-255,66,135994,92,173834
24523,0.002128,74.125.24.0-255,5020,141014,92,173834
24524,0.00213,172.31.47.0-255,66,141080,92,173834
24525,0.002304,74.125.24.0-255,1484,142564,92,173834
24526,0.00231,74.125.24.0-255,2902,145466,92,173834
24527,0.002314,172.31.47.0-255,66,145532,92,173834
24528,0.002344,74.125.24.0-255,5738,151270,92,173834
24529,0.002346,172.31.47.0-255,66,151336,92,173834
24530,0.002353,74.125.24.0-255,7156,158492,92,173834
24531,0.002354,172.31.47.0-255,66,158558,92,173834
24532,0.002359,74.125.24.0-255,4320,162878,92,173834
24533,0.002361,172.31.47.0-255,66,162944,92,173834
24534,0.002404,74.125.24.0-255,5020,167964,92,173834
24535,0.007149,172.31.47.0-255,66,168030,92,173834
24536,0.009502,74.125.24.0-255,5738,173768,92,173834
24537,0.009515,172.31.47.0-255,66,173834,92,173834
24538,0.0,74.125.24.0-255,153,153,92,284559
24539,3.2e-05,172.31.47.0-255,66,219,92,284559
24540,3.9e-05,74.125.24.0-255,1484,1703,92,284559
24541,4.3e-05,172.31.47.0-255,66,1769,92,284559
24542,4.7e-05,74.125.24.0-255,2902,4671,92,284559
24543,4.9e-05,172.31.47.0-255,66,4737,92,284559
24544,5.7e-05,74.125.24.0-255,7156,11893,92,284559
24545,5.9e-05,172.31.47.0-255,66,11959,92,284559
24546,6.3e-05,74.125.24.0-255,3470,15429,92,284559
24547,6.5e-05,172.31.47.0-255,66,15495,92,284559
24548,9.2e-05,74.125.24.0-255,4320,19815,92,284559
24549,9.7e-05,172.31.47.0-255,66,19881,92,284559
24550,0.000104,74.125.24.0-255,7156,27037,92,284559
24551,0.000106,172.31.47.0-255,66,27103,92,284559
24552,0.000118,74.125.24.0-255,2902,30005,92,284559
24553,0.000121,172.31.47.0-255,66,30071,92,284559
24554,0.000123,74.125.24.0-255,1125,31196,92,284559
24555,0.000126,172.31.47.0-255,66,31262,92,284559
24556,0.000219,74.125.24.0-255,1484,32746,92,284559
24557,0.000223,172.31.47.0-255,66,32812,92,284559
24558,0.000227,74.125.24.0-255,2902,35714,92,284559
24559,0.00023,172.31.47.0-255,66,35780,92,284559
24560,0.000255,74.125.24.0-255,5738,41518,92,284559
24561,0.000258,172.31.47.0-255,66,41584,92,284559
24562,0.000287,172.31.47.0-255,66,41650,92,284559
24563,0.000308,74.125.24.0-255,7156,48806,92,284559
24564,0.000311,172.31.47.0-255,66,48872,92,284559
24565,0.000335,74.125.24.0-255,4320,53192,92,284559
24566,0.000337,172.31.47.0-255,66,53258,92,284559
24567,0.00034,74.125.24.0-255,1401,54659,92,284559
24568,0.000342,172.31.47.0-255,66,54725,92,284559
24569,0.000345,74.125.24.0-255,124,54849,92,284559
24570,0.000347,172.31.47.0-255,66,54915,92,284559
24571,0.000369,74.125.24.0-255,354,55269,92,284559
24572,0.000373,172.31.47.0-255,66,55335,92,284559
24573,0.00061,74.125.24.0-255,1484,56819,92,284559
24574,0.000616,74.125.24.0-255,2902,59721,92,284559
24575,0.00062,172.31.47.0-255,66,59787,92,284559
24576,0.000626,74.125.24.0-255,4320,64107,92,284559
24577,0.000639,74.125.24.0-255,1484,65591,92,284559
24578,0.00064,172.31.47.0-255,66,65657,92,284559
24579,0.000655,74.125.24.0-255,5738,71395,92,284559
24580,0.000666,172.31.47.0-255,66,71461,92,284559
24581,0.000673,74.125.24.0-255,7156,78617,92,284559
24582,0.000685,172.31.47.0-255,66,78683,92,284559
24583,0.000696,74.125.24.0-255,1484,80167,92,284559
24584,0.000708,74.125.24.0-255,766,80933,92,284559
24585,0.000722,172.31.47.0-255,66,80999,92,284559
24586,0.00109,74.125.24.0-255,1484,82483,92,284559
24587,0.001105,74.125.24.0-255,2902,85385,92,284559
24588,0.001109,172.31.47.0-255,66,85451,92,284559
24589,0.001112,74.125.24.0-255,1484,86935,92,284559
24590,0.001129,74.125.24.0-255,4320,91255,92,284559
24591,0.001132,74.125.24.0-255,1484,92739,92,284559
24592,0.001143,74.125.24.0-255,1484,94223,92,284559
24593,0.001143,172.31.47.0-255,66,94289,92,284559
24594,0.001155,74.125.24.0-255,2902,97191,92,284559
24595,0.001159,172.31.47.0-255,66,97257,92,284559
24596,0.001171,74.125.24.0-255,4320,101577,92,284559
24597,0.001186,172.31.47.0-255,66,101643,92,284559
24598,0.00119,74.125.24.0-255,4320,105963,92,284559
24599,0.001202,172.31.47.0-255,66,106029,92,284559
24600,0.001214,172.31.47.0-255,66,106095,92,284559
24601,0.001245,74.125.24.0-255,1484,107579,92,284559
24602,0.00125,74.125.24.0-255,2902,110481,92,284559
24603,0.001253,172.31.47.0-255,66,110547,92,284559
24604,0.00127,74.125.24.0-255,5738,116285,92,284559
24605,0.001273,74.125.24.0-255,1484,117769,92,284559
24606,0.001279,172.31.47.0-255,66,117835,92,284559
24607,0.00131,74.125.24.0-255,2902,120737,92,284559
24608,0.00133,172.31.47.0-255,66,120803,92,284559
24609,0.001345,172.31.47.0-255,66,120869,92,284559
24610,0.00139,74.125.24.0-255,5738,126607,92,284559
24611,0.001403,172.31.47.0-255,66,126673,92,284559
24612,0.001407,74.125.24.0-255,7156,133829,92,284559
24613,0.001417,172.31.47.0-255,66,133895,92,284559
24614,0.001478,74.125.24.0-255,6438,140333,92,284559
24615,0.001481,74.125.24.0-255,1484,141817,92,284559
24616,0.001483,172.31.47.0-255,66,141883,92,284559
24617,0.001492,74.125.24.0-255,1484,143367,92,284559
24618,0.001498,172.31.47.0-255,66,143433,92,284559
24619,0.001506,74.125.24.0-255,1484,144917,92,284559
24620,0.001523,74.125.24.0-255,5738,150655,92,284559
24621,0.001533,172.31.47.0-255,66,150721,92,284559
24622,0.001535,74.125.24.0-255,1484,152205,92,284559
24623,0.001559,172.31.47.0-255,66,152271,92,284559
24624,0.001561,74.125.24.0-255,5738,158009,92,284559
24625,0.001571,172.31.47.0-255,66,158075,92,284559
24626,0.001585,74.125.24.0-255,5738,163813,92,284559
24627,0.001589,74.125.24.0-255,2184,165997,92,284559
24628,0.001595,172.31.47.0-255,66,166063,92,284559
24629,0.00172,74.125.24.0-255,1484,167547,92,284559
24630,0.001733,74.125.24.0-255,2902,170449,92,284559
24631,0.001737,172.31.47.0-255,66,170515,92,284559
24632,0.001741,74.125.24.0-255,2902,173417,92,284559
24633,0.001748,172.31.47.0-255,66,173483,92,284559
24634,0.001758,74.125.24.0-255,2902,176385,92,284559
24635,0.00177,172.31.47.0-255,66,176451,92,284559
24636,0.001796,172.31.47.0-255,66,176517,92,284559
24637,0.001812,172.31.47.0-255,66,176583,92,284559
24638,0.00184,74.125.24.0-255,2902,179485,92,284559
24639,0.001846,74.125.24.0-255,4320,183805,92,284559
24640,0.001849,172.31.47.0-255,66,183871,92,284559
24641,0.00186,74.125.24.0-255,2902,186773,92,284559
24642,0.001861,172.31.47.0-255,66,186839,92,284559
24643,0.001875,74.125.24.0-255,5738,192577,92,284559
24644,0.001875,172.31.47.0-255,66,192643,92,284559
24645,0.00188,172.31.47.0-255,66,192709,92,284559
24646,0.001896,74.125.24.0-255,7156,199865,92,284559
24647,0.001904,172.31.47.0-255,66,199931,92,284559
24648,0.001921,74.125.24.0-255,766,200697,92,284559
24649,0.001923,172.31.47.0-255,66,200763,92,284559
24650,0.001963,74.125.24.0-255,1484,202247,92,284559
24651,0.001967,74.125.24.0-255,1484,203731,92,284559
24652,0.001969,172.31.47.0-255,66,203797,92,284559
24653,0.001985,74.125.24.0-255,2902,206699,92,284559
24654,0.001992,74.125.24.0-255,7156,213855,92,284559
24655,0.001997,172.31.47.0-255,66,213921,92,284559
24656,0.002025,172.31.47.0-255,66,213987,92,284559
24657,0.002035,74.125.24.0-255,2902,216889,92,284559
24658,0.002037,74.125.24.0-255,1484,218373,92,284559
24659,0.00204,172.31.47.0-255,66,218439,92,284559
24660,0.002053,74.125.24.0-255,6438,224877,92,284559
24661,0.002067,172.31.47.0-255,66,224943,92,284559
24662,0.00211,74.125.24.0-255,1484,226427,92,284559
24663,0.002128,74.125.24.0-255,2902,229329,92,284559
24664,0.002134,74.125.24.0-255,5738,235067,92,284559
24665,0.002134,172.31.47.0-255,66,235133,92,284559
24666,0.002138,172.31.47.0-255,66,235199,92,284559
24667,0.002155,74.125.24.0-255,2902,238101,92,284559
24668,0.002164,172.31.47.0-255,66,238167,92,284559
24669,0.002169,172.31.47.0-255,66,238233,92,284559
24670,0.002196,74.125.24.0-255,7156,245389,92,284559
24671,0.002203,172.31.47.0-255,66,245455,92,284559
24672,0.002258,74.125.24.0-255,3602,249057,92,284559
24673,0.002261,74.125.24.0-255,1484,250541,92,284559
24674,0.002263,172.31.47.0-255,66,250607,92,284559
24675,0.002276,74.125.24.0-255,2902,253509,92,284559
24676,0.002278,74.125.24.0-255,1484,254993,92,284559
24677,0.002281,172.31.47.0-255,66,255059,92,284559
24678,0.002298,74.125.24.0-255,2902,257961,92,284559
24679,0.002307,172.31.47.0-255,66,258027,92,284559
24680,0.002318,74.125.24.0-255,7156,265183,92,284559
24681,0.00232,172.31.47.0-255,66,265249,92,284559
24682,0.00234,74.125.24.0-255,7156,272405,92,284559
24683,0.002345,74.125.24.0-255,2902,275307,92,284559
24684,0.00235,172.31.47.0-255,66,275373,92,284559
24685,0.002374,172.31.47.0-255,66,275439,92,284559
24686,0.002399,74.125.24.0-255,4320,279759,92,284559
24687,0.00241,172.31.47.0-255,66,279825,92,284559
24688,0.00242,74.125.24.0-255,4392,284217,92,284559
24689,0.002434,172.31.47.0-255,66,284283,92,284559
24690,0.004761,74.125.24.0-255,105,284388,92,284559
24691,0.009344,172.31.47.0-255,66,284454,92,284559
24692,0.009378,172.31.47.0-255,105,284559,92,284559
24693,0.0,172.217.194.0-255,153,153,92,171520
24694,2.7e-05,172.31.47.0-255,66,219,92,171520
24695,3.4e-05,172.217.194.0-255,1484,1703,92,171520
24696,3.8e-05,172.31.47.0-255,66,1769,92,171520
24697,4.2e-05,172.217.194.0-255,2902,4671,92,171520
24698,4.5e-05,172.31.47.0-255,66,4737,92,171520
24699,4.7e-05,172.217.194.0-255,1484,6221,92,171520
24700,4.9e-05,172.31.47.0-255,66,6287,92,171520
24701,6.9e-05,172.217.194.0-255,5738,12025,92,171520
24702,7.2e-05,172.31.47.0-255,66,12091,92,171520
24703,7.6e-05,172.217.194.0-255,1974,14065,92,171520
24704,7.7e-05,172.31.47.0-255,66,14131,92,171520
24705,0.000142,172.217.194.0-255,1484,15615,92,171520
24706,0.000147,172.31.47.0-255,66,15681,92,171520
24707,0.000152,172.217.194.0-255,2902,18583,92,171520
24708,0.000154,172.31.47.0-255,66,18649,92,171520
24709,0.000176,172.217.194.0-255,5738,24387,92,171520
24710,0.000179,172.31.47.0-255,66,24453,92,171520
24711,0.000225,172.217.194.0-255,1484,25937,92,171520
24712,0.000228,172.31.47.0-255,66,26003,92,171520
24713,0.000248,172.217.194.0-255,5379,31382,92,171520
24714,0.000251,172.31.47.0-255,66,31448,92,171520
24715,0.000266,172.217.194.0-255,2902,34350,92,171520
24716,0.000268,172.31.47.0-255,66,34416,92,171520
24717,0.00029,172.217.194.0-255,4320,38736,92,171520
24718,0.000294,172.31.47.0-255,66,38802,92,171520
24719,0.000301,172.217.194.0-255,5738,44540,92,171520
24720,0.000303,172.31.47.0-255,66,44606,92,171520
24721,0.000339,172.217.194.0-255,3961,48567,92,171520
24722,0.000343,172.31.47.0-255,66,48633,92,171520
24723,0.000435,172.217.194.0-255,1484,50117,92,171520
24724,0.000439,172.31.47.0-255,66,50183,92,171520
24725,0.000444,172.217.194.0-255,2902,53085,92,171520
24726,0.000446,172.31.47.0-255,66,53151,92,171520
24727,0.00048,172.217.194.0-255,5738,58889,92,171520
24728,0.000483,172.31.47.0-255,66,58955,92,171520
24729,0.000488,172.217.194.0-255,2902,61857,92,171520
24730,0.000492,172.31.47.0-255,66,61923,92,171520
24731,0.000539,172.217.194.0-255,3961,65884,92,171520
24732,0.000542,172.31.47.0-255,66,65950,92,171520
24733,0.001185,172.217.194.0-255,646,66596,92,171520
24734,0.001206,172.217.194.0-255,1484,68080,92,171520
24735,0.00121,172.31.47.0-255,66,68146,92,171520
24736,0.001217,172.217.194.0-255,4320,72466,92,171520
24737,0.001219,172.31.47.0-255,66,72532,92,171520
24738,0.001258,172.31.47.0-255,66,72598,92,171520
24739,0.001261,172.217.194.0-255,1484,74082,92,171520
24740,0.001283,172.31.47.0-255,66,74148,92,171520
24741,0.001307,172.217.194.0-255,4320,78468,92,171520
24742,0.00131,172.31.47.0-255,66,78534,92,171520
24743,0.001315,172.217.194.0-255,5020,83554,92,171520
24744,0.001317,172.31.47.0-255,66,83620,92,171520
24745,0.001573,172.217.194.0-255,1484,85104,92,171520
24746,0.001593,172.217.194.0-255,2902,88006,92,171520
24747,0.001596,172.31.47.0-255,66,88072,92,171520
24748,0.001618,172.217.194.0-255,1484,89556,92,171520
24749,0.00163,172.217.194.0-255,4320,93876,92,171520
24750,0.001632,172.31.47.0-255,66,93942,92,171520
24751,0.001652,172.217.194.0-255,5738,99680,92,171520
24752,0.001654,172.31.47.0-255,66,99746,92,171520
24753,0.00167,172.217.194.0-255,4320,104066,92,171520
24754,0.001672,172.31.47.0-255,66,104132,92,171520
24755,0.001721,172.31.47.0-255,66,104198,92,171520
24756,0.001998,172.217.194.0-255,1484,105682,92,171520
24757,0.002015,172.217.194.0-255,2902,108584,92,171520
24758,0.002018,172.31.47.0-255,66,108650,92,171520
24759,0.002022,172.217.194.0-255,2902,111552,92,171520
24760,0.002024,172.31.47.0-255,66,111618,92,171520
24761,0.002037,172.217.194.0-255,2902,114520,92,171520
24762,0.002039,172.31.47.0-255,66,114586,92,171520
24763,0.002041,172.217.194.0-255,1484,116070,92,171520
24764,0.002068,172.31.47.0-255,66,116136,92,171520
24765,0.002107,172.217.194.0-255,7156,123292,92,171520
24766,0.00211,172.31.47.0-255,66,123358,92,171520
24767,0.002127,172.217.194.0-255,3602,126960,92,171520
24768,0.002129,172.31.47.0-255,66,127026,92,171520
24769,0.002469,172.217.194.0-255,1484,128510,92,171520
24770,0.002472,172.217.194.0-255,1484,129994,92,171520
24771,0.002473,172.31.47.0-255,66,130060,92,171520
24772,0.002489,172.217.194.0-255,1484,131544,92,171520
24773,0.002495,172.217.194.0-255,5738,137282,92,171520
24774,0.002497,172.31.47.0-255,66,137348,92,171520
24775,0.002521,172.217.194.0-255,5738,143086,92,171520
24776,0.002523,172.31.47.0-255,66,143152,92,171520
24777,0.002529,172.217.194.0-255,5738,148890,92,171520
24778,0.002531,172.31.47.0-255,66,148956,92,171520
24779,0.002548,172.217.194.0-255,7156,156112,92,171520
24780,0.002551,172.31.47.0-255,66,156178,92,171520
24781,0.002574,172.217.194.0-255,5020,161198,92,171520
24782,0.002576,172.31.47.0-255,66,161264,92,171520
24783,0.005134,172.217.194.0-255,4320,165584,92,171520
24784,0.005139,172.31.47.0-255,66,165650,92,171520
24785,0.005157,172.217.194.0-255,1484,167134,92,171520
24786,0.007716,172.217.194.0-255,4320,171454,92,171520
24787,0.007721,172.31.47.0-255,66,171520,92,171520
24788,0.0,172.31.47.0-255,105,105,92,105
24789,0.0,74.125.130.0-255,153,153,92,166120
24790,2.9e-05,172.31.47.0-255,66,219,92,166120
24791,3.9e-05,74.125.130.0-255,1484,1703,92,166120
24792,4.7e-05,172.31.47.0-255,66,1769,92,166120
24793,5.3e-05,74.125.130.0-255,2902,4671,92,166120
24794,6.7e-05,172.31.47.0-255,66,4737,92,166120
24795,8.1e-05,74.125.130.0-255,7156,11893,92,166120
24796,8.6e-05,172.31.47.0-255,66,11959,92,166120
24797,9.1e-05,74.125.130.0-255,2175,14134,92,166120
24798,9.4e-05,172.31.47.0-255,66,14200,92,166120
24799,9.9e-05,74.125.130.0-255,2902,17102,92,166120
24800,0.000103,172.31.47.0-255,66,17168,92,166120
24801,0.000114,74.125.130.0-255,7156,24324,92,166120
24802,0.000119,172.31.47.0-255,66,24390,92,166120
24803,0.000177,74.125.130.0-255,6797,31187,92,166120
24804,0.000185,172.31.47.0-255,66,31253,92,166120
24805,0.000447,74.125.130.0-255,1484,32737,92,166120
24806,0.000452,172.31.47.0-255,66,32803,92,166120
24807,0.00048,74.125.130.0-255,2902,35705,92,166120
24808,0.000484,172.31.47.0-255,66,35771,92,166120
24809,0.000489,74.125.130.0-255,4320,40091,92,166120
24810,0.000491,172.31.47.0-255,66,40157,92,166120
24811,0.000529,172.31.47.0-255,66,40223,92,166120
24812,0.000533,74.125.130.0-255,2902,43125,92,166120
24813,0.000535,172.31.47.0-255,66,43191,92,166120
24814,0.000572,172.31.47.0-255,66,43257,92,166120
24815,0.000574,74.125.130.0-255,766,44023,92,166120
24816,0.000575,172.31.47.0-255,66,44089,92,166120
24817,0.000593,74.125.130.0-255,344,44433,92,166120
24818,0.000594,172.31.47.0-255,66,44499,92,166120
24819,0.000643,74.125.130.0-255,114,44613,92,166120
24820,0.000715,74.125.130.0-255,1484,46097,92,166120
24821,0.00072,172.31.47.0-255,66,46163,92,166120
24822,0.000748,74.125.130.0-255,2902,49065,92,166120
24823,0.000752,172.31.47.0-255,66,49131,92,166120
24824,0.000757,74.125.130.0-255,5738,54869,92,166120
24825,0.000759,172.31.47.0-255,66,54935,92,166120
24826,0.000795,172.31.47.0-255,66,55001,92,166120
24827,0.000801,74.125.130.0-255,5738,60739,92,166120
24828,0.000803,172.31.47.0-255,66,60805,92,166120
24829,0.000828,74.125.130.0-255,4320,65125,92,166120
24830,0.00083,172.31.47.0-255,66,65191,92,166120
24831,0.000834,74.125.130.0-255,5020,70211,92,166120
24832,0.000836,172.31.47.0-255,66,70277,92,166120
24833,0.000854,74.125.130.0-255,383,70660,92,166120
24834,0.00121,74.125.130.0-255,1484,72144,92,166120
24835,0.001215,172.31.47.0-255,66,72210,92,166120
24836,0.001219,74.125.130.0-255,1484,73694,92,166120
24837,0.001233,74.125.130.0-255,1484,75178,92,166120
24838,0.001235,172.31.47.0-255,66,75244,92,166120
24839,0.001262,74.125.130.0-255,2902,78146,92,166120
24840,0.001264,172.31.47.0-255,66,78212,92,166120
24841,0.00129,74.125.130.0-255,1484,79696,92,166120
24842,0.0013,172.31.47.0-255,66,79762,92,166120
24843,0.001303,74.125.130.0-255,1484,81246,92,166120
24844,0.001343,74.125.130.0-255,4320,85566,92,166120
24845,0.001346,172.31.47.0-255,66,85632,92,166120
24846,0.001351,74.125.130.0-255,2902,88534,92,166120
24847,0.001353,172.31.47.0-255,66,88600,92,166120
24848,0.001374,74.125.130.0-255,2902,91502,92,166120
24849,0.001376,172.31.47.0-255,66,91568,92,166120
24850,0.001406,74.125.130.0-255,5020,96588,92,166120
24851,0.001409,172.31.47.0-255,66,96654,92,166120
24852,0.001727,74.125.130.0-255,1484,98138,92,166120
24853,0.001731,74.125.130.0-255,1484,99622,92,166120
24854,0.001734,172.31.47.0-255,66,99688,92,166120
24855,0.001745,74.125.130.0-255,1484,101172,92,166120
24856,0.00175,74.125.130.0-255,1484,102656,92,166120
24857,0.001752,172.31.47.0-255,66,102722,92,166120
24858,0.001778,74.125.130.0-255,4320,107042,92,166120
24859,0.001782,172.31.47.0-255,66,107108,92,166120
24860,0.001793,74.125.130.0-255,4320,111428,92,166120
24861,0.001795,172.31.47.0-255,66,111494,92,166120
24862,0.001824,172.31.47.0-255,66,111560,92,166120
24863,0.001854,172.31.47.0-255,66,111626,92,166120
24864,0.001876,74.125.130.0-255,2184,113810,92,166120
24865,0.001878,172.31.47.0-255,66,113876,92,166120
24866,0.001959,74.125.130.0-255,1484,115360,92,166120
24867,0.001994,74.125.130.0-255,2902,118262,92,166120
24868,0.001997,172.31.47.0-255,66,118328,92,166120
24869,0.002001,74.125.130.0-255,4320,122648,92,166120
24870,0.002003,172.31.47.0-255,66,122714,92,166120
24871,0.002008,74.125.130.0-255,5738,128452,92,166120
24872,0.002009,172.31.47.0-255,66,128518,92,166120
24873,0.002042,74.125.130.0-255,7156,135674,92,166120
24874,0.002044,172.31.47.0-255,66,135740,92,166120
24875,0.002071,74.125.130.0-255,4320,140060,92,166120
24876,0.002073,172.31.47.0-255,66,140126,92,166120
24877,0.002078,74.125.130.0-255,4320,144446,92,166120
24878,0.002079,172.31.47.0-255,66,144512,92,166120
24879,0.002096,74.125.130.0-255,3602,148114,92,166120
24880,0.002101,172.31.47.0-255,66,148180,92,166120
24881,0.002577,74.125.130.0-255,1484,149664,92,166120
24882,0.002592,74.125.130.0-255,1484,151148,92,166120
24883,0.002595,172.31.47.0-255,66,151214,92,166120
24884,0.002598,74.125.130.0-255,1484,152698,92,166120
24885,0.004651,74.125.130.0-255,1484,154182,92,166120
24886,0.004657,172.31.47.0-255,66,154248,92,166120
24887,0.005139,74.125.130.0-255,2902,157150,92,166120
24888,0.005143,172.31.47.0-255,66,157216,92,166120
24889,0.007212,74.125.130.0-255,2902,160118,92,166120
24890,0.007217,172.31.47.0-255,66,160184,92,166120
24891,0.00771,74.125.130.0-255,2902,163086,92,166120
24892,0.007716,172.31.47.0-255,66,163152,92,166120
24893,0.009776,74.125.130.0-255,2902,166054,92,166120
24894,0.009781,172.31.47.0-255,66,166120,92,166120
24895,0.0,74.125.24.0-255,297,297,92,127982
24896,1.9e-05,172.31.47.0-255,66,363,92,127982
24897,2.5e-05,74.125.24.0-255,1484,1847,92,127982
24898,2.9e-05,172.31.47.0-255,66,1913,92,127982
24899,3.5e-05,74.125.24.0-255,4320,6233,92,127982
24900,3.7e-05,172.31.47.0-255,66,6299,92,127982
24901,4.3e-05,74.125.24.0-255,5738,12037,92,127982
24902,4.6e-05,172.31.47.0-255,66,12103,92,127982
24903,6.3e-05,74.125.24.0-255,3439,15542,92,127982
24904,6.5e-05,172.31.47.0-255,66,15608,92,127982
24905,7e-05,74.125.24.0-255,4320,19928,92,127982
24906,7.3e-05,172.31.47.0-255,66,19994,92,127982
24907,0.000108,74.125.24.0-255,4320,24314,92,127982
24908,0.00011,172.31.47.0-255,66,24380,92,127982
24909,0.000129,74.125.24.0-255,5738,30118,92,127982
24910,0.000131,172.31.47.0-255,66,30184,92,127982
24911,0.00015,74.125.24.0-255,1125,31309,92,127982
24912,0.000152,172.31.47.0-255,66,31375,92,127982
24913,0.000181,74.125.24.0-255,1484,32859,92,127982
24914,0.000183,172.31.47.0-255,66,32925,92,127982
24915,0.000196,74.125.24.0-255,2902,35827,92,127982
24916,0.000198,172.31.47.0-255,66,35893,92,127982
24917,0.000201,74.125.24.0-255,1484,37377,92,127982
24918,0.000203,172.31.47.0-255,66,37443,92,127982
24919,0.000217,74.125.24.0-255,4320,41763,92,127982
24920,0.00022,172.31.47.0-255,66,41829,92,127982
24921,0.000242,74.125.24.0-255,4320,46149,92,127982
24922,0.000244,172.31.47.0-255,66,46215,92,127982
24923,0.000271,172.31.47.0-255,66,46281,92,127982
24924,0.000277,74.125.24.0-255,7156,53437,92,127982
24925,0.000279,172.31.47.0-255,66,53503,92,127982
24926,0.000306,74.125.24.0-255,2813,56316,92,127982
24927,0.000308,172.31.47.0-255,66,56382,92,127982
24928,0.000352,74.125.24.0-255,135,56517,92,127982
24929,0.00062,74.125.24.0-255,1484,58001,92,127982
24930,0.000624,172.31.47.0-255,66,58067,92,127982
24931,0.000629,74.125.24.0-255,2902,60969,92,127982
24932,0.000631,172.31.47.0-255,66,61035,92,127982
24933,0.000657,74.125.24.0-255,2902,63937,92,127982
24934,0.000659,172.31.47.0-255,66,64003,92,127982
24935,0.000665,74.125.24.0-255,5738,69741,92,127982
24936,0.000667,172.31.47.0-255,66,69807,92,127982
24937,0.000678,74.125.24.0-255,1484,71291,92,127982
24938,0.000703,74.125.24.0-255,1484,72775,92,127982
24939,0.000706,172.31.47.0-255,66,72841,92,127982
24940,0.000721,74.125.24.0-255,2543,75384,92,127982
24941,0.000723,172.31.47.0-255,66,75450,92,127982
24942,0.000761,74.125.24.0-255,4320,79770,92,127982
24943,0.000768,172.31.47.0-255,66,79836,92,127982
24944,0.000771,74.125.24.0-255,1484,81320,92,127982
24945,0.000787,74.125.24.0-255,2902,84222,92,127982
24946,0.00079,172.31.47.0-255,66,84288,92,127982
24947,0.00083,74.125.24.0-255,7056,91344,92,127982
24948,0.000833,172.31.47.0-255,66,91410,92,127982
24949,0.001636,74.125.24.0-255,1484,92894,92,127982
24950,0.001647,74.125.24.0-255,2902,95796,92,127982
24951,0.001652,172.31.47.0-255,66,95862,92,127982
24952,0.001659,74.125.24.0-255,4320,100182,92,127982
24953,0.001661,172.31.47.0-255,66,100248,92,127982
24954,0.001679,74.125.24.0-255,7156,107404,92,127982
24955,0.001681,172.31.47.0-255,66,107470,92,127982
24956,0.001692,74.125.24.0-255,1484,108954,92,127982
24957,0.001716,74.125.24.0-255,1484,110438,92,127982
24958,0.001719,172.31.47.0-255,66,110504,92,127982
24959,0.001752,172.31.47.0-255,66,110570,92,127982
24960,0.00429,74.125.24.0-255,5738,116308,92,127982
24961,0.004299,172.31.47.0-255,66,116374,92,127982
24962,0.006851,74.125.24.0-255,5738,122112,92,127982
24963,0.006858,172.31.47.0-255,66,122178,92,127982
24964,0.009391,74.125.24.0-255,5738,127916,92,127982
24965,0.0094,172.31.47.0-255,66,127982,92,127982
24966,0.0,74.125.200.0-255,153,153,92,219602
24967,2.1e-05,172.31.47.0-255,66,219,92,219602
24968,2.8e-05,74.125.200.0-255,1484,1703,92,219602
24969,3.2e-05,172.31.47.0-255,66,1769,92,219602
24970,5.1e-05,74.125.200.0-255,2902,4671,92,219602
24971,5.4e-05,172.31.47.0-255,66,4737,92,219602
24972,7.4e-05,74.125.200.0-255,5738,10475,92,219602
24973,7.6e-05,172.31.47.0-255,66,10541,92,219602
24974,7.9e-05,74.125.200.0-255,1484,12025,92,219602
24975,8.1e-05,172.31.47.0-255,66,12091,92,219602
24976,0.000133,74.125.200.0-255,2902,14993,92,219602
24977,0.000135,172.31.47.0-255,66,15059,92,219602
24978,0.000154,74.125.200.0-255,6366,21425,92,219602
24979,0.000156,172.31.47.0-255,66,21491,92,219602
24980,0.000161,74.125.200.0-255,4320,25811,92,219602
24981,0.000163,172.31.47.0-255,66,25877,92,219602
24982,0.000183,74.125.200.0-255,5379,31256,92,219602
24983,0.000185,172.31.47.0-255,66,31322,92,219602
24984,0.000278,74.125.200.0-255,1484,32806,92,219602
24985,0.000281,172.31.47.0-255,66,32872,92,219602
24986,0.000286,74.125.200.0-255,2902,35774,92,219602
24987,0.000288,172.31.47.0-255,66,35840,92,219602
24988,0.000298,74.125.200.0-255,1484,37324,92,219602
24989,0.0003,172.31.47.0-255,66,37390,92,219602
24990,0.00032,74.125.200.0-255,4320,41710,92,219602
24991,0.000322,172.31.47.0-255,66,41776,92,219602
24992,0.000334,74.125.200.0-255,2902,44678,92,219602
24993,0.000335,172.31.47.0-255,66,44744,92,219602
24994,0.000359,74.125.200.0-255,3961,48705,92,219602
24995,0.000361,172.31.47.0-255,66,48771,92,219602
24996,0.000369,74.125.200.0-255,7156,55927,92,219602
24997,0.000371,172.31.47.0-255,66,55993,92,219602
24998,0.000373,74.125.200.0-255,1484,57477,92,219602
24999,0.000402,74.125.200.0-255,7156,64633,92,219602
25000,0.000422,172.31.47.0-255,66,64699,92,219602
25001,0.000431,74.125.200.0-255,1713,66412,92,219602
25002,0.000458,172.31.47.0-255,66,66478,92,219602
25003,0.000602,74.125.200.0-255,1484,67962,92,219602
25004,0.00062,74.125.200.0-255,2902,70864,92,219602
25005,0.000623,74.125.200.0-255,2902,73766,92,219602
25006,0.000632,172.31.47.0-255,66,73832,92,219602
25007,0.000641,74.125.200.0-255,4320,78152,92,219602
25008,0.000645,172.31.47.0-255,66,78218,92,219602
25009,0.000653,74.125.200.0-255,2902,81120,92,219602
25010,0.00067,172.31.47.0-255,66,81186,92,219602
25011,0.000676,74.125.200.0-255,5738,86924,92,219602
25012,0.000678,74.125.200.0-255,1484,88408,92,219602
25013,0.000683,172.31.47.0-255,66,88474,92,219602
25014,0.000691,74.125.200.0-255,4320,92794,92,219602
25015,0.000709,172.31.47.0-255,66,92860,92,219602
25016,0.000725,74.125.200.0-255,2902,95762,92,219602
25017,0.000734,172.31.47.0-255,66,95828,92,219602
25018,0.000743,74.125.200.0-255,4320,100148,92,219602
25019,0.000746,74.125.200.0-255,218,100366,92,219602
25020,0.000749,172.31.47.0-255,66,100432,92,219602
25021,0.000811,74.125.200.0-255,1484,101916,92,219602
25022,0.000824,74.125.200.0-255,1484,103400,92,219602
25023,0.000836,74.125.200.0-255,2902,106302,92,219602
25024,0.000881,172.31.47.0-255,66,106368,92,219602
25025,0.000891,74.125.200.0-255,5738,112106,92,219602
25026,0.000906,172.31.47.0-255,66,112172,92,219602
25027,0.000946,74.125.200.0-255,7156,119328,92,219602
25028,0.000951,172.31.47.0-255,66,119394,92,219602
25029,0.000958,74.125.200.0-255,2184,121578,92,219602
25030,0.000978,172.31.47.0-255,66,121644,92,219602
25031,0.001042,74.125.200.0-255,1484,123128,92,219602
25032,0.001057,74.125.200.0-255,2902,126030,92,219602
25033,0.001074,74.125.200.0-255,2902,128932,92,219602
25034,0.001077,172.31.47.0-255,66,128998,92,219602
25035,0.001081,172.31.47.0-255,66,129064,92,219602
25036,0.001088,74.125.200.0-255,2902,131966,92,219602
25037,0.001104,74.125.200.0-255,4320,136286,92,219602
25038,0.00111,172.31.47.0-255,66,136352,92,219602
25039,0.001122,74.125.200.0-255,2902,139254,92,219602
25040,0.001133,74.125.200.0-255,2902,142156,92,219602
25041,0.001141,172.31.47.0-255,66,142222,92,219602
25042,0.001151,74.125.200.0-255,4320,146542,92,219602
25043,0.001154,74.125.200.0-255,1484,148026,92,219602
25044,0.001171,74.125.200.0-255,7156,155182,92,219602
25045,0.001174,74.125.200.0-255,766,155948,92,219602
25046,0.001179,172.31.47.0-255,66,156014,92,219602
25047,0.001822,74.125.200.0-255,1484,157498,92,219602
25048,0.001838,74.125.200.0-255,2902,160400,92,219602
25049,0.001842,172.31.47.0-255,66,160466,92,219602
25050,0.001868,74.125.200.0-255,5738,166204,92,219602
25051,0.001884,74.125.200.0-255,4320,170524,92,219602
25052,0.001886,172.31.47.0-255,66,170590,92,219602
25053,0.001891,172.31.47.0-255,66,170656,92,219602
25054,0.00191,74.125.200.0-255,5738,176394,92,219602
25055,0.001916,74.125.200.0-255,4320,180714,92,219602
25056,0.001923,172.31.47.0-255,66,180780,92,219602
25057,0.001937,74.125.200.0-255,7156,187936,92,219602
25058,0.001941,74.125.200.0-255,1484,189420,92,219602
25059,0.001957,74.125.200.0-255,766,190186,92,219602
25060,0.001967,172.31.47.0-255,66,190252,92,219602
25061,0.001997,74.125.200.0-255,1484,191736,92,219602
25062,0.002015,74.125.200.0-255,2902,194638,92,219602
25063,0.002017,172.31.47.0-255,66,194704,92,219602
25064,0.002023,74.125.200.0-255,4320,199024,92,219602
25065,0.002038,74.125.200.0-255,2902,201926,92,219602
25066,0.002045,172.31.47.0-255,66,201992,92,219602
25067,0.002069,74.125.200.0-255,2902,204894,92,219602
25068,0.002072,74.125.200.0-255,1484,206378,92,219602
25069,0.002087,172.31.47.0-255,66,206444,92,219602
25070,0.004061,74.125.200.0-255,1484,207928,92,219602
25071,0.004067,172.31.47.0-255,66,207994,92,219602
25072,0.004118,74.125.200.0-255,4320,212314,92,219602
25073,0.006096,74.125.200.0-255,1484,213798,92,219602
25074,0.007734,172.31.47.0-255,66,213864,92,219602
25075,0.009766,74.125.200.0-255,5738,219602,92,219602
25076,0.0,74.125.24.0-255,153,153,92,122618
25077,2.4e-05,172.31.47.0-255,66,219,92,122618
25078,2.9e-05,74.125.24.0-255,1484,1703,92,122618
25079,3.3e-05,172.31.47.0-255,66,1769,92,122618
25080,3.6e-05,74.125.24.0-255,1484,3253,92,122618
25081,3.7e-05,172.31.47.0-255,66,3319,92,122618
25082,5.4e-05,74.125.24.0-255,1484,4803,92,122618
25083,5.6e-05,172.31.47.0-255,66,4869,92,122618
25084,5.8e-05,74.125.24.0-255,1484,6353,92,122618
25085,6.3e-05,172.31.47.0-255,66,6419,92,122618
25086,8.5e-05,74.125.24.0-255,4320,10739,92,122618
25087,9.1e-05,172.31.47.0-255,66,10805,92,122618
25088,9.5e-05,74.125.24.0-255,2902,13707,92,122618
25089,9.6e-05,172.31.47.0-255,66,13773,92,122618
25090,0.000111,74.125.24.0-255,3463,17236,92,122618
25091,0.000113,172.31.47.0-255,66,17302,92,122618
25092,0.000123,74.125.24.0-255,7156,24458,92,122618
25093,0.000126,172.31.47.0-255,66,24524,92,122618
25094,0.000162,172.31.47.0-255,66,24590,92,122618
25095,0.000209,172.31.47.0-255,66,24656,92,122618
25096,0.000219,74.125.24.0-255,766,25422,92,122618
25097,0.000224,172.31.47.0-255,66,25488,92,122618
25098,0.000267,74.125.24.0-255,1484,26972,92,122618
25099,0.000271,172.31.47.0-255,66,27038,92,122618
25100,0.000296,74.125.24.0-255,2902,29940,92,122618
25101,0.000299,172.31.47.0-255,66,30006,92,122618
25102,0.000304,74.125.24.0-255,4320,34326,92,122618
25103,0.000307,172.31.47.0-255,66,34392,92,122618
25104,0.000325,74.125.24.0-255,1484,35876,92,122618
25105,0.000328,172.31.47.0-255,66,35942,92,122618
25106,0.000353,74.125.24.0-255,7153,43095,92,122618
25107,0.000356,172.31.47.0-255,66,43161,92,122618
25108,0.000441,74.125.24.0-255,1484,44645,92,122618
25109,0.000453,74.125.24.0-255,2902,47547,92,122618
25110,0.000456,172.31.47.0-255,66,47613,92,122618
25111,0.000481,74.125.24.0-255,5738,53351,92,122618
25112,0.000484,172.31.47.0-255,66,53417,92,122618
25113,0.000512,172.31.47.0-255,66,53483,92,122618
25114,0.000529,74.125.24.0-255,2902,56385,92,122618
25115,0.000531,172.31.47.0-255,66,56451,92,122618
25116,0.000538,74.125.24.0-255,5738,62189,92,122618
25117,0.00054,172.31.47.0-255,66,62255,92,122618
25118,0.000568,74.125.24.0-255,6438,68693,92,122618
25119,0.000571,172.31.47.0-255,66,68759,92,122618
25120,0.000574,74.125.24.0-255,329,69088,92,122618
25121,0.00112,74.125.24.0-255,1484,70572,92,122618
25122,0.001125,172.31.47.0-255,66,70638,92,122618
25123,0.00113,74.125.24.0-255,2902,73540,92,122618
25124,0.001132,172.31.47.0-255,66,73606,92,122618
25125,0.001169,74.125.24.0-255,5738,79344,92,122618
25126,0.001172,172.31.47.0-255,66,79410,92,122618
25127,0.001177,74.125.24.0-255,4320,83730,92,122618
25128,0.001178,172.31.47.0-255,66,83796,92,122618
25129,0.001208,172.31.47.0-255,66,83862,92,122618
25130,0.00124,172.31.47.0-255,66,83928,92,122618
25131,0.001344,74.125.24.0-255,1484,85412,92,122618
25132,0.001364,74.125.24.0-255,2902,88314,92,122618
25133,0.001368,172.31.47.0-255,66,88380,92,122618
25134,0.001375,74.125.24.0-255,5738,94118,92,122618
25135,0.001376,172.31.47.0-255,66,94184,92,122618
25136,0.00144,172.31.47.0-255,66,94250,92,122618
25137,0.001447,74.125.24.0-255,7156,101406,92,122618
25138,0.001449,172.31.47.0-255,66,101472,92,122618
25139,0.00147,74.125.24.0-255,3602,105074,92,122618
25140,0.001473,172.31.47.0-255,66,105140,92,122618
25141,0.003755,74.125.24.0-255,1484,106624,92,122618
25142,0.003774,74.125.24.0-255,4320,110944,92,122618
25143,0.003779,172.31.47.0-255,66,111010,92,122618
25144,0.006123,74.125.24.0-255,5738,116748,92,122618
25145,0.006129,172.31.47.0-255,66,116814,92,122618
25146,0.008449,74.125.24.0-255,5738,122552,92,122618
25147,0.008456,172.31.47.0-255,66,122618,92,122618
25148,0.0,74.125.24.0-255,153,153,92,263452
25149,2.7e-05,172.31.47.0-255,66,219,92,263452
25150,3.3e-05,74.125.24.0-255,1484,1703,92,263452
25151,3.7e-05,172.31.47.0-255,66,1769,92,263452
25152,4.2e-05,74.125.24.0-255,2902,4671,92,263452
25153,4.5e-05,172.31.47.0-255,66,4737,92,263452
25154,4.9e-05,74.125.24.0-255,1484,6221,92,263452
25155,5.1e-05,172.31.47.0-255,66,6287,92,263452
25156,7.5e-05,74.125.24.0-255,4320,10607,92,263452
25157,7.8e-05,172.31.47.0-255,66,10673,92,263452
25158,8.1e-05,74.125.24.0-255,1484,12157,92,263452
25159,8.3e-05,172.31.47.0-255,66,12223,92,263452
25160,0.000108,74.125.24.0-255,4920,17143,92,263452
25161,0.000111,172.31.47.0-255,66,17209,92,263452
25162,0.000118,74.125.24.0-255,7156,24365,92,263452
25163,0.000121,172.31.47.0-255,66,24431,92,263452
25164,0.00015,74.125.24.0-255,6797,31228,92,263452
25165,0.000154,172.31.47.0-255,66,31294,92,263452
25166,0.000318,74.125.24.0-255,1484,32778,92,263452
25167,0.000322,172.31.47.0-255,66,32844,92,263452
25168,0.000328,74.125.24.0-255,2902,35746,92,263452
25169,0.00033,172.31.47.0-255,66,35812,92,263452
25170,0.000335,74.125.24.0-255,2902,38714,92,263452
25171,0.000337,172.31.47.0-255,66,38780,92,263452
25172,0.000354,74.125.24.0-255,2902,41682,92,263452
25173,0.000356,172.31.47.0-255,66,41748,92,263452
25174,0.000372,74.125.24.0-255,1484,43232,92,263452
25175,0.000375,172.31.47.0-255,66,43298,92,263452
25176,0.000409,172.31.47.0-255,66,43364,92,263452
25177,0.000416,74.125.24.0-255,7156,50520,92,263452
25178,0.000419,172.31.47.0-255,66,50586,92,263452
25179,0.000457,74.125.24.0-255,5655,56241,92,263452
25180,0.000462,172.31.47.0-255,66,56307,92,263452
25181,0.000479,74.125.24.0-255,132,56439,92,263452
25182,0.000523,74.125.24.0-255,1484,57923,92,263452
25183,0.000527,172.31.47.0-255,66,57989,92,263452
25184,0.000541,74.125.24.0-255,1484,59473,92,263452
25185,0.000555,74.125.24.0-255,1484,60957,92,263452
25186,0.000558,172.31.47.0-255,66,61023,92,263452
25187,0.000567,74.125.24.0-255,5738,66761,92,263452
25188,0.00057,172.31.47.0-255,66,66827,92,263452
25189,0.000611,74.125.24.0-255,5738,72565,92,263452
25190,0.000615,172.31.47.0-255,66,72631,92,263452
25191,0.00064,172.31.47.0-255,66,72697,92,263452
25192,0.000671,74.125.24.0-255,4320,77017,92,263452
25193,0.000674,172.31.47.0-255,66,77083,92,263452
25194,0.000694,74.125.24.0-255,5636,82719,92,263452
25195,0.000698,172.31.47.0-255,66,82785,92,263452
25196,0.001063,74.125.24.0-255,1484,84269,92,263452
25197,0.00107,74.125.24.0-255,2902,87171,92,263452
25198,0.001075,172.31.47.0-255,66,87237,92,263452
25199,0.001081,74.125.24.0-255,2902,90139,92,263452
25200,0.001084,172.31.47.0-255,66,90205,92,263452
25201,0.001098,74.125.24.0-255,2902,93107,92,263452
25202,0.001102,172.31.47.0-255,66,93173,92,263452
25203,0.001107,74.125.24.0-255,2902,96075,92,263452
25204,0.00111,172.31.47.0-255,66,96141,92,263452
25205,0.001134,74.125.24.0-255,5738,101879,92,263452
25206,0.001137,172.31.47.0-255,66,101945,92,263452
25207,0.001153,74.125.24.0-255,5738,107683,92,263452
25208,0.001157,172.31.47.0-255,66,107749,92,263452
25209,0.001185,172.31.47.0-255,66,107815,92,263452
25210,0.001271,74.125.24.0-255,1484,109299,92,263452
25211,0.001289,74.125.24.0-255,2902,112201,92,263452
25212,0.001293,172.31.47.0-255,66,112267,92,263452
25213,0.001297,74.125.24.0-255,2902,115169,92,263452
25214,0.001301,172.31.47.0-255,66,115235,92,263452
25215,0.001325,74.125.24.0-255,2902,118137,92,263452
25216,0.001328,172.31.47.0-255,66,118203,92,263452
25217,0.001342,172.31.47.0-255,66,118269,92,263452
25218,0.001372,74.125.24.0-255,2902,121171,92,263452
25219,0.001376,172.31.47.0-255,66,121237,92,263452
25220,0.001405,172.31.47.0-255,66,121303,92,263452
25221,0.001744,74.125.24.0-255,1484,122787,92,263452
25222,0.00175,74.125.24.0-255,2902,125689,92,263452
25223,0.001757,172.31.47.0-255,66,125755,92,263452
25224,0.001768,74.125.24.0-255,4320,130075,92,263452
25225,0.001771,172.31.47.0-255,66,130141,92,263452
25226,0.001784,74.125.24.0-255,1484,131625,92,263452
25227,0.001797,172.31.47.0-255,66,131691,92,263452
25228,0.001821,74.125.24.0-255,1484,133175,92,263452
25229,0.001832,172.31.47.0-255,66,133241,92,263452
25230,0.001848,74.125.24.0-255,2184,135425,92,263452
25231,0.001851,172.31.47.0-255,66,135491,92,263452
25232,0.001894,74.125.24.0-255,2902,138393,92,263452
25233,0.001898,172.31.47.0-255,66,138459,92,263452
25234,0.001916,74.125.24.0-255,4320,142779,92,263452
25235,0.001919,172.31.47.0-255,66,142845,92,263452
25236,0.001922,74.125.24.0-255,1484,144329,92,263452
25237,0.001946,74.125.24.0-255,7156,151485,92,263452
25238,0.001949,172.31.47.0-255,66,151551,92,263452
25239,0.001956,74.125.24.0-255,5738,157289,92,263452
25240,0.001958,172.31.47.0-255,66,157355,92,263452
25241,0.001971,74.125.24.0-255,1484,158839,92,263452
25242,0.002007,74.125.24.0-255,7156,165995,92,263452
25243,0.002011,172.31.47.0-255,66,166061,92,263452
25244,0.002031,74.125.24.0-255,3602,169663,92,263452
25245,0.002033,172.31.47.0-255,66,169729,92,263452
25246,0.002141,74.125.24.0-255,1484,171213,92,263452
25247,0.00216,74.125.24.0-255,1484,172697,92,263452
25248,0.002164,172.31.47.0-255,66,172763,92,263452
25249,0.002181,74.125.24.0-255,1484,174247,92,263452
25250,0.002188,74.125.24.0-255,5738,179985,92,263452
25251,0.002192,172.31.47.0-255,66,180051,92,263452
25252,0.002259,172.31.47.0-255,66,180117,92,263452
25253,0.002272,172.31.47.0-255,66,180183,92,263452
25254,0.002276,74.125.24.0-255,2184,182367,92,263452
25255,0.002279,172.31.47.0-255,66,182433,92,263452
25256,0.002451,74.125.24.0-255,1484,183917,92,263452
25257,0.002456,74.125.24.0-255,2902,186819,92,263452
25258,0.002459,172.31.47.0-255,66,186885,92,263452
25259,0.002476,74.125.24.0-255,4320,191205,92,263452
25260,0.002479,172.31.47.0-255,66,191271,92,263452
25261,0.002502,74.125.24.0-255,1484,192755,92,263452
25262,0.002516,172.31.47.0-255,66,192821,92,263452
25263,0.002522,74.125.24.0-255,5738,198559,92,263452
25264,0.002524,172.31.47.0-255,66,198625,92,263452
25265,0.002537,74.125.24.0-255,2902,201527,92,263452
25266,0.00254,172.31.47.0-255,66,201593,92,263452
25267,0.002555,74.125.24.0-255,2184,203777,92,263452
25268,0.002557,172.31.47.0-255,66,203843,92,263452
25269,0.002587,74.125.24.0-255,2902,206745,92,263452
25270,0.00259,172.31.47.0-255,66,206811,92,263452
25271,0.002609,74.125.24.0-255,7156,213967,92,263452
25272,0.002612,172.31.47.0-255,66,214033,92,263452
25273,0.002638,172.31.47.0-255,66,214099,92,263452
25274,0.002641,74.125.24.0-255,1484,215583,92,263452
25275,0.002643,74.125.24.0-255,1484,217067,92,263452
25276,0.002645,172.31.47.0-255,66,217133,92,263452
25277,0.002682,172.31.47.0-255,66,217199,92,263452
25278,0.002687,74.125.24.0-255,3602,220801,92,263452
25279,0.002689,172.31.47.0-255,66,220867,92,263452
25280,0.002715,74.125.24.0-255,4320,225187,92,263452
25281,0.002718,172.31.47.0-255,66,225253,92,263452
25282,0.002741,172.31.47.0-255,66,225319,92,263452
25283,0.002744,74.125.24.0-255,1484,226803,92,263452
25284,0.002747,74.125.24.0-255,1484,228287,92,263452
25285,0.002748,172.31.47.0-255,66,228353,92,263452
25286,0.002784,172.31.47.0-255,66,228419,92,263452
25287,0.002801,74.125.24.0-255,1484,229903,92,263452
25288,0.002806,74.125.24.0-255,3602,233505,92,263452
25289,0.002809,172.31.47.0-255,66,233571,92,263452
25290,0.002825,74.125.24.0-255,1484,235055,92,263452
25291,0.002838,74.125.24.0-255,2902,237957,92,263452
25292,0.002841,172.31.47.0-255,66,238023,92,263452
25293,0.002847,74.125.24.0-255,5738,243761,92,263452
25294,0.00285,172.31.47.0-255,66,243827,92,263452
25295,0.002877,172.31.47.0-255,66,243893,92,263452
25296,0.002901,74.125.24.0-255,1484,245377,92,263452
25297,0.00293,172.31.47.0-255,66,245443,92,263452
25298,0.003,74.125.24.0-255,1484,246927,92,263452
25299,0.003004,74.125.24.0-255,1484,248411,92,263452
25300,0.003007,172.31.47.0-255,66,248477,92,263452
25301,0.003021,74.125.24.0-255,1484,249961,92,263452
25302,0.003026,74.125.24.0-255,2902,252863,92,263452
25303,0.003029,172.31.47.0-255,66,252929,92,263452
25304,0.003047,74.125.24.0-255,2902,255831,92,263452
25305,0.00305,172.31.47.0-255,66,255897,92,263452
25306,0.003055,74.125.24.0-255,4320,260217,92,263452
25307,0.003058,172.31.47.0-255,66,260283,92,263452
25308,0.003086,172.31.47.0-255,66,260349,92,263452
25309,0.003086,74.125.24.0-255,2932,263281,92,263452
25310,0.003089,172.31.47.0-255,66,263347,92,263452
25311,0.003133,74.125.24.0-255,105,263452,92,263452
25312,0.0,74.125.24.0-255,153,153,92,180748
25313,2.1e-05,172.31.47.0-255,66,219,92,180748
25314,2.8e-05,74.125.24.0-255,1484,1703,92,180748
25315,3.2e-05,172.31.47.0-255,66,1769,92,180748
25316,3.9e-05,74.125.24.0-255,2902,4671,92,180748
25317,4.2e-05,172.31.47.0-255,66,4737,92,180748
25318,5e-05,74.125.24.0-255,5738,10475,92,180748
25319,5.3e-05,172.31.47.0-255,66,10541,92,180748
25320,7.5e-05,74.125.24.0-255,3522,14063,92,180748
25321,7.8e-05,172.31.47.0-255,66,14129,92,180748
25322,0.000477,74.125.24.0-255,1484,15613,92,180748
25323,0.000482,172.31.47.0-255,66,15679,92,180748
25324,0.000488,74.125.24.0-255,2902,18581,92,180748
25325,0.00049,172.31.47.0-255,66,18647,92,180748
25326,0.000515,74.125.24.0-255,5738,24385,92,180748
25327,0.000517,172.31.47.0-255,66,24451,92,180748
25328,0.000553,74.125.24.0-255,2902,27353,92,180748
25329,0.000555,172.31.47.0-255,66,27419,92,180748
25330,0.000574,74.125.24.0-255,2902,30321,92,180748
25331,0.000577,172.31.47.0-255,66,30387,92,180748
25332,0.000615,74.125.24.0-255,1125,31512,92,180748
25333,0.000618,172.31.47.0-255,66,31578,92,180748
25334,0.000722,74.125.24.0-255,1484,33062,92,180748
25335,0.000725,74.125.24.0-255,1484,34546,92,180748
25336,0.00073,172.31.47.0-255,66,34612,92,180748
25337,0.000733,172.31.47.0-255,66,34678,92,180748
25338,0.000744,74.125.24.0-255,1484,36162,92,180748
25339,0.000747,172.31.47.0-255,66,36228,92,180748
25340,0.00075,74.125.24.0-255,1484,37712,92,180748
25341,0.000751,172.31.47.0-255,66,37778,92,180748
25342,0.000783,74.125.24.0-255,4320,42098,92,180748
25343,0.000786,172.31.47.0-255,66,42164,92,180748
25344,0.000793,74.125.24.0-255,6797,48961,92,180748
25345,0.000795,172.31.47.0-255,66,49027,92,180748
25346,0.0008,74.125.24.0-255,4320,53347,92,180748
25347,0.000802,172.31.47.0-255,66,53413,92,180748
25348,0.000818,74.125.24.0-255,7156,60569,92,180748
25349,0.00082,172.31.47.0-255,66,60635,92,180748
25350,0.000849,74.125.24.0-255,2902,63537,92,180748
25351,0.000852,172.31.47.0-255,66,63603,92,180748
25352,0.000885,74.125.24.0-255,2815,66418,92,180748
25353,0.000888,172.31.47.0-255,66,66484,92,180748
25354,0.000891,74.125.24.0-255,132,66616,92,180748
25355,0.000893,172.31.47.0-255,66,66682,92,180748
25356,0.001059,74.125.24.0-255,1484,68166,92,180748
25357,0.001063,172.31.47.0-255,66,68232,92,180748
25358,0.001075,74.125.24.0-255,2902,71134,92,180748
25359,0.001078,172.31.47.0-255,66,71200,92,180748
25360,0.001085,74.125.24.0-255,1484,72684,92,180748
25361,0.001086,172.31.47.0-255,66,72750,92,180748
25362,0.0011,74.125.24.0-255,4320,77070,92,180748
25363,0.001102,172.31.47.0-255,66,77136,92,180748
25364,0.001127,74.125.24.0-255,6797,83933,92,180748
25365,0.00113,172.31.47.0-255,66,83999,92,180748
25366,0.001135,74.125.24.0-255,4320,88319,92,180748
25367,0.001137,172.31.47.0-255,66,88385,92,180748
25368,0.001162,172.31.47.0-255,66,88451,92,180748
25369,0.001166,74.125.24.0-255,2543,90994,92,180748
25370,0.001168,172.31.47.0-255,66,91060,92,180748
25371,0.001508,74.125.24.0-255,1484,92544,92,180748
25372,0.001529,74.125.24.0-255,2902,95446,92,180748
25373,0.001532,172.31.47.0-255,66,95512,92,180748
25374,0.00154,74.125.24.0-255,5738,101250,92,180748
25375,0.001542,172.31.47.0-255,66,101316,92,180748
25376,0.001566,74.125.24.0-255,5738,107054,92,180748
25377,0.001568,172.31.47.0-255,66,107120,92,180748
25378,0.001573,74.125.24.0-255,4320,111440,92,180748
25379,0.001575,172.31.47.0-255,66,111506,92,180748
25380,0.001588,74.125.24.0-255,2902,114408,92,180748
25381,0.00159,172.31.47.0-255,66,114474,92,180748
25382,0.001613,74.125.24.0-255,4320,118794,92,180748
25383,0.001615,172.31.47.0-255,66,118860,92,180748
25384,0.001637,74.125.24.0-255,6438,125298,92,180748
25385,0.001639,172.31.47.0-255,66,125364,92,180748
25386,0.001692,74.125.24.0-255,1484,126848,92,180748
25387,0.001698,74.125.24.0-255,2902,129750,92,180748
25388,0.0017,172.31.47.0-255,66,129816,92,180748
25389,0.001733,74.125.24.0-255,2902,132718,92,180748
25390,0.001736,172.31.47.0-255,66,132784,92,180748
25391,0.00176,74.125.24.0-255,4320,137104,92,180748
25392,0.001762,172.31.47.0-255,66,137170,92,180748
25393,0.001768,74.125.24.0-255,5738,142908,92,180748
25394,0.001771,172.31.47.0-255,66,142974,92,180748
25395,0.001773,74.125.24.0-255,1484,144458,92,180748
25396,0.001798,74.125.24.0-255,5738,150196,92,180748
25397,0.001801,172.31.47.0-255,66,150262,92,180748
25398,0.001832,74.125.24.0-255,766,151028,92,180748
25399,0.001953,74.125.24.0-255,1484,152512,92,180748
25400,0.001958,74.125.24.0-255,2902,155414,92,180748
25401,0.001984,74.125.24.0-255,2902,158316,92,180748
25402,0.001998,74.125.24.0-255,2902,161218,92,180748
25403,0.00204,74.125.24.0-255,2902,164120,92,180748
25404,0.002046,74.125.24.0-255,7156,171276,92,180748
25405,0.002086,74.125.24.0-255,3602,174878,92,180748
25406,0.00699,172.31.47.0-255,66,174944,92,180748
25407,0.009037,74.125.24.0-255,5738,180682,92,180748
25408,0.009044,172.31.47.0-255,66,180748,92,180748
25409,0.0,172.31.47.0-255,105,105,92,105
25410,0.0,74.125.200.0-255,153,153,92,354004
25411,2.9e-05,172.31.47.0-255,66,219,92,354004
25412,3.6e-05,74.125.200.0-255,1484,1703,92,354004
25413,3.9e-05,172.31.47.0-255,66,1769,92,354004
25414,5.2e-05,74.125.200.0-255,1484,3253,92,354004
25415,5.3e-05,172.31.47.0-255,66,3319,92,354004
25416,7.1e-05,74.125.200.0-255,2902,6221,92,354004
25417,7.3e-05,172.31.47.0-255,66,6287,92,354004
25418,9.2e-05,74.125.200.0-255,5738,12025,92,354004
25419,9.5e-05,172.31.47.0-255,66,12091,92,354004
25420,9.7e-05,74.125.200.0-255,1484,13575,92,354004
25421,9.9e-05,172.31.47.0-255,66,13641,92,354004
25422,0.000122,74.125.200.0-255,2089,15730,92,354004
25423,0.000125,172.31.47.0-255,66,15796,92,354004
25424,0.000159,74.125.200.0-255,5738,21534,92,354004
25425,0.000161,172.31.47.0-255,66,21600,92,354004
25426,0.000179,74.125.200.0-255,7156,28756,92,354004
25427,0.000181,172.31.47.0-255,66,28822,92,354004
25428,0.000203,74.125.200.0-255,2543,31365,92,354004
25429,0.000205,172.31.47.0-255,66,31431,92,354004
25430,0.000297,74.125.200.0-255,1484,32915,92,354004
25431,0.0003,172.31.47.0-255,66,32981,92,354004
25432,0.000317,74.125.200.0-255,2902,35883,92,354004
25433,0.00032,172.31.47.0-255,66,35949,92,354004
25434,0.000345,74.125.200.0-255,5738,41687,92,354004
25435,0.000348,172.31.47.0-255,66,41753,92,354004
25436,0.000351,74.125.200.0-255,1484,43237,92,354004
25437,0.000353,172.31.47.0-255,66,43303,92,354004
25438,0.000375,74.125.200.0-255,5379,48682,92,354004
25439,0.000379,172.31.47.0-255,66,48748,92,354004
25440,0.000385,74.125.200.0-255,7156,55904,92,354004
25441,0.000391,172.31.47.0-255,66,55970,92,354004
25442,0.000407,74.125.200.0-255,5738,61708,92,354004
25443,0.000416,172.31.47.0-255,66,61774,92,354004
25444,0.000419,74.125.200.0-255,2902,64676,92,354004
25445,0.000429,172.31.47.0-255,66,64742,92,354004
25446,0.000445,74.125.200.0-255,1404,66146,92,354004
25447,0.000477,74.125.200.0-255,129,66275,92,354004
25448,0.000538,74.125.200.0-255,1484,67759,92,354004
25449,0.000543,172.31.47.0-255,66,67825,92,354004
25450,0.000553,74.125.200.0-255,2902,70727,92,354004
25451,0.000559,172.31.47.0-255,66,70793,92,354004
25452,0.000564,74.125.200.0-255,2902,73695,92,354004
25453,0.000571,172.31.47.0-255,66,73761,92,354004
25454,0.000576,74.125.200.0-255,1484,75245,92,354004
25455,0.000589,74.125.200.0-255,2902,78147,92,354004
25456,0.000594,172.31.47.0-255,66,78213,92,354004
25457,0.000609,74.125.200.0-255,5738,83951,92,354004
25458,0.000615,74.125.200.0-255,5738,89689,92,354004
25459,0.000617,172.31.47.0-255,66,89755,92,354004
25460,0.000621,172.31.47.0-255,66,89821,92,354004
25461,0.000639,74.125.200.0-255,7156,96977,92,354004
25462,0.000642,172.31.47.0-255,66,97043,92,354004
25463,0.000664,74.125.200.0-255,3602,100645,92,354004
25464,0.000672,172.31.47.0-255,66,100711,92,354004
25465,0.000733,74.125.200.0-255,1484,102195,92,354004
25466,0.000744,74.125.200.0-255,2902,105097,92,354004
25467,0.000753,172.31.47.0-255,66,105163,92,354004
25468,0.000772,74.125.200.0-255,2902,108065,92,354004
25469,0.000775,172.31.47.0-255,66,108131,92,354004
25470,0.000804,74.125.200.0-255,2902,111033,92,354004
25471,0.000812,172.31.47.0-255,66,111099,92,354004
25472,0.00083,74.125.200.0-255,1484,112583,92,354004
25473,0.000843,172.31.47.0-255,66,112649,92,354004
25474,0.000847,172.31.47.0-255,66,112715,92,354004
25475,0.000865,74.125.200.0-255,2902,115617,92,354004
25476,0.000869,172.31.47.0-255,66,115683,92,354004
25477,0.000881,74.125.200.0-255,1882,117565,92,354004
25478,0.00089,172.31.47.0-255,66,117631,92,354004
25479,0.000941,74.125.200.0-255,1484,119115,92,354004
25480,0.000953,74.125.200.0-255,2902,122017,92,354004
25481,0.000956,172.31.47.0-255,66,122083,92,354004
25482,0.000959,74.125.200.0-255,1484,123567,92,354004
25483,0.000976,74.125.200.0-255,2902,126469,92,354004
25484,0.000978,74.125.200.0-255,1484,127953,92,354004
25485,0.000987,172.31.47.0-255,66,128019,92,354004
25486,0.000999,74.125.200.0-255,4320,132339,92,354004
25487,0.00101,172.31.47.0-255,66,132405,92,354004
25488,0.001018,74.125.200.0-255,1484,133889,92,354004
25489,0.001055,172.31.47.0-255,66,133955,92,354004
25490,0.001074,74.125.200.0-255,1484,135439,92,354004
25491,0.001094,74.125.200.0-255,6438,141877,92,354004
25492,0.001097,172.31.47.0-255,66,141943,92,354004
25493,0.0011,74.125.200.0-255,1484,143427,92,354004
25494,0.001119,74.125.200.0-255,7156,150583,92,354004
25495,0.001123,74.125.200.0-255,4320,154903,92,354004
25496,0.001124,172.31.47.0-255,66,154969,92,354004
25497,0.001128,172.31.47.0-255,66,155035,92,354004
25498,0.001147,74.125.200.0-255,5738,160773,92,354004
25499,0.001179,74.125.200.0-255,3602,164375,92,354004
25500,0.001223,74.125.200.0-255,2902,167277,92,354004
25501,0.001276,74.125.200.0-255,4320,171597,92,354004
25502,0.001311,74.125.200.0-255,2184,173781,92,354004
25503,0.001343,74.125.200.0-255,1484,175265,92,354004
25504,0.001364,74.125.200.0-255,2902,178167,92,354004
25505,0.001367,74.125.200.0-255,1484,179651,92,354004
25506,0.001388,74.125.200.0-255,2902,182553,92,354004
25507,0.001399,74.125.200.0-255,2902,185455,92,354004
25508,0.001412,74.125.200.0-255,2902,188357,92,354004
25509,0.00144,74.125.200.0-255,5738,194095,92,354004
25510,0.001458,74.125.200.0-255,7156,201251,92,354004
25511,0.001484,74.125.200.0-255,6438,207689,92,354004
25512,0.001535,74.125.200.0-255,1484,209173,92,354004
25513,0.001539,74.125.200.0-255,2902,212075,92,354004
25514,0.001555,74.125.200.0-255,2902,214977,92,354004
25515,0.001566,74.125.200.0-255,2902,217879,92,354004
25516,0.001569,74.125.200.0-255,2902,220781,92,354004
25517,0.001586,74.125.200.0-255,1484,222265,92,354004
25518,0.001591,74.125.200.0-255,5738,228003,92,354004
25519,0.001628,74.125.200.0-255,2184,230187,92,354004
25520,0.00168,74.125.200.0-255,7156,237343,92,354004
25521,0.001696,74.125.200.0-255,1484,238827,92,354004
25522,0.001702,74.125.200.0-255,5738,244565,92,354004
25523,0.001714,74.125.200.0-255,4320,248885,92,354004
25524,0.001731,74.125.200.0-255,7156,256041,92,354004
25525,0.001744,74.125.200.0-255,4320,260361,92,354004
25526,0.001769,74.125.200.0-255,3602,263963,92,354004
25527,0.001824,74.125.200.0-255,1484,265447,92,354004
25528,0.001838,74.125.200.0-255,1484,266931,92,354004
25529,0.001843,74.125.200.0-255,4320,271251,92,354004
25530,0.001857,74.125.200.0-255,1484,272735,92,354004
25531,0.001877,74.125.200.0-255,7156,279891,92,354004
25532,0.001881,74.125.200.0-255,4320,284211,92,354004
25533,0.001884,74.125.200.0-255,2902,287113,92,354004
25534,0.001898,74.125.200.0-255,2902,290015,92,354004
25535,0.001929,74.125.200.0-255,4320,294335,92,354004
25536,0.001941,74.125.200.0-255,3602,297937,92,354004
25537,0.001986,74.125.200.0-255,1484,299421,92,354004
25538,0.002003,74.125.200.0-255,2902,302323,92,354004
25539,0.002005,74.125.200.0-255,1484,303807,92,354004
25540,0.002015,74.125.200.0-255,2902,306709,92,354004
25541,0.002032,74.125.200.0-255,1484,308193,92,354004
25542,0.002036,74.125.200.0-255,5738,313931,92,354004
25543,0.002053,74.125.200.0-255,4320,318251,92,354004
25544,0.002065,74.125.200.0-255,2902,321153,92,354004
25545,0.002081,74.125.200.0-255,2902,324055,92,354004
25546,0.002094,74.125.200.0-255,4320,328375,92,354004
25547,0.002125,74.125.200.0-255,1484,329859,92,354004
25548,0.00214,74.125.200.0-255,2184,332043,92,354004
25549,0.002158,74.125.200.0-255,1484,333527,92,354004
25550,0.002168,74.125.200.0-255,2902,336429,92,354004
25551,0.002189,74.125.200.0-255,5738,342167,92,354004
25552,0.002214,74.125.200.0-255,7156,349323,92,354004
25553,0.002228,74.125.200.0-255,2902,352225,92,354004
25554,0.002241,74.125.200.0-255,1437,353662,92,354004
25555,0.002257,74.125.200.0-255,105,353767,92,354004
25556,0.004635,172.31.47.0-255,66,353833,92,354004
25557,0.007053,172.31.47.0-255,105,353938,92,354004
25558,0.009653,74.125.200.0-255,66,354004,92,354004
25559,0.0,74.125.24.0-255,152,152,92,229856
25560,2.7e-05,172.31.47.0-255,66,218,92,229856
25561,3.4e-05,74.125.24.0-255,1484,1702,92,229856
25562,3.9e-05,172.31.47.0-255,66,1768,92,229856
25563,4.4e-05,74.125.24.0-255,2902,4670,92,229856
25564,4.6e-05,172.31.47.0-255,66,4736,92,229856
25565,5.1e-05,74.125.24.0-255,2902,7638,92,229856
25566,5.4e-05,172.31.47.0-255,66,7704,92,229856
25567,7.7e-05,74.125.24.0-255,2902,10606,92,229856
25568,8e-05,172.31.47.0-255,66,10672,92,229856
25569,8.4e-05,74.125.24.0-255,2902,13574,92,229856
25570,8.6e-05,172.31.47.0-255,66,13640,92,229856
25571,0.000101,74.125.24.0-255,3465,17105,92,229856
25572,0.000104,172.31.47.0-255,66,17171,92,229856
25573,0.000109,74.125.24.0-255,4320,21491,92,229856
25574,0.000111,172.31.47.0-255,66,21557,92,229856
25575,0.000134,74.125.24.0-255,4320,25877,92,229856
25576,0.000137,172.31.47.0-255,66,25943,92,229856
25577,0.000162,74.125.24.0-255,5379,31322,92,229856
25578,0.000165,172.31.47.0-255,66,31388,92,229856
25579,0.000283,74.125.24.0-255,1484,32872,92,229856
25580,0.000288,172.31.47.0-255,66,32938,92,229856
25581,0.000294,74.125.24.0-255,2902,35840,92,229856
25582,0.000297,172.31.47.0-255,66,35906,92,229856
25583,0.000319,74.125.24.0-255,2902,38808,92,229856
25584,0.000322,172.31.47.0-255,66,38874,92,229856
25585,0.000328,74.125.24.0-255,4320,43194,92,229856
25586,0.000331,172.31.47.0-255,66,43260,92,229856
25587,0.000344,74.125.24.0-255,2902,46162,92,229856
25588,0.000347,172.31.47.0-255,66,46228,92,229856
25589,0.000366,74.125.24.0-255,5738,51966,92,229856
25590,0.000369,172.31.47.0-255,66,52032,92,229856
25591,0.000387,74.125.24.0-255,5738,57770,92,229856
25592,0.00039,172.31.47.0-255,66,57836,92,229856
25593,0.000432,172.31.47.0-255,66,57902,92,229856
25594,0.00048,74.125.24.0-255,115,58017,92,229856
25595,0.000622,74.125.24.0-255,1484,59501,92,229856
25596,0.000628,172.31.47.0-255,66,59567,92,229856
25597,0.000635,74.125.24.0-255,2902,62469,92,229856
25598,0.000638,172.31.47.0-255,66,62535,92,229856
25599,0.000653,74.125.24.0-255,4320,66855,92,229856
25600,0.000656,172.31.47.0-255,66,66921,92,229856
25601,0.000678,74.125.24.0-255,1484,68405,92,229856
25602,0.000684,74.125.24.0-255,2902,71307,92,229856
25603,0.000686,172.31.47.0-255,66,71373,92,229856
25604,0.000696,172.31.47.0-255,66,71439,92,229856
25605,0.000716,74.125.24.0-255,1484,72923,92,229856
25606,0.000724,74.125.24.0-255,7156,80079,92,229856
25607,0.000726,172.31.47.0-255,66,80145,92,229856
25608,0.000745,74.125.24.0-255,3602,83747,92,229856
25609,0.000748,172.31.47.0-255,66,83813,92,229856
25610,0.000751,74.125.24.0-255,330,84143,92,229856
25611,0.001021,172.31.47.0-255,66,84209,92,229856
25612,0.00105,74.125.24.0-255,1484,85693,92,229856
25613,0.001064,74.125.24.0-255,2902,88595,92,229856
25614,0.001066,172.31.47.0-255,66,88661,92,229856
25615,0.001076,74.125.24.0-255,1484,90145,92,229856
25616,0.001088,74.125.24.0-255,4320,94465,92,229856
25617,0.001091,172.31.47.0-255,66,94531,92,229856
25618,0.001109,74.125.24.0-255,1484,96015,92,229856
25619,0.001134,172.31.47.0-255,66,96081,92,229856
25620,0.00114,74.125.24.0-255,5738,101819,92,229856
25621,0.001143,172.31.47.0-255,66,101885,92,229856
25622,0.001173,74.125.24.0-255,1484,103369,92,229856
25623,0.001185,74.125.24.0-255,3602,106971,92,229856
25624,0.001188,172.31.47.0-255,66,107037,92,229856
25625,0.001398,74.125.24.0-255,1484,108521,92,229856
25626,0.001419,74.125.24.0-255,2902,111423,92,229856
25627,0.001423,172.31.47.0-255,66,111489,92,229856
25628,0.00143,74.125.24.0-255,5738,117227,92,229856
25629,0.001432,172.31.47.0-255,66,117293,92,229856
25630,0.001437,74.125.24.0-255,4320,121613,92,229856
25631,0.001439,172.31.47.0-255,66,121679,92,229856
25632,0.001459,74.125.24.0-255,1484,123163,92,229856
25633,0.001494,172.31.47.0-255,66,123229,92,229856
25634,0.001535,74.125.24.0-255,3602,126831,92,229856
25635,0.00154,172.31.47.0-255,66,126897,92,229856
25636,0.00157,74.125.24.0-255,1484,128381,92,229856
25637,0.001583,74.125.24.0-255,2902,131283,92,229856
25638,0.001585,172.31.47.0-255,66,131349,92,229856
25639,0.00159,74.125.24.0-255,2902,134251,92,229856
25640,0.001592,172.31.47.0-255,66,134317,92,229856
25641,0.001596,74.125.24.0-255,2902,137219,92,229856
25642,0.001597,172.31.47.0-255,66,137285,92,229856
25643,0.001617,74.125.24.0-255,5738,143023,92,229856
25644,0.001619,172.31.47.0-255,66,143089,92,229856
25645,0.001654,74.125.24.0-255,7156,150245,92,229856
25646,0.001657,172.31.47.0-255,66,150311,92,229856
25647,0.001679,172.31.47.0-255,66,150377,92,229856
25648,0.002119,74.125.24.0-255,1484,151861,92,229856
25649,0.002124,74.125.24.0-255,1484,153345,92,229856
25650,0.002128,172.31.47.0-255,66,153411,92,229856
25651,0.002145,74.125.24.0-255,1484,154895,92,229856
25652,0.002152,74.125.24.0-255,5738,160633,92,229856
25653,0.002154,172.31.47.0-255,66,160699,92,229856
25654,0.002165,74.125.24.0-255,4320,165019,92,229856
25655,0.002167,172.31.47.0-255,66,165085,92,229856
25656,0.002187,172.31.47.0-255,66,165151,92,229856
25657,0.00219,74.125.24.0-255,1484,166635,92,229856
25658,0.002218,172.31.47.0-255,66,166701,92,229856
25659,0.002258,74.125.24.0-255,1484,168185,92,229856
25660,0.00227,74.125.24.0-255,2902,171087,92,229856
25661,0.002272,172.31.47.0-255,66,171153,92,229856
25662,0.002287,74.125.24.0-255,4320,175473,92,229856
25663,0.002289,172.31.47.0-255,66,175539,92,229856
25664,0.002302,74.125.24.0-255,1484,177023,92,229856
25665,0.002305,74.125.24.0-255,1484,178507,92,229856
25666,0.002306,172.31.47.0-255,66,178573,92,229856
25667,0.002359,74.125.24.0-255,5738,184311,92,229856
25668,0.002362,172.31.47.0-255,66,184377,92,229856
25669,0.002374,172.31.47.0-255,66,184443,92,229856
25670,0.00238,74.125.24.0-255,6438,190881,92,229856
25671,0.002382,172.31.47.0-255,66,190947,92,229856
25672,0.002385,74.125.24.0-255,2902,193849,92,229856
25673,0.002387,172.31.47.0-255,66,193915,92,229856
25674,0.002425,172.31.47.0-255,66,193981,92,229856
25675,0.002472,74.125.24.0-255,6438,200419,92,229856
25676,0.002475,172.31.47.0-255,66,200485,92,229856
25677,0.002479,74.125.24.0-255,2902,203387,92,229856
25678,0.002481,172.31.47.0-255,66,203453,92,229856
25679,0.002504,172.31.47.0-255,66,203519,92,229856
25680,0.002531,172.31.47.0-255,66,203585,92,229856
25681,0.002602,74.125.24.0-255,5738,209323,92,229856
25682,0.002606,172.31.47.0-255,66,209389,92,229856
25683,0.002641,172.31.47.0-255,66,209455,92,229856
25684,0.002692,74.125.24.0-255,5738,215193,92,229856
25685,0.002696,172.31.47.0-255,66,215259,92,229856
25686,0.002726,172.31.47.0-255,66,215325,92,229856
25687,0.002741,74.125.24.0-255,2184,217509,92,229856
25688,0.002744,172.31.47.0-255,66,217575,92,229856
25689,0.002777,74.125.24.0-255,2902,220477,92,229856
25690,0.00278,172.31.47.0-255,66,220543,92,229856
25691,0.002813,172.31.47.0-255,66,220609,92,229856
25692,0.002841,172.31.47.0-255,66,220675,92,229856
25693,0.005373,74.125.24.0-255,5738,226413,92,229856
25694,0.005378,172.31.47.0-255,66,226479,92,229856
25695,0.007921,74.125.24.0-255,3206,229685,92,229856
25696,0.007924,172.31.47.0-255,66,229751,92,229856
25697,0.008473,172.31.47.0-255,105,229856,92,229856
25698,0.0,172.217.194.0-255,153,153,92,135538
25699,2.7e-05,172.31.47.0-255,66,219,92,135538
25700,3.4e-05,172.217.194.0-255,1484,1703,92,135538
25701,3.8e-05,172.31.47.0-255,66,1769,92,135538
25702,4.3e-05,172.217.194.0-255,2902,4671,92,135538
25703,4.6e-05,172.31.47.0-255,66,4737,92,135538
25704,5.3e-05,172.217.194.0-255,7156,11893,92,135538
25705,5.6e-05,172.31.47.0-255,66,11959,92,135538
25706,6e-05,172.217.194.0-255,2108,14067,92,135538
25707,6.2e-05,172.31.47.0-255,66,14133,92,135538
25708,6.6e-05,172.217.194.0-255,1484,15617,92,135538
25709,6.7e-05,172.31.47.0-255,66,15683,92,135538
25710,0.000107,172.31.47.0-255,66,15749,92,135538
25711,0.000113,172.217.194.0-255,5379,21128,92,135538
25712,0.000116,172.31.47.0-255,66,21194,92,135538
25713,0.000264,172.217.194.0-255,1484,22678,92,135538
25714,0.000269,172.31.47.0-255,66,22744,92,135538
25715,0.000274,172.217.194.0-255,2902,25646,92,135538
25716,0.000277,172.31.47.0-255,66,25712,92,135538
25717,0.000283,172.217.194.0-255,5738,31450,92,135538
25718,0.000285,172.31.47.0-255,66,31516,92,135538
25719,0.000288,172.217.194.0-255,1484,33000,92,135538
25720,0.000291,172.31.47.0-255,66,33066,92,135538
25721,0.00031,172.217.194.0-255,4320,37386,92,135538
25722,0.000313,172.31.47.0-255,66,37452,92,135538
25723,0.000327,172.217.194.0-255,1484,38936,92,135538
25724,0.000329,172.31.47.0-255,66,39002,92,135538
25725,0.000364,172.31.47.0-255,66,39068,92,135538
25726,0.00037,172.217.194.0-255,3961,43029,92,135538
25727,0.000372,172.31.47.0-255,66,43095,92,135538
25728,0.000375,172.217.194.0-255,378,43473,92,135538
25729,0.000778,172.31.47.0-255,66,43539,92,135538
25730,0.000818,172.217.194.0-255,365,43904,92,135538
25731,0.000842,172.31.47.0-255,66,43970,92,135538
25732,0.001053,172.217.194.0-255,1484,45454,92,135538
25733,0.001063,172.217.194.0-255,2902,48356,92,135538
25734,0.001066,172.31.47.0-255,66,48422,92,135538
25735,0.001071,172.217.194.0-255,1484,49906,92,135538
25736,0.001089,172.217.194.0-255,4320,54226,92,135538
25737,0.001091,172.31.47.0-255,66,54292,92,135538
25738,0.001096,172.217.194.0-255,2902,57194,92,135538
25739,0.001098,172.31.47.0-255,66,57260,92,135538
25740,0.00112,172.31.47.0-255,66,57326,92,135538
25741,0.001126,172.217.194.0-255,4320,61646,92,135538
25742,0.001128,172.31.47.0-255,66,61712,92,135538
25743,0.001154,172.217.194.0-255,6438,68150,92,135538
25744,0.001157,172.31.47.0-255,66,68216,92,135538
25745,0.001472,172.217.194.0-255,1484,69700,92,135538
25746,0.00148,172.217.194.0-255,2902,72602,92,135538
25747,0.001484,172.31.47.0-255,66,72668,92,135538
25748,0.001491,172.217.194.0-255,5738,78406,92,135538
25749,0.001493,172.31.47.0-255,66,78472,92,135538
25750,0.001514,172.217.194.0-255,2902,81374,92,135538
25751,0.001516,172.31.47.0-255,66,81440,92,135538
25752,0.001539,172.31.47.0-255,66,81506,92,135538
25753,0.001624,172.217.194.0-255,4320,85826,92,135538
25754,0.001627,172.31.47.0-255,66,85892,92,135538
25755,0.001648,172.217.194.0-255,6438,92330,92,135538
25756,0.00165,172.31.47.0-255,66,92396,92,135538
25757,0.001679,172.217.194.0-255,1484,93880,92,135538
25758,0.001692,172.217.194.0-255,2902,96782,92,135538
25759,0.001695,172.31.47.0-255,66,96848,92,135538
25760,0.001715,172.217.194.0-255,5738,102586,92,135538
25761,0.001717,172.31.47.0-255,66,102652,92,135538
25762,0.001722,172.217.194.0-255,4320,106972,92,135538
25763,0.001724,172.31.47.0-255,66,107038,92,135538
25764,0.00174,172.217.194.0-255,4320,111358,92,135538
25765,0.001742,172.31.47.0-255,66,111424,92,135538
25766,0.001783,172.31.47.0-255,66,111490,92,135538
25767,0.001804,172.217.194.0-255,6438,117928,92,135538
25768,0.001806,172.31.47.0-255,66,117994,92,135538
25769,0.004145,172.217.194.0-255,5738,123732,92,135538
25770,0.004149,172.31.47.0-255,66,123798,92,135538
25771,0.00648,172.217.194.0-255,2902,126700,92,135538
25772,0.006483,172.31.47.0-255,66,126766,92,135538
25773,0.006495,172.217.194.0-255,2902,129668,92,135538
25774,0.006497,172.31.47.0-255,66,129734,92,135538
25775,0.008776,172.217.194.0-255,5738,135472,92,135538
25776,0.008784,172.31.47.0-255,66,135538,92,135538
25777,0.0,172.217.194.0-255,153,153,92,210712
25778,3.5e-05,172.31.47.0-255,66,219,92,210712
25779,4.1e-05,172.217.194.0-255,1484,1703,92,210712
25780,4.6e-05,172.31.47.0-255,66,1769,92,210712
25781,5e-05,172.217.194.0-255,2902,4671,92,210712
25782,5.3e-05,172.31.47.0-255,66,4737,92,210712
25783,6.8e-05,172.217.194.0-255,7156,11893,92,210712
25784,7.1e-05,172.31.47.0-255,66,11959,92,210712
25785,8.3e-05,172.31.47.0-255,66,12025,92,210712
25786,0.000127,172.217.194.0-255,7156,19181,92,210712
25787,0.00013,172.31.47.0-255,66,19247,92,210712
25788,0.000159,172.217.194.0-255,1125,20372,92,210712
25789,0.000162,172.31.47.0-255,66,20438,92,210712
25790,0.000174,172.31.47.0-255,66,20504,92,210712
25791,0.000187,172.31.47.0-255,66,20570,92,210712
25792,0.000207,172.217.194.0-255,1484,22054,92,210712
25793,0.00021,172.31.47.0-255,66,22120,92,210712
25794,0.000236,172.217.194.0-255,7156,29276,92,210712
25795,0.000239,172.31.47.0-255,66,29342,92,210712
25796,0.00025,172.31.47.0-255,66,29408,92,210712
25797,0.000252,172.217.194.0-255,361,29769,92,210712
25798,0.000255,172.31.47.0-255,66,29835,92,210712
25799,0.000328,172.217.194.0-255,1484,31319,92,210712
25800,0.000332,172.31.47.0-255,66,31385,92,210712
25801,0.000358,172.217.194.0-255,2902,34287,92,210712
25802,0.000363,172.31.47.0-255,66,34353,92,210712
25803,0.000396,172.217.194.0-255,2902,37255,92,210712
25804,0.000399,172.31.47.0-255,66,37321,92,210712
25805,0.000422,172.217.194.0-255,2902,40223,92,210712
25806,0.000425,172.31.47.0-255,66,40289,92,210712
25807,0.000432,172.217.194.0-255,6533,46822,92,210712
25808,0.000435,172.31.47.0-255,66,46888,92,210712
25809,0.000669,172.217.194.0-255,1484,48372,92,210712
25810,0.000676,172.217.194.0-255,2902,51274,92,210712
25811,0.000679,172.31.47.0-255,66,51340,92,210712
25812,0.000685,172.217.194.0-255,2902,54242,92,210712
25813,0.000687,172.31.47.0-255,66,54308,92,210712
25814,0.00071,172.217.194.0-255,2902,57210,92,210712
25815,0.000713,172.31.47.0-255,66,57276,92,210712
25816,0.000732,172.31.47.0-255,66,57342,92,210712
25817,0.000735,172.217.194.0-255,1484,58826,92,210712
25818,0.000768,172.31.47.0-255,66,58892,92,210712
25819,0.000991,172.217.194.0-255,1484,60376,92,210712
25820,0.000995,172.217.194.0-255,1484,61860,92,210712
25821,0.000999,172.31.47.0-255,66,61926,92,210712
25822,0.001025,172.217.194.0-255,1484,63410,92,210712
25823,0.001032,172.217.194.0-255,5738,69148,92,210712
25824,0.001035,172.31.47.0-255,66,69214,92,210712
25825,0.001039,172.217.194.0-255,1484,70698,92,210712
25826,0.001062,172.217.194.0-255,5738,76436,92,210712
25827,0.001065,172.31.47.0-255,66,76502,92,210712
25828,0.001117,172.31.47.0-255,66,76568,92,210712
25829,0.001122,172.217.194.0-255,2184,78752,92,210712
25830,0.001124,172.31.47.0-255,66,78818,92,210712
25831,0.001177,172.217.194.0-255,1484,80302,92,210712
25832,0.001182,172.217.194.0-255,2902,83204,92,210712
25833,0.001185,172.31.47.0-255,66,83270,92,210712
25834,0.001216,172.217.194.0-255,5738,89008,92,210712
25835,0.001224,172.31.47.0-255,66,89074,92,210712
25836,0.001247,172.31.47.0-255,66,89140,92,210712
25837,0.001278,172.217.194.0-255,2902,92042,92,210712
25838,0.001281,172.31.47.0-255,66,92108,92,210712
25839,0.001288,172.217.194.0-255,7156,99264,92,210712
25840,0.00129,172.31.47.0-255,66,99330,92,210712
25841,0.001301,172.217.194.0-255,3602,102932,92,210712
25842,0.001303,172.31.47.0-255,66,102998,92,210712
25843,0.001333,172.217.194.0-255,4320,107318,92,210712
25844,0.001337,172.31.47.0-255,66,107384,92,210712
25845,0.001348,172.31.47.0-255,66,107450,92,210712
25846,0.001351,172.217.194.0-255,1484,108934,92,210712
25847,0.001389,172.31.47.0-255,66,109000,92,210712
25848,0.001421,172.217.194.0-255,1484,110484,92,210712
25849,0.001434,172.31.47.0-255,66,110550,92,210712
25850,0.001439,172.31.47.0-255,66,110616,92,210712
25851,0.001445,172.217.194.0-255,5738,116354,92,210712
25852,0.001447,172.31.47.0-255,66,116420,92,210712
25853,0.00149,172.31.47.0-255,66,116486,92,210712
25854,0.001495,172.217.194.0-255,4320,120806,92,210712
25855,0.001497,172.31.47.0-255,66,120872,92,210712
25856,0.001535,172.217.194.0-255,5020,125892,92,210712
25857,0.001539,172.31.47.0-255,66,125958,92,210712
25858,0.001555,172.31.47.0-255,66,126024,92,210712
25859,0.001631,172.31.47.0-255,66,126090,92,210712
25860,0.001639,172.217.194.0-255,7156,133246,92,210712
25861,0.001643,172.31.47.0-255,66,133312,92,210712
25862,0.00165,172.217.194.0-255,6438,139750,92,210712
25863,0.001653,172.31.47.0-255,66,139816,92,210712
25864,0.001659,172.217.194.0-255,7156,146972,92,210712
25865,0.001662,172.31.47.0-255,66,147038,92,210712
25866,0.001679,172.31.47.0-255,66,147104,92,210712
25867,0.001694,172.31.47.0-255,66,147170,92,210712
25868,0.001713,172.217.194.0-255,1484,148654,92,210712
25869,0.001719,172.217.194.0-255,2902,151556,92,210712
25870,0.001722,172.31.47.0-255,66,151622,92,210712
25871,0.001728,172.217.194.0-255,5738,157360,92,210712
25872,0.00173,172.31.47.0-255,66,157426,92,210712
25873,0.001761,172.217.194.0-255,7156,164582,92,210712
25874,0.001766,172.31.47.0-255,66,164648,92,210712
25875,0.001803,172.217.194.0-255,5738,170386,92,210712
25876,0.001807,172.31.47.0-255,66,170452,92,210712
25877,0.001814,172.217.194.0-255,7156,177608,92,210712
25878,0.001816,172.31.47.0-255,66,177674,92,210712
25879,0.001821,172.217.194.0-255,3602,181276,92,210712
25880,0.001824,172.31.47.0-255,66,181342,92,210712
25881,0.001917,172.217.194.0-255,1484,182826,92,210712
25882,0.001939,172.217.194.0-255,2902,185728,92,210712
25883,0.001943,172.31.47.0-255,66,185794,92,210712
25884,0.00195,172.217.194.0-255,5738,191532,92,210712
25885,0.001953,172.31.47.0-255,66,191598,92,210712
25886,0.001963,172.217.194.0-255,2902,194500,92,210712
25887,0.001966,172.31.47.0-255,66,194566,92,210712
25888,0.002021,172.31.47.0-255,66,194632,92,210712
25889,0.002033,172.31.47.0-255,66,194698,92,210712
25890,0.002036,172.217.194.0-255,766,195464,92,210712
25891,0.002039,172.217.194.0-255,1484,196948,92,210712
25892,0.002042,172.31.47.0-255,66,197014,92,210712
25893,0.002073,172.217.194.0-255,4320,201334,92,210712
25894,0.002078,172.31.47.0-255,66,201400,92,210712
25895,0.002089,172.31.47.0-255,66,201466,92,210712
25896,0.002123,172.217.194.0-255,1484,202950,92,210712
25897,0.002135,172.31.47.0-255,66,203016,92,210712
25898,0.002139,172.217.194.0-255,1484,204500,92,210712
25899,0.002165,172.217.194.0-255,5738,210238,92,210712
25900,0.002168,172.31.47.0-255,66,210304,92,210712
25901,0.002212,172.31.47.0-255,66,210370,92,210712
25902,0.002215,172.217.194.0-255,105,210475,92,210712
25903,0.003705,172.31.47.0-255,66,210541,92,210712
25904,0.003732,172.31.47.0-255,105,210646,92,210712
25905,0.006303,172.217.194.0-255,66,210712,92,210712
25906,0.0,74.125.24.0-255,153,153,92,132394
25907,2.4e-05,172.31.47.0-255,66,219,92,132394
25908,3.1e-05,74.125.24.0-255,1484,1703,92,132394
25909,3.5e-05,172.31.47.0-255,66,1769,92,132394
25910,4.1e-05,74.125.24.0-255,2902,4671,92,132394
25911,4.4e-05,172.31.47.0-255,66,4737,92,132394
25912,5.2e-05,74.125.24.0-255,7156,11893,92,132394
25913,5.5e-05,172.31.47.0-255,66,11959,92,132394
25914,5.9e-05,74.125.24.0-255,2166,14125,92,132394
25915,6.2e-05,172.31.47.0-255,66,14191,92,132394
25916,0.00031,74.125.24.0-255,1484,15675,92,132394
25917,0.000315,172.31.47.0-255,66,15741,92,132394
25918,0.000322,74.125.24.0-255,2902,18643,92,132394
25919,0.000324,172.31.47.0-255,66,18709,92,132394
25920,0.000329,74.125.24.0-255,2902,21611,92,132394
25921,0.000332,172.31.47.0-255,66,21677,92,132394
25922,0.000354,74.125.24.0-255,2902,24579,92,132394
25923,0.000357,172.31.47.0-255,66,24645,92,132394
25924,0.000375,74.125.24.0-255,1484,26129,92,132394
25925,0.000378,172.31.47.0-255,66,26195,92,132394
25926,0.000409,172.31.47.0-255,66,26261,92,132394
25927,0.000437,74.125.24.0-255,5738,31999,92,132394
25928,0.000439,172.31.47.0-255,66,32065,92,132394
25929,0.000455,74.125.24.0-255,3961,36026,92,132394
25930,0.000457,172.31.47.0-255,66,36092,92,132394
25931,0.001237,74.125.24.0-255,1484,37576,92,132394
25932,0.001243,172.31.47.0-255,66,37642,92,132394
25933,0.001252,74.125.24.0-255,2902,40544,92,132394
25934,0.001254,172.31.47.0-255,66,40610,92,132394
25935,0.00126,74.125.24.0-255,5738,46348,92,132394
25936,0.001263,172.31.47.0-255,66,46414,92,132394
25937,0.001289,74.125.24.0-255,2902,49316,92,132394
25938,0.001292,172.31.47.0-255,66,49382,92,132394
25939,0.001312,172.31.47.0-255,66,49448,92,132394
25940,0.001324,172.31.47.0-255,66,49514,92,132394
25941,0.00135,74.125.24.0-255,2902,52416,92,132394
25942,0.001353,172.31.47.0-255,66,52482,92,132394
25943,0.001367,172.31.47.0-255,66,52548,92,132394
25944,0.001937,74.125.24.0-255,1484,54032,92,132394
25945,0.001963,74.125.24.0-255,2902,56934,92,132394
25946,0.001968,172.31.47.0-255,66,57000,92,132394
25947,0.001976,74.125.24.0-255,5738,62738,92,132394
25948,0.001978,172.31.47.0-255,66,62804,92,132394
25949,0.001983,74.125.24.0-255,2902,65706,92,132394
25950,0.001985,172.31.47.0-255,66,65772,92,132394
25951,0.002008,74.125.24.0-255,5738,71510,92,132394
25952,0.002011,172.31.47.0-255,66,71576,92,132394
25953,0.002045,74.125.24.0-255,4320,75896,92,132394
25954,0.002048,172.31.47.0-255,66,75962,92,132394
25955,0.002079,172.31.47.0-255,66,76028,92,132394
25956,0.002123,74.125.24.0-255,1484,77512,92,132394
25957,0.002141,74.125.24.0-255,2902,80414,92,132394
25958,0.002144,172.31.47.0-255,66,80480,92,132394
25959,0.002162,74.125.24.0-255,5738,86218,92,132394
25960,0.002165,172.31.47.0-255,66,86284,92,132394
25961,0.002171,74.125.24.0-255,4320,90604,92,132394
25962,0.002173,172.31.47.0-255,66,90670,92,132394
25963,0.002211,172.31.47.0-255,66,90736,92,132394
25964,0.002222,172.31.47.0-255,66,90802,92,132394
25965,0.002242,74.125.24.0-255,2184,92986,92,132394
25966,0.002245,172.31.47.0-255,66,93052,92,132394
25967,0.002285,74.125.24.0-255,1484,94536,92,132394
25968,0.00229,74.125.24.0-255,2902,97438,92,132394
25969,0.002292,172.31.47.0-255,66,97504,92,132394
25970,0.002316,74.125.24.0-255,5738,103242,92,132394
25971,0.002318,172.31.47.0-255,66,103308,92,132394
25972,0.002325,74.125.24.0-255,5738,109046,92,132394
25973,0.002328,172.31.47.0-255,66,109112,92,132394
25974,0.002336,74.125.24.0-255,7156,116268,92,132394
25975,0.002339,172.31.47.0-255,66,116334,92,132394
25976,0.004643,74.125.24.0-255,4320,120654,92,132394
25977,0.004647,172.31.47.0-255,66,120720,92,132394
25978,0.004666,74.125.24.0-255,1484,122204,92,132394
25979,0.007036,74.125.24.0-255,4320,126524,92,132394
25980,0.007044,172.31.47.0-255,66,126590,92,132394
25981,0.009397,74.125.24.0-255,5738,132328,92,132394
25982,0.009408,172.31.47.0-255,66,132394,92,132394
25983,0.0,74.125.130.0-255,153,153,92,193308
25984,2.2e-05,172.31.47.0-255,66,219,92,193308
25985,2.8e-05,74.125.130.0-255,1484,1703,92,193308
25986,3.1e-05,172.31.47.0-255,66,1769,92,193308
25987,3.6e-05,74.125.130.0-255,2902,4671,92,193308
25988,3.8e-05,172.31.47.0-255,66,4737,92,193308
25989,5.1e-05,74.125.130.0-255,7156,11893,92,193308
25990,5.3e-05,172.31.47.0-255,66,11959,92,193308
25991,5.7e-05,74.125.130.0-255,2218,14177,92,193308
25992,5.8e-05,172.31.47.0-255,66,14243,92,193308
25993,0.000303,74.125.130.0-255,1484,15727,92,193308
25994,0.000308,172.31.47.0-255,66,15793,92,193308
25995,0.000312,74.125.130.0-255,2902,18695,92,193308
25996,0.000314,172.31.47.0-255,66,18761,92,193308
25997,0.000339,74.125.130.0-255,5738,24499,92,193308
25998,0.000341,172.31.47.0-255,66,24565,92,193308
25999,0.000369,74.125.130.0-255,4320,28885,92,193308
26000,0.000372,172.31.47.0-255,66,28951,92,193308
26001,0.000402,74.125.130.0-255,3961,32912,92,193308
26002,0.000404,172.31.47.0-255,66,32978,92,193308
26003,0.000429,74.125.130.0-255,4320,37298,92,193308
26004,0.000431,172.31.47.0-255,66,37364,92,193308
26005,0.000462,172.31.47.0-255,66,37430,92,193308
26006,0.000484,74.125.130.0-255,1484,38914,92,193308
26007,0.000486,172.31.47.0-255,66,38980,92,193308
26008,0.000489,74.125.130.0-255,1125,40105,92,193308
26009,0.00049,172.31.47.0-255,66,40171,92,193308
26010,0.000528,74.125.130.0-255,1484,41655,92,193308
26011,0.000531,172.31.47.0-255,66,41721,92,193308
26012,0.000556,74.125.130.0-255,4320,46041,92,193308
26013,0.000558,172.31.47.0-255,66,46107,92,193308
26014,0.000582,74.125.130.0-255,5738,51845,92,193308
26015,0.000584,172.31.47.0-255,66,51911,92,193308
26016,0.00062,74.125.130.0-255,5379,57290,92,193308
26017,0.000622,172.31.47.0-255,66,57356,92,193308
26018,0.000624,74.125.130.0-255,380,57736,92,193308
26019,0.000886,74.125.130.0-255,98,57834,92,193308
26020,0.000958,172.31.47.0-255,66,57900,92,193308
26021,0.001082,74.125.130.0-255,1484,59384,92,193308
26022,0.001088,74.125.130.0-255,1484,60868,92,193308
26023,0.001091,172.31.47.0-255,66,60934,92,193308
26024,0.001102,74.125.130.0-255,1484,62418,92,193308
26025,0.001109,74.125.130.0-255,2902,65320,92,193308
26026,0.001111,172.31.47.0-255,66,65386,92,193308
26027,0.001133,74.125.130.0-255,2902,68288,92,193308
26028,0.001135,172.31.47.0-255,66,68354,92,193308
26029,0.001151,74.125.130.0-255,1484,69838,92,193308
26030,0.001173,74.125.130.0-255,5379,75217,92,193308
26031,0.001175,172.31.47.0-255,66,75283,92,193308
26032,0.001179,74.125.130.0-255,2902,78185,92,193308
26033,0.001181,172.31.47.0-255,66,78251,92,193308
26034,0.001203,74.125.130.0-255,2902,81153,92,193308
26035,0.001209,172.31.47.0-255,66,81219,92,193308
26036,0.001233,74.125.130.0-255,7156,88375,92,193308
26037,0.001237,172.31.47.0-255,66,88441,92,193308
26038,0.001252,74.125.130.0-255,3677,92118,92,193308
26039,0.001254,172.31.47.0-255,66,92184,92,193308
26040,0.001425,74.125.130.0-255,1484,93668,92,193308
26041,0.001432,74.125.130.0-255,2902,96570,92,193308
26042,0.001435,172.31.47.0-255,66,96636,92,193308
26043,0.001438,74.125.130.0-255,1484,98120,92,193308
26044,0.001469,74.125.130.0-255,4320,102440,92,193308
26045,0.001473,172.31.47.0-255,66,102506,92,193308
26046,0.001479,74.125.130.0-255,7156,109662,92,193308
26047,0.001481,172.31.47.0-255,66,109728,92,193308
26048,0.001483,74.125.130.0-255,1484,111212,92,193308
26049,0.00151,74.125.130.0-255,7156,118368,92,193308
26050,0.001513,172.31.47.0-255,66,118434,92,193308
26051,0.001518,74.125.130.0-255,5738,124172,92,193308
26052,0.001519,172.31.47.0-255,66,124238,92,193308
26053,0.001572,74.125.130.0-255,2184,126422,92,193308
26054,0.001575,172.31.47.0-255,66,126488,92,193308
26055,0.001839,74.125.130.0-255,1484,127972,92,193308
26056,0.001859,74.125.130.0-255,2902,130874,92,193308
26057,0.001864,172.31.47.0-255,66,130940,92,193308
26058,0.001886,74.125.130.0-255,1484,132424,92,193308
26059,0.001889,74.125.130.0-255,1484,133908,92,193308
26060,0.001892,172.31.47.0-255,66,133974,92,193308
26061,0.001915,74.125.130.0-255,1484,135458,92,193308
26062,0.001921,74.125.130.0-255,5738,141196,92,193308
26063,0.001923,172.31.47.0-255,66,141262,92,193308
26064,0.001926,74.125.130.0-255,1484,142746,92,193308
26065,0.00195,74.125.130.0-255,5738,148484,92,193308
26066,0.001953,172.31.47.0-255,66,148550,92,193308
26067,0.001973,74.125.130.0-255,1484,150034,92,193308
26068,0.001975,74.125.130.0-255,1484,151518,92,193308
26069,0.001977,172.31.47.0-255,66,151584,92,193308
26070,0.001999,74.125.130.0-255,1484,153068,92,193308
26071,0.002004,74.125.130.0-255,5738,158806,92,193308
26072,0.002006,172.31.47.0-255,66,158872,92,193308
26073,0.002024,74.125.130.0-255,2184,161056,92,193308
26074,0.002026,172.31.47.0-255,66,161122,92,193308
26075,0.002559,74.125.130.0-255,1484,162606,92,193308
26076,0.002565,74.125.130.0-255,2902,165508,92,193308
26077,0.002568,172.31.47.0-255,66,165574,92,193308
26078,0.002591,74.125.130.0-255,4320,169894,92,193308
26079,0.002594,172.31.47.0-255,66,169960,92,193308
26080,0.00265,74.125.130.0-255,5738,175698,92,193308
26081,0.002654,172.31.47.0-255,66,175764,92,193308
26082,0.002679,74.125.130.0-255,2902,178666,92,193308
26083,0.002681,172.31.47.0-255,66,178732,92,193308
26084,0.002685,74.125.130.0-255,2902,181634,92,193308
26085,0.002687,172.31.47.0-255,66,181700,92,193308
26086,0.005306,74.125.130.0-255,5738,187438,92,193308
26087,0.005323,172.31.47.0-255,66,187504,92,193308
26088,0.007935,74.125.130.0-255,5738,193242,92,193308
26089,0.007947,172.31.47.0-255,66,193308,92,193308
26090,0.0,172.31.47.0-255,105,105,92,660
26091,0.000306,172.31.47.0-255,90,195,92,660
26092,0.000317,172.31.47.0-255,66,261,92,660
26093,0.001767,157.240.13.0-255,105,366,92,660
26094,0.001801,172.31.47.0-255,54,420,92,660
26095,0.001807,157.240.13.0-255,66,486,92,660
26096,0.001812,172.31.47.0-255,54,540,92,660
26097,0.002043,157.240.13.0-255,60,600,92,660
26098,0.002047,157.240.13.0-255,60,660,92,660
26099,0.0,172.31.47.0-255,105,105,92,105
26100,0.0,172.217.194.0-255,153,153,92,176997
26101,2.2e-05,172.31.47.0-255,66,219,92,176997
26102,3e-05,172.217.194.0-255,1484,1703,92,176997
26103,3.4e-05,172.31.47.0-255,66,1769,92,176997
26104,4.1e-05,172.217.194.0-255,2902,4671,92,176997
26105,5.3e-05,172.31.47.0-255,66,4737,92,176997
26106,6e-05,172.217.194.0-255,5738,10475,92,176997
26107,6.3e-05,172.31.47.0-255,66,10541,92,176997
26108,9e-05,172.217.194.0-255,3627,14168,92,176997
26109,9.3e-05,172.31.47.0-255,66,14234,92,176997
26110,0.000141,172.217.194.0-255,1484,15718,92,176997
26111,0.000144,172.31.47.0-255,66,15784,92,176997
26112,0.000149,172.217.194.0-255,2902,18686,92,176997
26113,0.000151,172.31.47.0-255,66,18752,92,176997
26114,0.000187,172.217.194.0-255,5738,24490,92,176997
26115,0.00019,172.31.47.0-255,66,24556,92,176997
26116,0.000197,172.217.194.0-255,6797,31353,92,176997
26117,0.0002,172.31.47.0-255,66,31419,92,176997
26118,0.000226,172.217.194.0-255,1484,32903,92,176997
26119,0.000228,172.31.47.0-255,66,32969,92,176997
26120,0.000253,172.217.194.0-255,2902,35871,92,176997
26121,0.000255,172.31.47.0-255,66,35937,92,176997
26122,0.000262,172.217.194.0-255,5738,41675,92,176997
26123,0.000264,172.31.47.0-255,66,41741,92,176997
26124,0.000292,172.217.194.0-255,6797,48538,92,176997
26125,0.000294,172.31.47.0-255,66,48604,92,176997
26126,0.000357,172.217.194.0-255,1484,50088,92,176997
26127,0.00036,172.31.47.0-255,66,50154,92,176997
26128,0.000388,172.217.194.0-255,2902,53056,92,176997
26129,0.000391,172.31.47.0-255,66,53122,92,176997
26130,0.000398,172.217.194.0-255,5738,58860,92,176997
26131,0.000401,172.31.47.0-255,66,58926,92,176997
26132,0.000448,172.31.47.0-255,66,58992,92,176997
26133,0.000487,172.217.194.0-255,1484,60476,92,176997
26134,0.0005,172.217.194.0-255,2902,63378,92,176997
26135,0.000503,172.31.47.0-255,66,63444,92,176997
26136,0.000508,172.217.194.0-255,2902,66346,92,176997
26137,0.00051,172.31.47.0-255,66,66412,92,176997
26138,0.000534,172.217.194.0-255,2902,69314,92,176997
26139,0.000536,172.31.47.0-255,66,69380,92,176997
26140,0.000554,172.31.47.0-255,66,69446,92,176997
26141,0.000583,172.217.194.0-255,2543,71989,92,176997
26142,0.000585,172.31.47.0-255,66,72055,92,176997
26143,0.000588,172.217.194.0-255,1484,73539,92,176997
26144,0.000624,172.31.47.0-255,66,73605,92,176997
26145,0.000668,172.31.47.0-255,66,73671,92,176997
26146,0.000686,172.31.47.0-255,66,73737,92,176997
26147,0.000722,172.31.47.0-255,66,73803,92,176997
26148,0.00078,172.217.194.0-255,1484,75287,92,176997
26149,0.000786,172.217.194.0-255,2902,78189,92,176997
26150,0.000789,172.31.47.0-255,66,78255,92,176997
26151,0.00082,172.217.194.0-255,5738,83993,92,176997
26152,0.000824,172.31.47.0-255,66,84059,92,176997
26153,0.000831,172.217.194.0-255,7156,91215,92,176997
26154,0.000834,172.31.47.0-255,66,91281,92,176997
26155,0.00086,172.217.194.0-255,5738,97019,92,176997
26156,0.000863,172.31.47.0-255,66,97085,92,176997
26157,0.000876,172.31.47.0-255,66,97151,92,176997
26158,0.00135,172.217.194.0-255,1484,98635,92,176997
26159,0.001357,172.217.194.0-255,2902,101537,92,176997
26160,0.001361,172.31.47.0-255,66,101603,92,176997
26161,0.001383,172.217.194.0-255,5738,107341,92,176997
26162,0.001386,172.31.47.0-255,66,107407,92,176997
26163,0.001424,172.217.194.0-255,5738,113145,92,176997
26164,0.001427,172.31.47.0-255,66,113211,92,176997
26165,0.00146,172.217.194.0-255,7156,120367,92,176997
26166,0.001463,172.31.47.0-255,66,120433,92,176997
26167,0.001482,172.31.47.0-255,66,120499,92,176997
26168,0.002067,172.217.194.0-255,1484,121983,92,176997
26169,0.002081,172.217.194.0-255,2902,124885,92,176997
26170,0.002084,172.31.47.0-255,66,124951,92,176997
26171,0.002092,172.217.194.0-255,5738,130689,92,176997
26172,0.002094,172.31.47.0-255,66,130755,92,176997
26173,0.002137,172.31.47.0-255,66,130821,92,176997
26174,0.002145,172.217.194.0-255,7156,137977,92,176997
26175,0.002147,172.31.47.0-255,66,138043,92,176997
26176,0.002186,172.217.194.0-255,3602,141645,92,176997
26177,0.002189,172.31.47.0-255,66,141711,92,176997
26178,0.002291,172.217.194.0-255,1484,143195,92,176997
26179,0.002296,172.217.194.0-255,1484,144679,92,176997
26180,0.002299,172.31.47.0-255,66,144745,92,176997
26181,0.002329,172.217.194.0-255,1484,146229,92,176997
26182,0.002337,172.217.194.0-255,5738,151967,92,176997
26183,0.002339,172.31.47.0-255,66,152033,92,176997
26184,0.002345,172.217.194.0-255,4320,156353,92,176997
26185,0.002347,172.31.47.0-255,66,156419,92,176997
26186,0.002371,172.31.47.0-255,66,156485,92,176997
26187,0.002376,172.217.194.0-255,2902,159387,92,176997
26188,0.002378,172.31.47.0-255,66,159453,92,176997
26189,0.004653,172.217.194.0-255,2902,162355,92,176997
26190,0.00466,172.31.47.0-255,66,162421,92,176997
26191,0.004679,172.217.194.0-255,2902,165323,92,176997
26192,0.004681,172.31.47.0-255,66,165389,92,176997
26193,0.006972,172.217.194.0-255,5738,171127,92,176997
26194,0.006976,172.31.47.0-255,66,171193,92,176997
26195,0.009298,172.217.194.0-255,5738,176931,92,176997
26196,0.009302,172.31.47.0-255,66,176997,92,176997
26197,0.0,172.217.194.0-255,153,153,92,156655
26198,2.2e-05,172.31.47.0-255,66,219,92,156655
26199,2.8e-05,172.217.194.0-255,1484,1703,92,156655
26200,3.2e-05,172.31.47.0-255,66,1769,92,156655
26201,3.6e-05,172.217.194.0-255,2902,4671,92,156655
26202,3.7e-05,172.31.47.0-255,66,4737,92,156655
26203,4.3e-05,172.217.194.0-255,5738,10475,92,156655
26204,5.2e-05,172.31.47.0-255,66,10541,92,156655
26205,7.9e-05,172.217.194.0-255,1484,12025,92,156655
26206,8.1e-05,172.31.47.0-255,66,12091,92,156655
26207,8.7e-05,172.217.194.0-255,5009,17100,92,156655
26208,9.3e-05,172.31.47.0-255,66,17166,92,156655
26209,0.000103,172.31.47.0-255,66,17232,92,156655
26210,0.000131,172.217.194.0-255,5379,22611,92,156655
26211,0.000139,172.31.47.0-255,66,22677,92,156655
26212,0.001086,172.217.194.0-255,1484,24161,92,156655
26213,0.001092,172.31.47.0-255,66,24227,92,156655
26214,0.001101,172.217.194.0-255,2902,27129,92,156655
26215,0.001102,172.31.47.0-255,66,27195,92,156655
26216,0.001111,172.217.194.0-255,4320,31515,92,156655
26217,0.001113,172.31.47.0-255,66,31581,92,156655
26218,0.001136,172.217.194.0-255,1484,33065,92,156655
26219,0.001137,172.31.47.0-255,66,33131,92,156655
26220,0.00114,172.217.194.0-255,1484,34615,92,156655
26221,0.001142,172.31.47.0-255,66,34681,92,156655
26222,0.001173,172.217.194.0-255,6797,41478,92,156655
26223,0.001174,172.31.47.0-255,66,41544,92,156655
26224,0.001187,172.31.47.0-255,66,41610,92,156655
26225,0.001207,172.217.194.0-255,1378,42988,92,156655
26226,0.001209,172.31.47.0-255,66,43054,92,156655
26227,0.001294,172.217.194.0-255,119,43173,92,156655
26228,0.001374,172.217.194.0-255,1484,44657,92,156655
26229,0.001376,172.31.47.0-255,66,44723,92,156655
26230,0.001392,172.217.194.0-255,2902,47625,92,156655
26231,0.001393,172.31.47.0-255,66,47691,92,156655
26232,0.00142,172.217.194.0-255,2902,50593,92,156655
26233,0.001421,172.31.47.0-255,66,50659,92,156655
26234,0.001445,172.217.194.0-255,2902,53561,92,156655
26235,0.001447,172.31.47.0-255,66,53627,92,156655
26236,0.001462,172.31.47.0-255,66,53693,92,156655
26237,0.001471,172.31.47.0-255,66,53759,92,156655
26238,0.001473,172.217.194.0-255,380,54139,92,156655
26239,0.001878,172.217.194.0-255,1484,55623,92,156655
26240,0.00188,172.31.47.0-255,66,55689,92,156655
26241,0.001893,172.217.194.0-255,2902,58591,92,156655
26242,0.001898,172.31.47.0-255,66,58657,92,156655
26243,0.001901,172.217.194.0-255,1484,60141,92,156655
26244,0.001922,172.217.194.0-255,4320,64461,92,156655
26245,0.001924,172.31.47.0-255,66,64527,92,156655
26246,0.001947,172.217.194.0-255,2902,67429,92,156655
26247,0.001949,172.31.47.0-255,66,67495,92,156655
26248,0.00197,172.217.194.0-255,2902,70397,92,156655
26249,0.001972,172.31.47.0-255,66,70463,92,156655
26250,0.001978,172.217.194.0-255,7156,77619,92,156655
26251,0.00198,172.31.47.0-255,66,77685,92,156655
26252,0.002008,172.217.194.0-255,5738,83423,92,156655
26253,0.00201,172.31.47.0-255,66,83489,92,156655
26254,0.002033,172.217.194.0-255,5020,88509,92,156655
26255,0.002035,172.31.47.0-255,66,88575,92,156655
26256,0.002112,172.217.194.0-255,1484,90059,92,156655
26257,0.002115,172.217.194.0-255,1484,91543,92,156655
26258,0.002139,172.217.194.0-255,1484,93027,92,156655
26259,0.002144,172.217.194.0-255,5738,98765,92,156655
26260,0.002162,172.217.194.0-255,2902,101667,92,156655
26261,0.002181,172.217.194.0-255,7156,108823,92,156655
26262,0.002197,172.217.194.0-255,1484,110307,92,156655
26263,0.002232,172.217.194.0-255,2184,112491,92,156655
26264,0.002235,172.217.194.0-255,2902,115393,92,156655
26265,0.002243,172.217.194.0-255,1484,116877,92,156655
26266,0.002259,172.217.194.0-255,7156,124033,92,156655
26267,0.00228,172.217.194.0-255,7156,131189,92,156655
26268,0.002284,172.217.194.0-255,4320,135509,92,156655
26269,0.002297,172.217.194.0-255,5738,141247,92,156655
26270,0.002299,172.217.194.0-255,766,142013,92,156655
26271,0.002372,172.217.194.0-255,1484,143497,92,156655
26272,0.002397,172.217.194.0-255,1484,144981,92,156655
26273,0.003368,172.31.47.0-255,66,145047,92,156655
26274,0.005658,172.217.194.0-255,5738,150785,92,156655
26275,0.005662,172.31.47.0-255,66,150851,92,156655
26276,0.007953,172.217.194.0-255,5738,156589,92,156655
26277,0.007959,172.31.47.0-255,66,156655,92,156655
26278,0.0,172.31.47.0-255,105,105,92,105
26279,0.0,74.125.24.0-255,153,153,92,128862
26280,1.7e-05,172.31.47.0-255,66,219,92,128862
26281,2.3e-05,74.125.24.0-255,1484,1703,92,128862
26282,2.7e-05,172.31.47.0-255,66,1769,92,128862
26283,3.8e-05,74.125.24.0-255,2902,4671,92,128862
26284,4e-05,172.31.47.0-255,66,4737,92,128862
26285,7.4e-05,74.125.24.0-255,7156,11893,92,128862
26286,7.7e-05,172.31.47.0-255,66,11959,92,128862
26287,0.000165,74.125.24.0-255,2092,14051,92,128862
26288,0.000168,172.31.47.0-255,66,14117,92,128862
26289,0.000182,74.125.24.0-255,1484,15601,92,128862
26290,0.000187,172.31.47.0-255,66,15667,92,128862
26291,0.000211,74.125.24.0-255,1484,17151,92,128862
26292,0.000214,172.31.47.0-255,66,17217,92,128862
26293,0.000238,74.125.24.0-255,4320,21537,92,128862
26294,0.00024,172.31.47.0-255,66,21603,92,128862
26295,0.000265,74.125.24.0-255,2902,24505,92,128862
26296,0.000267,172.31.47.0-255,66,24571,92,128862
26297,0.000345,74.125.24.0-255,5738,30309,92,128862
26298,0.00036,172.31.47.0-255,66,30375,92,128862
26299,0.000388,172.31.47.0-255,66,30441,92,128862
26300,0.000576,74.125.24.0-255,5738,36179,92,128862
26301,0.000581,172.31.47.0-255,66,36245,92,128862
26302,0.00061,74.125.24.0-255,2543,38788,92,128862
26303,0.000612,172.31.47.0-255,66,38854,92,128862
26304,0.000707,172.31.47.0-255,66,38920,92,128862
26305,0.000735,74.125.24.0-255,7127,46047,92,128862
26306,0.000738,172.31.47.0-255,66,46113,92,128862
26307,0.000935,74.125.24.0-255,347,46460,92,128862
26308,0.000939,172.31.47.0-255,66,46526,92,128862
26309,0.000994,172.31.47.0-255,66,46592,92,128862
26310,0.001228,172.31.47.0-255,66,46658,92,128862
26311,0.001257,74.125.24.0-255,5379,52037,92,128862
26312,0.001494,74.125.24.0-255,5738,57775,92,128862
26313,0.001762,74.125.24.0-255,2184,59959,92,128862
26314,0.001979,74.125.24.0-255,4320,64279,92,128862
26315,0.002481,74.125.24.0-255,2902,67181,92,128862
26316,0.002516,74.125.24.0-255,1484,68665,92,128862
26317,0.002544,74.125.24.0-255,4320,72985,92,128862
26318,0.002554,74.125.24.0-255,1484,74469,92,128862
26319,0.002631,74.125.24.0-255,7156,81625,92,128862
26320,0.00265,74.125.24.0-255,5738,87363,92,128862
26321,0.00285,74.125.24.0-255,4320,91683,92,128862
26322,0.002863,74.125.24.0-255,6438,98121,92,128862
26323,0.002982,74.125.24.0-255,7156,105277,92,128862
26324,0.00349,74.125.24.0-255,4320,109597,92,128862
26325,0.003911,172.31.47.0-255,66,109663,92,128862
26326,0.004202,74.125.24.0-255,7156,116819,92,128862
26327,0.00421,172.31.47.0-255,66,116885,92,128862
26328,0.00424,172.31.47.0-255,66,116951,92,128862
26329,0.00451,74.125.24.0-255,7156,124107,92,128862
26330,0.004536,172.31.47.0-255,66,124173,92,128862
26331,0.004657,172.31.47.0-255,66,124239,92,128862
26332,0.005879,74.125.24.0-255,4320,128559,92,128862
26333,0.005885,172.31.47.0-255,66,128625,92,128862
26334,0.005974,172.31.47.0-255,66,128691,92,128862
26335,0.006497,172.31.47.0-255,105,128796,92,128862
26336,0.008414,74.125.24.0-255,66,128862,92,128862
26337,0.0,74.125.200.0-255,153,153,92,60064
26338,2.5e-05,172.31.47.0-255,66,219,92,60064
26339,3.1e-05,74.125.200.0-255,1484,1703,92,60064
26340,3.5e-05,172.31.47.0-255,66,1769,92,60064
26341,3.9e-05,74.125.200.0-255,2902,4671,92,60064
26342,4.3e-05,172.31.47.0-255,66,4737,92,60064
26343,6e-05,74.125.200.0-255,2902,7639,92,60064
26344,6.3e-05,172.31.47.0-255,66,7705,92,60064
26345,0.000106,74.125.200.0-255,2902,10607,92,60064
26346,0.000109,172.31.47.0-255,66,10673,92,60064
26347,0.000122,74.125.200.0-255,1484,12157,92,60064
26348,0.000125,172.31.47.0-255,66,12223,92,60064
26349,0.000208,172.31.47.0-255,66,12289,92,60064
26350,0.000217,74.125.200.0-255,635,12924,92,60064
26351,0.000219,172.31.47.0-255,66,12990,92,60064
26352,0.000326,74.125.200.0-255,4320,17310,92,60064
26353,0.000331,172.31.47.0-255,66,17376,92,60064
26354,0.000354,74.125.200.0-255,7156,24532,92,60064
26355,0.000358,172.31.47.0-255,66,24598,92,60064
26356,0.000373,74.125.200.0-255,4320,28918,92,60064
26357,0.000377,172.31.47.0-255,66,28984,92,60064
26358,0.000577,172.31.47.0-255,66,29050,92,60064
26359,0.000731,74.125.200.0-255,5738,34788,92,60064
26360,0.000737,172.31.47.0-255,66,34854,92,60064
26361,0.000768,172.31.47.0-255,66,34920,92,60064
26362,0.001003,74.125.200.0-255,2902,37822,92,60064
26363,0.001009,172.31.47.0-255,66,37888,92,60064
26364,0.001051,172.31.47.0-255,66,37954,92,60064
26365,0.001472,74.125.200.0-255,5738,43692,92,60064
26366,0.001533,74.125.200.0-255,2884,46576,92,60064
26367,0.002038,74.125.200.0-255,1484,48060,92,60064
26368,0.002294,172.31.47.0-255,66,48126,92,60064
26369,0.003027,74.125.200.0-255,4320,52446,92,60064
26370,0.003033,172.31.47.0-255,66,52512,92,60064
26371,0.00312,172.31.47.0-255,66,52578,92,60064
26372,0.003156,172.31.47.0-255,66,52644,92,60064
26373,0.003998,74.125.200.0-255,1484,54128,92,60064
26374,0.004034,172.31.47.0-255,66,54194,92,60064
26375,0.007385,172.31.47.0-255,66,54260,92,60064
26376,0.009647,74.125.200.0-255,5738,59998,92,60064
26377,0.009658,172.31.47.0-255,66,60064,92,60064
26378,0.0,172.217.194.0-255,153,153,92,282083
26379,3.1e-05,172.31.47.0-255,66,219,92,282083
26380,3.7e-05,172.217.194.0-255,1484,1703,92,282083
26381,4.1e-05,172.31.47.0-255,66,1769,92,282083
26382,4.6e-05,172.217.194.0-255,2902,4671,92,282083
26383,4.8e-05,172.31.47.0-255,66,4737,92,282083
26384,6.3e-05,172.217.194.0-255,7156,11893,92,282083
26385,6.5e-05,172.31.47.0-255,66,11959,92,282083
26386,7.4e-05,172.31.47.0-255,66,12025,92,282083
26387,0.000107,172.217.194.0-255,5000,17025,92,282083
26388,0.000109,172.31.47.0-255,66,17091,92,282083
26389,0.000115,172.217.194.0-255,5379,22470,92,282083
26390,0.000117,172.31.47.0-255,66,22536,92,282083
26391,0.000138,172.217.194.0-255,1484,24020,92,282083
26392,0.000141,172.31.47.0-255,66,24086,92,282083
26393,0.000167,172.217.194.0-255,4320,28406,92,282083
26394,0.00017,172.31.47.0-255,66,28472,92,282083
26395,0.000175,172.217.194.0-255,5738,34210,92,282083
26396,0.000177,172.31.47.0-255,66,34276,92,282083
26397,0.000211,172.217.194.0-255,2902,37178,92,282083
26398,0.000214,172.31.47.0-255,66,37244,92,282083
26399,0.000236,172.217.194.0-255,2543,39787,92,282083
26400,0.000241,172.31.47.0-255,66,39853,92,282083
26401,0.000251,172.217.194.0-255,1484,41337,92,282083
26402,0.000253,172.31.47.0-255,66,41403,92,282083
26403,0.000276,172.217.194.0-255,4320,45723,92,282083
26404,0.00028,172.31.47.0-255,66,45789,92,282083
26405,0.000286,172.217.194.0-255,5738,51527,92,282083
26406,0.000289,172.31.47.0-255,66,51593,92,282083
26407,0.00032,172.217.194.0-255,2902,54495,92,282083
26408,0.000323,172.31.47.0-255,66,54561,92,282083
26409,0.000348,172.217.194.0-255,2816,57377,92,282083
26410,0.00035,172.31.47.0-255,66,57443,92,282083
26411,0.000415,172.217.194.0-255,119,57562,92,282083
26412,0.000419,172.217.194.0-255,381,57943,92,282083
26413,0.000641,172.217.194.0-255,1484,59427,92,282083
26414,0.000645,172.31.47.0-255,66,59493,92,282083
26415,0.000648,172.217.194.0-255,1484,60977,92,282083
26416,0.000667,172.217.194.0-255,1484,62461,92,282083
26417,0.00067,172.31.47.0-255,66,62527,92,282083
26418,0.000675,172.217.194.0-255,2902,65429,92,282083
26419,0.000676,172.31.47.0-255,66,65495,92,282083
26420,0.000679,172.217.194.0-255,1484,66979,92,282083
26421,0.000707,172.217.194.0-255,2902,69881,92,282083
26422,0.000709,172.31.47.0-255,66,69947,92,282083
26423,0.000712,172.217.194.0-255,1484,71431,92,282083
26424,0.000741,172.217.194.0-255,7156,78587,92,282083
26425,0.000743,172.31.47.0-255,66,78653,92,282083
26426,0.000747,172.217.194.0-255,2902,81555,92,282083
26427,0.000749,172.31.47.0-255,66,81621,92,282083
26428,0.000809,172.31.47.0-255,66,81687,92,282083
26429,0.000812,172.217.194.0-255,1484,83171,92,282083
26430,0.000833,172.217.194.0-255,2902,86073,92,282083
26431,0.000836,172.31.47.0-255,66,86139,92,282083
26432,0.00084,172.217.194.0-255,2902,89041,92,282083
26433,0.000841,172.31.47.0-255,66,89107,92,282083
26434,0.000866,172.217.194.0-255,2902,92009,92,282083
26435,0.000869,172.31.47.0-255,66,92075,92,282083
26436,0.000871,172.217.194.0-255,5738,97813,92,282083
26437,0.000877,172.31.47.0-255,66,97879,92,282083
26438,0.000906,172.217.194.0-255,7156,105035,92,282083
26439,0.000909,172.31.47.0-255,66,105101,92,282083
26440,0.000919,172.31.47.0-255,66,105167,92,282083
26441,0.000944,172.217.194.0-255,766,105933,92,282083
26442,0.00109,172.217.194.0-255,1484,107417,92,282083
26443,0.001093,172.31.47.0-255,66,107483,92,282083
26444,0.001113,172.217.194.0-255,2902,110385,92,282083
26445,0.001115,172.31.47.0-255,66,110451,92,282083
26446,0.001134,172.217.194.0-255,5738,116189,92,282083
26447,0.001137,172.31.47.0-255,66,116255,92,282083
26448,0.001147,172.31.47.0-255,66,116321,92,282083
26449,0.001176,172.217.194.0-255,1484,117805,92,282083
26450,0.001193,172.31.47.0-255,66,117871,92,282083
26451,0.001197,172.217.194.0-255,2184,120055,92,282083
26452,0.001199,172.31.47.0-255,66,120121,92,282083
26453,0.001276,172.217.194.0-255,1484,121605,92,282083
26454,0.001278,172.217.194.0-255,1484,123089,92,282083
26455,0.001281,172.31.47.0-255,66,123155,92,282083
26456,0.001305,172.217.194.0-255,1484,124639,92,282083
26457,0.001311,172.217.194.0-255,5738,130377,92,282083
26458,0.001314,172.31.47.0-255,66,130443,92,282083
26459,0.001316,172.217.194.0-255,1484,131927,92,282083
26460,0.001344,172.31.47.0-255,66,131993,92,282083
26461,0.00137,172.217.194.0-255,1484,133477,92,282083
26462,0.00138,172.217.194.0-255,766,134243,92,282083
26463,0.001382,172.31.47.0-255,66,134309,92,282083
26464,0.001593,172.31.47.0-255,66,134375,92,282083
26465,0.001839,172.217.194.0-255,1484,135859,92,282083
26466,0.001848,172.217.194.0-255,2902,138761,92,282083
26467,0.001851,172.31.47.0-255,66,138827,92,282083
26468,0.001858,172.217.194.0-255,5738,144565,92,282083
26469,0.00186,172.31.47.0-255,66,144631,92,282083
26470,0.001886,172.217.194.0-255,7156,151787,92,282083
26471,0.001888,172.31.47.0-255,66,151853,92,282083
26472,0.001915,172.217.194.0-255,5738,157591,92,282083
26473,0.001917,172.31.47.0-255,66,157657,92,282083
26474,0.001922,172.217.194.0-255,5738,163395,92,282083
26475,0.001924,172.31.47.0-255,66,163461,92,282083
26476,0.001947,172.217.194.0-255,5020,168481,92,282083
26477,0.001949,172.31.47.0-255,66,168547,92,282083
26478,0.002256,172.217.194.0-255,1484,170031,92,282083
26479,0.002268,172.217.194.0-255,2902,172933,92,282083
26480,0.002271,172.31.47.0-255,66,172999,92,282083
26481,0.002295,172.217.194.0-255,4320,177319,92,282083
26482,0.002296,172.31.47.0-255,66,177385,92,282083
26483,0.00232,172.217.194.0-255,1484,178869,92,282083
26484,0.002329,172.217.194.0-255,5738,184607,92,282083
26485,0.002331,172.31.47.0-255,66,184673,92,282083
26486,0.002363,172.31.47.0-255,66,184739,92,282083
26487,0.002368,172.217.194.0-255,5020,189759,92,282083
26488,0.00237,172.31.47.0-255,66,189825,92,282083
26489,0.002405,172.217.194.0-255,1484,191309,92,282083
26490,0.002443,172.217.194.0-255,2902,194211,92,282083
26491,0.002445,172.31.47.0-255,66,194277,92,282083
26492,0.00245,172.217.194.0-255,5738,200015,92,282083
26493,0.002452,172.31.47.0-255,66,200081,92,282083
26494,0.002457,172.217.194.0-255,7156,207237,92,282083
26495,0.002463,172.217.194.0-255,1484,208721,92,282083
26496,0.002476,172.217.194.0-255,7156,215877,92,282083
26497,0.002499,172.217.194.0-255,5738,221615,92,282083
26498,0.002502,172.217.194.0-255,2184,223799,92,282083
26499,0.002577,172.217.194.0-255,1484,225283,92,282083
26500,0.002581,172.217.194.0-255,2902,228185,92,282083
26501,0.002592,172.217.194.0-255,1484,229669,92,282083
26502,0.002606,172.217.194.0-255,4320,233989,92,282083
26503,0.002628,172.217.194.0-255,5738,239727,92,282083
26504,0.002651,172.217.194.0-255,4320,244047,92,282083
26505,0.002665,172.217.194.0-255,2902,246949,92,282083
26506,0.002681,172.217.194.0-255,4320,251269,92,282083
26507,0.00272,172.217.194.0-255,6438,257707,92,282083
26508,0.002753,172.217.194.0-255,7156,264863,92,282083
26509,0.002802,172.217.194.0-255,2184,267047,92,282083
26510,0.002823,172.217.194.0-255,7156,274203,92,282083
26511,0.002841,172.217.194.0-255,2902,277105,92,282083
26512,0.002843,172.217.194.0-255,1484,278589,92,282083
26513,0.002884,172.217.194.0-255,1484,280073,92,282083
26514,0.002887,172.217.194.0-255,1484,281557,92,282083
26515,0.002889,172.217.194.0-255,184,281741,92,282083
26516,0.002935,172.217.194.0-255,105,281846,92,282083
26517,0.005803,172.31.47.0-255,66,281912,92,282083
26518,0.007308,172.31.47.0-255,105,282017,92,282083
26519,0.009357,172.217.194.0-255,66,282083,92,282083
26520,0.0,172.31.47.0-255,105,105,92,105
26521,0.0,74.125.24.0-255,298,298,92,122850
26522,2.3e-05,172.31.47.0-255,66,364,92,122850
26523,3e-05,74.125.24.0-255,1484,1848,92,122850
26524,3.5e-05,172.31.47.0-255,66,1914,92,122850
26525,5.1e-05,74.125.24.0-255,4320,6234,92,122850
26526,5.4e-05,172.31.47.0-255,66,6300,92,122850
26527,6.2e-05,74.125.24.0-255,7156,13456,92,122850
26528,6.5e-05,172.31.47.0-255,66,13522,92,122850
26529,8.7e-05,74.125.24.0-255,394,13916,92,122850
26530,9.3e-05,172.31.47.0-255,66,13982,92,122850
26531,0.000156,74.125.24.0-255,1484,15466,92,122850
26532,0.000159,172.31.47.0-255,66,15532,92,122850
26533,0.000164,74.125.24.0-255,2902,18434,92,122850
26534,0.000166,172.31.47.0-255,66,18500,92,122850
26535,0.000194,74.125.24.0-255,5738,24238,92,122850
26536,0.000197,172.31.47.0-255,66,24304,92,122850
26537,0.0002,74.125.24.0-255,1484,25788,92,122850
26538,0.000202,172.31.47.0-255,66,25854,92,122850
26539,0.000233,74.125.24.0-255,5379,31233,92,122850
26540,0.000238,172.31.47.0-255,66,31299,92,122850
26541,0.000376,74.125.24.0-255,1484,32783,92,122850
26542,0.00038,172.31.47.0-255,66,32849,92,122850
26543,0.000385,74.125.24.0-255,1484,34333,92,122850
26544,0.000387,172.31.47.0-255,66,34399,92,122850
26545,0.000407,74.125.24.0-255,1484,35883,92,122850
26546,0.000409,172.31.47.0-255,66,35949,92,122850
26547,0.00042,74.125.24.0-255,5738,41687,92,122850
26548,0.000423,172.31.47.0-255,66,41753,92,122850
26549,0.000428,74.125.24.0-255,2902,44655,92,122850
26550,0.000431,172.31.47.0-255,66,44721,92,122850
26551,0.000459,74.125.24.0-255,1484,46205,92,122850
26552,0.000462,172.31.47.0-255,66,46271,92,122850
26553,0.000466,74.125.24.0-255,2902,49173,92,122850
26554,0.000469,172.31.47.0-255,66,49239,92,122850
26555,0.00051,172.31.47.0-255,66,49305,92,122850
26556,0.000513,74.125.24.0-255,1484,50789,92,122850
26557,0.00054,74.125.24.0-255,5379,56168,92,122850
26558,0.000543,172.31.47.0-255,66,56234,92,122850
26559,0.000584,74.125.24.0-255,646,56880,92,122850
26560,0.001156,172.31.47.0-255,66,56946,92,122850
26561,0.001249,74.125.24.0-255,1484,58430,92,122850
26562,0.001257,74.125.24.0-255,2902,61332,92,122850
26563,0.00126,172.31.47.0-255,66,61398,92,122850
26564,0.001292,74.125.24.0-255,5738,67136,92,122850
26565,0.001294,172.31.47.0-255,66,67202,92,122850
26566,0.001298,74.125.24.0-255,1484,68686,92,122850
26567,0.001335,172.31.47.0-255,66,68752,92,122850
26568,0.00134,74.125.24.0-255,4320,73072,92,122850
26569,0.001342,172.31.47.0-255,66,73138,92,122850
26570,0.001379,74.125.24.0-255,6438,79576,92,122850
26571,0.001381,172.31.47.0-255,66,79642,92,122850
26572,0.001741,74.125.24.0-255,1484,81126,92,122850
26573,0.00175,74.125.24.0-255,2902,84028,92,122850
26574,0.001754,172.31.47.0-255,66,84094,92,122850
26575,0.001761,74.125.24.0-255,5738,89832,92,122850
26576,0.001764,172.31.47.0-255,66,89898,92,122850
26577,0.0018,172.31.47.0-255,66,89964,92,122850
26578,0.001831,74.125.24.0-255,1484,91448,92,122850
26579,0.001849,74.125.24.0-255,7156,98604,92,122850
26580,0.001852,172.31.47.0-255,66,98670,92,122850
26581,0.001882,74.125.24.0-255,6438,105108,92,122850
26582,0.001885,172.31.47.0-255,66,105174,92,122850
26583,0.004159,74.125.24.0-255,2902,108076,92,122850
26584,0.004167,172.31.47.0-255,66,108142,92,122850
26585,0.004195,74.125.24.0-255,2902,111044,92,122850
26586,0.004199,172.31.47.0-255,66,111110,92,122850
26587,0.006457,74.125.24.0-255,2902,114012,92,122850
26588,0.006465,172.31.47.0-255,66,114078,92,122850
26589,0.006496,74.125.24.0-255,2902,116980,92,122850
26590,0.006499,172.31.47.0-255,66,117046,92,122850
26591,0.008759,74.125.24.0-255,5738,122784,92,122850
26592,0.008764,172.31.47.0-255,66,122850,92,122850
26593,0.0,74.125.24.0-255,153,153,92,147839
26594,2.3e-05,172.31.47.0-255,66,219,92,147839
26595,2.9e-05,74.125.24.0-255,1484,1703,92,147839
26596,3.2e-05,172.31.47.0-255,66,1769,92,147839
26597,3.6e-05,74.125.24.0-255,2902,4671,92,147839
26598,3.9e-05,172.31.47.0-255,66,4737,92,147839
26599,5e-05,74.125.24.0-255,7156,11893,92,147839
26600,5.4e-05,172.31.47.0-255,66,11959,92,147839
26601,9.9e-05,172.31.47.0-255,66,12025,92,147839
26602,0.000129,74.125.24.0-255,6346,18371,92,147839
26603,0.000133,172.31.47.0-255,66,18437,92,147839
26604,0.000138,74.125.24.0-255,3961,22398,92,147839
26605,0.00014,172.31.47.0-255,66,22464,92,147839
26606,0.000433,74.125.24.0-255,1484,23948,92,147839
26607,0.000439,172.31.47.0-255,66,24014,92,147839
26608,0.000445,74.125.24.0-255,2902,26916,92,147839
26609,0.000448,172.31.47.0-255,66,26982,92,147839
26610,0.00047,74.125.24.0-255,4320,31302,92,147839
26611,0.000474,172.31.47.0-255,66,31368,92,147839
26612,0.000511,74.125.24.0-255,2902,34270,92,147839
26613,0.000519,172.31.47.0-255,66,34336,92,147839
26614,0.000527,74.125.24.0-255,5379,39715,92,147839
26615,0.000529,172.31.47.0-255,66,39781,92,147839
26616,0.000602,74.125.24.0-255,1484,41265,92,147839
26617,0.000605,172.31.47.0-255,66,41331,92,147839
26618,0.00061,74.125.24.0-255,2902,44233,92,147839
26619,0.000612,172.31.47.0-255,66,44299,92,147839
26620,0.00064,74.125.24.0-255,5738,50037,92,147839
26621,0.000644,172.31.47.0-255,66,50103,92,147839
26622,0.000674,74.125.24.0-255,6797,56900,92,147839
26623,0.000677,172.31.47.0-255,66,56966,92,147839
26624,0.0007,74.125.24.0-255,646,57612,92,147839
26625,0.000859,172.31.47.0-255,66,57678,92,147839
26626,0.000955,74.125.24.0-255,1484,59162,92,147839
26627,0.000964,74.125.24.0-255,2902,62064,92,147839
26628,0.000977,74.125.24.0-255,2902,64966,92,147839
26629,0.000989,74.125.24.0-255,2902,67868,92,147839
26630,0.00101,74.125.24.0-255,5738,73606,92,147839
26631,0.001024,74.125.24.0-255,2543,76149,92,147839
26632,0.001029,74.125.24.0-255,2902,79051,92,147839
26633,0.001048,74.125.24.0-255,5738,84789,92,147839
26634,0.001074,74.125.24.0-255,4320,89109,92,147839
26635,0.001086,74.125.24.0-255,2543,91652,92,147839
26636,0.001453,74.125.24.0-255,1484,93136,92,147839
26637,0.00146,74.125.24.0-255,2902,96038,92,147839
26638,0.001471,74.125.24.0-255,1484,97522,92,147839
26639,0.001486,74.125.24.0-255,4320,101842,92,147839
26640,0.001497,74.125.24.0-255,1484,103326,92,147839
26641,0.00153,74.125.24.0-255,1484,104810,92,147839
26642,0.001563,74.125.24.0-255,5738,110548,92,147839
26643,0.00158,74.125.24.0-255,4471,115019,92,147839
26644,0.00161,74.125.24.0-255,1484,116503,92,147839
26645,0.001629,74.125.24.0-255,1484,117987,92,147839
26646,0.001638,74.125.24.0-255,1484,119471,92,147839
26647,0.001641,74.125.24.0-255,2902,122373,92,147839
26648,0.001651,74.125.24.0-255,2902,125275,92,147839
26649,0.00168,74.125.24.0-255,1484,126759,92,147839
26650,0.001701,74.125.24.0-255,4320,131079,92,147839
26651,0.001713,74.125.24.0-255,2902,133981,92,147839
26652,0.001723,74.125.24.0-255,2184,136165,92,147839
26653,0.004249,172.31.47.0-255,66,136231,92,147839
26654,0.00628,74.125.24.0-255,5738,141969,92,147839
26655,0.006286,172.31.47.0-255,66,142035,92,147839
26656,0.008298,74.125.24.0-255,5738,147773,92,147839
26657,0.008305,172.31.47.0-255,66,147839,92,147839
26658,0.0,74.125.130.0-255,153,153,92,176827
26659,1.5e-05,172.31.47.0-255,66,219,92,176827
26660,3.6e-05,74.125.130.0-255,1484,1703,92,176827
26661,4e-05,172.31.47.0-255,66,1769,92,176827
26662,4.5e-05,74.125.130.0-255,2902,4671,92,176827
26663,4.7e-05,172.31.47.0-255,66,4737,92,176827
26664,7.6e-05,74.125.130.0-255,5738,10475,92,176827
26665,7.9e-05,172.31.47.0-255,66,10541,92,176827
26666,0.0001,74.125.130.0-255,3393,13934,92,176827
26667,0.000103,172.31.47.0-255,66,14000,92,176827
26668,0.000108,74.125.130.0-255,4320,18320,92,176827
26669,0.00011,172.31.47.0-255,66,18386,92,176827
26670,0.000138,172.31.47.0-255,66,18452,92,176827
26671,0.000157,74.125.130.0-255,1484,19936,92,176827
26672,0.000159,172.31.47.0-255,66,20002,92,176827
26673,0.000177,74.125.130.0-255,2543,22545,92,176827
26674,0.000179,172.31.47.0-255,66,22611,92,176827
26675,0.000343,74.125.130.0-255,1484,24095,92,176827
26676,0.000346,172.31.47.0-255,66,24161,92,176827
26677,0.000357,74.125.130.0-255,2902,27063,92,176827
26678,0.00036,172.31.47.0-255,66,27129,92,176827
26679,0.000383,74.125.130.0-255,4320,31449,92,176827
26680,0.000385,172.31.47.0-255,66,31515,92,176827
26681,0.000406,74.125.130.0-255,1484,32999,92,176827
26682,0.000408,172.31.47.0-255,66,33065,92,176827
26683,0.000416,74.125.130.0-255,6797,39862,92,176827
26684,0.000418,172.31.47.0-255,66,39928,92,176827
26685,0.000463,172.31.47.0-255,66,39994,92,176827
26686,0.000479,74.125.130.0-255,1484,41478,92,176827
26687,0.000481,172.31.47.0-255,66,41544,92,176827
26688,0.000503,74.125.130.0-255,6797,48341,92,176827
26689,0.000506,172.31.47.0-255,66,48407,92,176827
26690,0.000519,74.125.130.0-255,376,48783,92,176827
26691,0.000552,74.125.130.0-255,102,48885,92,176827
26692,0.000693,74.125.130.0-255,362,49247,92,176827
26693,0.000898,74.125.130.0-255,1484,50731,92,176827
26694,0.000901,172.31.47.0-255,66,50797,92,176827
26695,0.000906,74.125.130.0-255,2902,53699,92,176827
26696,0.000909,172.31.47.0-255,66,53765,92,176827
26697,0.000932,74.125.130.0-255,5738,59503,92,176827
26698,0.000934,172.31.47.0-255,66,59569,92,176827
26699,0.000974,172.31.47.0-255,66,59635,92,176827
26700,0.000976,74.125.130.0-255,1484,61119,92,176827
26701,0.001002,172.31.47.0-255,66,61185,92,176827
26702,0.001005,74.125.130.0-255,1484,62669,92,176827
26703,0.001023,74.125.130.0-255,3602,66271,92,176827
26704,0.001025,172.31.47.0-255,66,66337,92,176827
26705,0.001338,74.125.130.0-255,1484,67821,92,176827
26706,0.00135,74.125.130.0-255,1484,69305,92,176827
26707,0.001352,172.31.47.0-255,66,69371,92,176827
26708,0.001372,74.125.130.0-255,2902,72273,92,176827
26709,0.001375,172.31.47.0-255,66,72339,92,176827
26710,0.001397,74.125.130.0-255,1484,73823,92,176827
26711,0.001407,74.125.130.0-255,1484,75307,92,176827
26712,0.001409,172.31.47.0-255,66,75373,92,176827
26713,0.001425,74.125.130.0-255,1484,76857,92,176827
26714,0.001428,74.125.130.0-255,1484,78341,92,176827
26715,0.00143,172.31.47.0-255,66,78407,92,176827
26716,0.001443,74.125.130.0-255,2902,81309,92,176827
26717,0.001446,172.31.47.0-255,66,81375,92,176827
26718,0.001464,74.125.130.0-255,1484,82859,92,176827
26719,0.001471,74.125.130.0-255,7156,90015,92,176827
26720,0.001474,172.31.47.0-255,66,90081,92,176827
26721,0.001491,74.125.130.0-255,5738,95819,92,176827
26722,0.001494,172.31.47.0-255,66,95885,92,176827
26723,0.001504,74.125.130.0-255,2902,98787,92,176827
26724,0.001506,172.31.47.0-255,66,98853,92,176827
26725,0.001518,74.125.130.0-255,2184,101037,92,176827
26726,0.00152,172.31.47.0-255,66,101103,92,176827
26727,0.002108,74.125.130.0-255,1484,102587,92,176827
26728,0.002123,74.125.130.0-255,2902,105489,92,176827
26729,0.002127,172.31.47.0-255,66,105555,92,176827
26730,0.002131,74.125.130.0-255,1484,107039,92,176827
26731,0.002149,74.125.130.0-255,4320,111359,92,176827
26732,0.002152,172.31.47.0-255,66,111425,92,176827
26733,0.002172,74.125.130.0-255,1484,112909,92,176827
26734,0.002176,74.125.130.0-255,2902,115811,92,176827
26735,0.002179,172.31.47.0-255,66,115877,92,176827
26736,0.0022,74.125.130.0-255,1484,117361,92,176827
26737,0.002218,74.125.130.0-255,4320,121681,92,176827
26738,0.002221,172.31.47.0-255,66,121747,92,176827
26739,0.002256,74.125.130.0-255,7156,128903,92,176827
26740,0.002259,172.31.47.0-255,66,128969,92,176827
26741,0.002263,74.125.130.0-255,1484,130453,92,176827
26742,0.002286,74.125.130.0-255,1484,131937,92,176827
26743,0.002288,172.31.47.0-255,66,132003,92,176827
26744,0.002306,74.125.130.0-255,1484,133487,92,176827
26745,0.00231,74.125.130.0-255,2184,135671,92,176827
26746,0.002312,172.31.47.0-255,66,135737,92,176827
26747,0.002362,74.125.130.0-255,2902,138639,92,176827
26748,0.002365,172.31.47.0-255,66,138705,92,176827
26749,0.002368,74.125.130.0-255,1484,140189,92,176827
26750,0.002389,74.125.130.0-255,2902,143091,92,176827
26751,0.002392,172.31.47.0-255,66,143157,92,176827
26752,0.002415,74.125.130.0-255,1484,144641,92,176827
26753,0.002428,74.125.130.0-255,1484,146125,92,176827
26754,0.00243,172.31.47.0-255,66,146191,92,176827
26755,0.002436,74.125.130.0-255,4320,150511,92,176827
26756,0.002438,172.31.47.0-255,66,150577,92,176827
26757,0.002472,74.125.130.0-255,5738,156315,92,176827
26758,0.002478,172.31.47.0-255,66,156381,92,176827
26759,0.002504,74.125.130.0-255,7156,163537,92,176827
26760,0.002507,172.31.47.0-255,66,163603,92,176827
26761,0.002512,74.125.130.0-255,2902,166505,92,176827
26762,0.002513,172.31.47.0-255,66,166571,92,176827
26763,0.005008,74.125.130.0-255,4320,170891,92,176827
26764,0.005014,172.31.47.0-255,66,170957,92,176827
26765,0.00503,74.125.130.0-255,1484,172441,92,176827
26766,0.007511,74.125.130.0-255,4320,176761,92,176827
26767,0.007513,172.31.47.0-255,66,176827,92,176827
26768,0.0,172.31.47.0-255,105,105,92,105
26769,0.0,172.31.47.0-255,105,105,92,276
26770,0.001792,157.240.13.0-255,105,210,92,276
26771,0.001804,172.31.47.0-255,66,276,92,276
26772,0.0,172.31.47.0-255,105,105,92,105
26773,0.0,172.217.194.0-255,153,153,92,134309
26774,2.4e-05,172.31.47.0-255,66,219,92,134309
26775,2.9e-05,172.217.194.0-255,1484,1703,92,134309
26776,3.4e-05,172.31.47.0-255,66,1769,92,134309
26777,3.8e-05,172.217.194.0-255,2902,4671,92,134309
26778,4.1e-05,172.31.47.0-255,66,4737,92,134309
26779,4.9e-05,172.217.194.0-255,1484,6221,92,134309
26780,5.2e-05,172.31.47.0-255,66,6287,92,134309
26781,8.8e-05,172.217.194.0-255,5738,12025,92,134309
26782,9.1e-05,172.31.47.0-255,66,12091,92,134309
26783,0.000111,172.217.194.0-255,4880,16971,92,134309
26784,0.000114,172.31.47.0-255,66,17037,92,134309
26785,0.00012,172.217.194.0-255,5738,22775,92,134309
26786,0.000122,172.31.47.0-255,66,22841,92,134309
26787,0.000155,172.217.194.0-255,4320,27161,92,134309
26788,0.000157,172.31.47.0-255,66,27227,92,134309
26789,0.00018,172.217.194.0-255,3961,31188,92,134309
26790,0.000183,172.31.47.0-255,66,31254,92,134309
26791,0.000253,172.217.194.0-255,1484,32738,92,134309
26792,0.000257,172.31.47.0-255,66,32804,92,134309
26793,0.000275,172.217.194.0-255,2902,35706,92,134309
26794,0.000279,172.31.47.0-255,66,35772,92,134309
26795,0.000286,172.217.194.0-255,5738,41510,92,134309
26796,0.000288,172.31.47.0-255,66,41576,92,134309
26797,0.000329,172.31.47.0-255,66,41642,92,134309
26798,0.000387,172.31.47.0-255,66,41708,92,134309
26799,0.000404,172.217.194.0-255,677,42385,92,134309
26800,0.000407,172.31.47.0-255,66,42451,92,134309
26801,0.000516,172.217.194.0-255,1484,43935,92,134309
26802,0.00052,172.31.47.0-255,66,44001,92,134309
26803,0.000524,172.217.194.0-255,1484,45485,92,134309
26804,0.000549,172.217.194.0-255,1484,46969,92,134309
26805,0.000552,172.31.47.0-255,66,47035,92,134309
26806,0.000559,172.217.194.0-255,5738,52773,92,134309
26807,0.000562,172.31.47.0-255,66,52839,92,134309
26808,0.000597,172.217.194.0-255,4320,57159,92,134309
26809,0.0006,172.31.47.0-255,66,57225,92,134309
26810,0.000635,172.217.194.0-255,1484,58709,92,134309
26811,0.000636,172.31.47.0-255,66,58775,92,134309
26812,0.000673,172.31.47.0-255,66,58841,92,134309
26813,0.000696,172.217.194.0-255,1484,60325,92,134309
26814,0.000699,172.217.194.0-255,1484,61809,92,134309
26815,0.000702,172.31.47.0-255,66,61875,92,134309
26816,0.000727,172.217.194.0-255,1484,63359,92,134309
26817,0.000732,172.217.194.0-255,4320,67679,92,134309
26818,0.000735,172.31.47.0-255,66,67745,92,134309
26819,0.000747,172.31.47.0-255,66,67811,92,134309
26820,0.000774,172.217.194.0-255,1484,69295,92,134309
26821,0.000803,172.31.47.0-255,66,69361,92,134309
26822,0.00178,172.217.194.0-255,1484,70845,92,134309
26823,0.001791,172.217.194.0-255,2902,73747,92,134309
26824,0.001796,172.31.47.0-255,66,73813,92,134309
26825,0.001803,172.217.194.0-255,5738,79551,92,134309
26826,0.001805,172.31.47.0-255,66,79617,92,134309
26827,0.001847,172.31.47.0-255,66,79683,92,134309
26828,0.001854,172.217.194.0-255,5738,85421,92,134309
26829,0.001856,172.31.47.0-255,66,85487,92,134309
26830,0.001896,172.217.194.0-255,5020,90507,92,134309
26831,0.001899,172.31.47.0-255,66,90573,92,134309
26832,0.001979,172.217.194.0-255,1484,92057,92,134309
26833,0.002007,172.217.194.0-255,2902,94959,92,134309
26834,0.002012,172.31.47.0-255,66,95025,92,134309
26835,0.002019,172.217.194.0-255,5738,100763,92,134309
26836,0.002021,172.31.47.0-255,66,100829,92,134309
26837,0.002057,172.31.47.0-255,66,100895,92,134309
26838,0.002067,172.31.47.0-255,66,100961,92,134309
26839,0.002094,172.217.194.0-255,7156,108117,92,134309
26840,0.002097,172.31.47.0-255,66,108183,92,134309
26841,0.00214,172.31.47.0-255,66,108249,92,134309
26842,0.00215,172.31.47.0-255,66,108315,92,134309
26843,0.002157,172.217.194.0-255,1484,109799,92,134309
26844,0.002203,172.31.47.0-255,66,109865,92,134309
26845,0.002206,172.217.194.0-255,1484,111349,92,134309
26846,0.002273,172.31.47.0-255,66,111415,92,134309
26847,0.002306,172.217.194.0-255,5020,116435,92,134309
26848,0.002309,172.31.47.0-255,66,116501,92,134309
26849,0.002327,172.31.47.0-255,66,116567,92,134309
26850,0.002338,172.31.47.0-255,66,116633,92,134309
26851,0.002355,172.31.47.0-255,66,116699,92,134309
26852,0.002394,172.31.47.0-255,66,116765,92,134309
26853,0.002408,172.31.47.0-255,66,116831,92,134309
26854,0.002428,172.31.47.0-255,66,116897,92,134309
26855,0.004748,172.217.194.0-255,5738,122635,92,134309
26856,0.004752,172.31.47.0-255,66,122701,92,134309
26857,0.00713,172.217.194.0-255,5738,128439,92,134309
26858,0.007136,172.31.47.0-255,66,128505,92,134309
26859,0.009485,172.217.194.0-255,5738,134243,92,134309
26860,0.009492,172.31.47.0-255,66,134309,92,134309
26861,0.0,74.125.130.0-255,153,153,92,269100
26862,2.3e-05,172.31.47.0-255,66,219,92,269100
26863,2.8e-05,74.125.130.0-255,1484,1703,92,269100
26864,3.2e-05,172.31.47.0-255,66,1769,92,269100
26865,3.5e-05,74.125.130.0-255,1484,3253,92,269100
26866,3.7e-05,172.31.47.0-255,66,3319,92,269100
26867,5.8e-05,74.125.130.0-255,1484,4803,92,269100
26868,6e-05,172.31.47.0-255,66,4869,92,269100
26869,6.2e-05,74.125.130.0-255,1484,6353,92,269100
26870,6.4e-05,172.31.47.0-255,66,6419,92,269100
26871,8.1e-05,74.125.130.0-255,2902,9321,92,269100
26872,8.3e-05,172.31.47.0-255,66,9387,92,269100
26873,0.000123,74.125.130.0-255,1484,10871,92,269100
26874,0.000126,172.31.47.0-255,66,10937,92,269100
26875,0.000147,74.125.130.0-255,3392,14329,92,269100
26876,0.00015,172.31.47.0-255,66,14395,92,269100
26877,0.000155,74.125.130.0-255,5738,20133,92,269100
26878,0.000157,172.31.47.0-255,66,20199,92,269100
26879,0.000159,74.125.130.0-255,1484,21683,92,269100
26880,0.00016,172.31.47.0-255,66,21749,92,269100
26881,0.000175,74.125.130.0-255,1484,23233,92,269100
26882,0.000177,172.31.47.0-255,66,23299,92,269100
26883,0.000182,74.125.130.0-255,4320,27619,92,269100
26884,0.000184,172.31.47.0-255,66,27685,92,269100
26885,0.000213,74.125.130.0-255,1484,29169,92,269100
26886,0.000215,172.31.47.0-255,66,29235,92,269100
26887,0.000234,74.125.130.0-255,2543,31778,92,269100
26888,0.000237,172.31.47.0-255,66,31844,92,269100
26889,0.000378,74.125.130.0-255,1484,33328,92,269100
26890,0.000382,172.31.47.0-255,66,33394,92,269100
26891,0.000386,74.125.130.0-255,2902,36296,92,269100
26892,0.000387,172.31.47.0-255,66,36362,92,269100
26893,0.000418,74.125.130.0-255,5738,42100,92,269100
26894,0.000421,172.31.47.0-255,66,42166,92,269100
26895,0.000426,74.125.130.0-255,4320,46486,92,269100
26896,0.000428,172.31.47.0-255,66,46552,92,269100
26897,0.000433,74.125.130.0-255,5738,52290,92,269100
26898,0.000435,172.31.47.0-255,66,52356,92,269100
26899,0.000461,74.125.130.0-255,4320,56676,92,269100
26900,0.000464,172.31.47.0-255,66,56742,92,269100
26901,0.000487,74.125.130.0-255,7156,63898,92,269100
26902,0.00049,172.31.47.0-255,66,63964,92,269100
26903,0.000494,74.125.130.0-255,2184,66148,92,269100
26904,0.000496,172.31.47.0-255,66,66214,92,269100
26905,0.000507,74.125.130.0-255,380,66594,92,269100
26906,0.000533,74.125.130.0-255,100,66694,92,269100
26907,0.000666,74.125.130.0-255,1484,68178,92,269100
26908,0.00067,172.31.47.0-255,66,68244,92,269100
26909,0.000685,74.125.130.0-255,2902,71146,92,269100
26910,0.000687,172.31.47.0-255,66,71212,92,269100
26911,0.000708,74.125.130.0-255,5738,76950,92,269100
26912,0.000712,172.31.47.0-255,66,77016,92,269100
26913,0.000731,74.125.130.0-255,4320,81336,92,269100
26914,0.000735,172.31.47.0-255,66,81402,92,269100
26915,0.000771,74.125.130.0-255,5738,87140,92,269100
26916,0.000774,172.31.47.0-255,66,87206,92,269100
26917,0.000779,74.125.130.0-255,4320,91526,92,269100
26918,0.000781,172.31.47.0-255,66,91592,92,269100
26919,0.000795,74.125.130.0-255,5738,97330,92,269100
26920,0.000798,172.31.47.0-255,66,97396,92,269100
26921,0.000819,74.125.130.0-255,3602,100998,92,269100
26922,0.000821,172.31.47.0-255,66,101064,92,269100
26923,0.000913,74.125.130.0-255,1484,102548,92,269100
26924,0.000929,74.125.130.0-255,2902,105450,92,269100
26925,0.000932,172.31.47.0-255,66,105516,92,269100
26926,0.000946,74.125.130.0-255,1484,107000,92,269100
26927,0.000961,74.125.130.0-255,4320,111320,92,269100
26928,0.000964,172.31.47.0-255,66,111386,92,269100
26929,0.000967,74.125.130.0-255,1484,112870,92,269100
26930,0.000993,172.31.47.0-255,66,112936,92,269100
26931,0.001033,74.125.130.0-255,5738,118674,92,269100
26932,0.001036,172.31.47.0-255,66,118740,92,269100
26933,0.001051,74.125.130.0-255,5020,123760,92,269100
26934,0.001053,172.31.47.0-255,66,123826,92,269100
26935,0.001166,74.125.130.0-255,1484,125310,92,269100
26936,0.001179,74.125.130.0-255,2902,128212,92,269100
26937,0.001182,172.31.47.0-255,66,128278,92,269100
26938,0.001205,74.125.130.0-255,1484,129762,92,269100
26939,0.001222,74.125.130.0-255,2902,132664,92,269100
26940,0.001226,172.31.47.0-255,66,132730,92,269100
26941,0.001242,74.125.130.0-255,5738,138468,92,269100
26942,0.001244,172.31.47.0-255,66,138534,92,269100
26943,0.001259,74.125.130.0-255,1484,140018,92,269100
26944,0.001278,74.125.130.0-255,5738,145756,92,269100
26945,0.001281,172.31.47.0-255,66,145822,92,269100
26946,0.001286,74.125.130.0-255,4320,150142,92,269100
26947,0.001287,172.31.47.0-255,66,150208,92,269100
26948,0.0013,74.125.130.0-255,1484,151692,92,269100
26949,0.001314,74.125.130.0-255,4320,156012,92,269100
26950,0.001316,172.31.47.0-255,66,156078,92,269100
26951,0.001334,74.125.130.0-255,2184,158262,92,269100
26952,0.001337,172.31.47.0-255,66,158328,92,269100
26953,0.001377,74.125.130.0-255,2902,161230,92,269100
26954,0.00138,172.31.47.0-255,66,161296,92,269100
26955,0.001405,74.125.130.0-255,4320,165616,92,269100
26956,0.001408,172.31.47.0-255,66,165682,92,269100
26957,0.001433,74.125.130.0-255,2902,168584,92,269100
26958,0.001435,172.31.47.0-255,66,168650,92,269100
26959,0.00145,74.125.130.0-255,4320,172970,92,269100
26960,0.001452,172.31.47.0-255,66,173036,92,269100
26961,0.001473,74.125.130.0-255,5738,178774,92,269100
26962,0.001476,172.31.47.0-255,66,178840,92,269100
26963,0.001497,74.125.130.0-255,2902,181742,92,269100
26964,0.001499,172.31.47.0-255,66,181808,92,269100
26965,0.001502,74.125.130.0-255,2902,184710,92,269100
26966,0.001504,172.31.47.0-255,66,184776,92,269100
26967,0.001517,74.125.130.0-255,4320,189096,92,269100
26968,0.001519,172.31.47.0-255,66,189162,92,269100
26969,0.001535,74.125.130.0-255,2902,192064,92,269100
26970,0.001538,172.31.47.0-255,66,192130,92,269100
26971,0.001555,74.125.130.0-255,480,192610,92,269100
26972,0.001739,74.125.130.0-255,1484,194094,92,269100
26973,0.001745,172.31.47.0-255,66,194160,92,269100
26974,0.00175,74.125.130.0-255,2902,197062,92,269100
26975,0.001752,172.31.47.0-255,66,197128,92,269100
26976,0.001763,74.125.130.0-255,1484,198612,92,269100
26977,0.001781,74.125.130.0-255,4320,202932,92,269100
26978,0.001783,172.31.47.0-255,66,202998,92,269100
26979,0.001788,74.125.130.0-255,5738,208736,92,269100
26980,0.00179,172.31.47.0-255,66,208802,92,269100
26981,0.001803,74.125.130.0-255,4320,213122,92,269100
26982,0.001805,172.31.47.0-255,66,213188,92,269100
26983,0.00182,74.125.130.0-255,2902,216090,92,269100
26984,0.001821,172.31.47.0-255,66,216156,92,269100
26985,0.001837,74.125.130.0-255,2902,219058,92,269100
26986,0.001839,172.31.47.0-255,66,219124,92,269100
26987,0.001858,74.125.130.0-255,7156,226280,92,269100
26988,0.00186,172.31.47.0-255,66,226346,92,269100
26989,0.001877,74.125.130.0-255,766,227112,92,269100
26990,0.002126,74.125.130.0-255,1484,228596,92,269100
26991,0.002128,172.31.47.0-255,66,228662,92,269100
26992,0.002132,74.125.130.0-255,2902,231564,92,269100
26993,0.002134,172.31.47.0-255,66,231630,92,269100
26994,0.002136,74.125.130.0-255,1484,233114,92,269100
26995,0.00215,74.125.130.0-255,2902,236016,92,269100
26996,0.002152,172.31.47.0-255,66,236082,92,269100
26997,0.00218,74.125.130.0-255,5738,241820,92,269100
26998,0.002182,172.31.47.0-255,66,241886,92,269100
26999,0.002192,74.125.130.0-255,2902,244788,92,269100
27000,0.002193,172.31.47.0-255,66,244854,92,269100
27001,0.002213,74.125.130.0-255,4320,249174,92,269100
27002,0.002214,172.31.47.0-255,66,249240,92,269100
27003,0.002223,172.31.47.0-255,66,249306,92,269100
27004,0.002268,74.125.130.0-255,3602,252908,92,269100
27005,0.00227,172.31.47.0-255,66,252974,92,269100
27006,0.004514,74.125.130.0-255,1484,254458,92,269100
27007,0.004572,74.125.130.0-255,2902,257360,92,269100
27008,0.004575,172.31.47.0-255,66,257426,92,269100
27009,0.004586,74.125.130.0-255,1484,258910,92,269100
27010,0.006883,74.125.130.0-255,4320,263230,92,269100
27011,0.006889,172.31.47.0-255,66,263296,92,269100
27012,0.009182,74.125.130.0-255,5738,269034,92,269100
27013,0.009187,172.31.47.0-255,66,269100,92,269100
27014,0.0,216.58.221.0-255,153,153,92,228486
27015,1.1e-05,172.31.47.0-255,66,219,92,228486
27016,3.5e-05,216.58.221.0-255,1484,1703,92,228486
27017,3.8e-05,172.31.47.0-255,66,1769,92,228486
27018,4.3e-05,216.58.221.0-255,2902,4671,92,228486
27019,4.6e-05,172.31.47.0-255,66,4737,92,228486
27020,5.2e-05,216.58.221.0-255,5738,10475,92,228486
27021,5.5e-05,172.31.47.0-255,66,10541,92,228486
27022,8.1e-05,216.58.221.0-255,3585,14126,92,228486
27023,8.3e-05,172.31.47.0-255,66,14192,92,228486
27024,9.7e-05,216.58.221.0-255,4320,18512,92,228486
27025,0.0001,172.31.47.0-255,66,18578,92,228486
27026,0.000107,216.58.221.0-255,5738,24316,92,228486
27027,0.00011,172.31.47.0-255,66,24382,92,228486
27028,0.000137,216.58.221.0-255,4320,28702,92,228486
27029,0.00014,172.31.47.0-255,66,28768,92,228486
27030,0.00017,216.58.221.0-255,6797,35565,92,228486
27031,0.000174,172.31.47.0-255,66,35631,92,228486
27032,0.000185,172.31.47.0-255,66,35697,92,228486
27033,0.000187,216.58.221.0-255,1125,36822,92,228486
27034,0.000189,172.31.47.0-255,66,36888,92,228486
27035,0.000192,216.58.221.0-255,1484,38372,92,228486
27036,0.000194,172.31.47.0-255,66,38438,92,228486
27037,0.000215,216.58.221.0-255,4320,42758,92,228486
27038,0.000217,172.31.47.0-255,66,42824,92,228486
27039,0.000221,216.58.221.0-255,1484,44308,92,228486
27040,0.000223,172.31.47.0-255,66,44374,92,228486
27041,0.000246,172.31.47.0-255,66,44440,92,228486
27042,0.000281,216.58.221.0-255,1125,45565,92,228486
27043,0.000284,172.31.47.0-255,66,45631,92,228486
27044,0.000301,216.58.221.0-255,354,45985,92,228486
27045,0.001039,216.58.221.0-255,389,46374,92,228486
27046,0.001072,216.58.221.0-255,1484,47858,92,228486
27047,0.001078,216.58.221.0-255,4320,52178,92,228486
27048,0.001091,216.58.221.0-255,1484,53662,92,228486
27049,0.001108,216.58.221.0-255,4320,57982,92,228486
27050,0.001115,216.58.221.0-255,7156,65138,92,228486
27051,0.0012,216.58.221.0-255,2184,67322,92,228486
27052,0.001226,216.58.221.0-255,2902,70224,92,228486
27053,0.001251,216.58.221.0-255,7156,77380,92,228486
27054,0.001255,216.58.221.0-255,2902,80282,92,228486
27055,0.001278,216.58.221.0-255,4320,84602,92,228486
27056,0.001309,216.58.221.0-255,4320,88922,92,228486
27057,0.001325,216.58.221.0-255,3602,92524,92,228486
27058,0.001362,216.58.221.0-255,1484,94008,92,228486
27059,0.00138,216.58.221.0-255,2902,96910,92,228486
27060,0.001391,216.58.221.0-255,1484,98394,92,228486
27061,0.001405,216.58.221.0-255,4320,102714,92,228486
27062,0.001427,216.58.221.0-255,1484,104198,92,228486
27063,0.001445,216.58.221.0-255,7156,111354,92,228486
27064,0.001448,216.58.221.0-255,1484,112838,92,228486
27065,0.001465,216.58.221.0-255,5738,118576,92,228486
27066,0.001485,216.58.221.0-255,2902,121478,92,228486
27067,0.001491,216.58.221.0-255,5020,126498,92,228486
27068,0.001517,216.58.221.0-255,1484,127982,92,228486
27069,0.001521,216.58.221.0-255,2902,130884,92,228486
27070,0.001526,216.58.221.0-255,2902,133786,92,228486
27071,0.001539,216.58.221.0-255,2902,136688,92,228486
27072,0.001554,216.58.221.0-255,5738,142426,92,228486
27073,0.001568,216.58.221.0-255,7156,149582,92,228486
27074,0.001573,216.58.221.0-255,4320,153902,92,228486
27075,0.001589,216.58.221.0-255,2902,156804,92,228486
27076,0.001612,216.58.221.0-255,3602,160406,92,228486
27077,0.00166,216.58.221.0-255,1484,161890,92,228486
27078,0.001674,216.58.221.0-255,2902,164792,92,228486
27079,0.001693,216.58.221.0-255,5738,170530,92,228486
27080,0.001725,216.58.221.0-255,4320,174850,92,228486
27081,0.001774,216.58.221.0-255,4320,179170,92,228486
27082,0.001785,172.31.47.0-255,66,179236,92,228486
27083,0.001805,216.58.221.0-255,6438,185674,92,228486
27084,0.001835,216.58.221.0-255,1484,187158,92,228486
27085,0.001851,216.58.221.0-255,2902,190060,92,228486
27086,0.00187,216.58.221.0-255,4320,194380,92,228486
27087,0.001882,216.58.221.0-255,1484,195864,92,228486
27088,0.001903,216.58.221.0-255,4320,200184,92,228486
27089,0.001965,216.58.221.0-255,4320,204504,92,228486
27090,0.001981,216.58.221.0-255,6438,210942,92,228486
27091,0.001996,172.31.47.0-255,66,211008,92,228486
27092,0.003891,216.58.221.0-255,5738,216746,92,228486
27093,0.003896,172.31.47.0-255,66,216812,92,228486
27094,0.005797,216.58.221.0-255,5738,222550,92,228486
27095,0.006636,172.31.47.0-255,66,222616,92,228486
27096,0.008525,216.58.221.0-255,4320,226936,92,228486
27097,0.00853,172.31.47.0-255,66,227002,92,228486
27098,0.008553,216.58.221.0-255,1484,228486,92,228486
27099,0.0,172.31.47.0-255,105,105,92,105
27100,0.0,172.31.47.0-255,105,105,92,105
27101,0.0,172.31.47.0-255,105,105,92,210
27102,0.001479,157.240.13.0-255,105,210,92,210
27103,0.0,172.217.194.0-255,153,153,92,165697
27104,3.2e-05,172.31.47.0-255,66,219,92,165697
27105,4.1e-05,172.217.194.0-255,1484,1703,92,165697
27106,4.6e-05,172.31.47.0-255,66,1769,92,165697
27107,6.3e-05,172.217.194.0-255,2902,4671,92,165697
27108,6.7e-05,172.31.47.0-255,66,4737,92,165697
27109,7.6e-05,172.217.194.0-255,7156,11893,92,165697
27110,7.9e-05,172.31.47.0-255,66,11959,92,165697
27111,9.6e-05,172.31.47.0-255,66,12025,92,165697
27112,0.0001,172.217.194.0-255,2543,14568,92,165697
27113,0.000104,172.31.47.0-255,66,14634,92,165697
27114,0.000187,172.217.194.0-255,1484,16118,92,165697
27115,0.00019,172.31.47.0-255,66,16184,92,165697
27116,0.000221,172.217.194.0-255,2902,19086,92,165697
27117,0.000224,172.31.47.0-255,66,19152,92,165697
27118,0.000231,172.217.194.0-255,5738,24890,92,165697
27119,0.000233,172.31.47.0-255,66,24956,92,165697
27120,0.000238,172.217.194.0-255,4320,29276,92,165697
27121,0.000241,172.31.47.0-255,66,29342,92,165697
27122,0.000274,172.31.47.0-255,66,29408,92,165697
27123,0.000277,172.217.194.0-255,1484,30892,92,165697
27124,0.000279,172.31.47.0-255,66,30958,92,165697
27125,0.000307,172.31.47.0-255,66,31024,92,165697
27126,0.000422,172.217.194.0-255,1484,32508,92,165697
27127,0.000427,172.31.47.0-255,66,32574,92,165697
27128,0.000433,172.217.194.0-255,2902,35476,92,165697
27129,0.000435,172.31.47.0-255,66,35542,92,165697
27130,0.000467,172.217.194.0-255,5738,41280,92,165697
27131,0.00047,172.31.47.0-255,66,41346,92,165697
27132,0.000486,172.217.194.0-255,1484,42830,92,165697
27133,0.000538,172.217.194.0-255,4320,47150,92,165697
27134,0.000542,172.217.194.0-255,2543,49693,92,165697
27135,0.000723,172.31.47.0-255,66,49759,92,165697
27136,0.000868,172.217.194.0-255,1484,51243,92,165697
27137,0.000875,172.217.194.0-255,2902,54145,92,165697
27138,0.000877,172.217.194.0-255,1484,55629,92,165697
27139,0.000884,172.31.47.0-255,66,55695,92,165697
27140,0.000895,172.217.194.0-255,4320,60015,92,165697
27141,0.000903,172.217.194.0-255,4320,64335,92,165697
27142,0.000918,172.217.194.0-255,4320,68655,92,165697
27143,0.000921,172.31.47.0-255,66,68721,92,165697
27144,0.000939,172.217.194.0-255,7156,75877,92,165697
27145,0.000979,172.31.47.0-255,66,75943,92,165697
27146,0.001425,172.217.194.0-255,1484,77427,92,165697
27147,0.001432,172.217.194.0-255,2902,80329,92,165697
27148,0.001435,172.31.47.0-255,66,80395,92,165697
27149,0.001478,172.217.194.0-255,2902,83297,92,165697
27150,0.001494,172.217.194.0-255,2902,86199,92,165697
27151,0.001501,172.217.194.0-255,7156,93355,92,165697
27152,0.001517,172.217.194.0-255,2184,95539,92,165697
27153,0.001535,172.31.47.0-255,66,95605,92,165697
27154,0.001566,172.217.194.0-255,1484,97089,92,165697
27155,0.001571,172.217.194.0-255,2902,99991,92,165697
27156,0.001582,172.31.47.0-255,66,100057,92,165697
27157,0.001598,172.217.194.0-255,5738,105795,92,165697
27158,0.001637,172.217.194.0-255,4320,110115,92,165697
27159,0.001641,172.31.47.0-255,66,110181,92,165697
27160,0.001648,172.31.47.0-255,66,110247,92,165697
27161,0.00167,172.217.194.0-255,7156,117403,92,165697
27162,0.00169,172.217.194.0-255,3602,121005,92,165697
27163,0.001699,172.31.47.0-255,66,121071,92,165697
27164,0.00204,172.217.194.0-255,1484,122555,92,165697
27165,0.002047,172.217.194.0-255,2902,125457,92,165697
27166,0.00205,172.31.47.0-255,66,125523,92,165697
27167,0.002056,172.217.194.0-255,4320,129843,92,165697
27168,0.002076,172.217.194.0-255,1484,131327,92,165697
27169,0.002083,172.217.194.0-255,5738,137065,92,165697
27170,0.002096,172.217.194.0-255,1484,138549,92,165697
27171,0.002106,172.31.47.0-255,66,138615,92,165697
27172,0.002112,172.217.194.0-255,4320,142935,92,165697
27173,0.002116,172.31.47.0-255,66,143001,92,165697
27174,0.002154,172.217.194.0-255,766,143767,92,165697
27175,0.002164,172.31.47.0-255,66,143833,92,165697
27176,0.002293,172.217.194.0-255,1484,145317,92,165697
27177,0.002304,172.217.194.0-255,2902,148219,92,165697
27178,0.002307,172.31.47.0-255,66,148285,92,165697
27179,0.002312,172.217.194.0-255,2902,151187,92,165697
27180,0.002339,172.217.194.0-255,2902,154089,92,165697
27181,0.002345,172.217.194.0-255,7156,161245,92,165697
27182,0.002349,172.217.194.0-255,2902,164147,92,165697
27183,0.002366,172.217.194.0-255,1484,165631,92,165697
27184,0.008115,172.31.47.0-255,66,165697,92,165697
27185,0.0,74.125.24.0-255,153,153,92,129481
27186,2.4e-05,172.31.47.0-255,66,219,92,129481
27187,3e-05,74.125.24.0-255,1484,1703,92,129481
27188,3.4e-05,172.31.47.0-255,66,1769,92,129481
27189,6.8e-05,74.125.24.0-255,2902,4671,92,129481
27190,7.1e-05,172.31.47.0-255,66,4737,92,129481
27191,7.6e-05,74.125.24.0-255,5738,10475,92,129481
27192,7.9e-05,172.31.47.0-255,66,10541,92,129481
27193,9.9e-05,74.125.24.0-255,3464,14005,92,129481
27194,0.000101,172.31.47.0-255,66,14071,92,129481
27195,0.000106,74.125.24.0-255,4320,18391,92,129481
27196,0.000108,172.31.47.0-255,66,18457,92,129481
27197,0.000139,172.31.47.0-255,66,18523,92,129481
27198,0.000162,74.125.24.0-255,1484,20007,92,129481
27199,0.000164,172.31.47.0-255,66,20073,92,129481
27200,0.00017,74.125.24.0-255,4320,24393,92,129481
27201,0.000172,172.31.47.0-255,66,24459,92,129481
27202,0.000205,74.125.24.0-255,4320,28779,92,129481
27203,0.000208,172.31.47.0-255,66,28845,92,129481
27204,0.000244,172.31.47.0-255,66,28911,92,129481
27205,0.00052,74.125.24.0-255,1484,30395,92,129481
27206,0.000524,172.31.47.0-255,66,30461,92,129481
27207,0.000529,74.125.24.0-255,2902,33363,92,129481
27208,0.000532,172.31.47.0-255,66,33429,92,129481
27209,0.000558,74.125.24.0-255,5738,39167,92,129481
27210,0.00056,172.31.47.0-255,66,39233,92,129481
27211,0.000597,74.125.24.0-255,4320,43553,92,129481
27212,0.0006,172.31.47.0-255,66,43619,92,129481
27213,0.000626,74.125.24.0-255,2897,46516,92,129481
27214,0.000629,172.31.47.0-255,66,46582,92,129481
27215,0.000814,74.125.24.0-255,1484,48066,92,129481
27216,0.000823,74.125.24.0-255,2902,50968,92,129481
27217,0.000826,172.31.47.0-255,66,51034,92,129481
27218,0.000853,74.125.24.0-255,5738,56772,92,129481
27219,0.000855,74.125.24.0-255,1484,58256,92,129481
27220,0.000872,74.125.24.0-255,1484,59740,92,129481
27221,0.00088,172.31.47.0-255,66,59806,92,129481
27222,0.000936,74.125.24.0-255,3647,63453,92,129481
27223,0.000963,172.31.47.0-255,66,63519,92,129481
27224,0.000989,74.125.24.0-255,4320,67839,92,129481
27225,0.001014,74.125.24.0-255,7156,74995,92,129481
27226,0.001021,172.31.47.0-255,66,75061,92,129481
27227,0.001072,74.125.24.0-255,1484,76545,92,129481
27228,0.001078,74.125.24.0-255,7156,83701,92,129481
27229,0.001093,172.31.47.0-255,66,83767,92,129481
27230,0.00111,74.125.24.0-255,2184,85951,92,129481
27231,0.001139,172.31.47.0-255,66,86017,92,129481
27232,0.001468,74.125.24.0-255,1484,87501,92,129481
27233,0.001474,74.125.24.0-255,2902,90403,92,129481
27234,0.001477,172.31.47.0-255,66,90469,92,129481
27235,0.001502,74.125.24.0-255,5738,96207,92,129481
27236,0.001506,74.125.24.0-255,2902,99109,92,129481
27237,0.00156,74.125.24.0-255,2902,102011,92,129481
27238,0.001637,74.125.24.0-255,7156,109167,92,129481
27239,0.001651,74.125.24.0-255,2902,112069,92,129481
27240,0.001663,74.125.24.0-255,5738,117807,92,129481
27241,0.003896,172.31.47.0-255,66,117873,92,129481
27242,0.006153,74.125.24.0-255,5738,123611,92,129481
27243,0.006158,172.31.47.0-255,66,123677,92,129481
27244,0.008415,74.125.24.0-255,5738,129415,92,129481
27245,0.008421,172.31.47.0-255,66,129481,92,129481
27246,0.0,172.31.47.0-255,66,66,92,66
27247,0.0,74.125.24.0-255,153,153,92,234071
27248,2e-05,172.31.47.0-255,66,219,92,234071
27249,2.7e-05,74.125.24.0-255,1484,1703,92,234071
27250,3.2e-05,172.31.47.0-255,66,1769,92,234071
27251,3.8e-05,74.125.24.0-255,2902,4671,92,234071
27252,4e-05,172.31.47.0-255,66,4737,92,234071
27253,4.8e-05,74.125.24.0-255,7156,11893,92,234071
27254,5e-05,172.31.47.0-255,66,11959,92,234071
27255,7.6e-05,74.125.24.0-255,2065,14024,92,234071
27256,7.8e-05,172.31.47.0-255,66,14090,92,234071
27257,0.00012,74.125.24.0-255,1484,15574,92,234071
27258,0.000122,172.31.47.0-255,66,15640,92,234071
27259,0.000126,74.125.24.0-255,2902,18542,92,234071
27260,0.000129,172.31.47.0-255,66,18608,92,234071
27261,0.000145,74.125.24.0-255,5738,24346,92,234071
27262,0.000147,172.31.47.0-255,66,24412,92,234071
27263,0.000162,74.125.24.0-255,1484,25896,92,234071
27264,0.000164,172.31.47.0-255,66,25962,92,234071
27265,0.000182,74.125.24.0-255,5379,31341,92,234071
27266,0.000184,172.31.47.0-255,66,31407,92,234071
27267,0.000189,74.125.24.0-255,7156,38563,92,234071
27268,0.000191,172.31.47.0-255,66,38629,92,234071
27269,0.000243,172.31.47.0-255,66,38695,92,234071
27270,0.000343,74.125.24.0-255,1484,40179,92,234071
27271,0.000346,172.31.47.0-255,66,40245,92,234071
27272,0.000351,74.125.24.0-255,2902,43147,92,234071
27273,0.000352,172.31.47.0-255,66,43213,92,234071
27274,0.000355,74.125.24.0-255,1484,44697,92,234071
27275,0.000356,172.31.47.0-255,66,44763,92,234071
27276,0.000385,74.125.24.0-255,4320,49083,92,234071
27277,0.000388,172.31.47.0-255,66,49149,92,234071
27278,0.000393,74.125.24.0-255,5738,54887,92,234071
27279,0.000395,172.31.47.0-255,66,54953,92,234071
27280,0.000427,74.125.24.0-255,1708,56661,92,234071
27281,0.000429,172.31.47.0-255,66,56727,92,234071
27282,0.000458,74.125.24.0-255,2902,59629,92,234071
27283,0.000461,172.31.47.0-255,66,59695,92,234071
27284,0.000477,74.125.24.0-255,2902,62597,92,234071
27285,0.000487,74.125.24.0-255,1484,64081,92,234071
27286,0.00049,74.125.24.0-255,1484,65565,92,234071
27287,0.000503,74.125.24.0-255,7156,72721,92,234071
27288,0.000508,172.31.47.0-255,66,72787,92,234071
27289,0.000532,74.125.24.0-255,4320,77107,92,234071
27290,0.000538,172.31.47.0-255,66,77173,92,234071
27291,0.000548,74.125.24.0-255,7156,84329,92,234071
27292,0.000552,172.31.47.0-255,66,84395,92,234071
27293,0.000568,74.125.24.0-255,6438,90833,92,234071
27294,0.000583,172.31.47.0-255,66,90899,92,234071
27295,0.000907,74.125.24.0-255,1484,92383,92,234071
27296,0.000911,74.125.24.0-255,1484,93867,92,234071
27297,0.000914,172.31.47.0-255,66,93933,92,234071
27298,0.000932,74.125.24.0-255,1484,95417,92,234071
27299,0.00095,74.125.24.0-255,5738,101155,92,234071
27300,0.000955,172.31.47.0-255,66,101221,92,234071
27301,0.000987,74.125.24.0-255,5738,106959,92,234071
27302,0.001004,74.125.24.0-255,4320,111279,92,234071
27303,0.001006,74.125.24.0-255,766,112045,92,234071
27304,0.001008,172.31.47.0-255,66,112111,92,234071
27305,0.001012,172.31.47.0-255,66,112177,92,234071
27306,0.001034,74.125.24.0-255,1484,113661,92,234071
27307,0.001054,74.125.24.0-255,4320,117981,92,234071
27308,0.001063,172.31.47.0-255,66,118047,92,234071
27309,0.001073,74.125.24.0-255,5738,123785,92,234071
27310,0.001077,172.31.47.0-255,66,123851,92,234071
27311,0.001085,74.125.24.0-255,4320,128171,92,234071
27312,0.00109,74.125.24.0-255,4320,132491,92,234071
27313,0.001102,172.31.47.0-255,66,132557,92,234071
27314,0.001114,74.125.24.0-255,7156,139713,92,234071
27315,0.001118,172.31.47.0-255,66,139779,92,234071
27316,0.001136,74.125.24.0-255,5738,145517,92,234071
27317,0.001142,172.31.47.0-255,66,145583,92,234071
27318,0.001149,74.125.24.0-255,766,146349,92,234071
27319,0.001393,74.125.24.0-255,1484,147833,92,234071
27320,0.001397,172.31.47.0-255,66,147899,92,234071
27321,0.001402,74.125.24.0-255,2902,150801,92,234071
27322,0.001433,172.31.47.0-255,66,150867,92,234071
27323,0.001449,74.125.24.0-255,5738,156605,92,234071
27324,0.001472,172.31.47.0-255,66,156671,92,234071
27325,0.001513,74.125.24.0-255,2184,158855,92,234071
27326,0.001518,172.31.47.0-255,66,158921,92,234071
27327,0.001547,74.125.24.0-255,1484,160405,92,234071
27328,0.00155,74.125.24.0-255,1484,161889,92,234071
27329,0.001553,172.31.47.0-255,66,161955,92,234071
27330,0.00157,74.125.24.0-255,1484,163439,92,234071
27331,0.001576,74.125.24.0-255,5738,169177,92,234071
27332,0.00158,172.31.47.0-255,66,169243,92,234071
27333,0.001592,74.125.24.0-255,4320,173563,92,234071
27334,0.001596,74.125.24.0-255,2902,176465,92,234071
27335,0.001604,172.31.47.0-255,66,176531,92,234071
27336,0.001616,74.125.24.0-255,2902,179433,92,234071
27337,0.001628,74.125.24.0-255,4320,183753,92,234071
27338,0.001639,172.31.47.0-255,66,183819,92,234071
27339,0.001645,74.125.24.0-255,7156,190975,92,234071
27340,0.001648,74.125.24.0-255,2184,193159,92,234071
27341,0.001652,172.31.47.0-255,66,193225,92,234071
27342,0.001727,74.125.24.0-255,1484,194709,92,234071
27343,0.001742,74.125.24.0-255,2902,197611,92,234071
27344,0.001758,172.31.47.0-255,66,197677,92,234071
27345,0.001773,74.125.24.0-255,5738,203415,92,234071
27346,0.001787,172.31.47.0-255,66,203481,92,234071
27347,0.001828,172.31.47.0-255,66,203547,92,234071
27348,0.001845,74.125.24.0-255,766,204313,92,234071
27349,0.001953,74.125.24.0-255,1484,205797,92,234071
27350,0.001956,172.31.47.0-255,66,205863,92,234071
27351,0.00196,74.125.24.0-255,2902,208765,92,234071
27352,0.001968,172.31.47.0-255,66,208831,92,234071
27353,0.001977,74.125.24.0-255,4320,213151,92,234071
27354,0.001991,74.125.24.0-255,1484,214635,92,234071
27355,0.002003,74.125.24.0-255,5738,220373,92,234071
27356,0.002005,172.31.47.0-255,66,220439,92,234071
27357,0.002009,172.31.47.0-255,66,220505,92,234071
27358,0.002022,74.125.24.0-255,7156,227661,92,234071
27359,0.002038,172.31.47.0-255,66,227727,92,234071
27360,0.002094,172.31.47.0-255,66,227793,92,234071
27361,0.002111,172.31.47.0-255,66,227859,92,234071
27362,0.002118,74.125.24.0-255,1484,229343,92,234071
27363,0.002155,172.31.47.0-255,66,229409,92,234071
27364,0.002224,74.125.24.0-255,1484,230893,92,234071
27365,0.002269,74.125.24.0-255,2902,233795,92,234071
27366,0.002317,74.125.24.0-255,105,233900,92,234071
27367,0.00633,172.31.47.0-255,66,233966,92,234071
27368,0.008387,172.31.47.0-255,105,234071,92,234071
27369,0.0,74.125.68.0-255,153,153,92,170272
27370,1.7e-05,172.31.47.0-255,66,219,92,170272
27371,2.4e-05,74.125.68.0-255,1484,1703,92,170272
27372,2.7e-05,172.31.47.0-255,66,1769,92,170272
27373,3.2e-05,74.125.68.0-255,2902,4671,92,170272
27374,3.4e-05,172.31.47.0-255,66,4737,92,170272
27375,4.4e-05,74.125.68.0-255,2902,7639,92,170272
27376,4.7e-05,172.31.47.0-255,66,7705,92,170272
27377,6.8e-05,74.125.68.0-255,4320,12025,92,170272
27378,7.5e-05,172.31.47.0-255,66,12091,92,170272
27379,9.7e-05,74.125.68.0-255,2112,14203,92,170272
27380,0.0001,172.31.47.0-255,66,14269,92,170272
27381,0.000236,74.125.68.0-255,1484,15753,92,170272
27382,0.000241,172.31.47.0-255,66,15819,92,170272
27383,0.000245,74.125.68.0-255,1484,17303,92,170272
27384,0.000246,172.31.47.0-255,66,17369,92,170272
27385,0.000267,74.125.68.0-255,2902,20271,92,170272
27386,0.000269,172.31.47.0-255,66,20337,92,170272
27387,0.000279,74.125.68.0-255,5738,26075,92,170272
27388,0.000281,172.31.47.0-255,66,26141,92,170272
27389,0.000319,74.125.68.0-255,5379,31520,92,170272
27390,0.000321,172.31.47.0-255,66,31586,92,170272
27391,0.000326,74.125.68.0-255,4320,35906,92,170272
27392,0.000328,172.31.47.0-255,66,35972,92,170272
27393,0.00035,74.125.68.0-255,1484,37456,92,170272
27394,0.000353,172.31.47.0-255,66,37522,92,170272
27395,0.000358,74.125.68.0-255,4320,41842,92,170272
27396,0.000359,172.31.47.0-255,66,41908,92,170272
27397,0.000393,74.125.68.0-255,5738,47646,92,170272
27398,0.000395,172.31.47.0-255,66,47712,92,170272
27399,0.000406,74.125.68.0-255,2902,50614,92,170272
27400,0.000412,172.31.47.0-255,66,50680,92,170272
27401,0.000441,172.31.47.0-255,66,50746,92,170272
27402,0.000451,74.125.68.0-255,1484,52230,92,170272
27403,0.000456,172.31.47.0-255,66,52296,92,170272
27404,0.000481,74.125.68.0-255,5020,57316,92,170272
27405,0.000484,172.31.47.0-255,66,57382,92,170272
27406,0.000519,74.125.68.0-255,678,58060,92,170272
27407,0.000704,74.125.68.0-255,1484,59544,92,170272
27408,0.000718,74.125.68.0-255,1484,61028,92,170272
27409,0.000738,74.125.68.0-255,1484,62512,92,170272
27410,0.000745,74.125.68.0-255,5738,68250,92,170272
27411,0.000751,172.31.47.0-255,66,68316,92,170272
27412,0.000762,74.125.68.0-255,5738,74054,92,170272
27413,0.000778,172.31.47.0-255,66,74120,92,170272
27414,0.000784,74.125.68.0-255,7156,81276,92,170272
27415,0.00083,172.31.47.0-255,66,81342,92,170272
27416,0.000839,74.125.68.0-255,2184,83526,92,170272
27417,0.000849,172.31.47.0-255,66,83592,92,170272
27418,0.000986,74.125.68.0-255,1484,85076,92,170272
27419,0.000992,74.125.68.0-255,2902,87978,92,170272
27420,0.000995,172.31.47.0-255,66,88044,92,170272
27421,0.001023,74.125.68.0-255,4320,92364,92,170272
27422,0.001046,172.31.47.0-255,66,92430,92,170272
27423,0.001051,74.125.68.0-255,2902,95332,92,170272
27424,0.001055,172.31.47.0-255,66,95398,92,170272
27425,0.00108,74.125.68.0-255,2902,98300,92,170272
27426,0.001084,74.125.68.0-255,1484,99784,92,170272
27427,0.001103,74.125.68.0-255,5738,105522,92,170272
27428,0.001106,74.125.68.0-255,1484,107006,92,170272
27429,0.001112,172.31.47.0-255,66,107072,92,170272
27430,0.001133,74.125.68.0-255,7156,114228,92,170272
27431,0.001139,74.125.68.0-255,3602,117830,92,170272
27432,0.001158,172.31.47.0-255,66,117896,92,170272
27433,0.001491,74.125.68.0-255,1484,119380,92,170272
27434,0.001508,74.125.68.0-255,2902,122282,92,170272
27435,0.001512,74.125.68.0-255,2902,125184,92,170272
27436,0.001517,172.31.47.0-255,66,125250,92,170272
27437,0.001525,74.125.68.0-255,1484,126734,92,170272
27438,0.001541,172.31.47.0-255,66,126800,92,170272
27439,0.001545,74.125.68.0-255,2902,129702,92,170272
27440,0.001568,74.125.68.0-255,5738,135440,92,170272
27441,0.001571,74.125.68.0-255,1484,136924,92,170272
27442,0.001588,172.31.47.0-255,66,136990,92,170272
27443,0.001597,74.125.68.0-255,2902,139892,92,170272
27444,0.001623,74.125.68.0-255,2902,142794,92,170272
27445,0.001638,74.125.68.0-255,1484,144278,92,170272
27446,0.001642,74.125.68.0-255,2902,147180,92,170272
27447,0.001655,172.31.47.0-255,66,147246,92,170272
27448,0.001659,74.125.68.0-255,2902,150148,92,170272
27449,0.001663,172.31.47.0-255,66,150214,92,170272
27450,0.00168,74.125.68.0-255,2184,152398,92,170272
27451,0.001697,172.31.47.0-255,66,152464,92,170272
27452,0.003974,74.125.68.0-255,2902,155366,92,170272
27453,0.003981,172.31.47.0-255,66,155432,92,170272
27454,0.004012,74.125.68.0-255,2902,158334,92,170272
27455,0.004014,172.31.47.0-255,66,158400,92,170272
27456,0.006283,74.125.68.0-255,2902,161302,92,170272
27457,0.006286,172.31.47.0-255,66,161368,92,170272
27458,0.006312,74.125.68.0-255,2902,164270,92,170272
27459,0.006315,172.31.47.0-255,66,164336,92,170272
27460,0.008593,74.125.68.0-255,2902,167238,92,170272
27461,0.008599,172.31.47.0-255,66,167304,92,170272
27462,0.008627,74.125.68.0-255,2902,170206,92,170272
27463,0.00863,172.31.47.0-255,66,170272,92,170272
27464,0.0,74.125.24.0-255,298,298,92,108893
27465,1e-05,172.31.47.0-255,66,364,92,108893
27466,3e-05,74.125.24.0-255,1484,1848,92,108893
27467,3.4e-05,172.31.47.0-255,66,1914,92,108893
27468,4.1e-05,74.125.24.0-255,4320,6234,92,108893
27469,4.3e-05,172.31.47.0-255,66,6300,92,108893
27470,0.000102,74.125.24.0-255,4320,10620,92,108893
27471,0.000105,172.31.47.0-255,66,10686,92,108893
27472,0.00013,74.125.24.0-255,3264,13950,92,108893
27473,0.000132,172.31.47.0-255,66,14016,92,108893
27474,0.000155,74.125.24.0-255,1484,15500,92,108893
27475,0.000157,172.31.47.0-255,66,15566,92,108893
27476,0.000185,74.125.24.0-255,2902,18468,92,108893
27477,0.000187,172.31.47.0-255,66,18534,92,108893
27478,0.000193,74.125.24.0-255,5738,24272,92,108893
27479,0.000194,172.31.47.0-255,66,24338,92,108893
27480,0.000236,74.125.24.0-255,1484,25822,92,108893
27481,0.000239,172.31.47.0-255,66,25888,92,108893
27482,0.000258,74.125.24.0-255,5379,31267,92,108893
27483,0.000261,172.31.47.0-255,66,31333,92,108893
27484,0.000626,74.125.24.0-255,1484,32817,92,108893
27485,0.00063,172.31.47.0-255,66,32883,92,108893
27486,0.000635,74.125.24.0-255,2902,35785,92,108893
27487,0.000637,172.31.47.0-255,66,35851,92,108893
27488,0.000661,74.125.24.0-255,5738,41589,92,108893
27489,0.000664,172.31.47.0-255,66,41655,92,108893
27490,0.000669,74.125.24.0-255,4320,45975,92,108893
27491,0.000671,172.31.47.0-255,66,46041,92,108893
27492,0.000711,172.31.47.0-255,66,46107,92,108893
27493,0.000715,74.125.24.0-255,2902,49009,92,108893
27494,0.000716,172.31.47.0-255,66,49075,92,108893
27495,0.000741,74.125.24.0-255,3961,53036,92,108893
27496,0.000746,172.31.47.0-255,66,53102,92,108893
27497,0.001536,74.125.24.0-255,645,53747,92,108893
27498,0.001566,74.125.24.0-255,1484,55231,92,108893
27499,0.00157,172.31.47.0-255,66,55297,92,108893
27500,0.001591,74.125.24.0-255,4320,59617,92,108893
27501,0.001594,172.31.47.0-255,66,59683,92,108893
27502,0.001618,74.125.24.0-255,5738,65421,92,108893
27503,0.00162,172.31.47.0-255,66,65487,92,108893
27504,0.001651,172.31.47.0-255,66,65553,92,108893
27505,0.001676,74.125.24.0-255,1484,67037,92,108893
27506,0.001685,172.31.47.0-255,66,67103,92,108893
27507,0.001707,74.125.24.0-255,2184,69287,92,108893
27508,0.001709,172.31.47.0-255,66,69353,92,108893
27509,0.002064,74.125.24.0-255,1484,70837,92,108893
27510,0.002067,74.125.24.0-255,1484,72321,92,108893
27511,0.002069,172.31.47.0-255,66,72387,92,108893
27512,0.002082,74.125.24.0-255,1484,73871,92,108893
27513,0.002091,74.125.24.0-255,5738,79609,92,108893
27514,0.002093,172.31.47.0-255,66,79675,92,108893
27515,0.002115,74.125.24.0-255,4320,83995,92,108893
27516,0.002117,172.31.47.0-255,66,84061,92,108893
27517,0.002141,74.125.24.0-255,4320,88381,92,108893
27518,0.002143,172.31.47.0-255,66,88447,92,108893
27519,0.002177,74.125.24.0-255,2902,91349,92,108893
27520,0.002179,172.31.47.0-255,66,91415,92,108893
27521,0.002213,172.31.47.0-255,66,91481,92,108893
27522,0.004519,74.125.24.0-255,5738,97219,92,108893
27523,0.004527,172.31.47.0-255,66,97285,92,108893
27524,0.006808,74.125.24.0-255,5738,103023,92,108893
27525,0.006813,172.31.47.0-255,66,103089,92,108893
27526,0.00915,74.125.24.0-255,5738,108827,92,108893
27527,0.009157,172.31.47.0-255,66,108893,92,108893
27528,0.0,172.217.194.0-255,153,153,92,237978
27529,3.2e-05,172.31.47.0-255,66,219,92,237978
27530,3.9e-05,172.217.194.0-255,1484,1703,92,237978
27531,4.3e-05,172.31.47.0-255,66,1769,92,237978
27532,4.9e-05,172.217.194.0-255,2902,4671,92,237978
27533,5.1e-05,172.31.47.0-255,66,4737,92,237978
27534,5.7e-05,172.217.194.0-255,7156,11893,92,237978
27535,6e-05,172.31.47.0-255,66,11959,92,237978
27536,6.3e-05,172.217.194.0-255,2110,14069,92,237978
27537,6.6e-05,172.31.47.0-255,66,14135,92,237978
27538,0.000103,172.31.47.0-255,66,14201,92,237978
27539,0.000125,172.217.194.0-255,5379,19580,92,237978
27540,0.000128,172.31.47.0-255,66,19646,92,237978
27541,0.000198,172.217.194.0-255,1484,21130,92,237978
27542,0.000201,172.31.47.0-255,66,21196,92,237978
27543,0.000205,172.217.194.0-255,2902,24098,92,237978
27544,0.000207,172.31.47.0-255,66,24164,92,237978
27545,0.000236,172.217.194.0-255,5738,29902,92,237978
27546,0.000238,172.31.47.0-255,66,29968,92,237978
27547,0.000241,172.217.194.0-255,1484,31452,92,237978
27548,0.000244,172.31.47.0-255,66,31518,92,237978
27549,0.000261,172.217.194.0-255,7156,38674,92,237978
27550,0.000264,172.31.47.0-255,66,38740,92,237978
27551,0.000288,172.217.194.0-255,5379,44119,92,237978
27552,0.000291,172.31.47.0-255,66,44185,92,237978
27553,0.000303,172.31.47.0-255,66,44251,92,237978
27554,0.000326,172.217.194.0-255,98,44349,92,237978
27555,0.000329,172.31.47.0-255,66,44415,92,237978
27556,0.000332,172.217.194.0-255,365,44780,92,237978
27557,0.000334,172.31.47.0-255,66,44846,92,237978
27558,0.000525,172.217.194.0-255,1484,46330,92,237978
27559,0.000533,172.217.194.0-255,2902,49232,92,237978
27560,0.000536,172.31.47.0-255,66,49298,92,237978
27561,0.00054,172.217.194.0-255,1484,50782,92,237978
27562,0.000557,172.217.194.0-255,4320,55102,92,237978
27563,0.000559,172.31.47.0-255,66,55168,92,237978
27564,0.000564,172.217.194.0-255,2902,58070,92,237978
27565,0.000566,172.31.47.0-255,66,58136,92,237978
27566,0.000589,172.31.47.0-255,66,58202,92,237978
27567,0.000596,172.217.194.0-255,7156,65358,92,237978
27568,0.000598,172.31.47.0-255,66,65424,92,237978
27569,0.000621,172.217.194.0-255,2902,68326,92,237978
27570,0.000624,172.31.47.0-255,66,68392,92,237978
27571,0.00065,172.31.47.0-255,66,68458,92,237978
27572,0.000689,172.217.194.0-255,5738,74196,92,237978
27573,0.00069,172.31.47.0-255,66,74262,92,237978
27574,0.000693,172.31.47.0-255,66,74328,92,237978
27575,0.000714,172.31.47.0-255,66,74394,92,237978
27576,0.000731,172.217.194.0-255,2902,77296,92,237978
27577,0.000734,172.31.47.0-255,66,77362,92,237978
27578,0.00077,172.31.47.0-255,66,77428,92,237978
27579,0.000777,172.217.194.0-255,7156,84584,92,237978
27580,0.000779,172.31.47.0-255,66,84650,92,237978
27581,0.000812,172.31.47.0-255,66,84716,92,237978
27582,0.000815,172.217.194.0-255,766,85482,92,237978
27583,0.001026,172.217.194.0-255,1484,86966,92,237978
27584,0.00103,172.31.47.0-255,66,87032,92,237978
27585,0.001095,172.217.194.0-255,2902,89934,92,237978
27586,0.001098,172.31.47.0-255,66,90000,92,237978
27587,0.001103,172.217.194.0-255,5738,95738,92,237978
27588,0.001105,172.31.47.0-255,66,95804,92,237978
27589,0.001116,172.31.47.0-255,66,95870,92,237978
27590,0.001125,172.31.47.0-255,66,95936,92,237978
27591,0.001154,172.217.194.0-255,6438,102374,92,237978
27592,0.001156,172.31.47.0-255,66,102440,92,237978
27593,0.001162,172.217.194.0-255,7156,109596,92,237978
27594,0.001165,172.31.47.0-255,66,109662,92,237978
27595,0.001195,172.217.194.0-255,1484,111146,92,237978
27596,0.001223,172.31.47.0-255,66,111212,92,237978
27597,0.001227,172.217.194.0-255,5020,116232,92,237978
27598,0.001229,172.31.47.0-255,66,116298,92,237978
27599,0.001442,172.217.194.0-255,1484,117782,92,237978
27600,0.001456,172.217.194.0-255,2902,120684,92,237978
27601,0.00146,172.217.194.0-255,4320,125004,92,237978
27602,0.00146,172.31.47.0-255,66,125070,92,237978
27603,0.001463,172.31.47.0-255,66,125136,92,237978
27604,0.001468,172.217.194.0-255,1484,126620,92,237978
27605,0.001488,172.217.194.0-255,2902,129522,92,237978
27606,0.00149,172.31.47.0-255,66,129588,92,237978
27607,0.001521,172.31.47.0-255,66,129654,92,237978
27608,0.001525,172.217.194.0-255,4320,133974,92,237978
27609,0.001527,172.31.47.0-255,66,134040,92,237978
27610,0.001542,172.217.194.0-255,4320,138360,92,237978
27611,0.001545,172.31.47.0-255,66,138426,92,237978
27612,0.001578,172.217.194.0-255,2184,140610,92,237978
27613,0.001581,172.31.47.0-255,66,140676,92,237978
27614,0.001667,172.217.194.0-255,1484,142160,92,237978
27615,0.001673,172.217.194.0-255,2902,145062,92,237978
27616,0.001676,172.31.47.0-255,66,145128,92,237978
27617,0.001679,172.217.194.0-255,1484,146612,92,237978
27618,0.001693,172.217.194.0-255,4320,150932,92,237978
27619,0.001696,172.31.47.0-255,66,150998,92,237978
27620,0.001701,172.217.194.0-255,4320,155318,92,237978
27621,0.001703,172.31.47.0-255,66,155384,92,237978
27622,0.001727,172.217.194.0-255,4320,159704,92,237978
27623,0.00173,172.31.47.0-255,66,159770,92,237978
27624,0.001757,172.217.194.0-255,2902,162672,92,237978
27625,0.00176,172.31.47.0-255,66,162738,92,237978
27626,0.001779,172.31.47.0-255,66,162804,92,237978
27627,0.001803,172.217.194.0-255,3602,166406,92,237978
27628,0.001806,172.31.47.0-255,66,166472,92,237978
27629,0.00186,172.217.194.0-255,1484,167956,92,237978
27630,0.001864,172.217.194.0-255,1484,169440,92,237978
27631,0.001866,172.31.47.0-255,66,169506,92,237978
27632,0.001888,172.217.194.0-255,1484,170990,92,237978
27633,0.001894,172.217.194.0-255,5738,176728,92,237978
27634,0.001897,172.31.47.0-255,66,176794,92,237978
27635,0.001907,172.31.47.0-255,66,176860,92,237978
27636,0.001927,172.217.194.0-255,2902,179762,92,237978
27637,0.001929,172.31.47.0-255,66,179828,92,237978
27638,0.00194,172.31.47.0-255,66,179894,92,237978
27639,0.002016,172.217.194.0-255,1484,181378,92,237978
27640,0.002021,172.217.194.0-255,2902,184280,92,237978
27641,0.002029,172.31.47.0-255,66,184346,92,237978
27642,0.002047,172.217.194.0-255,5738,190084,92,237978
27643,0.00205,172.31.47.0-255,66,190150,92,237978
27644,0.002054,172.217.194.0-255,2902,193052,92,237978
27645,0.002056,172.31.47.0-255,66,193118,92,237978
27646,0.002098,172.31.47.0-255,66,193184,92,237978
27647,0.002107,172.31.47.0-255,66,193250,92,237978
27648,0.002109,172.217.194.0-255,1484,194734,92,237978
27649,0.002112,172.217.194.0-255,766,195500,92,237978
27650,0.002113,172.31.47.0-255,66,195566,92,237978
27651,0.002161,172.217.194.0-255,1484,197050,92,237978
27652,0.002166,172.217.194.0-255,4320,201370,92,237978
27653,0.002168,172.31.47.0-255,66,201436,92,237978
27654,0.002174,172.217.194.0-255,5738,207174,92,237978
27655,0.002177,172.217.194.0-255,4320,211494,92,237978
27656,0.002178,172.31.47.0-255,66,211560,92,237978
27657,0.00218,172.31.47.0-255,66,211626,92,237978
27658,0.002224,172.31.47.0-255,66,211692,92,237978
27659,0.00223,172.217.194.0-255,6438,218130,92,237978
27660,0.002233,172.31.47.0-255,66,218196,92,237978
27661,0.002312,172.217.194.0-255,1484,219680,92,237978
27662,0.002318,172.217.194.0-255,2902,222582,92,237978
27663,0.002321,172.31.47.0-255,66,222648,92,237978
27664,0.002337,172.217.194.0-255,5738,228386,92,237978
27665,0.00234,172.31.47.0-255,66,228452,92,237978
27666,0.002345,172.217.194.0-255,5738,234190,92,237978
27667,0.002347,172.31.47.0-255,66,234256,92,237978
27668,0.002385,172.217.194.0-255,3551,237807,92,237978
27669,0.002389,172.31.47.0-255,66,237873,92,237978
27670,0.002408,172.217.194.0-255,105,237978,92,237978
